,n_samples,MAE,RMSE,R2,time_learning,time_predicting,memory,n_nodes,n_branches,n_leaves,n_active_leaves,n_inactive_leaves,height,total_observed_weight
0,999,20.440979986079185,37.967697877130654,-0.015855405519509258,0.13603734970092773,0.06887435913085938,0.20744705200195312,3,1,2,2,0,2,1000.0
1,1999,21.31080732288728,42.87461280238688,-0.004421547843187712,0.278639554977417,0.13524174690246582,0.27556610107421875,3,1,2,2,0,2,2000.0
2,2999,20.397330638790503,39.57390096207081,0.0007348535944003975,0.4144444465637207,0.1955583095550537,0.6217117309570312,17,2,15,15,0,3,3000.0
3,3999,20.508314489474415,44.407106026780376,0.011323311928136404,0.5224626064300537,0.24965119361877441,0.8194923400878906,17,2,15,15,0,3,4000.0
4,4999,19.993003274920202,41.899697707982384,0.012074566550400734,0.6400778293609619,0.3040432929992676,0.9302520751953125,17,2,15,15,0,3,5000.0
5,5999,19.60112125488773,40.46515405455935,0.011666968211875073,0.7611756324768066,0.358443021774292,1.0125999450683594,18,2,16,16,0,3,6000.0
6,6999,19.500999290529982,39.384706186786595,0.01242669690728715,0.883594274520874,0.4127485752105713,1.0752372741699219,18,2,16,16,0,3,7000.0
7,7999,19.66464607092514,38.888628039335174,0.01157747904198092,1.0043928623199463,0.46755409240722656,1.1205596923828125,18,2,16,16,0,3,8000.0
8,8999,19.982729286311802,39.096006574701235,0.012745441836717886,1.135807991027832,0.524329662322998,1.038909912109375,23,3,20,20,0,3,9000.0
9,9999,20.448109261126202,39.69709972458173,0.018589121647238582,1.2408645153045654,0.5795607566833496,1.2144584655761719,23,3,20,20,0,3,10000.0
10,10999,20.63059398189732,39.4738513708808,0.018561577964349874,1.3427555561065674,0.6347510814666748,1.3082008361816406,23,3,20,20,0,3,11000.0
11,11999,20.76714934801344,39.199144942399066,0.020853095765522633,1.4743618965148926,0.6902432441711426,1.3602256774902344,25,4,21,21,0,4,12000.0
12,12999,21.303134330957896,40.54716996208335,0.022285555379921607,1.5977814197540283,0.7457780838012695,1.4007072448730469,27,5,22,22,0,4,13000.0
13,13999,21.869092312118898,41.141336223348084,0.02485591910036966,1.7016305923461914,0.8013978004455566,1.479156494140625,27,5,22,22,0,4,14000.0
14,14999,22.363564804202245,41.58976395729209,0.028690427580305045,1.8255665302276611,0.8578221797943115,1.4480400085449219,33,7,26,26,0,4,15000.0
15,15999,22.56486219504081,41.4996080587948,0.031483408568488414,1.932471513748169,0.9149012565612793,1.5754966735839844,33,7,26,26,0,4,16000.0
16,16999,22.93458725178538,41.96063134728981,0.03412798082559998,2.0500214099884033,0.9705047607421875,1.6596298217773438,33,7,26,26,0,4,17000.0
17,17999,23.223728159834547,41.916612755836994,0.034469358675977224,2.166548252105713,1.0263879299163818,1.7140655517578125,33,7,26,26,0,4,18000.0
18,18999,23.178061169525595,41.52610223565763,0.03696285431973345,2.275303840637207,1.0823099613189697,1.7742919921875,33,7,26,26,0,4,19000.0
19,19999,23.22140462031433,41.23027371040575,0.032598394707664125,2.412545680999756,1.1384210586547852,1.8912429809570312,35,8,27,27,0,4,20000.0
20,20999,23.13391730071752,40.961352922685116,0.028288731273115486,2.5170698165893555,1.1946887969970703,1.9037284851074219,44,9,35,35,0,4,21000.0
21,21999,22.985116740109312,40.49087888422214,0.02621847843394831,2.6418426036834717,1.2506608963012695,2.003337860107422,44,9,35,35,0,4,22000.0
22,22999,22.849978117047755,40.25654397080245,0.02405850984001867,2.769253730773926,1.3070356845855713,2.1021804809570312,45,9,36,36,0,4,23000.0
23,23999,22.70290713591651,39.77870858038698,0.02325343988839934,2.8705780506134033,1.3628172874450684,2.145965576171875,45,9,36,36,0,4,24000.0
24,24999,22.55407811797765,39.364471839728445,0.02238038991761071,3.0116348266601562,1.4193651676177979,2.1784515380859375,45,9,36,36,0,4,25000.0
25,25999,22.42532066156132,39.047893725035536,0.02126820551361497,3.1194472312927246,1.4752497673034668,2.1048431396484375,47,10,37,37,0,4,26000.0
26,26999,22.321637958288612,38.71088767643103,0.020104167107524162,3.2422735691070557,1.5316412448883057,2.1855010986328125,47,10,37,37,0,4,27000.0
27,27999,22.200059737124647,38.41815706717919,0.019622464998627187,3.377384662628174,1.5878772735595703,2.244037628173828,47,10,37,37,0,4,28000.0
28,28999,22.107581879231493,38.29413808740664,0.018533774407225923,3.4711456298828125,1.643887996673584,2.2999496459960938,47,10,37,37,0,4,29000.0
29,29999,22.01301591352476,38.01722632879976,0.018071755128445277,3.613424777984619,1.699960470199585,2.2851600646972656,53,12,41,41,0,5,30000.0
30,30999,21.961871742500623,38.140675611577144,0.018152483036460776,3.7275660037994385,1.756291389465332,2.3415870666503906,53,12,41,41,0,5,31000.0
31,31999,21.883709115349294,37.88590576708556,0.01782846398631799,3.8455846309661865,1.8127171993255615,2.375072479248047,53,12,41,41,0,5,32000.0
32,32999,21.840532053688886,37.76388939657605,0.017473000175000974,3.977158784866333,1.869260311126709,2.3563919067382812,55,13,42,42,0,5,33000.0
33,33999,21.795801677916977,37.58333530754987,0.017643407645441034,4.099672317504883,1.925614595413208,2.3919715881347656,55,13,42,42,0,5,34000.0
34,34999,21.775957151955033,37.452984206136534,0.017452663865636042,4.2152485847473145,1.9821078777313232,2.4494667053222656,61,14,47,47,0,5,35000.0
35,35999,21.79822430786068,37.312547332508466,0.0178854481360613,4.361837148666382,2.0389184951782227,2.4031829833984375,67,15,52,52,0,5,36000.0
36,36999,21.78813920773123,37.150623487899495,0.017710762854754036,4.4643332958221436,2.09586238861084,2.4844741821289062,67,15,52,52,0,5,37000.0
37,37999,21.77242889143574,36.95994344060154,0.01744370858070754,4.594853639602661,2.1519672870635986,2.5214004516601562,67,15,52,52,0,5,38000.0
38,38999,21.73013481646514,36.78461388913982,0.01744361133933181,4.7177300453186035,2.2089197635650635,2.503326416015625,72,16,56,56,0,5,39000.0
39,39999,21.66283661228845,36.583635403087,0.018029189317647742,4.831764459609985,2.266498327255249,2.604015350341797,72,16,56,56,0,5,40000.0
40,40999,21.590310056767645,36.448690155782415,0.017514630659597574,4.936389207839966,2.324784994125366,2.869598388671875,72,16,56,56,0,5,41000.0
41,41999,21.453827002077208,36.19138906346989,0.017646796915505747,5.05958104133606,2.38106632232666,2.9657440185546875,72,16,56,56,0,5,42000.0
42,42999,21.330006258796573,35.96469613040425,0.017978193686009725,5.176665306091309,2.4379477500915527,3.0379981994628906,72,16,56,56,0,5,43000.0
43,43999,21.193486958351517,35.713199236541755,0.018268205372004687,5.3009865283966064,2.4949288368225098,3.178455352783203,72,16,56,56,0,5,44000.0
44,44999,21.09108305728135,35.512837867816565,0.018518764988789904,5.419824600219727,2.5516247749328613,3.280536651611328,72,16,56,56,0,5,45000.0
45,45999,20.968234713166503,35.25784763648519,0.01910135244302258,5.536099910736084,2.608582019805908,3.343097686767578,72,16,56,56,0,5,46000.0
46,46999,20.851874873895152,35.0361602068205,0.01940363788475219,5.655863046646118,2.6660115718841553,3.1207275390625,78,18,60,60,0,5,47000.0
47,47999,20.746013186931112,34.911701526208574,0.019483840433679678,5.770938158035278,2.723600149154663,3.2274322509765625,78,18,60,60,0,5,48000.0
48,48999,20.68370769168969,34.89056789341762,0.019349119698289674,5.901983976364136,2.780614137649536,3.2880592346191406,78,18,60,60,0,5,49000.0
49,49999,20.60459081285376,34.85194905601396,0.019160323951370906,6.019751310348511,2.886460542678833,3.382465362548828,78,18,60,60,0,5,50000.0
50,50999,20.56337601386892,34.8012479125506,0.019341710248499733,6.1297607421875,2.943507194519043,3.4846534729003906,78,18,60,60,0,5,51000.0
51,51999,20.53454520335811,34.709812479595875,0.01949065217883683,6.26207971572876,3.0004899501800537,3.470794677734375,81,19,62,62,0,5,52000.0
52,52999,20.476079115040704,34.588632614090315,0.019640523050472147,6.374397039413452,3.0575339794158936,3.5356407165527344,81,19,62,62,0,5,53000.0
53,53999,20.451577119142122,34.55027393258484,0.019344226928942887,6.488933324813843,3.113811731338501,3.5869979858398438,81,19,62,62,0,5,54000.0
54,54999,20.44447038003119,34.50457670735623,0.019160291084014403,6.6066060066223145,3.170933246612549,3.6175498962402344,81,19,62,62,0,5,55000.0
55,55999,20.448045966268182,34.47596487102396,0.01924301946223539,6.7292656898498535,3.2277491092681885,3.5642623901367188,84,20,64,64,0,5,56000.0
56,56999,20.45246564412425,34.428828088385785,0.01928559484991521,6.870765924453735,3.284555196762085,3.600921630859375,84,20,64,64,0,5,57000.0
57,57999,20.460958873208366,34.37929464160595,0.019655773915057462,6.986413955688477,3.341632843017578,3.6372947692871094,84,20,64,64,0,5,58000.0
58,58999,20.461264390750653,34.31810687120936,0.01929461219613393,7.11320424079895,3.3980021476745605,3.5226287841796875,97,22,75,75,0,5,59000.0
59,59999,20.478005960931462,34.2708540155441,0.01898660272550312,7.231097221374512,3.4552507400512695,3.5722732543945312,97,22,75,75,0,5,60000.0
60,60999,20.503237466573005,34.381005085898295,0.019284641854619644,7.355974197387695,3.512634515762329,3.7666053771972656,100,22,78,78,0,5,61000.0
61,61999,20.406847969201547,34.24877841455367,0.0203249663173396,7.455288648605347,3.570067882537842,4.048877716064453,102,22,80,80,0,5,62000.0
62,62999,20.296576561633426,34.14634995177999,0.021071276592446675,7.569830417633057,3.6271791458129883,4.111747741699219,104,23,81,81,0,6,63000.0
63,63999,20.201334136685524,34.07194226587427,0.021721053180078553,7.690022706985474,3.684631109237671,4.135490417480469,110,25,85,85,0,6,64000.0
64,64999,20.105595243358632,33.92566987797461,0.02177136970932747,7.804980278015137,3.741521120071411,4.186618804931641,114,27,87,87,0,6,65000.0
65,65999,20.056666821540702,33.90378046086182,0.02173478117978911,7.919510841369629,3.7989418506622314,4.389373779296875,123,28,95,95,0,6,66000.0
66,66999,20.020917392944554,33.93937910641109,0.021803059888585996,8.038631200790405,3.856677293777466,4.395717620849609,127,29,98,98,0,6,67000.0
67,67999,19.983820603297403,33.881796488762056,0.02201057543109841,8.16813850402832,3.9146759510040283,4.471397399902344,131,30,101,101,0,6,68000.0
68,68999,19.996298070624647,33.92020409160635,0.02448473144197827,8.27952766418457,3.9726898670196533,4.621307373046875,132,30,102,102,0,6,69000.0
69,69999,20.02426800666923,34.2314480116366,0.02588719860926203,8.401477575302124,4.031446933746338,4.70758056640625,132,30,102,102,0,6,70000.0
70,70999,20.092008417441548,34.458566646120524,0.027548659644021645,8.50587010383606,4.089107036590576,4.790119171142578,137,31,106,106,0,6,71000.0
71,71999,20.186459224419252,34.6718350543381,0.029833140598687025,8.612000942230225,4.1462562084198,4.8923187255859375,137,31,106,106,0,6,72000.0
72,72999,20.258131022385154,35.041575181634165,0.030583645832514494,8.737426280975342,4.204054117202759,4.848155975341797,145,32,113,113,0,6,73000.0
73,73999,20.34024264394314,35.3223876038457,0.03310125187634383,8.862393140792847,4.262153387069702,4.952476501464844,151,33,118,118,0,6,74000.0
74,74999,20.41491948185782,35.459581157989184,0.03463150687015881,8.987138032913208,4.3216753005981445,5.025890350341797,164,35,129,129,0,7,75000.0
75,75999,20.490842406069433,35.57010133645919,0.03743616920043835,9.090168476104736,4.380052089691162,5.193721771240234,164,35,129,129,0,7,76000.0
76,76999,20.614675958849553,35.99691359124106,0.03936223731427746,9.203243732452393,4.438228368759155,5.298595428466797,164,35,129,129,0,7,77000.0
77,77999,20.743013480668065,36.19573601161527,0.040302814611248294,9.318274974822998,4.495645761489868,5.384918212890625,167,36,131,131,0,7,78000.0
78,78999,20.858645245170546,36.355659776792926,0.04046544435817567,9.438894033432007,4.553579568862915,5.368839263916016,171,37,134,134,0,7,79000.0
79,79999,20.971426550207703,36.468123905162685,0.04159643773909261,9.548271417617798,4.6120805740356445,5.414703369140625,173,38,135,135,0,7,80000.0
80,80999,21.0618976755674,36.54172512232629,0.04167688814981585,9.667242527008057,4.669970989227295,5.476219177246094,173,38,135,135,0,7,81000.0
81,81999,21.053396953892634,36.528559859913386,0.041048465456390626,9.782500505447388,4.727698564529419,5.820518493652344,178,38,140,140,0,7,82000.0
82,82999,21.011708756863186,36.504034343012755,0.04115004546611001,9.89589786529541,4.785003662109375,5.9537353515625,178,38,140,140,0,7,83000.0
83,83999,20.954575575228194,36.388464752386334,0.04145273341362088,10.018190145492554,4.84290885925293,5.990875244140625,185,40,145,145,0,7,84000.0
84,84999,20.915769999806997,36.30990869973049,0.04125306335241963,10.121310234069824,4.900570631027222,6.1041717529296875,185,40,145,145,0,7,85000.0
85,85999,20.922861737381677,36.34106953842897,0.0417753476709789,10.244359254837036,4.959171533584595,6.2659912109375,191,42,149,149,0,7,86000.0
86,86999,20.90378323514314,36.29462459351761,0.04113181973807234,10.35589599609375,5.017285346984863,6.3659820556640625,193,43,150,150,0,7,87000.0
87,87999,20.94868087314287,36.3649253690258,0.04066082348646538,10.470638990402222,5.075674533843994,6.5077972412109375,200,45,155,155,0,7,88000.0
88,88999,20.989148092141082,36.43473632783817,0.04015737009505915,10.589706659317017,5.133997201919556,6.596599578857422,202,46,156,156,0,7,89000.0
89,89999,21.04140303227493,36.48729746510089,0.04047053747423612,10.702876806259155,5.191743850708008,6.730552673339844,202,46,156,156,0,7,90000.0
90,90999,21.10797950464864,36.571372414764085,0.04017563181950634,10.821322202682495,5.2508156299591064,6.895862579345703,211,47,164,164,0,7,91000.0
91,91999,21.193089636405563,36.7021783939645,0.04058420336668633,10.936284065246582,5.30936861038208,7.081256866455078,216,48,168,168,0,8,92000.0
92,92999,21.30889120909824,36.922046768876854,0.04219359006660761,11.04712438583374,5.367673397064209,7.225635528564453,216,48,168,168,0,8,93000.0
93,93999,21.404107281393085,37.05570321272088,0.042594743242317046,11.159543752670288,5.426241397857666,7.344612121582031,216,48,168,168,0,8,94000.0
94,94999,21.486469858777774,37.14299196195826,0.04284329962252209,11.273127317428589,5.483926296234131,7.434940338134766,216,48,168,168,0,8,95000.0
95,95999,21.59112066684618,37.29838142896341,0.0442265771292949,11.380446910858154,5.541946887969971,7.510795593261719,216,48,168,168,0,8,96000.0
96,96999,21.71768521247733,37.46482183324516,0.044509202812546,11.487227201461792,5.599825859069824,7.578449249267578,216,48,168,168,0,8,97000.0
97,97999,21.851029942325713,37.77399121032851,0.04511744342564672,11.593351602554321,5.65807032585144,7.620006561279297,224,49,175,175,0,8,98000.0
98,98999,21.975492993796333,37.94152977032811,0.04540210068424666,11.712546348571777,5.716026067733765,7.744316101074219,224,49,175,175,0,8,99000.0
99,99999,22.09769757964763,38.10262550313579,0.04730358142006563,11.840855598449707,5.774560928344727,7.719371795654297,235,51,184,184,0,8,100000.0
100,100999,22.193770457154063,38.19321919386247,0.048002528073944783,11.957174301147461,5.832845449447632,7.8047332763671875,241,52,189,189,0,8,101000.0
101,101999,22.23787432595377,38.21710731761284,0.0477683509830229,12.079960107803345,5.891046047210693,8.086223602294922,252,53,199,199,0,8,102000.0
102,102999,22.190978387151752,38.14180460729355,0.048024461231568005,12.181684017181396,5.949575662612915,8.269523620605469,252,53,199,199,0,8,103000.0
103,103999,22.158140347773397,38.127703229506565,0.048171439418675965,12.304518938064575,6.007847547531128,8.388038635253906,252,53,199,199,0,8,104000.0
104,104999,22.1089914600574,38.086469107940225,0.04807892757102783,12.41257095336914,6.065606355667114,8.451923370361328,254,54,200,200,0,8,105000.0
105,105999,22.066128245420717,38.01898741081172,0.048206771655925684,12.514172315597534,6.123706579208374,8.557022094726562,256,55,201,201,0,8,106000.0
106,106999,22.017272127992257,37.9373405917001,0.048264553966966606,12.6421799659729,6.181498289108276,8.529319763183594,261,57,204,204,0,8,107000.0
107,107999,21.96109707707328,37.83020657478212,0.04844153933471829,12.748161792755127,6.2399938106536865,8.645572662353516,263,58,205,205,0,8,108000.0
108,108999,21.92491353926541,37.90601668773653,0.04805320293295268,12.863329410552979,6.2988600730896,8.757038116455078,263,58,205,205,0,8,109000.0
109,109999,21.88203783463412,37.83221012100356,0.048222223969259015,12.98546814918518,6.356919288635254,8.83707046508789,263,58,205,205,0,8,110000.0
110,110999,21.856354206063813,37.75710781912801,0.04821933345661955,13.103725910186768,6.4151833057403564,8.82248306274414,265,59,206,206,0,8,111000.0
111,111999,21.84830075562121,37.8252235723422,0.047627492298792706,13.217450380325317,6.473252773284912,8.923873901367188,265,59,206,206,0,8,112000.0
112,112999,21.83325731403077,37.75466625871994,0.047453059358679606,13.337231159210205,6.531645774841309,8.990718841552734,265,59,206,206,0,8,113000.0
113,113999,21.820646941737937,37.7008536963329,0.047395409166869795,13.454398393630981,6.58996057510376,9.036346435546875,265,59,206,206,0,8,114000.0
114,114999,21.817215959768806,37.66250123334216,0.04721196286968232,13.576321840286255,6.648430824279785,9.084800720214844,265,59,206,206,0,8,115000.0
115,115999,21.810052523631715,37.60308569766167,0.04694239148872126,13.695481538772583,6.70623517036438,9.123794555664062,265,59,206,206,0,8,116000.0
116,116999,21.804446015848033,37.536698047951845,0.04675831281493181,13.805207967758179,6.763703107833862,9.176612854003906,270,60,210,210,0,8,117000.0
117,117999,21.80204994243012,37.52519968532343,0.04638354105745168,13.933515548706055,6.821667432785034,9.237953186035156,272,61,211,211,0,8,118000.0
118,118999,21.788708223142596,37.46671280604575,0.045911827788229,14.06928539276123,6.880352258682251,9.254207611083984,274,62,212,212,0,8,119000.0
119,119999,21.746797820938678,37.39963339886899,0.04586317910298254,14.241821765899658,6.938588857650757,9.591732025146484,281,62,219,219,0,8,120000.0
120,120999,21.691993921061318,37.30708961356687,0.046458396911008615,14.360569715499878,6.996397972106934,9.731914520263672,281,62,219,219,0,8,121000.0
121,121999,21.6258406185223,37.203563736018204,0.04691307165693959,14.471631526947021,7.0545408725738525,9.74200439453125,285,64,221,221,0,8,122000.0
122,122999,21.576249545968047,37.1223964683469,0.04750616753540449,14.59468126296997,7.113049268722534,9.8411865234375,291,65,226,226,0,8,123000.0
123,123999,21.528185552174023,37.036369279979205,0.04777913922089394,14.716481685638428,7.1715593338012695,9.80240249633789,297,68,229,229,0,8,124000.0
124,124999,21.484907107221954,37.01160361451376,0.048191998491839305,14.83014178276062,7.229978322982788,9.92425537109375,297,68,229,229,0,8,125000.0
125,125999,21.446498987306306,36.94535925392093,0.04827086317509399,14.940682888031006,7.289027452468872,9.946170806884766,304,71,233,233,0,8,126000.0
126,126999,21.412452261637995,36.880586335409234,0.048110010684897175,15.066949129104614,7.347451448440552,10.06558609008789,304,71,233,233,0,8,127000.0
127,127999,21.382539704036557,36.81620724307237,0.04779046220974237,15.176820516586304,7.405632734298706,10.143585205078125,304,71,233,233,0,8,128000.0
128,128999,21.36397428757347,36.7521940768285,0.0477252868852871,15.30964994430542,7.464814901351929,10.21725845336914,317,73,244,244,0,8,129000.0
129,129999,21.34694848076379,36.70376608411704,0.04744251045990422,15.419688940048218,7.523451805114746,10.331218719482422,317,73,244,244,0,8,130000.0
130,130999,21.32726653875299,36.657399873540626,0.04738025112219202,15.531510353088379,7.581665992736816,10.430397033691406,317,73,244,244,0,8,131000.0
131,131999,21.331124628258298,36.71002957824351,0.04763783660359122,15.654210329055786,7.639323949813843,10.496082305908203,317,73,244,244,0,8,132000.0
132,132999,21.329129724897392,36.685444823922374,0.04749114582536429,15.756296873092651,7.696753263473511,10.574993133544922,317,73,244,244,0,8,133000.0
133,133999,21.34568304286839,36.70088098657343,0.04750291084375069,15.880143880844116,7.754968881607056,10.620494842529297,323,74,249,249,0,8,134000.0
134,134999,21.37611525591754,36.72493290688903,0.04777496304668605,15.99415373802185,7.813644170761108,10.825969696044922,324,74,250,250,0,8,135000.0
135,135999,21.402840838271516,36.72930630166545,0.04780339518190424,16.106581449508667,7.87169623374939,10.888919830322266,329,75,254,254,0,8,136000.0
136,136999,21.433594924806123,36.74775349254415,0.04771066923817224,16.22261881828308,7.929893970489502,10.958694458007812,329,75,254,254,0,8,137000.0
137,137999,21.46974592796819,36.82618205050756,0.04778327865741716,16.350270986557007,7.98799729347229,11.03970718383789,329,75,254,254,0,8,138000.0
138,138999,21.484769156337396,36.815773099883465,0.04757873802835655,16.469106674194336,8.046102523803711,11.295806884765625,332,76,256,256,0,8,139000.0
139,139999,21.474343249046047,36.807293187230734,0.047004373568496516,16.567198753356934,8.103074550628662,11.505294799804688,339,77,262,262,0,8,140000.0
140,140999,21.448004940439077,36.74032243521858,0.04676938294317179,16.68364906311035,8.160503625869751,11.704139709472656,339,77,262,262,0,8,141000.0
141,141999,21.425001568926294,36.680994707219334,0.04661438997173839,16.801013708114624,8.218046426773071,11.811935424804688,339,77,262,262,0,8,142000.0
142,142999,21.39663584775679,36.608779681235,0.04643285539450037,16.909806728363037,8.27592658996582,11.880332946777344,339,77,262,262,0,8,143000.0
143,143999,21.376748737504577,36.57076810314148,0.04608828053944136,17.03820824623108,8.334139108657837,11.966373443603516,339,77,262,262,0,8,144000.0
144,144999,21.354397448951993,36.5017937436695,0.04585816848537605,17.141703128814697,8.391916513442993,12.028472900390625,339,77,262,262,0,8,145000.0
145,145999,21.33014814992321,36.437913887557286,0.04587379632679178,17.287497758865356,8.455615758895874,12.01531982421875,346,78,268,268,0,8,146000.0
146,146999,21.31243499368811,36.384762411431375,0.045703945313646965,17.40728759765625,8.515623331069946,12.064460754394531,346,78,268,268,0,8,147000.0
147,147999,21.290529826275396,36.31726903161097,0.04563777083568721,17.528675079345703,8.573920249938965,12.093875885009766,351,79,272,272,0,8,148000.0
148,148999,21.28133395556165,36.284702620104255,0.04528409590772353,17.64564037322998,8.633208274841309,12.175189971923828,351,79,272,272,0,8,149000.0
149,149999,21.27710104750608,36.232470987379614,0.044946754150469115,17.760839462280273,8.692214727401733,12.201766967773438,351,79,272,272,0,8,150000.0
150,150999,21.27933313775709,36.20861110490459,0.044650233290255414,17.88763117790222,8.75013256072998,12.174198150634766,358,80,278,278,0,8,151000.0
151,151999,21.275051921254658,36.166924240227445,0.044470353959581654,18.018012523651123,8.807596206665039,12.207706451416016,358,80,278,278,0,8,152000.0
152,152999,21.268578379380475,36.127767091922436,0.04419813971428743,18.14525294303894,8.872788906097412,12.224990844726562,358,80,278,278,0,8,153000.0
153,153999,21.274227672899144,36.089942432492045,0.04385428329132324,18.256191968917847,8.93093204498291,12.238574981689453,358,80,278,278,0,8,154000.0
154,154999,21.272714381712447,36.038593230693714,0.043572009160847136,18.387408018112183,8.98855185508728,12.28927993774414,359,80,279,279,0,8,155000.0
155,155999,21.269156866915708,35.98254854247934,0.043322534390683454,18.493113040924072,9.046139478683472,12.273418426513672,366,81,285,285,0,8,156000.0
156,156999,21.2618555801033,35.93726820291133,0.043076401779086226,18.633522987365723,9.10541033744812,12.222110748291016,375,83,292,292,0,8,157000.0
157,157999,21.249363642060636,35.90121290408542,0.04292350986251159,18.753016233444214,9.163985252380371,12.287029266357422,375,83,292,292,0,8,158000.0
158,158999,21.225401485255926,35.83976544473478,0.042860293098049396,18.864659547805786,9.227871894836426,12.326545715332031,375,83,292,292,0,8,159000.0
159,159999,21.19449372758567,35.7752264580377,0.042950075219521766,18.991729259490967,9.288709878921509,13.03317642211914,444,84,360,360,0,8,160000.0
160,160999,21.149446690065258,35.69922536249798,0.04321354735114458,19.12300992012024,9.361689567565918,13.479434967041016,445,84,361,361,0,8,161000.0
161,161999,21.101513441876033,35.62279220785046,0.0434008396291472,19.27237296104431,9.43470573425293,13.819076538085938,445,84,361,361,0,8,162000.0
162,162999,21.05484028259951,35.549853693826314,0.04362603684751287,19.387043237686157,9.492730140686035,14.095069885253906,445,84,361,361,0,8,163000.0
163,163999,21.018899408244238,35.50285812696423,0.04360621260371256,19.511698007583618,9.551565408706665,14.197250366210938,447,85,362,362,0,8,164000.0
164,164999,20.973964388589437,35.42353068968485,0.04381712976631513,19.624966621398926,9.609408140182495,14.299446105957031,447,85,362,362,0,8,165000.0
165,165999,20.942662934621666,35.36290730748527,0.04409898500172771,19.751248359680176,9.668182849884033,14.355449676513672,447,85,362,362,0,8,166000.0
166,166999,20.91605948899144,35.29724101759972,0.04422395523456102,19.85030770301819,9.726598024368286,14.426910400390625,447,85,362,362,0,8,167000.0
167,167999,20.88558228660405,35.24677093158023,0.044362755091573614,19.974294662475586,9.785987615585327,14.466163635253906,447,85,362,362,0,8,168000.0
168,168999,20.864456802527478,35.19476365207969,0.04451663270064321,20.099536657333374,9.844321012496948,14.514549255371094,447,85,362,362,0,8,169000.0
169,169999,20.861833785072797,35.233082664057406,0.04410226392394112,20.219196796417236,9.902506113052368,14.558795928955078,447,85,362,362,0,8,170000.0
170,170999,20.861686444472,35.2286512397323,0.04403808123899955,20.339080095291138,9.960749387741089,14.589584350585938,447,85,362,362,0,8,171000.0
171,171999,20.864047127281566,35.217946311257684,0.044029545966674855,20.45995831489563,10.019062519073486,14.61452865600586,447,85,362,362,0,8,172000.0
172,172999,20.87056982835916,35.219579193360765,0.04395924858061184,20.594196319580078,10.077925682067871,14.629241943359375,447,85,362,362,0,8,173000.0
173,173999,20.87850408550169,35.209545750842544,0.043906827272994664,20.71288537979126,10.13645052909851,14.632190704345703,453,86,367,367,0,8,174000.0
174,174999,20.891508833741433,35.212070196434226,0.04367395820953668,20.84390950202942,10.194958209991455,14.618850708007812,457,87,370,370,0,8,175000.0
175,175999,20.91114038731971,35.21790669403064,0.04360192920956818,20.955134630203247,10.253150701522827,14.73917007446289,457,87,370,370,0,8,176000.0
176,176999,20.92886169688079,35.22349075583198,0.04353257798899002,21.08414602279663,10.311595916748047,14.813568115234375,457,87,370,370,0,8,177000.0
177,177999,20.93833994700231,35.20897223706038,0.043415942589754786,21.214197635650635,10.37039041519165,14.784111022949219,466,89,377,377,0,8,178000.0
178,178999,20.93062513779228,35.16980559376919,0.0432456481830481,21.325374603271484,10.429087400436401,14.853023529052734,466,89,377,377,0,8,179000.0
179,179999,20.90192849204733,35.13643026744532,0.04341746073317332,21.434829711914062,10.48761773109436,15.080490112304688,475,90,385,385,0,8,180000.0
180,180999,20.862786892816594,35.072059293224875,0.0436557448813536,21.568666696548462,10.548074007034302,15.35305404663086,506,91,415,415,0,8,181000.0
181,181999,20.817046338342703,34.999884047923814,0.04392792884242214,21.677534818649292,10.606433153152466,15.584491729736328,506,91,415,415,0,8,182000.0
182,182999,20.775607477015562,34.936856357531305,0.04415850458074222,21.808479070663452,10.668415307998657,15.76318359375,506,91,415,415,0,8,183000.0
183,183999,20.741332434909573,34.886141212227514,0.04427292096514024,21.946576833724976,10.741879940032959,15.857479095458984,506,91,415,415,0,8,184000.0
184,184999,20.703660938606507,34.81962163954028,0.04450222481782118,22.082168102264404,10.803398132324219,15.891857147216797,506,91,415,415,0,8,185000.0
185,185999,20.671729575808957,34.755934047146305,0.0446399056773793,22.211425304412842,10.864049434661865,15.89712142944336,512,92,420,420,0,8,186000.0
186,186999,20.635326518289002,34.689399440312755,0.04486340886872531,22.324640035629272,10.922879934310913,15.866432189941406,514,93,421,421,0,8,187000.0
187,187999,20.59991143164091,34.627154928709366,0.0450449046028264,22.444769620895386,10.981830596923828,15.945823669433594,514,93,421,421,0,8,188000.0
188,188999,20.570192659432816,34.5752992545061,0.045242907974008206,22.576056480407715,11.042413711547852,15.847171783447266,516,94,422,422,0,8,189000.0
189,189999,20.544332631769382,34.543210062907754,0.04510947662282827,22.688963890075684,11.102914571762085,15.951332092285156,517,94,423,423,0,8,190000.0
190,190999,20.51568685457656,34.482405131540496,0.045123698920790045,22.817853450775146,11.161669492721558,15.88785171508789,519,95,424,424,0,8,191000.0
191,191999,20.492691456757147,34.4488612895993,0.04506332378773481,22.94979166984558,11.220998764038086,15.867855072021484,529,97,432,432,0,8,192000.0
192,192999,20.468323066654843,34.40654127648441,0.04508393656917964,23.059504747390747,11.279561996459961,15.959274291992188,529,97,432,432,0,8,193000.0
193,193999,20.451099521633143,34.36975574938066,0.04506041406659078,23.181429624557495,11.33881688117981,16.027896881103516,529,97,432,432,0,8,194000.0
194,194999,20.433033650256416,34.3325796499474,0.04494720426256682,23.309409141540527,11.397748708724976,16.080059051513672,529,97,432,432,0,8,195000.0
195,195999,20.43252008143286,34.31630684822922,0.044818541036260595,23.439831733703613,11.456715106964111,16.170555114746094,536,98,438,438,0,8,196000.0
196,196999,20.426485842720155,34.28899653849151,0.04465881779959058,23.560462474822998,11.517342567443848,16.250988006591797,536,98,438,438,0,8,197000.0
197,197999,20.42212088972365,34.26709136551202,0.04457300338194703,23.6731538772583,11.575640439987183,16.2939453125,536,98,438,438,0,8,198000.0
198,198999,20.41147946072126,34.23443195325932,0.04453806402579796,23.807578086853027,11.634628534317017,16.327438354492188,536,98,438,438,0,8,199000.0
199,199999,20.404492388228398,34.20328917745733,0.04420904075288268,24.02016282081604,11.694475650787354,16.473690032958984,539,99,440,440,0,8,200000.0
200,200999,20.384808850860196,34.17762314452211,0.044027795973683226,24.13401198387146,11.755338668823242,16.602222442626953,543,100,443,443,0,8,201000.0
201,201999,20.355604328895634,34.13138555313376,0.044120858281090136,24.247751235961914,11.815356492996216,16.730037689208984,544,100,444,444,0,8,202000.0
202,202999,20.33406171036251,34.10833370748543,0.04412146302479203,24.370090007781982,11.874924182891846,16.844314575195312,544,100,444,444,0,8,203000.0
203,203999,20.31057390420025,34.061411938824556,0.04414010886352926,24.48401427268982,11.938489198684692,16.981857299804688,546,100,446,446,0,8,204000.0
204,204999,20.290305226380315,34.02240106653775,0.04432878764495396,24.621107578277588,12.004085063934326,17.062744140625,548,101,447,447,0,8,205000.0
205,205999,20.272525323140982,33.98416322968899,0.0443900401977243,24.749937057495117,12.064001321792603,17.07415771484375,556,102,454,454,0,8,206000.0
206,206999,20.253406952819226,33.94867264645732,0.04458461196305652,24.876172065734863,12.128268003463745,17.08336639404297,567,104,463,463,0,8,207000.0
207,207999,20.244379587609476,33.94004959194183,0.044654339092824014,24.997642755508423,12.195936918258667,17.18950653076172,567,104,463,463,0,8,208000.0
208,208999,20.227106211248724,33.901837712752126,0.04466370826853028,25.136181354522705,12.256412506103516,17.06180191040039,585,108,477,477,0,9,209000.0
209,209999,20.226247049559543,33.88592478974505,0.04502238516559576,25.261885166168213,12.3200204372406,17.271930694580078,586,108,478,478,0,9,210000.0
210,210999,20.228563957628825,33.90809998351888,0.04491511412953453,25.384218215942383,12.380402565002441,17.386219024658203,586,108,478,478,0,9,211000.0
211,211999,20.22671079138039,33.88937844218098,0.04502346974547,25.503989696502686,12.439792156219482,17.425518035888672,588,109,479,479,0,9,212000.0
212,212999,20.227047732759637,33.89666665965835,0.04517661114440785,25.62871527671814,12.499578714370728,17.539913177490234,594,110,484,484,0,9,213000.0
213,213999,20.23069149305323,33.909127156129266,0.04535876022784924,25.748485565185547,12.56220269203186,17.571125030517578,601,112,489,489,0,9,214000.0
214,214999,20.24900250282813,33.94674449872582,0.04574950744998618,25.864586353302002,12.62136173248291,17.700031280517578,602,112,490,490,0,9,215000.0
215,215999,20.269251729085305,33.970494117851004,0.046429889557486836,25.98437786102295,12.681749105453491,17.90457534790039,603,112,491,491,0,9,216000.0
216,216999,20.29944851541111,34.00102720573561,0.046686910427580885,26.112849235534668,12.742851734161377,18.008827209472656,603,112,491,491,0,9,217000.0
217,217999,20.325397280706504,34.023879999737204,0.04697588174445022,26.23091745376587,12.802613973617554,18.038166046142578,613,113,500,500,0,9,218000.0
218,218999,20.35321545297576,34.053457546487444,0.04760671286977303,26.347750186920166,12.861772298812866,17.988628387451172,621,115,506,506,0,9,219000.0
219,219999,20.363626217874092,34.04134777162227,0.04703238545671795,26.471129894256592,12.921682596206665,18.238445281982422,622,115,507,507,0,9,220000.0
220,220999,20.366840424047798,34.04291687621558,0.04567924307473714,26.590734243392944,12.980968952178955,18.39813232421875,623,115,508,508,0,9,221000.0
221,221999,20.352813171342987,34.019093909791486,0.045154475667625316,26.70356798171997,13.040745735168457,18.49127960205078,623,115,508,508,0,9,222000.0
222,222999,20.345439887241636,33.9919891201363,0.04433128211354209,26.831950664520264,13.101720094680786,18.454402923583984,642,118,524,524,0,9,223000.0
223,223999,20.341969108318345,33.98644411875517,0.04385552055256703,26.941056728363037,13.162923336029053,18.580188751220703,642,118,524,524,0,9,224000.0
224,224999,20.340464789353877,33.971245265868525,0.04335674568389347,27.074928998947144,13.223346471786499,18.587932586669922,655,121,534,534,0,9,225000.0
225,225999,20.34256548930511,33.9524963390181,0.04284943556011067,27.20475482940674,13.285176753997803,18.68219757080078,657,122,535,535,0,9,226000.0
226,226999,20.340861688827662,33.94274886713266,0.042867712219712306,27.327664613723755,13.347333669662476,18.727306365966797,665,125,540,540,0,9,227000.0
227,227999,20.342338728139307,33.93393561785587,0.042969763353167933,27.445719718933105,13.409290790557861,18.830699920654297,679,127,552,552,0,9,228000.0
228,228999,20.35371803612757,33.95018041574135,0.043108096576511934,27.567856788635254,13.472205400466919,18.98904800415039,680,127,553,553,0,9,229000.0
229,229999,20.36368499378395,33.96899897354069,0.043143159865738356,27.69121527671814,13.533960580825806,19.101268768310547,684,128,556,556,0,9,230000.0
230,230999,20.386021064799923,34.01137277718625,0.04321525414700578,27.811785459518433,13.594953536987305,19.175621032714844,695,129,566,566,0,9,231000.0
231,231999,20.4077051544619,34.040744537821816,0.043356875683289275,27.93669581413269,13.655941486358643,19.26076889038086,697,130,567,567,0,9,232000.0
232,232999,20.437042256138362,34.106281552597785,0.043475966371339325,28.065741539001465,13.718202352523804,19.301654815673828,708,132,576,576,0,9,233000.0
233,233999,20.47295104981044,34.18998821767624,0.04420018399073333,28.189040660858154,13.779417991638184,19.338863372802734,719,134,585,585,0,9,234000.0
234,234999,20.51485096692106,34.31857587047483,0.04507651138817448,28.320841073989868,13.841415166854858,19.359752655029297,731,136,595,595,0,9,235000.0
235,235999,20.562627744621498,34.46260158464922,0.0454917359776591,28.436915159225464,13.90323781967163,19.588451385498047,733,136,597,597,0,9,236000.0
236,236999,20.6215528738152,34.61853468677318,0.0467032382542536,28.55328369140625,13.963875532150269,19.67917251586914,735,137,598,598,0,9,237000.0
237,237999,20.662844103574947,34.68077484148279,0.04770117641468008,28.671767234802246,14.024677753448486,19.782711029052734,735,137,598,598,0,9,238000.0
238,238999,20.695294528026384,34.72513067620395,0.048934809757053,28.79630184173584,14.087090492248535,19.864696502685547,736,137,599,599,0,9,239000.0
239,239999,20.704327200808176,34.75095774874936,0.04888313203223649,28.91979432106018,14.150822639465332,20.097454071044922,740,137,603,603,0,9,240000.0
240,240999,20.68649683322621,34.74003173369661,0.04893330101264892,29.043763875961304,14.214871168136597,20.257869720458984,745,138,607,607,0,9,241000.0
241,241999,20.669383675599242,34.709191428039496,0.04909652243956031,29.175127029418945,14.275056600570679,20.396015167236328,749,139,610,610,0,9,242000.0
242,242999,20.653291148775942,34.70040150651894,0.04909568222607752,29.285586833953857,14.335146427154541,20.510208129882812,749,139,610,610,0,9,243000.0
243,243999,20.638149348862697,34.67863392671022,0.049135015304166085,29.405343055725098,14.395281791687012,20.754776000976562,751,139,612,612,0,9,244000.0
244,244999,20.62443628711099,34.65191412575917,0.04908682107852591,29.5294246673584,14.45678186416626,20.89508056640625,755,140,615,615,0,9,245000.0
245,245999,20.609497643393084,34.62552178420731,0.0491102242018171,29.66000723838806,14.521024703979492,20.99832534790039,757,141,616,616,0,9,246000.0
246,246999,20.597918841400904,34.61511630750839,0.0490806917078207,29.787757873535156,14.58242654800415,21.055622100830078,761,143,618,618,0,9,247000.0
247,247999,20.589283985094493,34.599058375905415,0.048937042877474135,29.92441201210022,14.644436836242676,21.175399780273438,769,144,625,625,0,9,248000.0
248,248999,20.584113164374834,34.58634932108882,0.048840094236763276,30.058133840560913,14.709235906600952,21.308685302734375,784,146,638,638,0,9,249000.0
249,249999,20.57675238979582,34.56989538413728,0.04873685439687736,30.174535751342773,14.770976781845093,21.433578491210938,784,146,638,638,0,9,250000.0
250,250999,20.570902477137025,34.55583867614469,0.048839338063716875,30.30364680290222,14.833799600601196,21.50554656982422,786,147,639,639,0,9,251000.0
251,251999,20.56471146386523,34.53884913901618,0.04890114453723182,30.422462463378906,14.895335912704468,21.617778778076172,786,147,639,639,0,9,252000.0
252,252999,20.562797272483106,34.52462901855357,0.04893002197086893,30.538907289505005,14.957432746887207,21.730384826660156,786,147,639,639,0,9,253000.0
253,253999,20.559448307041375,34.50809830633612,0.04881496940955932,30.662041902542114,15.018151998519897,21.828895568847656,793,148,645,645,0,9,254000.0
254,254999,20.555053042168225,34.49471030596088,0.04885280444451057,30.775222539901733,15.07867956161499,21.93267059326172,804,149,655,655,0,9,255000.0
255,255999,20.544892808021473,34.468846901112755,0.048717865742326505,30.894728660583496,15.141626834869385,22.15746307373047,810,150,660,660,0,9,256000.0
256,256999,20.540129225899882,34.462105631824585,0.04894625299882904,31.01545023918152,15.203171014785767,22.244380950927734,813,151,662,662,0,9,257000.0
257,257999,20.543116421014908,34.46541993265716,0.04858217829973144,31.137102603912354,15.265412092208862,22.398475646972656,817,152,665,665,0,9,258000.0
258,258999,20.544928990912595,34.46049516785183,0.048308133970021094,31.26477813720703,15.328555822372437,22.622711181640625,820,152,668,668,0,9,259000.0
259,259999,20.548159879987573,34.453666901834836,0.047987795875294004,31.380666971206665,15.39051365852356,22.790088653564453,821,152,669,669,0,9,260000.0
260,260999,20.558875575571815,34.49264925131498,0.04798594871249162,31.507949113845825,15.45255732536316,22.828628540039062,828,155,673,673,0,9,261000.0
261,261999,20.56389784878866,34.51153360770242,0.04808534157553934,31.63354206085205,15.626574277877808,22.90457534790039,832,157,675,675,0,9,262000.0
262,262999,20.57292299128575,34.5279067358196,0.047900551407330516,31.768232822418213,15.689693212509155,23.097335815429688,855,160,695,695,0,9,263000.0
263,263999,20.587551491005417,34.55148200141428,0.04775971101078891,31.886847734451294,15.751828670501709,23.28469467163086,857,160,697,697,0,9,264000.0
264,264999,20.60915731374897,34.58320186439774,0.047880673366689,32.00028872489929,15.813517093658447,23.44366455078125,857,160,697,697,0,9,265000.0
265,265999,20.633378050048492,34.654407904817226,0.0478229513596482,32.14034938812256,15.875063180923462,23.53827667236328,864,161,703,703,0,9,266000.0
266,266999,20.65031464061633,34.6768762038585,0.04808145533174479,32.25709414482117,15.936270952224731,23.64004898071289,864,161,703,703,0,9,267000.0
267,267999,20.669115246515812,34.696680341649284,0.048270445201135104,32.38330435752869,15.998116493225098,23.6397705078125,881,164,717,717,0,9,268000.0
268,268999,20.687305473044766,34.718489315486195,0.04880027603496728,32.497140645980835,16.059129238128662,23.757953643798828,881,164,717,717,0,9,269000.0
269,269999,20.707008266810575,34.73927303491378,0.049229658195174,32.631619930267334,16.124945640563965,23.94570541381836,899,166,733,733,0,9,270000.0
270,270999,20.74609192380421,34.82044400173698,0.049708666637599985,32.75901818275452,16.18632936477661,24.07990264892578,899,166,733,733,0,9,271000.0
271,271999,20.766553719406772,34.83583413236936,0.05006807932510171,32.882174015045166,16.24584722518921,24.072959899902344,905,168,737,737,0,9,272000.0
272,272999,20.783186966063138,34.841435617198485,0.05057321745620613,32.99392533302307,16.307629823684692,24.17385482788086,905,168,737,737,0,9,273000.0
273,273999,20.789652119996727,34.89086579144876,0.05059309043427507,33.13784575462341,16.36597490310669,24.280216217041016,929,170,759,759,0,9,274000.0
274,274999,20.799926035716737,34.94460083052713,0.050779822401791685,33.25626087188721,16.430441856384277,24.458221435546875,932,170,762,762,0,9,275000.0
275,275999,20.80613702189614,35.01791137685065,0.05065920504490007,33.379775285720825,16.49364447593689,24.57398223876953,933,170,763,763,0,9,276000.0
276,276999,20.815310956633162,35.04050054461673,0.05074782022347324,33.50556397438049,16.553481578826904,24.610916137695312,949,171,778,778,0,9,277000.0
277,277999,20.827388807227305,35.06772305959408,0.05073292961183051,33.61596155166626,16.61414623260498,24.7972412109375,951,171,780,780,0,9,278000.0
278,278999,20.847508490425394,35.11619721688011,0.050809167676574396,33.75146293640137,16.67710518836975,24.851303100585938,953,172,781,781,0,9,279000.0
279,279999,20.865014897536717,35.147390470769274,0.05099594886487102,33.88845133781433,16.738184928894043,24.83096694946289,963,175,788,788,0,9,280000.0
280,280999,20.887117849540733,35.18171002087533,0.051537644160962404,34.02230477333069,16.799621105194092,24.957462310791016,966,176,790,790,0,9,281000.0
281,281999,20.916364566605132,35.26081612381664,0.05188552718436901,34.13596749305725,16.860921382904053,25.11901092529297,968,176,792,792,0,9,282000.0
282,282999,20.9504430606158,35.342472419568665,0.05233754200028762,34.28242039680481,16.922502756118774,25.039825439453125,993,179,814,814,0,9,283000.0
283,283999,20.990142439185178,35.41810186406584,0.05334072381487309,34.41160011291504,16.98243761062622,25.28595733642578,996,179,817,817,0,9,284000.0
284,284999,21.03056095229385,35.49947629198676,0.054133708244859635,34.534687995910645,17.04218888282776,25.176101684570312,1009,181,828,828,0,9,285000.0
285,285999,21.067512071960923,35.54756613638258,0.055271941830472016,34.671464920043945,17.104228019714355,25.141498565673828,1017,183,834,834,0,9,286000.0
286,286999,21.11410790802096,35.6272536942116,0.05756090278539239,34.79547476768494,17.167120218276978,25.248184204101562,1023,186,837,837,0,9,287000.0
287,287999,21.15438370747631,35.683125164054495,0.05939588966116971,34.909889698028564,17.227800369262695,25.405994415283203,1023,186,837,837,0,9,288000.0
288,288999,21.203371420139902,35.78803240205564,0.061364687920871686,35.03122520446777,17.289161205291748,25.58374786376953,1037,187,850,850,0,9,289000.0
289,289999,21.262331911689643,35.89862283254382,0.06333634543191446,35.1528537273407,17.350828647613525,25.641117095947266,1044,189,855,855,0,9,290000.0
290,290999,21.316698084869003,35.99134942716409,0.06563047489024676,35.295294761657715,17.41253924369812,25.486614227294922,1064,194,870,870,0,9,291000.0
291,291999,21.364277445296313,36.05474098015345,0.06833520168029306,35.42639660835266,17.47284722328186,25.6435546875,1074,196,878,878,0,9,292000.0
292,292999,21.39276725622907,36.106428010002475,0.06879421555648424,35.53331542015076,17.53291416168213,25.923011779785156,1077,196,881,881,0,9,293000.0
293,293999,21.38921930800064,36.135939677232905,0.06830504182911779,35.65917611122131,17.594625234603882,26.08348846435547,1093,197,896,896,0,9,294000.0
294,294999,21.37788243917169,36.13480039302673,0.06822420614624092,35.782286643981934,17.655278205871582,26.21540069580078,1094,197,897,897,0,9,295000.0
295,295999,21.37070312962884,36.131545108545765,0.0679896139092151,35.89752531051636,17.71861433982849,26.35269546508789,1095,197,898,898,0,9,296000.0
296,296999,21.367771177151898,36.127159475136644,0.0677235285271599,36.01532483100891,17.781734704971313,26.46752166748047,1097,197,900,900,0,9,297000.0
297,297999,21.36513047240666,36.11810393753633,0.06754032904080187,36.146201372146606,17.842190504074097,26.664722442626953,1126,200,926,926,0,9,298000.0
298,298999,21.36133406416708,36.11114556560249,0.06750095079588136,36.26849389076233,17.904346704483032,26.85358428955078,1129,201,928,928,0,9,299000.0
299,299999,21.358093123193058,36.099728260515754,0.06731295153039663,36.39321279525757,17.964736223220825,27.015838623046875,1131,202,929,929,0,9,300000.0
300,300999,21.35188450355029,36.07965186263437,0.06723757822557619,36.50284934043884,18.024738550186157,27.150711059570312,1132,202,930,930,0,9,301000.0
301,301999,21.34596863239687,36.067386572142105,0.06722909210808137,36.634573459625244,18.085541248321533,27.269989013671875,1139,203,936,936,0,9,302000.0
302,302999,21.342210713394987,36.051652808306045,0.0671253837290482,36.74104952812195,18.147792100906372,27.571144104003906,1144,203,941,941,0,9,303000.0
303,303999,21.334424870858598,36.031590375867296,0.0671140437398896,36.857257604599,18.207878828048706,27.74132537841797,1157,204,953,953,0,9,304000.0
304,304999,21.333438254246303,36.02408353985175,0.06707268460318028,36.98335003852844,18.268493175506592,27.875350952148438,1157,204,953,953,0,9,305000.0
305,305999,21.32923341822035,36.013633617013774,0.06705732716283552,37.10202598571777,18.329233169555664,27.96280288696289,1159,205,954,954,0,9,306000.0
306,306999,21.327168412576345,35.99979832672235,0.06713226880320844,37.22954440116882,18.390865087509155,27.913448333740234,1163,207,956,956,0,9,307000.0
307,307999,21.328450533508043,35.99187108886003,0.06747202910441674,37.33991980552673,18.451540231704712,28.068195343017578,1176,208,968,968,0,9,308000.0
308,308999,21.341429626468155,36.016349162327266,0.06815986490583992,37.45629167556763,18.5124614238739,28.31976318359375,1179,208,971,971,0,9,309000.0
309,309999,21.352691514952195,36.057683572430996,0.06914920036131045,37.573174476623535,18.57254981994629,28.442352294921875,1179,208,971,971,0,9,310000.0
310,310999,21.355605523344103,36.067280353336876,0.06961437222051581,37.71166729927063,18.6331729888916,28.47158432006836,1191,211,980,980,0,9,311000.0
311,311999,21.355708548213048,36.08239266425857,0.07024205522676585,37.82420516014099,18.69435429573059,28.647335052490234,1197,212,985,985,0,9,312000.0
312,312999,21.344972553955557,36.11602498607054,0.07023373248542819,38.08975315093994,18.7565279006958,29.137920379638672,1254,214,1040,1040,0,9,313000.0
313,313999,21.333179173350615,36.11695222657677,0.07035379209831516,38.20565366744995,18.81778311729431,29.524383544921875,1256,214,1042,1042,0,9,314000.0
314,314999,21.33295672681034,36.13286038709555,0.07147381807682063,38.33610415458679,18.878358840942383,29.82525634765625,1267,215,1052,1052,0,9,315000.0
315,315999,21.326993208273095,36.14531137072501,0.07213171602640489,38.44817280769348,18.939882516860962,30.042224884033203,1269,215,1054,1054,0,9,316000.0
316,316999,21.32773713522148,36.155432560595706,0.07275647639437588,38.57333517074585,19.002512216567993,30.282188415527344,1274,216,1058,1058,0,9,317000.0
317,317999,21.324955080231575,36.1578689535129,0.07337033000271265,38.72069525718689,19.064454793930054,30.38994598388672,1289,218,1071,1071,0,9,318000.0
318,318999,21.324583829723256,36.16603839549121,0.074119160118992,38.84938955307007,19.1283540725708,30.50461196899414,1307,220,1087,1087,0,9,319000.0
319,319999,21.32557533940644,36.17375144430226,0.07475014363385046,38.96157264709473,19.19159960746765,30.636966705322266,1309,221,1088,1088,0,9,320000.0
320,320999,21.325807178291498,36.17733339716291,0.07491101590052218,39.1009156703949,19.25175428390503,30.694183349609375,1319,224,1095,1095,0,9,321000.0
321,321999,21.323665328245145,36.16727304060296,0.07497658745747948,39.210487365722656,19.31304168701172,30.993854522705078,1324,224,1100,1100,0,9,322000.0
322,322999,21.3263193046166,36.164064827761756,0.07512249127944937,39.32894778251648,19.37368369102478,31.160831451416016,1324,224,1100,1100,0,9,323000.0
323,323999,21.327915652670892,36.19722985268781,0.07525111837924758,39.46221590042114,19.437533855438232,31.236141204833984,1329,226,1103,1103,0,9,324000.0
324,324999,21.32685086667169,36.18746076041425,0.07536421270397098,39.58729839324951,19.49821901321411,31.38257598876953,1329,226,1103,1103,0,9,325000.0
325,325999,21.32396057769566,36.175604575818355,0.0753969699113266,39.712552309036255,19.562877893447876,31.404659271240234,1345,228,1117,1117,0,9,326000.0
326,326999,21.32728523435844,36.177904464246836,0.07550139485127283,39.84403324127197,19.62520170211792,31.536605834960938,1345,228,1117,1117,0,9,327000.0
327,327999,21.32839428792522,36.172416413836366,0.07564593942729836,39.97740960121155,19.68912959098816,31.560344696044922,1380,231,1149,1149,0,9,328000.0
328,328999,21.3271535296003,36.16794612062433,0.07560480386710988,40.089027881622314,19.748680353164673,31.659137725830078,1380,231,1149,1149,0,9,329000.0
329,329999,21.318770646492666,36.14973480083378,0.07570500847724804,40.23089098930359,19.811830520629883,31.631511688232422,1384,233,1151,1151,0,9,330000.0
330,330999,21.308227144566285,36.12520341146604,0.07583472503230915,40.36722803115845,19.872584581375122,31.684783935546875,1406,235,1171,1171,0,9,331000.0
331,331999,21.30608699170052,36.137269733751744,0.0755165725168635,40.49237561225891,19.935567617416382,32.20937728881836,1423,236,1187,1187,0,9,332000.0
332,332999,21.289868610496725,36.1141982387188,0.07547329382275958,40.61621594429016,19.997055292129517,32.42136001586914,1424,236,1188,1188,0,9,333000.0
333,333999,21.274915157281743,36.09105270485892,0.07562653648356898,40.72730374336243,20.058398723602295,32.60597610473633,1427,236,1191,1191,0,9,334000.0
334,334999,21.263106128765788,36.079010232328095,0.0757906636476845,40.84444975852966,20.12223529815674,32.755035400390625,1428,236,1192,1192,0,9,335000.0
335,335999,21.25369778242246,36.06495301040834,0.07581326460391924,40.96926784515381,20.184060096740723,32.99374008178711,1433,237,1196,1196,0,9,336000.0
336,336999,21.249677238132755,36.073975514822955,0.07567842192103336,41.09757041931152,20.248320817947388,33.10205078125,1438,239,1199,1199,0,9,337000.0
337,337999,21.241541352557753,36.05831265737792,0.07575896486440292,41.225112199783325,20.31377935409546,33.219661712646484,1443,241,1202,1202,0,9,338000.0
338,338999,21.23844061963189,36.05327705479755,0.07583270740279857,41.34990310668945,20.375641345977783,33.33097839355469,1445,242,1203,1203,0,9,339000.0
339,339999,21.2337634360976,36.04086751034725,0.07601016127019844,41.466121196746826,20.43661403656006,33.54375076293945,1448,242,1206,1206,0,9,340000.0
340,340999,21.2367444155103,36.04114166852506,0.07618097763901555,41.595104694366455,20.501710891723633,33.67178726196289,1449,242,1207,1207,0,9,341000.0
341,341999,21.245280958011932,36.049534353468026,0.07634646904989106,41.72017741203308,20.562681198120117,33.873531341552734,1480,245,1235,1235,0,9,342000.0
342,342999,21.26814988846159,36.087136578915946,0.07669884104109581,41.83732986450195,20.622549057006836,34.027198791503906,1480,245,1235,1235,0,9,343000.0
343,343999,21.286827619412332,36.11242310926773,0.07701983239974808,41.975566387176514,20.686450481414795,34.08738708496094,1488,247,1241,1241,0,9,344000.0
344,344999,21.312724963298653,36.15016449127759,0.0776919842164363,42.105045557022095,20.747121572494507,34.155357360839844,1493,249,1244,1244,0,9,345000.0
345,345999,21.339036820900876,36.18956361411538,0.07843777627137838,42.219088315963745,20.807182550430298,34.193397521972656,1495,250,1245,1245,0,9,346000.0
346,346999,21.36757140010866,36.22594987883495,0.07916736223890508,42.336551666259766,20.87222409248352,34.27703094482422,1497,251,1246,1246,0,9,347000.0
347,347999,21.413481680918988,36.29372644769604,0.08040980111060081,42.45474433898926,20.933125257492065,34.49245071411133,1500,251,1249,1249,0,9,348000.0
348,348999,21.444900407570735,36.328799470632056,0.08106594562587155,42.56957149505615,20.994617223739624,34.58472442626953,1500,251,1249,1249,0,9,349000.0
349,349999,21.480339076531816,36.370051188033244,0.0819252336927142,42.705294609069824,21.05598211288452,34.539093017578125,1504,253,1251,1251,0,9,350000.0
350,350999,21.503730652569054,36.39547431561344,0.08235594531308155,42.824055910110474,21.117141246795654,34.669864654541016,1504,253,1251,1251,0,9,351000.0
351,351999,21.497802816794575,36.38553487055748,0.08219459268190454,42.94407248497009,21.18022584915161,35.10118103027344,1522,254,1268,1268,0,9,352000.0
352,352999,21.488798048422908,36.36993005824325,0.08199516804505946,43.06420087814331,21.241339445114136,35.24229049682617,1526,255,1271,1271,0,9,353000.0
353,353999,21.479149573891245,36.352041575716385,0.08176543203183928,43.2089958190918,21.30372190475464,35.3720703125,1539,258,1281,1281,0,9,354000.0
354,354999,21.468769094051087,36.32855474964822,0.08163384565874077,43.32602882385254,21.365288734436035,35.518959045410156,1547,259,1288,1288,0,9,355000.0
355,355999,21.467929584610985,36.32239092751527,0.08138443886046043,43.45709562301636,21.428191900253296,35.67420196533203,1568,262,1306,1306,0,9,356000.0
356,356999,21.470716648527876,36.31545537525604,0.08123932009950074,43.57606792449951,21.490204572677612,35.88938903808594,1585,264,1321,1321,0,9,357000.0
357,357999,21.47011925593857,36.300987836944984,0.08130002464239905,43.695595264434814,21.55168604850769,36.04702377319336,1588,265,1323,1323,0,9,358000.0
358,358999,21.466493288247136,36.284551439834914,0.08133154730741832,43.815452337265015,21.613888025283813,36.1229133605957,1592,267,1325,1325,0,9,359000.0
359,359999,21.465842298053914,36.27244367837432,0.08131348654423942,43.949463844299316,21.67788076400757,36.18311309814453,1604,270,1334,1334,0,9,360000.0
360,360999,21.466288790306997,36.264219257670874,0.08140066006890068,44.07189083099365,21.74092674255371,36.337974548339844,1605,270,1335,1335,0,9,361000.0
361,361999,21.46889225121337,36.25677635675311,0.08151724965194962,44.19900989532471,21.803947687149048,36.664432525634766,1614,271,1343,1343,0,10,362000.0
362,362999,21.469620449691394,36.24458092147541,0.08160044026790025,44.31494736671448,21.866823196411133,36.79294967651367,1630,272,1358,1358,0,10,363000.0
363,363999,21.47180752502378,36.23486909397613,0.08165179775815112,44.43623328208923,22.091718196868896,36.90372085571289,1633,273,1360,1360,0,10,364000.0
364,364999,21.474037475942165,36.22550294087932,0.08156726030374684,44.56413197517395,22.153908729553223,37.01988220214844,1651,275,1376,1376,0,10,365000.0
365,365999,21.478752201592904,36.21813639063344,0.08156197119594044,44.68687844276428,22.21593141555786,37.141807556152344,1651,275,1376,1376,0,10,366000.0
366,366999,21.486578003748864,36.21654348239512,0.08157145581752634,44.82091474533081,22.281277656555176,37.15016555786133,1657,277,1380,1380,0,10,367000.0
367,367999,21.49645042217359,36.21587621954195,0.08149525543099823,44.95756506919861,22.34201169013977,37.29352569580078,1670,280,1390,1390,0,10,368000.0
368,368999,21.505453841827542,36.211977745601295,0.08135936958885592,45.070812463760376,22.40331721305847,37.39689636230469,1674,281,1393,1393,0,10,369000.0
369,369999,21.514601564852345,36.2059084910429,0.08116690220482847,45.207964181900024,22.466514587402344,37.502052307128906,1682,282,1400,1400,0,10,370000.0
370,370999,21.524637404845635,36.200601076559494,0.08103227740550512,45.32951378822327,22.529109477996826,37.60566329956055,1684,283,1401,1401,0,10,371000.0
371,371999,21.52083870969105,36.19005335123082,0.08085668963973136,45.45293402671814,22.59301733970642,38.00557327270508,1693,283,1410,1410,0,10,372000.0
372,372999,21.50795330394822,36.18935083634096,0.08086309537989178,45.57017230987549,22.654436349868774,38.27749252319336,1697,283,1414,1414,0,10,373000.0
373,373999,21.489417920098877,36.16333309211794,0.08099432699724995,45.693923473358154,22.71705460548401,38.48029708862305,1712,285,1427,1427,0,10,374000.0
374,374999,21.469307376418687,36.13132179290341,0.0811035485504299,45.81776809692383,22.779619455337524,38.630821228027344,1712,285,1427,1427,0,10,375000.0
375,375999,21.45207713282342,36.10570392818354,0.08113127382854335,45.93748736381531,22.841994047164917,38.85920715332031,1718,286,1432,1432,0,10,376000.0
376,376999,21.43652071365542,36.09155082102633,0.08112650368566321,46.06845498085022,22.904333353042603,39.00899124145508,1721,287,1434,1434,0,10,377000.0
377,377999,21.42019398285575,36.07543577443714,0.081155647444078,46.203993797302246,22.96864080429077,39.06602478027344,1725,289,1436,1436,0,10,378000.0
378,378999,21.401571090644698,36.044107739559955,0.08124824159678001,46.32351279258728,23.03417658805847,39.19750213623047,1729,290,1439,1439,0,10,379000.0
379,379999,21.386234253175527,36.017851298961794,0.08127663114607342,46.44644355773926,23.09636664390564,39.367774963378906,1731,290,1441,1441,0,10,380000.0
380,380999,21.377387187725898,36.008405078271366,0.08120194602306041,46.55961608886719,23.158514261245728,39.649513244628906,1739,290,1449,1449,0,10,381000.0
381,381999,21.363358789769986,35.98565370157507,0.08121741468845656,46.6972873210907,23.22024631500244,39.785030364990234,1739,290,1449,1449,0,10,382000.0
382,382999,21.353228670392106,35.98847028043497,0.08120805018611321,46.81148147583008,23.284022092819214,39.911224365234375,1740,290,1450,1450,0,10,383000.0
383,383999,21.342069000959455,35.96595922095043,0.08129074255082303,46.9318482875824,23.34635853767395,39.9639892578125,1742,291,1451,1451,0,10,384000.0
384,384999,21.331818271454637,35.94200415990551,0.08138335013802822,47.07043147087097,23.409077882766724,40.001304626464844,1749,293,1456,1456,0,10,385000.0
385,385999,21.320317477045805,35.91655230209477,0.08140188572184337,47.19375801086426,23.47106695175171,40.19463348388672,1752,293,1459,1459,0,10,386000.0
386,386999,21.30704785028954,35.89233709976534,0.08149199355229175,47.30850577354431,23.532692432403564,40.30613708496094,1752,293,1459,1459,0,10,387000.0
387,387999,21.291498312951788,35.86536493953408,0.0815796693070776,47.433434009552,23.593883514404297,40.304439544677734,1761,294,1467,1467,0,10,388000.0
388,388999,21.29207683788283,35.90304705083005,0.08122489196375371,47.55669283866882,23.655431747436523,40.77043151855469,1776,295,1481,1481,0,10,389000.0
389,389999,21.289808110494814,35.89988523576309,0.08164596361826404,47.679855823516846,23.717747688293457,40.97596740722656,1781,296,1485,1485,0,10,390000.0
390,390999,21.287301399613046,35.89127007527471,0.08173757057455766,47.806639671325684,23.779476165771484,41.1190185546875,1799,298,1501,1501,0,10,391000.0
391,391999,21.293769880495066,35.89984284245881,0.0820203436465402,47.92467141151428,23.84064483642578,41.3807487487793,1808,299,1509,1509,0,10,392000.0
392,392999,21.306085266285077,35.929277740184446,0.08230994054327367,48.0450701713562,23.902315378189087,41.5745735168457,1810,300,1510,1510,0,10,393000.0
393,393999,21.32126479040811,35.9604301791591,0.08382805059557352,48.179282426834106,23.967214107513428,41.744022369384766,1827,302,1525,1525,0,10,394000.0
394,394999,21.34566880585301,36.013184946601385,0.08470044931121024,48.321436643600464,24.029757261276245,41.77423095703125,1835,306,1529,1529,0,10,395000.0
395,395999,21.36541014182257,36.05870831521751,0.08566466767518144,48.445135831832886,24.094730615615845,42.0460205078125,1853,307,1546,1546,0,10,396000.0
396,396999,21.38951273209714,36.10782860171888,0.08688690696489243,48.570916175842285,24.15633273124695,42.14943313598633,1872,309,1563,1563,0,10,397000.0
397,397999,21.42646757516204,36.18892782357271,0.08810978851383766,48.69120717048645,24.218570947647095,42.45785140991211,1881,310,1571,1571,0,10,398000.0
398,398999,21.455308524521016,36.239611202682006,0.08949275156920278,48.8107647895813,24.282029390335083,42.579673767089844,1884,311,1573,1573,0,10,399000.0
399,399999,21.49174514677162,36.33352803830288,0.09035790004330713,48.94550609588623,24.344087600708008,42.664154052734375,1889,313,1576,1576,0,10,400000.0
400,400999,21.52678909672584,36.39296526016881,0.09152459487959197,49.06683373451233,24.4058837890625,42.775482177734375,1894,315,1579,1579,0,10,401000.0
401,401999,21.563261652319134,36.454203508939706,0.09285383873461861,49.18529653549194,24.467879056930542,42.91281509399414,1896,316,1580,1580,0,10,402000.0
402,402999,21.603617220847866,36.54483642358316,0.09375363125854408,49.317766427993774,24.52883529663086,43.08317947387695,1906,317,1589,1589,0,10,403000.0
403,403999,21.64756217513502,36.617276745394456,0.09485170828374734,49.42836785316467,24.58916926383972,43.26880645751953,1906,317,1589,1589,0,10,404000.0
404,404999,21.690035799863708,36.69672240126467,0.09594581344471886,49.55127835273743,24.649572134017944,43.3043327331543,1912,319,1593,1593,0,10,405000.0
405,405999,21.723305274218895,36.73539333042811,0.09687855784758836,49.67842364311218,24.710431337356567,43.36164093017578,1916,321,1595,1595,0,10,406000.0
406,406999,21.73665366359302,36.74925733377937,0.09737008015297677,49.78643465042114,24.77072525024414,43.9228401184082,1934,321,1613,1613,0,10,407000.0
407,407999,21.731771512182675,36.760773714682124,0.09715158105275223,49.89153027534485,24.829714059829712,44.25339889526367,1941,322,1619,1619,0,10,408000.0
408,408999,21.730904981810113,36.79005032464417,0.09689536306302426,50.00331139564514,24.889556646347046,44.573211669921875,1952,323,1629,1629,0,10,409000.0
409,409999,21.72842594616846,36.79762838293602,0.0966759062464404,50.13834857940674,24.954309940338135,44.800662994384766,1968,326,1642,1642,0,10,410000.0
410,410999,21.72753631155403,36.80491826675879,0.09644231909322698,50.249051570892334,25.014812469482422,45.03425216674805,1971,327,1644,1644,0,10,411000.0
411,411999,21.72670200706369,36.80435210188074,0.09624025993792973,50.38003158569336,25.0769145488739,45.35452651977539,1986,330,1656,1656,0,10,412000.0
412,412999,21.72673925130532,36.79870221875035,0.09610756384626362,50.48114371299744,25.136146545410156,45.619873046875,1987,330,1657,1657,0,10,413000.0
413,413999,21.72343931481725,36.78607427548327,0.09610091915858632,50.614968061447144,25.198777437210083,45.79286575317383,1998,333,1665,1665,0,10,414000.0
414,414999,21.723077091980223,36.7741515054592,0.09603034412191036,50.73406410217285,25.262819528579712,46.04563903808594,2000,333,1667,1667,0,10,415000.0
415,415999,21.72181700110965,36.76458619231746,0.09605019950704374,50.85697150230408,25.325505018234253,46.25416946411133,2003,333,1670,1670,0,10,416000.0
416,416999,21.719691885877104,36.758995271072315,0.09594360262890111,50.97393441200256,25.388481855392456,46.48041534423828,2009,333,1676,1676,0,10,417000.0
417,417999,21.719276488585983,36.74767252193477,0.09582141019367862,51.30209136009216,25.453558206558228,46.66201400756836,2023,336,1687,1687,0,10,418000.0
418,418999,21.717700851196216,36.733067444411226,0.09572516600465775,51.418503761291504,25.515044927597046,46.73454666137695,2028,337,1691,1691,0,10,419000.0
419,419999,21.718082405560093,36.72443359531907,0.09570596071805948,51.54806327819824,25.57955312728882,46.925724029541016,2033,339,1694,1694,0,10,420000.0
420,420999,21.71747820922048,36.75392188441381,0.0955067537354618,51.67153000831604,25.64271831512451,47.06825256347656,2035,340,1695,1695,0,10,421000.0
421,421999,21.719565622405778,36.77121619798373,0.0953538822153771,51.799909353256226,25.708133220672607,47.21129608154297,2038,341,1697,1697,0,10,422000.0
422,422999,21.721239643716157,36.76403853612671,0.0952904798341786,51.92202138900757,25.774303674697876,47.40117263793945,2044,342,1702,1702,0,10,423000.0
423,423999,21.71654556360914,36.74602970897492,0.09528565461295224,52.04537796974182,25.838804244995117,47.562843322753906,2046,343,1703,1703,0,10,424000.0
424,424999,21.714080657877627,36.73239665091325,0.09525909890216877,52.18255591392517,25.901512622833252,47.631526947021484,2053,346,1707,1707,0,10,425000.0
425,425999,21.711121998198326,36.71750556195824,0.09525178239588838,52.30342698097229,25.96618938446045,47.8004264831543,2053,346,1707,1707,0,10,426000.0
426,426999,21.700943044310726,36.69252219918962,0.09523895097611423,52.42566680908203,26.028311252593994,47.878536224365234,2057,347,1710,1710,0,10,427000.0
427,427999,21.684666732919982,36.66895759565928,0.09527006679866212,52.55814719200134,26.09273338317871,48.41089630126953,2078,348,1730,1730,0,10,428000.0
428,428999,21.664592112756687,36.64108289275467,0.09534815930212381,52.67085528373718,26.153676509857178,48.66557312011719,2079,348,1731,1731,0,10,429000.0
429,429999,21.648116120975786,36.61977997243626,0.09536456576508145,52.7977979183197,26.218989610671997,48.884613037109375,2087,349,1738,1738,0,10,430000.0
430,430999,21.62849685908149,36.59179962117416,0.09545180786800256,52.908573627471924,26.27995991706848,49.03425216674805,2088,349,1739,1739,0,10,431000.0
431,431999,21.612476406581205,36.56449767083088,0.09547231974131776,53.02234959602356,26.341092109680176,49.346580505371094,2112,350,1762,1762,0,10,432000.0
432,432999,21.59792454648173,36.546594151622635,0.09544359277021697,53.142693281173706,26.402348518371582,49.47681427001953,2114,351,1763,1763,0,10,433000.0
433,433999,21.57833346470139,36.5170355203992,0.09553295386595251,53.28783392906189,26.465462684631348,49.57353210449219,2121,354,1767,1767,0,10,434000.0
434,434999,21.561764803197594,36.48976180328691,0.0956051615872352,53.40127348899841,26.527087926864624,49.71527862548828,2121,354,1767,1767,0,10,435000.0
435,435999,21.5445107991847,36.46189851862219,0.0956901647247056,53.51465678215027,26.588934659957886,49.87461853027344,2125,354,1771,1771,0,10,436000.0
436,436999,21.528287867545856,36.43542889630868,0.0957662485513292,53.62938690185547,26.6531765460968,50.02156448364258,2128,354,1774,1774,0,10,437000.0
437,437999,21.514292042008965,36.41188690510122,0.0957474202427474,53.77685523033142,26.715736865997314,50.15943145751953,2139,356,1783,1783,0,10,438000.0
438,438999,21.501278277035407,36.38967259215149,0.09577805935203798,53.88783025741577,26.778271436691284,50.34495544433594,2139,356,1783,1783,0,10,439000.0
439,439999,21.487688158288865,36.36384499590282,0.09582931253295557,54.01006460189819,26.839671850204468,50.45742416381836,2142,357,1785,1785,0,10,440000.0
440,440999,21.473306306498614,36.33649930414692,0.09589410146105026,54.139490604400635,26.90216565132141,50.56194305419922,2144,358,1786,1786,0,10,441000.0
441,441999,21.458323391633204,36.30748419859623,0.09596006225991094,54.26861763000488,26.966093063354492,50.6231575012207,2146,359,1787,1787,0,10,442000.0
442,442999,21.448159673897052,36.2854223718726,0.095934951539971,54.39692664146423,27.03007411956787,50.78962326049805,2151,360,1791,1791,0,10,443000.0
443,443999,21.43915152762129,36.26186982844967,0.09580140536770365,54.516639709472656,27.0927095413208,50.93806838989258,2153,361,1792,1792,0,10,444000.0
444,444999,21.428202536996302,36.237190011694054,0.09575598392358209,54.635095834732056,27.153844833374023,51.07606887817383,2153,361,1792,1792,0,10,445000.0
445,445999,21.41859663651066,36.21539380493562,0.09573651051217436,54.75511980056763,27.215808153152466,51.1339225769043,2155,362,1793,1793,0,10,446000.0
446,446999,21.403564056272756,36.188494219403594,0.09582477646405385,54.866016149520874,27.27757215499878,51.4636116027832,2165,362,1803,1803,0,10,447000.0
447,447999,21.38533255632108,36.1745487253312,0.09584904623588764,54.989365339279175,27.34317111968994,51.916378021240234,2180,363,1817,1817,0,10,448000.0
448,448999,21.3641223116157,36.14419257419876,0.09601443304776891,55.10331177711487,27.406042337417603,52.08755874633789,2185,364,1821,1821,0,10,449000.0
449,449999,21.344720589353276,36.1250341478483,0.09609068474066906,55.228429317474365,27.468047618865967,52.31816864013672,2195,366,1829,1829,0,10,450000.0
450,450999,21.32609014645978,36.100622555214244,0.09621334261790748,55.33975529670715,27.5282781124115,52.51100540161133,2196,366,1830,1830,0,10,451000.0
451,451999,21.309559516584702,36.07396816011643,0.09631518586233367,55.48053574562073,27.592069625854492,52.8072509765625,2203,367,1836,1836,0,10,452000.0
452,452999,21.29079432045913,36.05102476583724,0.09640947138925227,55.58767557144165,27.65191125869751,53.01222610473633,2203,367,1836,1836,0,10,453000.0
453,453999,21.271551322036064,36.0247170652972,0.09652488950713967,55.724849224090576,27.716461420059204,53.06431579589844,2210,370,1840,1840,0,10,454000.0
454,454999,21.2540364250849,35.99937359745754,0.09665519087651953,55.84486126899719,27.777778387069702,53.214698791503906,2236,372,1864,1864,0,10,455000.0
455,455999,21.234339355739458,35.973657842862835,0.09681562512636044,55.99137568473816,27.842634439468384,53.43107986450195,2247,373,1874,1874,0,10,456000.0
456,456999,21.213876674390434,35.94712408381659,0.0969497876861779,56.10172748565674,27.90531301498413,53.612586975097656,2248,373,1875,1875,0,10,457000.0
457,457999,21.198149891362885,35.93188176891557,0.09696457082607979,56.22336721420288,27.967570781707764,54.01710891723633,2257,374,1883,1883,0,10,458000.0
458,458999,21.179850994598258,35.90222427327326,0.09708245537715798,56.34677529335022,28.029895305633545,54.14356231689453,2260,375,1885,1885,0,10,459000.0
459,459999,21.163205084903456,35.88067337252376,0.0971204141234907,56.482715129852295,28.09926199913025,54.170433044433594,2264,376,1888,1888,0,10,460000.0
460,460999,21.147091284451452,35.855855099144556,0.09719555402923796,56.61617302894592,28.16081428527832,54.27106475830078,2268,378,1890,1890,0,10,461000.0
461,461999,21.131340818124468,35.82957415509589,0.09727253105602962,56.73261880874634,28.22423028945923,54.44828414916992,2268,378,1890,1890,0,10,462000.0
462,462999,21.117659992949328,35.804805348013076,0.09731293472642999,56.86328625679016,28.28951930999756,54.60432434082031,2273,379,1894,1894,0,10,463000.0
463,463999,21.10668279330689,35.78352374475463,0.09733670357907231,56.997875928878784,28.353455781936646,54.67095947265625,2278,381,1897,1897,0,10,464000.0
464,464999,21.094902477048112,35.76048837421622,0.09736279127667857,57.11695671081543,28.414098262786865,54.82997131347656,2281,382,1899,1899,0,10,465000.0
465,465999,21.085249769695956,35.74114975477133,0.09737515093097404,57.23343467712402,28.473865509033203,54.95494842529297,2281,382,1899,1899,0,10,466000.0
466,466999,21.068533570686476,35.7131289187098,0.09747828278104487,57.346105337142944,28.533303260803223,55.073421478271484,2305,383,1922,1922,0,10,467000.0
467,467999,21.05467836663724,35.68992709853548,0.09738520073276835,57.48665738105774,28.595129013061523,55.53756332397461,2358,387,1971,1971,0,10,468000.0
468,468999,21.039724498134554,35.679494682277685,0.0973475323132964,57.60238027572632,28.656126976013184,55.81928253173828,2360,387,1973,1973,0,10,469000.0
469,469999,21.02718784406872,35.658724370346796,0.09731828720865987,57.710715532302856,28.71622133255005,56.06068420410156,2365,387,1978,1978,0,10,470000.0
470,470999,21.015302706074266,35.636466432253656,0.09732690126818588,57.8179190158844,28.776129484176636,56.22590637207031,2367,387,1980,1980,0,10,471000.0
471,471999,21.00844442941833,35.63190356922591,0.09717953720400918,57.9347083568573,28.838324308395386,56.50659942626953,2372,387,1985,1985,0,10,472000.0
472,472999,20.99886844311138,35.61310058688048,0.09710945310591501,58.07419037818909,28.903257846832275,56.559444427490234,2381,390,1991,1991,0,10,473000.0
473,473999,20.98749883499064,35.597311064548684,0.09708460331358326,58.20449709892273,28.96548891067505,56.68146896362305,2386,392,1994,1994,0,10,474000.0
474,474999,20.980440526374107,35.60271177471527,0.09689198480972383,58.31996417045593,29.02779459953308,56.826011657714844,2388,393,1995,1995,0,10,475000.0
475,475999,20.973939309195064,35.594341592939024,0.09674074080646766,58.45791721343994,29.0904278755188,56.973876953125,2398,395,2003,2003,0,10,476000.0
476,476999,20.96731371253109,35.587212575656764,0.09660345978928064,58.5792019367218,29.151005744934082,57.07643508911133,2401,396,2005,2005,0,10,477000.0
477,477999,20.96000376424791,35.56843803333948,0.0964692483508327,58.71807503700256,29.216756343841553,57.35404968261719,2415,398,2017,2017,0,10,478000.0
478,478999,20.955167739640785,35.5540700920243,0.09628201358471566,58.8341851234436,29.277722120285034,57.53651809692383,2415,398,2017,2017,0,10,479000.0
479,479999,20.950138020253558,35.53730853289357,0.09616462786892188,58.960705041885376,29.34255576133728,57.6767692565918,2418,399,2019,2019,0,10,480000.0
480,480999,20.942539278972692,35.5178690932128,0.0960616452216998,59.09276103973389,29.40450358390808,57.7215461730957,2423,401,2022,2022,0,10,481000.0
481,481999,20.938804242207393,35.50706057911665,0.09589981598810637,59.204692125320435,29.466215133666992,57.87991714477539,2424,401,2023,2023,0,10,482000.0
482,482999,20.937921176673367,35.49597661720443,0.09566905869845654,59.32548666000366,29.527515649795532,57.94096374511719,2426,402,2024,2024,0,10,483000.0
483,483999,20.941333163132366,35.48866370443553,0.09536563679558563,59.44850468635559,29.592206954956055,58.082523345947266,2433,403,2030,2030,0,10,484000.0
484,484999,20.94550652197901,35.48071283267625,0.09506072128435283,59.7988076210022,29.6559898853302,58.20366287231445,2433,403,2030,2030,0,10,485000.0
485,485999,20.94928875163967,35.47276067412088,0.09478239275697242,59.9367253780365,29.717563152313232,58.20692443847656,2438,405,2033,2033,0,10,486000.0
486,486999,20.952152633454308,35.46210942086563,0.09457972976507167,60.06121253967285,29.779072046279907,58.26036834716797,2441,406,2035,2035,0,10,487000.0
487,487999,20.945113716802894,35.446433117371186,0.0944136584774693,60.192360639572144,29.84536051750183,58.875064849853516,2462,406,2056,2056,0,10,488000.0
488,488999,20.93686808741972,35.44628353968511,0.09417651998131638,60.3050754070282,29.908602476119995,59.2629508972168,2469,406,2063,2063,0,10,489000.0
489,489999,20.92529342874389,35.43695818927839,0.09411613206396219,60.421353340148926,29.970436573028564,59.45700454711914,2487,407,2080,2080,0,10,490000.0
490,490999,20.912628788199342,35.414281204920336,0.09415646442656866,60.55925703048706,30.033541917800903,59.61625671386719,2500,410,2090,2090,0,10,491000.0
491,491999,20.905529886806562,35.4136581134311,0.09403371359443413,60.68512415885925,30.096197366714478,59.76680374145508,2503,411,2092,2092,0,10,492000.0
492,492999,20.900289861467368,35.40061219797095,0.0939544996942947,60.81523680686951,30.16112780570984,60.07067108154297,2512,413,2099,2099,0,10,493000.0
493,493999,20.895835942084037,35.387272870710724,0.0938705962278541,60.93637299537659,30.22545599937439,60.206260681152344,2514,414,2100,2100,0,10,494000.0
494,494999,20.89137296422164,35.376027666097755,0.09376581245978122,61.05075001716614,30.287426948547363,60.36246109008789,2517,415,2102,2102,0,10,495000.0
495,495999,20.8840500122287,35.357181985289394,0.09369159305167496,61.195422649383545,30.349905252456665,60.39921951293945,2525,418,2107,2107,0,10,496000.0
496,496999,20.877588496045625,35.3447760619379,0.09365857072599648,61.31952095031738,30.413291692733765,60.60459518432617,2528,418,2110,2110,0,10,497000.0
497,497999,20.874225701815053,35.33447432306658,0.0936312794685148,61.45124125480652,30.476383924484253,60.74821090698242,2540,420,2120,2120,0,10,498000.0
498,498999,20.87453591786916,35.32612045364296,0.0935760324136311,61.57234740257263,30.541473388671875,60.97608184814453,2544,421,2123,2123,0,10,499000.0
499,499999,20.87839055758213,35.33024232143524,0.09364764642001666,61.704787492752075,30.603750467300415,61.103633880615234,2546,422,2124,2124,0,10,500000.0
500,500999,20.87995102544612,35.32408669200561,0.09360960235075833,61.827632188797,30.667251586914062,61.19756317138672,2553,424,2129,2129,0,10,501000.0
501,501999,20.885010944200705,35.32796041723234,0.09378629121494386,61.957048416137695,30.72974967956543,61.32420349121094,2556,425,2131,2131,0,10,502000.0
502,502999,20.895543770512774,35.33970315661209,0.09425835648826819,62.08992028236389,30.791783809661865,61.36793899536133,2560,427,2133,2133,0,10,503000.0
503,503999,20.903836143114376,35.37381913460425,0.09427657146581092,62.21865129470825,30.85298442840576,61.5020866394043,2567,429,2138,2138,0,10,504000.0
504,504999,20.91474324629028,35.381255627998456,0.09420826086260392,62.3380241394043,30.91324496269226,61.635589599609375,2569,430,2139,2139,0,10,505000.0
505,505999,20.92731800428982,35.39426281119382,0.09413605883590626,62.47020101547241,30.978203535079956,61.702293395996094,2573,431,2142,2142,0,10,506000.0
506,506999,20.93644892012983,35.43023666299544,0.09390834103165069,62.59533762931824,31.04472279548645,61.76908493041992,2576,432,2144,2144,0,10,507000.0
507,507999,20.93868815435131,35.4279828191156,0.09393449487960925,62.71458864212036,31.105422973632812,61.88697814941406,2580,433,2147,2147,0,10,508000.0
508,508999,20.929951775254523,35.43255006836044,0.09406876802452213,62.83424472808838,31.167837142944336,62.4953498840332,2596,433,2163,2163,0,10,509000.0
509,509999,20.918198038734058,35.41541016092168,0.0945697537293837,62.95203113555908,31.229663610458374,62.738094329833984,2598,433,2165,2165,0,10,510000.0
510,510999,20.90644466159073,35.4011467413595,0.09495474757846856,63.061821699142456,31.292094230651855,62.97774887084961,2604,433,2171,2171,0,10,511000.0
511,511999,20.89574557063698,35.384302871170526,0.09520310888497152,63.20116591453552,31.364673137664795,63.229339599609375,2612,434,2178,2178,0,10,512000.0
512,512999,20.88833895140974,35.379124824030036,0.09536921529141629,63.335270404815674,31.42734694480896,63.3947868347168,2621,436,2185,2185,0,10,513000.0
513,513999,20.87945353869465,35.36616421450889,0.09544206828685264,63.454405546188354,31.490540742874146,63.51340866088867,2624,437,2187,2187,0,10,514000.0
514,514999,20.871403071201307,35.35140446045719,0.09552577598289591,63.60065698623657,31.554169416427612,63.61802291870117,2628,439,2189,2189,0,10,515000.0
515,515999,20.861308735241526,35.33332081028367,0.09558639402654823,63.72684645652771,31.6171555519104,63.84242248535156,2634,439,2195,2195,0,10,516000.0
516,516999,20.852560257263377,35.319172370988895,0.09578053930116381,63.84425401687622,31.681307792663574,63.94778060913086,2634,439,2195,2195,0,10,517000.0
517,517999,20.84561505487608,35.30551714907099,0.09579086274907866,63.97456216812134,31.749104499816895,64.2142105102539,2644,440,2204,2204,0,10,518000.0
518,518999,20.836808308255918,35.29140948508807,0.09593642118988865,64.12026000022888,31.811766386032104,64.27991104125977,2680,443,2237,2237,0,10,519000.0
519,519999,20.825676061056804,35.27157131401976,0.0960992327043535,64.24416899681091,31.881965398788452,64.4869270324707,2681,443,2238,2238,0,10,520000.0
520,520999,20.820463973728014,35.31271428208664,0.09592349542253009,64.36673188209534,31.94302225112915,64.60197448730469,2683,444,2239,2239,0,10,521000.0
521,521999,20.815205877772303,35.30091194987112,0.09601735059856376,64.49385595321655,32.00507593154907,64.69200134277344,2685,445,2240,2240,0,10,522000.0
522,522999,20.808787963761485,35.301357044937504,0.09596060531881478,64.62441873550415,32.06960415840149,64.8957748413086,2688,445,2243,2243,0,10,523000.0
523,523999,20.797948821259197,35.283086588552024,0.09603014266116139,64.73843145370483,32.13342881202698,65.00194549560547,2689,445,2244,2244,0,10,524000.0
524,524999,20.78692819839181,35.26342149143244,0.09611778139822225,64.86208510398865,32.19708490371704,65.12562942504883,2693,446,2247,2247,0,10,525000.0
525,525999,20.78456035706955,35.28545529087927,0.09586739859255089,64.98901867866516,32.25956845283508,65.74909973144531,2719,447,2272,2272,0,10,526000.0
526,526999,20.777174455042047,35.27016857523935,0.09579711720829209,65.09967279434204,32.32374024391174,66.06863403320312,2725,447,2278,2278,0,10,527000.0
527,527999,20.7708261247113,35.25776213664497,0.0957907132225595,65.22052216529846,32.38563513755798,66.17557907104492,2731,448,2283,2283,0,10,528000.0
528,528999,20.763732823808617,35.24531548715001,0.09573425028942484,65.33712553977966,32.44722604751587,66.56201553344727,2738,448,2290,2290,0,10,529000.0
529,529999,20.75767697646849,35.23392001598683,0.09576463126076229,65.4647912979126,32.507853507995605,66.71419525146484,2743,450,2293,2293,0,10,530000.0
530,530999,20.75445439137158,35.23531668696622,0.09561803916540412,65.60331749916077,32.57029676437378,66.80192184448242,2755,454,2301,2301,0,10,531000.0
531,531999,20.74787715329182,35.22646021414249,0.0955221584043493,65.74646306037903,32.634310245513916,66.93463134765625,2763,458,2305,2305,0,10,532000.0
532,532999,20.74245017148255,35.249474698376325,0.09525931246335817,65.85915684700012,32.69503426551819,67.13352966308594,2771,459,2312,2312,0,10,533000.0
533,533999,20.738518389585217,35.247320435482486,0.09510205685174256,65.9989960193634,32.75859880447388,67.301025390625,2776,460,2316,2316,0,10,534000.0
534,534999,20.736173073169155,35.23478627810781,0.09495876488258637,66.11132979393005,32.823599100112915,67.71977615356445,2783,460,2323,2323,0,10,535000.0
535,535999,20.734926565802944,35.23299497218579,0.09481572805152383,66.2358672618866,32.88552260398865,67.80534362792969,2789,462,2327,2327,0,10,536000.0
536,536999,20.733850923790502,35.23359719631151,0.09481049811351805,66.36920619010925,32.94665312767029,67.89617919921875,2799,465,2334,2334,0,10,537000.0
537,537999,20.739568638979794,35.24049709882448,0.09472808581320524,66.49826049804688,33.01146101951599,68.03092956542969,2804,467,2337,2337,0,10,538000.0
538,538999,20.74472751152995,35.245017447192005,0.09469015998614849,66.63315653800964,33.07296681404114,68.14188766479492,2807,468,2339,2339,0,10,539000.0
539,539999,20.746498650761744,35.24397657264722,0.09469109736542014,66.7434389591217,33.133949518203735,68.29092025756836,2807,468,2339,2339,0,10,540000.0
540,540999,20.75448399332967,35.26962643462484,0.09445574403439772,66.85482859611511,33.19664907455444,68.63130950927734,2812,468,2344,2344,0,10,541000.0
541,541999,20.759482502863605,35.26552022878537,0.09434840584979554,66.9786126613617,33.25827741622925,68.68150329589844,2816,470,2346,2346,0,10,542000.0
542,542999,20.762867554970217,35.261861647400906,0.09431603320258275,67.10431504249573,33.31846761703491,68.80494689941406,2816,470,2346,2346,0,10,543000.0
543,543999,20.762054743646406,35.250507587113965,0.09421535925915436,67.22568416595459,33.37953972816467,68.86521911621094,2818,471,2347,2347,0,10,544000.0
544,544999,20.75881138904824,35.2435474854283,0.09405210358190463,67.34426808357239,33.44395589828491,69.46890258789062,2841,472,2369,2369,0,10,545000.0
545,545999,20.74841475188252,35.23998984629396,0.09399027286602091,67.45083093643188,33.50377130508423,69.83032608032227,2846,472,2374,2374,0,10,546000.0
546,546999,20.737725327952173,35.222590860745086,0.09393590985973721,67.5654456615448,33.56397771835327,70.06203079223633,2853,473,2380,2380,0,10,547000.0
547,547999,20.728540394358145,35.21870760529149,0.09383283147715404,67.67544507980347,33.623347759246826,70.27791595458984,2858,474,2384,2384,0,10,548000.0
548,548999,20.719195553313934,35.203031835239685,0.09377727640267919,67.7968282699585,33.68397355079651,70.47051239013672,2881,476,2405,2405,0,10,549000.0
549,549999,20.712284270617904,35.18982997402034,0.09367972106744948,67.94334983825684,33.7444965839386,70.61516189575195,2890,480,2410,2410,0,10,550000.0
550,550999,20.707559000815383,35.175614684661866,0.09361370528937785,68.05575132369995,33.80591297149658,70.78342056274414,2893,481,2412,2412,0,10,551000.0
551,551999,20.705358475752696,35.16873595232084,0.09356704878167721,68.19738745689392,33.866644620895386,70.89831161499023,2906,484,2422,2422,0,10,552000.0
552,552999,20.699648025659496,35.15554747106565,0.09353259017190352,68.30837154388428,33.927361249923706,71.25936508178711,2909,484,2425,2425,0,10,553000.0
553,553999,20.696674476162144,35.14439467732916,0.09354625827220853,68.43933486938477,33.993321657180786,71.4602279663086,2918,485,2433,2433,0,10,554000.0
554,554999,20.695965981261566,35.140385334274434,0.09341020979267067,68.55785393714905,34.056591510772705,71.85675811767578,2928,485,2443,2443,0,10,555000.0
555,555999,20.695068121368497,35.13152480888427,0.09338604935854311,68.67630410194397,34.11669611930847,72.04442596435547,2932,487,2445,2445,0,10,556000.0
556,556999,20.692287297449397,35.121925584114024,0.09335267397244906,69.06897187232971,34.17890667915344,72.18357467651367,2939,489,2450,2450,0,10,557000.0
557,557999,20.687909112249134,35.10997859364718,0.0933838644377849,69.18746185302734,34.2404465675354,72.41007232666016,2942,490,2452,2452,0,10,558000.0
558,558999,20.686961598070425,35.1026948338934,0.09340904545421536,69.31000471115112,34.30113172531128,72.59398651123047,2945,491,2454,2454,0,10,559000.0
559,559999,20.683402213035855,35.09333856588299,0.09346458899605448,69.43308401107788,34.36610269546509,72.75214767456055,2949,492,2457,2457,0,10,560000.0
560,560999,20.680288339070117,35.08352463987912,0.09354998422226057,69.56123089790344,34.427555084228516,72.95953750610352,2958,494,2464,2464,0,10,561000.0
561,561999,20.681715250476543,35.08183968379635,0.09354845434705128,69.68301939964294,34.4893434047699,73.1197509765625,2961,495,2466,2466,0,10,562000.0
562,562999,20.680301288071593,35.073547625155484,0.09368239256770416,69.81561803817749,34.551647424697876,73.23192977905273,2968,498,2470,2470,0,10,563000.0
563,563999,20.678885743408483,35.06562012461213,0.09381060747723036,69.95952248573303,34.61493539810181,73.37260437011719,2979,501,2478,2478,0,10,564000.0
564,564999,20.672555166377332,35.054368699004954,0.09376334287934085,70.08566069602966,34.67725729942322,73.78225708007812,2997,502,2495,2495,0,10,565000.0
565,565999,20.660455737754877,35.04063591232552,0.09374205916182154,70.21136260032654,34.739134550094604,74.15923309326172,3003,502,2501,2501,0,10,566000.0
566,566999,20.647633118664988,35.02392327678407,0.09378358147487265,70.32168865203857,34.80062222480774,74.35497665405273,3004,502,2502,2502,0,10,567000.0
567,567999,20.636939290373665,35.01341022580206,0.0937605639147635,70.44405889511108,34.86569118499756,74.55780410766602,3013,503,2510,2510,0,10,568000.0
568,568999,20.62409755126266,34.99336025810661,0.09380967098195148,70.5767011642456,34.928415060043335,74.63742065429688,3019,505,2514,2514,0,10,569000.0
569,569999,20.612388443528516,34.976472659073224,0.09388890785286996,70.6949315071106,34.98988580703735,74.96827697753906,3024,505,2519,2519,0,10,570000.0
570,570999,20.599067942097566,34.956117061961535,0.09394015061840899,70.8113694190979,35.05034637451172,75.04610061645508,3026,506,2520,2520,0,10,571000.0
571,571999,20.58759443271028,34.93811676269982,0.09400577611941141,70.93767809867859,35.11322808265686,75.19616317749023,3027,506,2521,2521,0,10,572000.0
572,572999,20.575127061520057,34.91861273549649,0.09405428072281952,71.06444096565247,35.177491188049316,75.31278610229492,3030,507,2523,2523,0,10,573000.0
573,573999,20.565881644179342,34.902149562359575,0.09406875827426675,71.19831705093384,35.238325357437134,75.39997100830078,3038,509,2529,2529,0,10,574000.0
574,574999,20.55540438442083,34.88331899070931,0.09405943337609424,71.31483960151672,35.30000376701355,75.6562385559082,3060,510,2550,2550,0,10,575000.0
575,575999,20.548235934629577,34.902114038315595,0.0938521319226957,71.4244704246521,35.36060857772827,75.81066513061523,3060,510,2550,2550,0,10,576000.0
576,576999,20.537277085742975,34.882058891031306,0.09386126911459358,71.5559241771698,35.42305111885071,75.88311767578125,3062,511,2551,2551,0,10,577000.0
577,577999,20.529734065852498,34.86600496799296,0.09385785492224041,71.69446539878845,35.4865460395813,75.98128890991211,3065,512,2553,2553,0,10,578000.0
578,578999,20.520414417714477,34.848799735871076,0.09384502848804466,71.81832003593445,35.55063533782959,76.10895919799805,3066,512,2554,2554,0,10,579000.0
579,579999,20.51309662318848,34.83489039287061,0.09384188401204963,71.93608021736145,35.61164045333862,76.15568923950195,3068,513,2555,2555,0,10,580000.0
580,580999,20.50813009088562,34.84115000707208,0.09371262965643878,72.0761947631836,35.67259740829468,76.19953918457031,3076,515,2561,2561,0,10,581000.0
581,581999,20.501175783527167,34.82441488865375,0.09370383229629076,72.19952774047852,35.73232650756836,76.25146484375,3078,516,2562,2562,0,10,582000.0
582,582999,20.494529617975942,34.80912381578857,0.09370393356273443,72.31697225570679,35.792683839797974,76.31097412109375,3078,516,2562,2562,0,10,583000.0
583,583999,20.4851870842634,34.792152371586866,0.09373146894311857,72.43854808807373,35.85355091094971,76.36786270141602,3078,516,2562,2562,0,10,584000.0
584,584999,20.477057683852834,34.791437253303116,0.09380840661391998,72.55319094657898,35.91688776016235,76.88066101074219,3097,516,2581,2581,0,10,585000.0
585,585999,20.46513561603916,34.79253886841243,0.0926916650233196,72.66916108131409,35.97817063331604,77.21603012084961,3103,517,2586,2586,0,10,586000.0
586,586999,20.454391030508447,34.7882820619252,0.09267189270317688,72.79153847694397,36.03921842575073,77.50430679321289,3113,518,2595,2595,0,10,587000.0
587,587999,20.44448260460265,34.77582768261483,0.09254879652705417,72.91807341575623,36.10127353668213,77.73827743530273,3123,520,2603,2603,0,10,588000.0
588,588999,20.435465277525477,34.76344476804607,0.09252339945380705,73.03148341178894,36.16248941421509,77.98831176757812,3148,521,2627,2627,0,10,589000.0
589,589999,20.427511116610713,34.75082957741919,0.09251929149522009,73.15664601325989,36.2234845161438,78.34983825683594,3153,521,2632,2632,0,10,590000.0
590,590999,20.42010229925269,34.74402452810396,0.09246907065709464,73.27760481834412,36.28486204147339,78.46176528930664,3158,523,2635,2635,0,10,591000.0
591,591999,20.4121955351613,34.728590855964114,0.09247423464868276,73.3983805179596,36.34646391868591,78.61382293701172,3160,524,2636,2636,0,10,592000.0
592,592999,20.404248399458613,34.714568050938155,0.09251153104817167,73.52074098587036,36.4075984954834,78.85387420654297,3171,525,2646,2646,0,10,593000.0
593,593999,20.396130971395035,34.70153725620222,0.09253381266963456,73.65318250656128,36.47180199623108,79.03921890258789,3177,526,2651,2651,0,10,594000.0
594,594999,20.392856597844045,34.70028628821256,0.09247640963200432,73.7825870513916,36.53396964073181,79.33804321289062,3188,527,2661,2661,0,10,595000.0
595,595999,20.38766219209176,34.69531491760585,0.09243599697021176,73.90473866462708,36.59779334068298,79.56738662719727,3190,528,2662,2662,0,10,596000.0
596,596999,20.38244641794632,34.68365576201658,0.0924970847500245,74.01787686347961,36.65899586677551,79.72395324707031,3193,529,2664,2664,0,10,597000.0
597,597999,20.37632754953597,34.672814725069045,0.09254846243507453,74.14568090438843,36.72096014022827,79.8402328491211,3197,531,2666,2666,0,10,598000.0
598,598999,20.37077617805834,34.661060382991565,0.09256652273745292,74.27711486816406,36.7862069606781,79.91762161254883,3203,533,2670,2670,0,10,599000.0
599,599999,20.367968278703504,34.65301035703933,0.0926087636325742,74.39546847343445,36.850080251693726,80.10379791259766,3203,533,2670,2670,0,10,600000.0
600,600999,20.36353108930453,34.641972925552295,0.09269169129466792,74.54197359085083,36.913559436798096,80.25775527954102,3212,535,2677,2677,0,10,601000.0
601,601999,20.361644999599342,34.63230203307539,0.09266411086871607,74.65873384475708,36.97419095039368,80.36100006103516,3214,536,2678,2678,0,10,602000.0
602,602999,20.357071944780948,34.61971164950311,0.09265761462953492,74.76879668235779,37.034700870513916,80.46976470947266,3214,536,2678,2678,0,10,603000.0
603,603999,20.352147717557532,34.614597406160726,0.09261584159855929,74.91551089286804,37.10488033294678,80.53319931030273,3217,537,2680,2680,0,10,604000.0
604,604999,20.34430182873493,34.59945382803856,0.0926839849640988,75.0491590499878,37.16707229614258,81.06414031982422,3246,539,2707,2707,0,10,605000.0
605,605999,20.335857699312395,34.58658056992075,0.09257472366317365,75.1653938293457,37.2310574054718,81.48037719726562,3250,539,2711,2711,0,10,606000.0
606,606999,20.327722434743006,34.57296135944735,0.09254899918577797,75.27614712715149,37.29291796684265,81.78277969360352,3255,539,2716,2716,0,10,607000.0
607,607999,20.319252035769644,34.560453850160535,0.09251155303079706,75.39907598495483,37.355382442474365,81.98222351074219,3261,540,2721,2721,0,10,608000.0
608,608999,20.313556848637777,34.54960766370241,0.09244640847647412,75.51773262023926,37.41726088523865,82.27172470092773,3290,541,2749,2749,0,10,609000.0
609,609999,20.30831779199374,34.53866527606144,0.0923833714398038,75.6540174484253,37.48296546936035,82.42427062988281,3296,543,2753,2753,0,10,610000.0
610,610999,20.304564948375642,34.535771257852836,0.09228396413973872,75.80774092674255,37.54491305351257,82.3624496459961,3332,548,2784,2784,0,10,611000.0
611,611999,20.29843618223468,34.52303767219651,0.09223803775592787,75.94922995567322,37.608108043670654,82.5070571899414,3338,551,2787,2787,0,10,612000.0
612,612999,20.29420703123486,34.51588636639404,0.09216300349342033,76.06663823127747,37.67320680618286,82.79238891601562,3342,551,2791,2791,0,10,613000.0
613,613999,20.289429309030982,34.50540712073532,0.0920753568594892,76.19359636306763,37.73819088935852,82.93267440795898,3345,552,2793,2793,0,10,614000.0
614,614999,20.288743575086432,34.50183799713029,0.09199085068395496,76.30416297912598,37.80017161369324,83.3222541809082,3353,552,2801,2801,0,10,615000.0
615,615999,20.29057980269447,34.4988231782424,0.09201294612742339,76.42563080787659,37.861985206604004,83.49585723876953,3355,553,2802,2802,0,10,616000.0
616,616999,20.293668266712796,34.49868990846854,0.09235245568235839,76.54984188079834,37.924805879592896,83.61772537231445,3360,554,2806,2806,0,10,617000.0
617,617999,20.303233517965353,34.53556224930826,0.09273293289314521,76.68456888198853,37.98751711845398,83.80973815917969,3420,556,2864,2864,0,10,618000.0
618,618999,20.31276312380674,34.5480110541984,0.09303550808981176,76.81480193138123,38.048110246658325,84.34413146972656,3423,557,2866,2866,0,10,619000.0
619,619999,20.32631926889382,34.56890295403845,0.09325480141536757,76.94287467002869,38.11093020439148,84.57084655761719,3428,559,2869,2869,0,10,620000.0
620,620999,20.34037791166961,34.58470532900109,0.09337463070841145,77.0684449672699,38.172317028045654,84.78579330444336,3437,560,2877,2877,0,10,621000.0
621,621999,20.34951408396869,34.590807929015476,0.0935092351187814,77.19352388381958,38.2359778881073,84.88322830200195,3437,560,2877,2877,0,10,622000.0
622,622999,20.361998538384352,34.60331002982704,0.09366870909124936,77.32535886764526,38.297438859939575,84.80506896972656,3443,562,2881,2881,0,10,623000.0
623,623999,20.369913219096052,34.60235064756023,0.09378486360836458,77.45628809928894,38.360283851623535,84.90949249267578,3445,563,2882,2882,0,10,624000.0
624,624999,20.36829519453036,34.59690672891988,0.09353050457199097,77.5848479270935,38.430893898010254,85.74732971191406,3474,563,2911,2911,0,10,625000.0
625,625999,20.36372701375897,34.58753543877436,0.09344897301962285,77.70286965370178,38.498539447784424,86.05897521972656,3475,563,2912,2912,0,10,626000.0
626,626999,20.359873213516913,34.583484458248,0.09337527536062007,77.8213381767273,38.567548990249634,86.35487747192383,3481,563,2918,2918,0,10,627000.0
627,627999,20.35534128432895,34.57537515193061,0.09328927020518563,77.95107173919678,38.629530906677246,86.50371932983398,3484,564,2920,2920,0,10,628000.0
628,628999,20.35366125696162,34.57544725136564,0.09314531604564558,78.07803058624268,38.691516637802124,86.82612228393555,3519,566,2953,2953,0,10,629000.0
629,629999,20.350884148866815,34.56496233196123,0.09309722286907574,78.21403336524963,38.75611138343811,86.99067687988281,3525,568,2957,2957,0,10,630000.0
630,630999,20.348386308390868,34.5566937133318,0.09301365761703306,78.33643245697021,38.8195858001709,87.14029693603516,3528,569,2959,2959,0,10,631000.0
631,631999,20.348069313758117,34.58017712518314,0.0927948512356398,78.45306539535522,38.88250541687012,87.29867172241211,3528,569,2959,2959,0,10,632000.0
632,632999,20.346743513327613,34.573516439443715,0.09276599709618472,78.57160663604736,38.94772911071777,87.47289657592773,3531,569,2962,2962,0,10,633000.0
633,633999,20.346425785905815,34.572616580478275,0.09264903631215382,78.7056610584259,39.01499843597412,87.62263870239258,3534,569,2965,2965,0,10,634000.0
634,634999,20.346973700842305,34.56590236991848,0.09261976082048973,78.82427835464478,39.076003074645996,87.91408157348633,3562,570,2992,2992,0,10,635000.0
635,635999,20.34949751345029,34.56303255292059,0.09257596800113,78.96582221984863,39.13775420188904,88.02655029296875,3571,572,2999,2999,0,10,636000.0
636,636999,20.35358134874833,34.58570240644358,0.0925259776516234,79.07868576049805,39.200175762176514,88.17263412475586,3572,572,3000,3000,0,10,637000.0
637,637999,20.355727634209778,34.581303373975956,0.09252587455606309,79.20155048370361,39.26171088218689,88.26755905151367,3572,572,3000,3000,0,10,638000.0
638,638999,20.36043271327349,34.58159913586408,0.09259370523073451,79.31773114204407,39.32428812980652,88.34748458862305,3574,573,3001,3001,0,10,639000.0
639,639999,20.368060280744558,34.58882844002088,0.09265708243570003,79.46328353881836,39.38951873779297,88.37859725952148,3578,575,3003,3003,0,10,640000.0
640,640999,20.37682541339997,34.59318216989116,0.09264124912461624,79.61180019378662,39.453439474105835,88.53196716308594,3584,577,3007,3007,0,10,641000.0
641,641999,20.384502307449964,34.5947926248133,0.09258077661121367,79.7323865890503,39.51546764373779,88.63909912109375,3586,578,3008,3008,0,10,642000.0
642,642999,20.39459008525368,34.60127135793163,0.09258611350454216,79.87487006187439,39.57985591888428,88.6229362487793,3594,581,3013,3013,0,10,643000.0
643,643999,20.400794531001935,34.598721375006974,0.09255428107551122,79.99832916259766,39.641268491744995,88.7013931274414,3598,582,3016,3016,0,10,644000.0
644,644999,20.40066737248878,34.592944608349946,0.09244955910158859,80.13939309120178,39.70616269111633,89.0941047668457,3613,584,3029,3029,0,10,645000.0
645,645999,20.396369195698878,34.60154632420585,0.09230945317247408,80.25603652000427,40.08051252365112,89.48834609985352,3619,584,3035,3035,0,10,646000.0
646,646999,20.393001069400515,34.595487143815106,0.09224829253361677,80.39056491851807,40.142072916030884,89.77650833129883,3656,586,3070,3070,0,10,647000.0
647,647999,20.389056980534306,34.591776904471516,0.0922425047681461,80.5004334449768,40.20354914665222,89.95668411254883,3656,586,3070,3070,0,10,648000.0
648,648999,20.384164028767618,34.58079172628884,0.09219145825418562,80.64105749130249,40.26987051963806,90.34798431396484,3668,587,3081,3081,0,10,649000.0
649,649999,20.381227119522872,34.573302695458196,0.09212925215401502,80.76718997955322,40.33645272254944,90.54671859741211,3668,587,3081,3081,0,10,650000.0
650,650999,20.378406332912558,34.56514624712494,0.0921238277554628,80.89583921432495,40.397408962249756,90.6500244140625,3674,589,3085,3085,0,10,651000.0
651,651999,20.376028888579214,34.562944006342505,0.09199221106230115,81.02755331993103,40.462172985076904,90.86174774169922,3677,589,3088,3088,0,10,652000.0
652,652999,20.37471566949101,34.56801876305379,0.09190428731446976,81.14695954322815,40.52464699745178,91.04050064086914,3680,589,3091,3091,0,10,653000.0
653,653999,20.377639872946325,34.56961922620937,0.09181470795645552,81.25987553596497,40.58810806274414,91.32831192016602,3687,589,3098,3098,0,10,654000.0
654,654999,20.380522444446573,34.57108562296307,0.09178612930080599,81.3790819644928,40.64970660209656,91.47368240356445,3689,590,3099,3099,0,10,655000.0
655,655999,20.380410827967232,34.565593324489136,0.09179437663622192,81.50715446472168,40.7113733291626,91.58984756469727,3692,591,3101,3101,0,10,656000.0
656,656999,20.383791425599288,34.569547931284134,0.0917590299739085,81.62974119186401,40.772897720336914,91.66906356811523,3696,592,3104,3104,0,10,657000.0
657,657999,20.390252527898603,34.58203766519466,0.09169873216319635,81.77598643302917,40.837772846221924,91.79336547851562,3696,592,3104,3104,0,10,658000.0
658,658999,20.400353255997477,34.61377286517396,0.09143563160566848,81.89011669158936,40.900466203689575,91.9723892211914,3697,592,3105,3105,0,10,659000.0
659,659999,20.405738830833208,34.63517508262573,0.0911883872042546,82.04299306869507,40.975284576416016,92.04928588867188,3702,593,3109,3109,0,10,660000.0
660,660999,20.408204822190946,34.63434393026198,0.0910491278128629,82.17032933235168,41.04016995429993,92.13996124267578,3704,594,3110,3110,0,10,661000.0
661,661999,20.406293920496587,34.63885104367833,0.09079397955377255,82.29376554489136,41.10659599304199,92.88543319702148,3724,594,3130,3130,0,10,662000.0
662,662999,20.404276092354543,34.64480862158646,0.09071846349881252,82.41182470321655,41.17214775085449,93.23242568969727,3728,594,3134,3134,0,10,663000.0
663,663999,20.400734344708233,34.647101073077785,0.0905742682633407,82.52574300765991,41.23729109764099,93.4894905090332,3732,594,3138,3138,0,10,664000.0
664,664999,20.39786357075623,34.642179657819185,0.09050758250023028,82.65121459960938,41.3028769493103,93.85574340820312,3744,595,3149,3149,0,10,665000.0
665,665999,20.39414250831217,34.631948091684116,0.0905106655627822,82.76978349685669,41.36886739730835,94.14198684692383,3746,595,3151,3151,0,10,666000.0
666,666999,20.39211722303045,34.62696843459941,0.09038288119413518,82.8945620059967,41.43484330177307,94.34091567993164,3746,595,3151,3151,0,10,667000.0
667,667999,20.39046845830526,34.62578272232135,0.0903027122573109,83.03164386749268,41.50015068054199,94.42626190185547,3753,597,3156,3156,0,10,668000.0
668,668999,20.388876784738628,34.61996308673493,0.09021663230297694,83.17806506156921,41.56498718261719,94.53307723999023,3786,600,3186,3186,0,10,669000.0
669,669999,20.389111712503073,34.62693459272997,0.08995785337289086,83.32253766059875,41.630839347839355,94.66279983520508,3790,602,3188,3188,0,10,670000.0
670,670999,20.392831442223606,34.647204961062386,0.0895971128359393,83.45561695098877,41.69731783866882,95.00314331054688,3794,603,3191,3191,0,10,671000.0
671,671999,20.393954065645868,34.64318550374161,0.08944445641714738,83.57960224151611,41.762601375579834,95.17672348022461,3796,604,3192,3192,0,10,672000.0
672,672999,20.397081992908635,34.641729509542294,0.0891961117675707,83.70698070526123,41.82724475860596,95.29117965698242,3798,605,3193,3193,0,10,673000.0
673,673999,20.39635149679661,34.635556774522236,0.08908356820859054,83.8519594669342,41.892313957214355,95.37167358398438,3826,607,3219,3219,0,10,674000.0
674,674999,20.39944552018785,34.65907539271773,0.08886375799087909,83.97150325775146,41.95784902572632,95.49800491333008,3826,607,3219,3219,0,10,675000.0
675,675999,20.402434025347326,34.65854518457807,0.0887468194745673,84.12870931625366,42.02385091781616,95.47673416137695,3835,610,3225,3225,0,10,676000.0
676,676999,20.40567604551237,34.65357736412814,0.08868136070897281,84.25966715812683,42.089582443237305,95.81002426147461,3868,611,3257,3257,0,10,677000.0
677,677999,20.411978204959972,34.66489772706703,0.08852748910306896,84.4085865020752,42.154762744903564,95.90677642822266,3872,613,3259,3259,0,10,678000.0
678,678999,20.414207259539676,34.65935228065207,0.08846716440553759,84.52210903167725,42.22003436088562,96.05033874511719,3872,613,3259,3259,0,10,679000.0
679,679999,20.4151559070872,34.65369480432785,0.08837467636929952,84.65287709236145,42.28494930267334,96.12300109863281,3874,614,3260,3260,0,10,680000.0
680,680999,20.413198514246837,34.651198260131146,0.08826371240805264,84.77289724349976,42.350178956985474,96.84523391723633,3891,614,3277,3277,0,10,681000.0
681,681999,20.40879167585849,34.650348693624046,0.08816962330061329,84.8868978023529,42.415411949157715,97.24948120117188,3891,614,3277,3277,0,10,682000.0
682,682999,20.40603969717678,34.64687502679224,0.08800599357167305,85.02335739135742,42.48033094406128,97.53325271606445,3904,616,3288,3288,0,10,683000.0
683,683999,20.4041162582429,34.643999059418434,0.08786399549746349,85.14489841461182,42.54572129249573,97.81083297729492,3908,617,3291,3291,0,10,684000.0
684,684999,20.403050823844545,34.64248882873611,0.08771997067394444,85.26524066925049,42.61013722419739,98.07184219360352,3912,618,3294,3294,0,10,685000.0
685,685999,20.405389800153795,34.64007714959425,0.08761921883105939,85.41726732254028,42.67973351478577,98.34586715698242,3919,620,3299,3299,0,10,686000.0
686,686999,20.40502379127142,34.631875124113755,0.0875226194441675,85.52880668640137,42.744773864746094,98.58998107910156,3919,620,3299,3299,0,10,687000.0
687,687999,20.408678134469714,34.63864857429955,0.08738707691639092,85.68194770812988,42.80934691429138,98.72272872924805,3925,622,3303,3303,0,10,688000.0
688,688999,20.413020798251615,34.64410820029518,0.08729568712923774,85.78719139099121,42.87127900123596,98.92182159423828,3926,622,3304,3304,0,10,689000.0
689,689999,20.413893239606292,34.63780633968655,0.087277738943628,85.91448616981506,42.933192014694214,99.04541015625,3933,623,3310,3310,0,10,690000.0
690,690999,20.420526760389055,34.640243239721826,0.08723151795826034,86.04534077644348,42.996317625045776,99.40821075439453,3937,624,3313,3313,0,10,691000.0
691,691999,20.42583560979545,34.640854340258045,0.08712855756415816,86.1726815700531,43.05953621864319,99.65896987915039,3939,625,3314,3314,0,10,692000.0
692,692999,20.431865368479812,34.64117650535959,0.08702768696754282,86.28238153457642,43.12205672264099,99.90061950683594,3939,625,3314,3314,0,10,693000.0
693,693999,20.438115905806725,34.64304753184645,0.08693489806023291,86.3979926109314,43.18387413024902,100.04299926757812,3941,626,3315,3315,0,10,694000.0
694,694999,20.44572069004553,34.64743333898946,0.08687365686893322,86.51645350456238,43.245795011520386,100.2335433959961,3942,626,3316,3316,0,10,695000.0
695,695999,20.455083377064938,34.65263443216428,0.0868772703370958,86.63110542297363,43.30779409408569,100.3702392578125,3942,626,3316,3316,0,10,696000.0
696,696999,20.46485090249301,34.658782685686006,0.08676952689072603,86.77681970596313,43.37389254570007,100.59367752075195,3948,628,3320,3320,0,10,697000.0
697,697999,20.471623867068818,34.659161936388074,0.0866130983501675,86.90622162818909,43.43657660484314,100.7149772644043,3952,630,3322,3322,0,10,698000.0
698,698999,20.47926840171514,34.66030527528348,0.0864634315273195,87.04432988166809,43.49882102012634,100.86897659301758,3956,632,3324,3324,0,10,699000.0
699,699999,20.483572789386933,34.65762817983963,0.08634418140505451,87.17664933204651,43.56060767173767,100.98363876342773,3958,633,3325,3325,0,10,700000.0
700,700999,20.483211987619875,34.65316868789847,0.08625718162920915,87.29722213745117,43.623231410980225,101.50360870361328,3969,633,3336,3336,0,10,701000.0
701,701999,20.475508571775908,34.64417282141918,0.08625440910794446,87.4228413105011,43.686306953430176,101.76398849487305,3975,634,3341,3341,0,10,702000.0
702,702999,20.46830526042401,34.63615849552395,0.0862593766477282,87.53672075271606,43.7511305809021,102.06035232543945,3976,634,3342,3342,0,10,703000.0
703,703999,20.460834964570875,34.6316857824912,0.08630670720599298,87.66402554512024,43.81178140640259,102.27642440795898,3981,635,3346,3346,0,10,704000.0
704,704999,20.46025694278665,34.67026285019979,0.08631803389905224,87.80142498016357,43.87627363204956,102.53948211669922,4014,637,3377,3377,0,10,705000.0
705,705999,20.461506579625443,34.673864644078165,0.08677429048402319,87.90990734100342,43.93912053108215,102.8112564086914,4016,637,3379,3379,0,10,706000.0
706,706999,20.46941905946751,34.70202439040536,0.08677160349287227,88.0483193397522,44.00013566017151,102.84563827514648,4022,639,3383,3383,0,10,707000.0
707,707999,20.477687609617135,34.73173173740074,0.08722378698059319,88.18647527694702,44.06117224693298,102.98871612548828,4024,640,3384,3384,0,10,708000.0
708,708999,20.48811906407005,34.76265624868303,0.08744047675866906,88.32848143577576,44.12264442443848,102.9958381652832,4031,642,3389,3389,0,10,709000.0
709,709999,20.499533662984547,34.80239580495143,0.08748980090280578,88.44737243652344,44.18576669692993,103.19261932373047,4032,642,3390,3390,0,10,710000.0
710,710999,20.51461450048996,34.847861433094785,0.08754497460643595,88.57330346107483,44.249207496643066,103.5038948059082,4033,642,3391,3391,0,10,711000.0
711,711999,20.52598860619277,34.88309437197946,0.08754877902540814,88.67872667312622,44.31051778793335,103.6604118347168,4033,642,3391,3391,0,10,712000.0
712,712999,20.536732111961108,34.90598810753816,0.0876951713674331,88.80791687965393,44.37117624282837,103.74399185180664,4038,643,3395,3395,0,10,713000.0
713,713999,20.54851287952082,34.93378588807837,0.08765244791960103,88.92966985702515,44.432005167007446,103.86919021606445,4038,643,3395,3395,0,10,714000.0
714,714999,20.560164688056602,34.95398708482323,0.08767163169855441,89.0387589931488,44.492698192596436,103.9704475402832,4038,643,3395,3395,0,10,715000.0
715,715999,20.57377704889073,34.97982901503816,0.08757699469897862,89.17144775390625,44.554114818573,104.05780029296875,4044,645,3399,3399,0,10,716000.0
716,716999,20.588149682942994,35.004447960548006,0.08741066934473773,89.29736828804016,44.61690354347229,104.12234497070312,4046,646,3400,3400,0,10,717000.0
717,717999,20.601933647641317,35.02430233506878,0.08732813034178077,89.42125630378723,44.67810249328613,104.18572235107422,4051,647,3404,3404,0,10,718000.0
718,718999,20.614748332855434,35.03894878444693,0.08727060084486915,89.55082845687866,44.73805904388428,104.221923828125,4054,648,3406,3406,0,10,719000.0
719,719999,20.614993754016908,35.03637387599773,0.08719506556991541,89.66499662399292,44.80129647254944,104.88504409790039,4069,648,3421,3421,0,10,720000.0
720,720999,20.613402805180584,35.045344261980944,0.08709832273537921,89.77427005767822,44.86522340774536,105.28848266601562,4070,648,3422,3422,0,10,721000.0
721,721999,20.611222616998347,35.04206702248766,0.0869814001003838,89.91335892677307,44.92947196960449,105.5080680847168,4076,650,3426,3426,0,10,722000.0
722,722999,20.609979885800655,35.044175526955385,0.08684746285170619,90.0537416934967,44.991814851760864,105.67057418823242,4086,653,3433,3433,0,10,723000.0
723,723999,20.610292804365976,35.04471028091055,0.08668189040723817,90.17446327209473,45.055991649627686,106.06822204589844,4120,654,3466,3466,0,10,724000.0
724,724999,20.608692916610742,35.04142131240931,0.08656349569510857,90.31296110153198,45.116825342178345,106.24556350708008,4125,656,3469,3469,0,10,725000.0
725,725999,20.607154749628034,35.03705234789349,0.08648972913498187,90.42409920692444,45.17640256881714,106.48745346069336,4125,656,3469,3469,0,10,726000.0
726,726999,20.60570717415543,35.03055023156415,0.08642545886320174,90.53643250465393,45.23646092414856,106.65087509155273,4125,656,3469,3469,0,10,727000.0
727,727999,20.60271948486512,35.022969719406866,0.08636454578856523,90.65595531463623,45.301175355911255,106.87071228027344,4127,656,3471,3471,0,10,728000.0
728,728999,20.60129762647534,35.01880140623648,0.08629053017877708,90.77728796005249,45.361520528793335,106.97173309326172,4131,657,3474,3474,0,10,729000.0
729,729999,20.599775144475434,35.014120704681034,0.08617919868582102,90.89140605926514,45.42245888710022,107.35188674926758,4133,657,3476,3476,0,10,730000.0
730,730999,20.596574342624695,35.00530280001573,0.08610883585610796,91.01217269897461,45.487447023391724,107.53372573852539,4133,657,3476,3476,0,10,731000.0
731,731999,20.596779429609516,35.02661373947994,0.08590922694385816,91.14706921577454,45.549750089645386,107.6773910522461,4140,658,3482,3482,0,10,732000.0
732,732999,20.593685754069053,35.01975313242269,0.08585140473168529,91.2572877407074,45.612361907958984,107.8465347290039,4140,658,3482,3482,0,10,733000.0
733,733999,20.592865848204706,35.0125477091505,0.08577109714399656,91.39735841751099,45.676135540008545,107.94599151611328,4142,659,3483,3483,0,10,734000.0
734,734999,20.59071046210354,35.00323749028135,0.08570605066862735,91.51463675498962,45.73821210861206,108.07246780395508,4142,659,3483,3483,0,10,735000.0
735,735999,20.593138204866953,35.001155861520914,0.08559296036061126,91.65609502792358,45.801032066345215,108.14189147949219,4147,661,3486,3486,0,10,736000.0
736,736999,20.593401616383503,34.99574607658122,0.08551551597281903,91.78677320480347,45.86195516586304,108.29367446899414,4153,662,3491,3491,0,10,737000.0
737,737999,20.59272954177826,34.98844174900012,0.08543840562845761,91.90351867675781,45.92353343963623,108.43925094604492,4153,662,3491,3491,0,10,738000.0
738,738999,20.590175772120357,34.979812354324956,0.08537021623265773,92.01677942276001,45.98441481590271,108.54130554199219,4153,662,3491,3491,0,10,739000.0
739,739999,20.590425249074322,35.00451611959184,0.08512800669886633,92.13232088088989,46.04916477203369,109.42931747436523,4176,662,3514,3514,0,10,740000.0
740,740999,20.58700537947491,35.036361785478896,0.08490561181164613,92.26307320594788,46.11408758163452,109.73915100097656,4182,663,3519,3519,0,10,741000.0
741,741999,20.58180423747422,35.04225406429182,0.08481671877402763,92.36815333366394,46.17539930343628,110.00203323364258,4182,663,3519,3519,0,10,742000.0
742,742999,20.57858720818179,35.05232008532314,0.08475287255181785,92.49386978149414,46.2404203414917,110.19095230102539,4185,664,3521,3521,0,10,743000.0
743,743999,20.57320435240024,35.045334218045696,0.08482164242766466,92.6129982471466,46.302136182785034,110.52159881591797,4190,665,3525,3525,0,10,744000.0
744,744999,20.566857902292583,35.0342645087834,0.08474724126688271,92.73351216316223,46.36331868171692,110.75277328491211,4193,666,3527,3527,0,10,745000.0
745,745999,20.564820505090577,35.04034750920554,0.08466442024453213,92.863272190094,46.792866468429565,110.92951965332031,4195,667,3528,3528,0,10,746000.0
746,746999,20.559164762863396,35.03066989618107,0.08464530926974578,93.00170159339905,46.85499930381775,110.98048782348633,4201,669,3532,3532,0,10,747000.0
747,747999,20.555569382644048,35.02855847759182,0.08466687529352379,93.12473917007446,46.91838026046753,111.16241455078125,4205,670,3535,3535,0,10,748000.0
748,748999,20.5501045949147,35.02209745756155,0.08464340899740097,93.25752711296082,46.98374390602112,111.31990814208984,4212,671,3541,3541,0,10,749000.0
749,749999,20.549137745252445,35.02197360865371,0.0845922146206406,93.4033637046814,47.05869245529175,111.73856735229492,4213,671,3542,3542,0,10,750000.0
750,750999,20.548505696156354,35.02376949835277,0.08456500486435092,93.53948402404785,47.12241268157959,111.86882019042969,4218,673,3545,3545,0,10,751000.0
751,751999,20.544650551714405,35.014369731338505,0.0845404555036724,93.66254878044128,47.18754029273987,112.11456680297852,4218,673,3545,3545,0,10,752000.0
752,752999,20.540790009477977,35.00685200896426,0.08452050705501268,93.7880392074585,47.248923540115356,112.21080017089844,4222,674,3548,3548,0,10,753000.0
753,753999,20.540793542260253,35.00738137689981,0.08444994471766398,93.92173671722412,47.3100950717926,112.30615997314453,4230,676,3554,3554,0,10,754000.0
754,754999,20.540556880625882,35.00520889377698,0.084405913655625,94.04619669914246,47.3714816570282,112.39703750610352,4232,677,3555,3555,0,10,755000.0
755,755999,20.541790360200572,35.00396673743648,0.08437681854660917,94.18200302124023,47.436118364334106,112.56957244873047,4234,678,3556,3556,0,10,756000.0
756,756999,20.544318365655005,35.00262830699022,0.0843111358962193,94.31134819984436,47.49743175506592,112.65287017822266,4236,679,3557,3557,0,10,757000.0
757,757999,20.545821603246587,35.00041459794046,0.0842911885075659,94.43859100341797,47.557915449142456,112.6976432800293,4241,680,3561,3561,0,10,758000.0
758,758999,20.54593180651898,34.995409228394685,0.08423359105610617,94.55969047546387,47.618932485580444,112.80524063110352,4241,680,3561,3561,0,10,759000.0
759,759999,20.54489992334855,34.99458093049415,0.0840331257816822,94.70179057121277,47.683879137039185,113.49354553222656,4261,681,3580,3580,0,10,760000.0
760,760999,20.537250856537025,34.98849297036219,0.08398481424935078,94.84722137451172,47.752418756484985,113.83550262451172,4274,683,3591,3591,0,10,761000.0
761,761999,20.52773162783368,34.97539184261307,0.08399497421420543,94.95587372779846,47.81338453292847,114.1084098815918,4275,683,3592,3592,0,10,762000.0
762,762999,20.5207882273603,34.98054418626904,0.08390628872739148,95.063969373703,47.873647689819336,114.33899307250977,4275,683,3592,3592,0,10,763000.0
763,763999,20.514123430861012,34.97580974037566,0.08385758556585576,95.1846809387207,47.93558120727539,114.47702407836914,4279,684,3595,3595,0,10,764000.0
764,764999,20.508033559955592,34.96877270089053,0.08378727374411488,95.31091356277466,48.0011670589447,114.88515853881836,4284,685,3599,3599,0,10,765000.0
765,765999,20.50446533176316,34.96584312358539,0.08372723059550624,95.44839692115784,48.06339359283447,115.03500747680664,4290,686,3604,3604,0,10,766000.0
766,766999,20.50041172952854,34.9633510204675,0.08363662124448523,95.56579065322876,48.12810254096985,115.19094848632812,4290,686,3604,3604,0,10,767000.0
767,767999,20.496116406549564,34.958759852895724,0.08360195972098805,95.69108867645264,48.19289016723633,115.33327102661133,4293,687,3606,3606,0,10,768000.0
768,768999,20.491708930797568,34.951851997566685,0.08355542828345841,95.81220769882202,48.25331115722656,115.43865585327148,4295,688,3607,3607,0,10,769000.0
769,769999,20.490512603794446,34.950556812547774,0.08348772587423303,95.93800663948059,48.31452488899231,115.60845184326172,4301,689,3612,3612,0,10,770000.0
770,770999,20.491314417977584,34.94809412731137,0.08343043644991288,96.05980825424194,48.37748193740845,115.8324966430664,4303,690,3613,3613,0,10,771000.0
771,771999,20.49099641995954,34.9506814317136,0.08334341269436962,96.17092037200928,48.43965220451355,115.9974136352539,4303,690,3613,3613,0,10,772000.0
772,772999,20.49069595765579,34.94759227787817,0.08329402842871447,96.29459023475647,48.50119185447693,116.11621856689453,4303,690,3613,3613,0,10,773000.0
773,773999,20.491905203111727,34.94557158636393,0.0832442547889779,96.41605520248413,48.56295824050903,116.19061660766602,4305,691,3614,3614,0,10,774000.0
774,774999,20.494014078073977,34.9484774020291,0.08319533843996496,96.56196713447571,48.63476824760437,116.26647567749023,4307,692,3615,3615,0,10,775000.0
775,775999,20.496053539495925,34.94662249945552,0.08320481562543847,96.70467257499695,48.69688820838928,116.44842529296875,4372,694,3678,3678,0,10,776000.0
776,776999,20.5003277585643,34.975004761045945,0.08305681264660392,96.84534335136414,48.75937247276306,117.37142944335938,4374,695,3679,3679,0,10,777000.0
777,777999,20.504013153732693,34.97430643467904,0.08301103551254752,96.97002077102661,48.82136368751526,117.70702362060547,4376,696,3680,3680,0,10,778000.0
778,778999,20.50797594469285,34.9753843979943,0.0830239640114584,97.10339212417603,48.88451337814331,117.8748779296875,4381,698,3683,3683,0,10,779000.0
779,779999,20.50885524110888,34.977744305438435,0.08295218021450201,97.21881675720215,48.94793725013733,118.06436157226562,4381,698,3683,3683,0,10,780000.0
780,780999,20.5027332457622,34.98621494795476,0.08287815015109123,97.3365683555603,49.00964665412903,118.68235778808594,4384,698,3686,3686,0,10,781000.0
781,781999,20.49452759173839,34.97423447016329,0.08290016586724869,97.46243739128113,49.07177424430847,118.86671829223633,4389,699,3690,3690,0,10,782000.0
782,782999,20.48589076152471,34.966330517467796,0.08292470719701639,97.59373331069946,49.14139175415039,119.10649108886719,4390,699,3691,3691,0,10,783000.0
783,783999,20.477906962081384,34.95798266856376,0.08291947886739359,97.7278060913086,49.20385003089905,119.32725143432617,4394,700,3694,3694,0,10,784000.0
784,784999,20.472745857582606,34.963739172435965,0.0828767748578243,97.84184741973877,49.266921520233154,119.53428268432617,4395,700,3695,3695,0,10,785000.0
785,785999,20.467096123735878,34.954531202779705,0.08286556130672496,97.97134041786194,49.32859563827515,119.63934326171875,4397,701,3696,3696,0,10,786000.0
786,786999,20.461478363392658,34.94569832509378,0.0828608059612369,98.0915756225586,49.3907630443573,119.74288177490234,4397,701,3696,3696,0,10,787000.0
787,787999,20.457296358340407,34.95482031822286,0.08276872539341751,98.22692131996155,49.45435428619385,119.86472702026367,4403,702,3701,3701,0,10,788000.0
788,788999,20.451548568990425,34.96589926084815,0.08269654450606767,98.36127710342407,49.51872229576111,119.97146987915039,4409,703,3706,3706,0,10,789000.0
789,789999,20.44500683077189,34.956925703514116,0.0826909009476825,98.48117542266846,49.57970881462097,120.17074584960938,4416,704,3712,3712,0,10,790000.0
790,790999,20.43923374321188,34.948550422950134,0.08269171793382779,98.60435032844543,49.63996410369873,120.31216049194336,4418,705,3713,3713,0,10,791000.0
791,791999,20.434979041883313,34.94495360120193,0.08267196668521193,98.71787977218628,49.69971776008606,120.47357559204102,4418,705,3713,3713,0,10,792000.0
792,792999,20.429711338019494,34.93892577957216,0.0826811086431366,98.84596014022827,49.76050686836243,120.51014709472656,4423,706,3717,3717,0,10,793000.0
793,793999,20.425882329533003,34.93191971330994,0.08270363519606205,98.97496247291565,49.82102966308594,120.85871124267578,4481,707,3774,3774,0,10,794000.0
794,794999,20.42108650580236,34.92062076940968,0.08266422932866369,99.10278153419495,49.89427709579468,121.23701095581055,4482,707,3775,3775,0,10,795000.0
795,795999,20.417410430100272,34.91240169378224,0.08263666072072373,99.26054430007935,49.96639919281006,121.3228530883789,4484,708,3776,3776,0,10,796000.0
796,796999,20.412065552726997,34.900233265290744,0.08261852898341149,99.39579677581787,50.03606939315796,121.44064331054688,4492,709,3783,3783,0,10,797000.0
797,797999,20.405574796268585,34.888832751591465,0.08260011345944729,99.51954245567322,50.10183238983154,122.29640197753906,4508,709,3799,3799,0,10,798000.0
798,798999,20.395285796559744,34.87261961365892,0.08267119476609464,99.63438820838928,50.16710829734802,122.60023880004883,4509,709,3800,3800,0,10,799000.0
799,799999,20.388436400757083,34.87602169588815,0.08259390999461824,99.76519322395325,50.2320659160614,122.81502914428711,4541,710,3831,3831,0,10,800000.0
800,800999,20.381953461114662,34.87004532511251,0.08254490545859872,99.88812208175659,50.297985553741455,123.15658950805664,4546,710,3836,3836,0,10,801000.0
801,801999,20.378516808306134,34.8697610610654,0.08241781814378679,100.0108208656311,50.36445355415344,123.35095977783203,4551,711,3840,3840,0,10,802000.0
802,802999,20.372381800088835,34.85870669362027,0.08236050834629016,100.14757370948792,50.430049657821655,123.5018196105957,4553,712,3841,3841,0,10,803000.0
803,803999,20.36570776063947,34.84725119646707,0.08227740976985543,100.27724814414978,50.49572396278381,123.65645980834961,4553,712,3841,3841,0,10,804000.0
804,804999,20.360800216052763,34.840521421331005,0.08219011484103111,100.4012987613678,50.56097674369812,123.8135871887207,4558,713,3845,3845,0,10,805000.0
805,805999,20.357572640673915,34.83382941057161,0.08205280955785799,100.54644894599915,50.62676119804382,123.88389205932617,4566,715,3851,3851,0,10,806000.0
806,806999,20.35553175428953,34.8293071324793,0.08193130370514168,100.68432188034058,50.69167971611023,124.16888046264648,4574,717,3857,3857,0,10,807000.0
807,807999,20.354314992375453,34.83837224096048,0.08182582942612282,100.8224356174469,50.75675106048584,124.24261856079102,4580,719,3861,3861,0,10,808000.0
808,808999,20.351675320750342,34.83349554057475,0.08166558378722655,100.97088932991028,50.8222770690918,124.37026977539062,4584,721,3863,3863,0,10,809000.0
809,809999,20.348629631474505,34.82747056444559,0.08159785384494223,101.10336089134216,50.896867990493774,124.53485870361328,4584,721,3863,3863,0,10,810000.0
810,810999,20.345920404275546,34.824027194003214,0.08148543429084898,101.2311577796936,50.96229529380798,124.65313339233398,4586,722,3864,3864,0,10,811000.0
811,811999,20.344314446865976,34.81940829636262,0.08143453815035007,101.36080002784729,51.028313875198364,124.77104949951172,4586,722,3864,3864,0,10,812000.0
812,812999,20.342298951000295,34.81251555529663,0.08133923029029777,101.48243808746338,51.097267150878906,125.0766487121582,4588,722,3866,3866,0,10,813000.0
813,813999,20.342382309075237,34.80831011255836,0.08126421168540965,101.6186797618866,51.161840200424194,125.20693969726562,4591,723,3868,3868,0,10,814000.0
814,814999,20.340092912729926,34.80011203416171,0.08122477219331614,101.74067831039429,51.22834897041321,125.33461380004883,4591,723,3868,3868,0,10,815000.0
815,815999,20.336863753604227,34.78937438404689,0.08117764697321417,101.8855333328247,51.29356098175049,125.33717346191406,4599,725,3874,3874,0,10,816000.0
816,816999,20.3359301970193,34.803126597276666,0.08098451455938549,102.00118446350098,51.35859274864197,126.04961395263672,4607,725,3882,3882,0,10,817000.0
817,817999,20.327706490796892,34.79032347254513,0.08098760972432306,102.1125876903534,51.42260122299194,126.37235641479492,4608,725,3883,3883,0,10,818000.0
818,818999,20.32054432937293,34.780392960057846,0.08099104191851891,102.25206851959229,51.49100947380066,126.62953186035156,4610,725,3885,3885,0,10,819000.0
819,819999,20.31447482340651,34.769211535683304,0.0810039776636895,102.37336611747742,51.55592727661133,126.80862426757812,4613,726,3887,3887,0,10,820000.0
820,820999,20.31063403128305,34.76546642415439,0.08099660072663706,102.51537466049194,51.62085294723511,126.96820449829102,4617,728,3889,3889,0,10,821000.0
821,821999,20.308211834084585,34.7594673102174,0.08101729105008304,102.6730420589447,51.68553018569946,127.09120178222656,4625,731,3894,3894,0,10,822000.0
822,822999,20.306544836223004,34.75424192189038,0.08107382018861753,102.81031680107117,51.75082516670227,127.26720428466797,4627,732,3895,3895,0,10,823000.0
823,823999,20.30654426374845,34.75182530520944,0.0812161311892331,102.9456057548523,51.82575345039368,127.47013092041016,4628,732,3896,3896,0,10,824000.0
824,824999,20.30830737679627,34.76285347568013,0.08117884793579777,103.08493041992188,51.89582562446594,127.5966682434082,4631,733,3898,3898,0,10,825000.0
825,825999,20.31011077056942,34.76426321106854,0.08134199829511246,103.21278285980225,51.96119999885559,127.7812728881836,4633,733,3900,3900,0,10,826000.0
826,826999,20.31551230021571,34.77441018364185,0.08144004970386409,103.34284949302673,52.02585959434509,128.0354995727539,4636,734,3902,3902,0,10,827000.0
827,827999,20.319154359935077,34.775850498424305,0.08155298016892853,103.46602821350098,52.09165668487549,128.24303817749023,4636,734,3902,3902,0,10,828000.0
828,828999,20.324492842675756,34.77706361551264,0.08166561709376496,103.60378289222717,52.156192779541016,128.44036102294922,4645,735,3910,3910,0,10,829000.0
829,829999,20.329418719034877,34.78301085357771,0.08178539034079102,103.73011207580566,52.22079634666443,128.58103942871094,4647,736,3911,3911,0,10,830000.0
830,830999,20.334827846853965,34.78813289241291,0.08204265911178832,103.85646319389343,52.28637456893921,128.72003555297852,4647,736,3911,3911,0,10,831000.0
831,831999,20.34024463015635,34.79146957949216,0.08218288716081668,103.97267746925354,52.350494384765625,128.8447265625,4648,736,3912,3912,0,10,832000.0
832,832999,20.348525298387873,34.80009504796405,0.08229435012609931,104.12129282951355,52.41639828681946,129.04814910888672,4661,738,3923,3923,0,10,833000.0
833,833999,20.356258662501677,34.80702141494924,0.08246218029072527,104.27778482437134,52.48155474662781,129.15611267089844,4667,741,3926,3926,0,10,834000.0
834,834999,20.359033254775348,34.80555295145171,0.0826475666300377,104.41080045700073,52.546905755996704,129.3540382385254,4669,742,3927,3927,0,10,835000.0
835,835999,20.360575890569358,34.80061066312845,0.08271132443533402,104.54025053977966,52.61297559738159,129.4920310974121,4671,743,3928,3928,0,10,836000.0
836,836999,20.35810068549771,34.795691476537556,0.08269249350773888,104.66318917274475,52.677109718322754,130.02970504760742,4676,743,3933,3933,0,10,837000.0
837,837999,20.355043769029415,34.801005094133465,0.0826090868597199,104.79536128044128,52.74453401565552,130.34455108642578,4678,743,3935,3935,0,10,838000.0
838,838999,20.352412905608023,34.80291975271524,0.08257182103643701,104.91991972923279,52.808544635772705,130.51517486572266,4678,743,3935,3935,0,10,839000.0
839,839999,20.35109356891562,34.80322667690203,0.08256477835306653,105.0830888748169,52.88022541999817,130.6549186706543,4685,745,3940,3940,0,10,840000.0
840,840999,20.352135263606474,34.80291670334606,0.08250947841369749,105.2279679775238,52.94626569747925,131.02059173583984,4721,747,3974,3974,0,10,841000.0
841,841999,20.35476983722883,34.81211418243971,0.08239473437758293,105.33736944198608,53.01074743270874,131.22305297851562,4721,747,3974,3974,0,10,842000.0
842,842999,20.356678442089468,34.82162060651574,0.08231876379127112,105.49020957946777,53.07587814331055,131.29738998413086,4725,749,3976,3976,0,10,843000.0
843,843999,20.364146117972833,34.85401181060814,0.08224522525193534,105.63511800765991,53.1452796459198,131.4084930419922,4727,750,3977,3977,0,10,844000.0
844,844999,20.371578714416774,34.88707413763322,0.0821467339784242,105.77592444419861,53.21031069755554,131.73660278320312,4800,752,4048,4048,0,10,845000.0
845,845999,20.386835735277536,34.94701696653641,0.08187885874007927,105.9078528881073,53.275092363357544,132.3772964477539,4801,752,4049,4049,0,10,846000.0
846,846999,20.39986667959992,35.00114916564283,0.08173300993048449,106.02909183502197,53.3403856754303,132.69860458374023,4801,752,4049,4049,0,10,847000.0
847,847999,20.416715687371255,35.059070333321465,0.08160950222835095,106.15656733512878,53.40443277359009,132.94031524658203,4806,753,4053,4053,0,10,848000.0
848,848999,20.430955267446766,35.10030395204055,0.08168001426171356,106.29836082458496,53.46901035308838,133.0630111694336,4809,754,4055,4055,0,10,849000.0
849,849999,20.450740162746534,35.15554536989465,0.08174038283442642,106.43184280395508,53.53311610221863,133.22499465942383,4815,755,4060,4060,0,10,850000.0
850,850999,20.472710003685222,35.214566915218384,0.08171177131621721,106.57364177703857,53.59737467765808,133.2306251525879,4821,757,4064,4064,0,10,851000.0
851,851999,20.493410239427526,35.25904617976429,0.08226898137758276,106.70079469680786,53.66205811500549,133.3594741821289,4826,758,4068,4068,0,10,852000.0
852,852999,20.503832320174464,35.278194058360285,0.08221299151217842,106.84019875526428,53.726974964141846,133.79127502441406,4863,759,4104,4104,0,10,853000.0
853,853999,20.52024399414289,35.366022270333545,0.08202995489258469,106.9582245349884,53.79124593734741,134.2457275390625,4865,759,4106,4106,0,10,854000.0
854,854999,20.5439103403674,35.4674723284158,0.08231158288563711,107.08836388587952,53.855156898498535,134.5106658935547,4877,760,4117,4117,0,10,855000.0
855,855999,20.564890068443404,35.54996141308382,0.08200335680923954,107.23258996009827,53.92097568511963,134.87218475341797,4885,761,4124,4124,0,10,856000.0
856,856999,20.586165661042195,35.62789337789973,0.08184288912905602,107.34895730018616,53.98536920547485,135.21549606323242,4885,761,4124,4124,0,10,857000.0
857,857999,20.602915521597104,35.67765003098612,0.08191764945578273,107.50543594360352,54.050185441970825,135.25321578979492,4891,764,4127,4127,0,10,858000.0
858,858999,20.62129876729508,35.72541685158891,0.0820519559248647,107.6427206993103,54.115517139434814,135.42107009887695,4895,765,4130,4130,0,10,859000.0
859,859999,20.639010118254205,35.76929487873299,0.08211587157679157,107.7743272781372,54.18103814125061,135.64915084838867,4898,766,4132,4132,0,10,860000.0
860,860999,20.655994102569142,35.80407660335734,0.08243930998241922,107.89711713790894,54.24557089805603,135.98491668701172,4930,767,4163,4163,0,10,861000.0
861,861999,20.668216473167483,35.82274298792377,0.08241875194458081,108.01736736297607,54.310473680496216,136.14279556274414,4932,768,4164,4164,0,10,862000.0
862,862999,20.683723290242337,35.85378682510121,0.08267726006062626,108.15811681747437,54.37552285194397,136.29097366333008,4934,769,4165,4165,0,10,863000.0
863,863999,20.699568545141506,35.9073278734845,0.08268738294157829,108.29020595550537,54.44069790840149,136.46709060668945,4936,770,4166,4166,0,10,864000.0
864,864999,20.719551486171945,35.97231371258801,0.08290263095583361,108.4023985862732,54.50471043586731,136.60306549072266,4936,770,4166,4166,0,10,865000.0
865,865999,20.737159649617986,35.99864225586957,0.08301716422566663,108.52071714401245,54.569454193115234,136.79379653930664,4936,770,4166,4166,0,10,866000.0
866,866999,20.75672249369557,36.04539678643324,0.08315493214853842,109.1574478149414,54.634193897247314,136.69575119018555,4952,775,4177,4177,0,10,867000.0
867,867999,20.77563099530373,36.06912903263471,0.0834210140671271,109.28711175918579,54.69962120056152,136.86749649047852,4954,776,4178,4178,0,10,868000.0
868,868999,20.78815037842555,36.092859128337594,0.08343471185602325,109.43232250213623,54.76547193527222,137.33406829833984,4972,778,4194,4194,0,10,869000.0
869,869999,20.800274900441174,36.150696668126436,0.08323682167163937,109.56506180763245,54.83291268348694,137.79880142211914,4978,779,4199,4199,0,10,870000.0
870,870999,20.810767778210483,36.19798193869613,0.08301077616565022,109.68355441093445,54.89876079559326,138.1019515991211,4980,779,4201,4201,0,10,871000.0
871,871999,20.822931756891283,36.23102001786025,0.08285023826061833,109.83804297447205,54.963706970214844,138.28443908691406,5020,782,4238,4238,0,10,872000.0
872,872999,20.836656287236803,36.27008120262141,0.08286517672481797,109.95871615409851,55.02863574028015,138.5406265258789,5022,782,4240,4240,0,10,873000.0
873,873999,20.852295931753176,36.33016690536966,0.08298049016143427,110.10470533370972,55.09414505958557,138.78317260742188,5027,784,4243,4243,0,10,874000.0
874,874999,20.86439714393391,36.357619121450305,0.08320750032836599,110.24125361442566,55.159541606903076,138.93752670288086,5030,785,4245,4245,0,10,875000.0
875,875999,20.878557489903457,36.404503626201254,0.08402525662724725,110.3585455417633,55.22450137138367,139.09713745117188,5030,785,4245,4245,0,10,876000.0
876,876999,20.893610964662365,36.43985141995357,0.08455537454074591,110.50357055664062,55.29200291633606,139.14358139038086,5038,787,4251,4251,0,10,877000.0
877,877999,20.911951090622146,36.5035320803326,0.08534206338653649,110.64051008224487,55.35769748687744,139.32534790039062,5046,788,4258,4258,0,10,878000.0
878,878999,20.93094563958519,36.54481281087309,0.08611577338499687,110.7850775718689,55.42376399040222,139.53427124023438,5055,790,4265,4265,0,10,879000.0
879,879999,20.94929411024237,36.581099606737844,0.08653406189891699,110.94384956359863,55.49036121368408,139.64100646972656,5064,792,4272,4272,0,10,880000.0
880,880999,20.969568351891347,36.62474982923764,0.08744645825361075,111.10666251182556,55.55825662612915,139.75107955932617,5070,795,4275,4275,0,10,881000.0
881,881999,20.987559774818127,36.65786192279149,0.08804339476394585,111.23881411552429,55.62361192703247,139.91915893554688,5077,796,4281,4281,0,10,882000.0
882,882999,21.010226726116993,36.710884693391456,0.08904140513585901,111.37665700912476,55.689210414886475,140.0411491394043,5079,797,4282,4282,0,10,883000.0
883,883999,21.029149174035883,36.74304397673486,0.08983588823258526,111.48944878578186,55.75420355796814,140.1572151184082,5079,797,4282,4282,0,10,884000.0
884,884999,21.046490048841584,36.76765920295073,0.09036836798489534,111.62595915794373,55.819621086120605,140.32129669189453,5083,798,4285,4285,0,10,885000.0
885,885999,21.064098861552083,36.79566292766434,0.09096736296814789,111.80007791519165,55.885793924331665,140.33591079711914,5097,802,4295,4295,0,10,886000.0
886,886999,21.085091741821238,36.842404778441825,0.09162238074563567,111.94524097442627,55.95093274116516,140.3490219116211,5110,804,4306,4306,0,10,887000.0
887,887999,21.099242250061682,36.85513774327253,0.09217241148552724,112.08381605148315,56.01652550697327,140.48895645141602,5112,805,4307,4307,0,10,888000.0
888,888999,21.10987274249556,36.87772927579853,0.09220413772057723,112.22129321098328,56.08708691596985,141.1959457397461,5130,806,4324,4324,0,10,889000.0
889,889999,21.109521217860788,36.88123909446483,0.09206654888313925,112.36366820335388,56.15191292762756,141.51684188842773,5135,808,4327,4327,0,10,890000.0
890,890999,21.113884027473848,36.90462719668387,0.09190580491851408,112.49954152107239,56.21800923347473,141.77954483032227,5165,809,4356,4356,0,10,891000.0
891,891999,21.117832740628465,36.91681927192382,0.09178250690513035,112.61767578125,56.28290295600891,141.99306106567383,5165,809,4356,4356,0,10,892000.0
892,892999,21.12043231860655,36.924261294946675,0.09167274117424384,112.77400541305542,56.35289144515991,142.15871047973633,5199,811,4388,4388,0,10,893000.0
893,893999,21.12432885518147,36.93209265670563,0.09161380114407347,112.90629005432129,56.418721199035645,142.37837982177734,5201,812,4389,4389,0,10,894000.0
894,894999,21.1270402613067,36.93606666178344,0.0915322160371973,113.04306387901306,56.48405480384827,142.52264022827148,5203,813,4390,4390,0,10,895000.0
895,895999,21.13187114637671,36.94416133697796,0.09151696312977697,113.1870219707489,56.54949426651001,142.56493759155273,5207,815,4392,4392,0,10,896000.0
896,896999,21.135665078732917,36.95043891853395,0.0915515807146513,113.3306610584259,56.61496448516846,142.63573455810547,5212,817,4395,4395,0,10,897000.0
897,897999,21.143086781631172,36.96780521682831,0.09160019462495961,113.45433712005615,56.68008089065552,142.8069725036621,5212,817,4395,4395,0,10,898000.0
898,898999,21.15153543679545,36.982921784594446,0.0918113279144871,113.59762358665466,56.745452880859375,142.91131591796875,5221,819,4402,4402,0,10,899000.0
899,899999,21.15726895652815,36.99181455724144,0.09186164590292101,113.73170733451843,56.810387134552,143.08824157714844,5223,820,4403,4403,0,10,900000.0
900,900999,21.165792337436997,37.00326988167456,0.09206390583775403,113.86565661430359,56.875651836395264,143.1831512451172,5225,821,4404,4404,0,10,901000.0
901,901999,21.173444200281597,37.015604528728005,0.09227277479004403,113.99294018745422,56.94019937515259,143.24810028076172,5227,822,4405,4405,0,10,902000.0
902,902999,21.18515693625632,37.03479645064592,0.0925767099825181,114.12097477912903,57.00479340553284,143.36731719970703,5227,822,4405,4405,0,10,903000.0
903,903999,21.198433519043363,37.05817165683144,0.09303596220519461,114.26390480995178,57.07032036781311,143.41986846923828,5233,823,4410,4410,0,10,904000.0
904,904999,21.21227383326954,37.07712089060795,0.09333678233932385,114.41082334518433,57.13707375526428,143.54203033447266,5238,825,4413,4413,0,10,905000.0
905,905999,21.224127298007907,37.093094509140585,0.09366083603583508,114.57036399841309,57.20241117477417,143.57562255859375,5247,828,4419,4419,0,10,906000.0
906,906999,21.23757173127627,37.11760990809446,0.09404519928782362,114.71162271499634,57.267762184143066,143.67614364624023,5253,829,4424,4424,0,10,907000.0
907,907999,21.25318523213113,37.14033305079595,0.09465624754238511,114.83605670928955,57.332484006881714,143.74599075317383,5255,830,4425,4425,0,10,908000.0
908,908999,21.26027180166247,37.14649571420191,0.09491633258896581,114.96978092193604,57.397303104400635,143.91250228881836,5259,831,4428,4428,0,10,909000.0
909,909999,21.2621715939106,37.16669281535867,0.09473579338619176,115.15198302268982,57.47060751914978,144.43111038208008,5273,834,4439,4439,0,10,910000.0
910,910999,21.26133470557284,37.1683169926569,0.09461955658182919,115.28587698936462,57.53600740432739,144.62770080566406,5277,835,4442,4442,0,10,911000.0
911,911999,21.263865028764258,37.175284505963475,0.09441393948269372,115.41126298904419,57.60190200805664,144.8494644165039,5277,835,4442,4442,0,10,912000.0
912,912999,21.268496043473313,37.189323073835894,0.09416114927421271,115.57380938529968,57.667744874954224,145.0557746887207,5288,838,4450,4450,0,10,913000.0
913,913999,21.271564413123265,37.193805833344854,0.09388590386784357,115.71275496482849,57.73983550071716,145.17815399169922,5290,839,4451,4451,0,10,914000.0
914,914999,21.27521481726785,37.198909824382426,0.0936667231667967,115.87275910377502,57.80616211891174,145.18304443359375,5334,842,4492,4492,0,10,915000.0
915,915999,21.278642414789587,37.2016851876569,0.09354908397326023,116.02962946891785,57.87221670150757,145.2450714111328,5338,844,4494,4494,0,10,916000.0
916,916999,21.28172419706653,37.21039156804056,0.09345382187758,116.16778421401978,57.938880443573,145.42069244384766,5340,844,4496,4496,0,10,917000.0
917,917999,21.285220650645545,37.21472461238302,0.09335184535318375,116.28192615509033,58.004090547561646,145.56301879882812,5341,844,4497,4497,0,10,918000.0
918,918999,21.293386533392923,37.255252898918904,0.0931840131935584,116.42517375946045,58.06993222236633,146.00645065307617,5343,845,4498,4498,0,10,919000.0
919,919999,21.29564626803197,37.25683606247805,0.09315793010499529,116.55608415603638,58.136096239089966,146.2220687866211,5345,846,4499,4499,0,10,920000.0
920,920999,21.300000570578135,37.26152233898327,0.09311691335102545,116.67624616622925,58.20115613937378,146.4533233642578,5345,846,4499,4499,0,10,921000.0
921,921999,21.304247847949902,37.265331779171625,0.09308289866314146,116.85057020187378,58.2669792175293,146.49491500854492,5364,850,4514,4514,0,10,922000.0
922,922999,21.310119965379002,37.27905654499512,0.09312212230228123,117.01013708114624,58.332499504089355,146.59186935424805,5371,852,4519,4519,0,10,923000.0
923,923999,21.31498545821545,37.28195248734759,0.0931343390379944,117.14706325531006,58.39814472198486,146.7608184814453,5375,853,4522,4522,0,10,924000.0
924,924999,21.319936472843207,37.288342873599994,0.09306429752643774,117.30386662483215,58.463279247283936,146.80936813354492,5383,855,4528,4528,0,10,925000.0
925,925999,21.325256015347566,37.294573170736314,0.09305123283738093,117.4246768951416,58.527910232543945,146.90078735351562,5383,855,4528,4528,0,10,926000.0
926,926999,21.321242063806856,37.286112287020444,0.09307953336359465,117.59307265281677,58.59409976005554,147.4589080810547,5411,858,4553,4553,0,10,927000.0
927,927999,21.316930811472506,37.282817449408974,0.09303544121082208,117.71990442276001,58.660889863967896,147.80361938476562,5417,859,4558,4558,0,10,928000.0
928,928999,21.31368913602708,37.27844546368063,0.09298513342888148,117.83540678024292,58.726680278778076,148.06593704223633,5417,859,4558,4558,0,10,929000.0
929,929999,21.30947328513919,37.26932863569406,0.09294950461093432,117.99044299125671,58.79279017448425,148.15793991088867,5427,862,4565,4565,0,10,930000.0
930,930999,21.30828960913321,37.263342596067545,0.09288896923748369,118.12314701080322,58.85909700393677,148.50720977783203,5461,863,4598,4598,0,10,931000.0
931,931999,21.30513947493521,37.25626294042636,0.09283409649416785,118.26561188697815,58.92470836639404,148.67499542236328,5463,864,4599,4599,0,10,932000.0
932,932999,21.301665823453263,37.248478001837654,0.09275133086958576,118.38555645942688,58.990623235702515,148.86551666259766,5463,864,4599,4599,0,10,933000.0
933,933999,21.3011469479855,37.26461002516856,0.09254451057212165,118.52352166175842,59.05703330039978,148.99392700195312,5466,865,4601,4601,0,10,934000.0
934,934999,21.298279911468473,37.25558129924453,0.092481140702939,118.67643785476685,59.12243318557739,149.0445556640625,5471,867,4604,4604,0,10,935000.0
935,935999,21.29795317354632,37.25492674298789,0.09231663277728652,118.82238602638245,59.18895363807678,149.23741149902344,5476,869,4607,4607,0,10,936000.0
936,936999,21.297692610048077,37.25006488833271,0.09214526110490406,118.95995330810547,59.25528860092163,149.37808227539062,5478,870,4608,4608,0,10,937000.0
937,937999,21.29966468102694,37.250189144839375,0.09207754381637112,119.10451698303223,59.32072567939758,149.42408752441406,5485,872,4613,4613,0,10,938000.0
938,938999,21.301880516329028,37.256529247444234,0.09192221375553067,119.25731229782104,59.38798427581787,149.4987907409668,5489,874,4615,4615,0,10,939000.0
939,939999,21.305178402150844,37.25782656787109,0.09188569884583642,119.37932062149048,59.45352864265442,149.64711380004883,5489,874,4615,4615,0,10,940000.0
940,940999,21.309094425706675,37.26243266059138,0.09182474562296872,119.5067310333252,59.518699645996094,149.7521858215332,5491,875,4616,4616,0,10,941000.0
941,941999,21.311282457768122,37.26124099495929,0.09170839007790776,119.65725564956665,59.59006214141846,149.97219848632812,5493,875,4618,4618,0,10,942000.0
942,942999,21.316238252040826,37.26316170961182,0.0915874128197699,119.81609892845154,59.654993295669556,149.98252487182617,5497,877,4620,4620,0,10,943000.0
943,943999,21.318310261893213,37.26053230160994,0.09151206001102963,119.9412751197815,59.71997094154358,150.1085090637207,5503,878,4625,4625,0,10,944000.0
944,944999,21.320547724036498,37.264455793065935,0.09140315198789173,120.06809902191162,59.78477430343628,150.19604110717773,5503,878,4625,4625,0,10,945000.0
945,945999,21.321823614429547,37.261606577139084,0.09134851248521692,120.19162082672119,59.849711656570435,150.5406494140625,5510,878,4632,4632,0,10,946000.0
946,946999,21.318541428624123,37.26821810150875,0.09125121549081194,120.33383178710938,59.91414523124695,150.94794845581055,5514,880,4634,4634,0,10,947000.0
947,947999,21.31266624861076,37.25959005002411,0.0912241414498739,120.4665412902832,59.97834610939026,151.1703224182129,5518,881,4637,4637,0,10,948000.0
948,948999,21.305652937158367,37.248644509750314,0.0912387964239253,120.61389565467834,60.04347085952759,151.3133316040039,5523,883,4640,4640,0,10,949000.0
949,949999,21.30251011999579,37.24737448834817,0.09117394198895867,120.75941252708435,60.10780096054077,151.46387481689453,5574,885,4689,4689,0,10,950000.0
950,950999,21.298820341058633,37.239727917665085,0.09112356298805424,120.91061520576477,60.17349171638489,151.6645736694336,5579,887,4692,4692,0,10,951000.0
951,951999,21.295607042535046,37.23079464869056,0.09107213041284123,121.04268646240234,60.23811149597168,151.787841796875,5585,888,4697,4697,0,10,952000.0
952,952999,21.292388882375985,37.22330066706087,0.09100267505004533,121.19521307945251,60.304221630096436,151.91511917114258,5587,889,4698,4698,0,10,953000.0
953,953999,21.2890914824871,37.21522328641844,0.09093601987755384,121.31869769096375,60.36890959739685,152.0047264099121,5589,890,4699,4699,0,10,954000.0
954,954999,21.28666284653511,37.21176795108397,0.09085104951020384,121.45047926902771,60.433316230773926,152.1850471496582,5592,890,4702,4702,0,10,955000.0
955,955999,21.28486114625432,37.205384257936394,0.09081614275145267,121.61613464355469,60.4990131855011,152.1607780456543,5604,893,4711,4711,0,10,956000.0
956,956999,21.283679969312132,37.20083571812685,0.09073328645152423,121.75978207588196,60.56504559516907,152.3901824951172,5607,894,4713,4713,0,10,957000.0
957,957999,21.28401781943163,37.19739174918303,0.09069322966088489,121.89265727996826,60.6294891834259,152.54858779907227,5609,895,4714,4714,0,10,958000.0
958,958999,21.284250301181775,37.19166221285816,0.09065189664349071,122.01880598068237,60.69413113594055,152.71521377563477,5609,895,4714,4714,0,10,959000.0
959,959999,21.286681426272587,37.19204289540352,0.09059509736051563,122.1554045677185,60.76103377342224,152.7858428955078,5614,896,4718,4718,0,10,960000.0
960,960999,21.290649399107316,37.197134393601665,0.09053391567285218,122.29017639160156,60.826531410217285,152.8959503173828,5616,897,4719,4719,0,10,961000.0
961,961999,21.292798222323807,37.19783672500589,0.0904782171309324,122.43583393096924,60.89120602607727,152.9399070739746,5621,899,4722,4722,0,10,962000.0
962,962999,21.29533766243143,37.196522558083196,0.090440192464461,122.58542084693909,60.956411361694336,153.15935134887695,5629,901,4728,4728,0,10,963000.0
963,963999,21.298948680764166,37.196287496622816,0.09042952830805395,122.72055244445801,61.022674322128296,153.3089485168457,5631,902,4729,4729,0,10,964000.0
964,964999,21.30274182580001,37.19500217034058,0.09041091971413084,122.83538103103638,61.08763551712036,153.47224807739258,5631,902,4729,4729,0,10,965000.0
965,965999,21.303582362571742,37.1891117843604,0.09038472581813617,123.0013358592987,61.155662298202515,153.5201416015625,5636,904,4732,4732,0,10,966000.0
966,966999,21.302788791347812,37.189645456492414,0.09033858436392372,123.1580114364624,61.22020220756531,153.9105224609375,5653,906,4747,4747,0,10,967000.0
967,967999,21.295387167510977,37.17946881255459,0.09034093004521138,123.30374598503113,61.28491806983948,154.16511917114258,5657,908,4749,4749,0,10,968000.0
968,968999,21.287409593867064,37.1674250297439,0.09035911442854672,123.44197869300842,61.35031485557556,154.3059196472168,5663,909,4754,4754,0,10,969000.0
969,969999,21.280206978804248,37.15815767892627,0.0903576765166505,123.57317209243774,61.41541934013367,154.44318389892578,5666,910,4756,4756,0,10,970000.0
970,970999,21.273348714857185,37.14728631474697,0.09032882677907617,123.70935773849487,61.480910301208496,154.60190200805664,5669,911,4758,4758,0,10,971000.0
971,971999,21.2655485146825,37.133770092036606,0.09035482879998746,123.85277724266052,61.54584550857544,154.89177322387695,5679,913,4766,4766,0,10,972000.0
972,972999,21.257671336945275,37.12156830053321,0.09035617589862799,123.98445796966553,61.611287355422974,155.02800369262695,5681,914,4767,4767,0,10,973000.0
973,973999,21.250529873464142,37.110345915852335,0.09035193441500367,124.13400316238403,61.676631689071655,155.09414291381836,5689,916,4773,4773,0,10,974000.0
974,974999,21.24297268672792,37.09786588783876,0.09035632985276398,124.25749611854553,61.742202281951904,155.26438522338867,5689,916,4773,4773,0,10,975000.0
975,975999,21.23638793087407,37.08615305012984,0.09034591800506586,124.40463614463806,61.80720043182373,155.39507675170898,5692,917,4775,4775,0,10,976000.0
976,976999,21.23096989812038,37.08000661992827,0.09031781520196391,124.55520749092102,61.872986793518066,155.5037612915039,5698,919,4779,4779,0,10,977000.0
977,977999,21.225981342642562,37.06853286410454,0.09028506204804354,124.69959878921509,61.937424182891846,155.61435317993164,5703,921,4782,4782,0,10,978000.0
978,978999,21.22260207625949,37.0839308366486,0.09013149095389172,124.86076402664185,62.003150939941406,155.6956443786621,5710,922,4788,4788,0,10,979000.0
979,979999,21.21766819521151,37.07415043621527,0.09012321250678157,125.00223159790039,62.06919264793396,155.78674697875977,5714,924,4790,4790,0,10,980000.0
980,980999,21.2120356694195,37.062637568217006,0.0901335424460894,125.16510653495789,62.13484501838684,155.86656951904297,5728,927,4801,4801,0,10,981000.0
981,981999,21.209444208799972,37.05675417937332,0.09011264832867927,125.30023145675659,62.20023560523987,155.9751853942871,5730,928,4802,4802,0,10,982000.0
982,982999,21.206378174130272,37.049088871511444,0.09007628002726942,125.44393420219421,62.26477384567261,156.08703231811523,5733,929,4804,4804,0,10,983000.0
983,983999,21.203110275007152,37.039767128941655,0.09003121232556,125.564444065094,62.32932186126709,156.21685028076172,5733,929,4804,4804,0,10,984000.0
984,984999,21.200691954519133,37.031321384048034,0.09000032219502574,125.72581624984741,62.39432621002197,156.20084381103516,5741,932,4809,4809,0,10,985000.0
985,985999,21.19627078932829,37.02116542157528,0.08998337687843505,125.88187217712402,62.45953154563904,156.25556564331055,5750,934,4816,4816,0,10,986000.0
986,986999,21.191355157406175,37.01046467541948,0.0899600895460626,126.00719809532166,62.52653217315674,156.41129684448242,5750,934,4816,4816,0,10,987000.0
987,987999,21.19248754213657,37.02625679811429,0.08987331256322684,126.13699626922607,62.59107279777527,157.00618743896484,5760,935,4825,4825,0,10,988000.0
988,988999,21.19726657429594,37.05835932311541,0.0896976971981368,126.28077244758606,62.655388593673706,157.2518310546875,5765,937,4828,4828,0,10,989000.0
989,989999,21.205115856604685,37.116879389836555,0.08949469844357583,126.44227409362793,62.71969962120056,157.40697479248047,5802,940,4862,4862,0,10,990000.0
990,990999,21.206215081558657,37.12092035742338,0.08951397166356723,126.57559537887573,62.78868865966797,157.60969924926758,5804,941,4863,4863,0,10,991000.0
991,991999,21.20870200195877,37.122039922879395,0.08951377750188616,126.76071357727051,62.85881590843201,157.71547317504883,5813,945,4868,4868,0,10,992000.0
992,992999,21.216309412903215,37.13334215667712,0.08938396346752442,126.94098901748657,62.92395496368408,157.8222770690918,5853,949,4904,4904,0,10,993000.0
993,993999,21.223308819863774,37.1406029547107,0.08911757627844796,127.06289172172546,62.98850631713867,157.98348999023438,5853,949,4904,4904,0,10,994000.0
994,994999,21.228017667333365,37.147041863527605,0.089003121019811,127.18905520439148,63.05335259437561,158.13716888427734,5853,949,4904,4904,0,10,995000.0
995,995999,21.232922488042654,37.151354084002,0.08883772663727219,127.31454396247864,63.11901021003723,158.31081771850586,5886,950,4936,4936,0,10,996000.0
996,996999,21.236102612441325,37.15317016435984,0.08876743452908242,127.47198390960693,63.18461465835571,158.31365585327148,5890,952,4938,4938,0,10,997000.0
997,997999,21.242830532221777,37.15677454339291,0.08842051316465216,127.64937448501587,63.250285148620605,158.43148040771484,5900,955,4945,4945,0,10,998000.0
998,998999,21.249780070257405,37.16474060974609,0.08803354915373907,127.82690072059631,63.31575846672058,158.43233108520508,5915,959,4956,4956,0,10,999000.0
999,999999,21.25638678843978,37.17234451084563,0.08777662458004454,127.95860004425049,63.3817183971405,158.5598907470703,5917,960,4957,4957,0,10,1000000.0
1000,1000999,21.261024097710397,37.17347971110369,0.0874901110828703,128.10716581344604,63.44671607017517,158.68529510498047,5922,961,4961,4961,0,10,1001000.0
1001,1001999,21.26669168516838,37.18512642535187,0.08729105534539139,128.22192001342773,63.5121169090271,158.8357048034668,5922,961,4961,4961,0,10,1002000.0
1002,1002999,21.271940872804397,37.18723519789069,0.08710454315770733,128.34775853157043,63.577362060546875,158.92523956298828,5922,961,4961,4961,0,10,1003000.0
1003,1003999,21.275477945079047,37.186923342855046,0.08692398220003295,128.49511218070984,63.645888805389404,159.0747299194336,5931,962,4969,4969,0,10,1004000.0
1004,1004999,21.279611147614094,37.18626814555513,0.08673785310530291,128.636323928833,63.71121025085449,159.1534080505371,5933,963,4970,4970,0,10,1005000.0
1005,1005999,21.282063108204643,37.18441394712171,0.08657929917734497,128.78070759773254,63.7765474319458,159.2590103149414,5938,965,4973,4973,0,10,1006000.0
1006,1006999,21.285177023721623,37.18969682774691,0.08641609540013506,128.93177342414856,63.84129619598389,159.39790725708008,5943,966,4977,4977,0,10,1007000.0
1007,1007999,21.283797334393192,37.18428256030828,0.08632910199112187,129.1043140888214,63.90655446052551,159.94826889038086,5970,969,5001,5001,0,10,1008000.0
1008,1008999,21.279080800286618,37.181151638871015,0.08627149153560187,129.2249972820282,63.97303867340088,160.31581115722656,5972,969,5003,5003,0,10,1009000.0
1009,1009999,21.273646055160864,37.17463199338623,0.08624077180791212,129.35871529579163,64.03897452354431,160.54465866088867,5978,970,5008,5008,0,10,1010000.0
1010,1010999,21.268722445252024,37.169202655020314,0.08622310058495786,129.52331137657166,64.10480260848999,160.63854598999023,6018,974,5044,5044,0,10,1011000.0
1011,1011999,21.264998425868942,37.1634321933819,0.0861869973237569,129.69265627861023,64.17109441757202,160.78153228759766,6031,977,5054,5054,0,10,1012000.0
1012,1012999,21.261496746062097,37.15625679950223,0.08614548067877881,129.84291648864746,64.23701667785645,161.10028076171875,6040,979,5061,5061,0,10,1013000.0
1013,1013999,21.25942046145812,37.14941076983862,0.08610405027999068,129.9757297039032,64.30267143249512,161.26897811889648,6042,980,5062,5062,0,10,1014000.0
1014,1014999,21.25639277124815,37.14453502053456,0.08607850931941907,130.09999704360962,64.36755537986755,161.38628387451172,6044,981,5063,5063,0,10,1015000.0
1015,1015999,21.2530127306297,37.13761468199064,0.08606007818740358,130.2655975818634,64.43360233306885,161.38414001464844,6051,984,5067,5067,0,10,1016000.0
1016,1016999,21.251124392622916,37.13204906330537,0.08609545861971313,130.40344858169556,64.49925780296326,161.5634307861328,6055,985,5070,5070,0,10,1017000.0
1017,1017999,21.253453991012943,37.1331398751714,0.08612007390954968,130.60632157325745,64.57253432273865,161.64760208129883,6067,989,5078,5078,0,10,1018000.0
1018,1018999,21.257517811531454,37.138746404310616,0.08612180864659191,130.73650121688843,64.63769817352295,161.83158111572266,6069,990,5079,5079,0,10,1019000.0
1019,1019999,21.260217387398473,37.13898491846944,0.08622442979562195,130.86670351028442,64.70337080955505,161.9515495300293,6074,991,5083,5083,0,10,1020000.0
1020,1020999,21.262314247304435,37.139513408654,0.08627020726008183,131.00324177742004,65.31153631210327,162.06130981445312,6076,992,5084,5084,0,10,1021000.0
1021,1021999,21.267591540327846,37.14411747179445,0.08628674000347558,131.13697695732117,65.37704992294312,162.16525650024414,6078,993,5085,5085,0,10,1022000.0
1022,1022999,21.271309171878634,37.146399314739284,0.08639186095280871,131.30127120018005,65.44264769554138,162.2155990600586,6084,995,5089,5089,0,10,1023000.0
1023,1023999,21.276305834326607,37.14720780453252,0.08640331662711975,131.43669652938843,65.50853443145752,162.43749618530273,6089,996,5093,5093,0,10,1024000.0
1024,1024999,21.28001792941178,37.14661699724748,0.08643270102097589,131.59582924842834,65.57493495941162,162.53631973266602,6093,998,5095,5095,0,10,1025000.0
1025,1025999,21.285423150181327,37.149895326835725,0.08647949760576934,131.74599933624268,65.64085459709167,162.66432571411133,6097,1000,5097,5097,0,10,1026000.0
1026,1026999,21.288019075980493,37.14766780690043,0.08654707210432655,131.88507723808289,65.70688104629517,162.7837791442871,6099,1001,5098,5098,0,10,1027000.0
1027,1027999,21.288164392350023,37.14303876816302,0.08653908841546476,132.01571893692017,65.77395153045654,162.94744491577148,6099,1001,5098,5098,0,10,1028000.0
1028,1028999,21.28295510294283,37.13534886253904,0.08649311846527974,132.212420463562,65.84288811683655,163.63829040527344,6136,1006,5130,5130,0,10,1029000.0
1029,1029999,21.277224812693145,37.12884439033532,0.08647675421635981,132.36352682113647,65.909334897995,163.85487365722656,6148,1008,5140,5140,0,10,1030000.0
1030,1030999,21.271715906268103,37.12033848090605,0.08648603482114414,132.52485537528992,65.98350095748901,164.07269287109375,6150,1009,5141,5141,0,10,1031000.0
1031,1031999,21.265639146522716,37.110357849574136,0.08649515011084996,132.65685510635376,66.0492811203003,164.22504425048828,6155,1010,5145,5145,0,10,1032000.0
1032,1032999,21.260035251470978,37.10159390274576,0.08647633983274072,132.81582736968994,66.11562204360962,164.40978240966797,6159,1012,5147,5147,0,10,1033000.0
1033,1033999,21.25594580599648,37.094494108915825,0.08643943223470651,132.9662148952484,66.18168687820435,164.5246124267578,6168,1014,5154,5154,0,10,1034000.0
1034,1034999,21.251429337324335,37.08745427396283,0.08640979734250198,133.08927583694458,66.24745607376099,164.6568832397461,6168,1014,5154,5154,0,10,1035000.0
1035,1035999,21.24701890797144,37.08234394364886,0.08637137910363235,133.23309135437012,66.31385970115662,164.72949600219727,6174,1015,5159,5159,0,10,1036000.0
1036,1036999,21.243509410172233,37.07856802678751,0.0863196776972881,133.37204837799072,66.37908148765564,164.78082656860352,6177,1016,5161,5161,0,10,1037000.0
1037,1037999,21.24095423959254,37.072935780486716,0.08626341786629133,133.4917552471161,66.4444489479065,164.91001892089844,6177,1016,5161,5161,0,10,1038000.0
1038,1038999,21.239003586600088,37.06684620613385,0.08621959261988443,133.62387681007385,66.5098466873169,165.10298538208008,6178,1016,5162,5162,0,10,1039000.0
1039,1039999,21.237229963942408,37.062188354480625,0.08616071225795818,133.8028211593628,66.58300709724426,165.17377090454102,6189,1019,5170,5170,0,10,1040000.0
1040,1040999,21.237008085807663,37.06142235604476,0.08608461779598287,133.95669317245483,66.6483063697815,165.21569061279297,6200,1021,5179,5179,0,10,1041000.0
1041,1041999,21.236044154457403,37.05682059546687,0.0860344935839199,134.10909795761108,66.71403074264526,165.28480529785156,6209,1023,5186,5186,0,10,1042000.0
1042,1042999,21.237291733213944,37.055345967579846,0.08598892349160536,134.24653887748718,66.77935361862183,165.3857650756836,6212,1024,5188,5188,0,10,1043000.0
1043,1043999,21.239760485480375,37.05746876722603,0.08593471826158405,134.36656069755554,66.84582924842834,165.50874710083008,6213,1024,5189,5189,0,10,1044000.0
1044,1044999,21.241896062106463,37.05811207562922,0.08584289431391201,134.53045964241028,66.9119827747345,165.63887405395508,6225,1027,5198,5198,0,10,1045000.0
1045,1045999,21.24454643260676,37.05780868173221,0.08577999907866396,134.6860134601593,66.9778151512146,165.70832443237305,6229,1029,5200,5200,0,10,1046000.0
1046,1046999,21.248005554122905,37.05954173171,0.08576555866203284,134.841979265213,67.04749774932861,165.78485488891602,6241,1031,5210,5210,0,10,1047000.0
1047,1047999,21.250971978262346,37.05818989358054,0.08577216569910784,135.01814460754395,67.11448812484741,165.80586624145508,6251,1034,5217,5217,0,10,1048000.0
1048,1048999,21.24939231576346,37.0507708850849,0.08575817544580755,135.181378364563,67.18026351928711,165.96122360229492,6269,1037,5232,5232,0,10,1049000.0
1049,1049999,21.245945106823246,37.04781796051623,0.08569623785308322,135.33912086486816,67.24800324440002,166.64679336547852,6314,1039,5275,5275,0,10,1050000.0
1050,1050999,21.241510604758705,37.04055613654708,0.08570719402107174,135.4568681716919,67.31356453895569,166.90558624267578,6315,1039,5276,5276,0,10,1051000.0
1051,1051999,21.234597021010973,37.029703698612714,0.08573216756628954,135.59385895729065,67.382643699646,167.0216827392578,6317,1040,5277,5277,0,10,1052000.0
1052,1052999,21.231338298272448,37.02258786799688,0.08570606995884666,135.7456545829773,67.44798398017883,167.21508407592773,6322,1042,5280,5280,0,10,1053000.0
1053,1053999,21.226843777501717,37.013906389905394,0.08567852376118212,135.86339449882507,67.51287651062012,167.37094497680664,6322,1042,5280,5280,0,10,1054000.0
1054,1054999,21.225750918588528,37.016560328665165,0.08559412982139081,135.99307584762573,67.57809376716614,167.4931983947754,6322,1042,5280,5280,0,10,1055000.0
1055,1055999,21.22581635666534,37.02586819428065,0.08550982721814637,136.16971015930176,67.64437699317932,167.56195831298828,6343,1045,5298,5298,0,10,1056000.0
1056,1056999,21.226539689834677,37.03823564534289,0.08545427903140446,136.30714869499207,67.70963406562805,167.64934539794922,6346,1046,5300,5300,0,10,1057000.0
1057,1057999,21.233629234228417,37.094029226178236,0.08528458683769702,136.47750306129456,67.77575826644897,167.69332885742188,6357,1049,5308,5308,0,10,1058000.0
1058,1058999,21.238489193065146,37.1077129704642,0.08525720537088666,136.6439027786255,67.84154510498047,167.7720832824707,6363,1052,5311,5311,0,10,1059000.0
1059,1059999,21.243129195570756,37.13672047322003,0.08513680781514543,136.792058467865,67.9069435596466,167.85863494873047,6370,1054,5316,5316,0,10,1060000.0
1060,1060999,21.24863074110285,37.16332160727067,0.08501151637914939,136.94674611091614,67.97279167175293,167.94069290161133,6403,1056,5347,5347,0,10,1061000.0
1061,1061999,21.258096364328303,37.20446536504675,0.084963745910979,137.08156514167786,68.03967523574829,168.02230072021484,6405,1057,5348,5348,0,10,1062000.0
1062,1062999,21.2672069377936,37.23295942180377,0.0849831100332964,137.25706219673157,68.10569715499878,168.10155868530273,6417,1060,5357,5357,0,10,1063000.0
1063,1063999,21.27649101633811,37.26428553673384,0.08493605968640905,137.3951141834259,68.17089247703552,168.2080078125,6419,1061,5358,5358,0,10,1064000.0
1064,1064999,21.27996510463131,37.27604458195634,0.08478481702104768,137.5553801059723,68.23647356033325,168.63023376464844,6466,1063,5403,5403,0,10,1065000.0
1065,1065999,21.281411187734893,37.289599097516124,0.08472981186515649,137.67561411857605,68.30208492279053,169.10959243774414,6471,1063,5408,5408,0,10,1066000.0
1066,1066999,21.28429326192334,37.30556467902907,0.08462392166415778,137.8040370941162,68.36707806587219,169.28719329833984,6474,1064,5410,5410,0,10,1067000.0
1067,1067999,21.28689019919194,37.32283697829526,0.08461639480977612,137.981538772583,68.43372654914856,169.54465866088867,6488,1067,5421,5421,0,10,1068000.0
1068,1068999,21.28827050351499,37.32493077595415,0.08467381172347499,138.09700894355774,68.4989025592804,169.81471252441406,6488,1067,5421,5421,0,10,1069000.0
1069,1069999,21.293759262474843,37.34823512228011,0.08463319146616777,138.242094039917,68.5643265247345,169.93450546264648,6492,1069,5423,5423,0,10,1070000.0
1070,1070999,21.29718628697597,37.36113876977082,0.08471034425390689,138.35909914970398,68.63001155853271,170.10430145263672,6492,1069,5423,5423,0,10,1071000.0
1071,1071999,21.30153238329839,37.37207674384018,0.0846991131597461,138.52037954330444,68.695645570755,170.16899490356445,6502,1071,5431,5431,0,10,1072000.0
1072,1072999,21.305564070476397,37.379210700687175,0.08480795438913691,138.66539525985718,68.76192855834961,170.29742813110352,6507,1072,5435,5435,0,10,1073000.0
1073,1073999,21.314182224864286,37.406344027895315,0.0847761989869622,138.80132699012756,68.82752847671509,170.47197723388672,6515,1073,5442,5442,0,10,1074000.0
1074,1074999,21.32512077101729,37.44679877695647,0.08488731753056877,138.91400289535522,68.8922107219696,170.60762405395508,6515,1073,5442,5442,0,10,1075000.0
1075,1075999,21.334579390615776,37.462550049171575,0.08500914812898352,139.0844156742096,68.95767784118652,170.5618553161621,6526,1076,5450,5450,0,10,1076000.0
1076,1076999,21.347546587628962,37.486867886624935,0.08523566091610824,139.218159198761,69.02442646026611,170.6088409423828,6528,1077,5451,5451,0,10,1077000.0
1077,1077999,21.360751317654334,37.51437268657178,0.08554976115599511,139.35468649864197,69.09016680717468,170.69213104248047,6530,1078,5452,5452,0,10,1078000.0
1078,1078999,21.377004962363834,37.55749538045369,0.08567971207684488,139.49641227722168,69.1555027961731,170.95093536376953,6536,1079,5457,5457,0,10,1079000.0
1079,1079999,21.39402649248897,37.596061658609024,0.08595739347432974,139.65752172470093,69.22014689445496,170.98263549804688,6545,1082,5463,5463,0,10,1080000.0
1080,1080999,21.41359697535578,37.639688250614725,0.08642342110826073,139.8038969039917,69.28542971611023,170.98723983764648,6554,1084,5470,5470,0,10,1081000.0
1081,1081999,21.431657507218304,37.694058558618565,0.08697359620597345,139.96183681488037,69.35100674629211,171.07192611694336,6564,1086,5478,5478,0,10,1082000.0
1082,1082999,21.435601326580507,37.70463790678462,0.08695639910482766,140.11600828170776,69.41613268852234,171.65375900268555,6576,1088,5488,5488,0,10,1083000.0
1083,1083999,21.434428212339277,37.70632849602766,0.08690431786094321,140.22779273986816,69.4810209274292,171.95848083496094,6577,1088,5489,5489,0,10,1084000.0
1084,1084999,21.435723674697297,37.720694059088856,0.08680103505404035,140.42496466636658,69.54617357254028,171.99282455444336,6589,1093,5496,5496,0,10,1085000.0
1085,1085999,21.435667182482028,37.72598490985448,0.08675501065962099,140.57045125961304,69.61097502708435,172.1848030090332,6596,1095,5501,5501,0,10,1086000.0
1086,1086999,21.436268252450756,37.726945400110964,0.08675474597949462,140.70338654518127,69.67705702781677,172.4140739440918,6604,1096,5508,5508,0,10,1087000.0
1087,1087999,21.439372104835574,37.74768006713773,0.08665438385219015,140.875586271286,69.74189305305481,172.5269889831543,6613,1099,5514,5514,0,10,1088000.0
1088,1088999,21.442562201035283,37.75242386350223,0.08668302090997204,141.00533270835876,69.80701422691345,172.72980880737305,6615,1100,5515,5515,0,10,1089000.0
1089,1089999,21.445823748961907,37.75576938969276,0.08669046509634315,141.14235663414001,69.87215161323547,172.84626388549805,6617,1101,5516,5516,0,10,1090000.0
1090,1090999,21.450520902101093,37.764374235717234,0.08675680389963947,141.29371738433838,69.9377167224884,172.9876937866211,6622,1102,5520,5520,0,10,1091000.0
1091,1091999,21.456974672939573,37.775491504319255,0.08687684872420542,141.42964673042297,70.00286293029785,173.0981903076172,6624,1103,5521,5521,0,10,1092000.0
1092,1092999,21.464141110331074,37.783393812514326,0.08707302566992026,141.56182312965393,70.06843948364258,173.36016082763672,6625,1103,5522,5522,0,10,1093000.0
1093,1093999,21.470827439736087,37.79368293240635,0.08729621146455169,141.6967692375183,70.13308620452881,173.48910903930664,6627,1104,5523,5523,0,10,1094000.0
1094,1094999,21.478022321074835,37.80118725759549,0.0874720060972678,141.82948851585388,70.19799518585205,173.5888214111328,6629,1105,5524,5524,0,10,1095000.0
1095,1095999,21.486309436433512,37.823853876753276,0.08779589282140887,141.96465015411377,70.26259851455688,173.69218826293945,6631,1106,5525,5525,0,10,1096000.0
1096,1096999,21.49593581355212,37.837143226405665,0.08815045569925073,142.09063005447388,70.32767462730408,173.80648803710938,6632,1106,5526,5526,0,10,1097000.0
1097,1097999,21.50435362216682,37.84544508254499,0.08845655973372946,142.22857356071472,70.39211773872375,173.87337112426758,6634,1107,5527,5527,0,10,1098000.0
1098,1098999,21.512308980634362,37.85186457082928,0.08871245437511066,142.35575580596924,70.45696091651917,174.13604736328125,6637,1107,5530,5530,0,10,1099000.0
1099,1099999,21.521803545699996,37.86078839525833,0.08887254922254462,142.5277669429779,70.52192616462708,174.14212036132812,6645,1110,5535,5535,0,10,1100000.0
1100,1100999,21.52800476607193,37.86386053595204,0.08906186454643983,142.68216180801392,70.58807849884033,174.2244644165039,6649,1112,5537,5537,0,10,1101000.0
1101,1101999,21.532443737452603,37.86453038039466,0.08920544040822997,142.83957409858704,70.6535005569458,174.3001708984375,6655,1114,5541,5541,0,10,1102000.0
1102,1102999,21.532047920590212,37.862769838665045,0.08911200952317566,142.97570490837097,70.71923089027405,174.79295349121094,6665,1115,5550,5550,0,10,1103000.0
1103,1103999,21.527996775599224,37.86084328961986,0.08908721396376451,143.12173128128052,70.7837917804718,175.0201759338379,6670,1117,5553,5553,0,10,1104000.0
1104,1104999,21.523471048787524,37.854450682389405,0.08904862171294914,143.24811363220215,70.84831690788269,175.21065139770508,6671,1117,5554,5554,0,10,1105000.0
1105,1105999,21.520575374143196,37.84999374203635,0.08911602374504424,143.41624069213867,70.91345143318176,175.27623748779297,6678,1120,5558,5558,0,10,1106000.0
1106,1106999,21.51947333352188,37.848970665985306,0.0891265206405003,143.55728769302368,70.97829818725586,175.46935272216797,6688,1121,5567,5567,0,10,1107000.0
1107,1107999,21.516682270426518,37.84356456466065,0.08918151046238543,143.68308568000793,71.04310894012451,175.72784423828125,6715,1122,5593,5593,0,10,1108000.0
1108,1108999,21.515309071441834,37.840721482015326,0.08916207633643136,143.8224527835846,71.10755157470703,175.83081817626953,6717,1123,5594,5594,0,10,1109000.0
1109,1109999,21.512471459927294,37.83449944952791,0.08918794006826936,143.95663690567017,71.17335772514343,175.95255661010742,6719,1124,5595,5595,0,10,1110000.0
1110,1110999,21.509056356021965,37.82675653368499,0.08918182314613932,144.0701813697815,71.23848176002502,176.0657844543457,6719,1124,5595,5595,0,10,1111000.0
1111,1111999,21.50816847404463,37.8226033639655,0.08916734189710784,144.19782519340515,71.30326247215271,176.21279907226562,6722,1124,5598,5598,0,10,1112000.0
1112,1112999,21.509245576317046,37.82183644598419,0.08916808757243033,144.38140487670898,71.368403673172,176.34629821777344,6731,1127,5604,5604,0,10,1113000.0
1113,1113999,21.50641758934944,37.81571199517933,0.08914257876477216,144.51012086868286,71.432776927948,176.50207901000977,6733,1128,5605,5605,0,10,1114000.0
1114,1114999,21.506664927337432,37.816379553659964,0.08909211858092525,144.6430516242981,71.49730777740479,176.6181526184082,6735,1129,5606,5606,0,10,1115000.0
1115,1115999,21.504850963999523,37.80927951360001,0.08907416790081524,144.79341077804565,71.56197953224182,176.72732162475586,6745,1131,5614,5614,0,10,1116000.0
1116,1116999,21.503164886468443,37.805379478438134,0.0890678082784434,144.96437978744507,71.62801885604858,176.7519416809082,6751,1134,5617,5617,0,10,1117000.0
1117,1117999,21.501125578936385,37.79857453733732,0.08904043864836908,145.08554244041443,71.69272041320801,176.89257049560547,6751,1134,5617,5617,0,10,1118000.0
1118,1118999,21.49900569107605,37.79137879642249,0.08903314133426576,145.2096769809723,71.7575159072876,177.11677932739258,6753,1134,5619,5619,0,10,1119000.0
1119,1119999,21.496380515963423,37.78396706671215,0.0890043102223469,145.3771047592163,71.8221869468689,177.11957168579102,6769,1137,5632,5632,0,10,1120000.0
1120,1120999,21.494558066006988,37.77746891183254,0.08898134553081916,145.49694418907166,71.88681125640869,177.25191116333008,6769,1137,5632,5632,0,10,1121000.0
1121,1121999,21.490450482620734,37.767829493849895,0.08896814273477682,145.64548254013062,71.95162677764893,177.2982292175293,6773,1139,5634,5634,0,10,1122000.0
1122,1122999,21.487030005413786,37.75940956884315,0.08896070491280894,145.79019403457642,72.01700901985168,177.59273147583008,6795,1141,5654,5654,0,10,1123000.0
1123,1123999,21.481971003377584,37.75765439253154,0.08891251682865098,145.97173714637756,72.08206176757812,177.96906661987305,6805,1145,5660,5660,0,10,1124000.0
1124,1124999,21.47434022493618,37.7505831889465,0.0889380571111027,146.1320240497589,72.14676928520203,178.09525299072266,6816,1148,5668,5668,0,10,1125000.0
1125,1125999,21.46849500660254,37.74362215205182,0.0889586443027085,146.2941174507141,72.21182680130005,178.3340072631836,6861,1151,5710,5710,0,10,1126000.0
1126,1126999,21.4625434712699,37.73827121282536,0.08894890971752678,146.41800904273987,72.27720713615417,178.63233184814453,6861,1151,5710,5710,0,10,1127000.0
1127,1127999,21.455808541646515,37.72851140664228,0.08895211927752134,146.6031424999237,72.34333801269531,178.75679397583008,6870,1155,5715,5715,0,10,1128000.0
1128,1128999,21.449665349994692,37.718128520881706,0.08896707405050708,146.72392463684082,72.40810132026672,178.94713973999023,6870,1155,5715,5715,0,10,1129000.0
1129,1129999,21.44365379791534,37.7099153004218,0.08898191236864594,146.86396741867065,72.47285294532776,179.01038360595703,6877,1156,5721,5721,0,10,1130000.0
1130,1130999,21.438922425182426,37.70670190987767,0.0889519188899126,146.99405598640442,72.5387110710144,179.11931228637695,6881,1157,5724,5724,0,10,1131000.0
1131,1131999,21.433156731509772,37.69714696143079,0.08894405947400608,147.16380405426025,72.61431455612183,179.28960800170898,6885,1158,5727,5727,0,10,1132000.0
1132,1132999,21.427990573862253,37.688022224527636,0.08893376843322809,147.2979748249054,72.6838972568512,179.40094375610352,6885,1158,5727,5727,0,10,1133000.0
1133,1133999,21.424615168041903,37.682007137929645,0.088815953726328,147.48757600784302,72.75643849372864,179.59954833984375,6895,1161,5734,5734,0,10,1134000.0
1134,1134999,21.420560415722274,37.674524338518054,0.08876570129024663,147.60286378860474,72.8218686580658,179.84458923339844,6896,1161,5735,5735,0,10,1135000.0
1135,1135999,21.417250704884477,37.66971212719373,0.08872871087437306,147.7387580871582,72.88728952407837,179.92493438720703,6898,1162,5736,5736,0,10,1136000.0
1136,1136999,21.41438086496166,37.66632922638801,0.08865339357616764,147.90799474716187,72.95280432701111,179.96151733398438,6910,1165,5745,5745,0,10,1137000.0
1137,1137999,21.41022464847701,37.65659766295313,0.0886259125226545,148.0580997467041,73.0183265209198,180.06231689453125,6915,1166,5749,5749,0,10,1138000.0
1138,1138999,21.40886867230885,37.653729940810365,0.08857932839069593,148.19995093345642,73.08355236053467,180.1772003173828,6917,1167,5750,5750,0,10,1139000.0
1139,1139999,21.40708751696542,37.647033718585234,0.08854143962910233,148.35623168945312,73.14942860603333,180.5029067993164,6934,1169,5765,5765,0,10,1140000.0
1140,1140999,21.406305795538007,37.64242636419761,0.08851880407508828,148.4955699443817,73.22166299819946,180.70129013061523,6936,1170,5766,5766,0,10,1141000.0
1141,1141999,21.403928828837323,37.635050454782736,0.08853995727166097,148.6604950428009,73.28857207298279,180.79208755493164,6947,1173,5774,5774,0,10,1142000.0
1142,1142999,21.402045109062133,37.628229036173224,0.08854485836599024,148.80255675315857,73.35410761833191,180.98036575317383,6949,1174,5775,5775,0,10,1143000.0
1143,1143999,21.40160547289381,37.63040840730512,0.08853537827083269,148.95239639282227,73.4235827922821,181.57066345214844,6954,1175,5779,5779,0,10,1144000.0
1144,1144999,21.399990504475067,37.63218560656109,0.08855991992932344,149.07317566871643,73.48919987678528,181.87939071655273,6954,1175,5779,5779,0,10,1145000.0
1145,1145999,21.39893749479425,37.63086531813531,0.08863285481230931,149.22321462631226,73.55478644371033,181.97652435302734,6958,1177,5781,5781,0,10,1146000.0
1146,1146999,21.401701948411542,37.64043526588946,0.08859775150841331,149.39350128173828,73.620432138443,182.04923248291016,6967,1180,5787,5787,0,10,1147000.0
1147,1147999,21.401901044552254,37.646006043680686,0.08854938769764376,149.54627013206482,73.68725061416626,182.16978073120117,6971,1182,5789,5789,0,10,1148000.0
1148,1148999,21.405242312628097,37.654850129971244,0.08856189166377326,149.6935751438141,73.75901341438293,182.44330215454102,6974,1183,5791,5791,0,10,1149000.0
1149,1149999,21.411064869002224,37.668353523279976,0.08862954062294337,149.835129737854,73.82467746734619,182.5720558166504,6978,1184,5794,5794,0,10,1150000.0
1150,1150999,21.418676434541066,37.691449556436986,0.08865913937226388,149.98536658287048,73.89044237136841,182.62925720214844,6987,1186,5801,5801,0,10,1151000.0
1151,1151999,21.424606082665736,37.700050075445056,0.08875672217390562,150.1062364578247,73.9563057422638,182.7820930480957,6988,1186,5802,5802,0,10,1152000.0
1152,1152999,21.43326965990026,37.72253603925453,0.08889858639072823,150.26615571975708,74.02337574958801,182.83438110351562,6992,1188,5804,5804,0,10,1153000.0
1153,1153999,21.445544299246666,37.74605095369587,0.089149021327662,150.415283203125,74.08970618247986,183.07240295410156,6996,1190,5806,5806,0,10,1154000.0
1154,1154999,21.455815628470194,37.76470819459368,0.08929993689303528,150.54887795448303,74.155508518219,183.16704559326172,6998,1191,5807,5807,0,10,1155000.0
1155,1155999,21.4648180604145,37.77890750051459,0.08942811610292445,150.71396207809448,74.22977709770203,183.18376922607422,7002,1193,5809,5809,0,10,1156000.0
1156,1156999,21.475991269994683,37.79639743160949,0.08959544164298205,150.84893608093262,74.29623484611511,183.2988739013672,7004,1194,5810,5810,0,10,1157000.0
1157,1157999,21.489725932684163,37.82490182183532,0.08999928756402453,150.97555303573608,74.36286330223083,183.44777297973633,7004,1194,5810,5810,0,10,1158000.0
1158,1158999,21.50390219671787,37.855874924727566,0.09025926992537503,151.13714694976807,74.42883610725403,183.49159622192383,7014,1197,5817,5817,0,10,1159000.0
1159,1159999,21.519693805594777,37.88682988259996,0.09054689792380077,151.28060483932495,74.49684953689575,183.6768684387207,7016,1198,5818,5818,0,10,1160000.0
1160,1160999,21.5337104260386,37.90771162074656,0.09078656852753098,151.41548895835876,74.56168174743652,183.79244232177734,7023,1199,5824,5824,0,10,1161000.0
1161,1161999,21.547823276168955,37.925918039898924,0.09125454390364895,151.56646132469177,74.6319329738617,183.8654670715332,7025,1200,5825,5825,0,10,1162000.0
1162,1162999,21.558331247869837,37.94259569159135,0.09167135756339995,151.75870203971863,74.69732785224915,183.8681983947754,7063,1204,5859,5859,0,10,1163000.0
1163,1163999,21.55946415395772,37.94977605519003,0.09162134203678585,151.883882522583,74.76328635215759,184.59185028076172,7065,1204,5861,5861,0,10,1164000.0
1164,1164999,21.560190426635625,37.957537506238296,0.09152231912821174,152.05033588409424,74.82939577102661,184.62236785888672,7074,1207,5867,5867,0,10,1165000.0
1165,1165999,21.561493560318873,37.96120555306146,0.091523384183965,152.19076800346375,74.89534378051758,184.7599334716797,7076,1208,5868,5868,0,10,1166000.0
1166,1166999,21.564239750933993,37.968083783767575,0.09150318717548722,152.3392150402069,74.96800541877747,184.91629791259766,7107,1209,5898,5898,0,10,1167000.0
1167,1167999,21.5672142176514,37.988233309257545,0.0913622318035856,152.49612998962402,75.03425168991089,185.14111709594727,7111,1211,5900,5900,0,10,1168000.0
1168,1168999,21.570554835690775,37.99108987682206,0.09135301118429495,152.63482451438904,75.10153913497925,185.2689437866211,7113,1212,5901,5901,0,10,1169000.0
1169,1169999,21.57618981496049,38.001043555866225,0.09136681349477027,152.79951333999634,75.19063830375671,185.4092903137207,7113,1212,5901,5901,0,10,1170000.0
1170,1170999,21.581717750700196,38.010112836607384,0.09143033153758495,152.95295882225037,75.2565746307373,185.48048400878906,7118,1214,5904,5904,0,10,1171000.0
1171,1171999,21.5865009147039,38.01745423237062,0.09144195443755287,153.092848777771,75.32228064537048,185.59296035766602,7121,1215,5906,5906,0,10,1172000.0
1172,1172999,21.595229736246235,38.03625693586941,0.09155850045541714,153.21164059638977,75.3877272605896,185.74484252929688,7121,1215,5906,5906,0,10,1173000.0
1173,1173999,21.60746703257707,38.0620795425165,0.09165837564045698,153.38077020645142,75.45338869094849,185.89808654785156,7127,1218,5909,5909,0,10,1174000.0
1174,1174999,21.616129546737973,38.07663986802901,0.0917334516738103,153.50522470474243,75.51951360702515,186.03498077392578,7127,1218,5909,5909,0,10,1175000.0
1175,1175999,21.626308169595944,38.09675864467479,0.09189595157219288,153.63173818588257,75.58474707603455,186.1301383972168,7127,1218,5909,5909,0,10,1176000.0
1176,1176999,21.63688883685119,38.11653704058088,0.0920592040151057,153.76404643058777,75.64991331100464,186.20127487182617,7129,1219,5910,5910,0,10,1177000.0
1177,1177999,21.650491268677786,38.14557753871257,0.09237679732037074,153.89004683494568,75.71518874168396,186.3058204650879,7129,1219,5910,5910,0,10,1178000.0
1178,1178999,21.659961989997,38.1579133778427,0.09249022470562107,154.03456497192383,75.78061485290527,186.4116973876953,7131,1220,5911,5911,0,10,1179000.0
1179,1179999,21.67141788348593,38.181310787490645,0.0925659457026422,154.17371463775635,75.84732842445374,186.53910446166992,7133,1221,5912,5912,0,10,1180000.0
1180,1180999,21.685454649448552,38.205079083512565,0.09276849783274,154.34596180915833,75.91368246078491,186.51415634155273,7143,1224,5919,5919,0,10,1181000.0
1181,1181999,21.695384689545772,38.21502323580912,0.09298553005489119,154.47723770141602,75.97868585586548,186.5909080505371,7145,1225,5920,5920,0,10,1182000.0
1182,1182999,21.703391121709192,38.224736768255255,0.09299863545017972,154.61479544639587,76.04900789260864,186.69115447998047,7149,1226,5923,5923,0,10,1183000.0
1183,1183999,21.70284407104963,38.228850205104926,0.0929182111399054,154.83061385154724,76.11478900909424,187.15127182006836,7183,1231,5952,5952,0,10,1184000.0
1184,1184999,21.70206363074812,38.22720386814359,0.0929034880379439,154.95379328727722,76.1799829006195,187.4006118774414,7183,1231,5952,5952,0,10,1185000.0
1185,1185999,21.700480425173396,38.22653615827352,0.09290308660251834,155.10784268379211,76.24573302268982,187.55479049682617,7189,1233,5956,5956,0,10,1186000.0
1186,1186999,21.69932681626956,38.224382814942594,0.09289568485024224,155.26569652557373,76.31195664405823,187.70656204223633,7198,1235,5963,5963,0,10,1187000.0
1187,1187999,21.69783659851663,38.22020311800399,0.09289044210589048,155.40417456626892,76.3772542476654,187.88547897338867,7203,1236,5967,5967,0,10,1188000.0
1188,1188999,21.69576273275123,38.214342444324814,0.09288777672350079,155.54348278045654,76.44274139404297,187.97754287719727,7205,1237,5968,5968,0,10,1189000.0
1189,1189999,21.69435453666079,38.211339859186545,0.09285139298479428,155.66188216209412,76.50819706916809,188.06953811645508,7205,1237,5968,5968,0,10,1190000.0
1190,1190999,21.69335837818737,38.209860158796225,0.09281745522352003,155.80134773254395,76.57390260696411,188.14166641235352,7207,1238,5969,5969,0,10,1191000.0
1191,1191999,21.692978513998803,38.215926217280376,0.09276509555976176,155.97106885910034,76.6402096748352,188.18713760375977,7211,1240,5971,5971,0,10,1192000.0
1192,1192999,21.692101266047743,38.21130024282673,0.09275118049707376,156.12339162826538,76.70654225349426,188.3134880065918,7213,1241,5972,5972,0,10,1193000.0
1193,1193999,21.691108561827157,38.206570767094895,0.09277405120924043,156.28589010238647,76.77340173721313,188.3555679321289,7220,1243,5977,5977,0,10,1194000.0
1194,1194999,21.69085436390343,38.20264146415398,0.09276387170817679,156.4187650680542,76.8393611907959,188.4604148864746,7220,1243,5977,5977,0,10,1195000.0
1195,1195999,21.69019772396438,38.197152624256304,0.09276856530341893,156.57047295570374,76.90478849411011,188.48339462280273,7230,1245,5985,5985,0,10,1196000.0
1196,1196999,21.690687344736137,38.19310808621661,0.09279219816843154,156.7068853378296,76.97059082984924,188.65264129638672,7230,1245,5985,5985,0,10,1197000.0
1197,1197999,21.6904547110071,38.18712386510672,0.09276264358310549,156.84082770347595,77.03603553771973,188.7873992919922,7232,1246,5986,5986,0,10,1198000.0
1198,1198999,21.690037857205414,38.18178822805857,0.09275360479155992,156.9544858932495,77.1002676486969,188.86489486694336,7232,1246,5986,5986,0,10,1199000.0
1199,1199999,21.690173451120057,38.17784456887823,0.09273510312479216,157.12203359603882,77.16537690162659,188.90771484375,7242,1248,5994,5994,0,10,1200000.0
1200,1200999,21.68685427011159,38.17738880408407,0.09270755276945142,157.26746368408203,77.23060274124146,189.33686447143555,7248,1249,5999,5999,0,10,1201000.0
1201,1201999,21.68339274611147,38.18367145149485,0.09267355689200774,157.42779064178467,77.30170178413391,189.59403228759766,7254,1250,6004,6004,0,10,1202000.0
1202,1202999,21.679756154866133,38.17958367778787,0.09267339501887883,157.56674075126648,77.3681435585022,189.69833755493164,7256,1251,6005,6005,0,10,1203000.0
1203,1203999,21.67471215066221,38.17098693908015,0.0927058044759842,157.72373867034912,77.43357586860657,189.81445693969727,7265,1253,6012,6012,0,10,1204000.0
1204,1204999,21.670493899000913,38.16637007458685,0.09270973987888953,157.85378456115723,77.4991979598999,190.04095458984375,7265,1253,6012,6012,0,10,1205000.0
1205,1205999,21.666447158778183,38.15930877326534,0.09273053569689993,157.99291729927063,77.5646505355835,190.1362419128418,7267,1254,6013,6013,0,10,1206000.0
1206,1206999,21.661204629087923,38.15054936881915,0.09274031224403745,158.11884093284607,77.63007068634033,190.24888610839844,7267,1254,6013,6013,0,10,1207000.0
1207,1207999,21.655360964185814,38.139950097195396,0.09276669653052216,158.2603840827942,77.69568157196045,190.29479598999023,7269,1255,6014,6014,0,10,1208000.0
1208,1208999,21.651010819188382,38.130742289841734,0.09277301976629959,158.3984978199005,77.76141119003296,190.37639617919922,7271,1256,6015,6015,0,10,1209000.0
1209,1209999,21.646621779560075,38.12113507686294,0.09276335343362518,158.52832078933716,77.82744407653809,190.46851348876953,7271,1256,6015,6015,0,10,1210000.0
1210,1210999,21.643226752582812,38.11297366650216,0.09274020591875043,158.6463508605957,77.8931097984314,190.63162994384766,7271,1256,6015,6015,0,10,1211000.0
1211,1211999,21.640298453324593,38.10612572752568,0.09270865945904272,158.76074600219727,77.95801067352295,190.74124908447266,7271,1256,6015,6015,0,10,1212000.0
1212,1212999,21.63824120426453,38.100677417767756,0.09268740708035172,158.90859079360962,78.02388668060303,190.77570724487305,7273,1257,6016,6016,0,11,1213000.0
1213,1213999,21.636443160120443,38.09671515276017,0.09265066765377694,159.07465147972107,78.09030222892761,190.7962875366211,7277,1259,6018,6018,0,11,1214000.0
1214,1214999,21.63523244559083,38.091661877906034,0.09265256696561075,159.20045042037964,78.15625739097595,190.8945770263672,7277,1259,6018,6018,0,11,1215000.0
1215,1215999,21.63356214734579,38.08549293904955,0.09266033686860453,159.33192801475525,78.22264790534973,190.99256134033203,7277,1259,6018,6018,0,11,1216000.0
1216,1216999,21.63320944594057,38.08172496614623,0.09264742220873545,159.4538290500641,78.28905153274536,191.1089973449707,7277,1259,6018,6018,0,11,1217000.0
1217,1217999,21.63159705629766,38.075769339589336,0.09264385322989965,159.58060550689697,78.35422945022583,191.20429611206055,7277,1259,6018,6018,0,11,1218000.0
1218,1218999,21.630301706232068,38.06987907107964,0.09264760586760368,159.73760056495667,78.42028570175171,191.1970977783203,7283,1261,6022,6022,0,11,1219000.0
1219,1219999,21.628872137869678,38.06408255598851,0.09265703713540907,159.86561918258667,78.48556423187256,191.27132415771484,7283,1261,6022,6022,0,11,1220000.0
1220,1220999,21.626370154348162,38.061334876146304,0.09262833725599873,159.9969265460968,78.54986882209778,191.60919189453125,7288,1262,6026,6026,0,11,1221000.0
1221,1221999,21.622109663570633,38.05440195196523,0.09258484240734643,160.13106417655945,78.61506795883179,191.78872299194336,7290,1263,6027,6027,0,11,1222000.0
1222,1222999,21.61835080234088,38.04860038000099,0.0925479343142267,160.30163741111755,78.68015837669373,191.82268905639648,7296,1265,6031,6031,0,11,1223000.0
1223,1223999,21.613916403578177,38.03922391978542,0.09254106035193044,161.08747792243958,78.7458803653717,191.93366622924805,7298,1266,6032,6032,0,11,1224000.0
1224,1224999,21.60918922003649,38.03063147182927,0.09252321565544475,161.21757864952087,78.81098937988281,192.0247917175293,7298,1266,6032,6032,0,11,1225000.0
1225,1225999,21.60629392563737,38.02170364649645,0.09248682941267616,161.3664128780365,78.87629199028015,192.1352882385254,7300,1267,6033,6033,0,11,1226000.0
1226,1226999,21.604655659398,38.01489914471444,0.09245462981791852,161.5035171508789,78.94236850738525,192.19522857666016,7302,1268,6034,6034,0,11,1227000.0
1227,1227999,21.601244107240397,38.00563489875994,0.09244003863756711,161.63548302650452,79.00771188735962,192.26795959472656,7302,1268,6034,6034,0,11,1228000.0
1228,1228999,21.59829278816235,38.00104296447687,0.09240522501485682,161.78921699523926,79.07277870178223,192.29183959960938,7304,1269,6035,6035,0,11,1229000.0
1229,1229999,21.594468617857764,37.991580681548776,0.09242566780797545,161.91076111793518,79.13763546943665,192.3816032409668,7304,1269,6035,6035,0,11,1230000.0
1230,1230999,21.593491788078147,37.98783211459085,0.09244605298741049,162.0594940185547,79.2029664516449,192.4312973022461,7306,1270,6036,6036,0,11,1231000.0
1231,1231999,21.594238026638223,37.98572431006209,0.09242572710190144,162.19391059875488,79.2683744430542,192.4790153503418,7308,1271,6037,6037,0,11,1232000.0
1232,1232999,21.593803571083015,37.9801898488936,0.0924390799279372,162.3166480064392,79.33377766609192,192.56657791137695,7308,1271,6037,6037,0,11,1233000.0
1233,1233999,21.593589560268953,37.97614348890791,0.09243966841247131,162.47025227546692,79.39870166778564,192.57938385009766,7312,1272,6040,6040,0,11,1234000.0
1234,1234999,21.593720441042393,37.974418680175354,0.09243961043794746,162.61605525016785,79.46438813209534,192.6470069885254,7320,1273,6047,6047,0,11,1235000.0
1235,1235999,21.595171129569138,37.97440814811403,0.09248898067179112,162.79934000968933,79.529629945755,192.6073455810547,7326,1276,6050,6050,0,11,1236000.0
1236,1236999,21.595759925770523,37.97194135024557,0.09250845021097942,162.93531489372253,79.59499931335449,192.67974472045898,7332,1277,6055,6055,0,11,1237000.0
1237,1237999,21.597399067167512,37.96927903928466,0.09249924196165504,163.09280133247375,79.66144514083862,192.83150100708008,7332,1277,6055,6055,0,11,1238000.0
1238,1238999,21.599014456405104,37.967280660564235,0.09254600280284464,163.21438670158386,79.72716164588928,192.90851211547852,7333,1277,6056,6056,0,11,1239000.0
1239,1239999,21.59975744054014,37.96407600689831,0.09256454389009172,163.32909893989563,79.79257559776306,192.98072814941406,7333,1277,6056,6056,0,11,1240000.0
1240,1240999,21.59943363082722,37.966092477066866,0.09259599660206719,163.48602032661438,79.85928893089294,193.00611114501953,7335,1278,6057,6057,0,11,1241000.0
1241,1241999,21.596779431822114,37.95961268119287,0.09252898360390815,163.6208837032318,79.92517828941345,193.4728660583496,7337,1278,6059,6059,0,11,1242000.0
1242,1242999,21.592474621343456,37.952418492022375,0.09249695798063862,163.7802700996399,79.99306464195251,193.67596054077148,7346,1280,6066,6066,0,11,1243000.0
1243,1243999,21.587708024810823,37.943821659974994,0.09247533870085178,163.93398451805115,80.05871248245239,193.79639053344727,7348,1281,6067,6067,0,11,1244000.0
1244,1244999,21.583688649425508,37.93634046455975,0.09244579701389999,164.10248231887817,80.12432718276978,193.8104705810547,7355,1284,6071,6071,0,11,1245000.0
1245,1245999,21.579526856833287,37.927212033606764,0.09243453829668469,164.23778200149536,80.19010353088379,193.9310760498047,7359,1285,6074,6074,0,11,1246000.0
1246,1246999,21.576835494573626,37.919839006967585,0.09237624955738266,164.40370917320251,80.25573086738586,193.95416259765625,7392,1287,6105,6105,0,11,1247000.0
1247,1247999,21.57492281031519,37.91290019279693,0.09232029214720283,164.5539894104004,80.32108807563782,194.0130157470703,7394,1288,6106,6106,0,11,1248000.0
1248,1248999,21.571725057439977,37.90526540623326,0.09230395447977313,164.67901301383972,80.38799715042114,194.0999526977539,7394,1288,6106,6106,0,11,1249000.0
1249,1249999,21.56796399732574,37.89699673771618,0.09230591768571061,164.83650279045105,80.45286250114441,194.09905242919922,7398,1290,6108,6108,0,11,1250000.0
1250,1250999,21.564584431992152,37.89212083199377,0.09230303294576614,164.96339464187622,80.51837658882141,194.25274276733398,7398,1290,6108,6108,0,11,1251000.0
1251,1251999,21.562462602341046,37.88496277830783,0.09231508084950701,165.09033060073853,80.58349251747131,194.44475936889648,7398,1290,6108,6108,0,11,1252000.0
1252,1252999,21.562243533012932,37.88011956411962,0.09226332983103658,165.24788880348206,80.64881038665771,194.5077247619629,7402,1292,6110,6110,0,11,1253000.0
1253,1253999,21.561056109680028,37.87586719183889,0.09220989618537323,165.395201921463,80.7143726348877,194.5932159423828,7406,1293,6113,6113,0,11,1254000.0
1254,1254999,21.559747839936943,37.87009720194909,0.0921939420530532,165.5153148174286,80.78107237815857,194.72117614746094,7406,1293,6113,6113,0,11,1255000.0
1255,1255999,21.559330503240655,37.866088375041315,0.09219220104453563,165.65013337135315,80.8455822467804,194.78774642944336,7410,1294,6116,6116,0,11,1256000.0
1256,1256999,21.55910061150868,37.87472507038209,0.09213306377138097,165.82309222221375,80.91078615188599,194.76991653442383,7421,1297,6124,6124,0,11,1257000.0
1257,1257999,21.55999280801538,37.87122577856642,0.09208173375271245,165.9684658050537,80.97587633132935,194.95723724365234,7428,1298,6130,6130,0,11,1258000.0
1258,1258999,21.562441663579218,37.86854055663723,0.09200016561517188,166.12201285362244,81.04114603996277,195.0126724243164,7442,1300,6142,6142,0,11,1259000.0
1259,1259999,21.563733388851915,37.864671949726194,0.09195284075839849,166.26607179641724,81.10681915283203,195.09545135498047,7444,1301,6143,6143,0,11,1260000.0
1260,1260999,21.56351651552874,37.85954236321751,0.09192969924722005,166.41259336471558,81.17120504379272,195.11572647094727,7446,1302,6144,6144,0,11,1261000.0
1261,1261999,21.56184324602088,37.85292907532397,0.09192470574840639,166.55986189842224,81.23570227622986,195.35186386108398,7449,1303,6146,6146,0,11,1262000.0
1262,1262999,21.558092677285735,37.845607362124774,0.09193959642448402,166.69118666648865,81.30059456825256,195.7829475402832,7449,1303,6146,6146,0,11,1263000.0
1263,1263999,21.554616078689044,37.8381671924808,0.09197853059446748,166.8027732372284,81.36566400527954,195.93477249145508,7450,1303,6147,6147,0,11,1264000.0
1264,1264999,21.552184681853227,37.83207573852653,0.09198743226580186,166.96571946144104,81.43088150024414,195.9950408935547,7454,1305,6149,6149,0,11,1265000.0
1265,1265999,21.551475920991102,37.82943981232347,0.09208932456383723,167.08488154411316,81.49557781219482,196.11278533935547,7454,1305,6149,6149,0,11,1266000.0
1266,1266999,21.552735648220384,37.82946438047979,0.0921750986705746,167.2454376220703,81.56062197685242,196.2392234802246,7459,1307,6152,6152,0,11,1267000.0
1267,1267999,21.55449029093389,37.83056917227126,0.09218753235719701,167.38204622268677,81.62560200691223,196.3787612915039,7459,1307,6152,6152,0,11,1268000.0
1268,1268999,21.556425012857517,37.83249974836564,0.09217210616126714,167.5047059059143,81.69029903411865,196.45771026611328,7459,1307,6152,6152,0,11,1269000.0
1269,1269999,21.559030143536944,37.83526794271383,0.0921390441897384,167.6555416584015,81.7549319267273,196.5213165283203,7490,1308,6182,6182,0,11,1270000.0
1270,1270999,21.561423709455187,37.838144284873486,0.09210684803040448,167.79424905776978,81.81965231895447,196.59175872802734,7493,1309,6184,6184,0,11,1271000.0
1271,1271999,21.56529422344966,37.84259921274612,0.09207107449878182,167.93231058120728,81.885080575943,196.70203399658203,7493,1309,6184,6184,0,11,1272000.0
1272,1272999,21.568664250297573,37.84721127715766,0.09206183059117945,168.1153268814087,81.95184230804443,196.81444549560547,7502,1312,6190,6190,0,11,1273000.0
1273,1273999,21.57135016461467,37.84947614084522,0.09201944763084902,168.25396132469177,82.01771903038025,196.92048263549805,7504,1313,6191,6191,0,11,1274000.0
1274,1274999,21.57473835639943,37.851684950084795,0.09200144744945271,168.38561916351318,82.08275246620178,196.98457717895508,7508,1314,6194,6194,0,11,1275000.0
1275,1275999,21.578025248274038,37.855024549855436,0.0919858983298234,168.51856327056885,82.14750695228577,197.06239318847656,7510,1315,6195,6195,0,11,1276000.0
1276,1276999,21.581561750609495,37.85735033255368,0.09202917715708958,168.68629908561707,82.21303009986877,197.0384521484375,7516,1317,6199,6199,0,11,1277000.0
1277,1277999,21.585081113405924,37.864115917832926,0.09207611579031838,168.8143277168274,82.27807331085205,197.15849685668945,7516,1317,6199,6199,0,11,1278000.0
1278,1278999,21.58932700071897,37.872334121689605,0.09203632397873229,168.9596643447876,82.34369349479675,197.37806701660156,7518,1318,6200,6200,0,11,1279000.0
1279,1279999,21.592558160256115,37.87468348451716,0.09201576221921648,169.11361503601074,82.40896320343018,197.4649772644043,7528,1320,6208,6208,0,11,1280000.0
1280,1280999,21.595830177517634,37.876541596482504,0.09201940053174795,169.22863173484802,82.47364211082458,197.5921859741211,7528,1320,6208,6208,0,11,1281000.0
1281,1281999,21.596926296032922,37.8743274772098,0.09201805591692891,169.3834526538849,82.53876495361328,197.66991806030273,7530,1321,6209,6209,0,11,1282000.0
1282,1282999,21.59529293296223,37.867554224445946,0.09202508086815564,169.5021493434906,82.60441017150879,198.0806121826172,7530,1321,6209,6209,0,11,1283000.0
1283,1283999,21.59101875278177,37.86190016334469,0.09194193214519497,169.65275526046753,82.67013931274414,198.2888298034668,7534,1323,6211,6211,0,11,1284000.0
1284,1284999,21.58660243262852,37.856684852820635,0.09181090924016766,169.83364844322205,82.73593616485596,198.3387451171875,7540,1326,6214,6214,0,11,1285000.0
1285,1285999,21.583263041024782,37.854804835089254,0.09173823699796912,169.96661353111267,82.80273056030273,198.49780654907227,7542,1327,6215,6215,0,11,1286000.0
1286,1286999,21.57850976284978,37.84530501077008,0.09172759723662072,170.10909843444824,82.86814641952515,198.60608673095703,7545,1328,6217,6217,0,11,1287000.0
1287,1287999,21.573443310511703,37.835126592925064,0.09174570049691744,170.234379529953,82.93314671516418,198.83413696289062,7545,1328,6217,6217,0,11,1288000.0
1288,1288999,21.569901435199874,37.82663122560044,0.09172544200277388,170.35715246200562,82.99831295013428,198.9652099609375,7545,1328,6217,6217,0,11,1289000.0
1289,1289999,21.565863398212734,37.82441389920561,0.09169995015265053,170.47856903076172,83.06332683563232,199.04431533813477,7545,1328,6217,6217,0,11,1290000.0
1290,1290999,21.561229915480013,37.81560691882335,0.09171548499671367,170.63807797431946,83.128915309906,199.02380752563477,7551,1330,6221,6221,0,11,1291000.0
1291,1291999,21.55762739280698,37.81000457263423,0.09169395574377481,170.7635977268219,83.19470143318176,199.14983367919922,7551,1330,6221,6221,0,11,1292000.0
1292,1292999,21.554983447041597,37.808873857115294,0.09166480835584034,170.90843391418457,83.26149415969849,199.24750518798828,7553,1331,6222,6222,0,11,1293000.0
1293,1293999,21.552594741057206,37.802072576357844,0.09162805257918161,171.04093670845032,83.32852864265442,199.41884231567383,7553,1331,6222,6222,0,11,1294000.0
1294,1294999,21.550416709938713,37.79582004679611,0.09160521395263321,171.18063950538635,83.39447593688965,199.44747924804688,7555,1332,6223,6223,0,11,1295000.0
1295,1295999,21.54833363210559,37.79202719875298,0.09157485623154515,171.3476505279541,83.46099472045898,199.4564323425293,7559,1334,6225,6225,0,11,1296000.0
1296,1296999,21.5455272201695,37.78585492514295,0.0915663626479033,171.466210603714,83.52691507339478,199.56767654418945,7560,1334,6226,6226,0,11,1297000.0
1297,1297999,21.543640245888476,37.78117220955793,0.09157078183169054,171.62018752098083,83.5925064086914,199.58961868286133,7562,1335,6227,6227,0,11,1298000.0
1298,1298999,21.54207297392875,37.77535511994794,0.09156187746392852,171.74446392059326,83.65860080718994,199.67711639404297,7562,1335,6227,6227,0,11,1299000.0
1299,1299999,21.541934484335016,37.77182800574538,0.09150885473793502,171.88187074661255,83.7241439819336,199.8609733581543,7563,1335,6228,6228,0,11,1300000.0
1300,1300999,21.54060010895207,37.76691121930408,0.09146018399884259,172.03327250480652,83.79030179977417,199.91213989257812,7567,1336,6231,6231,0,11,1301000.0
1301,1301999,21.540654432683887,37.764238359391214,0.09142232470587885,172.18545627593994,83.85502529144287,199.91893005371094,7576,1338,6238,6238,0,11,1302000.0
1302,1302999,21.539667491941582,37.759197033157456,0.09139750693574233,172.31235003471375,83.91992735862732,200.04984664916992,7576,1338,6238,6238,0,11,1303000.0
1303,1303999,21.535843348790966,37.750927669513494,0.09140042475888766,172.43231773376465,83.98462915420532,200.35231399536133,7576,1338,6238,6238,0,11,1304000.0
1304,1304999,21.530783071246198,37.74332909226607,0.0914104293783744,172.56595873832703,84.04947996139526,200.58095169067383,7578,1339,6239,6239,0,11,1305000.0
1305,1305999,21.525975379365516,37.738674817750095,0.09140240785125942,172.71511054039001,84.11606812477112,200.68649291992188,7583,1340,6243,6243,0,11,1306000.0
1306,1306999,21.52106996501709,37.732208730501966,0.09140798942636341,172.85019278526306,84.1810896396637,200.76216506958008,7585,1341,6244,6244,0,11,1307000.0
1307,1307999,21.51523174687522,37.72287299857096,0.09144026679739992,172.9738917350769,84.24700331687927,200.87475967407227,7586,1341,6245,6245,0,11,1308000.0
1308,1308999,21.510680659002976,37.714190513951024,0.09143863240782857,173.1129868030548,84.31259727478027,201.02932739257812,7591,1342,6249,6249,0,11,1309000.0
1309,1309999,21.506538178265455,37.704773012301075,0.09144831906291184,173.2315812110901,84.37849521636963,201.1399383544922,7591,1342,6249,6249,0,11,1310000.0
1310,1310999,21.501212435746776,37.694601040154915,0.09145982602747105,173.35570216178894,84.44360613822937,201.2171401977539,7591,1342,6249,6249,0,11,1311000.0
1311,1311999,21.49721889770718,37.68830278214668,0.09144066579986365,173.5049877166748,84.50968956947327,201.24333572387695,7593,1343,6250,6250,0,11,1312000.0
1312,1312999,21.492768146650175,37.68180214533809,0.09143019564635058,173.64798951148987,84.57618260383606,201.28264617919922,7595,1344,6251,6251,0,11,1313000.0
1313,1313999,21.488625071029485,37.674668857025324,0.09141695227569047,173.80485606193542,84.6427800655365,201.30098724365234,7599,1346,6253,6253,0,11,1314000.0
1314,1314999,21.485373659767173,37.666527044209815,0.09139265768115323,173.93466901779175,84.70827865600586,201.50799179077148,7599,1346,6253,6253,0,11,1315000.0
1315,1315999,21.483374611474915,37.659679550821565,0.09134181504272454,174.07330346107483,84.77402758598328,201.5852928161621,7630,1347,6283,6283,0,11,1316000.0
1316,1316999,21.480334482260904,37.65173450887433,0.09131547375870464,174.2174916267395,84.83908939361572,201.6229362487793,7632,1348,6284,6284,0,11,1317000.0
1317,1317999,21.478602786822666,37.64542806761722,0.09127042483958836,174.33778429031372,84.90409183502197,201.70150756835938,7632,1348,6284,6284,0,11,1318000.0
1318,1318999,21.477796188331972,37.64593606184044,0.09118663523110271,174.4769778251648,84.9695987701416,201.77089309692383,7633,1348,6285,6285,0,11,1319000.0
1319,1319999,21.477040820290075,37.64136543380235,0.09114906380879484,174.59396839141846,85.03454232215881,201.85504913330078,7633,1348,6285,6285,0,11,1320000.0
1320,1320999,21.47869577862404,37.64109619751611,0.0910807055682541,174.7189211845398,85.10051703453064,201.98118591308594,7633,1348,6285,6285,0,11,1321000.0
1321,1321999,21.480117075296594,37.63841923819268,0.09102947890832891,174.8548641204834,85.16688776016235,202.0550651550293,7633,1348,6285,6285,0,11,1322000.0
1322,1322999,21.482164038729273,37.63684690787966,0.09098099856415265,174.99958729743958,85.23244023323059,202.03052139282227,7639,1349,6290,6290,0,11,1323000.0
1323,1323999,21.483123866364117,37.634668862447086,0.09091281114563299,175.119811296463,85.29820036888123,202.1109619140625,7639,1349,6290,6290,0,11,1324000.0
1324,1324999,21.480093335102232,37.62679874672638,0.09090335316963172,175.25173234939575,85.36391830444336,202.47990798950195,7639,1349,6290,6290,0,11,1325000.0
1325,1325999,21.475566154256683,37.62724069527516,0.09091564291615573,175.40806555747986,85.42950940132141,203.05051803588867,7685,1350,6335,6335,0,11,1326000.0
1326,1326999,21.470906287372472,37.62893336282803,0.09087275878469281,175.52543592453003,85.49492597579956,203.35987091064453,7685,1350,6335,6335,0,11,1327000.0
1327,1327999,21.465118760025984,37.62197361141637,0.09088271992252883,175.66639399528503,85.5606861114502,203.60743713378906,7691,1351,6340,6340,0,11,1328000.0
1328,1328999,21.459864925050223,37.61717972329164,0.09087885526819417,175.80788779258728,85.62595462799072,203.78932189941406,7693,1352,6341,6341,0,11,1329000.0
1329,1329999,21.4542196717888,37.60807070067627,0.09088887095222942,175.9315264225006,85.69125604629517,203.9752082824707,7693,1352,6341,6341,0,11,1330000.0
1330,1330999,21.448656736616257,37.59912989409285,0.09090416607445362,176.0670485496521,85.75659656524658,203.9896469116211,7699,1353,6346,6346,0,11,1331000.0
1331,1331999,21.442429034757364,37.59020447465224,0.09092039282011888,176.19705891609192,85.82232332229614,204.09378051757812,7707,1354,6353,6353,0,11,1332000.0
1332,1332999,21.436536357342952,37.58044644192304,0.09093542447472713,176.33458828926086,85.88757491111755,204.24642181396484,7707,1354,6353,6353,0,11,1333000.0
1333,1333999,21.43094303267387,37.57188849475375,0.09094862364721235,176.45304441452026,85.95259141921997,204.3393096923828,7707,1354,6353,6353,0,11,1334000.0
1334,1334999,21.426733608511245,37.56598198190877,0.09097390822256513,176.60775876045227,86.01786971092224,204.49933624267578,7711,1355,6356,6356,0,11,1335000.0
1335,1335999,21.423845327412632,37.5646172727423,0.09094416020720697,176.7933897972107,86.08453416824341,204.52112579345703,7728,1358,6370,6370,0,11,1336000.0
1336,1336999,21.421188066513288,37.56058477978157,0.09092256190571812,176.90633916854858,86.14983105659485,204.65654754638672,7728,1358,6370,6370,0,11,1337000.0
1337,1337999,21.41826074248943,37.555156935421145,0.09092517216658391,177.05919003486633,86.21631908416748,204.74722290039062,7730,1359,6371,6371,0,11,1338000.0
1338,1338999,21.417749153980264,37.554497847977956,0.09091050077368301,177.19789600372314,86.28142833709717,204.8384017944336,7732,1360,6372,6372,0,11,1339000.0
1339,1339999,21.416713077663186,37.55566107297162,0.09088223455007638,177.3390564918518,86.34750056266785,204.99414443969727,7734,1361,6373,6373,0,11,1340000.0
1340,1340999,21.415024719876264,37.55270866219959,0.09086607676354552,177.45574855804443,86.41297698020935,205.1590919494629,7734,1361,6373,6373,0,11,1341000.0
1341,1341999,21.412517362282028,37.54634618480073,0.09085986506196331,177.59327363967896,86.47762060165405,205.1985092163086,7736,1362,6374,6374,0,11,1342000.0
1342,1342999,21.409060043289532,37.53939494623659,0.09084738788900992,177.73553133010864,86.54239130020142,205.51037216186523,7738,1363,6375,6375,0,11,1343000.0
1343,1343999,21.403999266388436,37.533009756750516,0.09085177480061313,177.8649880886078,86.60892224311829,205.81623458862305,7739,1363,6376,6376,0,11,1344000.0
1344,1344999,21.399160441543405,37.525610456206394,0.09085973940385861,178.01651525497437,86.6747694015503,205.90520477294922,7743,1365,6378,6378,0,11,1345000.0
1345,1345999,21.394917901322035,37.5254629484075,0.09083211666607627,178.13522005081177,86.7400164604187,206.08691024780273,7744,1365,6379,6379,0,11,1346000.0
1346,1346999,21.391122842939765,37.51842416980326,0.09084426924420552,178.2535617351532,86.8061876296997,206.30254745483398,7745,1365,6380,6380,0,11,1347000.0
1347,1347999,21.388342061390084,37.51195858437138,0.09082595669937055,178.4072835445404,86.87303590774536,206.40014266967773,7748,1366,6382,6382,0,11,1348000.0
1348,1348999,21.384982966168742,37.50524412103881,0.09080533939817936,178.53262400627136,86.93888425827026,206.51168823242188,7748,1366,6382,6382,0,11,1349000.0
1349,1349999,21.38274297309134,37.503637228939326,0.0907536917044921,178.6769518852234,87.00790524482727,206.55076217651367,7750,1367,6383,6383,0,11,1350000.0
1350,1350999,21.38121926183493,37.50423717494176,0.09069544979366861,178.85899019241333,87.07423043251038,206.56825256347656,7757,1369,6388,6388,0,11,1351000.0
1351,1351999,21.378766385855634,37.49865483311896,0.09067089059511557,179.057053565979,87.15043497085571,206.57907485961914,7768,1372,6396,6396,0,11,1352000.0
1352,1352999,21.376284760348053,37.49195943609615,0.09063417989023115,179.1872661113739,87.22022223472595,206.73179626464844,7768,1372,6396,6396,0,11,1353000.0
1353,1353999,21.375021940601435,37.48884664098129,0.09058779581896359,179.29922699928284,87.28534197807312,206.8113021850586,7768,1372,6396,6396,0,11,1354000.0
1354,1354999,21.37488871274601,37.496869118825025,0.09047090658819978,179.42438650131226,87.35060000419617,206.87614059448242,7768,1372,6396,6396,0,11,1355000.0
1355,1355999,21.374301858805683,37.49297472456332,0.09042432899625019,179.60130739212036,87.41615080833435,206.8045997619629,7780,1375,6405,6405,0,11,1356000.0
1356,1356999,21.373489654358576,37.48922011677965,0.09037804814123307,179.80104994773865,87.48662805557251,206.8245849609375,7788,1378,6410,6410,0,11,1357000.0
1357,1357999,21.375047307280106,37.496861262726995,0.09028915999999731,179.95074343681335,87.55470728874207,206.92658615112305,7790,1379,6411,6411,0,11,1358000.0
1358,1358999,21.375411898000404,37.494389340631635,0.09023865661158526,180.0832531452179,87.62029361724854,207.15237426757812,7791,1379,6412,6412,0,11,1359000.0
1359,1359999,21.375947733419714,37.49161510778888,0.09020419057993845,180.20784950256348,87.68571162223816,207.28248977661133,7791,1379,6412,6412,0,11,1360000.0
1360,1360999,21.375830464990955,37.48743158001077,0.09018731770287702,180.34725379943848,87.75108218193054,207.33813095092773,7793,1380,6413,6413,0,11,1361000.0
1361,1361999,21.374904125889397,37.48175933093893,0.09016443465139679,180.49154615402222,87.81653213500977,207.37353515625,7801,1381,6420,6420,0,11,1362000.0
1362,1362999,21.37597247276447,37.480581910775,0.0900803897647452,180.62294483184814,87.88249659538269,207.7739601135254,7808,1382,6426,6426,0,11,1363000.0
1363,1363999,21.37414992125262,37.47664455496899,0.09002430092094216,180.74072813987732,87.94809579849243,208.05088424682617,7808,1382,6426,6426,0,11,1364000.0
1364,1364999,21.373552943006374,37.4761682778583,0.08997535961460901,180.8866834640503,88.01330304145813,208.1388053894043,7810,1383,6427,6427,0,11,1365000.0
1365,1365999,21.372722968956126,37.47394763104914,0.08993027032299339,181.03477334976196,88.07996368408203,208.19259643554688,7813,1384,6429,6429,0,11,1366000.0
1366,1366999,21.372037055616595,37.47148488159657,0.08988217560783607,181.1520552635193,88.1453161239624,208.31337356567383,7814,1384,6430,6430,0,11,1367000.0
1367,1367999,21.374680712154735,37.474528605005155,0.08979262108726949,181.296067237854,88.21062111854553,208.46950912475586,7817,1385,6432,6432,0,11,1368000.0
1368,1368999,21.37601842561221,37.473775691725265,0.08970613614756129,181.4253101348877,88.27558088302612,208.59932327270508,7817,1385,6432,6432,0,11,1369000.0
1369,1369999,21.377798812231323,37.474281990974376,0.08964333229535104,181.5363233089447,88.34022927284241,208.70333099365234,7817,1385,6432,6432,0,11,1370000.0
1370,1370999,21.37853935408108,37.471808718501634,0.08961238604186039,181.70768427848816,88.40573596954346,208.66349029541016,7821,1387,6434,6434,0,11,1371000.0
1371,1371999,21.37897336776249,37.46832352657195,0.08955822364010857,181.8861870765686,88.47143268585205,208.66409301757812,7828,1390,6438,6438,0,11,1372000.0
1372,1372999,21.38055938364966,37.46771201587642,0.08951007712141257,182.0087287425995,88.53761029243469,208.77598571777344,7828,1390,6438,6438,0,11,1373000.0
1373,1373999,21.382132235655753,37.465516485291886,0.08942251359548781,182.1480586528778,88.60295486450195,208.89184188842773,7830,1391,6439,6439,0,11,1374000.0
1374,1374999,21.38488765904436,37.465761698430484,0.08933580342504566,182.26176071166992,88.66805052757263,209.00518035888672,7830,1391,6439,6439,0,11,1375000.0
1375,1375999,21.38570138521567,37.460854461353186,0.08925169938702093,182.414160490036,88.73355102539062,209.0268096923828,7832,1392,6440,6440,0,11,1376000.0
1376,1376999,21.386780783072858,37.45809680647465,0.08916569585123091,182.54288125038147,88.79896187782288,209.1235466003418,7832,1392,6440,6440,0,11,1377000.0
1377,1377999,21.387932533614645,37.455292110018505,0.08911850497100804,182.71876287460327,88.86485075950623,209.0567741394043,7839,1395,6444,6444,0,11,1378000.0
1378,1378999,21.388663333419565,37.45427772758403,0.08908092365190512,182.8591206073761,88.9305431842804,209.07464981079102,7842,1396,6446,6446,0,11,1379000.0
1379,1379999,21.389885276166595,37.450616475773025,0.08899504882752296,183.00176811218262,88.99656748771667,209.11651229858398,7844,1397,6447,6447,0,11,1380000.0
1380,1380999,21.391725794010373,37.44699455179904,0.08892361772206048,183.13583874702454,89.06155061721802,209.19892120361328,7844,1397,6447,6447,0,11,1381000.0
1381,1381999,21.391388983781457,37.441028490678704,0.08885623718249658,183.2932047843933,89.12795066833496,209.18903350830078,7848,1399,6449,6449,0,11,1382000.0
1382,1382999,21.390873385579887,37.434790126639626,0.08878310422957936,183.42592763900757,89.19305729866028,209.23873901367188,7848,1399,6449,6449,0,11,1383000.0
1383,1383999,21.389281541142868,37.430640486158964,0.08871484184065448,183.56232023239136,89.25784516334534,209.56991577148438,7857,1400,6457,6457,0,11,1384000.0
1384,1384999,21.38589710842795,37.42274180245879,0.08871148643412752,183.70379853248596,89.32306003570557,209.7958869934082,7859,1401,6458,6458,0,11,1385000.0
1385,1385999,21.382358034897457,37.41588778518505,0.08871819262653824,183.87658381462097,89.38993954658508,209.82258987426758,7868,1403,6465,6465,0,11,1386000.0
1386,1386999,21.380109492392922,37.411759439691096,0.08865963033807012,183.99382495880127,89.45490574836731,209.97019577026367,7868,1403,6465,6465,0,11,1387000.0
1387,1387999,21.376748529310476,37.40330025237678,0.08865679229162537,184.10838270187378,89.5193657875061,210.09270858764648,7869,1403,6466,6466,0,11,1388000.0
1388,1388999,21.375956418328514,37.39783357631556,0.08858755597484436,184.24878191947937,89.58444094657898,210.30548858642578,7872,1404,6468,6468,0,11,1389000.0
1389,1389999,21.373791775634153,37.390283755734934,0.088548085200012,184.39048051834106,89.64996314048767,210.43964767456055,7874,1405,6469,6469,0,11,1390000.0
1390,1390999,21.371755212414236,37.38294436244743,0.08850675424645327,184.52537035942078,89.71616649627686,210.52738571166992,7877,1406,6471,6471,0,11,1391000.0
1391,1391999,21.369648712135998,37.376841325247774,0.08846111430333503,184.68759679794312,89.78192400932312,210.58413696289062,7886,1408,6478,6478,0,11,1392000.0
1392,1392999,21.367997438761186,37.37007991863684,0.0884125138058135,184.81500005722046,89.84704422950745,210.71782684326172,7886,1408,6478,6478,0,11,1393000.0
1393,1393999,21.366194962551283,37.36424424007045,0.08836063623865442,184.97426581382751,89.91343474388123,210.74321365356445,7888,1409,6479,6479,0,11,1394000.0
1394,1394999,21.368252676213064,37.363305116568675,0.08822206123991261,185.11513137817383,89.97891402244568,210.96662139892578,7890,1410,6480,6480,0,11,1395000.0
1395,1395999,21.372890659678994,37.369100344686224,0.08802808440509635,185.28444981575012,90.05075979232788,211.05720901489258,7894,1412,6482,6482,0,11,1396000.0
1396,1396999,21.378560223338166,37.377460568897874,0.08795313154515405,185.42841029167175,90.116206407547,211.1490936279297,7896,1413,6483,6483,0,11,1397000.0
1397,1397999,21.38513974136213,37.388506197306086,0.08782974769895646,185.5693323612213,90.18110752105713,211.25659942626953,7899,1414,6485,6485,0,11,1398000.0
1398,1398999,21.390784324149028,37.39843984397613,0.08777566416166294,185.69402050971985,90.24632453918457,211.3952865600586,7899,1414,6485,6485,0,11,1399000.0
1399,1399999,21.395778295502595,37.402935007634284,0.087688488881276,185.85839653015137,90.31169128417969,211.42523956298828,7909,1417,6492,6492,0,11,1400000.0
1400,1400999,21.40635140317711,37.416600938145166,0.08745774013332697,186.0104682445526,90.37743973731995,211.62534713745117,7914,1419,6495,6495,0,11,1401000.0
1401,1401999,21.413458694721246,37.42190884228057,0.0872684676751514,186.14957237243652,90.44240927696228,211.72037887573242,7922,1420,6502,6502,0,11,1402000.0
1402,1402999,21.420814563477133,37.426874522953185,0.08714317945887418,186.31632709503174,90.50862050056458,211.7523536682129,7927,1422,6505,6505,0,11,1403000.0
1403,1403999,21.425218218919007,37.43096481187717,0.08707127409349402,186.4597487449646,90.57408285140991,211.85365676879883,7929,1423,6506,6506,0,11,1404000.0
1404,1404999,21.428218908525395,37.42957663498461,0.08677046774810337,186.62064409255981,90.6391294002533,212.18289947509766,7937,1425,6512,6512,0,11,1405000.0
1405,1405999,21.430946343520933,37.42745422998534,0.08647384558621285,186.73667669296265,90.70488619804382,212.41314697265625,7937,1425,6512,6512,0,11,1406000.0
1406,1406999,21.433722251839768,37.42477413225636,0.08618705374537083,186.88719964027405,90.76989507675171,212.52584075927734,7939,1426,6513,6513,0,11,1407000.0
1407,1407999,21.43760053618238,37.426014335164034,0.08576985936610071,187.00765943527222,90.83438634872437,212.6538429260254,7940,1426,6514,6514,0,11,1408000.0
1408,1408999,21.438204671681834,37.4219034561909,0.0855730377420767,187.16023230552673,90.89984941482544,212.71014404296875,7942,1427,6515,6515,0,11,1409000.0
1409,1409999,21.442082928714537,37.421419592302904,0.08523536425793576,187.3001194000244,90.96561789512634,212.91954040527344,7944,1428,6516,6516,0,11,1410000.0
1410,1410999,21.444176607059998,37.417446962642664,0.08501798309750097,187.431401014328,91.03185200691223,212.98721313476562,7947,1429,6518,6518,0,11,1411000.0
1411,1411999,21.445075871542013,37.413699897574276,0.08486537578143527,187.586172580719,91.09698367118835,213.0175552368164,7952,1431,6521,6521,0,11,1412000.0
1412,1412999,21.44577540540569,37.411540009425096,0.08471142048752778,187.7284255027771,91.16260385513306,213.1146354675293,7955,1432,6523,6523,0,11,1413000.0
1413,1413999,21.446632601624266,37.40958627610349,0.08458436466939967,187.85296416282654,91.22811818122864,213.22683334350586,7955,1432,6523,6523,0,11,1414000.0
1414,1414999,21.450087170186872,37.41896752147489,0.08453662278950569,188.0004427433014,91.29401850700378,213.3047332763672,7957,1433,6524,6524,0,11,1415000.0
1415,1415999,21.45778179901856,37.43812947800138,0.08423519625636078,188.21929931640625,91.35995817184448,213.25848007202148,7969,1438,6531,6531,0,11,1416000.0
1416,1416999,21.463269359157618,37.44408746513998,0.08409882195247365,188.3313570022583,91.42503452301025,213.4272232055664,7970,1438,6532,6532,0,11,1417000.0
1417,1417999,21.469064091299717,37.455763345201106,0.08403680199996921,188.48670411109924,91.49038052558899,213.45714950561523,7975,1440,6535,6535,0,11,1418000.0
1418,1418999,21.47459104207334,37.46646801273856,0.08397639510094301,188.65493488311768,91.55638861656189,213.51761627197266,7979,1442,6537,6537,0,11,1419000.0
1419,1419999,21.478633917093497,37.47275121655375,0.08384641455557085,188.77934980392456,91.62160563468933,213.66120147705078,7980,1442,6538,6538,0,11,1420000.0
1420,1420999,21.486668667194078,37.490149611244874,0.0838333471399163,188.9009518623352,91.68678259849548,213.82471084594727,7980,1442,6538,6538,0,11,1421000.0
1421,1421999,21.495498575935404,37.499933174015986,0.08383029791397512,189.0593283176422,91.75239682197571,213.8986473083496,7986,1444,6542,6542,0,11,1422000.0
1422,1422999,21.50356783825771,37.50795706854544,0.08381943679077342,189.2078766822815,91.81717681884766,213.96426391601562,7989,1445,6544,6544,0,11,1423000.0
1423,1423999,21.511778286424722,37.516735090082854,0.0838304652804992,189.33231329917908,91.88347220420837,214.07537841796875,7989,1445,6544,6544,0,11,1424000.0
1424,1424999,21.51403361614934,37.51467179114501,0.08386155368793102,189.44533801078796,91.94789576530457,214.1814956665039,7990,1445,6545,6545,0,11,1425000.0
1425,1425999,21.519759307951187,37.522515008621056,0.0835017041354279,189.6072039604187,92.01395010948181,214.53378295898438,7997,1447,6550,6550,0,11,1426000.0
1426,1426999,21.52360844932501,37.52550398785845,0.08323707987518414,189.7326774597168,92.07942652702332,214.76206588745117,7997,1447,6550,6550,0,11,1427000.0
1427,1427999,21.5265611679623,37.524629383393,0.08301501565430736,189.87891101837158,92.14610719680786,214.88037109375,7999,1448,6551,6551,0,11,1428000.0
1428,1428999,21.53065979947974,37.52629067773582,0.08276852385247169,189.99641132354736,92.21114349365234,215.01327896118164,8001,1448,6553,6553,0,11,1429000.0
1429,1429999,21.533943218063765,37.527148141719536,0.08251625967743526,190.1433229446411,92.27732515335083,215.13624572753906,8004,1449,6555,6555,0,11,1430000.0
1430,1430999,21.539547569107135,37.5300590608449,0.08208279469107538,190.29109501838684,92.34374737739563,215.28473663330078,8008,1450,6558,6558,0,11,1431000.0
1431,1431999,21.543337743780032,37.5309010832671,0.08180183766561822,190.43268179893494,92.40993285179138,215.4223518371582,8010,1451,6559,6559,0,11,1432000.0
1432,1432999,21.54706445447668,37.53332311364876,0.08143364280913223,190.60188937187195,92.47622346878052,215.46429443359375,8018,1454,6564,6564,0,11,1433000.0
1433,1433999,21.549870819485395,37.5331505138819,0.08118123855931836,190.71931719779968,92.5421257019043,215.59614944458008,8019,1454,6565,6565,0,11,1434000.0
1434,1434999,21.55201858982811,37.53168644271146,0.08101975032211173,190.94473147392273,92.60979771614075,215.52058029174805,8031,1459,6572,6572,0,11,1435000.0
1435,1435999,21.554836652609243,37.53154347671756,0.08079033287412674,191.113765001297,92.67672324180603,215.6138572692871,8036,1461,6575,6575,0,11,1436000.0
1436,1436999,21.56029903569765,37.53411808646057,0.08051880321537797,191.2607204914093,92.74331855773926,215.73915481567383,8038,1462,6576,6576,0,11,1437000.0
1437,1437999,21.56459056145265,37.535718505537396,0.08024685515066432,191.39393663406372,92.80887460708618,215.80472564697266,8041,1463,6578,6578,0,11,1438000.0
1438,1438999,21.568560729155475,37.53769975083823,0.08008544869723866,191.59524083137512,92.87573099136353,215.70490264892578,8051,1467,6584,6584,0,11,1439000.0
1439,1439999,21.572223329171486,37.53843119311781,0.07997986270113544,191.73528051376343,92.94505953788757,215.81036376953125,8053,1468,6585,6585,0,11,1440000.0
1440,1440999,21.576107199418423,37.53954855303462,0.07999853347124397,191.92576026916504,93.01210379600525,215.7865219116211,8064,1471,6593,6593,0,11,1441000.0
1441,1441999,21.581354243920845,37.542463186016626,0.07996483678963073,192.09121894836426,93.07840275764465,215.87074661254883,8068,1473,6595,6595,0,11,1442000.0
1442,1442999,21.58776210409064,37.54502782535032,0.07979638166758873,192.2072081565857,93.14366555213928,215.99497604370117,8069,1473,6596,6596,0,11,1443000.0
1443,1443999,21.59389337511352,37.5484285306162,0.07971543179722029,192.40385103225708,93.20932102203369,215.91901779174805,8080,1477,6603,6603,0,11,1444000.0
1444,1444999,21.598570744121748,37.55462521232625,0.07974647064012175,192.52154088020325,93.27487707138062,216.03060913085938,8080,1477,6603,6603,0,11,1445000.0
1445,1445999,21.601549016995023,37.5529459505973,0.07971679210921456,192.6806037425995,93.34059715270996,216.1263198852539,8090,1479,6611,6611,0,11,1446000.0
1446,1446999,21.601344946769025,37.551133341954895,0.07959868397753422,192.80691003799438,93.4058187007904,216.53395462036133,8090,1479,6611,6611,0,11,1447000.0
1447,1447999,21.6011283116608,37.55561112440266,0.07950359394101791,192.92567229270935,93.47105669975281,216.66163635253906,8090,1479,6611,6611,0,11,1448000.0
1448,1448999,21.59975492791803,37.55070400093312,0.07942792826764955,193.07515382766724,93.53695607185364,216.72924423217773,8093,1480,6613,6613,0,11,1449000.0
1449,1449999,21.598995530582524,37.550438008436934,0.07937688130774989,193.2233169078827,93.60245323181152,216.7710304260254,8095,1481,6614,6614,0,11,1450000.0
1450,1450999,21.599209121804556,37.54970009274027,0.07932696357256341,193.3730525970459,93.66833138465881,216.84209442138672,8099,1483,6616,6616,0,11,1451000.0
1451,1451999,21.59945810582118,37.55006137163057,0.07923830360563522,193.53133821487427,93.74455666542053,216.94605255126953,8102,1484,6618,6618,0,11,1452000.0
1452,1452999,21.600167133345877,37.54789569344538,0.0791820358330565,193.67512106895447,93.81089067459106,217.0138053894043,8104,1485,6619,6619,0,11,1453000.0
1453,1453999,21.600259501035364,37.56540598151145,0.0790736367688164,193.82036781311035,93.8765070438385,217.06356811523438,8106,1486,6620,6620,0,11,1454000.0
1454,1454999,21.600961729732084,37.56597600857252,0.07903738715236774,193.94629788398743,93.94193983078003,217.14960479736328,8106,1486,6620,6620,0,11,1455000.0
1455,1455999,21.602202729684034,37.56560181836734,0.07899211547496066,194.1350917816162,94.00778985023499,217.1226692199707,8116,1489,6627,6627,0,11,1456000.0
1456,1456999,21.6059487389221,37.57984765712632,0.07889650990569186,194.2712481021881,94.07370662689209,217.23834228515625,8116,1489,6627,6627,0,11,1457000.0
1457,1457999,21.608772412765287,37.58227916290811,0.07881177201337497,194.4767997264862,94.13984513282776,217.11207962036133,8138,1494,6644,6644,0,11,1458000.0
1458,1458999,21.6124794055858,37.59740008350837,0.07877597174210382,194.59923577308655,94.20564675331116,217.1982421875,8138,1494,6644,6644,0,11,1459000.0
1459,1459999,21.617969469461094,37.619038227716054,0.07874286828667043,194.760155916214,94.27286672592163,217.23115921020508,8143,1496,6647,6647,0,11,1460000.0
1460,1460999,21.624430506052573,37.64156588297021,0.07851692558130219,194.9107301235199,94.33867073059082,217.3566436767578,8146,1497,6649,6649,0,11,1461000.0
1461,1461999,21.629448599900318,37.64799642145921,0.07837643812036188,195.0680866241455,94.40401220321655,217.3296012878418,8154,1499,6655,6655,0,11,1462000.0
1462,1462999,21.635154480019395,37.660510705267846,0.0782478503151306,195.20134592056274,94.46949672698975,217.41815185546875,8154,1499,6655,6655,0,11,1463000.0
1463,1463999,21.637479644568295,37.661556387540635,0.07818291694320456,195.32719922065735,94.53497242927551,217.8904914855957,8154,1499,6655,6655,0,11,1464000.0
1464,1464999,21.639632399211877,37.66849107439081,0.07814793610838511,195.46924877166748,94.60202407836914,218.18436813354492,8157,1500,6657,6657,0,11,1465000.0
1465,1465999,21.644098431024744,37.68129606236814,0.0781180629091025,195.59536361694336,94.66807889938354,218.37968826293945,8157,1500,6657,6657,0,11,1466000.0
1466,1466999,21.647422747274604,37.69117291131548,0.07810067112914343,195.7197082042694,94.73389959335327,218.5159797668457,8158,1500,6658,6658,0,11,1467000.0
1467,1467999,21.65441374657216,37.708710088842466,0.07806367339431197,195.83692359924316,94.7993369102478,218.6948127746582,8158,1500,6658,6658,0,11,1468000.0
1468,1468999,21.65872229217062,37.71634780415013,0.07798690304288369,195.968896150589,94.86585307121277,218.83482360839844,8159,1500,6659,6659,0,11,1469000.0
1469,1469999,21.66384473265813,37.7247759545839,0.07794647676753319,196.0915982723236,94.9312846660614,218.93107986450195,8159,1500,6659,6659,0,11,1470000.0
1470,1470999,21.669846485911375,37.73562448651774,0.07791146754019806,196.23714971542358,94.99696636199951,218.94658279418945,8161,1501,6660,6660,0,11,1471000.0
1471,1471999,21.676862737678093,37.74955180824682,0.0779366822197658,196.391752243042,95.06265354156494,218.97130966186523,8166,1503,6663,6663,0,11,1472000.0
1472,1472999,21.68376349914771,37.771406214856974,0.0779957164124947,196.53070664405823,95.12843561172485,219.08173751831055,8169,1504,6665,6665,0,11,1473000.0
1473,1473999,21.68879617741942,37.77946902987365,0.07798144697389653,196.69763922691345,95.19425296783447,219.0955352783203,8175,1506,6669,6669,0,11,1474000.0
1474,1474999,21.69600266687794,37.793826074277696,0.07807066989868028,196.86278319358826,95.26014113426208,219.11853408813477,8180,1508,6672,6672,0,11,1475000.0
1475,1475999,21.704093710190474,37.81104315547671,0.07810172481281741,196.98533391952515,95.32628607749939,219.2249641418457,8180,1508,6672,6672,0,11,1476000.0
1476,1476999,21.711457309808125,37.82370636549041,0.07821872212574921,197.14485597610474,95.3925576210022,219.20924377441406,8185,1510,6675,6675,0,11,1477000.0
1477,1477999,21.71947075896152,37.83446864509167,0.07823230016363181,197.30756855010986,95.46036410331726,219.2981948852539,8189,1512,6677,6677,0,11,1478000.0
1478,1478999,21.72577650019044,37.851808150575295,0.07831539460320602,197.45259380340576,95.52644181251526,219.3798599243164,8192,1513,6679,6679,0,11,1479000.0
1479,1479999,21.734721816425875,37.86742685692242,0.07840844356223697,197.56981754302979,95.59166240692139,219.45012664794922,8192,1513,6679,6679,0,11,1480000.0
1480,1480999,21.73563010620397,37.868683834618885,0.07842718770100854,197.69152212142944,95.65691709518433,219.73606491088867,8192,1513,6679,6679,0,11,1481000.0
1481,1481999,21.73313586086135,37.87007208910488,0.0783993396887317,197.81661891937256,95.72328233718872,219.97567749023438,8192,1513,6679,6679,0,11,1482000.0
1482,1482999,21.730010591574914,37.868319953072344,0.07838039995462076,197.9599905014038,95.78888058662415,220.05983352661133,8194,1514,6680,6680,0,11,1483000.0
1483,1483999,21.72651812497326,37.865638972692544,0.07835654445027085,198.07950735092163,95.85413384437561,220.17058944702148,8194,1514,6680,6680,0,11,1484000.0
1484,1484999,21.72463238324725,37.86328844263841,0.0783356960973226,198.25244665145874,95.92066693305969,220.28113174438477,8227,1516,6711,6711,0,11,1485000.0
1485,1485999,21.722431590103895,37.860881790144724,0.07832043579213332,198.3689043521881,95.98608779907227,220.4106788635254,8227,1516,6711,6711,0,11,1486000.0
1486,1486999,21.719657165969643,37.85468084222677,0.07831237253839773,198.5017249584198,96.05160284042358,220.50403213500977,8227,1516,6711,6711,0,11,1487000.0
1487,1487999,21.717382437774113,37.85093598043392,0.07830787885220747,198.6499412059784,96.11826920509338,220.53749084472656,8229,1517,6712,6712,0,11,1488000.0
1488,1488999,21.71680156962589,37.85183207110279,0.0783224901194236,198.77307748794556,96.18407106399536,220.6134376525879,8229,1517,6712,6712,0,11,1489000.0
1489,1489999,21.717017654737504,37.85834569658731,0.07829469898175145,198.91670322418213,96.25049042701721,220.70831680297852,8229,1517,6712,6712,0,11,1490000.0
1490,1490999,21.717567997781565,37.86045415978446,0.07825948334516764,199.03505730628967,96.3160891532898,220.8154525756836,8229,1517,6712,6712,0,11,1491000.0
1491,1491999,21.7179161828357,37.85972057198281,0.07825096021189837,199.17303490638733,96.39161682128906,220.88168334960938,8229,1517,6712,6712,0,11,1492000.0
1492,1492999,21.718696380235414,37.86102938004719,0.07826466855544412,199.31807208061218,96.45773506164551,220.90166091918945,8231,1518,6713,6713,0,11,1493000.0
1493,1493999,21.72044204745358,37.86243961619025,0.07831403853863383,199.4638557434082,96.5239679813385,220.92229080200195,8233,1519,6714,6714,0,11,1494000.0
1494,1494999,21.723405508089733,37.866103440574534,0.07833468819050937,199.61990118026733,96.5900354385376,220.94463729858398,8237,1521,6716,6716,0,11,1495000.0
1495,1495999,21.725837610887258,37.86959614421081,0.07845534676701227,199.79798984527588,96.65721392631531,220.9597396850586,8243,1523,6720,6720,0,11,1496000.0
1496,1496999,21.728359857083237,37.869496834434656,0.07848092780081783,199.9401490688324,96.72336864471436,221.06555938720703,8245,1524,6721,6721,0,11,1497000.0
1497,1497999,21.733357699852395,37.87955670055604,0.07847196246088595,200.12242150306702,96.78945755958557,220.9996337890625,8251,1527,6724,6724,0,11,1498000.0
1498,1498999,21.738090301531308,37.884641714753606,0.07856601963822418,200.26190161705017,96.85546612739563,221.12495040893555,8253,1528,6725,6725,0,11,1499000.0
1499,1499999,21.74079000045391,37.885746892557684,0.07859182834894096,200.40813446044922,96.92124032974243,221.17937088012695,8261,1529,6732,6732,0,11,1500000.0
1500,1500999,21.74202898601876,37.89444790141697,0.07853905178498344,200.53903436660767,96.98629474639893,221.48330307006836,8265,1530,6735,6735,0,11,1501000.0
1501,1501999,21.73897564003508,37.89921044429376,0.07849237198310521,200.65736317634583,97.0509865283966,221.69304275512695,8265,1530,6735,6735,0,11,1502000.0
1502,1502999,21.734038478399622,37.8936946163456,0.07849984822882083,200.7911205291748,97.11591744422913,221.78092193603516,8265,1530,6735,6735,0,11,1503000.0
1503,1503999,21.729612647075676,37.886470097192245,0.07850757612889736,200.9459421634674,97.18116426467896,221.84481811523438,8269,1531,6738,6738,0,11,1504000.0
1504,1504999,21.725617821887298,37.8802552609354,0.07850896806861729,201.0809268951416,97.2530574798584,221.93318557739258,8270,1531,6739,6739,0,11,1505000.0
1505,1505999,21.723500556085337,37.88055129794504,0.0784652589674314,201.21945881843567,97.31812238693237,222.0829315185547,8275,1532,6743,6743,0,11,1506000.0
1506,1506999,21.72116552254372,37.875770062992736,0.07843840925538681,201.3899917602539,97.39154148101807,222.14636611938477,8278,1533,6745,6745,0,11,1507000.0
1507,1507999,21.71861125357608,37.87174915945854,0.07840846187762263,201.5162227153778,97.45720648765564,222.24077224731445,8278,1533,6745,6745,0,11,1508000.0
1508,1508999,21.716623883903416,37.86667740443156,0.07837585016296011,201.6396656036377,97.52239179611206,222.3177947998047,8278,1533,6745,6745,0,11,1509000.0
1509,1509999,21.714106626659408,37.86127150259772,0.07836288616500497,201.76744961738586,97.58764481544495,222.40010833740234,8278,1533,6745,6745,0,11,1510000.0
1510,1510999,21.711812634280307,37.85562768119295,0.07835021030358191,201.91195011138916,97.65340495109558,222.46546173095703,8278,1533,6745,6745,0,11,1511000.0
1511,1511999,21.71115044903151,37.85350813608648,0.0783419729002619,202.03239560127258,97.71835589408875,222.59993743896484,8278,1533,6745,6745,0,11,1512000.0
1512,1512999,21.710849609930232,37.85146582533278,0.07830019780848119,202.15324473381042,97.78329348564148,222.68355560302734,8278,1533,6745,6745,0,11,1513000.0
1513,1513999,21.71094385637757,37.84864927418954,0.0782738037994628,202.28986740112305,97.84806323051453,222.7343864440918,8278,1533,6745,6745,0,11,1514000.0
1514,1514999,21.71133572502906,37.84956314352937,0.07824738735889836,202.47440695762634,97.91602158546448,222.68561935424805,8284,1536,6748,6748,0,11,1515000.0
1515,1515999,21.711771802531253,37.84727588058432,0.07823536791427355,202.61386370658875,97.98199439048767,222.69718170166016,8286,1537,6749,6749,0,11,1516000.0
1516,1516999,21.712001906062454,37.844718357370986,0.07825975617993042,202.73169207572937,98.04713535308838,222.78726196289062,8286,1537,6749,6749,0,11,1517000.0
1517,1517999,21.71377458542344,37.84417442680895,0.07827893602174507,202.87634682655334,98.11361885070801,222.9251823425293,8287,1537,6750,6750,0,11,1518000.0
1518,1518999,21.716815410538086,37.84458102520215,0.07829128860874757,203.04654455184937,98.17881321907043,222.8503532409668,8291,1539,6752,6752,0,11,1519000.0
1519,1519999,21.71923289822742,37.84507240839134,0.07833739156445885,203.16643500328064,98.24483227729797,222.99548721313477,8292,1539,6753,6753,0,11,1520000.0
1520,1520999,21.72089829598047,37.84399834993196,0.07836126107237318,203.30305695533752,98.3098213672638,223.0306282043457,8294,1540,6754,6754,0,11,1521000.0
1521,1521999,21.719534452102533,37.83964212786631,0.07838205578122626,203.45131182670593,98.37461876869202,223.26361083984375,8297,1541,6756,6756,0,11,1522000.0
1522,1522999,21.714817822836192,37.84221994257608,0.0783670850778504,203.59563875198364,98.43964791297913,223.41089248657227,8299,1542,6757,6757,0,11,1523000.0
1523,1523999,21.709470914003475,37.83850265155027,0.07837719619366035,203.73943042755127,98.50846910476685,223.4746208190918,8301,1543,6758,6758,0,11,1524000.0
1524,1524999,21.703553703940425,37.83030170369232,0.07839763040720671,203.8686842918396,98.57343554496765,223.56180953979492,8301,1543,6758,6758,0,11,1525000.0
1525,1525999,21.698128105697183,37.8220566948622,0.07841870838529919,203.99931931495667,98.63832592964172,223.60192489624023,8306,1544,6762,6762,0,11,1526000.0
1526,1526999,21.693263237764743,37.815338064436865,0.07843687435916347,204.1904718875885,98.70774531364441,223.69066619873047,8311,1546,6765,6765,0,11,1527000.0
1527,1527999,21.688623393745694,37.80801266152711,0.07845426291620405,204.30945205688477,98.77839803695679,223.87185287475586,8311,1546,6765,6765,0,11,1528000.0
1528,1528999,21.683778451151326,37.80008149190871,0.07847872554026258,204.4385049343109,98.84346151351929,223.99067306518555,8311,1546,6765,6765,0,11,1529000.0
1529,1529999,21.679298911538638,37.792937655966206,0.07849667328045107,204.56698536872864,98.91675186157227,224.06813430786133,8311,1546,6765,6765,0,11,1530000.0
1530,1530999,21.67529227125484,37.7878299367543,0.07849392996282845,204.71788477897644,98.98273777961731,224.08536911010742,8313,1547,6766,6766,0,11,1531000.0
1531,1531999,21.67182220755178,37.78186569440935,0.07850656523153188,204.89351511001587,99.04893589019775,224.13897323608398,8318,1549,6769,6769,0,11,1532000.0
1532,1532999,21.66766790815967,37.77459763857051,0.07852166983939668,205.01984930038452,99.11399698257446,224.29803085327148,8318,1549,6769,6769,0,11,1533000.0
1533,1533999,21.66406271918828,37.76724546929836,0.07853664217647205,205.20044040679932,99.18079352378845,224.24449157714844,8329,1552,6777,6777,0,11,1534000.0
1534,1534999,21.6602259835251,37.761659793542805,0.07854132970408123,205.32891082763672,99.24692368507385,224.39520645141602,8329,1552,6777,6777,0,11,1535000.0
1535,1535999,21.657866960310173,37.75717992673617,0.07854017425246596,205.4666576385498,99.3121452331543,224.5123405456543,8331,1553,6778,6778,0,11,1536000.0
1536,1536999,21.656480603664576,37.754688218666146,0.07854379622874241,205.6325433254242,99.37840938568115,224.58142852783203,8335,1555,6780,6780,0,11,1537000.0
1537,1537999,21.654521894240663,37.750326490776416,0.07855212997446348,205.75088357925415,99.44344115257263,224.69578170776367,8335,1555,6780,6780,0,11,1538000.0
1538,1538999,21.65314995080343,37.745609785364145,0.0785568206134053,205.89331126213074,99.50995898246765,224.83804321289062,8337,1556,6781,6781,0,11,1539000.0
1539,1539999,21.65178985977969,37.74145389643975,0.07855931491438883,206.03108763694763,99.5770161151886,224.98224639892578,8337,1556,6781,6781,0,11,1540000.0
1540,1540999,21.650619452255032,37.7381074499678,0.07855586811960324,206.14119863510132,99.64199829101562,225.08343505859375,8337,1556,6781,6781,0,11,1541000.0
1541,1541999,21.648347620761534,37.73246375825404,0.07855937209275188,206.25769662857056,99.70668458938599,225.1720733642578,8337,1556,6781,6781,0,11,1542000.0
1542,1542999,21.645618279779622,37.72643401037759,0.0784648623916614,206.37208127975464,99.77085161209106,225.4004249572754,8337,1556,6781,6781,0,11,1543000.0
1543,1543999,21.644717807922536,37.72586376350424,0.07831383878462428,206.52908182144165,99.83620548248291,225.54589080810547,8342,1558,6784,6784,0,11,1544000.0
1544,1544999,21.64276347876037,37.72026811856426,0.07823475876660269,206.65127539634705,99.90082859992981,225.65532302856445,8342,1558,6784,6784,0,11,1545000.0
1545,1545999,21.63997390222559,37.714046305753406,0.07820416021008214,206.7887315750122,99.96664953231812,225.73674392700195,8345,1559,6786,6786,0,11,1546000.0
1546,1546999,21.63855727753674,37.70997278075453,0.07815612775470349,206.9277241230011,100.03272461891174,225.8492660522461,8346,1559,6787,6787,0,11,1547000.0
1547,1547999,21.64043329564868,37.71070077635991,0.07801548829294858,207.0952889919281,100.09844946861267,225.925048828125,8351,1561,6790,6790,0,11,1548000.0
1548,1548999,21.642242406068874,37.71107276564948,0.07795903187943576,207.21389818191528,100.16342329978943,226.03960800170898,8351,1561,6790,6790,0,11,1549000.0
1549,1549999,21.64482509038962,37.71747552224581,0.07785122856724014,207.33811450004578,100.22849988937378,226.1180534362793,8351,1561,6790,6790,0,11,1550000.0
1550,1550999,21.64598530470692,37.72076233610478,0.07778585558363993,207.47879838943481,100.29439783096313,226.09746551513672,8354,1562,6792,6792,0,11,1551000.0
1551,1551999,21.650079666907455,37.73298379360542,0.07769827386225614,207.61473202705383,100.36021876335144,226.18618774414062,8354,1562,6792,6792,0,11,1552000.0
1552,1552999,21.651841619816885,37.73701124899201,0.07773329205252077,207.81667280197144,100.42629480361938,226.09658432006836,8362,1565,6797,6797,0,11,1553000.0
1553,1553999,21.658001793905708,37.75506026337469,0.07775492324074385,207.94567036628723,100.49324059486389,226.2210922241211,8362,1565,6797,6797,0,11,1554000.0
1554,1554999,21.6640809232298,37.77282743725326,0.07775283178438097,208.06191563606262,100.55872559547424,226.28428268432617,8362,1565,6797,6797,0,11,1555000.0
1555,1555999,21.66944106718009,37.78655102271042,0.07771612107203096,208.23566460609436,100.62453722953796,226.25101470947266,8366,1567,6799,6799,0,11,1556000.0
1556,1556999,21.67385762971532,37.796373736003,0.07769670157922404,208.37548995018005,100.6906247138977,226.32169342041016,8368,1568,6800,6800,0,11,1557000.0
1557,1557999,21.678932566616307,37.80634735619444,0.07771274092650615,208.53426861763,100.75663352012634,226.3541603088379,8370,1569,6801,6801,0,11,1558000.0
1558,1558999,21.682313011381,37.81084861390297,0.07764878835294442,208.65655970573425,100.82190346717834,226.44304275512695,8370,1569,6801,6801,0,11,1559000.0
1559,1559999,21.686568672146834,37.817824466533324,0.07757942265275042,208.8110225200653,100.88818526268005,226.44362258911133,8372,1570,6802,6802,0,11,1560000.0
1560,1560999,21.6908235181032,37.82613794057256,0.07752327336443232,208.961341381073,100.95326018333435,226.44214630126953,8376,1572,6804,6804,0,11,1561000.0
1561,1561999,21.695331649465267,37.83064452360632,0.07749204054627001,209.1042673587799,101.0194480419159,226.48606872558594,8378,1573,6805,6805,0,11,1562000.0
1562,1562999,21.69589931072299,37.827731755125406,0.0774532700849665,209.23818707466125,101.08436489105225,226.56808853149414,8378,1573,6805,6805,0,11,1563000.0
1563,1563999,21.694328369323028,37.82595831884574,0.0774602293502864,209.36342120170593,101.15051603317261,226.89524841308594,8378,1573,6805,6805,0,11,1564000.0
1564,1564999,21.693087651458914,37.825811929078675,0.0774799081064329,209.5494668483734,101.21760869026184,226.89374923706055,8384,1576,6808,6808,0,11,1565000.0
1565,1565999,21.69240798124217,37.825454214434934,0.0774768156422152,209.6979296207428,101.28475570678711,226.99737930297852,8386,1577,6809,6809,0,11,1566000.0
1566,1566999,21.692935387643278,37.82669085278554,0.07751816511144494,209.84581470489502,101.35131478309631,227.0930938720703,8390,1578,6812,6812,0,11,1567000.0
1567,1567999,21.694271934907682,37.82738452492282,0.07749792455772331,210.00946640968323,101.42033553123474,227.21951293945312,8396,1580,6816,6816,0,11,1568000.0
1568,1568999,21.6953060399116,37.82811294326174,0.07751886603492286,210.16334748268127,101.48720169067383,227.41050338745117,8400,1581,6819,6819,0,11,1569000.0
1569,1569999,21.69790999789357,37.83071413211578,0.0775200975671505,210.317458152771,101.55410075187683,227.4833526611328,8403,1582,6821,6821,0,11,1570000.0
1570,1570999,21.699678339167477,37.83255750945044,0.07751793168399834,210.45904755592346,101.62045359611511,227.5831642150879,8408,1583,6825,6825,0,11,1571000.0
1571,1571999,21.702111553650766,37.834387147299935,0.07752985953355496,210.60319423675537,101.68707489967346,227.6861228942871,8412,1584,6828,6828,0,11,1572000.0
1572,1572999,21.706235128306133,37.840025612897136,0.07754562084893812,210.7610068321228,101.75649785995483,227.79979705810547,8416,1586,6830,6830,0,11,1573000.0
1573,1573999,21.711749574457382,37.857233886563776,0.07763670619658902,210.94604539871216,101.82375192642212,227.9061279296875,8421,1588,6833,6833,0,11,1574000.0
1574,1574999,21.71706655482042,37.86550654773935,0.07772457723448545,211.07646012306213,101.88996815681458,228.01162719726562,8421,1588,6833,6833,0,11,1575000.0
1575,1575999,21.724070328028358,37.883364081086356,0.07775238212849012,211.19917821884155,101.95606446266174,228.1080780029297,8421,1588,6833,6833,0,11,1576000.0
1576,1576999,21.732699077668645,37.905412085536774,0.07781662143256007,211.3516001701355,102.03655362129211,228.19903564453125,8422,1588,6834,6834,0,11,1577000.0
1577,1577999,21.73911515290089,37.914264861164185,0.07787202168156948,211.48077034950256,102.10340332984924,228.26486206054688,8422,1588,6834,6834,0,11,1578000.0
1578,1578999,21.744733506220914,37.920994859278736,0.07797119405761588,211.6787040233612,102.17024087905884,228.13590240478516,8429,1591,6838,6838,0,11,1579000.0
1579,1579999,21.753103164148882,37.9328003907866,0.07807412406462744,211.84049320220947,102.23887038230896,228.2127227783203,8433,1593,6840,6840,0,11,1580000.0
1580,1580999,21.76070412806798,37.94114373352482,0.07819942888118336,211.9780399799347,102.30541610717773,228.32268905639648,8439,1594,6845,6845,0,11,1581000.0
1581,1581999,21.76885525263694,37.9489042303961,0.07844630950212861,212.17544078826904,102.37244176864624,228.2742462158203,8445,1597,6848,6848,0,11,1582000.0
1582,1582999,21.77687535213868,37.95740057915319,0.07867428483259331,212.3000190258026,102.4388039112091,228.40153884887695,8445,1597,6848,6848,0,11,1583000.0
1583,1583999,21.77958478746608,37.95916165646888,0.0786857489527838,212.47309970855713,102.50499701499939,228.66444778442383,8456,1599,6857,6857,0,11,1584000.0
1584,1584999,21.774563077142346,37.95090853557427,0.07870425725166075,212.5964379310608,102.5730082988739,228.8690185546875,8456,1599,6857,6857,0,11,1585000.0
1585,1585999,21.769086474620924,37.94236559707524,0.07872013628847285,212.72179985046387,102.63906645774841,228.9674835205078,8456,1599,6857,6857,0,11,1586000.0
1586,1586999,21.765237880719592,37.93678665970843,0.07872112105793128,212.86550092697144,102.7052390575409,229.02581405639648,8458,1600,6858,6858,0,11,1587000.0
1587,1587999,21.761497156103058,37.93358627633772,0.07871676278778694,213.0187544822693,102.7713212966919,229.0302276611328,8463,1601,6862,6862,0,11,1588000.0
1588,1588999,21.759003496571758,37.92978838050267,0.07870029029567316,213.14355158805847,102.83733344078064,229.17548751831055,8463,1601,6862,6862,0,11,1589000.0
1589,1589999,21.75601673698659,37.92379839508105,0.07869756402712702,213.26378798484802,102.9034035205841,229.26848602294922,8463,1601,6862,6862,0,11,1590000.0
1590,1590999,21.75224724541746,37.91645744058942,0.0786985867680936,213.42709612846375,102.96966099739075,229.2413558959961,8468,1603,6865,6865,0,11,1591000.0
1591,1591999,21.749769742490347,37.91138908402666,0.07868062111561147,213.57482600212097,103.03572487831116,229.30847930908203,8471,1604,6867,6867,0,11,1592000.0
1592,1592999,21.74756882641875,37.90815256631204,0.07866539840549336,213.72366166114807,103.10212707519531,229.38442993164062,8473,1605,6868,6868,0,11,1593000.0
1593,1593999,21.745947007248496,37.90497157024798,0.07865979594603922,213.87004351615906,103.16851735115051,229.47713470458984,8473,1605,6868,6868,0,11,1594000.0
1594,1594999,21.74596882842002,37.9031381510785,0.0786419855173267,214.03009557724,103.23495125770569,229.60665893554688,8477,1607,6870,6870,0,11,1595000.0
1595,1595999,21.747353309100642,37.9026814362908,0.0786350286541837,214.14908385276794,103.30202102661133,229.72263717651367,8477,1607,6870,6870,0,11,1596000.0
1596,1596999,21.7495897045566,37.91028254608675,0.07858354695165914,214.27853560447693,103.36828708648682,229.79894638061523,8477,1607,6870,6870,0,11,1597000.0
1597,1597999,21.75224820972112,37.91286984535409,0.07855682176791823,214.42414498329163,103.43449401855469,229.8552017211914,8479,1608,6871,6871,0,11,1598000.0
1598,1598999,21.757071711385127,37.920073383908985,0.07855089049922637,214.55434274673462,103.5009412765503,229.9147186279297,8479,1608,6871,6871,0,11,1599000.0
1599,1599999,21.762183675351302,37.92781118851549,0.07856363007215561,214.7116882801056,103.56716585159302,229.95182037353516,8481,1609,6872,6872,0,11,1600000.0
1600,1600999,21.768129400282966,37.93523235803568,0.07857758831576778,214.88143944740295,103.63391065597534,230.01377868652344,8488,1611,6877,6877,0,11,1601000.0
1601,1601999,21.774332386825538,37.944275429762314,0.07867999331043818,215.02284860610962,103.69954490661621,230.07257843017578,8491,1612,6879,6879,0,11,1602000.0
1602,1602999,21.784003059596277,37.976564475713836,0.07870864978783754,215.14473485946655,103.76499772071838,230.13729095458984,8491,1612,6879,6879,0,11,1603000.0
1603,1603999,21.78855174278532,37.9810960080975,0.07876803260555554,215.2866494655609,103.83079528808594,230.1506805419922,8495,1613,6882,6882,0,11,1604000.0
1604,1604999,21.79018810885645,37.98175280971058,0.07874051268469695,215.44559025764465,103.89633512496948,230.4154052734375,8506,1615,6891,6891,0,11,1605000.0
1605,1605999,21.790986215804832,37.99461364878645,0.07860163164074996,215.56931829452515,103.96221899986267,230.6629524230957,8506,1615,6891,6891,0,11,1606000.0
1606,1606999,21.791097228597305,38.00219554182766,0.07851132779219117,215.72755885124207,104.0284674167633,230.7088279724121,8510,1617,6893,6893,0,11,1607000.0
1607,1607999,21.790591948233295,38.00611705249655,0.07843597132184799,215.8674020767212,104.09552454948425,230.84125518798828,8512,1618,6894,6894,0,11,1608000.0
1608,1608999,21.790360248087396,38.00375056793368,0.07839053454686562,215.98879289627075,104.16140675544739,231.04754638671875,8512,1618,6894,6894,0,11,1609000.0
1609,1609999,21.790831893348,38.00412564877996,0.07834984774261511,216.1176359653473,104.22739505767822,231.20365524291992,8512,1618,6894,6894,0,11,1610000.0
1610,1610999,21.791706794896683,38.0072553465864,0.07832898594510618,216.23870396614075,104.293288230896,231.32008743286133,8512,1618,6894,6894,0,11,1611000.0
1611,1611999,21.792926703868826,38.0083340091428,0.07829766034812591,216.35960054397583,104.35941505432129,231.40539169311523,8512,1618,6894,6894,0,11,1612000.0
1612,1612999,21.793288646069193,38.006645891825535,0.07826333005356712,216.5002839565277,104.4255576133728,231.42246627807617,8514,1619,6895,6895,0,11,1613000.0
1613,1613999,21.794419894173764,38.00803183451278,0.0782464431373795,216.64994072914124,104.4931468963623,231.50550079345703,8517,1620,6897,6897,0,11,1614000.0
1614,1614999,21.7961245961077,38.00898525690371,0.07824259119118837,216.7764048576355,104.55873894691467,231.6145133972168,8517,1620,6897,6897,0,11,1615000.0
1615,1615999,21.798110971227864,38.01869228171976,0.07820781257929033,216.92565608024597,104.62489938735962,231.63624954223633,8519,1621,6898,6898,0,11,1616000.0
1616,1616999,21.798409070456387,38.0170716818922,0.07818697022102084,217.08058786392212,104.69054508209229,231.63058853149414,8524,1623,6901,6901,0,11,1617000.0
1617,1617999,21.799853256359764,38.01749230199956,0.07818192331518026,217.22759985923767,104.75633883476257,231.65908813476562,8532,1624,6908,6908,0,11,1618000.0
1618,1618999,21.800675105660304,38.01518762140587,0.07815657024362876,217.39714407920837,104.82288455963135,231.66624450683594,8537,1626,6911,6911,0,11,1619000.0
1619,1619999,21.801934807306104,38.013911590781085,0.07811845644481208,217.55914616584778,104.8886547088623,231.77967071533203,8541,1628,6913,6913,0,11,1620000.0
1620,1620999,21.803984159620832,38.02102086869819,0.07804831244794941,217.70207357406616,104.95425844192505,231.8404426574707,8543,1629,6914,6914,0,11,1621000.0
1621,1621999,21.803864054011576,38.017607945486866,0.07804348441450382,217.84268188476562,105.02813959121704,231.90625762939453,8543,1629,6914,6914,0,11,1622000.0
1622,1622999,21.802543796539116,38.01222254664579,0.07799000596606709,217.9799349308014,105.09454441070557,232.13291549682617,8545,1630,6915,6915,0,11,1623000.0
1623,1623999,21.802231616449824,38.011869173319496,0.07790805249814303,218.0967240333557,105.16010618209839,232.36816787719727,8545,1630,6915,6915,0,11,1624000.0
1624,1624999,21.801399511851862,38.00675493462145,0.07782149187110277,218.25979232788086,105.23068618774414,232.40350341796875,8550,1632,6918,6918,0,11,1625000.0
1625,1625999,21.80034224627522,38.00451938407798,0.07773305909770667,218.39709162712097,105.29602527618408,232.47309112548828,8552,1633,6919,6919,0,11,1626000.0
1626,1626999,21.80083146637256,38.00299296231898,0.07762028803787957,218.52725481987,105.36275887489319,232.63613510131836,8552,1633,6919,6919,0,11,1627000.0
1627,1627999,21.80071762790712,37.998386885166184,0.07754340042970065,218.6848497390747,105.42965269088745,232.65867233276367,8557,1635,6922,6922,0,11,1628000.0
1628,1628999,21.8004383283551,37.99459946638547,0.0774075118230999,218.82503366470337,105.49703907966614,232.73803329467773,8562,1636,6926,6926,0,11,1629000.0
1629,1629999,21.79873196547118,37.988859641707826,0.07735803020985321,219.01855540275574,105.56383967399597,232.68680572509766,8571,1640,6931,6931,0,11,1630000.0
1630,1630999,21.797738568276912,37.987834018980635,0.07724301725989358,219.19202828407288,105.63085508346558,232.67668914794922,8578,1642,6936,6936,0,11,1631000.0
1631,1631999,21.797170869447097,37.98345595484006,0.07712583943040818,219.3366723060608,105.69762897491455,232.76270294189453,8580,1643,6937,6937,0,11,1632000.0
1632,1632999,21.79918377675622,37.98325620941315,0.07692401743786648,219.50996851921082,105.76503920555115,232.85455703735352,8584,1645,6939,6939,0,11,1633000.0
1633,1633999,21.800661558066825,37.98109021821827,0.07679451612552435,219.6847870349884,105.83140778541565,232.86444473266602,8594,1648,6946,6946,0,11,1634000.0
1634,1634999,21.80193286718628,37.97774495185592,0.07667416225696944,219.83324551582336,105.9005799293518,232.91067123413086,8596,1649,6947,6947,0,11,1635000.0
1635,1635999,21.802199925753836,37.97441965482599,0.07657086918899536,220.0388798713684,105.96741986274719,232.8276252746582,8606,1653,6953,6953,0,11,1636000.0
1636,1636999,21.80185646852346,37.97368403199812,0.07649760682338813,220.22574400901794,106.03535461425781,232.8391456604004,8612,1656,6956,6956,0,11,1637000.0
1637,1637999,21.803959894618437,37.984064740215686,0.07637976690540882,220.3889729976654,106.1021876335144,232.85097885131836,8617,1658,6959,6959,0,11,1638000.0
1638,1638999,21.807963050677145,37.98405120198029,0.07614013363852334,220.51928687095642,106.16910648345947,233.02338027954102,8617,1658,6959,6959,0,11,1639000.0
1639,1639999,21.813226467553402,37.984982931609125,0.0759075570661375,220.65610480308533,106.23496437072754,233.1453857421875,8638,1659,6979,6979,0,11,1640000.0
1640,1640999,21.815591488586584,37.98286235484854,0.07572377473731806,220.82916903495789,106.30294752120972,233.1738166809082,8659,1662,6997,6997,0,11,1641000.0
1641,1641999,21.816555731038353,37.984458549575045,0.07559891394858909,221.0050504207611,106.36985754966736,233.25683975219727,8664,1664,7000,7000,0,11,1642000.0
1642,1642999,21.816810899174286,37.98259305002976,0.07548322892540849,221.1755669116974,106.43665981292725,233.47533416748047,8669,1666,7003,7003,0,11,1643000.0
1643,1643999,21.81606912104137,37.97937901753362,0.07537077119567404,221.34260940551758,106.50247192382812,233.54684448242188,8675,1668,7007,7007,0,11,1644000.0
1644,1644999,21.815155710028506,37.977958195353345,0.07527736183255818,221.46467971801758,106.56793570518494,233.66658401489258,8675,1668,7007,7007,0,11,1645000.0
1645,1645999,21.813712572374126,37.97535907012942,0.07519412219993582,221.61369729042053,106.63374519348145,233.74578475952148,8677,1669,7008,7008,0,11,1646000.0
1646,1646999,21.813186004004855,37.98878624919813,0.07505894528981627,221.75620698928833,106.6993556022644,233.79895401000977,8681,1670,7011,7011,0,11,1647000.0
1647,1647999,21.812754120710178,37.985013677965746,0.07496181899218968,221.88458704948425,106.76483869552612,233.89345932006836,8681,1670,7011,7011,0,11,1648000.0
1648,1648999,21.81246044126803,37.97996059581492,0.07483877505180558,222.0848262310028,106.83108377456665,233.81637954711914,8691,1674,7017,7017,0,11,1649000.0
1649,1649999,21.811376067028725,37.97491586044987,0.07473422687424891,222.2243528366089,106.89725375175476,233.93563079833984,8691,1674,7017,7017,0,11,1650000.0
1650,1650999,21.81023516307319,37.96951055121809,0.07465187496588055,222.34646224975586,106.96276187896729,233.99749755859375,8691,1674,7017,7017,0,11,1651000.0
1651,1651999,21.808551358389032,37.96380741709002,0.07459785979857647,222.52592825889587,107.02953815460205,233.96299743652344,8695,1676,7019,7019,0,11,1652000.0
1652,1652999,21.8069253611758,37.95811553112924,0.07454437415147175,222.70248579978943,107.09680891036987,233.9730110168457,8699,1678,7021,7021,0,11,1653000.0
1653,1653999,21.807186562425517,37.95485184804686,0.07440690320647192,222.8450412750244,107.16268396377563,234.0461082458496,8701,1679,7022,7022,0,11,1654000.0
1654,1654999,21.80822483501724,37.95208288536985,0.07420898889992078,223.01079177856445,107.22865581512451,233.97517013549805,8705,1681,7024,7024,0,11,1655000.0
1655,1655999,21.808089938036655,37.948867072823305,0.07410328762632534,223.13290143013,107.29461693763733,234.0682487487793,8705,1681,7024,7024,0,11,1656000.0
1656,1656999,21.809166135544977,37.94727039294102,0.07400050961948168,223.3489887714386,107.36108922958374,233.96919631958008,8716,1686,7030,7030,0,11,1657000.0
1657,1657999,21.811095598620472,37.94601485959877,0.0739179744231433,223.53256106376648,107.42743635177612,233.9964599609375,8723,1689,7034,7034,0,11,1658000.0
1658,1658999,21.81369313125779,37.94643626140188,0.07379331917339771,223.6714231967926,107.49743795394897,234.11302947998047,8723,1689,7034,7034,0,11,1659000.0
1659,1659999,21.8175240649553,37.94939725668943,0.07367027966465722,223.8519251346588,107.56391882896423,234.1181526184082,8728,1691,7037,7037,0,11,1660000.0
1660,1660999,21.82006216359559,37.94858634486628,0.07356589289513193,224.01287961006165,107.62966918945312,234.0756072998047,8733,1693,7040,7040,0,11,1661000.0
1661,1661999,21.821316450069496,37.9467558211065,0.07351068144625639,224.1387016773224,107.69501399993896,234.15108489990234,8733,1693,7040,7040,0,11,1662000.0
1662,1662999,21.822532973278538,37.94453471543615,0.07346228475099159,224.2974078655243,107.76060056686401,234.16433334350586,8741,1694,7047,7047,0,11,1663000.0
1663,1663999,21.82025781851455,37.9393020688583,0.07343231246887749,224.44590497016907,107.82550168037415,234.37982177734375,8743,1695,7048,7048,0,11,1664000.0
1664,1664999,21.817535346552113,37.93567925273942,0.07337772073788862,224.58919644355774,107.89092183113098,234.4604606628418,8750,1696,7054,7054,0,11,1665000.0
1665,1665999,21.81291751996799,37.92884353354139,0.07338814371862101,224.7302267551422,107.95585441589355,234.4662742614746,8753,1697,7056,7056,0,11,1666000.0
1666,1666999,21.80874632874455,37.9258205191029,0.07337554462256124,224.84669017791748,108.02080178260803,234.55441665649414,8753,1697,7056,7056,0,11,1667000.0
1667,1667999,21.80445026642601,37.91942455975437,0.0733605504595437,224.96906995773315,108.08544778823853,234.6218376159668,8753,1697,7056,7056,0,11,1668000.0
1668,1668999,21.800765828247087,37.913068613475154,0.07336140149678394,225.13069939613342,108.15078473091125,234.68891525268555,8758,1699,7059,7059,0,11,1669000.0
1669,1669999,21.796664877706842,37.90651143322628,0.07336870496593206,225.27644085884094,108.21606302261353,234.76584243774414,8760,1700,7060,7060,0,11,1670000.0
1670,1670999,21.79239345562115,37.899686510875,0.07338267397694354,225.4063000679016,108.28118133544922,234.81951141357422,8763,1701,7062,7062,0,11,1671000.0
1671,1671999,21.787782669007758,37.892245117137534,0.07340464387575918,225.57392954826355,108.34830045700073,234.7441749572754,8767,1703,7064,7064,0,11,1672000.0
1672,1672999,21.78324304945677,37.884687149984316,0.07343061228070502,225.72305583953857,108.41413354873657,234.83106994628906,8770,1704,7066,7066,0,11,1673000.0
1673,1673999,21.77859367223212,37.87819901956184,0.07344684734699114,225.875248670578,108.48036789894104,234.89199829101562,8772,1705,7067,7067,0,11,1674000.0
1674,1674999,21.77467857067496,37.87112558935265,0.07345531022246143,226.03525519371033,108.54654002189636,234.99806213378906,8775,1706,7069,7069,0,11,1675000.0
1675,1675999,21.771557333958242,37.86476565844053,0.0734587387324559,226.19517731666565,108.61197829246521,235.03540802001953,8780,1708,7072,7072,0,11,1676000.0
1676,1676999,21.76774299090591,37.857777886501054,0.07346808885425393,226.32478737831116,108.67740035057068,235.11402130126953,8780,1708,7072,7072,0,11,1677000.0
1677,1677999,21.76509691263964,37.85254905808229,0.07346682627397916,226.4600121974945,108.74304389953613,235.1771011352539,8782,1709,7073,7073,0,11,1678000.0
1678,1678999,21.76422048912005,37.850284947426225,0.07345043555226494,226.64126658439636,108.80920958518982,235.16485214233398,8786,1711,7075,7075,0,11,1679000.0
1679,1679999,21.764126961462665,37.85284495988591,0.07343724235262994,226.76263236999512,108.87433815002441,235.26426696777344,8786,1711,7075,7075,0,11,1680000.0
1680,1680999,21.764255734098118,37.85487632773435,0.07342936373796272,226.91079258918762,108.93977189064026,235.40789031982422,8794,1712,7082,7082,0,11,1681000.0
1681,1681999,21.765012765786455,37.85679095004402,0.07340213337376555,227.03189969062805,109.0061993598938,235.5099334716797,8794,1712,7082,7082,0,11,1682000.0
1682,1682999,21.76400926394566,37.85221337344185,0.07342558512544528,227.21749234199524,109.07216048240662,235.44030380249023,8802,1715,7087,7087,0,11,1683000.0
1683,1683999,21.762687839971477,37.84719828948718,0.07341397458241494,227.33248162269592,109.13749575614929,235.55447387695312,8802,1715,7087,7087,0,11,1684000.0
1684,1684999,21.759206760518452,37.84082672354829,0.07340177972588025,227.44581747055054,109.2030885219574,235.80902862548828,8804,1715,7089,7089,0,11,1685000.0
1685,1685999,21.753802847497155,37.833340820307896,0.07343098464471798,227.57062911987305,109.26857924461365,235.9774169921875,8804,1715,7089,7089,0,11,1686000.0
1686,1686999,21.749647147299974,37.82690696460466,0.07345452786296591,227.68791961669922,109.33414840698242,236.07883071899414,8804,1715,7089,7089,0,11,1687000.0
1687,1687999,21.745933071592212,37.820732945471995,0.07347034068213154,227.81130051612854,109.40096044540405,236.16777420043945,8804,1715,7089,7089,0,11,1688000.0
1688,1688999,21.742610051248732,37.81543617575972,0.07347829837143982,227.93671917915344,109.46727657318115,236.25459671020508,8805,1715,7090,7090,0,11,1689000.0
1689,1689999,21.740460223667295,37.8138230794838,0.07347087957718901,228.14221000671387,109.53413438796997,236.1872100830078,8813,1719,7094,7094,0,11,1690000.0
1690,1690999,21.73877550733962,37.81192708441013,0.07347763448606226,228.27826571464539,109.5994930267334,236.31000518798828,8813,1719,7094,7094,0,11,1691000.0
1691,1691999,21.737197200635364,37.8107674273239,0.07351501243288405,228.40091490745544,109.66441535949707,236.3975486755371,8813,1719,7094,7094,0,11,1692000.0
1692,1692999,21.73601937556123,37.81394272041804,0.07353108406520237,228.53884506225586,109.73007559776306,236.43414306640625,8816,1720,7096,7096,0,11,1693000.0
1693,1693999,21.736995163834465,37.82859958312062,0.07353582840468165,228.70502066612244,109.79573130607605,236.4746322631836,8821,1722,7099,7099,0,11,1694000.0
1694,1694999,21.737456559937073,37.83343305733814,0.07356929888198815,228.89306473731995,109.86228466033936,236.45951461791992,8830,1725,7105,7105,0,11,1695000.0
1695,1695999,21.740939742109937,37.847309583608435,0.07361234205301126,229.02718997001648,109.92793846130371,236.6191520690918,8830,1725,7105,7105,0,11,1696000.0
1696,1696999,21.742685290231716,37.85461838457815,0.07372671017107435,229.14452123641968,109.99307227134705,236.68339157104492,8830,1725,7105,7105,0,11,1697000.0
1697,1697999,21.74376737495807,37.860184970599455,0.0737572878140601,229.30636286735535,110.0585401058197,236.68737030029297,8834,1727,7107,7107,0,11,1698000.0
1698,1698999,21.74575336218844,37.867710432757484,0.07380612234926576,229.43377089500427,110.12399554252625,236.77188110351562,8834,1727,7107,7107,0,11,1699000.0
1699,1699999,21.748439863896543,37.878542252478844,0.07386461317207382,229.61424136161804,110.19053959846497,236.69654083251953,8840,1730,7110,7110,0,11,1700000.0
1700,1700999,21.75027326931866,37.883384631047996,0.07394686852323362,229.7607707977295,110.25608897209167,236.76242446899414,8843,1731,7112,7112,0,11,1701000.0
1701,1701999,21.75326963090176,37.88874687465749,0.07404130879006676,229.90067625045776,110.32183837890625,236.85430145263672,8845,1732,7113,7113,0,11,1702000.0
1702,1702999,21.75655329908238,37.893529357751135,0.07414814759386124,230.0198438167572,110.38709497451782,236.92139434814453,8845,1732,7113,7113,0,11,1703000.0
1703,1703999,21.75833962499374,37.894160279256894,0.07423748065486879,230.21357083320618,110.45359683036804,236.8623504638672,8851,1735,7116,7116,0,11,1704000.0
1704,1704999,21.759715881778245,37.90561572776668,0.07426046389304897,230.3735933303833,110.519202709198,236.90835189819336,8858,1737,7121,7121,0,11,1705000.0
1705,1705999,21.757629094226523,37.90723451708218,0.07420765531733664,230.54125428199768,110.58598709106445,237.83670806884766,8889,1739,7150,7150,0,11,1706000.0
1706,1706999,21.753004492187994,37.90023961253678,0.07421728982769193,230.72999095916748,110.6541006565094,238.13275909423828,8898,1742,7156,7156,0,11,1707000.0
1707,1707999,21.748402387364077,37.89298597188741,0.07424140750190789,230.86075115203857,110.71949315071106,238.3600845336914,8901,1743,7158,7158,0,11,1708000.0
1708,1708999,21.74463356585687,37.89164191091155,0.07422958737048613,230.99793100357056,110.78629064559937,238.5763053894043,8906,1744,7162,7162,0,11,1709000.0
1709,1709999,21.74148635498624,37.887142704003544,0.07421889778936341,231.1490535736084,110.85252070426941,238.90826034545898,8919,1745,7174,7174,0,11,1710000.0
1710,1710999,21.73823296247841,37.88208138658745,0.07421373085385419,231.28231716156006,110.9178957939148,239.30235290527344,8921,1746,7175,7175,0,11,1711000.0
1711,1711999,21.736039734157973,37.878032597650886,0.07419761621214416,231.42121767997742,110.9832615852356,239.4810791015625,8923,1747,7176,7176,0,11,1712000.0
1712,1712999,21.733985255957663,37.87418460463887,0.0741882850709551,231.60568475723267,111.06132864952087,239.57328414916992,8927,1749,7178,7178,0,11,1713000.0
1713,1713999,21.732160904360388,37.87015843817,0.0741800361683499,231.76297187805176,111.12746405601501,239.7123794555664,8933,1751,7182,7182,0,11,1714000.0
1714,1714999,21.731221576883094,37.8811243334965,0.07413858066341583,231.88796186447144,111.19316697120667,239.9559555053711,8938,1751,7187,7187,0,11,1715000.0
1715,1715999,21.731675249452582,37.88080482815164,0.07410326905537046,232.05874037742615,111.25972247123718,240.0924415588379,8944,1753,7191,7191,0,11,1716000.0
1716,1716999,21.732511207880147,37.880865275159806,0.07404045635120393,232.2150855064392,111.32591795921326,240.28102493286133,8954,1755,7199,7199,0,11,1717000.0
1717,1717999,21.733694856507746,37.88825349033436,0.07404047921518486,232.3492875099182,111.39264154434204,240.46786880493164,8954,1755,7199,7199,0,11,1718000.0
1718,1718999,21.735446063834047,37.89212609083702,0.07403102454859778,232.46532225608826,111.45789980888367,240.60386276245117,8954,1755,7199,7199,0,11,1719000.0
1719,1719999,21.737147232994218,37.89458426459735,0.07406190105029875,232.64005970954895,111.52386116981506,240.66220474243164,8964,1758,7206,7206,0,11,1720000.0
1720,1720999,21.740930251484887,37.901712543079064,0.07408140327356016,232.78389835357666,111.58971452713013,240.84249114990234,8967,1759,7208,7208,0,11,1721000.0
1721,1721999,21.745865995301248,37.91594837238864,0.07407734077968886,232.92877888679504,111.65562510490417,241.08613967895508,8972,1760,7212,7212,0,11,1722000.0
1722,1722999,21.75133618216256,37.929306767641464,0.07409763561914195,233.06570053100586,111.72045922279358,241.23781204223633,8974,1761,7213,7213,0,11,1723000.0
1723,1723999,21.754735074944367,37.93305979562964,0.07422971121225497,233.22551727294922,111.78703761100769,241.36580276489258,8978,1763,7215,7215,0,11,1724000.0
1724,1724999,21.758793024831316,37.93805302089254,0.07436939536190501,233.4341332912445,111.8569724559784,241.46535873413086,8992,1767,7225,7225,0,11,1725000.0
1725,1725999,21.759521290389646,37.93684755622274,0.07441086549643083,233.58888125419617,111.92389631271362,242.02094268798828,9015,1768,7247,7247,0,11,1726000.0
1726,1726999,21.755390110139526,37.93081295798991,0.07440796623577184,233.73052287101746,111.99025011062622,242.72681045532227,9026,1769,7257,7257,0,11,1727000.0
1727,1727999,21.75132160023219,37.925672362993886,0.07441813324398405,233.84699940681458,112.05524635314941,242.9920654296875,9027,1769,7258,7258,0,11,1728000.0
1728,1728999,21.748001709163127,37.92507032509936,0.0744015596319424,233.96422386169434,112.12013673782349,243.2025260925293,9027,1769,7258,7258,0,11,1729000.0
1729,1729999,21.7449054805064,37.9216239937137,0.0743885622815087,234.0803611278534,112.18498682975769,243.3958740234375,9027,1769,7258,7258,0,11,1730000.0
1730,1730999,21.7425474816807,37.91809446433292,0.0743666720010463,234.2608790397644,112.25169968605042,243.65462112426758,9037,1772,7265,7265,0,11,1731000.0
1731,1731999,21.739829631068982,37.91318509133497,0.07434990905870542,234.39534664154053,112.31721186637878,243.84980392456055,9040,1773,7267,7267,0,11,1732000.0
1732,1732999,21.736797401553808,37.908267118559806,0.07434304605540432,234.55839586257935,112.38286638259888,243.96416854858398,9049,1775,7274,7274,0,11,1733000.0
1733,1733999,21.73442076111827,37.903997480872796,0.0743228593140911,234.70179176330566,112.44818043708801,244.04706954956055,9051,1776,7275,7275,0,11,1734000.0
1734,1734999,21.733668714940684,37.903037891938055,0.07433514333078561,234.82160782814026,112.51466751098633,244.25079345703125,9053,1776,7277,7277,0,11,1735000.0
1735,1735999,21.733303746703232,37.90349328709579,0.07430225557947623,234.9675576686859,112.58009266853333,244.33982849121094,9058,1777,7281,7281,0,11,1736000.0
1736,1736999,21.73372790503771,37.91674523932388,0.0742523498344223,235.15412783622742,112.64666771888733,244.51686477661133,9075,1780,7295,7295,0,11,1737000.0
1737,1737999,21.734034833742943,37.916704353529965,0.0742445800573096,235.33463883399963,112.71285581588745,244.6165313720703,9083,1783,7300,7300,0,11,1738000.0
1738,1738999,21.734614796738008,37.91736093875145,0.07423300927957688,235.4736614227295,112.78062629699707,244.73033905029297,9085,1784,7301,7301,0,11,1739000.0
1739,1739999,21.734817758455765,37.91644893750143,0.0742705160717374,235.5860686302185,112.84629917144775,244.9071388244629,9085,1784,7301,7301,0,11,1740000.0
1740,1740999,21.7362138168468,37.9179604576799,0.07431932575238753,235.8035387992859,112.91345643997192,244.8854217529297,9094,1788,7306,7306,0,11,1741000.0
1741,1741999,21.738313129012127,37.921096134619,0.07436484736997573,235.94290971755981,112.9796257019043,245.01641082763672,9099,1789,7310,7310,0,11,1742000.0
1742,1742999,21.742173997124464,37.92787344830706,0.07446279101170217,236.10921001434326,113.04589819908142,245.29774856567383,9106,1791,7315,7315,0,11,1743000.0
1743,1743999,21.746854021824497,37.94701762860211,0.07446636565404452,236.27038145065308,113.11275959014893,245.3582992553711,9110,1793,7317,7317,0,11,1744000.0
1744,1744999,21.75019229231191,37.95361193626171,0.07451761362491083,236.4063582420349,113.17819428443909,245.46786499023438,9115,1794,7321,7321,0,11,1745000.0
1745,1745999,21.752072112179096,37.956304451973416,0.07453718822458999,236.57692885398865,113.24394941329956,245.5655174255371,9124,1796,7328,7328,0,11,1746000.0
1746,1746999,21.751258100332056,37.955969474863885,0.07451150178938237,236.74744272232056,113.31031203269958,246.36200332641602,9152,1798,7354,7354,0,11,1747000.0
1747,1747999,21.750473848250728,37.957196910734396,0.07450897203813434,236.87909603118896,113.37609314918518,246.76740264892578,9156,1799,7357,7357,0,11,1748000.0
1748,1748999,21.74798463696719,37.953955443097996,0.07451233455925255,237.01773595809937,113.44234108924866,247.02495193481445,9163,1800,7363,7363,0,11,1749000.0
1749,1749999,21.74626368591711,37.95410605508302,0.0744810847214975,237.1609923839569,113.50862765312195,247.20907592773438,9165,1801,7364,7364,0,11,1750000.0
1750,1750999,21.744586457943026,37.95308694299827,0.07448024162503963,237.33779430389404,113.57601976394653,247.54021072387695,9205,1804,7401,7401,0,11,1751000.0
1751,1751999,21.7439039277816,37.955619725321064,0.07442818056690248,237.4828007221222,113.64192008972168,247.7903938293457,9208,1805,7403,7403,0,11,1752000.0
1752,1752999,21.743332784301813,37.95561950622462,0.0744185192670237,237.61945509910583,113.70737195014954,247.9089012145996,9211,1806,7405,7405,0,11,1753000.0
1753,1753999,21.74240279555025,37.95362151807918,0.07440351926067756,237.7430398464203,113.77331566810608,248.06332397460938,9212,1806,7406,7406,0,11,1754000.0
1754,1754999,21.74203098147103,37.953059439257956,0.07437198332870021,237.88201117515564,113.83941316604614,248.18375778198242,9216,1807,7409,7409,0,11,1755000.0
1755,1755999,21.742010378439975,37.952687185176174,0.0743528052649921,238.06708765029907,113.90538620948792,248.17747116088867,9222,1810,7412,7412,0,11,1756000.0
1756,1756999,21.741407535768243,37.9516154151256,0.07436097469600411,238.2425549030304,113.97149896621704,248.40762329101562,9230,1813,7417,7417,0,11,1757000.0
1757,1757999,21.74318636784498,37.96008879157387,0.07432989972665416,238.4218394756317,114.03854131698608,248.4779510498047,9241,1816,7425,7425,0,11,1758000.0
1758,1758999,21.743400644334763,37.95842491295418,0.07432898170831725,238.56978178024292,114.10486388206482,248.62124633789062,9243,1817,7426,7426,0,11,1759000.0
1759,1759999,21.744474583636762,37.95805677757464,0.07432368570290204,238.79473423957825,114.17199087142944,248.65534210205078,9255,1822,7433,7433,0,11,1760000.0
1760,1760999,21.74531154200306,37.957379959358946,0.07432164459704549,238.916419506073,114.23757719993591,248.87288665771484,9257,1822,7435,7435,0,11,1761000.0
1761,1761999,21.748222509182614,37.959642982578806,0.07432902643300476,239.05834579467773,114.30384302139282,249.1723175048828,9263,1823,7440,7440,0,11,1762000.0
1762,1762999,21.749039289825863,37.959280555756095,0.07433981530856604,239.19127082824707,114.36947965621948,249.30449295043945,9265,1824,7441,7441,0,11,1763000.0
1763,1763999,21.751092928155433,37.964035255697965,0.07433424012526912,239.3995668888092,114.43670701980591,249.3530044555664,9277,1828,7449,7449,0,11,1764000.0
1764,1764999,21.748742293999655,37.95897867883796,0.0743274326446749,239.557279586792,114.50310182571411,249.9687271118164,9310,1830,7480,7480,0,11,1765000.0
1765,1765999,21.745314667338413,37.95462183890909,0.07433350115073833,239.70020627975464,114.57022023200989,250.3798713684082,9316,1831,7485,7485,0,11,1766000.0
1766,1766999,21.74264043611087,37.951726844604856,0.07432856140669719,239.8382806777954,114.63606882095337,250.69980239868164,9323,1832,7491,7491,0,11,1767000.0
1767,1767999,21.739978022581905,37.94873932317433,0.07431180461453912,240.00007963180542,114.70345687866211,250.83106994628906,9328,1834,7494,7494,0,11,1768000.0
1768,1768999,21.737232585317663,37.94545529158037,0.07429109869895656,240.11784410476685,114.76961898803711,251.1934814453125,9333,1834,7499,7499,0,11,1769000.0
1769,1769999,21.734706541809548,37.94045240538091,0.07428279297829665,240.25576257705688,114.83537936210632,251.433349609375,9336,1835,7501,7501,0,11,1770000.0
1770,1770999,21.732003919053536,37.93513396729842,0.0742711260823673,240.42155075073242,114.90190863609314,251.58568572998047,9340,1837,7503,7503,0,11,1771000.0
1771,1771999,21.729801975003696,37.93344280044474,0.0742426547951025,240.58191657066345,114.98238372802734,251.73878860473633,9343,1838,7505,7505,0,11,1772000.0
1772,1772999,21.727761114028862,37.92961017817797,0.07423642846309964,240.7623746395111,115.05806493759155,251.84047317504883,9350,1840,7510,7510,0,11,1773000.0
1773,1773999,21.72572626012917,37.92658168898958,0.07423400459062568,240.92692065238953,115.12529492378235,251.92181777954102,9357,1842,7515,7515,0,11,1774000.0
1774,1774999,21.725301933879912,37.923740575818,0.07419499859042611,241.06777834892273,115.19194269180298,252.2758026123047,9364,1843,7521,7521,0,11,1775000.0
1775,1775999,21.725997654107026,37.924224749501676,0.07415643970429797,241.22550082206726,115.25807094573975,252.38026428222656,9368,1845,7523,7523,0,11,1776000.0
1776,1776999,21.727435503737862,37.92733669419055,0.07415174764999755,241.34946513175964,115.3232033252716,252.5608673095703,9368,1845,7523,7523,0,11,1777000.0
1777,1777999,21.728548366240656,37.927199636456095,0.07413911363008807,241.5232195854187,115.38937187194824,252.57236099243164,9376,1848,7528,7528,0,11,1778000.0
1778,1778999,21.731264667777577,37.930716119638895,0.07420888051132946,241.68680691719055,115.455983877182,252.6754608154297,9381,1850,7531,7531,0,11,1779000.0
1779,1779999,21.734247394527152,37.93428730479703,0.07424164005629252,241.85594987869263,115.52571678161621,252.76557159423828,9386,1852,7534,7534,0,11,1780000.0
1780,1780999,21.74004353160105,37.942497007503896,0.07429880613450068,241.9719796180725,115.59161829948425,253.24639129638672,9391,1852,7539,7539,0,11,1781000.0
1781,1781999,21.746459093461866,37.952595621471374,0.07435860835856767,242.10729885101318,115.65692138671875,253.41275787353516,9393,1853,7540,7540,0,11,1782000.0
1782,1782999,21.752230529361967,37.961539177797334,0.07446433580108813,242.28798818588257,115.72337555885315,253.44765090942383,9399,1856,7543,7543,0,11,1783000.0
1783,1783999,21.75566599962185,37.9637402132487,0.0745207203335142,242.47107315063477,115.78948640823364,253.56259536743164,9407,1859,7548,7548,0,11,1784000.0
1784,1784999,21.754824785479382,37.95980115142494,0.07452625743456365,242.5870132446289,115.85489892959595,253.9838752746582,9416,1859,7557,7557,0,11,1785000.0
1785,1785999,21.752250767660826,37.95697631490662,0.07449880136327025,242.72745847702026,115.91958928108215,254.11703491210938,9419,1860,7559,7559,0,11,1786000.0
1786,1786999,21.74882849638406,37.951815781616745,0.07449986953387866,242.87682127952576,115.98361039161682,254.21255111694336,9426,1862,7564,7564,0,11,1787000.0
1787,1787999,21.74646197363204,37.94922635238882,0.07447534285626389,243.01416397094727,116.04908180236816,254.40921783447266,9431,1863,7568,7568,0,11,1788000.0
1788,1788999,21.744459467671923,37.946587171831794,0.07447156486291939,243.19662141799927,116.11426734924316,254.4033088684082,9466,1866,7600,7600,0,11,1789000.0
1789,1789999,21.743695233853767,37.94380756094658,0.07444849598342973,243.3393166065216,116.17886018753052,254.6190299987793,9469,1867,7602,7602,0,11,1790000.0
1790,1790999,21.7417411504299,37.93812114301951,0.07442914819060131,243.48763370513916,116.24378538131714,254.76137161254883,9471,1868,7603,7603,0,11,1791000.0
1791,1791999,21.74107876372923,37.93466931801415,0.07440393574573367,243.60616207122803,116.30944919586182,254.8834342956543,9471,1868,7603,7603,0,11,1792000.0
1792,1792999,21.738948451910602,37.928929833752456,0.07439572395446126,243.72814202308655,116.37399435043335,255.02074432373047,9472,1868,7604,7604,0,11,1793000.0
1793,1793999,21.738417003113806,37.93522062742566,0.07435825579155131,243.88539338111877,116.43904423713684,255.16183471679688,9483,1869,7614,7614,0,11,1794000.0
1794,1794999,21.738401486943367,37.933154649946935,0.07432947037171778,244.04040813446045,116.50397849082947,255.26629257202148,9488,1871,7617,7617,0,11,1795000.0
1795,1795999,21.738015468351254,37.928807363128534,0.07429172340615986,244.20941257476807,116.56882572174072,255.44190216064453,9493,1873,7620,7620,0,11,1796000.0
1796,1796999,21.738062382820942,37.92620959677417,0.07425832968736312,244.33085322380066,116.63444495201111,255.59916305541992,9493,1873,7620,7620,0,11,1797000.0
1797,1797999,21.737955311885113,37.92249061856919,0.07422061155705084,244.50655484199524,116.7077784538269,255.66061782836914,9497,1875,7622,7622,0,11,1798000.0
1798,1798999,21.737753156786326,37.919284374933824,0.07418615843536036,244.64685678482056,116.77317786216736,255.76506423950195,9500,1876,7624,7624,0,11,1799000.0
1799,1799999,21.73851949934516,37.916991594928206,0.07415972972516516,244.79703664779663,116.83923149108887,255.8240966796875,9503,1877,7626,7626,0,11,1800000.0
1800,1800999,21.739019654084675,37.92335169553985,0.07412347661849361,244.95323538780212,116.90449357032776,255.92416381835938,9510,1878,7632,7632,0,11,1801000.0
1801,1801999,21.739291581150002,37.920999095204856,0.07409229594692157,245.1187720298767,116.97078442573547,256.0853729248047,9519,1880,7639,7639,0,11,1802000.0
1802,1802999,21.739469530926947,37.91814544535183,0.0740747668581565,245.28260707855225,117.03564500808716,256.21533203125,9525,1882,7643,7643,0,11,1803000.0
1803,1803999,21.738638163792768,37.91431189597172,0.07405935410422937,245.41881322860718,117.09997892379761,256.275634765625,9527,1883,7644,7644,0,11,1804000.0
1804,1804999,21.737082301505453,37.90938222712269,0.07405854189972771,245.5684633255005,117.16511750221252,256.31835174560547,9529,1884,7645,7645,0,11,1805000.0
1805,1805999,21.734869075614924,37.905772347428886,0.07402541268396223,245.71313571929932,117.22995615005493,256.68862533569336,9544,1885,7659,7659,0,11,1806000.0
1806,1806999,21.731043208650817,37.90049196268067,0.07402839339115852,245.8550419807434,117.29502892494202,256.8764305114746,9548,1886,7662,7662,0,11,1807000.0
1807,1807999,21.72892323900543,37.899120126191455,0.07402440683317224,245.9982521533966,117.35996675491333,256.9945755004883,9579,1887,7692,7692,0,11,1808000.0
1808,1808999,21.72860913087967,37.90198938489884,0.07400900727105286,246.14036107063293,117.42517852783203,257.0908317565918,9583,1888,7695,7695,0,11,1809000.0
1809,1809999,21.7272860330975,37.903663305909944,0.07397370167246786,246.28920245170593,117.49052286148071,257.24255752563477,9587,1889,7698,7698,0,11,1810000.0
1810,1810999,21.72806862864566,37.906518138245545,0.07394839334184389,246.40525794029236,117.55639028549194,257.5441093444824,9591,1889,7702,7702,0,11,1811000.0
1811,1811999,21.730475327214318,37.91088639846783,0.07390235106997856,246.54786372184753,117.62110900878906,257.65935134887695,9594,1890,7704,7704,0,11,1812000.0
1812,1812999,21.732197630974827,37.91201037532807,0.07387378917992338,246.68703746795654,117.68630504608154,257.77294921875,9596,1891,7705,7705,0,11,1813000.0
1813,1813999,21.732483193230383,37.91141358757283,0.07384314384033375,246.83069682121277,117.75135207176208,257.8730888366699,9599,1892,7707,7707,0,11,1814000.0
1814,1814999,21.73300594512824,37.9126714543543,0.0738175501654934,246.97677636146545,117.81730651855469,258.06378173828125,9606,1893,7713,7713,0,11,1815000.0
1815,1815999,21.73503982476937,37.91682509867236,0.07382454007318051,247.16972517967224,117.88348126411438,258.24676513671875,9616,1896,7720,7720,0,11,1816000.0
1816,1816999,21.73576234176712,37.915745604754726,0.07382898554864525,247.33020615577698,117.94848489761353,258.3562202453613,9621,1898,7723,7723,0,11,1817000.0
1817,1817999,21.73592114959625,37.91394846462992,0.07382769194196837,247.47649002075195,118.01352834701538,258.5027542114258,9623,1899,7724,7724,0,11,1818000.0
1818,1818999,21.738274736096884,37.92122340990523,0.07382250240225896,247.6822030544281,118.08031344413757,258.55775451660156,9631,1903,7728,7728,0,11,1819000.0
1819,1819999,21.739529985066643,37.92036154282548,0.07382501505144434,247.8423776626587,118.14553356170654,258.6104049682617,9636,1905,7731,7731,0,11,1820000.0
1820,1820999,21.740844120867603,37.919767661421986,0.07382754673424496,247.9604947566986,118.21100544929504,258.8433494567871,9640,1905,7735,7735,0,11,1821000.0
1821,1821999,21.743661380740978,37.921894656900555,0.07385045742110674,248.1052474975586,118.27733731269836,259.2035026550293,9650,1906,7744,7744,0,11,1822000.0
1822,1822999,21.7458083774949,37.92161190832207,0.07386185564104497,248.26139616966248,118.34212136268616,259.347957611084,9654,1908,7746,7746,0,11,1823000.0
1823,1823999,21.749612824104773,37.924695333973574,0.07398888960412298,248.40083956718445,118.40712094306946,259.5326042175293,9656,1909,7747,7747,0,11,1824000.0
1824,1824999,21.752034635099424,37.924262370720044,0.07405134867974283,248.56358003616333,118.47259020805359,259.6582260131836,9661,1911,7750,7750,0,11,1825000.0
1825,1825999,21.750288282537817,37.92053692344815,0.07405462570321641,248.68401861190796,118.53714680671692,260.049991607666,9670,1911,7759,7759,0,11,1826000.0
1826,1826999,21.746238082974607,37.91671967191131,0.07404793723615866,248.80346512794495,118.60161209106445,260.32141876220703,9671,1911,7760,7760,0,11,1827000.0
1827,1827999,21.74255225863177,37.912281971881875,0.074039309632569,248.9626588821411,118.66616010665894,260.4099349975586,9679,1913,7766,7766,0,11,1828000.0
1828,1828999,21.740678756268853,37.912283193853426,0.07400967129292901,249.14754700660706,118.73218512535095,260.53333282470703,9687,1916,7771,7771,0,11,1829000.0
1829,1829999,21.736779144868965,37.90589380207866,0.07399985263690267,249.33401203155518,118.79695582389832,260.66869354248047,9723,1919,7804,7804,0,11,1830000.0
1830,1830999,21.73475074694429,37.91375636298741,0.07393424571962925,249.49575781822205,118.8622043132782,260.9349174499512,9737,1921,7816,7816,0,11,1831000.0
1831,1831999,21.73252865480624,37.90964775709301,0.07392237696260917,249.6378264427185,118.92822480201721,261.104549407959,9739,1922,7817,7817,0,11,1832000.0
1832,1832999,21.731056867892953,37.9086327417306,0.07390354852440029,249.75745725631714,118.99314594268799,261.26819610595703,9739,1922,7817,7817,0,11,1833000.0
1833,1833999,21.729959389488798,37.90567407276138,0.07390020520074725,249.9033842086792,119.05783081054688,261.40120697021484,9742,1923,7819,7819,0,11,1834000.0
1834,1834999,21.72936797049852,37.903986481359006,0.0739286334021888,250.01814699172974,119.12246298789978,261.55812072753906,9743,1923,7820,7820,0,11,1835000.0
1835,1835999,21.73082017710271,37.90573534031097,0.07392766069256895,250.16739654541016,119.18735074996948,261.6904487609863,9747,1924,7823,7823,0,11,1836000.0
1836,1836999,21.732323746094437,37.908075583837544,0.07395841839478179,250.32875418663025,119.25333428382874,261.91397857666016,9755,1926,7829,7829,0,11,1837000.0
1837,1837999,21.734788015901398,37.911198430401676,0.07397710688145298,250.4589879512787,119.31801915168762,262.0941848754883,9756,1926,7830,7830,0,11,1838000.0
1838,1838999,21.7372530020582,37.91348191432944,0.0740163820266807,250.57661318778992,119.38241267204285,262.20313262939453,9756,1926,7830,7830,0,11,1839000.0
1839,1839999,21.741485156698037,37.918792774770886,0.07404150888602556,250.74435663223267,119.44821429252625,262.28472900390625,9763,1928,7835,7835,0,11,1840000.0
1840,1840999,21.745799464934574,37.92612238666852,0.0741065581338125,250.8925440311432,119.51323556900024,262.35800552368164,9767,1929,7838,7838,0,11,1841000.0
1841,1841999,21.751774104744936,37.9347612725394,0.07415609724406047,251.0046570301056,119.57837915420532,262.4782485961914,9767,1929,7838,7838,0,11,1842000.0
1842,1842999,21.75847371525464,37.942112417643436,0.07418300940507716,251.12635493278503,119.64300918579102,262.7875747680664,9773,1929,7844,7844,0,11,1843000.0
1843,1843999,21.765439480308856,37.951392631291675,0.07429164522955212,251.26417636871338,119.70734906196594,262.9104995727539,9775,1930,7845,7845,0,11,1844000.0
1844,1844999,21.772876907561578,37.970598788581405,0.07434476851726057,251.46619749069214,119.77254128456116,262.89466857910156,9784,1934,7850,7850,0,11,1845000.0
1845,1845999,21.776694054662915,37.97500649722605,0.074411704328747,251.6310737133026,119.83777856826782,262.95618057250977,9788,1936,7852,7852,0,11,1846000.0
1846,1846999,21.77590474930396,37.972136233445354,0.07441324802432658,251.75367665290833,119.90428900718689,263.59251403808594,9811,1936,7875,7875,0,11,1847000.0
1847,1847999,21.771979572308894,37.96703709374837,0.07441554138020445,251.87291502952576,119.9694550037384,263.8922424316406,9814,1936,7878,7878,0,11,1848000.0
1848,1848999,21.768217323071863,37.960940190504246,0.07440489452815369,251.99406743049622,120.0345950126648,264.09489822387695,9815,1936,7879,7879,0,11,1849000.0
1849,1849999,21.764881165175595,37.957333996281875,0.07439324922901747,252.14278745651245,120.10969686508179,264.2775459289551,9817,1936,7881,7881,0,11,1850000.0
1850,1850999,21.761716106856916,37.95226762926305,0.07438410715442034,252.33252692222595,120.18217611312866,264.4001693725586,9856,1939,7917,7917,0,11,1851000.0
1851,1851999,21.7591421979168,37.946691545840395,0.07437463228246921,252.4840371608734,120.24828171730042,264.67822265625,9861,1940,7921,7921,0,11,1852000.0
1852,1852999,21.7561249718191,37.94117627403717,0.07437275499941842,252.6235635280609,120.31612992286682,264.8120765686035,9863,1941,7922,7922,0,11,1853000.0
1853,1853999,21.753372617609894,37.936121575776355,0.07436807635590392,252.74933195114136,120.38160943984985,264.94566345214844,9863,1941,7922,7922,0,11,1854000.0
1854,1854999,21.751320023697456,37.9312732445657,0.07435688889587899,252.89039301872253,120.44655227661133,265.0657501220703,9866,1942,7924,7924,0,11,1855000.0
1855,1855999,21.750187725182577,37.928402387831134,0.07434827097298768,253.09233736991882,120.51264691352844,265.08677673339844,9878,1946,7932,7932,0,11,1856000.0
1856,1856999,21.748521322106903,37.92470395875144,0.07433995851135256,254.16266322135925,120.57929873466492,265.24107360839844,9882,1947,7935,7935,0,11,1857000.0
1857,1857999,21.748941335550125,37.92367056810158,0.07433993614015977,254.32570791244507,120.644855260849,265.43087005615234,9889,1949,7940,7940,0,11,1858000.0
1858,1858999,21.74984706685788,37.92267708936953,0.07434477794083938,254.44824051856995,120.71093463897705,265.5982856750488,9889,1949,7940,7940,0,11,1859000.0
1859,1859999,21.751765489797897,37.92509452870631,0.07435972927761314,254.59666562080383,120.77670454978943,265.6882553100586,9891,1950,7941,7941,0,11,1860000.0
1860,1860999,21.753559560526792,37.92516992507607,0.07437966996334544,254.74309754371643,120.84226179122925,265.8110542297363,9898,1951,7947,7947,0,11,1861000.0
1861,1861999,21.75683285902243,37.92870839827636,0.07441377675268568,254.8748688697815,120.90762710571289,265.9276351928711,9899,1951,7948,7948,0,11,1862000.0
1862,1862999,21.75967545791067,37.930564877286436,0.07446433977515288,255.03781127929688,120.97314286231995,266.0159378051758,9911,1953,7958,7958,0,11,1863000.0
1863,1863999,21.76359341726573,37.93276220633267,0.07448746758972435,255.16114401817322,121.03893613815308,266.24583435058594,9913,1953,7960,7960,0,11,1864000.0
1864,1864999,21.767232012632274,37.93542782680483,0.07453878344615938,255.3611922264099,121.10498571395874,266.29568099975586,9919,1956,7963,7963,0,11,1865000.0
1865,1865999,21.770283570054076,37.93598235537811,0.07462369483387321,255.5567786693573,121.1705551147461,266.3132095336914,9925,1959,7966,7966,0,11,1866000.0
1866,1866999,21.77147551889012,37.93436262464749,0.07465341209386034,255.67844343185425,121.23636889457703,266.4922752380371,9925,1959,7966,7966,0,11,1867000.0
1867,1867999,21.769994621207818,37.93764922604273,0.07450137689862901,255.80119633674622,121.30237650871277,267.15167236328125,9949,1959,7990,7990,0,11,1868000.0
1868,1868999,21.76512284270192,37.93085849768283,0.07447824182487062,255.92691111564636,121.36857151985168,267.49468994140625,9952,1959,7993,7993,0,11,1869000.0
1869,1869999,21.761277459178046,37.929127243202565,0.07446773909445026,256.0420272350311,121.43441009521484,267.69640350341797,9953,1959,7994,7994,0,11,1870000.0
1870,1870999,21.757152515894578,37.92318988520487,0.07448150957188826,256.1742751598358,121.50213623046875,267.8643264770508,9954,1959,7995,7995,0,11,1871000.0
1871,1871999,21.752937240317916,37.91653554266562,0.07449747077326574,256.32665157318115,121.56844282150269,267.95331954956055,9956,1960,7996,7996,0,11,1872000.0
1872,1872999,21.749053861127447,37.910453693030355,0.07449869368923645,256.46484994888306,121.63411235809326,268.21507263183594,9962,1961,8001,8001,0,11,1873000.0
1873,1873999,21.745524794502685,37.90383573714552,0.07451801874661812,256.5934102535248,121.70048666000366,268.41515350341797,9963,1961,8002,8002,0,11,1874000.0
1874,1874999,21.742642051540273,37.89938460454759,0.0745180261051901,256.7127106189728,121.76575589179993,268.5474624633789,9963,1961,8002,8002,0,11,1875000.0
1875,1875999,21.739954352539428,37.89404447175643,0.07453258076241132,256.86322951316833,121.83202028274536,268.65975189208984,9966,1962,8004,8004,0,11,1876000.0
1876,1876999,21.737770952166876,37.890476739476746,0.07453289050530953,257.08322191238403,121.89847350120544,268.66123962402344,9976,1966,8010,8010,0,11,1877000.0
1877,1877999,21.735759781534348,37.88835119397412,0.07453643145302091,257.22381925582886,121.96453642845154,268.80292892456055,9978,1967,8011,8011,0,11,1878000.0
1878,1878999,21.735013668151414,37.886529022626995,0.074533314945464,257.37352323532104,122.03107619285583,269.0943603515625,9985,1968,8017,8017,0,11,1879000.0
1879,1879999,21.73430916431165,37.8843772728507,0.0745454859992406,257.5349555015564,122.09934282302856,269.22375106811523,9990,1970,8020,8020,0,11,1880000.0
1880,1880999,21.733884024553802,37.88726041962721,0.0745912832821426,257.6991729736328,122.16536283493042,269.268497467041,9994,1972,8022,8022,0,11,1881000.0
1881,1881999,21.733714514304562,37.88539812338621,0.07461030704125249,257.829523563385,122.23149585723877,269.4311752319336,9995,1972,8023,8023,0,11,1882000.0
1882,1882999,21.73480473320998,37.884984179636014,0.07462876828147158,257.9976096153259,122.29774451255798,269.48331451416016,10002,1974,8028,8028,0,11,1883000.0
1883,1883999,21.734825001006545,37.882772644406366,0.07470158255323256,258.17270588874817,122.36422038078308,269.56763458251953,10008,1976,8032,8032,0,11,1884000.0
1884,1884999,21.737968916638675,37.88506699870298,0.07470602561464534,258.3058125972748,122.4328727722168,269.86647033691406,10012,1976,8036,8036,0,11,1885000.0
1885,1885999,21.740021861120876,37.884627526719804,0.07474625322134876,258.5002670288086,122.49925637245178,269.8906478881836,10020,1979,8041,8041,0,11,1886000.0
1886,1886999,21.741424756724776,37.882730493735046,0.07477864124392708,258.67319655418396,122.56537675857544,269.90819549560547,10024,1981,8043,8043,0,11,1887000.0
1887,1887999,21.74266453393153,37.88102340236135,0.07478889314987569,258.83273220062256,122.63098621368408,269.997013092041,10032,1983,8049,8049,0,11,1888000.0
1888,1888999,21.740748597670805,37.87584830867573,0.07476290995666102,258.9908106327057,122.69680881500244,270.6239929199219,10061,1984,8077,8077,0,11,1889000.0
1889,1889999,21.736850882480187,37.86938057683205,0.07477127628661051,259.1077392101288,122.76233005523682,270.9839744567871,10065,1984,8081,8081,0,11,1890000.0
1890,1890999,21.734396124565183,37.865936347059524,0.07477464007445578,259.2408230304718,122.82857942581177,271.1962127685547,10070,1985,8085,8085,0,11,1891000.0
1891,1891999,21.731031165724787,37.85992745515538,0.07478897837921772,259.3801727294922,122.90422892570496,271.3256416320801,10070,1985,8085,8085,0,11,1892000.0
1892,1892999,21.727956510891016,37.85389954881339,0.07478669166759433,259.51907682418823,122.97011733055115,271.5272789001465,10073,1986,8087,8087,0,11,1893000.0
1893,1893999,21.72571108590475,37.84968752664288,0.07478455276349394,259.63445019721985,123.035400390625,271.70723724365234,10073,1986,8087,8087,0,11,1894000.0
1894,1894999,21.72345825265593,37.84743516376342,0.07477385511670531,259.784854888916,123.10110878944397,271.8184394836426,10081,1987,8094,8094,0,11,1895000.0
1895,1895999,21.721554546751605,37.84502189340668,0.07475446918201911,259.9498031139374,123.16693663597107,271.853328704834,10088,1989,8099,8099,0,11,1896000.0
1896,1896999,21.71932720268873,37.84018889211519,0.07474645267099422,260.12297534942627,123.23458337783813,271.95771408081055,10100,1991,8109,8109,0,11,1897000.0
1897,1897999,21.716483805149448,37.83493138521806,0.07474251296038636,260.31457018852234,123.3034245967865,272.0257110595703,10107,1994,8113,8113,0,11,1898000.0
1898,1898999,21.714958046487734,37.831727524685654,0.07472096126528016,260.58432817459106,123.37077474594116,272.0477714538574,10122,2000,8122,8122,0,11,1899000.0
1899,1899999,21.712918793163478,37.829675182073125,0.07470335369752823,260.73157382011414,123.43701767921448,272.2319107055664,10129,2001,8128,8128,0,11,1900000.0
1900,1900999,21.709911569840756,37.82362893684892,0.0747056575583096,260.85215759277344,123.50358605384827,272.37801361083984,10129,2001,8128,8128,0,11,1901000.0
1901,1901999,21.70779823834537,37.818528283770014,0.07470820064443373,261.0438244342804,123.57001423835754,272.44395446777344,10140,2004,8136,8136,0,11,1902000.0
1902,1902999,21.706075861009868,37.81422645124646,0.07470523611468671,261.1873333454132,123.63590788841248,272.5617332458496,10145,2005,8140,8140,0,11,1903000.0
1903,1903999,21.705375988126814,37.81100368060386,0.07469107841979283,261.3577663898468,123.70202398300171,272.7993621826172,10152,2007,8145,8145,0,11,1904000.0
1904,1904999,21.703723042487905,37.80598252037154,0.07469853135097715,261.5187485218048,123.76828813552856,272.8726921081543,10156,2009,8147,8147,0,11,1905000.0
1905,1905999,21.702064397038473,37.80123321473849,0.07469598495401408,261.691650390625,123.8406023979187,273.0294075012207,10165,2011,8154,8154,0,11,1906000.0
1906,1906999,21.699598327627964,37.79673279369186,0.07466505393682421,261.8196783065796,123.90662741661072,273.63859939575195,10186,2011,8175,8175,0,11,1907000.0
1907,1907999,21.69594382416774,37.791744402356066,0.07467232825076486,261.9345054626465,123.97265195846558,273.93747329711914,10191,2011,8180,8180,0,11,1908000.0
1908,1908999,21.691892961065495,37.787019241963094,0.07468169831190907,262.074138879776,124.03796052932739,274.11157989501953,10195,2012,8183,8183,0,11,1909000.0
1909,1909999,21.687586177976154,37.78167676591541,0.07470011735488702,262.1990165710449,124.10370087623596,274.28686904907227,10196,2012,8184,8184,0,11,1910000.0
1910,1910999,21.68326167693122,37.77562528274062,0.07473177898272187,262.33704662323,124.16991472244263,274.58180236816406,10205,2013,8192,8192,0,11,1911000.0
1911,1911999,21.67922662069822,37.76898677058875,0.0747697791869002,262.4658532142639,124.23919463157654,274.74156188964844,10205,2013,8192,8192,0,11,1912000.0
1912,1912999,21.674313181117622,37.761466384606884,0.07481183249296608,262.63948822021484,124.30479717254639,274.8345413208008,10209,2015,8194,8194,0,11,1913000.0
1913,1913999,21.670364647898733,37.75532653113486,0.07483699902677299,262.7822606563568,124.37088656425476,274.9737892150879,10212,2016,8196,8196,0,11,1914000.0
1914,1914999,21.666800057614683,37.753926245965744,0.07486188649697445,262.9055161476135,124.43648982048035,275.1604194641113,10215,2016,8199,8199,0,11,1915000.0
1915,1915999,21.66368001963239,37.75035084365498,0.07486141923930578,263.0446105003357,124.50330352783203,275.24602127075195,10217,2017,8200,8200,0,11,1916000.0
1916,1916999,21.660548502873723,37.7450427835379,0.07487011628410634,263.1904499530792,124.57257056236267,275.5086364746094,10224,2018,8206,8206,0,11,1917000.0
1917,1917999,21.65785500993953,37.740752840413386,0.074876918679328,263.33380699157715,124.63814568519592,275.63522720336914,10226,2019,8207,8207,0,11,1918000.0
1918,1918999,21.65573183894243,37.74918426004991,0.07482239442854954,263.4987165927887,124.70370626449585,275.73033905029297,10230,2021,8209,8209,0,11,1919000.0
1919,1919999,21.653979414266175,37.746248541446235,0.07482172219744165,263.662401676178,124.770432472229,275.83477783203125,10242,2023,8219,8219,0,11,1920000.0
1920,1920999,21.652784310206503,37.744841648479735,0.07482538450778076,263.8571836948395,124.83704352378845,275.8243713378906,10248,2026,8222,8222,0,11,1921000.0
1921,1921999,21.65126088918278,37.74410849003076,0.07481644189360537,264.0418326854706,124.90353178977966,275.9547805786133,10257,2029,8228,8228,0,11,1922000.0
1922,1922999,21.649976140868947,37.73964119345753,0.07479444845081618,264.20368552207947,124.96883177757263,276.0824165344238,10262,2031,8231,8231,0,11,1923000.0
1923,1923999,21.648726016052358,37.736127655481795,0.07480897794356023,264.4214324951172,125.03504037857056,276.104434967041,10271,2035,8236,8236,0,11,1924000.0
1924,1924999,21.646277424548416,37.73117609034414,0.07481769335776434,264.5899934768677,125.1026554107666,276.1947898864746,10276,2037,8239,8239,0,11,1925000.0
1925,1925999,21.643913975147278,37.72620938751187,0.07482518348146527,264.7769408226013,125.16896533966064,276.28085708618164,10287,2040,8247,8247,0,11,1926000.0
1926,1926999,21.64015892480988,37.72308147737129,0.07482814474614718,264.91177773475647,125.23380661010742,276.7059211730957,10300,2041,8259,8259,0,11,1927000.0
1927,1927999,21.634956154153624,37.71853707661796,0.07483917769093851,265.0665428638458,125.29943752288818,276.90125274658203,10334,2043,8291,8291,0,11,1928000.0
1928,1928999,21.62989546267657,37.71197716200549,0.07485780934954778,265.2125794887543,125.36436223983765,277.0860786437988,10342,2044,8298,8298,0,11,1929000.0
1929,1929999,21.625803290889188,37.7081067149905,0.07486375873950157,265.34205436706543,125.42867136001587,277.2680854797363,10344,2044,8300,8300,0,11,1930000.0
1930,1930999,21.621238177248998,37.70142641018123,0.07488429087503934,265.510705947876,125.49355602264404,277.30733489990234,10348,2046,8302,8302,0,11,1931000.0
1931,1931999,21.61655206396644,37.694413631285144,0.07490498792430611,265.7038769721985,125.56027245521545,277.4679870605469,10357,2049,8308,8308,0,11,1932000.0
1932,1932999,21.6121889707553,37.68757671649854,0.07491796193133726,265.83591079711914,125.62470316886902,277.6688919067383,10359,2050,8309,8309,0,11,1933000.0
1933,1933999,21.60791278835088,37.68144553211075,0.07493203824326511,265.9557340145111,125.68969535827637,277.82840728759766,10359,2050,8309,8309,0,11,1934000.0
1934,1934999,21.604056842133126,37.675993942752065,0.07493768727014227,266.07345938682556,125.75426936149597,277.9801902770996,10360,2050,8310,8310,0,11,1935000.0
1935,1935999,21.599705874429745,37.66955896119376,0.07495763683831569,266.20037055015564,125.81905484199524,278.14692306518555,10363,2050,8313,8313,0,11,1936000.0
1936,1936999,21.596055239910118,37.66376491325246,0.07496960931509933,266.3469099998474,125.88365650177002,278.2036590576172,10366,2051,8315,8315,0,11,1937000.0
1937,1937999,21.59396926589267,37.6612675393313,0.07495531061190397,266.4970905780792,125.94901537895203,278.3415184020996,10368,2052,8316,8316,0,11,1938000.0
1938,1938999,21.590509969218925,37.655893070625794,0.07496256243805632,266.6539521217346,126.02603769302368,278.44726181030273,10368,2052,8316,8316,0,11,1939000.0
1939,1939999,21.587828975556448,37.6504251965241,0.07496306800096275,266.8038845062256,126.0905921459198,278.5162696838379,10370,2053,8317,8317,0,11,1940000.0
1940,1940999,21.58520392818051,37.64630732386997,0.07495701346481831,266.9196472167969,126.155264377594,278.62799072265625,10371,2053,8318,8318,0,11,1941000.0
1941,1941999,21.583006523184995,37.64244647388811,0.07496431109593515,267.05908703804016,126.219895362854,278.64586639404297,10374,2054,8320,8320,0,11,1942000.0
1942,1942999,21.58039701298445,37.637133304256636,0.07496890461239292,267.2080421447754,126.28471183776855,278.7725601196289,10378,2055,8323,8323,0,11,1943000.0
1943,1943999,21.57868609501442,37.63671260787612,0.07494125806019036,267.3589656352997,126.34978890419006,278.8606147766113,10381,2056,8325,8325,0,11,1944000.0
1944,1944999,21.576349169529006,37.63134927303814,0.07495310079072792,267.5385982990265,126.42212700843811,278.9379119873047,10383,2057,8326,8326,0,11,1945000.0
1945,1945999,21.573857724655507,37.626121795173376,0.07495033134209383,267.67713475227356,126.4861831665039,278.97448348999023,10388,2058,8330,8330,0,11,1946000.0
1946,1946999,21.570669789091923,37.62037257284345,0.07494798559414895,267.84759736061096,126.55103206634521,279.07516860961914,10399,2060,8339,8339,0,11,1947000.0
1947,1947999,21.567030691142747,37.614590170807496,0.07496428312880743,267.99090027809143,126.6159155368805,279.3641052246094,10412,2061,8351,8351,0,11,1948000.0
1948,1948999,21.56171311108913,37.60815674714334,0.0749899665283672,268.1394829750061,126.6822395324707,279.5740966796875,10420,2062,8358,8358,0,11,1949000.0
1949,1949999,21.556886275414012,37.60187710518385,0.07500685254000927,268.2549521923065,126.7465295791626,279.74878692626953,10423,2062,8361,8361,0,11,1950000.0
1950,1950999,21.5528321820282,37.597686197695204,0.07501373957270441,268.4190969467163,126.81155204772949,279.81882095336914,10432,2064,8368,8368,0,11,1951000.0
1951,1951999,21.548481644216746,37.59106432761614,0.07502056551097591,268.58461141586304,126.87703824043274,280.0134696960449,10441,2066,8375,8375,0,11,1952000.0
1952,1952999,21.54434494787446,37.58471537991116,0.07502696295920686,268.70313572883606,126.9425094127655,280.2450637817383,10443,2066,8377,8377,0,11,1953000.0
1953,1953999,21.540107248829194,37.57841213427462,0.07504128251781728,268.8889670372009,127.00739741325378,280.2406692504883,10449,2069,8380,8380,0,11,1954000.0
1954,1954999,21.535723106293045,37.57136859977907,0.07505211833648018,268.99801874160767,127.07231879234314,280.44034576416016,10449,2069,8380,8380,0,11,1955000.0
1955,1955999,21.531643939367335,37.5664922582767,0.0750496493077798,269.1220545768738,127.13672232627869,280.5780143737793,10450,2069,8381,8381,0,11,1956000.0
1956,1956999,21.527693471331226,37.561649229393694,0.07503439352589747,269.28010749816895,127.20246815681458,280.71802139282227,10457,2070,8387,8387,0,11,1957000.0
1957,1957999,21.524942335384132,37.55902349922683,0.07501215531168282,269.4012658596039,127.26848435401917,280.9694137573242,10462,2070,8392,8392,0,11,1958000.0
1958,1958999,21.521759579612755,37.55627532892185,0.07499228571337835,269.5378966331482,127.33339142799377,281.11996841430664,10464,2071,8393,8393,0,11,1959000.0
1959,1959999,21.518722644504575,37.55225291947604,0.07498920962205269,269.68963503837585,127.39939737319946,281.22593688964844,10466,2072,8394,8394,0,11,1960000.0
1960,1960999,21.51577460109629,37.546853420758204,0.07498898294581258,269.8891034126282,127.46779251098633,281.317440032959,10472,2075,8397,8397,0,11,1961000.0
1961,1961999,21.513052232830685,37.541284921523214,0.07498598639447451,270.02901124954224,127.53311085700989,281.4730110168457,10477,2076,8401,8401,0,11,1962000.0
1962,1962999,21.510997570790735,37.53756810801729,0.07498369764465629,270.18553400039673,127.59897661209106,281.61999893188477,10483,2077,8406,8406,0,11,1963000.0
1963,1963999,21.509368510299076,37.5341741490562,0.07495821833998273,270.32756090164185,127.66438889503479,281.92908477783203,10495,2078,8417,8417,0,11,1964000.0
1964,1964999,21.507244411336718,37.528957300256295,0.07495152727681609,270.4848961830139,127.72930479049683,282.0334587097168,10506,2080,8426,8426,0,11,1965000.0
1965,1965999,21.50616174083286,37.528620532186345,0.0749364572223552,270.60416769981384,127.79513812065125,282.19364166259766,10506,2080,8426,8426,0,11,1966000.0
1966,1966999,21.503520550811597,37.52302418527912,0.0749400232718681,270.7794699668884,127.86141514778137,282.2703094482422,10510,2082,8428,8428,0,11,1967000.0
1967,1967999,21.50155559922586,37.518370829938036,0.07495344854853825,270.9124348163605,127.92588090896606,282.4380683898926,10513,2083,8430,8430,0,11,1968000.0
1968,1968999,21.50061352976179,37.52092472546251,0.07492703158384006,271.0759720802307,127.9917848110199,282.8871650695801,10528,2085,8443,8443,0,11,1969000.0
1969,1969999,21.499866446828342,37.52777001971618,0.07495355230311485,271.1902885437012,128.0565013885498,283.1504554748535,10530,2085,8445,8445,0,11,1970000.0
1970,1970999,21.49943094352895,37.529317695508865,0.0749806701073168,271.3414657115936,128.12144708633423,283.3396873474121,10537,2086,8451,8451,0,11,1971000.0
1971,1971999,21.50023815639354,37.533687630114585,0.0750461595857026,271.5074188709259,128.18608140945435,283.4304885864258,10541,2088,8453,8453,0,11,1972000.0
1972,1972999,21.501542914181453,37.53941126473618,0.07505324252748846,271.65572142601013,128.25249028205872,283.60647201538086,10546,2089,8457,8457,0,11,1973000.0
1973,1973999,21.506453931257518,37.55518895257792,0.07503911355484771,271.8058850765228,128.3167576789856,283.72090911865234,10550,2090,8460,8460,0,11,1974000.0
1974,1974999,21.510683231004368,37.56758463914935,0.07507419465058718,271.94169306755066,128.38106083869934,283.7722854614258,10553,2091,8462,8462,0,11,1975000.0
1975,1975999,21.51374946448015,37.57717001447336,0.07517154637351153,272.09720373153687,128.4470341205597,283.8717842102051,10556,2092,8464,8464,0,11,1976000.0
1976,1976999,21.517104013581548,37.58676816530099,0.07516452839577137,272.24668979644775,128.51278376579285,283.98669052124023,10563,2093,8470,8470,0,11,1977000.0
1977,1977999,21.521230750919923,37.59824886936026,0.07517825387335031,272.42018485069275,128.57759952545166,284.0159912109375,10568,2095,8473,8473,0,11,1978000.0
1978,1978999,21.526211846472485,37.61029537451801,0.07518212982746186,272.6160981655121,128.64362263679504,284.1973419189453,10579,2098,8481,8481,0,11,1979000.0
1979,1979999,21.530655254845207,37.62634245812807,0.07516570709089265,272.77645111083984,128.70894122123718,284.3051414489746,10585,2100,8485,8485,0,11,1980000.0
1980,1980999,21.53402216903345,37.63359452924645,0.07519808243864723,272.9292492866516,128.7738904953003,284.413875579834,10587,2101,8486,8486,0,11,1981000.0
1981,1981999,21.53739351189688,37.63817973875063,0.07521457846693169,273.0989599227905,128.8397319316864,284.493408203125,10593,2103,8490,8490,0,11,1982000.0
1982,1982999,21.542523029459844,37.647132364673,0.075264000974123,273.27065992355347,128.90493774414062,284.6152687072754,10603,2105,8498,8498,0,11,1983000.0
1983,1983999,21.547216982868225,37.65615229725769,0.07525748663637832,273.4277925491333,128.97140955924988,284.89004135131836,10611,2106,8505,8505,0,11,1984000.0
1984,1984999,21.551582039077616,37.66268964900792,0.07532144057823886,273.5470607280731,129.03594040870667,285.0615997314453,10611,2106,8505,8505,0,11,1985000.0
1985,1985999,21.55742356923702,37.67328602965278,0.0753578088606538,273.74805068969727,129.10077691078186,285.058780670166,10624,2109,8515,8515,0,11,1986000.0
1986,1986999,21.56186567420934,37.67721636854566,0.07540011235518895,273.8931028842926,129.16568851470947,285.14820861816406,10626,2110,8516,8516,0,11,1987000.0
1987,1987999,21.563806369306462,37.67708226230078,0.07541009289611211,274.04707431793213,129.23089337348938,285.3051414489746,10628,2111,8517,8517,0,11,1988000.0
1988,1988999,21.561007021665237,37.67535493765506,0.07539018443962764,274.16786646842957,129.29701948165894,286.03268814086914,10653,2111,8542,8542,0,11,1989000.0
1989,1989999,21.558142898823526,37.67045308778827,0.0754035416853498,274.28236413002014,129.3627507686615,286.28521728515625,10655,2111,8544,8544,0,11,1990000.0
1990,1990999,21.557529017861714,37.670941921939324,0.07536854080183308,274.4002437591553,129.4284152984619,286.53007888793945,10659,2111,8548,8548,0,11,1991000.0
1991,1991999,21.55593770495752,37.66761764065875,0.0753532728138151,274.5131890773773,129.49329781532288,286.7098617553711,10660,2111,8549,8549,0,11,1992000.0
1992,1992999,21.55643770876519,37.668661032068165,0.07531448801151919,274.6907618045807,129.56704425811768,286.8665428161621,10667,2113,8554,8554,0,11,1993000.0
1993,1993999,21.557014943369186,37.66966936544594,0.07529107104809762,274.85766220092773,129.6341209411621,286.97884368896484,10672,2115,8557,8557,0,11,1994000.0
1994,1994999,21.558515464341312,37.67171039465341,0.07530605785628164,275.0246162414551,129.70037817955017,287.1056785583496,10678,2117,8561,8561,0,11,1995000.0
1995,1995999,21.56070637206234,37.67396429634347,0.07531011089759154,275.2108111381531,129.76663064956665,287.12195587158203,10689,2120,8569,8569,0,11,1996000.0
1996,1996999,21.56461406791049,37.68090815835438,0.07529430063157039,275.39895462989807,129.8332440853119,287.2258186340332,10701,2123,8578,8578,0,11,1997000.0
1997,1997999,21.56807828523971,37.687273780454305,0.07527003461079951,275.6082320213318,129.90242671966553,287.36238861083984,10712,2126,8586,8586,0,11,1998000.0
1998,1998999,21.573118702376277,37.696321391636914,0.07534761538238566,275.7808859348297,129.9690420627594,287.65882873535156,10726,2128,8598,8598,0,11,1999000.0
1999,1999999,21.579264589008368,37.705545312027525,0.07536636745202274,275.9223277568817,130.03463745117188,287.85439682006836,10728,2129,8599,8599,0,11,2000000.0
2000,2000999,21.58577136406982,37.717028138429235,0.07544234986063303,276.08604741096497,130.10172200202942,287.97802734375,10732,2131,8601,8601,0,11,2001000.0
2001,2001999,21.592284165521463,37.727343196417806,0.07556537526346652,276.2050848007202,130.16772317886353,288.13183212280273,10733,2131,8602,8602,0,11,2002000.0
2002,2002999,21.598384938283413,37.73562574728818,0.07566156019210835,276.357638835907,130.23375511169434,288.22591400146484,10735,2132,8603,8603,0,11,2003000.0
2003,2003999,21.605125223351983,37.75098883163932,0.07574762168201887,276.5229170322418,130.29982447624207,288.24861907958984,10739,2134,8605,8605,0,11,2004000.0
2004,2004999,21.612021456007618,37.758824541477246,0.0757848206325179,276.6706557273865,130.36590194702148,288.5498733520508,10747,2135,8612,8612,0,11,2005000.0
2005,2005999,21.618820443668746,37.76720726517683,0.075889732963346,276.8787121772766,130.43226027488708,288.59030532836914,10756,2139,8617,8617,0,11,2006000.0
2006,2006999,21.626624952337863,37.77754728049255,0.07602097495575222,277.04910135269165,130.497309923172,288.6018486022949,10762,2141,8621,8621,0,11,2007000.0
2007,2007999,21.63123857248323,37.781514032364555,0.07612670405741362,277.27616810798645,130.5653839111328,288.7110824584961,10774,2145,8629,8629,0,11,2008000.0
2008,2008999,21.632170896998144,37.7849672423074,0.07608121814005275,277.422883272171,130.63175439834595,289.3587875366211,10801,2146,8655,8655,0,11,2009000.0
2009,2009999,21.628809279385365,37.78365893105113,0.07604030993281796,277.539657831192,130.69732546806335,289.65689849853516,10804,2146,8658,8658,0,11,2010000.0
2010,2010999,21.625397329800553,37.778839104506936,0.07603918180762592,277.6802542209625,130.7631392478943,289.78912353515625,10808,2147,8661,8661,0,11,2011000.0
2011,2011999,21.622242928175666,37.77447439709936,0.07603786282808422,277.82554721832275,130.82857608795166,289.9507179260254,10834,2148,8686,8686,0,11,2012000.0
2012,2012999,21.619280060546508,37.78180103464085,0.0759842270773583,277.9664087295532,130.8942587375641,290.13554763793945,10836,2149,8687,8687,0,11,2013000.0
2013,2013999,21.615743337516193,37.775380711097036,0.07598575475102043,278.11118602752686,130.96027088165283,290.4135513305664,10842,2150,8692,8692,0,11,2014000.0
2014,2014999,21.61274039296571,37.77041211265101,0.0759786839812241,278.2814726829529,131.02602458000183,290.5267028808594,10847,2152,8695,8695,0,11,2015000.0
2015,2015999,21.6099601209282,37.76526409858357,0.07597338124457198,278.4057619571686,131.0915503501892,290.68008041381836,10848,2152,8696,8696,0,11,2016000.0
2016,2016999,21.607101463713054,37.7599514700096,0.07597249583021404,278.5259699821472,131.15684056282043,290.7976760864258,10849,2152,8697,8697,0,11,2017000.0
2017,2017999,21.605309889393183,37.758246887757636,0.07596814342713165,278.67875266075134,131.22268629074097,290.90090560913086,10853,2153,8700,8700,0,11,2018000.0
2018,2018999,21.60378128300674,37.7547285319472,0.07596407325046095,278.8686330318451,131.28877067565918,290.9861755371094,10868,2156,8712,8712,0,11,2019000.0
2019,2019999,21.60334036949611,37.7524931421897,0.0759656089040156,279.03291177749634,131.35404777526855,291.16720962524414,10877,2158,8719,8719,0,11,2020000.0
2020,2020999,21.60349520775773,37.75026557701632,0.07597422434800494,279.1568193435669,131.41938090324402,291.366641998291,10877,2158,8719,8719,0,11,2021000.0
2021,2021999,21.603951085946548,37.74998420020793,0.07600975698606394,279.27869296073914,131.48463129997253,291.4887580871582,10877,2158,8719,8719,0,11,2022000.0
2022,2022999,21.605177043912775,37.750931776343364,0.07604416653431201,279.4250500202179,131.550283908844,291.56979751586914,10879,2159,8720,8720,0,11,2023000.0
2023,2023999,21.60849049034855,37.75708893229223,0.0761167909637187,279.65018224716187,131.616938829422,291.5475959777832,10891,2163,8728,8728,0,11,2024000.0
2024,2024999,21.613591845756915,37.76748217738073,0.07629808915542835,279.8238699436188,131.68284702301025,291.77893447875977,10905,2165,8740,8740,0,11,2025000.0
2025,2025999,21.619887373661207,37.77728523601874,0.07649247231490475,279.9404010772705,131.74825239181519,291.9680862426758,10905,2165,8740,8740,0,11,2026000.0
2026,2026999,21.62532483173959,37.78735802305846,0.07669528847694163,280.0838255882263,131.81347799301147,292.07556533813477,10907,2166,8741,8741,0,11,2027000.0
2027,2027999,21.629162288984883,37.79179212422056,0.07675641875587835,280.2280924320221,131.87873363494873,292.16619873046875,10909,2167,8742,8742,0,11,2028000.0
2028,2028999,21.630038472584875,37.79155070099529,0.07682260731691437,280.37294483184814,131.94401907920837,292.25308990478516,10918,2168,8750,8750,0,11,2029000.0
2029,2029999,21.629773173455533,37.795695917822826,0.07656912103496494,280.5459306240082,132.01082038879395,292.9398498535156,10956,2170,8786,8786,0,11,2030000.0
2030,2030999,21.62828278589909,37.792841276629346,0.07654039380445887,280.6677346229553,132.07799172401428,293.3082084655762,10959,2170,8789,8789,0,11,2031000.0
2031,2031999,21.625770287574145,37.78897085464866,0.07653469730254014,280.78857493400574,132.14396333694458,293.53292083740234,10961,2170,8791,8791,0,11,2032000.0
2032,2032999,21.624423697759255,37.789851965095146,0.07651092324838082,280.95461797714233,132.21033716201782,293.63211822509766,10965,2172,8793,8793,0,11,2033000.0
2033,2033999,21.622331958507562,37.78548067463964,0.0764963539167356,281.12037539482117,132.27666354179382,293.8488655090332,10975,2174,8801,8801,0,11,2034000.0
2034,2034999,21.620562802669706,37.78154779833336,0.07647523666963452,281.2346487045288,132.3421187400818,294.0245246887207,10975,2174,8801,8801,0,11,2035000.0
2035,2035999,21.619317330924208,37.77813963922648,0.07646338564068211,281.4464557170868,132.40892624855042,294.0631866455078,10991,2178,8813,8813,0,11,2036000.0
2036,2036999,21.61833472841367,37.778943169112054,0.07642517931507264,281.5688645839691,132.4752471446991,294.2902183532715,10993,2178,8815,8815,0,11,2037000.0
2037,2037999,21.616811688657513,37.77678078540987,0.07640695383268103,281.74799156188965,132.54205012321472,294.34162521362305,10998,2180,8818,8818,0,11,2038000.0
2038,2038999,21.615861107469637,37.77892343294823,0.07638942512647473,281.9172480106354,132.60877466201782,294.540225982666,11006,2182,8824,8824,0,11,2039000.0
2039,2039999,21.615250064617367,37.78109958607157,0.0763719215258385,282.1714417934418,132.6763801574707,294.5543327331543,11018,2187,8831,8831,0,11,2040000.0
2040,2040999,21.613646412172027,37.77626832671243,0.0763562259062337,282.35049510002136,132.74311566352844,294.6250419616699,11024,2189,8835,8835,0,11,2041000.0
2041,2041999,21.612720313449355,37.77311322546029,0.07633518202064138,282.4716501235962,132.80931329727173,294.8013153076172,11024,2189,8835,8835,0,11,2042000.0
2042,2042999,21.61206037163812,37.76987049229838,0.07632053652514703,282.668319940567,132.87578582763672,294.87199783325195,11030,2192,8838,8838,0,11,2043000.0
2043,2043999,21.611476997014645,37.76975982898156,0.0762983858866717,282.78415417671204,132.94208192825317,295.13371658325195,11034,2192,8842,8842,0,11,2044000.0
2044,2044999,21.61066489178298,37.769377171616746,0.07628124084099708,282.9202456474304,133.00746059417725,295.2426986694336,11036,2193,8843,8843,0,11,2045000.0
2045,2045999,21.609684711867196,37.76516252261534,0.07626207495411796,283.0950310230255,133.07343435287476,295.3067321777344,11045,2195,8850,8850,0,11,2046000.0
2046,2046999,21.607765724794614,37.75980283055252,0.07625663177017183,283.27230954170227,133.13928270339966,295.3485679626465,11059,2197,8862,8862,0,11,2047000.0
2047,2047999,21.6056444542898,37.75523460736332,0.07620635356766403,283.39305806159973,133.2071270942688,296.0862693786621,11085,2197,8888,8888,0,11,2048000.0
2048,2048999,21.60437595285437,37.755814359973705,0.07614380475758586,283.5366086959839,133.27383303642273,296.37966537475586,11093,2198,8895,8895,0,11,2049000.0
2049,2049999,21.60271715254051,37.75179118787288,0.07615216241102873,283.6888794898987,133.34087324142456,296.61890411376953,11101,2199,8902,8902,0,11,2050000.0
2050,2050999,21.60120898823951,37.74945764069518,0.07612021454212015,283.809534072876,133.40689134597778,296.9199028015137,11107,2199,8908,8908,0,11,2051000.0
2051,2051999,21.600076184432236,37.746252119304806,0.07607191441077277,283.9262742996216,133.47376489639282,297.2060966491699,11108,2199,8909,8909,0,11,2052000.0
2052,2052999,21.598552120971256,37.74641796184528,0.07606016272486649,284.06452107429504,133.53966355323792,297.3708076477051,11111,2200,8911,8911,0,11,2053000.0
2053,2053999,21.59920654286113,37.749341568791614,0.07604794755435695,284.2096631526947,133.60576629638672,297.50200271606445,11115,2201,8914,8914,0,11,2054000.0
2054,2054999,21.599135556880928,37.7512695606534,0.07609051343219508,284.38074374198914,133.67267060279846,297.6033744812012,11122,2203,8919,8919,0,11,2055000.0
2055,2055999,21.59956943028957,37.751654455423385,0.0760707955420371,284.52970790863037,133.73911547660828,297.7924041748047,11128,2204,8924,8924,0,11,2056000.0
2056,2056999,21.602192198963966,37.7583092963931,0.07607219336059379,284.6825294494629,133.80680966377258,298.0242385864258,11137,2205,8932,8932,0,11,2057000.0
2057,2057999,21.605121423645805,37.76688116406792,0.07606301983474473,284.84536933898926,133.87322402000427,298.18371200561523,11142,2207,8935,8935,0,11,2058000.0
2058,2058999,21.609300001632153,37.77513287371677,0.07611082877962139,285.00960087776184,133.93899250030518,298.2923240661621,11146,2209,8937,8937,0,11,2059000.0
2059,2059999,21.613705541784018,37.78687699412913,0.0761458178945088,285.2275376319885,134.00622582435608,298.4051170349121,11161,2213,8948,8948,0,11,2060000.0
2060,2060999,21.61773595620933,37.793812225401155,0.07620503779352539,285.3399519920349,134.07323241233826,298.5881462097168,11161,2213,8948,8948,0,11,2061000.0
2061,2061999,21.620828007839325,37.79677386529329,0.07626286238226243,285.5182056427002,134.1400351524353,298.7209014892578,11169,2215,8954,8954,0,11,2062000.0
2062,2062999,21.62674764521217,37.80725112189982,0.0763183989714068,285.663702249527,134.20610976219177,298.9775810241699,11175,2216,8959,8959,0,11,2063000.0
2063,2063999,21.63174730746098,37.82022553453898,0.0763879390155574,285.86184453964233,134.27253580093384,299.03703689575195,11182,2219,8963,8963,0,11,2064000.0
2064,2064999,21.636627005492056,37.827555524061125,0.07646834498265154,286.11717200279236,134.33974266052246,299.03543853759766,11197,2224,8973,8973,0,11,2065000.0
2065,2065999,21.63873596669134,37.831583919131916,0.07652923641952936,286.2427296638489,134.4058952331543,299.29712295532227,11199,2224,8975,8975,0,11,2066000.0
2066,2066999,21.638890401811917,37.84106823202737,0.0764755954719889,286.3837034702301,134.47115468978882,299.77330017089844,11211,2225,8986,8986,0,11,2067000.0
2067,2067999,21.63745244217687,37.839831279953074,0.07648019061465028,286.497642993927,134.53602385520935,299.95616912841797,11211,2225,8986,8986,0,11,2068000.0
2068,2068999,21.6363750300568,37.836977127146405,0.07649620914919841,286.64238953590393,134.60148572921753,300.1035270690918,11216,2226,8990,8990,0,11,2069000.0
2069,2069999,21.635573001924218,37.836085119668596,0.07650140106394254,286.84896636009216,134.6668999195099,300.1505126953125,11227,2230,8997,8997,0,11,2070000.0
2070,2070999,21.636228226822944,37.840698101725195,0.07644926425611676,287.02348279953003,134.73247122764587,300.3247604370117,11234,2232,9002,9002,0,11,2071000.0
2071,2071999,21.636404206296383,37.840140526539116,0.07642660806491908,287.2296099662781,134.79954934120178,300.4414939880371,11249,2235,9014,9014,0,11,2072000.0
2072,2072999,21.63675191355654,37.83901501262123,0.07644694256060414,287.3957962989807,134.8648064136505,300.64430236816406,11254,2237,9017,9017,0,11,2073000.0
2073,2073999,21.637531174925755,37.83951484719537,0.07651087472737872,287.5342617034912,134.9297695159912,300.83058166503906,11257,2238,9019,9019,0,11,2074000.0
2074,2074999,21.638314877519125,37.83932146639403,0.07652788665395871,287.7139046192169,134.99633026123047,301.0576820373535,11269,2240,9029,9029,0,11,2075000.0
2075,2075999,21.640658544277994,37.84297937844287,0.07659275068175408,287.8711054325104,135.0619637966156,301.2005844116211,11273,2241,9032,9032,0,11,2076000.0
2076,2076999,21.64414414840857,37.84978037405145,0.07663908661670105,288.01797819137573,135.1271777153015,301.40849685668945,11279,2242,9037,9037,0,11,2077000.0
2077,2077999,21.647049255889485,37.85249326419381,0.07670169494554546,288.19008898735046,135.1926417350769,301.54560470581055,11288,2244,9044,9044,0,11,2078000.0
2078,2078999,21.649735606161066,37.854767953100065,0.0767957833800208,288.3030643463135,135.2585768699646,301.73854064941406,11289,2244,9045,9045,0,11,2079000.0
2079,2079999,21.65308400575831,37.862057694835244,0.07681998268538348,288.50625252723694,135.324631690979,301.8457832336426,11299,2247,9052,9052,0,11,2080000.0
2080,2080999,21.655042785144417,37.862741832289224,0.0768799406641788,288.61724042892456,135.39011669158936,302.0002632141113,11299,2247,9052,9052,0,11,2081000.0
2081,2081999,21.657725934964695,37.864658077378174,0.0769383614431094,288.7584638595581,135.4549276828766,302.0487976074219,11303,2248,9055,9055,0,11,2082000.0
2082,2082999,21.660995193555422,37.87265704265518,0.0768959544598784,288.87922739982605,135.51965808868408,302.36045837402344,11307,2248,9059,9059,0,11,2083000.0
2083,2083999,21.663220593072893,37.87382278866495,0.07692697061135045,289.0834205150604,135.58598685264587,302.4287338256836,11321,2251,9070,9070,0,11,2084000.0
2084,2084999,21.66588912063178,37.87492164027608,0.07692471688549107,289.20559334754944,135.65069603919983,302.6322784423828,11321,2251,9070,9070,0,11,2085000.0
2085,2085999,21.667166213743407,37.87886560951723,0.07695016516889286,289.3517122268677,135.715665102005,302.6714553833008,11326,2252,9074,9074,0,11,2086000.0
2086,2086999,21.665870144028997,37.87645087371894,0.07691207002197731,289.4792764186859,135.7820439338684,303.1228332519531,11339,2252,9087,9087,0,11,2087000.0
2087,2087999,21.662561438069613,37.87174711115766,0.07689382779354159,289.59800457954407,135.8471176624298,303.3758201599121,11339,2252,9087,9087,0,11,2088000.0
2088,2088999,21.659273337163356,37.865400449382136,0.0769010860376852,289.7169940471649,135.91186141967773,303.53862380981445,11340,2252,9088,9088,0,11,2089000.0
2089,2089999,21.656397289860973,37.86161950315992,0.07689048383328534,289.8972499370575,135.97705388069153,303.6022415161133,11345,2254,9091,9091,0,11,2090000.0
2090,2090999,21.653272481600734,37.85646935310557,0.07688203956339235,290.02072405815125,136.04258823394775,303.8756561279297,11352,2254,9098,9098,0,11,2091000.0
2091,2091999,21.649599826905607,37.85027003679084,0.0768794014701083,290.1316075325012,136.10761976242065,304.1103744506836,11353,2254,9099,9099,0,11,2092000.0
2092,2092999,21.64659548350353,37.844840354689595,0.07687811580329162,290.33113074302673,136.1729085445404,304.1001205444336,11359,2257,9102,9102,0,11,2093000.0
2093,2093999,21.6436004488405,37.83937999395814,0.076870627885685,290.46702098846436,136.23847937583923,304.2876625061035,11359,2257,9102,9102,0,11,2094000.0
2094,2094999,21.641038979290855,37.8344718570428,0.0768744434714358,290.5809042453766,136.3033730983734,304.4491157531738,11361,2257,9104,9104,0,11,2095000.0
2095,2095999,21.638238671599126,37.82933890767618,0.07688509356500262,290.76111483573914,136.369309425354,304.52213287353516,11368,2259,9109,9109,0,11,2096000.0
2096,2096999,21.63693146027129,37.82634520556324,0.07689005995184084,290.9307816028595,136.43524193763733,304.77599716186523,11379,2261,9118,9118,0,11,2097000.0
2097,2097999,21.635862260850057,37.823538539793084,0.07689551889239143,291.12907671928406,136.5006275177002,304.8308219909668,11387,2264,9123,9123,0,11,2098000.0
2098,2098999,21.635151151512666,37.821959829239,0.07690778584175617,291.2738230228424,136.56574416160583,304.9714698791504,11389,2265,9124,9124,0,11,2099000.0
2099,2099999,21.635292174258545,37.821080691809975,0.07691003814425279,291.49692583084106,136.63306069374084,305.0093688964844,11399,2269,9130,9130,0,11,2100000.0
2100,2100999,21.63506521855495,37.81941021258135,0.07695632059363577,291.61088943481445,136.69786858558655,305.23137283325195,11400,2269,9131,9131,0,11,2101000.0
2101,2101999,21.636071764166605,37.819909103583406,0.07702703892810503,291.8203458786011,136.76372027397156,305.30567169189453,11413,2272,9141,9141,0,11,2102000.0
2102,2102999,21.639255278509506,37.823380660139605,0.0770668141501144,291.96339559555054,136.83017349243164,305.6953468322754,11425,2273,9152,9152,0,11,2103000.0
2103,2103999,21.642141176502935,37.82624884660759,0.07715503598321383,292.1314549446106,136.89509296417236,305.8324508666992,11429,2275,9154,9154,0,11,2104000.0
2104,2104999,21.644314662188453,37.827894607067236,0.07724280834948127,292.2696096897125,136.95981764793396,305.9731788635254,11431,2276,9155,9155,0,11,2105000.0
2105,2105999,21.645148357767713,37.827096454087595,0.07732775025188698,292.41563510894775,137.02446508407593,306.08537673950195,11433,2277,9156,9156,0,11,2106000.0
2106,2106999,21.642989419512897,37.82250521646979,0.07734752389596111,292.55550146102905,137.08998847007751,306.45165252685547,11444,2278,9166,9166,0,11,2107000.0
2107,2107999,21.638526130332135,37.817344806341396,0.07737494197568462,292.6677601337433,137.15439748764038,306.7451629638672,11444,2278,9166,9166,0,11,2108000.0
2108,2108999,21.634953688231967,37.812741206237014,0.07738376519697554,292.83977603912354,137.21911525726318,306.834774017334,11450,2280,9170,9170,0,11,2109000.0
2109,2109999,21.632533335279444,37.81370328309404,0.07737063478309392,292.99234771728516,137.28384399414062,307.01368713378906,11453,2281,9172,9172,0,11,2110000.0
2110,2110999,21.62862599043298,37.80761942372732,0.07737520855774993,293.13283801078796,137.34852623939514,307.1057777404785,11455,2282,9173,9173,0,11,2111000.0
2111,2111999,21.626039950378697,37.805276528616126,0.07736308087175026,293.3004367351532,137.41330790519714,307.2518196105957,11461,2284,9177,9177,0,11,2112000.0
2112,2112999,21.62238416140868,37.79936260985238,0.07736368250418324,293.5036971569061,137.48002290725708,307.36133575439453,11474,2287,9187,9187,0,11,2113000.0
2113,2113999,21.619358535462336,37.794380073791466,0.07735924553598883,293.6295852661133,137.5449185371399,307.5253486633301,11475,2287,9188,9188,0,11,2114000.0
2114,2114999,21.61610911260263,37.78909130032635,0.07735972190476581,293.7851836681366,137.61002659797668,307.62492752075195,11478,2288,9190,9190,0,11,2115000.0
2115,2115999,21.613663049186542,37.78457603905251,0.07735566938445948,293.9885289669037,137.67650437355042,307.6887741088867,11487,2291,9196,9196,0,11,2116000.0
2116,2116999,21.611283649836825,37.779838896732706,0.07734549685821335,294.1633381843567,137.74318504333496,307.8436279296875,11495,2293,9202,9202,0,11,2117000.0
2117,2117999,21.609728864154683,37.776163982357176,0.07732550970258312,294.3451690673828,137.80846405029297,307.9148292541504,11500,2295,9205,9205,0,11,2118000.0
2118,2118999,21.60866010287618,37.77416667652344,0.07731461966853759,294.4716548919678,137.87351822853088,308.1009979248047,11500,2295,9205,9205,0,11,2119000.0
2119,2119999,21.60762860377743,37.77106510914602,0.07730143053433913,294.61828804016113,137.93960523605347,308.21548080444336,11502,2296,9206,9206,0,11,2120000.0
2120,2120999,21.60652130308661,37.76792884372291,0.07729123894318546,294.76590943336487,138.00516748428345,308.3333969116211,11505,2297,9208,9208,0,11,2121000.0
2121,2121999,21.60608217599329,37.76649137262092,0.07727737604439078,294.92035007476807,138.07069516181946,308.4203758239746,11514,2298,9216,9216,0,11,2122000.0
2122,2122999,21.60593964342344,37.763929019540676,0.07727006560680427,295.1007421016693,138.13656067848206,308.6222152709961,11524,2300,9224,9224,0,11,2123000.0
2123,2123999,21.60617108090698,37.76222590480109,0.07726474041987119,295.2114658355713,138.20254683494568,308.83565521240234,11524,2300,9224,9224,0,11,2124000.0
2124,2124999,21.607010129949153,37.76177693645346,0.07725621291535156,295.3532636165619,138.26757311820984,308.99027252197266,11526,2301,9225,9225,0,11,2125000.0
2125,2125999,21.60741130030683,37.76019042816931,0.07725847775533135,295.4863796234131,138.33239650726318,309.09948348999023,11526,2301,9225,9225,0,11,2126000.0
2126,2126999,21.60645462260935,37.75678369894054,0.07724516593014463,295.6845953464508,138.3978111743927,309.1343879699707,11532,2304,9228,9228,0,11,2127000.0
2127,2127999,21.602885995167597,37.75034217058129,0.07725709990454821,295.85013484954834,138.4641695022583,309.7821502685547,11560,2306,9254,9254,0,11,2128000.0
2128,2128999,21.598035105092595,37.743435514837174,0.07729127909306333,295.96403336524963,138.52911138534546,310.04029846191406,11562,2306,9256,9256,0,11,2129000.0
2129,2129999,21.593992836052447,37.737897634418985,0.07730975297820986,296.11045026779175,138.59491443634033,310.22944259643555,11567,2307,9260,9260,0,11,2130000.0
2130,2130999,21.590577076675718,37.73379024634883,0.07731793672767306,296.2679109573364,138.6611077785492,310.35071563720703,11569,2308,9261,9261,0,11,2131000.0
2131,2131999,21.58728978796672,37.72872954953904,0.07732152580276552,296.43848943710327,138.72676992416382,310.51144790649414,11577,2310,9267,9267,0,11,2132000.0
2132,2132999,21.58405979216684,37.7228928553896,0.07732724221198539,296.5619788169861,138.7924783229828,310.7249641418457,11577,2310,9267,9267,0,11,2133000.0
2133,2133999,21.580850641821275,37.71793940305697,0.07732318201662458,296.71092987060547,138.85804152488708,310.86974716186523,11579,2311,9268,9268,0,11,2134000.0
2134,2134999,21.576785635652346,37.71150867835053,0.07733610596513718,296.903906583786,138.92476725578308,310.86920166015625,11587,2314,9273,9273,0,11,2135000.0
2135,2135999,21.573075280462433,37.705750204731174,0.07734740239685933,297.0803761482239,138.99122643470764,310.98038482666016,11596,2316,9280,9280,0,11,2136000.0
2136,2136999,21.56945126928832,37.69958256449084,0.07736116307590324,297.25856733322144,139.05761122703552,311.16502380371094,11604,2318,9286,9286,0,11,2137000.0
2137,2137999,21.56605042236395,37.69343407137307,0.07736258136817442,297.38929748535156,139.12385869026184,311.4247245788574,11608,2318,9290,9290,0,11,2138000.0
2138,2138999,21.563180209745514,37.68784205540312,0.07734841699992978,297.565936088562,139.19203329086304,311.5074348449707,11614,2320,9294,9294,0,11,2139000.0
2139,2139999,21.56097382206594,37.68338584087631,0.0773413514983815,297.73753547668457,139.25807189941406,311.6183052062988,11626,2322,9304,9304,0,11,2140000.0
2140,2140999,21.55842326449481,37.67822464283004,0.07732566430836141,297.8913223743439,139.3248257637024,311.73514556884766,11628,2323,9305,9305,0,11,2141000.0
2141,2141999,21.556708802146204,37.67399359824108,0.07731299252459356,298.0158362388611,139.3905966281891,311.8497009277344,11629,2323,9306,9306,0,11,2142000.0
2142,2142999,21.554831656014855,37.66930122536251,0.07730931171960675,298.1947674751282,139.4568314552307,311.8564872741699,11640,2325,9315,9315,0,11,2143000.0
2143,2143999,21.553776582280836,37.66589111365996,0.07728122822419292,298.37164306640625,139.5229229927063,312.1698188781738,11656,2327,9329,9329,0,11,2144000.0
2144,2144999,21.552196814611627,37.66142876493037,0.07726105934413674,298.51483821868896,139.58842062950134,312.33244705200195,11658,2328,9330,9330,0,11,2145000.0
2145,2145999,21.551436994501664,37.658625368448455,0.07722709159660379,298.74480390548706,139.65530562400818,312.4089164733887,11668,2332,9336,9336,0,11,2146000.0
2146,2146999,21.549900620220036,37.65446494583914,0.07721946570552718,298.9160120487213,139.72116613388062,312.494327545166,11672,2334,9338,9338,0,11,2147000.0
2147,2147999,21.54699394776358,37.6491638333572,0.07720996309189265,299.08581948280334,139.7870876789093,312.660213470459,11705,2336,9369,9369,0,11,2148000.0
2148,2148999,21.542282918384437,37.64230972988359,0.07724739606224051,299.21102023124695,139.85355281829834,313.36419677734375,11730,2336,9394,9394,0,11,2149000.0
2149,2149999,21.537451917791717,37.6356616019079,0.07727664823997427,299.38208413124084,139.9190170764923,313.4925880432129,11734,2338,9396,9396,0,11,2150000.0
2150,2150999,21.533025386223404,37.629789153103566,0.07730477233885091,299.4980216026306,139.98481225967407,313.71421813964844,11736,2338,9398,9398,0,11,2151000.0
2151,2151999,21.528922134233557,37.62539166465637,0.0773283619192664,299.62736678123474,140.04974579811096,313.83541107177734,11736,2338,9398,9398,0,11,2152000.0
2152,2152999,21.52506581574405,37.62266307027175,0.07733228608339027,299.8232412338257,140.11560702323914,313.9307975769043,11745,2341,9404,9404,0,11,2153000.0
2153,2153999,21.52143303642837,37.61819067679065,0.07733731915301856,299.9398956298828,140.18174481391907,314.17202377319336,11746,2341,9405,9405,0,11,2154000.0
2154,2154999,21.517436013702714,37.61249525489373,0.07735290718977872,300.1142420768738,140.24761581420898,314.2957572937012,11760,2343,9417,9417,0,11,2155000.0
2155,2155999,21.513718650301993,37.60843708580837,0.07735751350653952,300.2334179878235,140.31281757354736,314.4092216491699,11760,2343,9417,9417,0,11,2156000.0
2156,2156999,21.509923043283894,37.602973808698906,0.07736951348967913,300.4119873046875,140.37876963615417,314.4825210571289,11766,2345,9421,9421,0,11,2157000.0
2157,2157999,21.506331256101255,37.59713757164173,0.07737572335972132,300.54044461250305,140.44430422782898,314.63450622558594,11768,2345,9423,9423,0,11,2158000.0
2158,2158999,21.50257985287107,37.59106887113796,0.07738046468378001,300.6882963180542,140.50979375839233,314.8153953552246,11774,2346,9428,9428,0,11,2159000.0
2159,2159999,21.500170235606507,37.58675394544706,0.07736615095441224,300.83476519584656,140.57643485069275,314.96703338623047,11777,2347,9430,9430,0,11,2160000.0
2160,2160999,21.4976135128907,37.582381256747794,0.07735993189598411,300.9487347602844,140.64146876335144,315.1046676635742,11777,2347,9430,9430,0,11,2161000.0
2161,2161999,21.495389081526127,37.578674496853345,0.0773485372294721,301.12614822387695,140.70718431472778,315.15295028686523,11781,2349,9432,9432,0,11,2162000.0
2162,2162999,21.493779214325006,37.585560814152196,0.0773051831296312,301.3024649620056,140.77285146713257,315.18530654907227,11786,2351,9435,9435,0,11,2163000.0
2163,2163999,21.492284098091016,37.58244044579934,0.07729826150661123,301.4798061847687,140.83877277374268,315.2857666015625,11794,2353,9441,9441,0,11,2164000.0
2164,2164999,21.49076641321556,37.57824652482702,0.07728125175270195,301.630747795105,140.9057056903839,315.49615478515625,11800,2354,9446,9446,0,11,2165000.0
2165,2165999,21.48934311403977,37.57468513951991,0.07727316135636586,301.7539265155792,142.0778934955597,315.6603698730469,11800,2354,9446,9446,0,11,2166000.0
2166,2166999,21.488275949550797,37.570886919010675,0.07725073912841174,301.96483302116394,142.14435362815857,315.770938873291,11810,2357,9453,9453,0,11,2167000.0
2167,2167999,21.486894504215652,37.56665936482672,0.07723269324054305,302.13787961006165,142.21045398712158,315.8853302001953,11826,2359,9467,9467,0,11,2168000.0
2168,2168999,21.48420606576534,37.56127233487367,0.07723006118276876,302.2790422439575,142.27651929855347,316.0566596984863,11827,2359,9468,9468,0,11,2169000.0
2169,2169999,21.48111839240061,37.556863333485374,0.07723714127254588,302.4354763031006,142.34398770332336,316.8305854797363,11859,2360,9499,9499,0,11,2170000.0
2170,2170999,21.477356283577862,37.55124075880801,0.0772693226484451,302.55918622016907,142.41074395179749,317.11542892456055,11862,2360,9502,9502,0,11,2171000.0
2171,2171999,21.47357932475028,37.545438518492084,0.07731559003451316,302.68342423439026,142.47796440124512,317.32365798950195,11865,2360,9505,9505,0,11,2172000.0
2172,2172999,21.470690188399626,37.54167558595873,0.07733798526768221,302.8325412273407,142.54596209526062,317.4671325683594,11867,2361,9506,9506,0,11,2173000.0
2173,2173999,21.468771802850473,37.538043749097646,0.07734405717658388,302.9526288509369,142.61242151260376,317.70449447631836,11868,2361,9507,9507,0,11,2174000.0
2174,2174999,21.46733469464433,37.535461590260944,0.07731031695406043,303.1065683364868,142.6789367198944,317.80982208251953,11870,2362,9508,9508,0,11,2175000.0
2175,2175999,21.46530188430045,37.532356113537894,0.07729643257955288,303.3197464942932,142.74604392051697,317.81615829467773,11877,2365,9512,9512,0,11,2176000.0
2176,2176999,21.462871205206017,37.52801679879194,0.07730326695236722,303.47185921669006,142.81258893013,317.9349021911621,11880,2366,9514,9514,0,11,2177000.0
2177,2177999,21.46090377491398,37.52385223023754,0.07730128092423272,303.6834235191345,142.8797070980072,317.9256057739258,11894,2369,9525,9525,0,11,2178000.0
2178,2178999,21.459542336135225,37.520376813341095,0.0772536224540924,303.86271047592163,142.9489505290985,318.1027946472168,11904,2371,9533,9533,0,11,2179000.0
2179,2179999,21.458675901223145,37.51740376189812,0.07720761154887945,304.1032531261444,143.01622819900513,318.14156341552734,11915,2375,9540,9540,0,11,2180000.0
2180,2180999,21.456692064203853,37.5129494589483,0.07720428843714955,304.2840414047241,143.0828206539154,318.24071884155273,11920,2377,9543,9543,0,11,2181000.0
2181,2181999,21.45526278552757,37.508804745407204,0.07718969584624968,304.4357371330261,143.14944314956665,318.34668731689453,11922,2378,9544,9544,0,11,2182000.0
2182,2182999,21.45322448619238,37.50395503733741,0.07719340726604984,304.59071230888367,143.2156264781952,318.4197883605957,11925,2379,9546,9546,0,11,2183000.0
2183,2183999,21.452230684428503,37.50015898868045,0.0771813798439206,304.72543144226074,143.28269481658936,318.741153717041,11931,2379,9552,9552,0,11,2184000.0
2184,2184999,21.45063691625315,37.495725493501766,0.0771850564424782,304.8471715450287,143.34857487678528,318.9271125793457,11931,2379,9552,9552,0,11,2185000.0
2185,2185999,21.448479819266698,37.49057955492976,0.077192464260603,304.9924147129059,143.41456532478333,319.10074615478516,11934,2380,9554,9554,0,11,2186000.0
2186,2186999,21.446069615289947,37.48565698895538,0.07718516612157056,305.2083389759064,143.48318529129028,319.3390769958496,11955,2383,9572,9572,0,11,2187000.0
2187,2187999,21.44376321158379,37.48340234275116,0.07718065661739937,305.33523201942444,143.5500364303589,319.84999084472656,11968,2383,9585,9585,0,11,2188000.0
2188,2188999,21.440910951456434,37.48158923886672,0.0771811643946122,305.5139756202698,143.61828446388245,320.0855522155762,11980,2385,9595,9595,0,11,2189000.0
2189,2189999,21.437681297219825,37.47768002857809,0.07719555717115534,305.63890194892883,143.68532752990723,320.3364067077637,11982,2385,9597,9597,0,11,2190000.0
2190,2190999,21.43423993106755,37.47228863230083,0.07721825800001336,305.75596714019775,143.7516782283783,320.6891441345215,11989,2385,9604,9604,0,11,2191000.0
2191,2191999,21.43059522570489,37.466501913199366,0.07723307043378336,305.8728713989258,143.81824803352356,320.9241523742676,11989,2385,9604,9604,0,11,2192000.0
2192,2192999,21.427331647199818,37.4639547214933,0.07722951692675428,306.01643657684326,143.88411450386047,321.0350570678711,11991,2386,9605,9605,0,11,2193000.0
2193,2193999,21.42344077165911,37.45777102953725,0.07724401167365058,306.1733877658844,143.95046877861023,321.12841033935547,11996,2387,9609,9609,0,11,2194000.0
2194,2194999,21.42035852767352,37.45276402921238,0.0772507181537142,306.34676575660706,144.01699709892273,321.1988296508789,12001,2389,9612,9612,0,11,2195000.0
2195,2195999,21.41705636011054,37.447230654755685,0.07725353051444361,306.5522611141205,144.08438110351562,321.30860137939453,12011,2392,9619,9619,0,11,2196000.0
2196,2196999,21.414952146744124,37.44290369998074,0.07722907502767673,306.719206571579,144.15187001228333,321.638671875,12053,2394,9659,9659,0,11,2197000.0
2197,2197999,21.413922667256823,37.4449162700533,0.0771861461404536,306.8666081428528,144.21805119514465,321.80216217041016,12056,2395,9661,9661,0,11,2198000.0
2198,2198999,21.412828834037807,37.441332943405406,0.0771532768335157,307.0263090133667,144.28470087051392,321.92060470581055,12058,2396,9662,9662,0,11,2199000.0
2199,2199999,21.411833099448685,37.43895373302296,0.07713454680201415,307.2643437385559,144.3514106273651,321.9364433288574,12066,2400,9666,9666,0,11,2200000.0
2200,2200999,21.41070494693357,37.43683757989623,0.0771051150772426,307.3823001384735,144.41767716407776,322.1195869445801,12067,2400,9667,9667,0,11,2201000.0
2201,2201999,21.410185720023808,37.4389887767778,0.0770459004123204,307.50244665145874,144.48361110687256,322.2691078186035,12068,2400,9668,9668,0,11,2202000.0
2202,2202999,21.410639001989853,37.43929002906634,0.07700354943145027,307.64947390556335,144.5499997138977,322.53577041625977,12075,2401,9674,9674,0,11,2203000.0
2203,2203999,21.410227056577444,37.43665476645014,0.07697391689138933,307.80430603027344,144.61587691307068,322.65920639038086,12077,2402,9675,9675,0,11,2204000.0
2204,2204999,21.409778218006522,37.4376456459564,0.07693703429750498,307.9530305862427,144.6834580898285,322.74406814575195,12079,2403,9676,9676,0,11,2205000.0
2205,2205999,21.409133135488798,37.43427026623785,0.0768994420779715,308.1595025062561,144.74979186058044,322.78549575805664,12085,2406,9679,9679,0,11,2206000.0
2206,2206999,21.407194555881077,37.4302875127833,0.0768881282382835,308.2771635055542,144.81595277786255,323.168270111084,12096,2406,9690,9690,0,11,2207000.0
2207,2207999,21.40272514452948,37.426838139885874,0.07691386098777053,308.39508533477783,144.8806335926056,323.4723777770996,12098,2406,9692,9692,0,11,2208000.0
2208,2208999,21.398015449160454,37.42160859403462,0.076943122687677,308.57773780822754,144.9459662437439,323.58544158935547,12103,2408,9695,9695,0,11,2209000.0
2209,2209999,21.393532649605934,37.41583224359661,0.07697228517089272,308.72048115730286,145.01109766960144,323.82897567749023,12114,2409,9705,9705,0,11,2210000.0
2210,2210999,21.3893651187008,37.41307831394268,0.07698039549871338,308.9085912704468,145.0767216682434,323.8852348327637,12119,2411,9708,9708,0,11,2211000.0
2211,2211999,21.385082204702258,37.40668495569379,0.07701113491573863,309.05384850502014,145.14333868026733,324.11035537719727,12126,2412,9714,9714,0,11,2212000.0
2212,2212999,21.380830832291753,37.400939210165085,0.07702777271470784,309.17432045936584,145.2079849243164,324.3038864135742,12127,2412,9715,9715,0,11,2213000.0
2213,2213999,21.376490147759448,37.39433677762838,0.07705561955518336,309.35575580596924,145.2738265991211,324.35959243774414,12131,2414,9717,9717,0,11,2214000.0
2214,2214999,21.372450911806993,37.38861029643371,0.07707750905681132,309.50430488586426,145.3391306400299,324.4635772705078,12136,2415,9721,9721,0,11,2215000.0
2215,2215999,21.368221056202408,37.38249680802566,0.07710396085992488,309.64934849739075,145.40384531021118,324.59557723999023,12141,2416,9725,9725,0,11,2216000.0
2216,2216999,21.364571997740974,37.37680162263249,0.07711893496121747,309.7821481227875,145.46978497505188,324.740047454834,12141,2416,9725,9725,0,11,2217000.0
2217,2217999,21.361389419380274,37.37147198353677,0.07711742544368405,309.9426522254944,145.53494000434875,324.8892478942871,12147,2417,9730,9730,0,11,2218000.0
2218,2218999,21.358396060853455,37.36688974904196,0.07712195082333295,310.0903124809265,145.60035729408264,325.0029067993164,12149,2418,9731,9731,0,11,2219000.0
2219,2219999,21.355644344235827,37.36343960211412,0.07711124456361329,310.23690962791443,145.66506052017212,325.05430603027344,12153,2419,9734,9734,0,11,2220000.0
2220,2220999,21.352965452596422,37.35878594290288,0.07711136532779317,310.361172914505,145.7300066947937,325.1710205078125,12154,2419,9735,9735,0,11,2221000.0
2221,2221999,21.350560273567467,37.355626556660965,0.07710443596633809,310.4892909526825,145.79503202438354,325.24535751342773,12154,2419,9735,9735,0,11,2222000.0
2222,2222999,21.348100575020382,37.35141821402616,0.0771045741598444,310.63962984085083,145.85961437225342,325.31406021118164,12156,2420,9736,9736,0,11,2223000.0
2223,2223999,21.345495282425365,37.346323311745,0.07710909630817786,310.78671050071716,145.92465448379517,325.5032043457031,12162,2421,9741,9741,0,11,2224000.0
2224,2224999,21.343470497929076,37.34708238783727,0.07710043183382032,310.98061966896057,145.98978924751282,325.5838165283203,12166,2423,9743,9743,0,11,2225000.0
2225,2225999,21.34115439790847,37.343164783004525,0.07709630128739964,311.1533353328705,146.0549807548523,325.6692924499512,12170,2425,9745,9745,0,11,2226000.0
2226,2226999,21.33814236782086,37.3380632713037,0.0770948228225421,311.32154536247253,146.1200556755066,325.70920181274414,12180,2427,9753,9753,0,11,2227000.0
2227,2227999,21.334811894153592,37.33290353419451,0.07709633852451159,311.44663882255554,146.18501591682434,326.0801811218262,12191,2427,9764,9764,0,11,2228000.0
2228,2228999,21.3308344796158,37.329186658503374,0.07710978618217046,311.5767948627472,146.25042605400085,326.32066345214844,12193,2427,9766,9766,0,11,2229000.0
2229,2229999,21.326899886990482,37.324678406070035,0.07713544534302896,311.70283675193787,146.3158540725708,326.4581108093262,12193,2427,9766,9766,0,11,2230000.0
2230,2230999,21.32259288828579,37.31875983878428,0.07717025959149826,311.8742883205414,146.38148021697998,326.4908332824707,12199,2429,9770,9770,0,11,2231000.0
2231,2231999,21.318979310212505,37.31533059780043,0.07718137735024411,312.0790545940399,146.44769668579102,326.592529296875,12215,2432,9783,9783,0,11,2232000.0
2232,2232999,21.314600982251314,37.309110310537896,0.07720607334014218,312.2249228954315,146.51305890083313,326.87694549560547,12223,2433,9790,9790,0,11,2233000.0
2233,2233999,21.310423404534212,37.30296833372708,0.07723233288253872,312.3719217777252,146.5789806842804,327.0059471130371,12227,2434,9793,9793,0,11,2234000.0
2234,2234999,21.30706729655253,37.29807373890604,0.07725135074472234,312.6189720630646,146.64547061920166,327.01054763793945,12245,2438,9807,9807,0,11,2235000.0
2235,2235999,21.30319603202081,37.29223647288874,0.07727429313491596,312.7660458087921,146.7106740474701,327.1405487060547,12249,2439,9810,9810,0,11,2236000.0
2236,2236999,21.30023038355794,37.28722062707097,0.07729002305995414,312.9148967266083,146.7774052619934,327.32995986938477,12256,2440,9816,9816,0,11,2237000.0
2237,2237999,21.29815546453085,37.283875171709845,0.07730071532547078,313.0987684726715,146.8435776233673,327.61277770996094,12266,2442,9824,9824,0,11,2238000.0
2238,2238999,21.297447927151524,37.2830624630967,0.07728607356098138,313.29440569877625,146.90909242630005,327.6717758178711,12272,2445,9827,9827,0,11,2239000.0
2239,2239999,21.297941873721765,37.291820658211904,0.07723015922016663,313.4478826522827,146.97419214248657,327.8568344116211,12274,2446,9828,9828,0,11,2240000.0
2240,2240999,21.29846265448678,37.303167212728084,0.07720009703109598,313.6167905330658,147.0404508113861,328.0164566040039,12278,2448,9830,9830,0,11,2241000.0
2241,2241999,21.29896897362946,37.316506976620865,0.07716626503197221,313.738783121109,147.1058704853058,328.1856269836426,12279,2448,9831,9831,0,11,2242000.0
2242,2242999,21.301300289721816,37.33339782055727,0.07707320388177208,313.92191529273987,147.17154097557068,328.27441787719727,12286,2450,9836,9836,0,11,2243000.0
2243,2243999,21.303663580923974,37.338161258916855,0.0770370866977339,314.0391833782196,147.23845291137695,328.6380195617676,12294,2450,9844,9844,0,11,2244000.0
2244,2244999,21.305093217384822,37.34379181173525,0.07700280826610817,314.21476221084595,147.30352330207825,328.7429962158203,12300,2452,9848,9848,0,11,2245000.0
2245,2245999,21.30576030926535,37.34382272375862,0.0770051026821964,314.33260011672974,147.36823987960815,328.9040641784668,12300,2452,9848,9848,0,11,2246000.0
2246,2246999,21.305437696529964,37.34229870598113,0.07704810186655298,314.4881546497345,147.43357253074646,328.99359130859375,12302,2453,9849,9849,0,11,2247000.0
2247,2247999,21.30396707534632,37.3409189880067,0.07702962155515702,314.6570465564728,147.49881386756897,329.4921417236328,12348,2455,9893,9893,0,11,2248000.0
2248,2248999,21.30229398420078,37.34084499081817,0.07706322217648398,314.80193281173706,147.56413793563843,329.75160217285156,12350,2456,9894,9894,0,11,2249000.0
2249,2249999,21.301788066611067,37.341921091429285,0.07709786683648168,314.97204852104187,147.62994027137756,329.8848762512207,12357,2458,9899,9899,0,11,2250000.0
2250,2250999,21.300946539538547,37.341481771829315,0.07709464417779754,315.19605350494385,147.6954860687256,330.02614974975586,12374,2462,9912,9912,0,11,2251000.0
2251,2251999,21.30204777521256,37.34458611356088,0.07708541565197846,315.37459778785706,147.7610960006714,330.2697639465332,12388,2464,9924,9924,0,11,2252000.0
2252,2252999,21.304142755764087,37.34806363279101,0.07711797448963664,315.5791280269623,147.83615136146545,330.51976013183594,12399,2466,9933,9933,0,11,2253000.0
2253,2253999,21.30570787313864,37.35032901334905,0.0771897811835831,315.7514498233795,147.90224385261536,330.6192169189453,12404,2468,9936,9936,0,11,2254000.0
2254,2254999,21.30776306814903,37.35534092465843,0.07735689570116533,315.95216131210327,147.96816396713257,330.6988067626953,12411,2471,9940,9940,0,11,2255000.0
2255,2255999,21.30936176622646,37.35660189202559,0.0774907556250709,316.0692255496979,148.03364872932434,330.9179039001465,12412,2471,9941,9941,0,11,2256000.0
2256,2256999,21.312772123127047,37.36475937660292,0.07759104142691797,316.22272396087646,148.0992956161499,331.0600280761719,12417,2472,9945,9945,0,11,2257000.0
2257,2257999,21.31662237602724,37.372943543176284,0.07775829066270501,316.40222787857056,148.16516423225403,331.3195686340332,12427,2474,9953,9953,0,11,2258000.0
2258,2258999,21.320168169439476,37.37798125185041,0.0779067203736512,316.6089994907379,148.2312774658203,331.4374084472656,12435,2477,9958,9958,0,11,2259000.0
2259,2259999,21.32245186841121,37.38088948345309,0.07805771537827444,316.72294187545776,148.29640889167786,331.62278747558594,12436,2477,9959,9959,0,11,2260000.0
2260,2260999,21.325090448366947,37.385857740664505,0.07811200905541871,316.9376244544983,148.36357593536377,331.71398162841797,12444,2480,9964,9964,0,11,2261000.0
2261,2261999,21.32806920692444,37.390029507905524,0.07821855546704937,317.0575819015503,148.42956376075745,331.8907661437988,12445,2480,9965,9965,0,11,2262000.0
2262,2262999,21.331365669427885,37.39480379817608,0.07827852851837414,317.2373397350311,148.5043430328369,332.0435028076172,12449,2481,9968,9968,0,11,2263000.0
2263,2263999,21.334961276667865,37.39768428772391,0.07828180604077017,317.35852885246277,148.56956911087036,332.3514862060547,12454,2481,9973,9973,0,11,2264000.0
2264,2264999,21.337141760822906,37.39820542245155,0.0783105506002042,317.4975686073303,148.63426780700684,332.4529800415039,12458,2482,9976,9976,0,11,2265000.0
2265,2265999,21.339374607989473,37.39853486615771,0.07834068286794826,317.7003798484802,148.70013093948364,332.5258140563965,12464,2485,9979,9979,0,11,2266000.0
2266,2266999,21.339470690364323,37.395764405573985,0.0783406625525781,317.90537905693054,148.7656548023224,332.5904426574707,12472,2488,9984,9984,0,11,2267000.0
2267,2267999,21.336882142917364,37.39337347023829,0.07833338089371356,318.0661630630493,148.83266592025757,333.2953338623047,12501,2489,10012,10012,0,11,2268000.0
2268,2268999,21.3332217634363,37.38859247440915,0.07834170046366329,318.2349102497101,148.89877247810364,333.5204429626465,12509,2491,10018,10018,0,11,2269000.0
2269,2269999,21.329926629193473,37.38399480229893,0.07834530026927056,318.3822867870331,148.9645254611969,333.7272605895996,12514,2492,10022,10022,0,11,2270000.0
2270,2270999,21.327285677538775,37.380606871282694,0.07833893538116632,318.49960112571716,149.03130221366882,333.9231605529785,12514,2492,10022,10022,0,11,2271000.0
2271,2271999,21.324292827066706,37.3760506719945,0.07833218900105454,318.6778476238251,149.09787011146545,334.13686752319336,12525,2494,10031,10031,0,11,2272000.0
2272,2272999,21.32215990462411,37.372100685627395,0.07832875649485327,318.88411140441895,149.16432404518127,334.2105712890625,12533,2497,10036,10036,0,11,2273000.0
2273,2273999,21.320177117693905,37.36902532953509,0.07831972841037693,318.9997715950012,149.2299633026123,334.4358558654785,12533,2497,10036,10036,0,11,2274000.0
2274,2274999,21.318983874203926,37.367938239603106,0.0783371249840128,319.1764934062958,149.29686427116394,334.53447341918945,12537,2499,10038,10038,0,11,2275000.0
2275,2275999,21.318084029930098,37.37474025576192,0.0783197834940651,319.3546152114868,149.36287188529968,334.625057220459,12543,2501,10042,10042,0,11,2276000.0
2276,2276999,21.318128445465216,37.376842843206425,0.07833245902575847,319.47365522384644,149.4293074607849,334.8470993041992,12547,2501,10046,10046,0,11,2277000.0
2277,2277999,21.319256268256705,37.380944378017574,0.07837211985552106,319.7333574295044,149.4960482120514,334.9408264160156,12574,2506,10068,10068,0,11,2278000.0
2278,2278999,21.321441245764724,37.38824954218843,0.07845398331657782,319.9510335922241,149.56466031074524,335.10163497924805,12584,2509,10075,10075,0,11,2279000.0
2279,2279999,21.322817831234595,37.39238728652464,0.0785908355303111,320.12006998062134,149.6310954093933,335.25580978393555,12597,2511,10086,10086,0,11,2280000.0
2280,2280999,21.32433272020463,37.39505733383163,0.07872934270908727,320.26646733283997,149.69727778434753,335.4137878417969,12599,2512,10087,10087,0,11,2281000.0
2281,2281999,21.32684583090426,37.403356209271635,0.07884333524776,320.4128053188324,149.76334190368652,335.5524139404297,12602,2513,10089,10089,0,11,2282000.0
2282,2282999,21.330473978582297,37.409450960061726,0.07894896928351636,320.5368127822876,149.83073091506958,335.70885848999023,12602,2513,10089,10089,0,11,2283000.0
2283,2283999,21.333225826323304,37.41179780343452,0.07901802947831826,320.68503189086914,149.8965573310852,336.0111885070801,12609,2514,10095,10095,0,11,2284000.0
2284,2284999,21.337751701252774,37.418259456147155,0.07908912530360224,320.88658928871155,149.962486743927,336.0966491699219,12615,2517,10098,10098,0,11,2285000.0
2285,2285999,21.341448280623688,37.422263975534605,0.07915452323396,321.0622138977051,150.02855372428894,336.2135772705078,12619,2519,10100,10100,0,11,2286000.0
2286,2286999,21.34356100151417,37.42260681692521,0.07918926056618802,321.2475893497467,150.09651494026184,336.31216049194336,12625,2521,10104,10104,0,11,2287000.0
2287,2287999,21.343121589678333,37.42063595819277,0.07914163796305751,321.4643602371216,150.16362929344177,336.7686233520508,12657,2524,10133,10133,0,11,2288000.0
2288,2288999,21.339875381248504,37.415486388400865,0.07912943706258557,321.6144185066223,150.22956323623657,337.0801582336426,12664,2525,10139,10139,0,11,2289000.0
2289,2289999,21.33726762440364,37.41097619145432,0.07913891748522828,321.73173809051514,150.29494738578796,337.3298683166504,12666,2525,10141,10141,0,11,2290000.0
2290,2290999,21.33579921061221,37.408523360722924,0.07913643392646375,321.8540074825287,150.36058712005615,337.5188980102539,12668,2525,10143,10143,0,11,2291000.0
2291,2291999,21.3348983781489,37.40819602411022,0.07912732169350878,321.99771904945374,150.42596244812012,337.6491050720215,12671,2526,10145,10145,0,11,2292000.0
2292,2292999,21.334727886973468,37.408282076525275,0.07910202223489426,322.1748569011688,150.49285435676575,337.94945526123047,12683,2528,10155,10155,0,11,2293000.0
2293,2293999,21.333353981255605,37.40489558942079,0.07911829878452492,322.32288694381714,150.55934882164001,338.1492691040039,12690,2529,10161,10161,0,11,2294000.0
2294,2294999,21.333033778268277,37.40373656412463,0.07910254841763031,322.44803500175476,150.62514996528625,338.2940444946289,12690,2529,10161,10161,0,11,2295000.0
2295,2295999,21.333343993497405,37.404049406963594,0.07909359001298344,322.5585443973541,150.6904332637787,338.41484451293945,12691,2529,10162,10162,0,11,2296000.0
2296,2296999,21.333617788395777,37.404439148747464,0.07908494357272566,322.7610194683075,150.7577018737793,338.5137748718262,12701,2532,10169,10169,0,11,2297000.0
2297,2297999,21.334288611105883,37.40503072856538,0.07908030339668948,322.9084630012512,150.82385802268982,338.6435356140137,12704,2533,10171,10171,0,11,2298000.0
2298,2298999,21.335048885494363,37.40451964042432,0.07908865222840111,323.17070412635803,150.89045333862305,338.6905860900879,12719,2538,10181,10181,0,11,2299000.0
2299,2299999,21.33638746294319,37.40474981513871,0.07908736682264417,323.32701230049133,150.95677614212036,338.8486442565918,12722,2539,10183,10183,0,11,2300000.0
2300,2300999,21.338191926687905,37.407803825625656,0.07909373293305844,323.44602632522583,151.0222511291504,338.9798278808594,12722,2539,10183,10183,0,11,2301000.0
2301,2301999,21.339824468558167,37.409007910499454,0.07910414834248869,323.5744626522064,151.08762216567993,339.09539794921875,12723,2539,10184,10184,0,11,2302000.0
2302,2302999,21.34221161805123,37.41250438936154,0.0791285896018935,323.78122639656067,151.15393543243408,339.07954025268555,12730,2542,10188,10188,0,11,2303000.0
2303,2303999,21.344223999235545,37.4141591233062,0.07917124902389927,323.9640910625458,151.2201051712036,339.26207733154297,12740,2544,10196,10196,0,11,2304000.0
2304,2304999,21.34789624817725,37.42448119294396,0.0791081636139187,324.08557391166687,151.28553009033203,339.518741607666,12743,2544,10199,10199,0,11,2305000.0
2305,2305999,21.350539957762905,37.42702801831206,0.07909356998636174,324.23299646377563,151.35101652145386,339.63509368896484,12745,2545,10200,10200,0,11,2306000.0
2306,2306999,21.35359285556029,37.432953874797825,0.07906497415912994,324.41174268722534,151.41849088668823,339.678279876709,12749,2547,10202,10202,0,11,2307000.0
2307,2307999,21.354621848042303,37.4323908275221,0.07904744412200937,324.59233355522156,151.48398065567017,339.7494201660156,12762,2549,10213,10213,0,11,2308000.0
2308,2308999,21.35350724212247,37.43080294159159,0.07901537877658105,324.74686574935913,151.55152535438538,340.39916229248047,12790,2550,10240,10240,0,11,2309000.0
2309,2309999,21.351124799557315,37.42980308700453,0.07898762662585546,324.93023657798767,151.6183202266693,340.6235046386719,12799,2552,10247,10247,0,11,2310000.0
2310,2310999,21.348316809459405,37.42487549196756,0.07900735661662972,325.08309864997864,151.6843764781952,340.90795516967773,12834,2553,10281,10281,0,11,2311000.0
2311,2311999,21.345264504184943,37.419744049814774,0.07903192259312242,325.26789474487305,151.75150442123413,340.9995994567871,12844,2555,10289,10289,0,11,2312000.0
2312,2312999,21.342210862531093,37.4145474663172,0.07905496596146788,325.4243919849396,151.8181176185608,341.24277114868164,12848,2556,10292,10292,0,11,2313000.0
2313,2313999,21.339204846295143,37.40918804658493,0.07907559030923017,325.5448303222656,151.8837673664093,341.4802665710449,12848,2556,10292,10292,0,11,2314000.0
2314,2314999,21.33571815796395,37.40341423778708,0.07910726166177873,325.66520380973816,151.9495952129364,341.6310386657715,12849,2556,10293,10293,0,11,2315000.0
2315,2315999,21.332844070759556,37.398157292425935,0.07913043030741584,325.81428503990173,152.01599669456482,341.7325668334961,12852,2557,10295,10295,0,11,2316000.0
2316,2316999,21.329711671657265,37.39268695449269,0.07915704367883436,325.96500754356384,152.08275890350342,341.85722732543945,12855,2558,10297,10297,0,11,2317000.0
2317,2317999,21.32660276195034,37.38733298201679,0.07917347537379882,326.1539075374603,152.14970564842224,342.0232276916504,12865,2560,10305,10305,0,11,2318000.0
2318,2318999,21.324748532814414,37.38317484684954,0.07915397021458248,326.3834207057953,152.2164924144745,342.0588798522949,12875,2564,10311,10311,0,11,2319000.0
2319,2319999,21.322852492092373,37.3793512440026,0.07914861954956376,326.5759871006012,152.28653573989868,342.1168518066406,12879,2566,10313,10313,0,11,2320000.0
2320,2320999,21.321718496782783,37.37577134413139,0.07913950089423005,326.75631380081177,152.35331344604492,342.19161224365234,12885,2568,10317,10317,0,11,2321000.0
2321,2321999,21.320269649180204,37.372714390166145,0.07912511043308013,326.92342376708984,152.4223279953003,342.25022888183594,12887,2569,10318,10318,0,11,2322000.0
2322,2322999,21.318647169047885,37.36864854019133,0.07912957811265742,327.07285499572754,152.48879265785217,342.42022705078125,12891,2570,10321,10321,0,11,2323000.0
2323,2323999,21.316652367137465,37.36429107767667,0.07913586740481648,327.21595644950867,152.55420851707458,342.6303367614746,12894,2571,10323,10323,0,11,2324000.0
2324,2324999,21.3143273970791,37.35932058452802,0.07916628741714393,327.3983561992645,152.62040901184082,342.69171142578125,12900,2573,10327,10327,0,11,2325000.0
2325,2325999,21.31177320423818,37.3545772423963,0.07918228864703447,327.61375641822815,152.68680000305176,342.7294692993164,12913,2576,10337,10337,0,11,2326000.0
2326,2326999,21.308721658945455,37.35338675556878,0.07919796522210154,327.7314314842224,152.7548952102661,343.4588165283203,12936,2576,10360,10360,0,11,2327000.0
2327,2327999,21.305648833968426,37.35174885527386,0.07922222498024567,327.8505582809448,152.8211271762848,343.72683334350586,12940,2576,10364,10364,0,11,2328000.0
2328,2328999,21.30222784077725,37.34620367674071,0.07927236639406399,327.97154784202576,152.88688802719116,343.9497413635254,12941,2576,10365,10365,0,11,2329000.0
2329,2329999,21.298985607348037,37.34092586529916,0.07930789792079718,328.12829208374023,152.95384621620178,344.1669235229492,12948,2577,10371,10371,0,11,2330000.0
2330,2330999,21.295763234074812,37.335532773078214,0.07934137427095556,328.24210596084595,153.01904582977295,344.4007263183594,12948,2577,10371,10371,0,11,2331000.0
2331,2331999,21.292546689545865,37.33046452712754,0.0793610468130882,328.38859581947327,153.08599209785461,344.4949607849121,12950,2578,10372,10372,0,11,2332000.0
2332,2332999,21.289237743081554,37.32560747026383,0.07938077694983103,328.54082798957825,153.1521337032318,344.60354232788086,12952,2579,10373,10373,0,11,2333000.0
2333,2333999,21.285876543617324,37.32027499589832,0.07940814313226674,328.74335074424744,153.22765183448792,344.66822052001953,12957,2581,10376,10376,0,11,2334000.0
2334,2334999,21.283196161996916,37.31817110660496,0.07940541309969107,328.8911716938019,153.29461026191711,344.8083801269531,12962,2582,10380,10380,0,11,2335000.0
2335,2335999,21.280793563236884,37.31494051666905,0.07940451043943375,329.0421905517578,153.36124801635742,345.02430725097656,12968,2583,10385,10385,0,11,2336000.0
2336,2336999,21.279010260429217,37.31109968449528,0.07939683418577426,329.21517395973206,153.4274070262909,345.13598251342773,12974,2585,10389,10389,0,11,2337000.0
2337,2337999,21.277908165966593,37.31500481359006,0.07935380061464459,329.3355441093445,153.49325394630432,345.3060607910156,12974,2585,10389,10389,0,11,2338000.0
2338,2338999,21.276499007827923,37.31176024116253,0.0793353642279927,329.55350136756897,153.5599229335785,345.33018493652344,12980,2588,10392,10392,0,11,2339000.0
2339,2339999,21.274591174593265,37.307318987591614,0.07933002788653165,329.7077102661133,153.62592387199402,345.427921295166,12982,2589,10393,10393,0,11,2340000.0
2340,2340999,21.273537349878772,37.30483393548943,0.07930746757926677,329.83358693122864,153.69175267219543,345.58027267456055,12983,2589,10394,10394,0,11,2341000.0
2341,2341999,21.27202328931314,37.300677647837205,0.07929285144990816,329.99931836128235,153.7581570148468,345.77303314208984,12990,2590,10400,10400,0,11,2342000.0
2342,2342999,21.271005254303997,37.30257432648835,0.07925708929546194,330.1489288806915,153.82427215576172,345.8927307128906,12992,2591,10401,10401,0,11,2343000.0
2343,2343999,21.269519593556453,37.2986421008334,0.07924655158257399,330.3487641811371,153.89034342765808,345.9770317077637,13001,2594,10407,10407,0,11,2344000.0
2344,2344999,21.267922803171185,37.295008906318316,0.07922781243528387,330.50194358825684,153.95694398880005,346.0653419494629,13003,2595,10408,10408,0,11,2345000.0
2345,2345999,21.26522354644071,37.28949513777323,0.07922504067234315,330.68252635002136,154.02279114723206,346.09696197509766,13007,2597,10410,10410,0,11,2346000.0
2346,2346999,21.26194958329487,37.29007493020238,0.07922479771699176,330.8047070503235,154.08843803405762,346.61498260498047,13015,2597,10418,10418,0,11,2347000.0
2347,2347999,21.257908015977076,37.28479580492152,0.07925225929650204,330.97760939598083,154.1531264781952,346.7246437072754,13029,2599,10430,10430,0,11,2348000.0
2348,2348999,21.253512884208227,37.27830897811621,0.0792930072478385,331.18892216682434,154.21840977668762,346.82281494140625,13063,2602,10461,10461,0,11,2349000.0
2349,2349999,21.249873296197016,37.27325573273239,0.07932950653020121,331.31044697761536,154.28307032585144,347.1771469116211,13063,2602,10461,10461,0,11,2350000.0
2350,2350999,21.245925849340786,37.267383172630296,0.07935502307277942,331.48887181282043,154.34854817390442,347.3482475280762,13068,2604,10464,10464,0,11,2351000.0
2351,2351999,21.24231560622381,37.2621589257381,0.07937557960357355,331.63876724243164,154.4137945175171,347.5591163635254,13070,2605,10465,10465,0,11,2352000.0
2352,2352999,21.238422665257882,37.25610012335573,0.07939645593537414,331.84918308258057,154.48018097877502,347.5668296813965,13077,2608,10469,10469,0,11,2353000.0
2353,2353999,21.234805495198053,37.25094880823704,0.07941446077774394,331.97952699661255,154.54529547691345,347.75911712646484,13077,2608,10469,10469,0,11,2354000.0
2354,2354999,21.231634694847884,37.2462910650298,0.0794320529931567,332.0999758243561,154.61087322235107,347.9391899108887,13079,2608,10471,10471,0,11,2355000.0
2355,2355999,21.228558072738664,37.24135167858066,0.07943692376502043,332.25502586364746,154.6760127544403,348.09332275390625,13083,2609,10474,10474,0,11,2356000.0
2356,2356999,21.22613826555527,37.23716455771877,0.07943703863593676,332.46118426322937,154.7470715045929,348.25820541381836,13089,2611,10478,10478,0,11,2357000.0
2357,2357999,21.22440059937321,37.233526269197306,0.07943137801253342,332.5863244533539,154.81256318092346,348.43360900878906,13090,2611,10479,10479,0,11,2358000.0
2358,2358999,21.223181338276028,37.23134018425319,0.07941354332907136,332.711731672287,154.87769603729248,348.53006744384766,13090,2611,10479,10479,0,11,2359000.0
2359,2359999,21.221834406934374,37.22839532663896,0.07939812817226621,332.86767077445984,154.94221329689026,348.5940818786621,13092,2612,10480,10480,0,11,2360000.0
2360,2360999,21.221118500947757,37.22658091421771,0.07939296352498659,333.01852679252625,155.0081284046173,348.64559173583984,13095,2613,10482,10482,0,11,2361000.0
2361,2361999,21.220767383175698,37.22533053163324,0.0793874877879216,333.16497230529785,155.0735466480255,348.74513244628906,13095,2613,10482,10482,0,11,2362000.0
2362,2362999,21.220359403497625,37.223610210315,0.07938126586720051,333.2848880290985,155.1444239616394,348.97386932373047,13098,2613,10485,10485,0,11,2363000.0
2363,2363999,21.22115025578861,37.22364385810457,0.0793567440985613,333.4468858242035,155.20852398872375,349.05770111083984,13109,2614,10495,10495,0,11,2364000.0
2364,2364999,21.220897169364452,37.22247353274095,0.07934089547258305,333.63376021385193,155.27332091331482,349.0938148498535,13113,2616,10497,10497,0,11,2365000.0
2365,2365999,21.219838454701655,37.21899381997891,0.07932357255586686,333.80386686325073,155.33850479125977,349.15532302856445,13117,2618,10499,10499,0,11,2366000.0
2366,2366999,21.218231705607106,37.216159241979085,0.079303643848883,333.9642324447632,155.4042820930481,349.46413803100586,13131,2619,10512,10512,0,11,2367000.0
2367,2367999,21.214818719534616,37.21080183431225,0.07932691382511947,334.1095745563507,155.4698724746704,349.85803985595703,13144,2620,10524,10524,0,11,2368000.0
2368,2368999,21.211787762099476,37.208747093526874,0.07932865749240936,334.29113817214966,155.5360028743744,350.00382232666016,13151,2622,10529,10529,0,11,2369000.0
2369,2369999,21.208060302365055,37.2026341497528,0.07935259681560214,334.4142789840698,155.60172152519226,350.2303466796875,13154,2622,10532,10532,0,11,2370000.0
2370,2370999,21.20464454277086,37.19744397098509,0.07936899111693985,334.55486583709717,155.66966128349304,350.3976020812988,13155,2622,10533,10533,0,11,2371000.0
2371,2371999,21.201458978659893,37.1926393795071,0.07937592356528966,334.7032039165497,155.73554372787476,350.69256591796875,13162,2623,10539,10539,0,11,2372000.0
2372,2372999,21.198360031754355,37.189695398596236,0.07938268945213145,334.81517910957336,155.80054998397827,350.88681411743164,13163,2623,10540,10540,0,11,2373000.0
2373,2373999,21.195101657320727,37.18410660250681,0.0794010424838324,335.0023760795593,155.86633563041687,351.01101303100586,13168,2625,10543,10543,0,11,2374000.0
2374,2374999,21.191861744786518,37.17871525099661,0.0794203318265474,335.1574101448059,155.93597650527954,351.1404914855957,13171,2626,10545,10545,0,11,2375000.0
2375,2375999,21.18888724010822,37.17347761748441,0.07943118096009238,335.3099751472473,156.0022439956665,351.2115936279297,13175,2627,10548,10548,0,11,2376000.0
2376,2376999,21.185919173732653,37.168434253738106,0.07943961463724392,335.52201080322266,156.06866145133972,351.2386703491211,13190,2630,10560,10560,0,11,2377000.0
2377,2377999,21.184780373514716,37.16543949543612,0.07938813688384694,335.70654702186584,156.13559889793396,351.5096130371094,13200,2632,10568,10568,0,11,2378000.0
2378,2378999,21.183182664555208,37.161944656439246,0.07935474010946131,335.85508728027344,156.20198726654053,351.64941024780273,13202,2633,10569,10569,0,11,2379000.0
2379,2379999,21.182802140310468,37.16062348571005,0.07932014202682791,336.09025049209595,156.26817440986633,351.6608581542969,13213,2637,10576,10576,0,11,2380000.0
2380,2380999,21.18396519999818,37.1682221171335,0.07925966768021353,336.2059679031372,156.33362102508545,351.8555335998535,13214,2637,10577,10577,0,11,2381000.0
2381,2381999,21.185171180235592,37.16992812458449,0.07925673004828471,336.4121515750885,156.3997015953064,351.92383193969727,13221,2640,10581,10581,0,11,2382000.0
2382,2382999,21.186827401176433,37.171939527110574,0.07922961259916639,336.56547570228577,156.46675896644592,352.1564140319824,13230,2641,10589,10589,0,11,2383000.0
2383,2383999,21.189644819335587,37.17624453522584,0.07919270915304277,336.6762614250183,156.53167986869812,352.4626922607422,13234,2641,10593,10593,0,11,2384000.0
2384,2384999,21.191781726942715,37.17773517172765,0.07919056613053033,336.89106035232544,156.59791803359985,352.58714294433594,13243,2644,10599,10599,0,11,2385000.0
2385,2385999,21.193859320684812,37.17926529943044,0.07917036632396846,337.0679020881653,156.66396379470825,352.7268943786621,13247,2646,10601,10601,0,11,2386000.0
2386,2386999,21.194880201982297,37.17875881005311,0.07918828064386363,337.2134177684784,156.73025012016296,352.89437103271484,13258,2647,10611,10611,0,11,2387000.0
2387,2387999,21.19127369109259,37.173445802021234,0.07920990623267343,337.3960473537445,156.7961597442627,353.36015701293945,13273,2649,10624,10624,0,11,2388000.0
2388,2388999,21.18785571019526,37.16885533283524,0.07922237350296168,337.51248240470886,156.86136984825134,353.5441589355469,13273,2649,10624,10624,0,11,2389000.0
2389,2389999,21.18500730450455,37.166324600128675,0.0792262374628745,337.69309282302856,156.92653703689575,353.7100067138672,13288,2651,10637,10637,0,11,2390000.0
2390,2390999,21.18176928139059,37.16204108141111,0.07923560794560103,337.92199087142944,156.9920573234558,353.8888053894043,13303,2655,10648,10648,0,11,2391000.0
2391,2391999,21.179195541236574,37.157446150299904,0.07922238570304097,338.1368908882141,157.05796194076538,354.1118927001953,13317,2658,10659,10659,0,11,2392000.0
2392,2392999,21.17686080700104,37.1525818654848,0.07922084714978217,338.2870650291443,157.12323212623596,354.3498115539551,13320,2659,10661,10661,0,11,2393000.0
2393,2393999,21.17474843908064,37.147922746271156,0.07921182615291622,338.4162302017212,157.18829679489136,354.4986877441406,13320,2659,10661,10661,0,11,2394000.0
2394,2394999,21.172376823913112,37.14286182246718,0.07921390162809616,338.5306580066681,157.25239610671997,354.6079978942871,13320,2659,10661,10661,0,11,2395000.0
2395,2395999,21.170036372479338,37.13870869380912,0.0792146419573927,338.70149850845337,157.32290506362915,354.7251739501953,13324,2660,10664,10664,0,11,2396000.0
2396,2396999,21.167852869671503,37.13550992840542,0.07920544946343644,338.81900811195374,157.38873410224915,354.8932342529297,13327,2660,10667,10667,0,11,2397000.0
2397,2397999,21.16586430266431,37.13097085609626,0.07921058684022764,339.0426535606384,157.45485854148865,355.0823059082031,13343,2663,10680,10680,0,11,2398000.0
2398,2398999,21.16447537214343,37.127673750626684,0.07919764450401923,339.1943562030792,157.52453589439392,355.30028915405273,13346,2664,10682,10682,0,11,2399000.0
2399,2399999,21.163496056190258,37.12543118836036,0.07919337292082507,339.3458459377289,157.58983826637268,355.4229507446289,13358,2665,10693,10693,0,11,2400000.0
2400,2400999,21.16394027146152,37.12537920282907,0.0791688774586069,339.49703454971313,157.65605664253235,355.52587890625,13360,2666,10694,10694,0,11,2401000.0
2401,2401999,21.163936823929017,37.12391096726992,0.0791485102168975,339.61993408203125,157.72129678726196,355.6586494445801,13361,2666,10695,10695,0,11,2402000.0
2402,2402999,21.164303428881635,37.12281830634949,0.07915049902489846,339.7627680301666,157.7864909172058,355.79853439331055,13366,2667,10699,10699,0,11,2403000.0
2403,2403999,21.168273047044877,37.12915896256591,0.07910797076557519,339.92753434181213,157.8519937992096,356.0483589172363,13373,2668,10705,10705,0,11,2404000.0
2404,2404999,21.171821889496545,37.1358509503013,0.07907679971691317,340.11116218566895,157.91734218597412,356.12014389038086,13378,2670,10708,10708,0,11,2405000.0
2405,2405999,21.17520224028579,37.13996549967145,0.07909925973092757,340.35974383354187,157.98435163497925,356.0767593383789,13388,2674,10714,10714,0,11,2406000.0
2406,2406999,21.177843215392116,37.141860611429024,0.07909005927267687,340.5082862377167,158.04955434799194,356.1705513000488,13390,2675,10715,10715,0,11,2407000.0
2407,2407999,21.176928205513228,37.14211694632981,0.0790584821646303,340.68568181991577,158.11577463150024,356.6736297607422,13421,2677,10744,10744,0,11,2408000.0
2408,2408999,21.174329091280672,37.15131228105603,0.07899859177643886,340.8069632053375,158.18209981918335,357.10265350341797,13426,2677,10749,10749,0,11,2409000.0
2409,2409999,21.17134146809436,37.147612221065174,0.07900653771201771,340.9366238117218,158.24757599830627,357.410457611084,13428,2677,10751,10751,0,11,2410000.0
2410,2410999,21.168518230075403,37.143521150684826,0.07902093618528783,341.05070757865906,158.31352066993713,357.59455490112305,13429,2677,10752,10752,0,11,2411000.0
2411,2411999,21.165662752508585,37.139362616300524,0.07902119229154647,341.17385506629944,158.37943363189697,357.82128524780273,13433,2677,10756,10756,0,11,2412000.0
2412,2412999,21.1633362641999,37.13574293823198,0.0790167374123385,341.3312244415283,158.44564819335938,358.0398941040039,13437,2678,10759,10759,0,11,2413000.0
2413,2413999,21.160410228065643,37.13078243283393,0.07902173814988622,341.446790933609,158.51132082939148,358.20067977905273,13437,2678,10759,10759,0,11,2414000.0
2414,2414999,21.158457555243334,37.126889968606434,0.07901642892074101,341.61332297325134,158.57775259017944,358.2967529296875,13439,2679,10760,10760,0,11,2415000.0
2415,2415999,21.156043530299982,37.123139628414656,0.07901493327925357,341.78970861434937,158.64367198944092,358.3470230102539,13444,2681,10763,10763,0,11,2416000.0
2416,2416999,21.153714500263554,37.11891551967388,0.07900778474594905,341.95230078697205,158.7106065750122,358.5009002685547,13463,2682,10781,10781,0,11,2417000.0
2417,2417999,21.152005221047276,37.11601435811655,0.07898685693864926,342.12868094444275,158.77608132362366,358.5506706237793,13470,2684,10786,10786,0,11,2418000.0
2418,2418999,21.150408779900914,37.11235966170228,0.07895200420730575,342.28376293182373,158.84270572662354,358.8381462097168,13480,2685,10795,10795,0,11,2419000.0
2419,2419999,21.15001433851785,37.11161163520267,0.07889972590378536,342.43745017051697,158.90999054908752,359.0091133117676,13482,2686,10796,10796,0,11,2420000.0
2420,2420999,21.149590369999796,37.110065927747314,0.07889736499017685,342.5865399837494,158.97591972351074,359.17716217041016,13492,2687,10805,10805,0,11,2421000.0
2421,2421999,21.150276770326176,37.110947944753974,0.07893843001347989,342.77263355255127,159.04224348068237,359.3230743408203,13506,2689,10817,10817,0,11,2422000.0
2422,2422999,21.150715840814513,37.112067307465466,0.07898639208736391,342.92038226127625,159.10819697380066,359.41711044311523,13509,2690,10819,10819,0,11,2423000.0
2423,2423999,21.153066594799167,37.11563192297142,0.07900155694507105,343.07192754745483,159.1737105846405,359.5483589172363,13519,2691,10828,10828,0,11,2424000.0
2424,2424999,21.155851206318793,37.120074048252036,0.07900291161008344,343.1897482872009,159.23997712135315,359.8318557739258,13522,2691,10831,10831,0,11,2425000.0
2425,2425999,21.158667382525653,37.12511360822664,0.07901859690530078,343.4172728061676,159.3056993484497,359.8880271911621,13532,2695,10837,10837,0,11,2426000.0
2426,2426999,21.159940783034028,37.125927463571074,0.07902032625039224,343.6052930355072,159.37119817733765,359.9108009338379,13536,2697,10839,10839,0,11,2427000.0
2427,2427999,21.161606485080725,37.129744237724566,0.07902376107359532,343.7513608932495,159.43679237365723,360.09580993652344,13538,2698,10840,10840,0,11,2428000.0
2428,2428999,21.16045356880218,37.12852789269477,0.0789781731397996,343.8865909576416,159.5034625530243,360.7997283935547,13565,2698,10867,10867,0,11,2429000.0
2429,2429999,21.15814354834534,37.127760634223236,0.07896042955824956,344.00139236450195,159.56927609443665,361.08660888671875,13566,2698,10868,10868,0,11,2430000.0
2430,2430999,21.156202997360865,37.12571203876714,0.07893350655753106,344.12614250183105,159.63542294502258,361.2873191833496,13568,2698,10870,10870,0,11,2431000.0
2431,2431999,21.153394310329958,37.121723223703896,0.0789308806085014,344.2463393211365,159.70051383972168,361.4408149719238,13569,2698,10871,10871,0,11,2432000.0
2432,2432999,21.15073268894465,37.11791652474885,0.07892409422138824,344.40752816200256,159.76607584953308,361.5442085266113,13571,2699,10872,10872,0,11,2433000.0
2433,2433999,21.149314843151206,37.116827839772625,0.07889018742433151,344.5537564754486,159.83156371116638,361.8191337585449,13577,2700,10877,10877,0,11,2434000.0
2434,2434999,21.14737243248676,37.11484003363332,0.07886645850582152,344.7194344997406,159.89740633964539,361.9222602844238,13579,2701,10878,10878,0,11,2435000.0
2435,2435999,21.14541028604004,37.111055340371884,0.07884480302229202,344.8305525779724,159.96268272399902,362.07923126220703,13580,2701,10879,10879,0,11,2436000.0
2436,2436999,21.143401923426158,37.10683502642032,0.0788308088004479,344.9525182247162,160.02780723571777,362.20362091064453,13581,2701,10880,10880,0,11,2437000.0
2437,2437999,21.1412916629243,37.102657436088556,0.07882229176273081,345.14630246162415,160.0932765007019,362.23645782470703,13586,2703,10883,10883,0,11,2438000.0
2438,2438999,21.139371970464975,37.098847607382915,0.07880736576618319,345.3040454387665,160.15893077850342,362.3321075439453,13589,2704,10885,10885,0,11,2439000.0
2439,2439999,21.13810431886862,37.09546676267449,0.0787773006310617,345.4529392719269,160.22401762008667,362.5071105957031,13594,2705,10889,10889,0,11,2440000.0
2440,2440999,21.13690715892717,37.092787804256254,0.07875146686376633,345.5675983428955,160.2902684211731,362.6695365905762,13595,2705,10890,10890,0,11,2441000.0
2441,2441999,21.136091269397504,37.09054490635504,0.07873042287739695,345.72212624549866,160.35546398162842,362.7262306213379,13597,2706,10891,10891,0,11,2442000.0
2442,2442999,21.134775505988692,37.08667143308032,0.0787143552901386,345.8422009944916,160.42065262794495,362.8444023132324,13598,2706,10892,10892,0,11,2443000.0
2443,2443999,21.134350270853027,37.084289083464405,0.07869430297743074,346.0643560886383,160.48644709587097,362.8086471557617,13606,2709,10897,10897,0,11,2444000.0
2444,2444999,21.133795340522376,37.08125551780335,0.07867205296451663,346.22171545028687,160.55262351036072,363.0078430175781,13614,2710,10904,10904,0,11,2445000.0
2445,2445999,21.133701633038676,37.07891493665981,0.07864179423653184,346.34488344192505,160.61740469932556,363.2434539794922,13616,2710,10906,10906,0,11,2446000.0
2446,2446999,21.13325670234658,37.07625699071535,0.07861792731864481,346.53551745414734,160.68332409858704,363.33282470703125,13620,2712,10908,10908,0,11,2447000.0
2447,2447999,21.133152191987755,37.07349689296014,0.07858992539295995,346.71869349479675,160.7490532398224,363.3953285217285,13634,2714,10920,10920,0,11,2448000.0
2448,2448999,21.13300537206822,37.07366385289261,0.0785488044764655,346.84327960014343,160.81407690048218,363.50506591796875,13634,2714,10920,10920,0,11,2449000.0
2449,2449999,21.131624250760154,37.07421327298475,0.07852617409575013,346.9642322063446,160.8802592754364,364.2549476623535,13667,2714,10953,10953,0,11,2450000.0
2450,2450999,21.129353431254707,37.070787987555,0.07850872316339552,347.08177042007446,160.94591665267944,364.59071350097656,13671,2714,10957,10957,0,11,2451000.0
2451,2451999,21.127257327471956,37.06711908980258,0.07851425820403701,347.219575881958,161.01205015182495,364.85948944091797,13676,2714,10962,10962,0,11,2452000.0
2452,2452999,21.125178669361702,37.06369575402303,0.07850710188819043,347.33919954299927,161.07755732536316,365.02954864501953,13677,2714,10963,10963,0,11,2453000.0
2453,2453999,21.123614550123456,37.06151961242361,0.07849544562919875,347.51627922058105,161.14340662956238,365.2259407043457,13683,2716,10967,10967,0,11,2454000.0
2454,2454999,21.122352590763196,37.06028854907391,0.07849993074474515,347.66339087486267,161.20881533622742,365.33666610717773,13691,2717,10974,10974,0,11,2455000.0
2455,2455999,21.120773830085987,37.05667022583843,0.07850410273393649,347.7834429740906,161.27430653572083,365.53096771240234,13691,2717,10974,10974,0,11,2456000.0
2456,2456999,21.119270370521534,37.054811326070194,0.078511635632461,347.9653375148773,161.33998918533325,365.60606384277344,13696,2719,10977,10977,0,11,2457000.0
2457,2457999,21.11763661176446,37.05174048371503,0.07852181014737603,348.1264181137085,161.4057855606079,365.7709770202637,13702,2720,10982,10982,0,11,2458000.0
2458,2458999,21.115834382573247,37.04790632153914,0.07851778974804147,348.25091648101807,161.47130799293518,365.97118377685547,13705,2720,10985,10985,0,11,2459000.0
2459,2459999,21.11510796740976,37.045595739134406,0.0785091325023135,348.47562623023987,161.5376012325287,366.00643157958984,13712,2723,10989,10989,0,11,2460000.0
2460,2460999,21.114484469595048,37.04755582180473,0.0784761597383643,348.6249523162842,161.60350823402405,366.1148109436035,13714,2724,10990,10990,0,11,2461000.0
2461,2461999,21.11420713893966,37.04578531462345,0.0784733967647313,348.7764005661011,161.66933703422546,366.1920967102051,13718,2725,10993,10993,0,11,2462000.0
2462,2462999,21.11357806317391,37.04252235236744,0.07846512052953414,348.96501111984253,161.73557305335999,366.2789306640625,13722,2727,10995,10995,0,11,2463000.0
2463,2463999,21.113013735026403,37.039558974553145,0.07845266937532658,349.12331438064575,161.80182814598083,366.4267463684082,13726,2728,10998,10998,0,11,2464000.0
2464,2464999,21.112955115475522,37.037498643177635,0.07841617397206757,349.27280735969543,161.8674874305725,366.6327705383301,13729,2729,11000,11000,0,11,2465000.0
2465,2465999,21.111894039425955,37.033891417218925,0.0783900117326326,349.4499626159668,161.9343421459198,366.71241760253906,13733,2731,11002,11002,0,11,2466000.0
2466,2466999,21.111008772872303,37.03037892547824,0.0783613935401185,349.60818433761597,161.99931383132935,366.78016662597656,13738,2732,11006,11006,0,11,2467000.0
2467,2467999,21.109394866337677,37.03029547222524,0.07833787768137668,349.74175333976746,162.07413458824158,367.5221633911133,13766,2732,11034,11034,0,11,2468000.0
2468,2468999,21.107515058910394,37.028883397430484,0.07832551813680333,349.8690114021301,162.14010071754456,367.8083267211914,13770,2732,11038,11038,0,11,2469000.0
2469,2469999,21.105753868836747,37.02732945553995,0.07830330044448264,350.02469086647034,162.20569825172424,367.97764587402344,13773,2733,11040,11040,0,11,2470000.0
2470,2470999,21.10409797966999,37.02491106892161,0.07828801176223232,350.1500151157379,162.2720911502838,368.3186569213867,13781,2733,11048,11048,0,11,2471000.0
2471,2471999,21.103052384636925,37.02267618334787,0.07826863748709811,350.29519033432007,162.33847284317017,368.5493507385254,13783,2734,11049,11049,0,11,2472000.0
2472,2472999,21.100960858657366,37.018451987761786,0.07827326719104932,350.4125852584839,162.40364861488342,368.7134704589844,13783,2734,11049,11049,0,11,2473000.0
2473,2473999,21.10023632924601,37.01734146525896,0.07827374797811171,350.59398198127747,162.46936774253845,368.75878143310547,13789,2736,11053,11053,0,11,2474000.0
2474,2474999,21.09847394766002,37.014024316833954,0.07827915753200976,350.74843287467957,162.5355305671692,368.92615127563477,13793,2737,11056,11056,0,11,2475000.0
2475,2475999,21.097604498534185,37.01954902256121,0.07823569049647328,350.9289515018463,162.60175561904907,369.0399742126465,13802,2739,11063,11063,0,11,2476000.0
2476,2476999,21.09692261251182,37.017550449066526,0.07820724436001114,351.11860966682434,162.66908025741577,369.3152847290039,13816,2741,11075,11075,0,11,2477000.0
2477,2477999,21.097333849393912,37.02000496219948,0.07817492690634331,351.26692366600037,162.7359426021576,369.5041732788086,13818,2742,11076,11076,0,11,2478000.0
2478,2478999,21.097565463342935,37.01838955814508,0.07816639378529766,351.4148368835449,162.8016037940979,369.6422882080078,13821,2743,11078,11078,0,11,2479000.0
2479,2479999,21.098629860456075,37.018412226448135,0.07815707389591042,351.6297061443329,162.86892199516296,369.70073318481445,13827,2746,11081,11081,0,11,2480000.0
2480,2480999,21.099464390930027,37.017692539260565,0.07816091685860205,351.7649042606354,162.93672800064087,369.90877532958984,13828,2746,11082,11082,0,11,2481000.0
2481,2481999,21.1015609890319,37.019345343452756,0.07814958438399244,351.91229128837585,163.00274443626404,369.99345779418945,13831,2747,11084,11084,0,11,2482000.0
2482,2482999,21.104048344788726,37.02716216371284,0.0780976836188142,352.0688536167145,163.0686867237091,370.2693634033203,13841,2748,11093,11093,0,11,2483000.0
2483,2483999,21.106605730301816,37.029831936556185,0.07808126398320459,352.18046832084656,163.1350383758545,370.478214263916,13842,2748,11094,11094,0,11,2484000.0
2484,2484999,21.108372296741145,37.029433809497235,0.07807424735899071,352.39539885520935,163.2016158103943,370.5259590148926,13850,2751,11099,11099,0,11,2485000.0
2485,2485999,21.110360337630922,37.032118584574974,0.0780636758277573,352.5809717178345,163.26797223091125,370.6537742614746,13860,2753,11107,11107,0,11,2486000.0
2486,2486999,21.110231550257858,37.02928748737594,0.07806286380269589,352.73646235466003,163.33369660377502,370.85052490234375,13865,2754,11111,11111,0,11,2487000.0
2487,2487999,21.10825806137263,37.027548089224105,0.07803164941256158,352.90744614601135,163.40919661521912,371.29993438720703,13877,2755,11122,11122,0,11,2488000.0
2488,2488999,21.106128712715723,37.02597578502326,0.07802356715303493,353.020220041275,163.47339391708374,371.4831657409668,13877,2755,11122,11122,0,11,2489000.0
2489,2489999,21.104376021349445,37.024107525145,0.0780162947055103,353.1522014141083,163.53824138641357,371.67270278930664,13881,2755,11126,11126,0,11,2490000.0
2490,2490999,21.103058259798402,37.02289063737875,0.07800190583608746,353.2935574054718,163.6026487350464,371.7846908569336,13884,2756,11128,11128,0,11,2491000.0
2491,2491999,21.10107629456207,37.02155123366429,0.07799080917007362,353.45672249794006,163.66885805130005,371.93103408813477,13887,2757,11130,11130,0,11,2492000.0
2492,2492999,21.099343583668745,37.01878719608449,0.07798103349255348,353.61233139038086,163.73303127288818,372.0047035217285,13889,2758,11131,11131,0,11,2493000.0
2493,2493999,21.097530177098943,37.01604040530959,0.0779713502311209,353.7754740715027,163.79764580726624,372.1057319641113,13894,2759,11135,11135,0,11,2494000.0
2494,2494999,21.095531652684716,37.012314710923356,0.07796668194912848,353.8834581375122,163.8616886138916,372.23472595214844,13894,2759,11135,11135,0,11,2495000.0
2495,2495999,21.094083072016485,37.011474426637896,0.07795341573559078,354.0373606681824,163.92654252052307,372.29137802124023,13897,2760,11137,11137,0,11,2496000.0
2496,2496999,21.091828406434004,37.00653856626263,0.07795434851890215,354.1710305213928,163.9910545349121,372.4513626098633,13900,2760,11140,11140,0,11,2497000.0
2497,2497999,21.090475479128354,37.007542748030616,0.07792514013208696,354.393940448761,164.0559048652649,372.5100402832031,13910,2763,11147,11147,0,11,2498000.0
2498,2498999,21.089214653923307,37.00435530380854,0.07791868987384432,354.61399841308594,164.12098169326782,372.5456428527832,13916,2766,11150,11150,0,11,2499000.0
2499,2499999,21.087806102733094,37.000529433509705,0.07791581795920455,354.7549424171448,164.18620657920837,372.7035102844238,13928,2767,11161,11161,0,11,2500000.0
2500,2500999,21.086981524586545,36.99900633385183,0.07790367794913422,354.91761231422424,164.2510814666748,372.8243103027344,13930,2768,11162,11162,0,11,2501000.0
2501,2501999,21.085702568739475,36.99514782962407,0.07789733301546309,355.0495455265045,164.31716322898865,372.9360237121582,13931,2768,11163,11163,0,11,2502000.0
2502,2502999,21.084660500070722,36.991541903990836,0.07788643278554619,355.16135907173157,164.38125729560852,373.0230522155762,13931,2768,11163,11163,0,11,2503000.0
2503,2503999,21.084116943562393,36.98835793847622,0.077867875204651,355.31381464004517,164.4457974433899,373.161678314209,13938,2769,11169,11169,0,11,2504000.0
2504,2504999,21.08312879237471,36.98434151763364,0.07785895826727407,355.47189259529114,164.5108790397644,373.33069229125977,13940,2770,11170,11170,0,11,2505000.0
2505,2505999,21.081963581525002,36.98055401945367,0.0778525360482425,355.6614532470703,164.5756368637085,373.4285469055176,13944,2772,11172,11172,0,11,2506000.0
2506,2506999,21.08088080058824,36.976556884501825,0.07785066313124434,355.8154978752136,164.64057755470276,373.48812103271484,13946,2773,11173,11173,0,11,2507000.0
2507,2507999,21.078876676699437,36.97264210577982,0.07782932333714165,355.96936893463135,164.7056028842926,373.7502899169922,13961,2774,11187,11187,0,11,2508000.0
2508,2508999,21.075429809166614,36.96701169051275,0.07784098113690618,356.0917937755585,164.77074098587036,374.075927734375,13968,2774,11194,11194,0,11,2509000.0
2509,2509999,21.072669400392364,36.963374756477705,0.07785433313586598,356.21803760528564,164.8365511894226,374.18970108032227,13968,2774,11194,11194,0,11,2510000.0
2510,2510999,21.06969268181856,36.95923874620788,0.07788115878447832,356.3476583957672,164.90175318717957,374.31930923461914,13970,2774,11196,11196,0,11,2511000.0
2511,2511999,21.0671637760672,36.958631727442956,0.07789188453693807,356.53968954086304,164.96770238876343,374.3874702453613,13975,2776,11199,11199,0,11,2512000.0
2512,2512999,21.063494591133107,36.95331211510008,0.07792464147719214,356.6609237194061,165.0335693359375,374.6802673339844,13980,2776,11204,11204,0,11,2513000.0
2513,2513999,21.060402026623322,36.94910279434658,0.0779582358429507,356.7750527858734,165.09777569770813,374.8536682128906,13981,2776,11205,11205,0,11,2514000.0
2514,2514999,21.05655622749442,36.943445758023515,0.07798875786659332,356.9355044364929,165.16335201263428,374.93764877319336,13983,2777,11206,11206,0,11,2515000.0
2515,2515999,21.053004620061454,36.939623987596335,0.07801262716904112,357.0803289413452,165.2293405532837,375.03931427001953,13986,2778,11208,11208,0,11,2516000.0
2516,2516999,21.049656639410394,36.93419210278053,0.07803629517913535,357.2062678337097,165.2948887348175,375.1781883239746,13988,2778,11210,11210,0,11,2517000.0
2517,2517999,21.046836590199444,36.92953155328239,0.07806135947101267,357.40422201156616,165.36090731620789,375.2035217285156,13994,2780,11214,11214,0,11,2518000.0
2518,2518999,21.044197689211835,36.92543671034823,0.078070771462316,357.55906438827515,165.4270486831665,375.47998809814453,14001,2781,11220,11220,0,11,2519000.0
2519,2519999,21.041600637484276,36.92038026111481,0.07808424232375655,357.7065269947052,165.49197793006897,375.6076965332031,14005,2782,11223,11223,0,11,2520000.0
2520,2520999,21.038815709804023,36.91515837408187,0.07809603557749445,357.8887243270874,165.55758261680603,375.6863098144531,14009,2784,11225,11225,0,11,2521000.0
2521,2521999,21.036139130918052,36.910609520018404,0.07810782410031503,358.0043354034424,165.62263822555542,375.8678894042969,14010,2784,11226,11226,0,11,2522000.0
2522,2522999,21.03358777213948,36.906289942988245,0.07812076513625876,358.12126898765564,165.68788838386536,376.0181007385254,14012,2784,11228,11228,0,11,2523000.0
2523,2523999,21.03172097465487,36.902792713742244,0.0781279218579295,358.3125970363617,165.75392699241638,376.049129486084,14017,2786,11231,11231,0,11,2524000.0
2524,2524999,21.03010067369521,36.8987454939014,0.07813032600342107,358.50106978416443,167.10814142227173,376.3505859375,14031,2788,11243,11243,0,11,2525000.0
2525,2525999,21.02840926603099,36.89485439429959,0.07812549952297021,358.7210865020752,167.17442631721497,376.446475982666,14038,2791,11247,11247,0,11,2526000.0
2526,2526999,21.02632066282069,36.89047958249732,0.07813024479220265,358.87433195114136,167.24021244049072,376.5913619995117,14040,2792,11248,11248,0,11,2527000.0
2527,2527999,21.02420955146773,36.886335336945216,0.07813424928813051,359.03336453437805,167.30650758743286,376.72394943237305,14042,2793,11249,11249,0,11,2528000.0
2528,2528999,21.021011727378056,36.881631744030734,0.07815522146648424,359.18680143356323,167.3727605342865,377.17603302001953,14058,2794,11264,11264,0,11,2529000.0
2529,2529999,21.01743551579656,36.87806739103392,0.07817476837841586,359.3015384674072,167.4397075176239,377.41154861450195,14059,2794,11265,11265,0,11,2530000.0
2530,2530999,21.014078204630056,36.87343824278471,0.0781969359982323,359.45368695259094,167.50482034683228,377.5815010070801,14065,2795,11270,11270,0,11,2531000.0
2531,2531999,21.01126755715501,36.87269244451256,0.07819673833519736,359.67880511283875,167.57085990905762,377.6938591003418,14076,2798,11278,11278,0,11,2532000.0
2532,2532999,21.007797570206495,36.86816697267952,0.07821120307687224,359.9018692970276,167.63725781440735,377.8311309814453,14084,2801,11283,11283,0,11,2533000.0
2533,2533999,21.005500020082106,36.864462607735476,0.0782278757170306,360.05339217185974,167.70501279830933,378.08055114746094,14087,2802,11285,11285,0,11,2534000.0
2534,2534999,21.00260672899348,36.85945854337498,0.07824979478781646,360.17663502693176,167.77023935317993,378.22730255126953,14087,2802,11285,11285,0,11,2535000.0
2535,2535999,20.999536111956704,36.85448444842868,0.07826495051484517,360.3111469745636,167.83527207374573,378.35330963134766,14087,2802,11285,11285,0,11,2536000.0
2536,2536999,20.997051286623453,36.85061392692583,0.07827769595298584,360.4607253074646,167.90087223052979,378.4400405883789,14090,2803,11287,11287,0,11,2537000.0
2537,2537999,20.994151667952686,36.84536418419787,0.07829803894857157,360.66012501716614,167.9670708179474,378.5178909301758,14101,2805,11296,11296,0,11,2538000.0
2538,2538999,20.991941020099965,36.841499458402666,0.07829198929718262,360.81801176071167,168.03457593917847,378.7784538269043,14108,2806,11302,11302,0,11,2539000.0
2539,2539999,20.989642589987163,36.83673632882878,0.07829817067350842,361.00625467300415,168.1005244255066,378.88037109375,14119,2808,11311,11311,0,11,2540000.0
2540,2540999,20.987681428070697,36.83266635098306,0.07829875947663956,361.13991260528564,168.1664593219757,379.1688995361328,14119,2808,11311,11311,0,11,2541000.0
2541,2541999,20.985991230692655,36.82950205389288,0.07829177100043794,361.26832580566406,168.23190832138062,379.3346061706543,14120,2808,11312,11312,0,11,2542000.0
2542,2542999,20.985731396576533,36.83201494892374,0.07829586980464098,361.43157601356506,168.2978630065918,379.4375991821289,14124,2809,11315,11315,0,11,2543000.0
2543,2543999,20.985959301991592,36.831524977410545,0.07834378290385868,361.5901618003845,168.3636486530304,379.57783126831055,14131,2810,11321,11321,0,11,2544000.0
2544,2544999,20.98637964029705,36.831464256845365,0.07837326261928201,361.7404770851135,168.4296588897705,379.8155288696289,14138,2811,11327,11327,0,11,2545000.0
2545,2545999,20.988019507033776,36.83509887217536,0.07837774334427439,361.90211749076843,168.49749779701233,379.9612693786621,14140,2812,11328,11328,0,11,2546000.0
2546,2546999,20.98917298630885,36.835285709579644,0.07841299628840903,362.095431804657,168.56327414512634,380.0732078552246,14144,2814,11330,11330,0,11,2547000.0
2547,2547999,20.988799435359283,36.832306045939774,0.07843374600412467,362.25084400177,168.6292233467102,380.15707778930664,14147,2815,11332,11332,0,11,2548000.0
2548,2548999,20.98773228199288,36.829430222181685,0.07843944475970832,362.4173758029938,168.69493985176086,380.36159896850586,14153,2816,11337,11337,0,11,2549000.0
2549,2549999,20.984761270034905,36.826533026609106,0.07844977393801067,362.5521092414856,168.7660596370697,381.0715980529785,14179,2816,11363,11363,0,11,2550000.0
2550,2550999,20.982366213114627,36.82383932744204,0.07845570617172337,362.6743860244751,168.8315930366516,381.2732849121094,14179,2816,11363,11363,0,11,2551000.0
2551,2551999,20.97939808391729,36.81906490726039,0.07847914488721142,362.83284640312195,168.8975179195404,381.4233512878418,14188,2817,11371,11371,0,11,2552000.0
2552,2552999,20.976617898389463,36.81444580670923,0.07848902069528374,362.95392632484436,168.9630892276764,381.66674423217773,14189,2817,11372,11372,0,11,2553000.0
2553,2553999,20.975047358417772,36.81283346528302,0.07847164009556162,363.21101450920105,169.03026461601257,381.7152633666992,14200,2821,11379,11379,0,11,2554000.0
2554,2554999,20.973252225765854,36.80948565393156,0.07847266486761895,363.32165360450745,169.09536504745483,381.9278335571289,14200,2821,11379,11379,0,11,2555000.0
2555,2555999,20.97186396449425,36.80894534941377,0.07845410734303926,363.4827301502228,169.1613254547119,382.0420684814453,14202,2822,11380,11380,0,11,2556000.0
2556,2556999,20.970877633486793,36.81489179655183,0.07841428790017557,363.6745994091034,169.22828364372253,382.0913772583008,14206,2824,11382,11382,0,11,2557000.0
2557,2557999,20.97009113734797,36.81362402463183,0.07841944031017156,363.86946153640747,169.2949092388153,382.1755905151367,14212,2826,11386,11386,0,11,2558000.0
2558,2558999,20.968964088878415,36.81145365255108,0.07840908983188288,363.99262857437134,169.36037516593933,382.38370513916016,14216,2826,11390,11390,0,11,2559000.0
2559,2559999,20.969321353576444,36.81235199014543,0.07839378035789879,364.2246723175049,169.42750310897827,382.6203269958496,14234,2829,11405,11405,0,11,2560000.0
2560,2560999,20.969577542447237,36.81125394032438,0.07840813615674103,364.38256192207336,169.49436616897583,382.7770576477051,14237,2830,11407,11407,0,11,2561000.0
2561,2561999,20.97077363679834,36.813117141358795,0.07842447820082732,364.5091452598572,169.5601463317871,382.9468116760254,14237,2830,11407,11407,0,11,2562000.0
2562,2562999,20.97259823472965,36.81677612777643,0.0784999568674275,364.7023491859436,169.62604904174805,383.0418510437012,14250,2832,11418,11418,0,11,2563000.0
2563,2563999,20.97460260650525,36.81858897440289,0.07853965187023504,364.8596074581146,169.69193696975708,383.1399688720703,14253,2833,11420,11420,0,11,2564000.0
2564,2564999,20.977048440353457,36.821782030998264,0.07865794500812573,365.0047564506531,169.757497549057,383.24291229248047,14256,2834,11422,11422,0,11,2565000.0
2565,2565999,20.981421974879233,36.82754017564439,0.07868504737111892,365.2274806499481,169.824524641037,383.3923530578613,14283,2837,11446,11446,0,11,2566000.0
2566,2566999,20.9866055427967,36.83440668129891,0.07884040400739656,365.48675751686096,169.89049077033997,383.4599304199219,14293,2841,11452,11452,0,11,2567000.0
2567,2567999,20.990362340981207,36.8409391235436,0.07893083872588169,365.6308205127716,169.95579767227173,383.5948371887207,14295,2842,11453,11453,0,11,2568000.0
2568,2568999,20.99538060095243,36.84668493712646,0.07912207052108,365.8198595046997,170.0213680267334,383.74218368530273,14299,2844,11455,11455,0,11,2569000.0
2569,2569999,20.996835593727738,36.85142647181057,0.0791485980779536,365.94509983062744,170.08749771118164,384.41724014282227,14326,2844,11482,11482,0,11,2570000.0
2570,2570999,20.99405978553898,36.848051777366,0.07914469851129702,366.1288266181946,170.1542661190033,384.6611137390137,14335,2846,11489,11489,0,11,2571000.0
2571,2571999,20.99136354473034,36.84526820300376,0.07914719900817868,366.24579882621765,170.2198407649994,384.91301345825195,14336,2846,11490,11490,0,11,2572000.0
2572,2572999,20.98963646185864,36.8457809756766,0.07912209242821189,366.3751084804535,170.29649877548218,385.1215171813965,14339,2846,11493,11493,0,11,2573000.0
2573,2573999,20.987632584598757,36.8424630801803,0.07911909587690424,366.5046513080597,170.36222982406616,385.28490447998047,14339,2846,11493,11493,0,11,2574000.0
2574,2574999,20.98595492515778,36.83964396035534,0.07910947519220035,366.72212529182434,170.42930626869202,385.4895324707031,14349,2849,11500,11500,0,11,2575000.0
2575,2575999,20.984332581809443,36.83646101663751,0.0791037358644886,366.8459458351135,170.49521374702454,385.660343170166,14349,2849,11500,11500,0,11,2576000.0
2576,2576999,20.982830355264984,36.832981692766076,0.0790948633881563,366.95939564704895,170.5605010986328,385.80797576904297,14350,2849,11501,11501,0,11,2577000.0
2577,2577999,20.98187342299155,36.830158529205555,0.0790871186848946,367.08565282821655,170.626140832901,385.92296600341797,14351,2849,11502,11502,0,11,2578000.0
2578,2578999,20.981064276642364,36.82889806890602,0.07907160516344247,367.22963762283325,170.70394730567932,386.0447654724121,14352,2849,11503,11503,0,11,2579000.0
2579,2579999,20.979649122352807,36.82559408943567,0.07906926475949083,367.35503029823303,170.7690839767456,386.1534729003906,14353,2849,11504,11504,0,11,2580000.0
2580,2580999,20.979609440997468,36.82418651601464,0.07906169550982678,367.50771927833557,170.83461737632751,386.3294258117676,14358,2850,11508,11508,0,11,2581000.0
2581,2581999,20.97986992852646,36.823109617718316,0.0790506187366724,367.70562386512756,170.90072989463806,386.3812828063965,14363,2852,11511,11511,0,11,2582000.0
2582,2582999,20.980362168975837,36.82273372168812,0.07903250359716407,367.84972643852234,170.96594095230103,386.4503936767578,14365,2853,11512,11512,0,11,2583000.0
2583,2583999,20.981054621347965,36.82323856948333,0.07902386769252745,367.97375202178955,171.03132247924805,386.5681343078613,14366,2853,11513,11513,0,11,2584000.0
2584,2584999,20.982213553115177,36.823931785677715,0.07901596279030398,368.1334397792816,171.09755110740662,386.61414337158203,14369,2854,11515,11515,0,11,2585000.0
2585,2585999,20.983386925441796,36.8240249018746,0.0790074874001927,368.3712115287781,171.16375374794006,386.58128356933594,14378,2857,11521,11521,0,11,2586000.0
2586,2586999,20.985938178932894,36.82582902038379,0.07896455836713934,368.52698588371277,171.22975492477417,386.9561462402344,14389,2858,11531,11531,0,11,2587000.0
2587,2587999,20.987920687554755,36.826964934819586,0.07893531902082063,368.71066308021545,171.29545187950134,387.07067108154297,14395,2860,11535,11535,0,11,2588000.0
2588,2588999,20.990717788623563,36.829576127443296,0.0789067665917842,368.8735032081604,171.36135721206665,387.1709747314453,14406,2861,11545,11545,0,11,2589000.0
2589,2589999,20.994043363734818,36.834941531147926,0.07887287952886324,369.05579686164856,171.42707204818726,387.2629737854004,14410,2863,11547,11547,0,11,2590000.0
2590,2590999,20.993617275145667,36.83305086071356,0.07886151390002394,369.17590284347534,171.49415802955627,387.9234733581543,14439,2863,11576,11576,0,11,2591000.0
2591,2591999,20.990968859241487,36.83064062526409,0.07886290644897609,369.3970296382904,171.56173300743103,388.1399383544922,14454,2866,11588,11588,0,11,2592000.0
2592,2592999,20.988349058443127,36.827717794287395,0.07887539482922457,369.5183255672455,171.62829208374023,388.4391403198242,14458,2866,11592,11592,0,11,2593000.0
2593,2593999,20.98554398505647,36.82315093307726,0.0788958248544438,369.63967299461365,171.69398832321167,388.64487075805664,14460,2866,11594,11594,0,11,2594000.0
2594,2594999,20.982635939589407,36.81823234891797,0.07891800838507557,369.75575399398804,171.7609429359436,388.9312629699707,14463,2866,11597,11597,0,11,2595000.0
2595,2595999,20.98009996363469,36.813772383823476,0.07893193766362261,369.9029929637909,171.82717537879944,389.1057548522949,14468,2867,11601,11601,0,11,2596000.0
2596,2596999,20.977184533892697,36.808836049936296,0.07894561266632016,370.04959988594055,171.89344310760498,389.28659439086914,14477,2868,11609,11609,0,11,2597000.0
2597,2597999,20.974500496849956,36.804595659768694,0.07895705064230074,370.18288350105286,171.96070003509521,389.47314453125,14478,2868,11610,11610,0,11,2598000.0
2598,2598999,20.97225563952371,36.80077596193502,0.07896808486319629,370.3701362609863,172.02812886238098,389.6154022216797,14486,2870,11616,11616,0,11,2599000.0
2599,2599999,20.96973294347738,36.796144074016176,0.07898446275640314,370.5886218547821,172.09530091285706,389.634033203125,14494,2873,11621,11621,0,11,2600000.0
2600,2600999,20.96815714013327,36.79312284391822,0.07897598024457331,370.7996072769165,172.162113904953,389.89443588256836,14504,2876,11628,11628,0,11,2601000.0
2601,2601999,20.966683646143004,36.789781691902995,0.07898287038052565,370.95535945892334,172.22935390472412,390.13329696655273,14515,2877,11638,11638,0,11,2602000.0
2602,2602999,20.965676180429625,36.78758402258698,0.07897796575570548,371.1348476409912,172.29699277877808,390.2643165588379,14539,2879,11660,11660,0,11,2603000.0
2603,2603999,20.964709858704328,36.78487775528327,0.07898425090805972,371.31551909446716,172.36356449127197,390.35583877563477,14545,2881,11664,11664,0,11,2604000.0
2604,2604999,20.964776667314887,36.78344565158415,0.07897514232524894,371.5085713863373,172.43058514595032,390.4551010131836,14549,2883,11666,11666,0,11,2605000.0
2605,2605999,20.965436173062045,36.783084170467546,0.07895754924753662,371.6671578884125,172.4973645210266,390.7745475769043,14555,2884,11671,11671,0,11,2606000.0
2606,2606999,20.965389029997358,36.782142818878945,0.0789488547466376,371.9135191440582,172.56507563591003,390.8178024291992,14563,2888,11675,11675,0,11,2607000.0
2607,2607999,20.965861565864678,36.78067535089112,0.07895550187111045,372.05879974365234,172.63082432746887,390.9663543701172,14565,2889,11676,11676,0,11,2608000.0
2608,2608999,20.963277220459247,36.77674689206792,0.07897373662864227,372.2233898639679,172.69770121574402,391.61302947998047,14595,2890,11705,11705,0,11,2609000.0
2609,2609999,20.960123136622375,36.772074186855335,0.0789996575534413,372.3482882976532,172.76376247406006,391.87997817993164,14599,2890,11709,11709,0,11,2610000.0
2610,2610999,20.957053006424875,36.76811025159088,0.07902657980285344,372.49456334114075,172.82968640327454,392.06288146972656,14604,2891,11713,11713,0,11,2611000.0
2611,2611999,20.953463919526463,36.7625841251834,0.07906432753083281,372.6140697002411,172.8965871334076,392.3001403808594,14606,2891,11715,11715,0,11,2612000.0
2612,2612999,20.95033177706308,36.757928442477215,0.07909669360355442,372.72888827323914,172.96289134025574,392.6196746826172,14611,2891,11720,11720,0,11,2613000.0
2613,2613999,20.94713731643938,36.75260511422064,0.07912752469498119,372.94886016845703,173.02915596961975,392.6194763183594,14619,2894,11725,11725,0,11,2614000.0
2614,2614999,20.943941556292966,36.748085279679444,0.07915142977637657,373.0665988922119,173.09524655342102,392.8377494812012,14620,2894,11726,11726,0,11,2615000.0
2615,2615999,20.940601110593416,36.743128899155,0.07917728850443873,373.2324824333191,173.16207480430603,392.9033966064453,14623,2895,11728,11728,0,11,2616000.0
2616,2616999,20.937376318105425,36.73773893001125,0.07920077971980077,373.38914489746094,173.22842049598694,393.0838508605957,14631,2896,11735,11735,0,11,2617000.0
2617,2617999,20.934583403057566,36.73334985910262,0.07921332878857434,373.5481643676758,173.2944667339325,393.2041244506836,14634,2897,11737,11737,0,11,2618000.0
2618,2618999,20.93213499351096,36.728974333257916,0.07921096836234598,373.6958601474762,173.36061835289001,393.5601997375488,14645,2898,11747,11747,0,11,2619000.0
2619,2619999,20.93036341957886,36.726198103656195,0.07921123187072587,373.84320402145386,173.42748641967773,393.73286056518555,14647,2899,11748,11748,0,11,2620000.0
2620,2620999,20.928689930170737,36.723895626314665,0.07921953952969618,374.1302111148834,173.49453377723694,393.7484130859375,14659,2904,11755,11755,0,11,2621000.0
2621,2621999,20.927425122218725,36.721912338804664,0.0792331273042719,374.2500550746918,173.5603756904602,393.9501609802246,14660,2904,11756,11756,0,11,2622000.0
2622,2622999,20.927961598754532,36.72671366411361,0.07923473637031264,374.3669092655182,173.626229763031,394.1120948791504,14660,2904,11756,11756,0,11,2623000.0
2623,2623999,20.92830172468822,36.72640939877957,0.07922602037673288,374.50700974464417,173.69314074516296,394.4359664916992,14668,2904,11764,11764,0,11,2624000.0
2624,2624999,20.929009752008646,36.72640762413963,0.07922799293650618,374.6237828731537,173.75847697257996,394.6709289550781,14668,2904,11764,11764,0,11,2625000.0
2625,2625999,20.929427624267834,36.725847319637126,0.07922831696162946,374.80337023735046,173.82446241378784,394.8069381713867,14672,2906,11766,11766,0,11,2626000.0
2626,2626999,20.928684470436473,36.723011941517726,0.07925236865514251,374.98998951911926,173.8904528617859,394.8930320739746,14676,2908,11768,11768,0,11,2627000.0
2627,2627999,20.927252681027515,36.71930696516107,0.07925837888701126,375.1048393249512,173.95600843429565,395.0334777832031,14676,2908,11768,11768,0,11,2628000.0
2628,2628999,20.924140258506885,36.71413462021003,0.07926486110538378,375.25475430488586,174.02220249176025,395.5741958618164,14696,2909,11787,11787,0,11,2629000.0
2629,2629999,20.920673319310957,36.71101518277727,0.079265726785404,375.3698077201843,174.0865695476532,395.82127380371094,14698,2909,11789,11789,0,11,2630000.0
2630,2630999,20.91715368381765,36.70594321082477,0.07927549191289618,375.5522813796997,174.15235424041748,395.95123291015625,14705,2911,11794,11794,0,11,2631000.0
2631,2631999,20.914264891372387,36.70156814282158,0.07928281229875367,375.74194741249084,174.21805453300476,396.18807220458984,14718,2913,11805,11805,0,11,2632000.0
2632,2632999,20.911227055412077,36.69676848742018,0.07928780050804884,375.9436366558075,174.28429555892944,396.3654556274414,14725,2915,11810,11810,0,11,2633000.0
2633,2633999,20.90824898985812,36.6926976791625,0.07929493422372236,376.09156942367554,174.3501582145691,396.6046028137207,14727,2916,11811,11811,0,11,2634000.0
2634,2634999,20.90511716891425,36.688150572176085,0.0793005035503126,376.28437781333923,174.41588807106018,396.71881103515625,14731,2918,11813,11813,0,11,2635000.0
2635,2635999,20.901981900304254,36.683071810863595,0.07930675714641244,376.431298494339,174.48090767860413,396.87643814086914,14733,2919,11814,11814,0,11,2636000.0
2636,2636999,20.899263527774018,36.6807948064796,0.07930068906748089,376.6591019630432,174.54687094688416,396.9458541870117,14744,2922,11822,11822,0,11,2637000.0
2637,2637999,20.896589208677504,36.67654534414557,0.07930431359892132,376.81392312049866,174.6125464439392,397.12237548828125,14749,2923,11826,11826,0,11,2638000.0
2638,2638999,20.893706436688188,36.67187785420247,0.07930561103621225,376.9742360115051,174.67850756645203,397.336856842041,14756,2924,11832,11832,0,11,2639000.0
2639,2639999,20.891382321635998,36.66894872769398,0.07929663447711166,377.1678638458252,174.7438108921051,397.4507522583008,14762,2926,11836,11836,0,11,2640000.0
2640,2640999,20.88943624671817,36.66498172778966,0.07928640577640533,377.3017625808716,174.8086121082306,397.59926986694336,14762,2926,11836,11836,0,11,2641000.0
2641,2641999,20.88771035637021,36.66192256401714,0.07926914950859776,377.4582324028015,174.87396693229675,397.68555068969727,14764,2927,11837,11837,0,11,2642000.0
2642,2642999,20.886387075704054,36.65947238723748,0.07925891246905836,377.5870883464813,174.93919277191162,397.79798126220703,14765,2927,11838,11838,0,11,2643000.0
2643,2643999,20.885325306588896,36.65671437310639,0.07925254785622782,377.69928002357483,175.00375056266785,397.9005126953125,14765,2927,11838,11838,0,11,2644000.0
2644,2644999,20.884874045738723,36.65478425314041,0.07923830178669178,377.88196444511414,175.06935811042786,398.0757141113281,14774,2929,11845,11845,0,11,2645000.0
2645,2645999,20.885965335640496,36.65510951450948,0.07925321875115576,378.039395570755,175.13438153266907,398.16209411621094,14777,2930,11847,11847,0,11,2646000.0
2646,2646999,20.886605975884336,36.65367097567465,0.07927095817349783,378.26540660858154,175.20001578330994,398.17692947387695,14785,2933,11852,11852,0,11,2647000.0
2647,2647999,20.88743131385089,36.65367821163711,0.07932599156086251,378.4560558795929,175.26666450500488,398.2345314025879,14791,2935,11856,11856,0,11,2648000.0
2648,2648999,20.887150110625413,36.65273119553677,0.07935317798876118,378.6146788597107,175.33258891105652,398.2757453918457,14795,2936,11859,11859,0,11,2649000.0
2649,2649999,20.885246291221932,36.649636431556004,0.07932051155787168,378.77640986442566,175.39948749542236,398.8096008300781,14817,2937,11880,11880,0,11,2650000.0
2650,2650999,20.88257208261046,36.645351149415085,0.07932174032608408,378.8927571773529,175.46557688713074,399.0192985534668,14819,2937,11882,11882,0,11,2651000.0
2651,2651999,20.87967022496799,36.64092815687925,0.07931372134825809,379.011314868927,175.53155088424683,399.2092933654785,14824,2937,11887,11887,0,11,2652000.0
2652,2652999,20.877236732902325,36.63722101273861,0.0793079209142099,379.20881700515747,175.59775376319885,399.27114486694336,14838,2939,11899,11899,0,11,2653000.0
2653,2653999,20.875350252979697,36.634714170013154,0.07926187123375739,379.36764883995056,175.66381978988647,399.5829391479492,14851,2940,11911,11911,0,11,2654000.0
2654,2654999,20.873862645069515,36.63240978037487,0.07922383525711563,379.54889154434204,175.73024773597717,399.81796646118164,14873,2942,11931,11931,0,11,2655000.0
2655,2655999,20.872058523090452,36.6292582394409,0.07919978344196765,379.80731225013733,175.7968864440918,400.016845703125,14888,2946,11942,11942,0,11,2656000.0
2656,2656999,20.870420818066545,36.626026279971555,0.07917055339142731,379.95473885536194,175.86334347724915,400.26378631591797,14890,2947,11943,11943,0,11,2657000.0
2657,2657999,20.869225069218285,36.62395792642448,0.0791419098528734,380.0703842639923,175.93051481246948,400.49749755859375,14891,2947,11944,11944,0,11,2658000.0
2658,2658999,20.868425855682652,36.622496959754585,0.07913639122190086,380.1956830024719,175.9968123435974,400.8302001953125,14898,2947,11951,11951,0,11,2659000.0
2659,2659999,20.86986728554671,36.624745112755505,0.07912101102482283,380.46013498306274,176.0637390613556,401.0256233215332,14913,2951,11962,11962,0,11,2660000.0
2660,2660999,20.872125866061225,36.627444547609315,0.07915518125896781,380.6074104309082,176.12926244735718,401.2136917114258,14915,2952,11963,11963,0,11,2661000.0
2661,2661999,20.87477211485039,36.63079972082651,0.07921725702429605,380.79110050201416,176.19547629356384,401.36050033569336,14925,2954,11971,11971,0,11,2662000.0
2662,2662999,20.8789751802387,36.641738330757896,0.07925164568337772,381.0444014072418,176.26223731040955,401.49285888671875,14937,2958,11979,11979,0,11,2663000.0
2663,2663999,20.88410653520954,36.655815270619605,0.07931344324991152,381.237872838974,176.3306531906128,401.6451301574707,14942,2960,11982,11982,0,11,2664000.0
2664,2664999,20.88878524583253,36.66675827153592,0.0793887839823958,381.3943009376526,176.39764285087585,401.8033332824707,14946,2961,11985,11985,0,11,2665000.0
2665,2665999,20.893732185311034,36.671963777721885,0.079430054095458,381.5413475036621,176.46411323547363,402.3221664428711,14963,2962,12001,12001,0,11,2666000.0
2666,2666999,20.900208972652088,36.68159137983514,0.07956430964035788,381.79322028160095,176.53008031845093,402.36672592163086,14973,2966,12007,12007,0,11,2667000.0
2667,2667999,20.904369082281576,36.68487271691631,0.07964867286710164,381.9117796421051,176.5954794883728,402.5668296813965,14973,2966,12007,12007,0,11,2668000.0
2668,2668999,20.907776603817823,36.68935947730798,0.0796865209029094,382.0585870742798,176.66087675094604,402.71772384643555,14975,2967,12008,12008,0,11,2669000.0
2669,2669999,20.906602402836775,36.689474917881384,0.07964244753094307,382.17955780029297,176.72695422172546,403.2923393249512,14992,2967,12025,12025,0,11,2670000.0
2670,2670999,20.90528855840305,36.68950740426009,0.07962782159933846,382.2942967414856,176.7913510799408,403.48735427856445,14992,2967,12025,12025,0,11,2671000.0
2671,2671999,20.902845598716947,36.68589391209208,0.07962018820817784,382.44716691970825,176.85706853866577,403.6580238342285,14998,2968,12030,12030,0,11,2672000.0
2672,2672999,20.900273825089027,36.68255066202007,0.07962006125951715,382.6468858718872,176.92807006835938,403.8345603942871,15010,2970,12040,12040,0,11,2673000.0
2673,2673999,20.89806755608354,36.67924088200555,0.0796147879483331,382.8403100967407,176.99419140815735,404.0843734741211,15018,2972,12046,12046,0,11,2674000.0
2674,2674999,20.895874715441842,36.67553632822512,0.07958922560992043,382.9561870098114,177.05917644500732,404.34289169311523,15018,2972,12046,12046,0,11,2675000.0
2675,2675999,20.893598970218264,36.67131634404787,0.0795702809986949,383.12045407295227,177.1310520172119,404.43724822998047,15021,2973,12048,12048,0,11,2676000.0
2676,2676999,20.8920420102761,36.66915753332048,0.07955578800773844,383.31368136405945,177.1967453956604,404.5162811279297,15025,2975,12050,12050,0,11,2677000.0
2677,2677999,20.89025164647766,36.66642780228333,0.07954729378227354,383.46454548835754,177.26255917549133,404.63928604125977,15028,2976,12052,12052,0,11,2678000.0
2678,2678999,20.888803631797455,36.665147402495016,0.07958672079451945,383.6960802078247,177.32925415039062,404.77074432373047,15040,2979,12061,12061,0,11,2679000.0
2679,2679999,20.88957452506782,36.671280687571745,0.07958543646272898,383.89271783828735,177.39574313163757,405.0740165710449,15052,2981,12071,12071,0,11,2680000.0
2680,2680999,20.892001725774104,36.67828548981113,0.0796795279796364,384.08445167541504,177.46137404441833,405.2392883300781,15059,2983,12076,12076,0,11,2681000.0
2681,2681999,20.89483177497535,36.68504895005968,0.07975732694199433,384.2087390422821,177.5268521308899,405.4782257080078,15060,2983,12077,12077,0,11,2682000.0
2682,2682999,20.89987672969378,36.70045341466845,0.07988208951376718,384.3215663433075,177.5923171043396,405.65246200561523,15062,2983,12079,12079,0,11,2683000.0
2683,2683999,20.904972290077588,36.71331315420347,0.07994560302166043,384.50671434402466,177.65810990333557,405.7335891723633,15067,2985,12082,12082,0,11,2684000.0
2684,2684999,20.911141959274797,36.725976757672186,0.08009595239961642,384.63080167770386,177.72358632087708,405.90545654296875,15069,2985,12084,12084,0,11,2685000.0
2685,2685999,20.918854438626088,36.74143865730436,0.0802218906532145,384.8528392314911,177.79002904891968,406.1362762451172,15082,2988,12094,12094,0,11,2686000.0
2686,2686999,20.92726612462192,36.75714988196187,0.08034000275090758,385.0438780784607,177.85500073432922,406.2687339782715,15095,2990,12105,12105,0,11,2687000.0
2687,2687999,20.93458427772595,36.7714732015137,0.08041690245321453,385.2331576347351,177.92045974731445,406.39630126953125,15102,2992,12110,12110,0,11,2688000.0
2688,2688999,20.940566102582647,36.782198665622126,0.08054032278023715,385.4877254962921,177.9864785671234,406.3268280029297,15112,2996,12116,12116,0,11,2689000.0
2689,2689999,20.941904628378047,36.782218498535734,0.0805415989643179,385.60396552085876,178.05285263061523,406.97783279418945,15136,2996,12140,12140,0,11,2690000.0
2690,2690999,20.94000647059983,36.78322473720935,0.08051894328262821,385.7186825275421,178.11860990524292,407.3194465637207,15143,2996,12147,12147,0,11,2691000.0
2691,2691999,20.93746418804553,36.77937004104878,0.08051143177456332,385.8450255393982,178.18483066558838,407.5326919555664,15145,2996,12149,12149,0,11,2692000.0
2692,2692999,20.935364853571862,36.77651960351778,0.08049869657564979,385.96330738067627,178.25165939331055,407.6918296813965,15146,2996,12150,12150,0,11,2693000.0
2693,2693999,20.93284212145551,36.772760368139586,0.08049340242740588,386.12452125549316,178.31755709648132,407.81138610839844,15150,2997,12153,12153,0,11,2694000.0
2694,2694999,20.93039983537055,36.76889771653977,0.08048202784864333,386.27794194221497,178.38363432884216,408.11355209350586,15156,2998,12158,12158,0,11,2695000.0
2695,2695999,20.929005843126124,36.76765432184973,0.08043559242432008,386.46025013923645,178.44942712783813,408.23515701293945,15163,3000,12163,12163,0,11,2696000.0
2696,2696999,20.926907405353155,36.76396858940091,0.08042042913480096,386.6166036128998,178.51629447937012,408.36069107055664,15165,3001,12164,12164,0,11,2697000.0
2697,2697999,20.924426558460276,36.759492533789135,0.08041695435914986,386.8043293952942,178.5830578804016,408.4774856567383,15170,3003,12167,12167,0,11,2698000.0
2698,2698999,20.922107096742106,36.75539611662566,0.08040452267430609,387.0090363025665,178.6495931148529,408.6241683959961,15180,3005,12175,12175,0,11,2699000.0
2699,2699999,20.920174737908457,36.75313997350334,0.08038900148793682,387.1668908596039,178.71578216552734,408.7856903076172,15186,3006,12180,12180,0,11,2700000.0
2700,2700999,20.918838281742904,36.75006791719593,0.08036659155888815,387.32500982284546,178.78264832496643,409.2394142150879,15203,3007,12196,12196,0,11,2701000.0
2701,2701999,20.917151979516717,36.74668203658111,0.08035084667097014,387.51600551605225,178.84876441955566,409.4136962890625,15211,3009,12202,12202,0,11,2702000.0
2702,2702999,20.91573182184391,36.743680820014774,0.08032375593788554,387.63439202308655,178.91442704200745,409.59718322753906,15211,3009,12202,12202,0,11,2703000.0
2703,2703999,20.91502748523096,36.745801284669476,0.08029410714063168,387.79583287239075,178.98046016693115,409.7215881347656,15214,3010,12204,12204,0,11,2704000.0
2704,2704999,20.914262627827778,36.74364027962588,0.08026426864472658,387.94411873817444,179.0469274520874,409.8229103088379,15216,3011,12205,12205,0,11,2705000.0
2705,2705999,20.913087330225512,36.74041254889194,0.08024829000594869,388.0938289165497,179.11258602142334,409.91955184936523,15221,3012,12209,12209,0,11,2706000.0
2706,2706999,20.91269661034962,36.73793633956261,0.08022745101625373,388.28381156921387,179.17833065986633,410.1600341796875,15239,3014,12225,12225,0,11,2707000.0
2707,2707999,20.912190250211,36.73632985885754,0.08020951599545956,388.514554977417,179.24458289146423,410.22392654418945,15246,3017,12229,12229,0,11,2708000.0
2708,2708999,20.91134958787485,36.73324274616948,0.08019431805433785,388.6367177963257,179.309415102005,410.3669090270996,15246,3017,12229,12229,0,11,2709000.0
2709,2709999,20.909913060216805,36.729850248560744,0.08017622894046494,388.85773944854736,179.37525272369385,410.29417419433594,15252,3020,12232,12232,0,11,2710000.0
2710,2710999,20.907441756982887,36.72550464357016,0.0801687916610736,389.02702713012695,179.442054271698,410.8023567199707,15274,3021,12253,12253,0,11,2711000.0
2711,2711999,20.904075293843526,36.721095233845496,0.08017640423175898,389.15706396102905,179.5074610710144,411.0717544555664,15278,3021,12257,12257,0,11,2712000.0
2712,2712999,20.90072194393804,36.71589761292385,0.08018400539485038,389.2721993923187,179.57266473770142,411.2707061767578,15281,3021,12260,12260,0,11,2713000.0
2713,2713999,20.897820387944904,36.71139894051652,0.0801915243171597,389.38884806632996,179.63747906684875,411.4010314941406,15282,3021,12261,12261,0,11,2714000.0
2714,2714999,20.89507555421229,36.70747866763316,0.08019510357541293,389.5393748283386,179.70312476158142,411.44054794311523,15284,3022,12262,12262,0,11,2715000.0
2715,2715999,20.892046734515944,36.70287346865709,0.08019872254409832,389.69630551338196,179.76974177360535,411.7146797180176,15291,3023,12268,12268,0,11,2716000.0
2716,2716999,20.8894678032485,36.7002470753399,0.08020947455819016,389.8825652599335,179.8356418609619,411.9014091491699,15313,3025,12288,12288,0,11,2717000.0
2717,2717999,20.887381823619265,36.69689163852511,0.0801977635538006,390.0366373062134,179.9017632007599,412.107967376709,15316,3026,12290,12290,0,11,2718000.0
2718,2718999,20.885415852251125,36.69371343252387,0.08019965551037123,390.1948516368866,179.96885871887207,412.24061584472656,15319,3027,12292,12292,0,11,2719000.0
2719,2719999,20.883248452372445,36.69014603563032,0.08020236653866786,390.3681151866913,180.03646659851074,412.43919372558594,15323,3028,12295,12295,0,11,2720000.0
2720,2720999,20.881328048097437,36.68651639538975,0.08020577173105936,390.52485489845276,180.10234904289246,412.581356048584,15326,3029,12297,12297,0,11,2721000.0
2721,2721999,20.880558866068988,36.68431466865049,0.0802024062967922,390.67930459976196,180.16787886619568,412.7889633178711,15331,3030,12301,12301,0,11,2722000.0
2722,2722999,20.8801924132174,36.68345708032171,0.08020058094977,390.8366916179657,180.23371744155884,412.918514251709,15334,3031,12303,12303,0,11,2723000.0
2723,2723999,20.880111398539086,36.682014875700894,0.0802088269276312,390.9888186454773,180.30018091201782,413.0027313232422,15336,3032,12304,12304,0,11,2724000.0
2724,2724999,20.88021671165625,36.68103268997986,0.08021572229799634,391.13110184669495,180.3720543384552,413.138671875,15337,3032,12305,12305,0,11,2725000.0
2725,2725999,20.880440556921595,36.67989415328957,0.08023715070116233,391.422025680542,180.43836784362793,413.065860748291,15351,3037,12314,12314,0,11,2726000.0
2726,2726999,20.8809119016368,36.67957629705529,0.08024328794791502,391.582927942276,180.50431728363037,413.18245697021484,15355,3038,12317,12317,0,11,2727000.0
2727,2727999,20.88213787757535,36.67998321280985,0.08022091062367098,391.70154786109924,180.57141280174255,413.5454406738281,15364,3038,12326,12326,0,11,2728000.0
2728,2728999,20.88375221481327,36.680919474775465,0.08022901065936128,391.8910963535309,180.6374111175537,413.6493453979492,15368,3040,12328,12328,0,11,2729000.0
2729,2729999,20.884918378593852,36.68074173895909,0.08023770661291207,392.07409858703613,180.70337414741516,413.7758445739746,15384,3042,12342,12342,0,11,2730000.0
2730,2730999,20.885506254150958,36.67986245039194,0.08023114741827742,392.29567217826843,180.7695963382721,413.9503593444824,15423,3045,12378,12378,0,11,2731000.0
2731,2731999,20.88425193306097,36.677386654778935,0.0802329172764753,392.4635193347931,180.83722925186157,414.5138816833496,15451,3046,12405,12405,0,11,2732000.0
2732,2732999,20.881274188862957,36.67369172810603,0.08024864500579909,392.6533057689667,180.90361976623535,414.8032112121582,15473,3048,12425,12425,0,11,2733000.0
2733,2733999,20.878757754709667,36.67211162149239,0.08025387993736155,392.77811002731323,180.97025680541992,415.0524673461914,15478,3048,12430,12430,0,11,2734000.0
2734,2734999,20.875694030236694,36.66740151261942,0.08027458932014608,392.8950343132019,181.03630208969116,415.2085952758789,15480,3048,12432,12432,0,11,2735000.0
2735,2735999,20.873154088853585,36.66354738050903,0.08027917280509811,393.0546793937683,181.10361862182617,415.40747451782227,15483,3049,12434,12434,0,11,2736000.0
2736,2736999,20.870903753393915,36.66020016969984,0.08029025456660377,393.21423721313477,181.16957902908325,415.57680892944336,15485,3050,12435,12435,0,11,2737000.0
2737,2737999,20.869004281445047,36.65701441108065,0.0802970593329172,393.3413634300232,181.23598623275757,415.71926498413086,15485,3050,12435,12435,0,11,2738000.0
2738,2738999,20.866667800725665,36.65363056286592,0.08030021364401452,393.53082251548767,181.30270528793335,415.77538299560547,15490,3052,12438,12438,0,11,2739000.0
2739,2739999,20.86467379920153,36.65047839552497,0.08030640137683309,393.68019104003906,181.3690905570984,415.92455291748047,15504,3053,12451,12451,0,11,2740000.0
2740,2740999,20.862561724797374,36.64682279073475,0.0803147200468245,393.8110191822052,181.4350392818451,416.0399703979492,15504,3053,12451,12451,0,11,2741000.0
2741,2741999,20.86077753666573,36.643571157764946,0.08031547713983944,394.0071864128113,181.5022156238556,416.2527084350586,15513,3055,12458,12458,0,11,2742000.0
2742,2742999,20.859067158036275,36.64108570153531,0.08031391297067025,394.2023184299469,181.56922721862793,416.34443283081055,15517,3057,12460,12460,0,11,2743000.0
2743,2743999,20.857614991874588,36.63923456678443,0.08031679579622863,394.42895221710205,181.63580131530762,416.3856964111328,15527,3060,12467,12467,0,11,2744000.0
2744,2744999,20.85577390743846,36.635816050954574,0.08033089090211709,394.54582500457764,181.70145225524902,416.53846740722656,15527,3060,12467,12467,0,11,2745000.0
2745,2745999,20.854897131674065,36.63428706542411,0.08032185447165585,394.69981122016907,181.7674949169159,416.60479736328125,15529,3061,12468,12468,0,11,2746000.0
2746,2746999,20.853191535813416,36.630632282652606,0.08033817326700965,394.8218994140625,181.83310461044312,416.893985748291,15533,3061,12472,12472,0,11,2747000.0
2747,2747999,20.851233974407446,36.62691837934043,0.08035210204671261,394.97897267341614,181.89869379997253,417.0171585083008,15535,3062,12473,12473,0,11,2748000.0
2748,2748999,20.84896183019758,36.623005723380516,0.08037628618272952,395.1650426387787,181.96466541290283,417.0453643798828,15539,3064,12475,12475,0,11,2749000.0
2749,2749999,20.846027315138013,36.61907153092076,0.08039401364635312,395.3902871608734,182.03138399124146,417.40259552001953,15566,3067,12499,12499,0,11,2750000.0
2750,2750999,20.842535543611667,36.61457775918357,0.08041775820865438,395.5200939178467,182.09718084335327,417.7195625305176,15572,3067,12505,12505,0,11,2751000.0
2751,2751999,20.838971002374688,36.60931800163417,0.08045319474206736,395.6400730609894,182.1630561351776,417.9261016845703,15575,3067,12508,12508,0,11,2752000.0
2752,2752999,20.835783409118772,36.60504289917569,0.08047168175251496,395.75638580322266,182.22861790657043,418.0867614746094,15576,3067,12509,12509,0,11,2753000.0
2753,2753999,20.83288756532224,36.60089186002898,0.08049713638635214,395.87162017822266,182.2944793701172,418.3398017883301,15580,3067,12513,12513,0,11,2754000.0
2754,2754999,20.829828907505462,36.59650731341148,0.08051910613177216,395.9893708229065,182.36045575141907,418.48273849487305,15580,3067,12513,12513,0,11,2755000.0
2755,2755999,20.82698380725499,36.59279100666926,0.08052835613904519,396.1760482788086,182.43582606315613,418.59865951538086,15582,3068,12514,12514,0,11,2756000.0
2756,2756999,20.82422846240915,36.589050721435676,0.08053408855016464,396.3371379375458,182.50158286094666,418.66886138916016,15586,3069,12517,12517,0,11,2757000.0
2757,2757999,20.821755588310193,36.585337779572946,0.0805381114027166,396.4535508155823,182.56718730926514,418.8250274658203,15589,3069,12520,12520,0,11,2758000.0
2758,2758999,20.81939469964315,36.58160300294682,0.0805376184232196,396.6100766658783,182.6333270072937,418.9315414428711,15592,3070,12522,12522,0,11,2759000.0
2759,2759999,20.818337657571487,36.58649113713437,0.0804857078465202,396.73584723472595,182.70010542869568,419.2220687866211,15598,3070,12528,12528,0,11,2760000.0
2760,2760999,20.816530408775154,36.5834203900759,0.08047749507811708,396.92273330688477,182.7660093307495,419.3207359313965,15602,3072,12530,12530,0,11,2761000.0
2761,2761999,20.81522896681922,36.58093101102491,0.08045932031783354,397.14932918548584,182.8323483467102,419.3825378417969,15608,3075,12533,12533,0,11,2762000.0
2762,2762999,20.81410552210127,36.57844494984181,0.08045063073555181,397.2725076675415,182.89813661575317,419.51931381225586,15609,3075,12534,12534,0,11,2763000.0
2763,2763999,20.814301713624364,36.57822376591673,0.08043992890807028,397.3914968967438,182.96394300460815,419.6320610046387,15609,3075,12534,12534,0,11,2764000.0
2764,2764999,20.813825262517007,36.57654268746295,0.08043422103590647,397.5545611381531,183.03046107292175,419.7051773071289,15612,3076,12536,12536,0,11,2765000.0
2765,2765999,20.81416913653915,36.575904962175834,0.08040355470058291,397.7043426036835,183.0963170528412,420.0077362060547,15620,3077,12543,12543,0,11,2766000.0
2766,2766999,20.81427604084416,36.5747134741811,0.0803876375365502,397.8882157802582,183.1618926525116,420.12156677246094,15629,3079,12550,12550,0,11,2767000.0
2767,2767999,20.814196287914605,36.5727455062851,0.08036224391273938,398.0760703086853,183.2278974056244,420.1539726257324,15633,3081,12552,12552,0,11,2768000.0
2768,2768999,20.813531438015406,36.56999613269042,0.08035202157190946,398.2708718776703,183.29454398155212,420.2665557861328,15638,3083,12555,12555,0,11,2769000.0
2769,2769999,20.81115068243407,36.56669925904713,0.08035086369390931,398.3910562992096,183.36149907112122,420.6942024230957,15650,3083,12567,12567,0,11,2770000.0
2770,2770999,20.807591043128113,36.561708737588155,0.08037010872518024,398.5115616321564,183.42619347572327,420.9464340209961,15651,3083,12568,12568,0,11,2771000.0
2771,2771999,20.804166037293918,36.55732234146389,0.08038580934200912,398.6662178039551,183.4912691116333,421.0775604248047,15655,3084,12571,12571,0,11,2772000.0
2772,2772999,20.800891819098354,36.55349509535675,0.08039541389660776,398.8230195045471,183.5574061870575,421.29991912841797,15666,3085,12581,12581,0,11,2773000.0
2773,2773999,20.797934928650495,36.54997872536217,0.0804035607441621,399.013708114624,183.62263822555542,421.32587814331055,15670,3087,12583,12583,0,11,2774000.0
2774,2774999,20.795117320003136,36.5460206403807,0.08039535062576131,399.17453932762146,183.6880316734314,421.5674247741699,15673,3088,12585,12585,0,11,2775000.0
2775,2775999,20.79267209920303,36.54163577958258,0.08038651608521907,399.403329372406,183.75356531143188,421.6662902832031,15682,3091,12591,12591,0,11,2776000.0
2776,2776999,20.789793979216757,36.53689040850909,0.08038668040665198,399.5212869644165,183.81855940818787,421.81895446777344,15682,3091,12591,12591,0,11,2777000.0
2777,2777999,20.787122379350023,36.532606367554415,0.08038846960835022,399.65284299850464,183.88518834114075,421.9479560852051,15683,3091,12592,12592,0,11,2778000.0
2778,2778999,20.784446718155213,36.52804593505538,0.08039405871115124,399.77008509635925,183.94999480247498,422.1013832092285,15686,3091,12595,12595,0,11,2779000.0
2779,2779999,20.782072467417933,36.52369596617238,0.08038406462122905,399.9272427558899,184.0151960849762,422.170352935791,15690,3092,12598,12598,0,11,2780000.0
2780,2780999,20.78056576321619,36.52105497804267,0.08035930358576637,400.0642578601837,184.0810363292694,422.3992500305176,15693,3092,12601,12601,0,11,2781000.0
2781,2781999,20.7784275293618,36.517081563158314,0.08036042499166618,400.2214574813843,184.1456491947174,422.5133247375488,15695,3093,12602,12602,0,11,2782000.0
2782,2782999,20.77682542343823,36.51404750115442,0.08034420915746443,400.34393405914307,184.21037125587463,422.6125602722168,15695,3093,12602,12602,0,11,2783000.0
2783,2783999,20.775050852032468,36.510510169673914,0.08033112484468508,400.46397376060486,184.27550315856934,422.7067070007324,15696,3093,12603,12603,0,11,2784000.0
2784,2784999,20.77345359425692,36.50707942753431,0.08031828316892298,400.6207778453827,184.33990597724915,422.7431526184082,15698,3094,12604,12604,0,11,2785000.0
2785,2785999,20.772204049837853,36.50435142682985,0.08030609784207388,400.80198407173157,184.40485048294067,422.84060287475586,15700,3095,12605,12605,0,11,2786000.0
2786,2786999,20.770423745744186,36.50075385590495,0.08030230784030434,400.910768032074,184.4691343307495,423.08292388916016,15703,3095,12608,12608,0,11,2787000.0
2787,2787999,20.768966555319214,36.499456235483784,0.08028144461995501,401.10455560684204,184.53390264511108,423.14831161499023,15707,3097,12610,12610,0,11,2788000.0
2788,2788999,20.767270575196232,36.49613561672067,0.0802720473646078,401.2666380405426,184.59891080856323,423.2191047668457,15709,3098,12611,12611,0,11,2789000.0
2789,2789999,20.764894941045362,36.49195256157414,0.08027426343525401,401.41765809059143,184.66487526893616,423.29723739624023,15711,3099,12612,12612,0,11,2790000.0
2790,2790999,20.76465949830949,36.49818323967849,0.08013022483572774,401.54878330230713,184.73040342330933,423.72862243652344,15727,3099,12628,12628,0,11,2791000.0
2791,2791999,20.764513763862222,36.500304786861165,0.08005824472407086,401.6669600009918,184.79585480690002,423.9576873779297,15729,3099,12630,12630,0,11,2792000.0
2792,2792999,20.762741842492147,36.49939081502268,0.08004322983414935,401.78798937797546,184.86088371276855,424.09276962280273,15730,3099,12631,12631,0,11,2793000.0
2793,2793999,20.761276616316348,36.49880871839185,0.08005321064066839,401.945029258728,184.92674374580383,424.20323181152344,15733,3100,12633,12633,0,11,2794000.0
2794,2794999,20.7597799104474,36.497950742510895,0.08003626307536293,402.0981409549713,184.99228835105896,424.3072166442871,15736,3101,12635,12635,0,11,2795000.0
2795,2795999,20.759652872852005,36.499446613722164,0.08005703332319036,402.2098343372345,185.05751824378967,424.7270622253418,15744,3101,12643,12643,0,11,2796000.0
2796,2796999,20.758000504430274,36.49704000008271,0.0800754208060529,402.39761567115784,185.12325239181519,424.81505966186523,15751,3103,12648,12648,0,11,2797000.0
2797,2797999,20.756933062457133,36.49613098957118,0.08012107065626761,402.6630024909973,185.18981432914734,424.9339828491211,15762,3107,12655,12655,0,11,2798000.0
2798,2798999,20.75624148078033,36.495192497427254,0.08016376235320433,402.78031039237976,185.25548124313354,425.1650390625,15763,3107,12656,12656,0,11,2799000.0
2799,2799999,20.756056213253874,36.50050656634101,0.08013118626444171,402.8978886604309,185.32095956802368,425.3822822570801,15768,3107,12661,12661,0,11,2800000.0
2800,2800999,20.755375130980557,36.49867114528929,0.08017202923966427,403.089457988739,185.38832259178162,425.58430099487305,15777,3109,12668,12668,0,11,2801000.0
2801,2801999,20.755048232181807,36.49721508230483,0.08017005635092567,403.2514748573303,185.45411038398743,425.7420082092285,15779,3110,12669,12669,0,11,2802000.0
2802,2802999,20.755050150238496,36.496423900941856,0.08019080467261264,403.4831726551056,185.51973748207092,425.7447853088379,15790,3113,12677,12677,0,11,2803000.0
2803,2803999,20.754855568411998,36.49558792558815,0.08018512814406942,403.6401114463806,185.58558130264282,425.859375,15792,3114,12678,12678,0,11,2804000.0
2804,2804999,20.754213153913906,36.49370759320119,0.08018217477873901,403.8306541442871,185.65148258209229,425.9197120666504,15797,3116,12681,12681,0,11,2805000.0
2805,2805999,20.75408327328389,36.49190537465994,0.08018415752544905,403.95671916007996,185.71862840652466,426.0982131958008,15800,3116,12684,12684,0,11,2806000.0
2806,2806999,20.754250410961443,36.49048866503935,0.08019003320817075,404.1085321903229,185.78462672233582,426.39282608032227,15811,3117,12694,12694,0,11,2807000.0
2807,2807999,20.755156256478863,36.49710062524431,0.08015431463772582,404.421382188797,185.8512420654297,426.37780380249023,15834,3122,12712,12712,0,11,2808000.0
2808,2808999,20.755177157433817,36.49540443494986,0.08014720112972706,404.57687282562256,185.91825532913208,426.6013946533203,15836,3123,12713,12713,0,11,2809000.0
2809,2809999,20.7550696545784,36.49340752094479,0.08013222678681231,404.7762863636017,185.9848394393921,426.67453384399414,15840,3125,12715,12715,0,11,2810000.0
2810,2810999,20.753472851601764,36.48951353610723,0.08012689091855685,404.8937363624573,186.05056810379028,426.90223693847656,15847,3125,12722,12722,0,11,2811000.0
2811,2811999,20.74994547615655,36.48499304599261,0.0801484519019483,405.0480053424835,186.11627006530762,427.2761573791504,15857,3126,12731,12731,0,11,2812000.0
2812,2812999,20.746456199710902,36.48060810952749,0.08016899376379027,405.16753029823303,186.18083024024963,427.4338836669922,15857,3126,12731,12731,0,11,2813000.0
2813,2813999,20.74307633026853,36.4764455101812,0.08018738708475193,405.32623267173767,186.24626302719116,427.5654525756836,15863,3127,12736,12736,0,11,2814000.0
2814,2814999,20.73974949377506,36.47176219621023,0.08020595501569083,405.48691511154175,186.31207466125488,427.7048797607422,15866,3128,12738,12738,0,11,2815000.0
2815,2815999,20.7367532876867,36.4671964610767,0.08022208212171522,405.72163438796997,186.37813210487366,427.7934150695801,15874,3131,12743,12743,0,11,2816000.0
2816,2816999,20.73415905123843,36.46392740851095,0.08022720162995589,405.9158465862274,186.44338250160217,427.9516143798828,15884,3133,12751,12751,0,11,2817000.0
2817,2817999,20.731440211888028,36.46025376547098,0.08023179316099238,406.0316116809845,186.50831055641174,428.12204360961914,15885,3133,12752,12752,0,11,2818000.0
2818,2818999,20.728666363162926,36.45621539635927,0.08023412804686747,406.1957862377167,186.57330513000488,428.1982879638672,15887,3134,12753,12753,0,11,2819000.0
2819,2819999,20.72596905048059,36.45171752607482,0.08023300591871063,406.3178641796112,186.63838601112366,428.3581848144531,15889,3134,12755,12755,0,11,2820000.0
2820,2820999,20.723602730288185,36.44754916234074,0.08022746898717004,406.51727867126465,186.70430731773376,428.4799118041992,15899,3136,12763,12763,0,11,2821000.0
2821,2821999,20.722070671111403,36.44489748155392,0.08019623414569721,406.6714289188385,186.7695324420929,428.72912979125977,15906,3137,12769,12769,0,11,2822000.0
2822,2822999,20.72179804018442,36.451805068063024,0.08014604957763238,406.8677887916565,186.8350670337677,428.8299903869629,15910,3139,12771,12771,0,11,2823000.0
2823,2823999,20.721702327344115,36.45170608600074,0.08013636158706916,406.98214745521545,186.89991068840027,428.9939727783203,15910,3139,12771,12771,0,11,2824000.0
2824,2824999,20.72169978910877,36.45174231240372,0.08012009988494673,407.1794457435608,186.96650910377502,429.1009216308594,15916,3141,12775,12775,0,11,2825000.0
2825,2825999,20.722548565692083,36.453547927198656,0.08011112838446743,407.37239623069763,187.0321819782257,429.1646194458008,15921,3143,12778,12778,0,11,2826000.0
2826,2826999,20.72344198103969,36.45396063201532,0.08010223243274472,407.5685179233551,187.09837675094604,429.24505615234375,15928,3145,12783,12783,0,11,2827000.0
2827,2827999,20.723983770902674,36.452889716945116,0.08007525891444489,407.80775356292725,187.16509413719177,429.4887504577637,15947,3148,12799,12799,0,11,2828000.0
2828,2828999,20.725971557975953,36.45440885898426,0.08007642795906555,407.96417355537415,187.2298927307129,429.6844291687012,15949,3149,12800,12800,0,11,2829000.0
2829,2829999,20.727260173566858,36.454232804167944,0.08007551581474315,408.1568503379822,187.29543590545654,429.78556060791016,15955,3151,12804,12804,0,11,2830000.0
2830,2830999,20.727840687961365,36.452700963909024,0.0800592022303982,408.3584849834442,187.36152362823486,429.9126205444336,15959,3153,12806,12806,0,11,2831000.0
2831,2831999,20.727187940986493,36.45008879555455,0.08004495893232577,408.51985216140747,187.42803525924683,430.33042907714844,15975,3154,12821,12821,0,11,2832000.0
2832,2832999,20.72455626004065,36.447142900530395,0.0800447448498044,408.677845954895,187.49445867538452,430.7572822570801,15992,3155,12837,12837,0,11,2833000.0
2833,2833999,20.72166009276037,36.44406805224484,0.08005048076658017,408.7941780090332,187.56049585342407,430.97683334350586,15994,3155,12839,12839,0,11,2834000.0
2834,2834999,20.718480871025243,36.439126463253515,0.0800672656454493,408.9147620201111,187.62639737129211,431.17041397094727,15997,3155,12842,12842,0,11,2835000.0
2835,2835999,20.71621333542715,36.43548631873933,0.0800697600189545,409.0320677757263,187.69154691696167,431.31975173950195,15997,3155,12842,12842,0,11,2836000.0
2836,2836999,20.714222360694215,36.43312994031959,0.0800737608458626,409.23183727264404,187.75772547721863,431.509033203125,16006,3157,12849,12849,0,11,2837000.0
2837,2837999,20.712838986018287,36.43190024023211,0.08006258137957722,409.38642263412476,187.8248655796051,431.6953125,16011,3158,12853,12853,0,11,2838000.0
2838,2838999,20.711946267810955,36.43114925901037,0.08007605779485227,409.5363042354584,187.89157366752625,431.8213233947754,16013,3159,12854,12854,0,11,2839000.0
2839,2839999,20.71170745565707,36.43285184771131,0.08007604704306293,409.7078001499176,187.95727562904358,431.8986625671387,16016,3160,12856,12856,0,11,2840000.0
2840,2840999,20.712283708605415,36.435595758695236,0.08004616038106016,409.903359413147,188.023432970047,431.9900360107422,16022,3162,12860,12860,0,11,2841000.0
2841,2841999,20.713164843947045,36.438835878155004,0.08004621153296843,410.0301229953766,188.08936595916748,432.1769905090332,16026,3162,12864,12864,0,11,2842000.0
2842,2842999,20.715318298737813,36.444985599540814,0.08007104649045937,410.1600115299225,188.1555473804474,432.5592803955078,16040,3162,12878,12878,0,11,2843000.0
2843,2843999,20.71936259129899,36.458991314375936,0.08015612592814991,410.35363030433655,188.2216193675995,432.6743507385254,16046,3164,12882,12882,0,11,2844000.0
2844,2844999,20.722190634900613,36.465336976945565,0.08026861414626074,410.55902338027954,188.29395461082458,432.7921447753906,16054,3166,12888,12888,0,11,2845000.0
2845,2845999,20.726524250564033,36.47766926344176,0.08036698877589932,410.7203366756439,188.35988640785217,432.90260314941406,16057,3167,12890,12890,0,11,2846000.0
2846,2846999,20.73115241102842,36.48794243470076,0.08047207121233979,410.8842601776123,188.42596077919006,432.9849319458008,16059,3168,12891,12891,0,11,2847000.0
2847,2847999,20.735992906971696,36.50032957896306,0.08059855077227984,411.0028467178345,188.49213981628418,433.13521575927734,16059,3168,12891,12891,0,11,2848000.0
2848,2848999,20.742338713822186,36.51213494807764,0.08068024811696561,411.12022852897644,188.55729174613953,433.4348335266113,16063,3168,12895,12895,0,11,2849000.0
2849,2849999,20.74716752265653,36.51953451848007,0.08074910922603462,411.32350301742554,188.63231921195984,433.49875259399414,16069,3170,12899,12899,0,11,2850000.0
2850,2850999,20.752377343025987,36.52783442169469,0.08091059891188013,411.56549406051636,188.6984305381775,433.5128059387207,16075,3173,12902,12902,0,11,2851000.0
2851,2851999,20.75577662781722,36.532549400001365,0.08091781382286656,411.8015215396881,188.76428127288818,433.5624580383301,16087,3176,12911,12911,0,11,2852000.0
2852,2852999,20.75497992710541,36.53107241736133,0.08086400106136382,411.9250042438507,188.83243250846863,434.2888717651367,16115,3176,12939,12939,0,11,2853000.0
2853,2853999,20.752828654930408,36.528282301625346,0.08085013382658501,412.04435873031616,188.89802193641663,434.5377540588379,16116,3176,12940,12940,0,11,2854000.0
2854,2854999,20.75033782728875,36.5240275509427,0.08084936041030522,412.1619529724121,188.96416091918945,434.77198791503906,16120,3176,12944,12944,0,11,2855000.0
2855,2855999,20.749430274875202,36.52717531694791,0.08081764771635425,412.27681851387024,189.0297441482544,434.91948318481445,16121,3176,12945,12945,0,11,2856000.0
2856,2856999,20.74763436979358,36.523936519593526,0.08080751521375129,412.4294800758362,189.09524512290955,435.02418518066406,16124,3177,12947,12947,0,11,2857000.0
2857,2857999,20.74615002112518,36.5212292315833,0.08079448546037749,412.5837275981903,189.16153621673584,435.3674430847168,16132,3178,12954,12954,0,11,2858000.0
2858,2858999,20.744378305809363,36.51752063432804,0.08078247585651999,412.704922914505,189.22844433784485,435.5380096435547,16132,3178,12954,12954,0,11,2859000.0
2859,2859999,20.74301669316585,36.515449874841835,0.08077574809258503,412.8328604698181,189.29443168640137,435.6997413635254,16134,3178,12956,12956,0,11,2860000.0
2860,2860999,20.74230693786845,36.51443584201084,0.08075736449918536,412.98427391052246,189.36011958122253,435.79178619384766,16137,3179,12958,12958,0,11,2861000.0
2861,2861999,20.741444199208207,36.51234868268598,0.08074031435023898,413.1826927661896,189.4277150630951,435.9037055969238,16147,3181,12966,12966,0,11,2862000.0
2862,2862999,20.740463704334275,36.51039040767729,0.08072124655377233,413.377108335495,189.4945456981659,435.98980712890625,16154,3183,12971,12971,0,11,2863000.0
2863,2863999,20.7404401655632,36.51003473389584,0.08069546972257302,413.5690293312073,189.5607922077179,436.2514343261719,16167,3185,12982,12982,0,11,2864000.0
2864,2864999,20.740067821233975,36.5080553416073,0.0806960981265118,413.7217173576355,189.62647581100464,436.3873100280762,16170,3186,12984,12984,0,11,2865000.0
2865,2865999,20.739943035645183,36.5073510020357,0.08068970990479729,413.94341135025024,189.69311118125916,436.4735641479492,16180,3189,12991,12991,0,11,2866000.0
2866,2866999,20.740270610347647,36.506518783073986,0.08067803733732348,414.14002227783203,189.7599322795868,436.61794662475586,16186,3191,12995,12995,0,11,2867000.0
2867,2867999,20.740513093793144,36.50678459533869,0.08066561106669079,414.3748199939728,189.827250957489,436.7536811828613,16196,3194,13002,13002,0,11,2868000.0
2868,2868999,20.740738635484373,36.505731031841066,0.08066226763715134,414.5369596481323,189.89334297180176,436.9227294921875,16200,3195,13005,13005,0,11,2869000.0
2869,2869999,20.74137327614932,36.50542131796509,0.08064202244339869,414.700719833374,189.96002101898193,437.5727310180664,16244,3196,13048,13048,0,11,2870000.0
2870,2870999,20.741564382956366,36.503704145906525,0.08063862521775955,414.8224079608917,190.02637195587158,437.9323921203613,16244,3196,13048,13048,0,11,2871000.0
2871,2871999,20.741564384577956,36.50195646171396,0.0806338582830145,414.9379107952118,190.0932686328888,438.2355270385742,16244,3196,13048,13048,0,11,2872000.0
2872,2872999,20.740579824048055,36.49892571158987,0.08063832311933039,415.16435837745667,190.16004514694214,438.37285232543945,16254,3199,13055,13055,0,11,2873000.0
2873,2873999,20.73810573903,36.49456472029277,0.08064825629651118,415.3350954055786,190.2344057559967,439.05445098876953,16288,3200,13088,13088,0,11,2874000.0
2874,2874999,20.734984962929886,36.49035248458097,0.08066111094360906,415.4957387447357,190.30111622810364,439.2825469970703,16292,3201,13091,13091,0,11,2875000.0
2875,2875999,20.73233433998405,36.48804713109408,0.08066345318416723,415.61460542678833,190.36783146858215,439.5914535522461,16299,3201,13098,13098,0,11,2876000.0
2876,2876999,20.72975034733251,36.484363425140835,0.08067496770438098,415.7319333553314,190.43434524536133,439.76453399658203,16300,3201,13099,13099,0,11,2877000.0
2877,2877999,20.726965475109303,36.47995811864757,0.08068702240433812,415.92911887168884,190.50072050094604,439.9531440734863,16307,3203,13104,13104,0,11,2878000.0
2878,2878999,20.72459961015718,36.4765537542311,0.0806902127810929,416.08518719673157,190.5679543018341,440.13682556152344,16322,3204,13118,13118,0,11,2879000.0
2879,2879999,20.722203858661324,36.47260125474584,0.0806973966017771,416.24274826049805,190.6345295906067,440.2579689025879,16324,3205,13119,13119,0,11,2880000.0
2880,2880999,20.720170738163407,36.469227814424144,0.08070791466053284,416.473509311676,190.70103430747986,440.29809951782227,16333,3208,13125,13125,0,11,2881000.0
2881,2881999,20.71839731756797,36.46595916361629,0.08072320217421847,416.6008586883545,190.76891016960144,440.52271270751953,16337,3208,13129,13129,0,11,2882000.0
2882,2882999,20.717538455436756,36.464412429154,0.08071147677785973,416.75930547714233,190.83542728424072,440.65917587280273,16341,3209,13132,13132,0,11,2883000.0
2883,2883999,20.71728017439988,36.462880843378336,0.08070081360342629,417.02452635765076,190.9026620388031,440.84396743774414,16358,3213,13145,13145,0,11,2884000.0
2884,2884999,20.717234247220542,36.46304894441907,0.08069220747447847,417.2158224582672,190.96932792663574,441.0341339111328,16362,3215,13147,13147,0,11,2885000.0
2885,2885999,20.71737538298735,36.46190239535417,0.08070712461343099,417.3384692668915,191.0355212688446,441.2223091125488,16362,3215,13147,13147,0,11,2886000.0
2886,2886999,20.71799577073205,36.4618310506224,0.08073659914701403,417.49334049224854,191.1027946472168,441.3921241760254,16377,3216,13161,13161,0,11,2887000.0
2887,2887999,20.71861736492828,36.46138925289412,0.08077347253967349,417.65390038490295,191.16935014724731,441.4972801208496,16379,3217,13162,13162,0,11,2888000.0
2888,2888999,20.719765247448827,36.460992836849684,0.08076328340598227,417.81120777130127,191.23555517196655,441.81128692626953,16386,3218,13168,13168,0,11,2889000.0
2889,2889999,20.720029641605496,36.45957004507238,0.08075901701781651,418.074613571167,191.30171823501587,441.86936950683594,16395,3222,13173,13173,0,11,2890000.0
2890,2890999,20.719757053692447,36.456922228486555,0.08075937385423138,418.23200726509094,191.3688395023346,441.9590606689453,16397,3223,13174,13174,0,11,2891000.0
2891,2891999,20.718424179991672,36.45851588567505,0.08072911395081661,418.3640720844269,191.43634343147278,442.6476707458496,16423,3223,13200,13200,0,11,2892000.0
2892,2892999,20.71595836769014,36.45566685800346,0.08074243122438463,418.5288631916046,191.50305223464966,442.9027633666992,16436,3224,13212,13212,0,11,2893000.0
2893,2893999,20.71347230804325,36.45124865341708,0.08077371243113585,418.6454906463623,191.56975889205933,443.1091651916504,16437,3224,13213,13213,0,11,2894000.0
2894,2894999,20.71194551267695,36.449437931966365,0.08079148989434626,418.7979140281677,191.63573360443115,443.463191986084,16447,3225,13222,13222,0,11,2895000.0
2895,2895999,20.709991777578583,36.44635764851307,0.0808036954335184,418.90897822380066,191.70205807685852,443.65322494506836,16447,3225,13222,13222,0,11,2896000.0
2896,2896999,20.70798694550666,36.443099945696346,0.0808145195852803,419.0656113624573,191.76795887947083,443.7854919433594,16450,3226,13224,13224,0,11,2897000.0
2897,2897999,20.7056699819997,36.43919965007552,0.08082756087720999,419.2580907344818,191.83417129516602,443.9030075073242,16455,3228,13227,13227,0,11,2898000.0
2898,2898999,20.70365528227275,36.43570423942968,0.08084312814400141,419.4540023803711,191.90080857276917,444.1111831665039,16462,3230,13232,13232,0,11,2899000.0
2899,2899999,20.70209252811149,36.433288261582675,0.08083558649016542,419.6044690608978,191.96683263778687,444.3802680969238,16470,3231,13239,13239,0,11,2900000.0
2900,2900999,20.701407199935993,36.43173456087398,0.08081099322712149,419.7643656730652,192.03258204460144,444.53476333618164,16472,3232,13240,13240,0,11,2901000.0
2901,2901999,20.700049029459418,36.429042937095346,0.08080966865774075,420.07120537757874,192.0999231338501,444.51672744750977,16496,3237,13259,13259,0,11,2902000.0
2902,2902999,20.69938329134457,36.427130846698454,0.08080699380648426,420.2700011730194,192.1669464111328,444.5938606262207,16501,3239,13262,13262,0,11,2903000.0
2903,2903999,20.6991687207673,36.428780511425295,0.08078327925075635,420.4313886165619,192.23273730278015,444.7453308105469,16504,3240,13264,13264,0,11,2904000.0
2904,2904999,20.698890679000915,36.42723126186213,0.08076756847954703,420.60835361480713,192.3096890449524,445.07253646850586,16514,3241,13273,13273,0,11,2905000.0
2905,2905999,20.6988889720266,36.42630289983987,0.08075294328964999,420.8351695537567,192.37567949295044,445.1862030029297,16521,3244,13277,13277,0,11,2906000.0
2906,2906999,20.698932421853563,36.42559548148896,0.08075406963042953,421.06400775909424,192.44249653816223,445.29867935180664,16527,3247,13280,13280,0,11,2907000.0
2907,2907999,20.698181314630904,36.42538814467106,0.08073916088044697,421.21972012519836,192.50899934768677,445.4308319091797,16529,3248,13281,13281,0,11,2908000.0
2908,2908999,20.695240055196464,36.4207196743955,0.08077021678621599,421.33470845222473,192.5741367340088,445.8893394470215,16540,3248,13292,13292,0,11,2909000.0
2909,2909999,20.692468662167045,36.418237809822266,0.08079036264291795,421.4871435165405,192.63861107826233,446.03831481933594,16544,3249,13295,13295,0,11,2910000.0
2910,2910999,20.689841243824237,36.41519924294286,0.08081772062053372,421.6856110095978,192.70345211029053,446.1204528808594,16559,3251,13308,13308,0,11,2911000.0
2911,2911999,20.687218511156544,36.41226788290092,0.08084622888230075,421.8416414260864,192.76918053627014,446.4199981689453,16563,3252,13311,13311,0,11,2912000.0
2912,2912999,20.68399731131366,36.408169210064095,0.08088491700961453,422.0070550441742,192.83450412750244,446.60540771484375,16565,3253,13312,13312,0,11,2913000.0
2913,2913999,20.68114566655491,36.40439059088003,0.08090725524922415,422.2409017086029,192.90154385566711,446.6989059448242,16572,3256,13316,13316,0,11,2914000.0
2914,2914999,20.678455041384453,36.400839318989355,0.08092448847647138,422.4007623195648,192.96670174598694,446.8415985107422,16574,3257,13317,13317,0,11,2915000.0
2915,2915999,20.676804740217335,36.40074791140057,0.08091561385403079,422.52560091018677,193.03179955482483,447.0199661254883,16576,3257,13319,13319,0,11,2916000.0
2916,2916999,20.675851113976233,36.40147327536591,0.08088926477166691,422.647935628891,193.09719920158386,447.22216033935547,16580,3257,13323,13323,0,11,2917000.0
2917,2917999,20.675252855173234,36.402407547869046,0.0808697035640703,422.81551146507263,193.16266798973083,447.4048271179199,16586,3258,13328,13328,0,11,2918000.0
2918,2918999,20.67589900405437,36.40372150457195,0.0808583352372908,423.0113854408264,193.22762179374695,447.52426528930664,16591,3260,13331,13331,0,11,2919000.0
2919,2919999,20.675791824393947,36.40354805968449,0.0808472184497534,423.1371169090271,193.29276394844055,447.6767997741699,16591,3260,13331,13331,0,11,2920000.0
2920,2920999,20.6759805427689,36.40397172495211,0.0808368549038525,423.3493356704712,193.35844039916992,447.73702239990234,16595,3262,13333,13333,0,11,2921000.0
2921,2921999,20.675909013093822,36.403317001008,0.08082930276469724,423.4612526893616,193.42377996444702,447.8755989074707,16596,3262,13334,13334,0,11,2922000.0
2922,2922999,20.67606907711751,36.40279721259414,0.08082284601896106,423.6025273799896,193.49548935890198,447.9668197631836,16596,3262,13334,13334,0,11,2923000.0
2923,2923999,20.676406756152925,36.404877501458635,0.08081318481374122,423.7556531429291,193.56076979637146,448.1905097961426,16602,3263,13339,13339,0,11,2924000.0
2924,2924999,20.677209525664765,36.404574415489414,0.08080651840743058,423.9740626811981,193.62670278549194,448.1989631652832,16609,3265,13344,13344,0,11,2925000.0
2925,2925999,20.676431096638897,36.401672140720834,0.08080944183607786,424.17118859291077,193.69172382354736,448.26051330566406,16613,3267,13346,13346,0,11,2926000.0
2926,2926999,20.675843563757816,36.399431699032945,0.08080273951546402,424.44328689575195,193.757408618927,448.26710510253906,16626,3271,13355,13355,0,11,2927000.0
2927,2927999,20.674096155894052,36.396164244226156,0.08078906242662953,424.5669295787811,193.8222782611847,448.537410736084,16630,3271,13359,13359,0,11,2928000.0
2928,2928999,20.671112993864362,36.3921052304263,0.08080340175712553,424.76135301589966,193.88855743408203,448.8843765258789,16648,3273,13375,13375,0,11,2929000.0
2929,2929999,20.66772193062451,36.38793954886619,0.08081865333484439,424.9227066040039,193.9540731906891,449.0080108642578,16662,3274,13388,13388,0,11,2930000.0
2930,2930999,20.66440140643212,36.383114830216606,0.08083801600915252,425.05053520202637,194.019606590271,449.1387939453125,16664,3274,13390,13390,0,11,2931000.0
2931,2931999,20.661342415042242,36.379215950406085,0.08085411877212967,425.20568108558655,194.0857229232788,449.2448425292969,16667,3275,13392,13392,0,11,2932000.0
2932,2932999,20.658947132932788,36.37510060068218,0.08085366019541995,425.33696961402893,194.15141558647156,449.50083923339844,16671,3275,13396,13396,0,11,2933000.0
2933,2933999,20.656512113930102,36.37085697294084,0.08086486604154919,425.45086765289307,194.21631741523743,449.69153213500977,16672,3275,13397,13397,0,11,2934000.0
2934,2934999,20.65423108621448,36.36737580578977,0.080866199427865,425.64524102211,194.2818727493286,449.75625228881836,16676,3277,13399,13399,0,11,2935000.0
2935,2935999,20.651647231830196,36.36323961290843,0.08087285226978924,425.8012185096741,194.34844398498535,449.8882865905762,16679,3278,13401,13401,0,11,2936000.0
2936,2936999,20.64949502363645,36.360350957825105,0.08087520555375616,425.96998858451843,195.95448803901672,449.99414825439453,16682,3279,13403,13403,0,11,2937000.0
2937,2937999,20.648106823923506,36.359591137976906,0.0808800936871319,426.1371166706085,196.0217263698578,450.16006088256836,16689,3280,13409,13409,0,11,2938000.0
2938,2938999,20.648151352521456,36.361654906236545,0.08086719276482301,426.2640037536621,196.08775782585144,450.4429512023926,16693,3280,13413,13413,0,11,2939000.0
2939,2939999,20.64884997880893,36.371382492589035,0.0808238169150155,426.50846457481384,196.1537778377533,450.5423889160156,16702,3283,13419,13419,0,11,2940000.0
2940,2940999,20.650121937426146,36.37711348543079,0.0808103058127716,426.70972657203674,196.22009825706482,450.66932678222656,16706,3285,13421,13421,0,11,2941000.0
2941,2941999,20.651030943593685,36.380305671629,0.08082547824033126,426.8700280189514,196.28623509407043,450.8238639831543,16708,3286,13422,13422,0,11,2942000.0
2942,2942999,20.651254032802694,36.38104877122545,0.08082537750042473,427.039519071579,196.3538281917572,450.9320869445801,16711,3287,13424,13424,0,11,2943000.0
2943,2943999,20.652456875010547,36.38321958598821,0.0808201818644173,427.2045781612396,196.41991424560547,451.1027488708496,16718,3288,13430,13430,0,11,2944000.0
2944,2944999,20.65290797190742,36.38370594658855,0.08081863480740481,427.37294340133667,196.48709416389465,451.43281173706055,16729,3289,13440,13440,0,11,2945000.0
2945,2945999,20.654398973669622,36.38649830697656,0.08083138666225553,427.5792202949524,196.5532398223877,451.5956153869629,16733,3291,13442,13442,0,11,2946000.0
2946,2946999,20.654120645096807,36.38556229951072,0.0808468315819666,427.6966779232025,196.61929535865784,451.7936553955078,16733,3291,13442,13442,0,11,2947000.0
2947,2947999,20.65357906294554,36.38412017250724,0.08087739153920726,427.9022595882416,196.68548488616943,451.887264251709,16738,3293,13445,13445,0,11,2948000.0
2948,2948999,20.6526709600369,36.38604308468315,0.08088119588639742,428.0638236999512,196.75225257873535,452.24076080322266,16749,3294,13455,13455,0,11,2949000.0
2949,2949999,20.649981127828568,36.38494886690965,0.08088794586931658,428.2975208759308,196.81748294830322,452.34848403930664,16756,3297,13459,13459,0,11,2950000.0
2950,2950999,20.647433250367666,36.38354362733935,0.08089575695662754,428.45761728286743,196.8828341960907,452.46873474121094,16759,3298,13461,13461,0,11,2951000.0
2951,2951999,20.645561457041747,36.382710471359225,0.08089859026890822,428.5882649421692,196.94807648658752,452.61911392211914,16761,3298,13463,13463,0,11,2952000.0
2952,2952999,20.644754632568333,36.38416125372274,0.08089610549844284,428.79407024383545,197.01409792900085,452.67882537841797,16765,3300,13465,13465,0,11,2953000.0
2953,2953999,20.645523891961297,36.38775044810824,0.08087286486607148,428.92227029800415,197.0819592475891,452.8920783996582,16767,3300,13467,13467,0,11,2954000.0
2954,2954999,20.645569013164277,36.38866645067864,0.08086649339041307,429.04903745651245,197.14689087867737,452.9974060058594,16767,3300,13467,13467,0,11,2955000.0
2955,2955999,20.645349618208524,36.389043386565376,0.08087484277202728,429.17472672462463,197.2125334739685,453.07994842529297,16767,3300,13467,13467,0,11,2956000.0
2956,2956999,20.645508812585604,36.395582882988954,0.0808446333643058,429.3467791080475,197.27801156044006,453.1273994445801,16770,3301,13469,13469,0,11,2957000.0
2957,2957999,20.645390902254615,36.39526233129201,0.08085001130025304,429.5597896575928,197.3438274860382,453.1408004760742,16777,3303,13474,13474,0,11,2958000.0
2958,2958999,20.644965847973456,36.39443584820674,0.08088202672742939,429.7717237472534,197.40980339050293,453.20510482788086,16783,3305,13478,13478,0,11,2959000.0
2959,2959999,20.644608009657773,36.392933993586475,0.0808774084602093,429.9322073459625,197.47534561157227,453.3903923034668,16787,3306,13481,13481,0,11,2960000.0
2960,2960999,20.644826202646698,36.39308024677652,0.08088316409862695,430.13985323905945,197.54285550117493,453.48447036743164,16820,3308,13512,13512,0,11,2961000.0
2961,2961999,20.64552715212438,36.39692630672233,0.08088704861412321,430.30748176574707,197.608327627182,453.46546936035156,16822,3309,13513,13513,0,11,2962000.0
2962,2962999,20.64598211483902,36.39659259030781,0.080919193402049,430.47178173065186,197.67419481277466,453.55059814453125,16825,3310,13515,13515,0,11,2963000.0
2963,2963999,20.64753416949268,36.398133503186465,0.08095039326894693,430.59790658950806,197.73976755142212,453.6915168762207,16826,3310,13516,13516,0,11,2964000.0
2964,2964999,20.64872444464992,36.39902637938371,0.080988978673451,430.77697920799255,197.80585503578186,453.90050888061523,16833,3311,13522,13522,0,11,2965000.0
2965,2965999,20.650940184920618,36.40088287828142,0.08101715187785474,430.93166494369507,197.87168192863464,454.06688690185547,16837,3312,13525,13525,0,11,2966000.0
2966,2966999,20.652266966379326,36.40087674454184,0.08105929013241142,431.1811649799347,197.93766331672668,454.12786865234375,16857,3315,13542,13542,0,11,2967000.0
2967,2967999,20.653057252515165,36.3996630645708,0.08108174866757212,431.39008021354675,198.0037956237793,454.2343978881836,16861,3317,13544,13544,0,11,2968000.0
2968,2968999,20.65264536877165,36.39746170891849,0.08110074242489085,431.5491337776184,198.06884837150574,454.3721809387207,16866,3318,13548,13548,0,11,2969000.0
2969,2969999,20.650082043006403,36.39326329849578,0.0811066104620024,431.7124345302582,198.13833928108215,455.0336799621582,16891,3319,13572,13572,0,11,2970000.0
2970,2970999,20.64767563697167,36.39057093567485,0.08110251311193062,431.8343496322632,198.20433259010315,455.3599090576172,16895,3319,13576,13576,0,11,2971000.0
2971,2971999,20.645247084042104,36.387521394347814,0.08110015276896043,431.9899892807007,198.27046251296997,455.552059173584,16914,3320,13594,13594,0,11,2972000.0
2972,2972999,20.64323096391864,36.386915718836256,0.08108479886677711,432.10881996154785,198.33634972572327,455.7184600830078,16914,3320,13594,13594,0,11,2973000.0
2973,2973999,20.640861761153847,36.383891378093054,0.08108416263961393,432.3165068626404,198.40267968177795,455.8656997680664,16922,3322,13600,13600,0,11,2974000.0
2974,2974999,20.638967537635466,36.38670639047357,0.08106061859597469,432.434428691864,198.4681134223938,456.10143280029297,16923,3322,13601,13601,0,11,2975000.0
2975,2975999,20.636864565676987,36.38317110525556,0.08105310431215884,432.5579710006714,198.53419137001038,456.2650566101074,16923,3322,13601,13601,0,11,2976000.0
2976,2976999,20.63462914719918,36.37927354911521,0.08105329919578297,432.71584391593933,198.59991931915283,456.33779525756836,16925,3323,13602,13602,0,11,2977000.0
2977,2977999,20.632682607926636,36.37570634313431,0.08104752938981186,432.9295337200165,198.66602420806885,456.38708877563477,16930,3325,13605,13605,0,11,2978000.0
2978,2978999,20.631227727879338,36.3732708889732,0.08103657890998828,433.05232334136963,198.73174715042114,456.5799369812012,16935,3325,13610,13610,0,11,2979000.0
2979,2979999,20.630174307328517,36.37165067675139,0.08100081101854784,433.252149105072,198.79819416999817,456.8249931335449,16951,3327,13624,13624,0,11,2980000.0
2980,2980999,20.630011329671692,36.370831843360556,0.0809802419697292,433.50000953674316,198.86510252952576,456.9484672546387,16975,3330,13645,13645,0,11,2981000.0
2981,2981999,20.629907829830238,36.370668667782226,0.08096161667332236,433.69125723838806,198.93113684654236,457.0856285095215,16991,3332,13659,13659,0,11,2982000.0
2982,2982999,20.630183656027818,36.37038738846782,0.08098174709021544,433.8964307308197,198.9973165988922,457.19963455200195,16995,3334,13661,13661,0,11,2983000.0
2983,2983999,20.630595455852927,36.37013529518933,0.08097798254339272,434.01526641845703,199.06325459480286,457.36682510375977,16996,3334,13662,13662,0,11,2984000.0
2984,2984999,20.63178662854216,36.37114803869525,0.0809677691206494,434.14246821403503,199.1301188468933,457.4928398132324,16996,3334,13662,13662,0,11,2985000.0
2985,2985999,20.633941874170667,36.3740538998115,0.08095140514926524,434.29884576797485,199.19582390785217,457.7384262084961,17002,3335,13667,13667,0,11,2986000.0
2986,2986999,20.635313913713066,36.37478718318054,0.08097627782783512,434.4572796821594,199.2607660293579,457.9116020202637,17004,3336,13668,13668,0,11,2987000.0
2987,2987999,20.63724041327016,36.376882104196824,0.0810017198565327,434.70155668258667,199.32663440704346,457.9940605163574,17010,3339,13671,13671,0,11,2988000.0
2988,2988999,20.640070314341248,36.38215864319601,0.0810275379636185,434.8577699661255,199.39187693595886,458.0979690551758,17012,3340,13672,13672,0,11,2989000.0
2989,2989999,20.640923559256958,36.38489022345894,0.08103618438706561,435.062212228775,199.46394085884094,458.1944274902344,17017,3342,13675,13675,0,11,2990000.0
2990,2990999,20.639248481007364,36.38446463075755,0.08102316991428782,435.2292060852051,199.53186678886414,458.96265411376953,17051,3343,13708,13708,0,11,2991000.0
2991,2991999,20.637349862022482,36.384167411483325,0.08100212530769202,435.3416860103607,199.59746742248535,459.2368354797363,17055,3343,13712,13712,0,11,2992000.0
2992,2992999,20.634639197393806,36.37997007167719,0.08100872487445976,435.46519351005554,199.66374850273132,459.4621696472168,17058,3343,13715,13715,0,11,2993000.0
2993,2993999,20.632235562485594,36.377237109901316,0.0810049617238735,435.5775010585785,199.72978615760803,459.6076545715332,17058,3343,13715,13715,0,11,2994000.0
2994,2994999,20.63016986268928,36.375005759312735,0.08099215572987906,435.7743148803711,199.79680132865906,459.76345443725586,17065,3345,13720,13720,0,11,2995000.0
2995,2995999,20.628018637166527,36.371152054078394,0.08099407993552188,435.8878347873688,199.86234617233276,460.02236557006836,17067,3345,13722,13722,0,11,2996000.0
2996,2996999,20.626457156510252,36.36850080733025,0.08098436950330634,436.16105937957764,199.92918515205383,460.0554008483887,17085,3349,13736,13736,0,11,2997000.0
2997,2997999,20.624669820434313,36.36518009729689,0.08098252654050808,436.35893392562866,199.9961142539978,460.2154426574707,17090,3351,13739,13739,0,11,2998000.0
2998,2998999,20.622735226453376,36.36189760724521,0.08098410800750111,436.5567123889923,200.06255674362183,460.3062286376953,17096,3353,13743,13743,0,11,2999000.0
2999,2999999,20.62175393674298,36.359627762590975,0.08097211384768221,436.75206565856934,200.1296739578247,460.5493812561035,17109,3355,13754,13754,0,11,3000000.0
3000,3000999,20.621049812706836,36.35765385137943,0.08097628662868828,436.913622379303,200.1964726448059,460.7903861999512,17115,3356,13759,13759,0,11,3001000.0
3001,3001999,20.62057790283318,36.355465258228016,0.08095431649430862,437.1073191165924,200.26347374916077,460.9336700439453,17121,3358,13763,13763,0,11,3002000.0
3002,3002999,20.620818102700046,36.35570739531921,0.08091331090850895,437.2703411579132,200.3293972015381,461.11408615112305,17126,3359,13767,13767,0,11,3003000.0
3003,3003999,20.621797362363914,36.356757978628416,0.080974133235034,437.389039516449,200.39502263069153,461.2783203125,17127,3359,13768,13768,0,11,3004000.0
3004,3004999,20.623809073634185,36.360697269425366,0.08106454339546576,437.54645109176636,200.4604687690735,461.3821258544922,17130,3360,13770,13770,0,11,3005000.0
3005,3005999,20.627554589324735,36.36970103712788,0.08112493065020376,437.9079477787018,200.52749037742615,461.33706283569336,17145,3366,13779,13779,0,11,3006000.0
3006,3006999,20.632193276177198,36.377573370544376,0.08121604050715459,438.0768413543701,200.59587621688843,461.75445556640625,17160,3367,13793,13793,0,11,3007000.0
3007,3007999,20.638897094896052,36.38940481833422,0.08130357708257507,438.1939151287079,200.6614384651184,462.0302314758301,17161,3367,13794,13794,0,11,3008000.0
3008,3008999,20.645540729081404,36.40250750876873,0.08151167696006789,438.3485770225525,200.72804474830627,462.21017837524414,17163,3368,13795,13795,0,11,3009000.0
3009,3009999,20.652254995146723,36.4118613916321,0.08166016112460717,438.5075318813324,200.79371786117554,462.3378562927246,17165,3369,13796,13796,0,11,3010000.0
3010,3010999,20.656115131868336,36.416397758577936,0.08170618108956496,438.6732819080353,200.86032724380493,462.56422424316406,17182,3370,13812,13812,0,11,3011000.0
3011,3011999,20.655641375320183,36.41997876774224,0.08162495163643602,438.7971143722534,200.92837238311768,463.45505142211914,17217,3370,13847,13847,0,11,3012000.0
3012,3012999,20.654012812097584,36.41908693378682,0.08161488769402614,438.9091613292694,200.99477100372314,463.7360191345215,17222,3370,13852,13852,0,11,3013000.0
3013,3013999,20.652725412639118,36.41702745082839,0.08160737181412758,439.0261723995209,201.06011581420898,463.9571990966797,17227,3370,13857,13857,0,11,3014000.0
3014,3014999,20.651126933512085,36.415146085513285,0.08159275654138554,439.1782965660095,201.12588262557983,464.1100654602051,17230,3371,13859,13859,0,11,3015000.0
3015,3015999,20.650302900622293,36.414374009580406,0.08157007330818122,439.30690336227417,201.1922733783722,464.3595390319824,17232,3371,13861,13861,0,11,3016000.0
3016,3016999,20.648764314316374,36.411779872664326,0.08156117345954095,439.5021824836731,201.25782752037048,464.4229927062988,17239,3373,13866,13866,0,11,3017000.0
3017,3017999,20.64751597872831,36.40891002625191,0.08155310394104687,439.67086386680603,201.32893180847168,464.54239654541016,17241,3374,13867,13867,0,11,3018000.0
3018,3018999,20.646008531241232,36.4060884105338,0.08155065485884938,439.80071234703064,201.39494919776917,464.6954803466797,17244,3374,13870,13870,0,11,3019000.0
3019,3019999,20.644303033642228,36.40287333598545,0.08154871461080626,439.9238212108612,201.4607367515564,464.8487358093262,17246,3374,13872,13872,0,11,3020000.0
3020,3020999,20.6432475479885,36.40008319473915,0.08154330497292572,440.23787784576416,201.52738761901855,464.9227828979492,17263,3379,13884,13884,0,11,3021000.0
3021,3021999,20.64273398069374,36.39830144917901,0.08152853026987417,440.4887464046478,201.5958399772644,465.047607421875,17281,3382,13899,13899,0,11,3022000.0
3022,3022999,20.642865767512376,36.398081424417164,0.08152169578813206,440.72672986984253,201.66269207000732,465.0812759399414,17287,3385,13902,13902,0,11,3023000.0
3023,3023999,20.643711262497945,36.39825016391399,0.08153701362151267,440.8838472366333,201.7289958000183,465.22807693481445,17302,3386,13916,13916,0,11,3024000.0
3024,3024999,20.644390865701407,36.39753936389311,0.08151806412572626,441.057950258255,201.79535007476807,465.2822265625,17333,3387,13946,13946,0,11,3025000.0
3025,3025999,20.64545734999819,36.40091758734761,0.0814757814644953,441.21765398979187,201.86298751831055,465.5080032348633,17339,3388,13951,13951,0,11,3026000.0
3026,3026999,20.646518610581303,36.40084578261579,0.08144228086192029,441.4176390171051,201.92945647239685,465.6060981750488,17346,3390,13956,13956,0,11,3027000.0
3027,3027999,20.64654009517513,36.39875682131136,0.08141540150993443,441.6132102012634,201.9954059123993,465.71788024902344,17350,3392,13958,13958,0,11,3028000.0
3028,3028999,20.64559066520532,36.39576878681173,0.08139597470905446,441.82516622543335,202.06269645690918,466.1201705932617,17402,3394,14008,14008,0,11,3029000.0
3029,3029999,20.644441037855927,36.397844775435765,0.08136766234886417,441.9469690322876,202.12900853157043,466.4541435241699,17410,3394,14016,14016,0,11,3030000.0
3030,3030999,20.642932893344145,36.39620084389195,0.08136694724834326,442.1235611438751,202.19581007957458,466.6675491333008,17416,3395,14021,14021,0,11,3031000.0
3031,3031999,20.642500169850116,36.39637277210419,0.08137376694378362,442.24194407463074,202.26163697242737,466.8125190734863,17417,3395,14022,14022,0,11,3032000.0
3032,3032999,20.64269515548289,36.396781181066295,0.08135818413703444,442.4064521789551,202.32849669456482,467.0372657775879,17423,3396,14027,14027,0,11,3033000.0
3033,3033999,20.6426221161594,36.39635483613965,0.081366388062727,442.52776432037354,202.39415526390076,467.21607208251953,17423,3396,14027,14027,0,11,3034000.0
3034,3034999,20.642131218359992,36.39590068816403,0.08136966422440006,442.72595024108887,202.4599368572235,467.2966613769531,17430,3398,14032,14032,0,11,3035000.0
3035,3035999,20.64248924882269,36.39584504000352,0.08139521879493627,442.8572554588318,202.52654337882996,467.4464912414551,17431,3398,14033,14033,0,11,3036000.0
3036,3036999,20.642701138987654,36.395165236475876,0.08141100061397188,443.0627372264862,202.59286093711853,467.51084899902344,17440,3400,14040,14040,0,11,3037000.0
3037,3037999,20.643505858731093,36.39711332728772,0.08142104734568467,443.18292713165283,202.6594090461731,467.65135955810547,17442,3400,14042,14042,0,11,3038000.0
3038,3038999,20.645350476646,36.40290665029503,0.08145314525153557,443.345144033432,202.72660422325134,467.8866882324219,17450,3401,14049,14049,0,11,3039000.0
3039,3039999,20.64738782637484,36.405904249501674,0.0815328459074458,443.5018162727356,202.7924644947052,468.03110122680664,17452,3402,14050,14050,0,11,3040000.0
3040,3040999,20.64906872280125,36.40780934946494,0.08158495800706544,443.71255254745483,202.85865569114685,468.0963821411133,17456,3404,14052,14052,0,11,3041000.0
3041,3041999,20.651888157782857,36.41371055591657,0.08166242792866607,443.8299603462219,202.9240334033966,468.2074089050293,17457,3404,14053,14053,0,11,3042000.0
3042,3042999,20.65613975353147,36.42812218171693,0.08171389254763028,443.9916753768921,202.99048924446106,468.29220962524414,17460,3405,14055,14055,0,11,3043000.0
3043,3043999,20.659852817225524,36.43568267046165,0.08181093216715674,444.1628053188324,203.05722641944885,468.3843765258789,17464,3406,14058,14058,0,11,3044000.0
3044,3044999,20.663742136916742,36.440101837540816,0.08192094182634646,444.2858922481537,203.12346196174622,468.75939178466797,17472,3406,14066,14066,0,11,3045000.0
3045,3045999,20.66782583351788,36.44371117155824,0.0820423177824704,444.44509959220886,203.18881034851074,468.89473724365234,17474,3407,14067,14067,0,11,3046000.0
3046,3046999,20.67210658993735,36.44837931069511,0.08216451962836702,444.56361413002014,203.25426959991455,469.0343704223633,17474,3407,14067,14067,0,11,3047000.0
3047,3047999,20.675880874147765,36.45442852498645,0.08225241347213441,444.7649414539337,203.32103204727173,469.06806564331055,17478,3409,14069,14069,0,11,3048000.0
3048,3048999,20.675610924939807,36.452981331937664,0.0822675431996277,444.96137857437134,203.38773441314697,469.3704528808594,17496,3411,14085,14085,0,11,3049000.0
3049,3049999,20.673572228365337,36.4518380794855,0.0822590156443832,445.11298966407776,203.45198249816895,469.52162170410156,17499,3412,14087,14087,0,11,3050000.0
3050,3050999,20.671700446708062,36.450802404272586,0.08225864436424568,445.2699704170227,203.51625776290894,469.64580154418945,17503,3413,14090,14090,0,11,3051000.0
3051,3051999,20.67015383685652,36.44846203022384,0.08225331151280924,445.4670913219452,203.58109951019287,469.8521308898926,17544,3415,14129,14129,0,11,3052000.0
3052,3052999,20.668828956355092,36.447279255935165,0.08223236666638667,445.632178068161,203.64631962776184,469.9546241760254,17546,3416,14130,14130,0,11,3053000.0
3053,3053999,20.66736907344139,36.44445864357988,0.08223244762891657,445.8000030517578,203.71125841140747,470.13391494750977,17550,3417,14133,14133,0,11,3054000.0
3054,3054999,20.66644890326609,36.44266125122789,0.0822239692474721,445.99707078933716,203.77618598937988,470.2096061706543,17554,3419,14135,14135,0,11,3055000.0
3055,3055999,20.66573739978059,36.44053782838824,0.08221899133610189,446.12417101860046,203.84143948554993,470.38805389404297,17554,3419,14135,14135,0,11,3056000.0
3056,3056999,20.66530456005548,36.43895100150324,0.08221542400946447,446.27761459350586,203.90591597557068,470.46552658081055,17557,3420,14137,14137,0,11,3057000.0
3057,3057999,20.66538846163053,36.43810413357412,0.08221986067170117,446.4085204601288,203.97197651863098,470.6441535949707,17560,3420,14140,14140,0,11,3058000.0
3058,3058999,20.666195170905613,36.43841953629945,0.08222051471034797,446.61549401283264,204.03676533699036,470.6577835083008,17564,3422,14142,14142,0,11,3059000.0
3059,3059999,20.669090421645638,36.44308932685965,0.0822558419881203,446.8302433490753,204.10213589668274,470.6993942260742,17570,3424,14146,14146,0,11,3060000.0
3060,3060999,20.67139343436106,36.44658996570832,0.08229799152532147,446.99036049842834,204.1672327518463,470.83415603637695,17572,3425,14147,14147,0,11,3061000.0
3061,3061999,20.67392977587009,36.4502503229656,0.08236426193180002,447.15733647346497,204.23192262649536,470.87036514282227,17577,3426,14151,14151,0,11,3062000.0
3062,3062999,20.677401187099097,36.45902949693704,0.08242084481355594,447.27766847610474,204.29814887046814,470.99990463256836,17578,3426,14152,14152,0,11,3063000.0
3063,3063999,20.682429923812133,36.4695232963983,0.08252651387193788,447.4757511615753,204.36295199394226,471.0810127258301,17584,3428,14156,14156,0,11,3064000.0
3064,3064999,20.68680759776716,36.476545815093225,0.082632250211785,447.7248752117157,204.4285306930542,471.22927474975586,17596,3431,14165,14165,0,11,3065000.0
3065,3065999,20.6908113419177,36.480862251606084,0.0827592298950629,447.8446514606476,204.49281930923462,471.4254455566406,17596,3431,14165,14165,0,11,3066000.0
3066,3066999,20.69466515582721,36.48518622894427,0.08287760409386546,448.0425250530243,204.55837535858154,471.5130310058594,17600,3433,14167,14167,0,11,3067000.0
3067,3067999,20.698370348563337,36.488561812771216,0.08295015173786469,448.20229291915894,204.62317895889282,471.60485076904297,17602,3434,14168,14168,0,11,3068000.0
3068,3068999,20.700101124345178,36.488972007672615,0.08295331561206987,448.3188407421112,204.68771243095398,471.73350524902344,17604,3434,14170,14170,0,11,3069000.0
3069,3069999,20.698394651398857,36.48916805633237,0.08293306182456961,448.4719476699829,204.75330543518066,472.2203598022461,17635,3435,14200,14200,0,11,3070000.0
3070,3070999,20.696392942826492,36.48752364682238,0.08292933013209891,448.6281690597534,204.81829810142517,472.34156799316406,17641,3436,14205,14205,0,11,3071000.0
3071,3071999,20.694537255594284,36.48518586381543,0.08293132665805614,448.74834299087524,204.88369512557983,472.5236358642578,17643,3436,14207,14207,0,11,3072000.0
3072,3072999,20.6927955426404,36.48470757629768,0.08291311410897118,448.9126489162445,204.9490315914154,472.6039810180664,17645,3437,14208,14208,0,11,3073000.0
3073,3073999,20.691139282812912,36.48149882559666,0.08289483424668442,449.0339500904083,205.01411986351013,472.89166259765625,17650,3437,14213,14213,0,11,3074000.0
3074,3074999,20.689564035841855,36.48070487457866,0.08288121176721497,449.1612751483917,205.08832216262817,473.07900619506836,17651,3437,14214,14214,0,11,3075000.0
3075,3075999,20.68811160492631,36.47860800713268,0.08286820930007843,449.4428606033325,205.15420627593994,473.10406494140625,17660,3441,14219,14219,0,11,3076000.0
3076,3076999,20.686741441967666,36.476343165709515,0.08286473047873977,449.6012182235718,205.21920013427734,473.2943115234375,17663,3442,14221,14221,0,11,3077000.0
3077,3077999,20.685405246373982,36.47392956456301,0.08286680122240919,449.71753573417664,205.28349685668945,473.45951080322266,17665,3442,14223,14223,0,11,3078000.0
3078,3078999,20.685083993577823,36.47373193470451,0.08284126282815518,449.8375635147095,205.3489363193512,473.6044616699219,17667,3442,14225,14225,0,11,3079000.0
3079,3079999,20.684936718097184,36.47291660163572,0.08282905786512651,450.0888509750366,205.41485452651978,473.84088134765625,17680,3445,14235,14235,0,11,3080000.0
3080,3080999,20.685391268918384,36.47285879923329,0.08281381243857222,450.20355701446533,205.47916841506958,474.0217056274414,17680,3445,14235,14235,0,11,3081000.0
3081,3081999,20.685373294087853,36.47157399295566,0.08280248637319287,450.3300266265869,205.54404211044312,474.1556282043457,17680,3445,14235,14235,0,11,3082000.0
3082,3082999,20.68608038707051,36.47221684047784,0.08279701546507934,450.4834520816803,205.60874438285828,474.24633026123047,17683,3446,14237,14237,0,11,3083000.0
3083,3083999,20.686592133149627,36.47213567453461,0.08279035021878978,450.649600982666,205.67360043525696,474.35598373413086,17689,3447,14242,14242,0,11,3084000.0
3084,3084999,20.68697580194179,36.47106335095899,0.08279281917689318,450.8866922855377,205.73890233039856,474.43025970458984,17701,3450,14251,14251,0,11,3085000.0
3085,3085999,20.68830888644539,36.4713552733105,0.08277356125774016,451.07953357696533,205.804194688797,474.7580757141113,17714,3452,14262,14262,0,11,3086000.0
3086,3086999,20.689045800575077,36.47072968544314,0.08276205106268031,451.3128535747528,205.86954069137573,474.82735443115234,17720,3455,14265,14265,0,11,3087000.0
3087,3087999,20.689410001488678,36.46919329863697,0.08273749410911657,451.4799876213074,205.93448305130005,474.9338836669922,17722,3456,14266,14266,0,11,3088000.0
3088,3088999,20.689428576401824,36.46712959255464,0.08272499609617678,451.63115406036377,205.99984622001648,475.0800323486328,17724,3457,14267,14267,0,11,3089000.0
3089,3089999,20.68803143340669,36.46370588159282,0.08272228822828886,451.7933557033539,206.06531929969788,475.4319038391113,17741,3458,14283,14283,0,11,3090000.0
3090,3090999,20.68529849725625,36.46028864012097,0.0827302582126308,451.90512919425964,206.12977409362793,475.64581298828125,17741,3458,14283,14283,0,11,3091000.0
3091,3091999,20.68240944457683,36.45664962522155,0.08274200822902489,452.0631411075592,206.19561052322388,475.7717170715332,17745,3459,14286,14286,0,11,3092000.0
3092,3092999,20.68019135577659,36.45515710275,0.08274318920313384,452.2223742008209,206.2602322101593,475.91453552246094,17749,3460,14289,14289,0,11,3093000.0
3093,3093999,20.677762270032048,36.45178203634662,0.08274180256787189,452.390501499176,206.32530117034912,476.0489845275879,17751,3461,14290,14290,0,11,3094000.0
3094,3094999,20.67535098029964,36.4486888357534,0.08274145382734666,452.5552170276642,206.3903293609619,476.35372161865234,17758,3462,14296,14296,0,11,3095000.0
3095,3095999,20.672774197531606,36.444751596922536,0.08274590270252602,452.7554624080658,206.4554316997528,476.54010009765625,17772,3464,14308,14308,0,11,3096000.0
3096,3096999,20.671098256281024,36.44386620086586,0.0827296800570907,452.8736050128937,206.51984906196594,476.69224548339844,17772,3464,14308,14308,0,11,3097000.0
3097,3097999,20.669512177566915,36.44278383737559,0.08271774336185378,453.1187620162964,206.58542728424072,476.7280616760254,17784,3467,14317,14317,0,11,3098000.0
3098,3098999,20.66829489534942,36.440617359563646,0.08270448347488102,453.2903742790222,206.65174388885498,476.9476661682129,17792,3468,14324,14324,0,11,3099000.0
3099,3099999,20.666846413701666,36.43853026366316,0.08268846706173472,453.4421844482422,206.71648812294006,477.0870361328125,17795,3469,14326,14326,0,11,3100000.0
3100,3100999,20.666711594288643,36.43813051335069,0.08267217590930798,453.6147835254669,206.78197765350342,477.4203643798828,17806,3470,14336,14336,0,11,3101000.0
3101,3101999,20.666870006090857,36.43930424484787,0.08266118980148485,453.80883836746216,206.84729266166687,477.58337020874023,17813,3472,14341,14341,0,11,3102000.0
3102,3102999,20.66726310668715,36.43962351935687,0.08265369676585654,454.0192596912384,206.9137144088745,477.6097068786621,17817,3474,14343,14343,0,11,3103000.0
3103,3103999,20.667783592125605,36.44046637072643,0.082622901328398,454.2185859680176,206.97926807403564,477.7520446777344,17822,3476,14346,14346,0,11,3104000.0
3104,3104999,20.667921165461888,36.43984337960038,0.08259905145442958,454.34571647644043,207.04468202590942,477.9379425048828,17824,3476,14348,14348,0,11,3105000.0
3105,3105999,20.66895345973855,36.440680032966306,0.08258400410509004,454.5147969722748,207.11044764518738,478.1758918762207,17834,3477,14357,14357,0,11,3106000.0
3106,3106999,20.669610204597603,36.44107091370205,0.08257319604443114,454.6348502635956,207.17536616325378,478.5068473815918,17839,3477,14362,14362,0,11,3107000.0
3107,3107999,20.671001567462774,36.442748448860335,0.0825711706920087,454.8856201171875,207.241219997406,478.56911849975586,17847,3480,14367,14367,0,11,3108000.0
3108,3108999,20.672157601209253,36.44298124467925,0.08256666108965949,455.04389548301697,207.30683827400208,478.73558044433594,17849,3481,14368,14368,0,11,3109000.0
3109,3109999,20.67243339698111,36.44184697764004,0.08257925205619376,455.2723274230957,207.3733732700348,478.8163757324219,17856,3484,14372,14372,0,11,3110000.0
3110,3110999,20.670949666728287,36.43970326565949,0.08257201891748989,455.39194536209106,207.43972754478455,479.5388298034668,17882,3484,14398,14398,0,11,3111000.0
3111,3111999,20.668445546387286,36.436273353586046,0.08257132005290047,455.551274061203,207.5056540966034,479.7787628173828,17888,3485,14403,14403,0,11,3112000.0
3112,3112999,20.666164165308434,36.43377853326836,0.08256858946971901,455.66759610176086,207.5718276500702,480.02806091308594,17893,3485,14408,14408,0,11,3113000.0
3113,3113999,20.663769508759444,36.43046615002587,0.08257203447338457,455.86685729026794,207.63720321655273,480.15485763549805,17930,3487,14443,14443,0,11,3114000.0
3114,3114999,20.66148591819486,36.42686639852477,0.08257243882927512,455.996586561203,207.70281147956848,480.4068489074707,17934,3487,14447,14447,0,11,3115000.0
3115,3115999,20.659722351302744,36.42540190827677,0.08255910631962071,456.1950886249542,207.7682981491089,480.5885353088379,17939,3489,14450,14450,0,11,3116000.0
3116,3116999,20.658243953516394,36.42350119022603,0.08255996125126097,456.39253306388855,207.83354330062866,480.6931343078613,17946,3491,14455,14455,0,11,3117000.0
3117,3117999,20.656899020483117,36.42124299312608,0.08256036912184395,456.5524687767029,207.89873814582825,480.8363914489746,17951,3492,14459,14459,0,11,3118000.0
3118,3118999,20.6557246109833,36.41936714067505,0.0825621919986691,456.757954120636,207.96491312980652,480.9393768310547,17958,3494,14464,14464,0,11,3119000.0
3119,3119999,20.65509241572613,36.41832443693127,0.08256222297462446,456.9152090549469,208.03162908554077,481.11730194091797,17964,3495,14469,14469,0,11,3120000.0
3120,3120999,20.65508120073075,36.419008117174585,0.08257506783976332,457.0899221897125,208.09774470329285,481.2660903930664,17971,3496,14475,14475,0,11,3121000.0
3121,3121999,20.65506671863921,36.418310408550056,0.08259183111905244,457.25859785079956,208.16419625282288,481.7067451477051,17987,3497,14490,14490,0,11,3122000.0
3122,3122999,20.65523974594227,36.41921512465393,0.08260042268236789,457.41467475891113,208.22951745986938,481.8207550048828,17989,3498,14491,14491,0,11,3123000.0
3123,3123999,20.65602582223224,36.420772391400554,0.08260478121534465,457.5662217140198,208.29499459266663,481.9289665222168,17991,3499,14492,14492,0,11,3124000.0
3124,3124999,20.656759508118217,36.42152291303431,0.08261860934500187,457.7005009651184,208.36051034927368,482.0734634399414,17992,3499,14493,14493,0,11,3125000.0
3125,3125999,20.657677282001742,36.42297565066924,0.08263845966244965,457.913046836853,208.42681980133057,482.12000274658203,17996,3501,14495,14495,0,11,3126000.0
3126,3126999,20.657954152737542,36.42244734370799,0.0826595420744588,458.06812715530396,208.4925000667572,482.32784271240234,18002,3502,14500,14500,0,11,3127000.0
3127,3127999,20.658620989506232,36.421852564716254,0.08266629438527584,458.17951941490173,208.55708360671997,482.5366973876953,18002,3502,14500,14500,0,11,3128000.0
3128,3128999,20.659433635092505,36.42156083737998,0.08267182181721933,458.3827509880066,208.62250399589539,482.5938034057617,18006,3504,14502,14502,0,11,3129000.0
3129,3129999,20.65939728683376,36.42000502577375,0.08268514575682362,458.6221671104431,208.68833947181702,482.6877136230469,18012,3507,14505,14505,0,11,3130000.0
3130,3130999,20.658738377883797,36.41763058703517,0.08269236797614776,458.83438324928284,208.75415921211243,482.8452262878418,18021,3509,14512,14512,0,11,3131000.0
3131,3131999,20.657622760618146,36.41965301447712,0.08266244775216947,458.9581079483032,208.82036352157593,483.44617080688477,18044,3509,14535,14535,0,11,3132000.0
3132,3132999,20.655234311585254,36.41634212414844,0.08265381963321294,459.0786340236664,208.88548278808594,483.6510772705078,18046,3509,14537,14537,0,11,3133000.0
3133,3133999,20.65304182065492,36.41332235492201,0.08264513303017573,459.19677925109863,208.95182156562805,483.8614807128906,18049,3509,14540,14540,0,11,3134000.0
3134,3134999,20.651243130939957,36.41249249844376,0.08262373540718915,459.31448888778687,209.0168673992157,483.96934509277344,18049,3509,14540,14540,0,11,3135000.0
3135,3135999,20.6499930952931,36.41123026137855,0.08261908899650072,459.49175810813904,209.0910723209381,484.099853515625,18053,3510,14543,14543,0,11,3136000.0
3136,3136999,20.64902688568857,36.41014336580958,0.08259754080461434,459.65932512283325,209.1572778224945,484.3859405517578,18059,3511,14548,14548,0,11,3137000.0
3137,3137999,20.648204841925246,36.408813305228506,0.08258033508078544,459.78633427619934,209.2225489616394,484.5438003540039,18060,3511,14549,14549,0,11,3138000.0
3138,3138999,20.64773030233135,36.4084858175076,0.08256397354667577,459.89837431907654,209.28790712356567,484.65807723999023,18060,3511,14549,14549,0,11,3139000.0
3139,3139999,20.64793258659167,36.40835906555051,0.0825631480830471,460.0596504211426,209.35324001312256,484.75830459594727,18063,3512,14551,14551,0,11,3140000.0
3140,3140999,20.64936941169518,36.41601853597188,0.0825475802548421,460.1908013820648,209.41882419586182,484.8945655822754,18065,3512,14553,14553,0,11,3141000.0
3141,3141999,20.652890303352635,36.424014494508114,0.0825723801432664,460.3103291988373,209.4839539527893,485.0566635131836,18068,3512,14556,14556,0,11,3142000.0
3142,3142999,20.659612046413173,36.43863341068532,0.08262118537929164,460.44040083885193,209.5515034198761,485.3114585876465,18071,3512,14559,14559,0,11,3143000.0
3143,3143999,20.66773009556087,36.467710871540795,0.08266632230235593,460.6002907752991,209.61629676818848,485.4266052246094,18078,3513,14565,14565,0,11,3144000.0
3144,3144999,20.67640083121472,36.492266188814455,0.08280430414116136,460.76034331321716,209.6813566684723,485.5187530517578,18095,3514,14581,14581,0,11,3145000.0
3145,3145999,20.687377008276826,36.52663868823142,0.08289719056087586,460.9272906780243,209.74727606773376,485.6204719543457,18113,3515,14598,14598,0,11,3146000.0
3146,3146999,20.69995251251811,36.56436280001145,0.08311958692971533,461.1376669406891,209.8125855922699,485.7203063964844,18134,3517,14617,14617,0,11,3147000.0
3147,3147999,20.712474957223513,36.60020778318854,0.0832762048897564,461.2983043193817,209.87841629981995,486.08765411376953,18148,3518,14630,14630,0,11,3148000.0
3148,3148999,20.723497925578325,36.62417921509977,0.08347205735108454,461.4647660255432,209.9442217350006,486.26264572143555,18153,3519,14634,14634,0,11,3149000.0
3149,3149999,20.73454514743417,36.64975015563034,0.08375635249997326,461.6683807373047,210.01007270812988,486.35276794433594,18158,3521,14637,14637,0,11,3150000.0
3150,3150999,20.745350956606423,36.674648989228835,0.08401537523726477,461.8310248851776,210.075270652771,486.5420227050781,18162,3522,14640,14640,0,11,3151000.0
3151,3151999,20.75293955130754,36.691084594131844,0.08402213068235376,461.94834446907043,210.1427526473999,487.22900390625,18191,3522,14669,14669,0,11,3152000.0
3152,3152999,20.75258427408768,36.696578480001165,0.08394482148015558,462.11035442352295,210.2096028327942,487.57826232910156,18205,3523,14682,14682,0,11,3153000.0
3153,3153999,20.751480089639763,36.69563096047847,0.08392592321382042,462.22932529449463,210.27544784545898,487.8598937988281,18209,3523,14686,14686,0,11,3154000.0
3154,3154999,20.750487406199852,36.69500010798233,0.08391816916043582,462.3866066932678,210.3409960269928,488.02503204345703,18242,3524,14718,14718,0,11,3155000.0
3155,3155999,20.7497999041387,36.69425760265667,0.08388737913314182,462.55075573921204,210.40785026550293,488.29387283325195,18247,3525,14722,14722,0,11,3156000.0
3156,3156999,20.748983255672428,36.69291596508133,0.08387401470659694,462.6701879501343,210.4789502620697,488.48143768310547,18247,3525,14722,14722,0,11,3157000.0
3157,3157999,20.747727887811724,36.69036330239665,0.08386623560155337,462.8838105201721,210.5451717376709,488.5148696899414,18251,3527,14724,14724,0,11,3158000.0
3158,3158999,20.74737773612218,36.69489971093808,0.08381955752257408,463.04118299484253,210.61201977729797,488.64466857910156,18253,3528,14725,14725,0,11,3159000.0
3159,3159999,20.746317512790334,36.69280281516526,0.08380547586413956,463.2520360946655,210.6781907081604,488.7740821838379,18261,3530,14731,14731,0,11,3160000.0
3160,3160999,20.745725902013774,36.691460437288406,0.08377949912462124,463.4176347255707,210.74546146392822,488.890079498291,18264,3531,14733,14733,0,11,3161000.0
3161,3161999,20.745036559845,36.68987902281117,0.08376395487602561,463.61822414398193,210.8123300075531,489.1702766418457,18277,3533,14744,14744,0,11,3162000.0
3162,3162999,20.74517107708164,36.690118602006635,0.08373268661660938,463.832510471344,210.88122415542603,489.3100357055664,18285,3535,14750,14750,0,11,3163000.0
3163,3163999,20.74503757381455,36.68982744484914,0.08371509352808826,463.9883098602295,210.94676733016968,489.4679260253906,18289,3536,14753,14753,0,11,3164000.0
3164,3164999,20.745260859134834,36.689394098769796,0.0837011969650503,464.34779238700867,211.01460480690002,489.4390106201172,18311,3541,14770,14770,0,11,3165000.0
3165,3165999,20.745367551518015,36.68817323883698,0.08368361335061592,464.5134401321411,211.08105087280273,489.61524200439453,18315,3542,14773,14773,0,11,3166000.0
3166,3166999,20.745291536239193,36.68641350331434,0.083669249471366,464.6383099555969,211.14701747894287,489.89806365966797,18318,3542,14776,14776,0,11,3167000.0
3167,3167999,20.74535692255655,36.68535321422992,0.08365965610924231,464.8413383960724,211.2125494480133,490.04437255859375,18336,3544,14792,14792,0,11,3168000.0
3168,3168999,20.745432084277915,36.68375217398385,0.0836562057190342,465.04120421409607,211.27954292297363,490.09400177001953,18354,3546,14808,14808,0,11,3169000.0
3169,3169999,20.7448227200039,36.68271373498247,0.08363942076923114,465.21046590805054,211.3448429107666,490.19782638549805,18356,3547,14809,14809,0,11,3170000.0
3170,3170999,20.743134267971197,36.679874560895335,0.08363749480945037,465.333247423172,211.41147804260254,490.84391021728516,18380,3547,14833,14833,0,11,3171000.0
3171,3171999,20.740684410800174,36.67664943578986,0.08364302706335047,465.4523334503174,211.47767782211304,491.12891006469727,18383,3547,14836,14836,0,11,3172000.0
3172,3172999,20.738315265993542,36.67348084385424,0.08364821840968861,465.61594915390015,211.54358983039856,491.32576751708984,18388,3548,14840,14840,0,11,3173000.0
3173,3173999,20.735567359689902,36.66913066131173,0.08366065914091958,465.73768615722656,211.60933828353882,491.4944038391113,18389,3548,14841,14841,0,11,3174000.0
3174,3174999,20.733351160437834,36.66549245803891,0.08366293771577704,465.8493015766144,211.67444276809692,491.7671890258789,18393,3548,14845,14845,0,11,3175000.0
3175,3175999,20.731049005425263,36.662818569641445,0.08366465237327958,466.0505840778351,211.74014520645142,492.23645782470703,18455,3550,14905,14905,0,11,3176000.0
3176,3176999,20.72853306256472,36.658918415704356,0.08366984540002076,466.23091673851013,211.80646538734436,492.62225341796875,18457,3551,14906,14906,0,11,3177000.0
3177,3177999,20.726320127545034,36.65519025855621,0.08366943747188149,466.4254698753357,211.87238883972168,492.7856979370117,18462,3553,14909,14909,0,11,3178000.0
3178,3178999,20.724290277203163,36.6530414238663,0.08366237155585998,466.54598212242126,211.93805289268494,493.09142303466797,18466,3553,14913,14913,0,11,3179000.0
3179,3179999,20.72251335260094,36.65041992240079,0.08365278132984566,466.6652820110321,212.00368404388428,493.24755096435547,18466,3553,14913,14913,0,11,3180000.0
3180,3180999,20.720806471036248,36.647354029424605,0.08364093524855343,466.8278331756592,212.07027530670166,493.55834197998047,18476,3554,14922,14922,0,11,3181000.0
3181,3181999,20.719170152898858,36.64433389041625,0.08363123563496866,466.9897429943085,212.1359441280365,493.7125930786133,18478,3555,14923,14923,0,11,3182000.0
3182,3182999,20.71783779926011,36.64129641594066,0.08362045924426054,467.16777420043945,212.20206427574158,493.83626556396484,18480,3556,14924,14924,0,11,3183000.0
3183,3183999,20.71707701061823,36.63953255634146,0.08361522683737566,467.338604927063,212.26849222183228,493.9284019470215,18484,3557,14927,14927,0,11,3184000.0
3184,3184999,20.716999995466256,36.64132559380657,0.08360378528450119,467.4513347148895,212.3334081172943,494.05138778686523,18484,3557,14927,14927,0,11,3185000.0
3185,3185999,20.717054134653257,36.64118511248153,0.0836186982580982,467.61044359207153,212.3994162082672,494.14133071899414,18486,3558,14928,14928,0,11,3186000.0
3186,3186999,20.717110065748777,36.64016692962629,0.08363578324969656,467.8093934059143,212.46546530723572,494.42334747314453,18497,3560,14937,14937,0,11,3187000.0
3187,3187999,20.717489369145994,36.63978754390327,0.08367231823905008,468.0086500644684,212.53201460838318,494.51953506469727,18501,3562,14939,14939,0,11,3188000.0
3188,3188999,20.7180226635175,36.63970913287297,0.08369833043548747,468.1704361438751,212.59755992889404,494.67837142944336,18504,3563,14941,14941,0,11,3189000.0
3189,3189999,20.718413190705554,36.63861267165277,0.08369747625626345,468.4588780403137,212.66411447525024,494.68591690063477,18532,3567,14965,14965,0,11,3190000.0
3190,3190999,20.718039510755474,36.63820991115085,0.08368489950673363,468.58195519447327,212.73176836967468,495.1942672729492,18547,3567,14980,14980,0,11,3191000.0
3191,3191999,20.715150450690142,36.633784682188924,0.08369985906141131,468.69629645347595,212.79619026184082,495.4645462036133,18548,3567,14981,14981,0,11,3192000.0
3192,3192999,20.71266762050023,36.630998483806586,0.08370389112631682,468.8567581176758,212.86112236976624,495.63707733154297,18552,3568,14984,14984,0,11,3193000.0
3193,3193999,20.710745973376795,36.62846191588186,0.0837009676279078,469.0142984390259,212.92662143707275,495.7943000793457,18557,3569,14988,14988,0,11,3194000.0
3194,3194999,20.70870232787607,36.626255253070674,0.08369541595667085,469.169819355011,212.99173140525818,495.8917655944824,18559,3570,14989,14989,0,11,3195000.0
3195,3195999,20.706528540826575,36.62443196004883,0.08368728462965414,469.42210268974304,213.057523727417,495.9731788635254,18566,3573,14993,14993,0,11,3196000.0
3196,3196999,20.704388987599742,36.6207219971673,0.08368542894085773,469.58030700683594,213.12202787399292,496.0879783630371,18570,3574,14996,14996,0,11,3197000.0
3197,3197999,20.70227350337869,36.617216497195194,0.08368584503464371,469.71610975265503,213.18657422065735,496.23527908325195,18570,3574,14996,14996,0,11,3198000.0
3198,3198999,20.700635842088662,36.61593165278956,0.08367352860574584,469.83003878593445,213.25105786323547,496.34915924072266,18571,3574,14997,14997,0,11,3199000.0
3199,3199999,20.698899984201276,36.612717769196635,0.08367038985816688,469.95371747016907,213.3170223236084,496.4773712158203,18573,3574,14999,14999,0,11,3200000.0
3200,3200999,20.697723874013644,36.61122031433116,0.08365949789527671,470.12278628349304,213.382315158844,496.51791763305664,18577,3575,15002,15002,0,11,3201000.0
3201,3201999,20.697270220787438,36.61092886683495,0.08365580172726839,470.248957157135,213.44684982299805,496.72865295410156,18579,3575,15004,15004,0,11,3202000.0
3202,3202999,20.696765507717156,36.61015404015481,0.08365834153532892,470.37640404701233,213.5111620426178,496.8626136779785,18579,3575,15004,15004,0,11,3203000.0
3203,3203999,20.698040522503213,36.61369925791408,0.08369549466296089,470.5066018104553,213.57569646835327,496.98514556884766,18579,3575,15004,15004,0,11,3204000.0
3204,3204999,20.700858929057638,36.619858681519425,0.08372919204784446,470.7037272453308,213.64067316055298,497.01417541503906,18584,3577,15007,15007,0,11,3205000.0
3205,3205999,20.703933897850536,36.630250307543584,0.08373428411360662,470.8764410018921,213.70680260658264,497.1236267089844,18586,3578,15008,15008,0,11,3206000.0
3206,3206999,20.707586434948418,36.63722333170853,0.08379138681141884,471.034574508667,213.7712562084198,497.23762130737305,18617,3579,15038,15038,0,11,3207000.0
3207,3207999,20.71200735097061,36.64485183166094,0.08384960243465067,471.202180147171,213.83619141578674,497.5377540588379,18629,3580,15049,15049,0,11,3208000.0
3208,3208999,20.716608404532657,36.65288077459581,0.08390510196410272,471.4450612068176,213.90087795257568,497.5358238220215,18637,3583,15054,15054,0,11,3209000.0
3209,3209999,20.720634237795032,36.66033180721715,0.08396105987441704,471.66219091415405,213.9664614200592,497.60687255859375,18642,3585,15057,15057,0,11,3210000.0
3210,3210999,20.725201661778232,36.66703310918031,0.08408608309573795,471.8788170814514,214.03547477722168,497.6579284667969,18648,3587,15061,15061,0,11,3211000.0
3211,3211999,20.728311802406306,36.67827725802743,0.08412708044894834,472.0509910583496,214.1012887954712,498.0959815979004,18668,3588,15080,15080,0,11,3212000.0
3212,3212999,20.72578682903127,36.67577217940398,0.084127162960838,472.21146845817566,214.16804432868958,498.43077850341797,18682,3589,15093,15093,0,11,3213000.0
3213,3213999,20.723198222188547,36.67229580871556,0.08413699891083015,472.382860660553,214.2336823940277,498.60373306274414,18684,3590,15094,15094,0,11,3214000.0
3214,3214999,20.72070466536442,36.66883017857386,0.08414407279053404,472.51120829582214,214.29976987838745,498.83655166625977,18688,3590,15098,15098,0,11,3215000.0
3215,3215999,20.7185623113372,36.665653045697056,0.08414836272757908,472.69786310195923,214.3745560646057,498.97900772094727,18690,3591,15099,15099,0,11,3216000.0
3216,3216999,20.716768700568007,36.66367563529617,0.08413600648749664,472.8160045146942,214.44052815437317,499.35338592529297,18697,3591,15106,15106,0,11,3217000.0
3217,3217999,20.715142963570152,36.66207008384682,0.08412695608049425,472.98024797439575,214.50589156150818,499.5480766296387,18700,3592,15108,15108,0,11,3218000.0
3218,3218999,20.713571898108274,36.660280786015164,0.08413814988227575,473.242005109787,214.57774376869202,499.6766471862793,18710,3595,15115,15115,0,11,3219000.0
3219,3219999,20.71266736240676,36.660101415544275,0.08414720223742511,473.35855865478516,214.6443235874176,499.9106101989746,18711,3595,15116,15116,0,11,3220000.0
3220,3220999,20.712420093614284,36.66436704815352,0.08412356366072471,473.5709707736969,214.71439409255981,499.98608779907227,18716,3597,15119,15119,0,11,3221000.0
3221,3221999,20.7133148586879,36.6688594770628,0.08412548271401477,473.73902702331543,214.78166961669922,500.22336196899414,18726,3598,15128,15128,0,11,3222000.0
3222,3222999,20.71666811668056,36.67937459017812,0.08414397249024641,473.8599786758423,214.84822297096252,500.61470794677734,18732,3598,15134,15134,0,11,3223000.0
3223,3223999,20.72064191126323,36.69268751261633,0.08417444718092382,474.0625319480896,214.91336369514465,500.75358963012695,18737,3600,15137,15137,0,11,3224000.0
3224,3224999,20.72657520192308,36.70859582975631,0.08425178905450204,474.2268798351288,214.9787998199463,500.9659652709961,18742,3601,15141,15141,0,11,3225000.0
3225,3225999,20.73330234600836,36.7258121957305,0.08441849911310628,474.46523213386536,215.04625701904297,501.12912368774414,18751,3604,15147,15147,0,11,3226000.0
3226,3226999,20.7392395471033,36.74072289413589,0.08452365231445214,474.61920619010925,215.11172199249268,501.29876708984375,18754,3605,15149,15149,0,11,3227000.0
3227,3227999,20.746828559359752,36.7602204947085,0.08469666942901022,474.73846983909607,215.17754364013672,501.51721954345703,18756,3605,15151,15151,0,11,3228000.0
3228,3228999,20.75532731198584,36.780964042159866,0.08475269502651506,474.94165563583374,215.24331068992615,501.862117767334,18770,3607,15163,15163,0,11,3229000.0
3229,3229999,20.763756365481953,36.79825902287453,0.08491509123498653,475.15206956863403,215.3097288608551,502.0006637573242,18776,3609,15167,15167,0,11,3230000.0
3230,3230999,20.773765023360998,36.82250742137625,0.08516131508484226,475.27194929122925,215.37512803077698,502.17758560180664,18776,3609,15167,15167,0,11,3231000.0
3231,3231999,20.7796629982248,36.832773948906954,0.08526492609009684,475.480881690979,215.4429543018341,502.2871971130371,18781,3611,15170,15170,0,11,3232000.0
3232,3232999,20.779715963345375,36.83370237296776,0.08528037633429597,475.60113072395325,215.50804042816162,502.78603744506836,18793,3611,15182,15182,0,11,3233000.0
3233,3233999,20.777796438329432,36.83161009668639,0.08528428828324197,475.71599411964417,215.57278895378113,503.0058708190918,18794,3611,15183,15183,0,11,3234000.0
3234,3234999,20.776300213551938,36.83351432377495,0.08529080633741148,475.8848457336426,215.63766384124756,503.1564140319824,18801,3612,15189,15189,0,11,3235000.0
3235,3235999,20.775405254212334,36.833948612630486,0.08519796352809461,476.001015663147,215.70294380187988,503.3197937011719,18802,3612,15190,15190,0,11,3236000.0
3236,3236999,20.77423178553472,36.83240372805579,0.08517243918487816,476.21951174736023,215.76880049705505,503.4981346130371,18812,3614,15198,15198,0,11,3237000.0
3237,3237999,20.773105318664687,36.830572897259025,0.08515404320482378,476.3985161781311,215.8419647216797,503.69970703125,18814,3615,15199,15199,0,11,3238000.0
3238,3238999,20.77150296487165,36.82752836905711,0.08513455411912241,476.5595109462738,215.90698313713074,503.84718322753906,18817,3616,15201,15201,0,11,3239000.0
3239,3239999,20.770072463812017,36.82471235048204,0.08512934374534864,476.6701536178589,215.97262930870056,503.99828720092773,18817,3616,15201,15201,0,11,3240000.0
3240,3240999,20.769098669792065,36.82258186736985,0.08511839995035941,476.88480854034424,216.0380368232727,504.0794143676758,18826,3618,15208,15208,0,11,3241000.0
3241,3241999,20.76843742775357,36.82080196789803,0.08511240495872674,477.0018718242645,216.1034915447235,504.26479721069336,18828,3618,15210,15210,0,11,3242000.0
3242,3242999,20.767906767078447,36.81889065806824,0.08509474458921074,477.22940611839294,216.16928601264954,504.44526290893555,18838,3620,15218,15218,0,11,3243000.0
3243,3243999,20.769030778802676,36.82083564923777,0.08508502454281286,477.3850967884064,216.23496174812317,504.66913986206055,18842,3621,15221,15221,0,11,3244000.0
3244,3244999,20.77039726619867,36.821999259929676,0.08510757625200649,477.58820390701294,216.3006932735443,504.82586669921875,18849,3623,15226,15226,0,11,3245000.0
3245,3245999,20.773041505035945,36.82727540263496,0.08515010828756042,477.75423312187195,216.36623215675354,504.9662399291992,18851,3624,15227,15227,0,11,3246000.0
3246,3246999,20.77643347666684,36.83835202274627,0.08520519568190854,477.9751994609833,216.43298935890198,505.0712776184082,18856,3626,15230,15230,0,11,3247000.0
3247,3247999,20.78070563314442,36.84695686451357,0.08524171120775026,478.089985370636,216.4978518486023,505.23414611816406,18857,3626,15231,15231,0,11,3248000.0
3248,3248999,20.785753417184623,36.85744866389289,0.08529678782198957,478.2571759223938,216.56490302085876,505.590763092041,18871,3627,15244,15244,0,11,3249000.0
3249,3249999,20.790406543118667,36.8664240620508,0.08534886820779886,478.3809006214142,216.62995505332947,505.7934684753418,18871,3627,15244,15244,0,11,3250000.0
3250,3250999,20.79499969128623,36.87284677509674,0.08543572229168361,478.6000874042511,216.69602394104004,505.9262466430664,18882,3629,15253,15253,0,11,3251000.0
3251,3251999,20.800688852021104,36.88076625120411,0.08553422780376674,478.76084089279175,216.7617311477661,506.0535583496094,18884,3630,15254,15254,0,11,3252000.0
3252,3252999,20.803643197001367,36.886191871133136,0.08556393785328964,478.9581604003906,216.82680773735046,506.17253494262695,18888,3632,15256,15256,0,11,3253000.0
3253,3253999,20.80188352532732,36.883545628831556,0.08556060007323352,479.118497133255,216.89480209350586,506.9308319091797,18920,3633,15287,15287,0,11,3254000.0
3254,3254999,20.799723577206706,36.88059491714282,0.08554698736348598,479.2316839694977,216.96081352233887,507.2755889892578,18924,3633,15291,15291,0,11,3255000.0
3255,3255999,20.798196708954233,36.882420641777465,0.08550644975104593,479.43171977996826,217.0270562171936,507.50060272216797,18932,3635,15297,15297,0,11,3256000.0
3256,3256999,20.796590639296795,36.879886946549355,0.08548198528522866,479.54753017425537,217.09295964241028,507.6720161437988,18932,3635,15297,15297,0,11,3257000.0
3257,3257999,20.795048416889475,36.87861992461213,0.08547791176886788,479.7126941680908,217.15934467315674,507.9834747314453,18941,3636,15305,15305,0,11,3258000.0
3258,3258999,20.79416470111494,36.87741439089716,0.08544868997785615,479.8693096637726,217.22512006759644,508.20726013183594,18943,3637,15306,15306,0,11,3259000.0
3259,3259999,20.792906460675507,36.876722817156306,0.08542411231425906,480.02685475349426,217.29092645645142,508.35727310180664,18945,3638,15307,15307,0,11,3260000.0
3260,3260999,20.791570501064555,36.87419068613448,0.08541046649055395,480.2344205379486,217.35681891441345,508.4164276123047,18949,3640,15309,15309,0,11,3261000.0
3261,3261999,20.790421644239537,36.87167308599218,0.08539630951480925,480.38836765289307,217.4229335784912,508.536563873291,18952,3641,15311,15311,0,11,3262000.0
3262,3262999,20.789875464728485,36.87044036581372,0.08537020228695658,480.6123700141907,217.49036955833435,508.7740364074707,18968,3643,15325,15325,0,11,3263000.0
3263,3263999,20.789317466043656,36.870022645107646,0.08534215349715157,480.86863350868225,217.5611252784729,509.0657844543457,18991,3646,15345,15345,0,11,3264000.0
3264,3264999,20.789678283150167,36.86900289457644,0.08534386720924625,481.03548192977905,217.62767720222473,509.3760757446289,18999,3647,15352,15352,0,11,3265000.0
3265,3265999,20.78995565798318,36.86815725691223,0.08534835198185775,481.20081543922424,217.6941261291504,509.50902938842773,19001,3648,15353,15353,0,11,3266000.0
3266,3266999,20.790867149752536,36.86834026396735,0.08537440465344792,481.408771276474,217.76022171974182,509.6026420593262,19005,3650,15355,15355,0,11,3267000.0
3267,3267999,20.79279830405051,36.87062317879882,0.0854185885947798,481.538010597229,217.82656383514404,509.7667655944824,19005,3650,15355,15355,0,11,3268000.0
3268,3268999,20.795355244975415,36.873530491318604,0.08544516015236592,481.660973072052,217.89247846603394,509.92736434936523,19006,3650,15356,15356,0,11,3269000.0
3269,3269999,20.79853239991449,36.877563546779946,0.08547071034644882,481.8243477344513,217.95947933197021,510.1752395629883,19013,3651,15362,15362,0,11,3270000.0
3270,3270999,20.80237106350222,36.881590681004816,0.0855087723472907,481.93656182289124,218.0246193408966,510.38199615478516,19014,3651,15363,15363,0,11,3271000.0
3271,3271999,20.80536043518046,36.8834125103811,0.08555582420348973,482.14606833457947,218.09008741378784,510.52027893066406,19019,3653,15366,15366,0,11,3272000.0
3272,3272999,20.80834757745224,36.8852224186792,0.08558261939663447,482.4004020690918,218.15577816963196,510.55954360961914,19025,3656,15369,15369,0,11,3273000.0
3273,3273999,20.810318611244966,36.88592715933749,0.08562147584055069,482.55808901786804,218.22180247306824,510.7505111694336,19030,3657,15373,15373,0,11,3274000.0
3274,3274999,20.809460555058866,36.88344957523356,0.08561864327984803,482.72898292541504,218.28995895385742,511.4291000366211,19058,3658,15400,15400,0,11,3275000.0
3275,3275999,20.80759422542694,36.880418572224556,0.08560761515557791,482.8473651409149,218.35586261749268,511.6941032409668,19063,3658,15405,15405,0,11,3276000.0
3276,3276999,20.805391974270083,36.87736424051874,0.08560850825320077,482.96992230415344,218.42177081108093,511.97619247436523,19068,3658,15410,15410,0,11,3277000.0
3277,3277999,20.803824161502305,36.874582040111946,0.08559617578717271,483.0821907520294,218.48697113990784,512.1326866149902,19070,3658,15412,15412,0,11,3278000.0
3278,3278999,20.801603654551904,36.87083056224542,0.08559804103397906,483.2456216812134,218.55346202850342,512.2499160766602,19073,3659,15414,15414,0,11,3279000.0
3279,3279999,20.800560292097515,36.87237170363969,0.08554867424783041,483.41960310935974,218.62021231651306,512.6540870666504,19083,3660,15423,15423,0,11,3280000.0
3280,3280999,20.79885353331868,36.86954991900567,0.08553199466173511,483.5826303958893,218.6868553161621,512.8526458740234,19086,3661,15425,15425,0,11,3281000.0
3281,3281999,20.797448299771116,36.86669274242192,0.08550040717623453,483.6968584060669,218.75350046157837,513.0565528869629,19087,3661,15426,15426,0,11,3282000.0
3282,3282999,20.795983982126167,36.8638941800465,0.08547125362168706,483.896187543869,218.82020926475525,513.1529808044434,19095,3663,15432,15432,0,11,3283000.0
3283,3283999,20.794933404878144,36.861275940332554,0.08544198204302544,484.14587664604187,218.88761639595032,513.2845191955566,19106,3666,15440,15440,0,11,3284000.0
3284,3284999,20.794416095975674,36.85999783524128,0.0854306913499463,484.3056700229645,218.95361232757568,513.4555053710938,19109,3667,15442,15442,0,11,3285000.0
3285,3285999,20.79422397653974,36.85868831433524,0.08541086873746684,484.41803455352783,219.02055835723877,513.8665809631348,19117,3667,15450,15450,0,11,3286000.0
3286,3286999,20.794526578605247,36.85765385493848,0.08539979888490601,484.62711453437805,219.08653116226196,514.0204849243164,19122,3669,15453,15453,0,11,3287000.0
3287,3287999,20.795029846340643,36.8573615679211,0.08538337152636788,484.86981081962585,219.1529200077057,514.1333274841309,19128,3672,15456,15456,0,11,3288000.0
3288,3288999,20.795864278077122,36.8575060986614,0.0853731972599504,485.03571367263794,219.2200412750244,514.3159255981445,19131,3673,15458,15458,0,11,3289000.0
3289,3289999,20.796964439321965,36.857692344060176,0.0853457399423816,485.1533064842224,219.28590273857117,514.4614868164062,19131,3673,15458,15458,0,11,3290000.0
3290,3290999,20.798016908749652,36.85724530711291,0.08532138842067327,485.3606789112091,219.3521590232849,514.5822792053223,19138,3675,15463,15463,0,11,3291000.0
3291,3291999,20.799337385834818,36.85678718652181,0.08529637821523306,485.47904205322266,219.41831493377686,515.0704154968262,19151,3675,15476,15476,0,11,3292000.0
3292,3292999,20.80092974997724,36.85944603847276,0.08526453466768158,485.6419744491577,219.48445343971252,515.2373008728027,19155,3676,15479,15479,0,11,3293000.0
3293,3293999,20.80234141074088,36.86545304850657,0.08521780974102,485.76598477363586,219.55358147621155,515.4176979064941,19156,3676,15480,15480,0,11,3294000.0
3294,3294999,20.80304074890056,36.864194025083115,0.08519509303276296,486.11118054389954,219.62114262580872,515.4575614929199,19196,3681,15515,15515,0,11,3295000.0
3295,3295999,20.802671151904025,36.86371895037688,0.08514179137876543,486.2739944458008,219.68976950645447,516.159049987793,19243,3682,15561,15561,0,11,3296000.0
3296,3296999,20.80182815155361,36.86293444683723,0.08514440456631334,486.39930987358093,219.7567868232727,516.6379241943359,19255,3682,15573,15573,0,11,3297000.0
3297,3297999,20.800958357009225,36.861178693712134,0.0851405738140435,486.5152986049652,219.8226978778839,516.9270057678223,19258,3682,15576,15576,0,11,3298000.0
3298,3298999,20.800305558245316,36.85963885660735,0.085129553458969,486.64041686058044,219.89325094223022,517.1105308532715,19260,3682,15578,15578,0,11,3299000.0
3299,3299999,20.799912432757825,36.85881521622044,0.08512017973517194,486.8137307167053,219.9593403339386,517.3276138305664,19265,3683,15582,15582,0,11,3300000.0
3300,3300999,20.7993115190775,36.85737413907927,0.08512151138338231,486.9304234981537,220.02614903450012,517.5916748046875,19266,3683,15583,15583,0,11,3301000.0
3301,3301999,20.799286014721325,36.856670422026795,0.08512095999608438,487.0869688987732,220.09230852127075,517.7739486694336,19269,3684,15585,15585,0,11,3302000.0
3302,3302999,20.799535948770387,36.85559077514686,0.08510738797955142,487.33919310569763,220.15910506248474,517.8315124511719,19277,3687,15590,15590,0,11,3303000.0
3303,3303999,20.800693093025263,36.85814339171281,0.08509897084492135,487.5447487831116,220.22589635849,517.9653739929199,19282,3689,15593,15593,0,11,3304000.0
3304,3304999,20.801595136272933,36.860108133457786,0.08509149801097893,487.6640725135803,220.29253244400024,518.2282752990723,19289,3689,15600,15600,0,11,3305000.0
3305,3305999,20.804247102207093,36.871344045939544,0.08505914862525188,487.8294587135315,220.3594400882721,518.5724258422852,19300,3690,15610,15610,0,11,3306000.0
3306,3306999,20.808335088195097,36.88150630136199,0.0851499086702765,487.99076628685,220.42673015594482,518.803897857666,19304,3691,15613,15613,0,11,3307000.0
3307,3307999,20.81236681071641,36.88938943216354,0.08520576406328961,488.1993989944458,220.4933922290802,518.9553756713867,19309,3693,15616,15616,0,11,3308000.0
3308,3308999,20.81557647926736,36.89601695694104,0.08534292215096495,488.419442653656,220.56070923805237,519.0365257263184,19320,3695,15625,15625,0,11,3309000.0
3309,3309999,20.818732509114884,36.90089622892195,0.08549537335695367,488.63893580436707,220.628760099411,519.2580413818359,19325,3697,15628,15628,0,11,3310000.0
3310,3310999,20.821969113384974,36.90515618931462,0.08556791141795916,488.7618236541748,220.695294380188,519.5450706481934,19331,3697,15634,15634,0,11,3311000.0
3311,3311999,20.82559367713519,36.91063916117107,0.08571887561476155,488.9223096370697,220.76173162460327,519.8269195556641,19337,3698,15639,15639,0,11,3312000.0
3312,3312999,20.828107046784265,36.91296420185153,0.08583851056541891,489.0847375392914,220.82745099067688,519.9758148193359,19339,3699,15640,15640,0,11,3313000.0
3313,3313999,20.830147749169683,36.9143611573951,0.08588293450500284,489.33560967445374,220.89355421066284,520.0058135986328,19359,3702,15657,15657,0,11,3314000.0
3314,3314999,20.82992018176722,36.91462396482098,0.08588224640505915,489.45726203918457,220.96332478523254,520.5917282104492,19382,3702,15680,15680,0,11,3315000.0
3315,3315999,20.828729702753947,36.91406425751296,0.08586542161990374,489.6276481151581,221.0299198627472,520.8599548339844,19394,3703,15691,15691,0,11,3316000.0
3316,3316999,20.827487251680235,36.91255077211511,0.0858621728216109,489.76394033432007,221.10658526420593,521.0872230529785,19396,3703,15693,15693,0,11,3317000.0
3317,3317999,20.82670892045203,36.91335527222078,0.08585147473645982,489.88784766197205,221.17270016670227,521.2835655212402,19398,3703,15695,15695,0,11,3318000.0
3318,3318999,20.827099080246914,36.91423965573419,0.0858237255518911,490.0822548866272,221.24342274665833,521.5902786254883,19406,3704,15702,15702,0,11,3319000.0
3319,3319999,20.827130903396178,36.915954849339634,0.0858185210331247,490.19849705696106,221.30974411964417,521.7643280029297,19406,3704,15702,15702,0,11,3320000.0
3320,3320999,20.827193516982327,36.917231853554746,0.085832607810299,490.47317910194397,221.38321256637573,521.7991943359375,19412,3707,15705,15705,0,11,3321000.0
3321,3321999,20.828118409042194,36.91944786487192,0.08584350142456898,490.67671394348145,221.44960474967957,521.9503517150879,19417,3709,15708,15708,0,11,3322000.0
3322,3322999,20.828643533170748,36.91973628860177,0.08586956916176569,490.89133858680725,221.5164110660553,522.0991439819336,19430,3711,15719,15719,0,11,3323000.0
3323,3323999,20.829881416454988,36.921919502505645,0.08591242383850695,491.0085391998291,221.5826108455658,522.2523651123047,19432,3711,15721,15721,0,11,3324000.0
3324,3324999,20.83162402363598,36.92460166273208,0.08593927086351194,491.17910504341125,221.6493022441864,522.6398124694824,19445,3712,15733,15733,0,11,3325000.0
3325,3325999,20.833576957925185,36.926629311032784,0.08599469625036937,491.38208961486816,221.71500515937805,522.7996368408203,19449,3714,15735,15735,0,11,3326000.0
3326,3326999,20.83643415361006,36.93561533029219,0.08601945522626142,491.6360139846802,221.7818248271942,522.8617401123047,19466,3717,15749,15749,0,11,3327000.0
3327,3327999,20.838576199376114,36.940430955070916,0.08608659285332254,491.7997088432312,221.84894800186157,523.043514251709,19469,3718,15751,15751,0,11,3328000.0
3328,3328999,20.841400495224512,36.946947091254295,0.08616112333087345,491.96323895454407,221.9153447151184,523.1968154907227,19471,3719,15752,15752,0,11,3329000.0
3329,3329999,20.843819343490267,36.949393582866826,0.08621413924372001,492.12665581703186,221.98144102096558,523.3014068603516,19488,3720,15768,15768,0,11,3330000.0
3330,3330999,20.846470013319387,36.95421876389424,0.08629319296139326,492.3436095714569,222.048485994339,523.6034927368164,19516,3722,15794,15794,0,11,3331000.0
3331,3331999,20.848631878423966,36.95635835535839,0.08635438022165831,492.50239992141724,222.11498308181763,523.7884292602539,19518,3723,15795,15795,0,11,3332000.0
3332,3332999,20.85125747207819,36.961488765405576,0.0863983662794956,492.620267868042,222.18033075332642,523.9448623657227,19518,3723,15795,15795,0,11,3333000.0
3333,3333999,20.853289636473768,36.96270401520843,0.08645406541774259,492.8069348335266,222.25656747817993,523.9903450012207,19520,3724,15796,15796,0,11,3334000.0
3334,3334999,20.854072136851023,36.966466421533966,0.08646412694007888,493.0181350708008,222.32318305969238,524.2223358154297,19533,3726,15807,15807,0,11,3335000.0
3335,3335999,20.85181769813185,36.96473622603123,0.08646201917876006,493.1660649776459,222.39757466316223,524.4859352111816,19534,3726,15808,15808,0,11,3336000.0
3336,3336999,20.84950482395845,36.96155632170352,0.08646247347810843,493.33067178726196,222.4624330997467,524.6303176879883,19538,3727,15811,15811,0,11,3337000.0
3337,3337999,20.847235506575704,36.95808618404362,0.08646599559567014,493.4954249858856,222.52740359306335,524.7428436279297,19542,3728,15814,15814,0,11,3338000.0
3338,3338999,20.84571719238341,36.95653523382059,0.08645187973006108,493.66586422920227,222.59260296821594,524.8249816894531,19544,3729,15815,15815,0,11,3339000.0
3339,3339999,20.843754500713896,36.95328323185654,0.08644312462953918,493.8399021625519,222.65879273414612,524.9615211486816,19548,3730,15818,15818,0,11,3340000.0
3340,3340999,20.842317912410138,36.9521084519288,0.08642582794768405,494.01537108421326,222.7238974571228,525.1086311340332,19551,3731,15820,15820,0,11,3341000.0
3341,3341999,20.840885859731547,36.94966225580622,0.0864160754588793,494.1769268512726,222.78924798965454,525.1972312927246,19553,3732,15821,15821,0,11,3342000.0
3342,3342999,20.83973543568016,36.94744604611519,0.08640174219285546,494.3472716808319,222.8545753955841,525.3052444458008,19555,3733,15822,15822,0,11,3343000.0
3343,3343999,20.839329617241855,36.947537434913144,0.08638071162708261,494.56352829933167,222.92028760910034,525.357852935791,19563,3735,15828,15828,0,11,3344000.0
3344,3344999,20.839036530082254,36.94692594160902,0.0863655091479616,494.7007222175598,222.98564743995667,525.502628326416,19566,3735,15831,15831,0,11,3345000.0
3345,3345999,20.840058339874627,36.95013201015737,0.08634901375890791,494.8747236728668,223.0509855747223,525.6665344238281,19571,3736,15835,15835,0,11,3346000.0
3346,3346999,20.841953807571954,36.95439541759982,0.08639274441206657,495.05098390579224,223.11576747894287,525.8066253662109,19573,3737,15836,15836,0,11,3347000.0
3347,3347999,20.844035023651653,36.957651107172765,0.08644363416731704,495.1679151058197,223.18068528175354,525.9234275817871,19573,3737,15836,15836,0,11,3348000.0
3348,3348999,20.8467037171868,36.96304273561385,0.08645290377100145,495.38856840133667,223.24633193016052,525.9924545288086,19585,3739,15846,15846,0,11,3349000.0
3349,3349999,20.85054980835779,36.971554144391355,0.08647284340776507,495.6096365451813,223.31231904029846,526.1320838928223,19602,3741,15861,15861,0,11,3350000.0
3350,3350999,20.85508576324872,36.980537795605414,0.08649459878900634,495.73503375053406,223.37804532051086,526.2510871887207,19602,3741,15861,15861,0,11,3351000.0
3351,3351999,20.860281564722154,36.99651739005078,0.08649892980305995,495.85004711151123,223.44323348999023,526.5651626586914,19605,3741,15864,15864,0,11,3352000.0
3352,3352999,20.86474398075247,37.003551149349086,0.08651630047262149,496.11629033088684,223.50864839553833,526.4684944152832,19615,3744,15871,15871,0,11,3353000.0
3353,3353999,20.869154597530873,37.0101264953453,0.08658404283789756,496.3722746372223,223.57493901252747,526.5920257568359,19621,3747,15874,15874,0,11,3354000.0
3354,3354999,20.87215383035783,37.01209348263252,0.08662640483116824,496.53971886634827,223.6415672302246,526.7584419250488,19623,3748,15875,15875,0,11,3355000.0
3355,3355999,20.873340335896216,37.012875734531946,0.08663585097523052,496.67101192474365,223.70715522766113,527.124137878418,19634,3748,15886,15886,0,11,3356000.0
3356,3356999,20.871539554714143,37.01084902992174,0.08664210001247818,496.7976372241974,223.77240324020386,527.4822273254395,19642,3748,15894,15894,0,11,3357000.0
3357,3357999,20.87025642703064,37.011532507912506,0.08662896745503834,496.91613364219666,223.83722162246704,527.6442260742188,19643,3748,15895,15895,0,11,3358000.0
3358,3358999,20.868974540722583,37.01032732221575,0.0866162016405877,497.0505621433258,223.90338468551636,527.806079864502,19646,3748,15898,15898,0,11,3359000.0
3359,3359999,20.867315021817415,37.00740590754432,0.08660622074440094,497.1763756275177,223.9681429862976,527.899169921875,19646,3748,15898,15898,0,11,3360000.0
3360,3360999,20.86623934509094,37.00499466762394,0.08658676705698276,497.33452892303467,224.0336835384369,528.1375312805176,19653,3749,15904,15904,0,11,3361000.0
3361,3361999,20.86567756433909,37.0034020746297,0.0865730262923965,497.4536063671112,224.09917879104614,528.3090858459473,19654,3749,15905,15905,0,11,3362000.0
3362,3362999,20.864874019810916,37.001305604197476,0.08656155722205938,497.763986825943,224.1657395362854,528.3583755493164,19669,3753,15916,15916,0,11,3363000.0
3363,3363999,20.864086016941318,37.00119170172444,0.0865441416073014,497.8881766796112,224.23124408721924,528.5610847473145,19669,3753,15916,15916,0,11,3364000.0
3364,3364999,20.863225227620855,36.999638626016356,0.08653204830836159,498.0048701763153,224.29654693603516,528.7482948303223,19671,3753,15918,15918,0,11,3365000.0
3365,3365999,20.862997061633603,36.99854177997933,0.08651646220426423,498.170529127121,224.363667011261,528.932731628418,19678,3754,15924,15924,0,11,3366000.0
3366,3366999,20.864225613198187,37.00554452945401,0.08646231949302652,498.3396375179291,224.42939066886902,529.2105293273926,19686,3755,15931,15931,0,11,3367000.0
3367,3367999,20.867027790463805,37.015025605630136,0.08642262373253806,498.5164728164673,224.4940824508667,529.3608703613281,19688,3756,15932,15932,0,11,3368000.0
3368,3368999,20.870945578734585,37.02236474473242,0.08645120409021834,498.7293791770935,224.5599377155304,529.4297485351562,19692,3758,15934,15934,0,11,3369000.0
3369,3369999,20.874991625966047,37.033260903760954,0.08648519382773234,498.9392080307007,224.62671828269958,529.5618515014648,19697,3760,15937,15937,0,11,3370000.0
3370,3370999,20.881485641350533,37.05250027978683,0.0865580323049413,499.1162073612213,224.69249939918518,529.7003479003906,19703,3761,15942,15942,0,11,3371000.0
3371,3371999,20.88948013723061,37.07478947702635,0.08679175339974676,499.2784221172333,224.75846672058105,529.8551483154297,19707,3762,15945,15945,0,11,3372000.0
3372,3372999,20.89852711583515,37.09831347595222,0.08701898074274406,499.53657817840576,224.82534074783325,530.2054786682129,19731,3765,15966,15966,0,11,3373000.0
3373,3373999,20.907488127478153,37.1176422538812,0.08722939178692468,499.7530996799469,224.89240193367004,530.3551826477051,19736,3767,15969,15969,0,11,3374000.0
3374,3374999,20.916205140232027,37.13246564702058,0.08750473708558504,499.86727714538574,224.95794916152954,530.5668792724609,19736,3767,15969,15969,0,11,3375000.0
3375,3375999,20.923885354875747,37.145454552285884,0.08774917309698993,500.0774018764496,225.02353024482727,530.666431427002,19740,3769,15971,15971,0,11,3376000.0
3376,3376999,20.927044081490916,37.152068053886666,0.08779955508286441,500.23463678359985,225.08883929252625,531.0673332214355,19755,3770,15985,15985,0,11,3377000.0
3377,3377999,20.926459119999866,37.15271667383643,0.08776589392903045,500.35618114471436,225.1536841392517,531.2740058898926,19756,3770,15986,15986,0,11,3378000.0
3378,3378999,20.926049054234024,37.1540453207896,0.08773215413996527,500.60698342323303,225.2186279296875,531.365478515625,19766,3773,15993,15993,0,11,3379000.0
3379,3379999,20.927315277421116,37.15951872029722,0.08767292273459804,500.78032994270325,225.28354835510254,531.5518608093262,19770,3774,15996,15996,0,11,3380000.0
3380,3380999,20.928524049855028,37.16752519991854,0.08759481651014323,500.9410240650177,225.3491063117981,531.6945190429688,19772,3775,15997,15997,0,11,3381000.0
3381,3381999,20.929346240977274,37.168830486975175,0.08754518808284051,501.0707974433899,225.41442251205444,531.9468727111816,19774,3775,15999,15999,0,11,3382000.0
3382,3382999,20.93100796534604,37.17215535278235,0.08749302294224193,501.19023537635803,225.4791247844696,532.0688896179199,19774,3775,15999,15999,0,11,3383000.0
3383,3383999,20.93242345060207,37.174033815598534,0.08745193778637883,501.3109278678894,225.54545331001282,532.1491012573242,19774,3775,15999,15999,0,11,3384000.0
3384,3384999,20.93331768894031,37.17556192041835,0.08741704947705708,501.49141788482666,225.61051893234253,532.2091026306152,19777,3776,16001,16001,0,11,3385000.0
3385,3385999,20.933662945254916,37.17612942922244,0.08739582501422927,501.6623179912567,225.6753795146942,532.24951171875,19783,3777,16006,16006,0,11,3386000.0
3386,3386999,20.935055119087874,37.17792737950307,0.08737768299015947,501.8305723667145,225.7408480644226,532.345645904541,19785,3778,16007,16007,0,11,3387000.0
3387,3387999,20.935951858709178,37.177959934595535,0.08735395972069293,502.04315543174744,225.8065938949585,532.5244979858398,19793,3780,16013,16013,0,11,3388000.0
3388,3388999,20.93745186193792,37.18015568173384,0.0873358326472986,502.1631133556366,225.87154936790466,532.7150459289551,19793,3780,16013,16013,0,11,3389000.0
3389,3389999,20.938823897898434,37.18215759646087,0.08731904429548554,502.3313341140747,225.93649291992188,532.8147621154785,19795,3781,16014,16014,0,11,3390000.0
3390,3390999,20.939852873627494,37.18255627866472,0.0873174440085076,502.50337266921997,226.00147938728333,532.882194519043,19797,3782,16015,16015,0,11,3391000.0
3391,3391999,20.941606899256076,37.186843114333385,0.08729800117968001,502.6222336292267,226.0664677619934,533.0221176147461,19800,3782,16018,16018,0,11,3392000.0
3392,3392999,20.943069112078657,37.18809323328893,0.0872897826363912,502.8116750717163,226.13294744491577,533.0780448913574,19804,3783,16021,16021,0,11,3393000.0
3393,3393999,20.944292570478048,37.188861729044234,0.0873002497363976,502.92256712913513,226.19801878929138,533.4286689758301,19811,3783,16028,16028,0,11,3394000.0
3394,3394999,20.945238188403632,37.1884678806174,0.08731271567582166,503.0935757160187,226.26304244995117,533.5732612609863,19813,3784,16029,16029,0,11,3395000.0
3395,3395999,20.9460658165356,37.18736980651568,0.08734402500379146,503.2505085468292,226.3289077281952,533.6841621398926,19815,3785,16030,16030,0,11,3396000.0
3396,3396999,20.94662306268938,37.18843345505936,0.08734620247077007,503.46602511405945,226.39431166648865,533.7431526184082,19823,3787,16036,16036,0,11,3397000.0
3397,3397999,20.946093534153412,37.191218862226975,0.08731929877364975,503.6309151649475,226.46077966690063,534.2888946533203,19850,3788,16062,16062,0,11,3398000.0
3398,3398999,20.944141340800265,37.19118335047357,0.08729329217961068,503.7560725212097,226.52815127372742,534.6437873840332,19856,3788,16068,16068,0,11,3399000.0
3399,3399999,20.94151978937361,37.187704701193844,0.08729863221430534,503.9215021133423,226.59413981437683,534.8673362731934,19860,3789,16071,16071,0,11,3400000.0
3400,3400999,20.938965262988834,37.1850586666794,0.08730165167951154,504.0406439304352,226.65978169441223,535.0612449645996,19863,3789,16074,16074,0,11,3401000.0
3401,3401999,20.93639065639709,37.18168210617161,0.0873070024687349,504.1660168170929,226.72672390937805,535.2262763977051,19863,3789,16074,16074,0,11,3402000.0
3402,3402999,20.934418603009618,37.179887620642056,0.08729466265625185,504.37777280807495,226.79327607154846,535.4050559997559,19870,3791,16079,16079,0,11,3403000.0
3403,3403999,20.932255278209645,37.1763635076058,0.08729438548310675,504.5418837070465,226.858984708786,535.5403671264648,19872,3792,16080,16080,0,11,3404000.0
3404,3404999,20.93015923670612,37.17275078593504,0.0872958510809072,504.71652126312256,226.92461729049683,535.6400451660156,19874,3793,16081,16081,0,11,3405000.0
3405,3405999,20.927844753308374,37.168797366382265,0.0872976935326486,504.9691882133484,226.99125695228577,535.7144508361816,19881,3796,16085,16085,0,11,3406000.0
3406,3406999,20.926800807044913,37.16778450619341,0.08727715668165936,505.13526010513306,227.05871438980103,535.8592491149902,19884,3797,16087,16087,0,11,3407000.0
3407,3407999,20.925693703354703,37.16536731031456,0.08726322025167299,505.2572908401489,227.12503123283386,536.0921936035156,19889,3797,16092,16092,0,11,3408000.0
3408,3408999,20.925007986977366,37.16340921824405,0.08723180534918329,505.43022060394287,227.19350910186768,536.5070571899414,19907,3798,16109,16109,0,11,3409000.0
3409,3409999,20.925159883965446,37.16429612570162,0.08720054975139568,505.59558153152466,227.25937628746033,536.6744346618652,19910,3799,16111,16111,0,11,3410000.0
3410,3410999,20.924585135845778,37.16275716533994,0.08718309150466785,505.7160589694977,227.32489252090454,536.8326034545898,19910,3799,16111,16111,0,11,3411000.0
3411,3411999,20.924926297521186,37.16258923997999,0.08716914609072612,505.93157267570496,227.3920636177063,536.9286575317383,19915,3801,16114,16114,0,11,3412000.0
3412,3412999,20.92592723933051,37.16770366720915,0.08717526520614682,506.05285835266113,227.4578516483307,537.0606002807617,19915,3801,16114,16114,0,11,3413000.0
3413,3413999,20.927980921026414,37.17324273312043,0.08716364027382884,506.2356436252594,227.5244402885437,537.1504783630371,19917,3802,16115,16115,0,11,3414000.0
3414,3414999,20.931333025339026,37.183898335670435,0.08718972337185249,506.35005283355713,227.59060645103455,537.4248008728027,19920,3802,16118,16118,0,11,3415000.0
3415,3415999,20.93493052135218,37.19124504970601,0.0872040900039015,506.52561926841736,227.65619683265686,537.5146713256836,19922,3803,16119,16119,0,11,3416000.0
3416,3416999,20.938754119409253,37.20034532755889,0.0871976346993747,506.6409649848938,227.7209005355835,537.6594390869141,19922,3803,16119,16119,0,11,3417000.0
3417,3417999,20.94307948651519,37.2086277373103,0.08719434898726819,506.9099791049957,227.78671598434448,537.6387367248535,19929,3806,16123,16123,0,11,3418000.0
3418,3418999,20.944474457829184,37.21078394216676,0.087198301304513,507.081259727478,227.8529348373413,538.0252113342285,19950,3807,16143,16143,0,11,3419000.0
3419,3419999,20.94256985331821,37.21020668430671,0.08716698119225319,507.3325307369232,227.91980624198914,538.4054260253906,19976,3810,16166,16166,0,11,3420000.0
3420,3420999,20.94064351958577,37.20948096737613,0.08715309428699836,507.4995651245117,227.98709893226624,538.6040000915527,19983,3811,16172,16172,0,11,3421000.0
3421,3421999,20.939148255322827,37.20864933276275,0.08712804079749259,507.71920895576477,228.05430102348328,538.751049041748,19989,3813,16176,16176,0,11,3422000.0
3422,3422999,20.937084338316165,37.20592533264764,0.08712097433605015,507.83454728126526,228.12015080451965,538.9370155334473,19989,3813,16176,16176,0,11,3423000.0
3423,3423999,20.93534624455847,37.20323507102996,0.08710239528594299,508.0487129688263,228.18726205825806,539.2480201721191,20000,3815,16185,16185,0,11,3424000.0
3424,3424999,20.933533834206624,37.200204355631456,0.08709590184052274,508.1692020893097,230.03779935836792,539.4676551818848,20000,3815,16185,16185,0,11,3425000.0
3425,3425999,20.931558411970364,37.19717025505495,0.08709523512624284,508.3946623802185,230.10419487953186,539.6045608520508,20008,3817,16191,16191,0,11,3426000.0
3426,3426999,20.929895317609574,37.195392915008966,0.08708421234404917,508.52106499671936,230.17102360725403,539.7315139770508,20008,3817,16191,16191,0,11,3427000.0
3427,3427999,20.92837235073695,37.19236449808804,0.08709507163462238,508.6961612701416,230.2377429008484,539.8513870239258,20011,3818,16193,16193,0,11,3428000.0
3428,3428999,20.927396101219664,37.19430350760961,0.08706715414060884,508.8792746067047,230.304851770401,540.0056953430176,20017,3819,16198,16198,0,11,3429000.0
3429,3429999,20.92682149913127,37.19299692823823,0.08705073910128214,508.99842381477356,230.3721661567688,540.3142776489258,20024,3819,16205,16205,0,11,3430000.0
3430,3430999,20.926145158710753,37.191013653282646,0.08704512113721685,509.2182569503784,230.43871212005615,540.4366149902344,20029,3821,16208,16208,0,11,3431000.0
3431,3431999,20.926190789497582,37.19068553350265,0.08703717080440265,509.38335132598877,230.5046362876892,540.5712547302246,20032,3822,16210,16210,0,11,3432000.0
3432,3432999,20.92704627454959,37.19377440915354,0.08702762121766716,509.60423374176025,230.57139348983765,540.6759986877441,20037,3824,16213,16213,0,11,3433000.0
3433,3433999,20.9281267614762,37.19638647832095,0.08701697897207994,509.82556772232056,230.6381676197052,540.7668075561523,20041,3826,16215,16215,0,11,3434000.0
3434,3434999,20.929527526417065,37.19766890363845,0.08700712008837996,510.14787197113037,230.7057089805603,540.8042182922363,20053,3830,16223,16223,0,11,3435000.0
3435,3435999,20.930964334537453,37.19843339650286,0.0870066128364777,510.27964425086975,230.7727611064911,541.2363204956055,20066,3830,16236,16236,0,11,3436000.0
3436,3436999,20.932999996647133,37.20006617700089,0.0870144844849956,510.4486162662506,230.8392834663391,541.4571723937988,20078,3831,16247,16247,0,11,3437000.0
3437,3437999,20.934900817063514,37.20385762289761,0.08702762662233487,510.67018961906433,230.9058301448822,541.6280670166016,20082,3833,16249,16249,0,11,3438000.0
3438,3438999,20.936543937768462,37.20395137241976,0.08704835599507188,510.93934440612793,230.97425723075867,541.7776756286621,20118,3836,16282,16282,0,11,3439000.0
3439,3439999,20.936814575361545,37.202468609935984,0.08705037966597895,511.1112549304962,231.040185213089,541.8732376098633,20120,3837,16283,16283,0,11,3440000.0
3440,3440999,20.934999521646706,37.199841175731315,0.08703972031368423,511.24565291404724,231.11036610603333,542.8022766113281,20160,3837,16323,16323,0,11,3441000.0
3441,3441999,20.93259320254932,37.19640181616829,0.08704194686659272,511.371378660202,231.1773965358734,543.0723991394043,20161,3837,16324,16324,0,11,3442000.0
3442,3442999,20.93014454025974,37.192868096099566,0.08705134545924398,511.4941260814667,231.24503564834595,543.2880439758301,20165,3837,16328,16328,0,11,3443000.0
3443,3443999,20.9277629658668,37.189327293398584,0.08705837295984031,511.6188359260559,231.3114926815033,543.4643020629883,20166,3837,16329,16329,0,11,3444000.0
3444,3444999,20.925640909715582,37.186798005651895,0.08705658753039747,511.79679346084595,231.37869501113892,543.6839447021484,20170,3838,16332,16332,0,11,3445000.0
3445,3445999,20.923748153374056,37.184973244407686,0.08705004212021883,511.9718265533447,231.4458634853363,543.7956962585449,20172,3839,16333,16333,0,11,3446000.0
3446,3446999,20.92161902425289,37.18167703622697,0.08706477233324339,512.0976355075836,231.51281261444092,543.9422607421875,20172,3839,16333,16333,0,11,3447000.0
3447,3447999,20.919558688020633,37.180973479109596,0.08705563504617542,512.2295105457306,231.5816867351532,544.0911407470703,20175,3839,16336,16336,0,11,3448000.0
3448,3448999,20.917940297279202,37.18276971498795,0.08703469257260521,512.4447894096375,231.64863872528076,544.1658058166504,20181,3841,16340,16340,0,11,3449000.0
3449,3449999,20.916333662769482,37.18149581440881,0.08702550693961175,512.6172845363617,231.7159674167633,544.2550354003906,20184,3842,16342,16342,0,11,3450000.0
3450,3450999,20.915373330598953,37.18486676637587,0.08698898688097789,512.8500127792358,231.78442978858948,544.5513000488281,20196,3844,16352,16352,0,11,3451000.0
3451,3451999,20.91416777243712,37.18240028539954,0.0869806540441761,513.0609929561615,231.85370683670044,544.7129058837891,20200,3846,16354,16354,0,11,3452000.0
3452,3452999,20.913033777730305,37.18024878740639,0.08697307402717835,513.2330095767975,231.92040991783142,544.8723220825195,20217,3847,16370,16370,0,11,3453000.0
3453,3453999,20.912080818331734,37.17801396595738,0.08697141294094346,513.409530878067,231.98817253112793,544.9564056396484,20219,3848,16371,16371,0,11,3454000.0
3454,3454999,20.910904848093573,37.175295362100734,0.08696471443564557,513.5387179851532,232.055237531662,545.096118927002,20221,3848,16373,16373,0,11,3455000.0
3455,3455999,20.909663924999307,37.17227125559667,0.08696045329514346,513.6693351268768,232.12150144577026,545.3458518981934,20225,3848,16377,16377,0,11,3456000.0
3456,3456999,20.908446783958162,37.169519873280606,0.08696199916507308,513.8851983547211,232.18813681602478,545.4204711914062,20229,3850,16379,16379,0,11,3457000.0
3457,3457999,20.907297542239604,37.166488766681596,0.08696547986101089,514.0116729736328,232.25501012802124,545.551456451416,20229,3850,16379,16379,0,11,3458000.0
3458,3458999,20.905960105790236,37.163686042647925,0.08695878593981299,514.2442674636841,232.32173204421997,545.6657829284668,20240,3852,16388,16388,0,11,3459000.0
3459,3459999,20.903806038468584,37.161616180546496,0.08694849266528071,514.4690237045288,232.38950562477112,546.2291984558105,20277,3854,16423,16423,0,11,3460000.0
3460,3460999,20.901958529774046,37.16238780428842,0.08693882409314257,514.587399482727,232.45570302009583,546.495002746582,20280,3854,16426,16426,0,11,3461000.0
3461,3461999,20.899712485326987,37.159382357662366,0.08695355837040053,514.7008135318756,232.5213348865509,546.6953392028809,20282,3854,16428,16428,0,11,3462000.0
3462,3462999,20.89747776040076,37.15577481404261,0.0869617875597598,514.8253226280212,232.58751702308655,546.9525299072266,20287,3854,16433,16433,0,11,3463000.0
3463,3463999,20.895907819452027,37.154752190963215,0.08695634157123866,514.9503312110901,232.65473771095276,547.2431831359863,20289,3854,16435,16435,0,11,3464000.0
3464,3464999,20.893898645303675,37.15214225750513,0.08695619714087532,515.1083207130432,232.72051286697388,547.3389625549316,20291,3855,16436,16436,0,11,3465000.0
3465,3465999,20.89200865283622,37.14963455608664,0.0869524562137085,515.2833116054535,232.78681135177612,547.443058013916,20293,3856,16437,16437,0,11,3466000.0
3466,3466999,20.890327492364985,37.14709120513739,0.08694595106131475,515.4072484970093,232.85291123390198,547.5707092285156,20294,3856,16438,16438,0,11,3467000.0
3467,3467999,20.888947319247404,37.14460089856175,0.08693495761229586,515.537517786026,232.91994214057922,547.7780265808105,20300,3856,16444,16444,0,11,3468000.0
3468,3468999,20.88727872947537,37.14199792194921,0.08692961562174062,515.7011179924011,232.9864113330841,548.0353050231934,20324,3857,16467,16467,0,11,3469000.0
3469,3469999,20.88667219379735,37.14469737771295,0.08688254609381507,516.010509967804,233.05312776565552,548.0953636169434,20335,3861,16474,16474,0,11,3470000.0
3470,3470999,20.885980858414552,37.14439070826818,0.08687029887408193,516.1275284290314,233.11886835098267,548.3340606689453,20335,3861,16474,16474,0,11,3471000.0
3471,3471999,20.885302414260366,37.14298937452419,0.08684979662639825,516.3349325656891,233.18601274490356,548.4327697753906,20340,3863,16477,16477,0,11,3472000.0
3472,3472999,20.884867572608044,37.14110547837662,0.086832909824902,516.4528656005859,233.25237250328064,548.6168251037598,20341,3863,16478,16478,0,11,3473000.0
3473,3473999,20.88437051046975,37.13952468600082,0.08681811749829771,516.5816049575806,233.31825709342957,548.7561950683594,20341,3863,16478,16478,0,11,3474000.0
3474,3474999,20.884157145425316,37.13853099042463,0.0868030803125166,516.7057070732117,233.3842968940735,549.0741653442383,20349,3863,16486,16486,0,11,3475000.0
3475,3475999,20.88446367519934,37.13831310002358,0.08678454123635237,516.8696074485779,233.4506332874298,549.2428359985352,20351,3864,16487,16487,0,11,3476000.0
3476,3476999,20.884470716580665,37.13707903365219,0.08677623237472132,517.1337051391602,233.51742887496948,549.3200492858887,20357,3867,16490,16490,0,11,3477000.0
3477,3477999,20.884588814669332,37.13594992852156,0.08676637031354129,517.3049473762512,233.58349871635437,549.4680213928223,20359,3868,16491,16491,0,11,3478000.0
3478,3478999,20.88414583548775,37.13384468109051,0.08675754076390185,517.4698483943939,233.6490683555603,549.5692901611328,20362,3869,16493,16493,0,11,3479000.0
3479,3479999,20.88272579710949,37.13149812125441,0.08673802034528988,517.589483499527,233.71533846855164,550.1564025878906,20377,3869,16508,16508,0,11,3480000.0
3480,3480999,20.879946414578733,37.1276293716982,0.08675110153550103,517.7061333656311,233.78022050857544,550.3732261657715,20378,3869,16509,16509,0,11,3481000.0
3481,3481999,20.87768620104007,37.124664700500276,0.08675011289893886,517.9261746406555,233.8458321094513,550.5104904174805,20384,3871,16513,16513,0,11,3482000.0
3482,3482999,20.876003838091076,37.12282841084073,0.08674494743285954,518.0427701473236,233.9112732410431,550.6793098449707,20385,3871,16514,16514,0,11,3483000.0
3483,3483999,20.874108424958198,37.121891752198835,0.08673144525324938,518.1647620201111,233.97617554664612,550.8110542297363,20385,3871,16514,16514,0,11,3484000.0
3484,3484999,20.87299224808155,37.12096432438022,0.0867104953271598,518.379805803299,234.04180240631104,551.0173416137695,20392,3873,16519,16519,0,11,3485000.0
3485,3485999,20.87195066756947,37.118801272404916,0.08670377696257792,518.5985779762268,234.1074094772339,551.142951965332,20398,3875,16523,16523,0,11,3486000.0
3486,3486999,20.87182652907762,37.119029943123444,0.08668877030634436,518.8068294525146,234.1729395389557,551.2754325866699,20419,3877,16542,16542,0,11,3487000.0
3487,3487999,20.87232421369875,37.11976016251052,0.08668826803088492,518.9831006526947,234.23865008354187,551.3958625793457,20422,3878,16544,16544,0,11,3488000.0
3488,3488999,20.873752081156216,37.122989825391414,0.08669599829890606,519.108470916748,234.30386662483215,551.5950508117676,20426,3878,16548,16548,0,11,3489000.0
3489,3489999,20.876403430709306,37.12949554688495,0.08669465315776959,519.3156740665436,234.36967587471008,551.6996994018555,20435,3880,16555,16555,0,11,3490000.0
3490,3490999,20.880098797603154,37.1361555614306,0.08671046220468048,519.5010862350464,234.43530297279358,552.0237579345703,20450,3881,16569,16569,0,11,3491000.0
3491,3491999,20.88451901321585,37.14386321048575,0.08679309948220715,519.7065229415894,234.50054216384888,552.1799011230469,20455,3883,16572,16572,0,11,3492000.0
3492,3492999,20.889294853285758,37.15096450529705,0.08695480203784134,520.0245583057404,234.56773781776428,552.2582015991211,20467,3887,16580,16580,0,11,3493000.0
3493,3493999,20.894145116934173,37.158162006026934,0.0870822714076035,520.2375667095184,234.6356430053711,552.424934387207,20476,3889,16587,16587,0,11,3494000.0
3494,3494999,20.900724496147976,37.17061419491388,0.08724283010710421,520.3554944992065,234.70075225830078,552.637939453125,20476,3889,16587,16587,0,11,3495000.0
3495,3495999,20.907893885794632,37.183001909065354,0.08748768911558014,520.5231008529663,234.76740145683289,553.0718612670898,20492,3890,16602,16602,0,11,3496000.0
3496,3496999,20.9145747471672,37.19363862297734,0.08773210571920342,520.6323568820953,234.8322308063507,553.340145111084,20492,3890,16602,16602,0,11,3497000.0
3497,3497999,20.91959144594793,37.20187087316012,0.0879262721557692,520.8894369602203,234.89786624908447,553.4737205505371,20498,3893,16605,16605,0,11,3498000.0
3498,3498999,20.925003576162197,37.208363864499674,0.08825970839391795,521.0964512825012,234.96330523490906,553.6308784484863,20502,3895,16607,16607,0,11,3499000.0
3499,3499999,20.929147803216505,37.215000454116684,0.08851005974211135,521.2179489135742,235.02888131141663,553.8180160522461,20502,3895,16607,16607,0,11,3500000.0
3500,3500999,20.92733641850587,37.21299690223183,0.08850509213301183,521.3344469070435,235.09531950950623,554.4738349914551,20526,3895,16631,16631,0,11,3501000.0
3501,3501999,20.925554676625925,37.21127424014442,0.08849762831554331,521.5543715953827,235.16243290901184,554.6440010070801,20545,3897,16648,16648,0,11,3502000.0
3502,3502999,20.92445562639247,37.21071705748478,0.08848068695288847,521.6834492683411,235.2283787727356,554.8443565368652,20547,3897,16650,16650,0,11,3503000.0
3503,3503999,20.923409755681625,37.20976044003262,0.0884634777278891,521.8041298389435,235.29445910453796,554.9965476989746,20548,3897,16651,16651,0,11,3504000.0
3504,3504999,20.921925338623815,37.20826939121618,0.08844937063706038,521.9222855567932,235.3610188961029,555.2842979431152,20553,3897,16656,16656,0,11,3505000.0
3505,3505999,20.92083440247969,37.206086128965715,0.08845793105193178,522.0893168449402,235.42642545700073,555.4903602600098,20556,3898,16658,16658,0,11,3506000.0
3506,3506999,20.920004516337542,37.20734250796241,0.08843620339882174,522.255841255188,235.49184036254883,555.658561706543,20561,3899,16662,16662,0,11,3507000.0
3507,3507999,20.919382626424408,37.20709272627325,0.08842649843012285,522.509758234024,235.55811715126038,555.7841987609863,20571,3902,16669,16669,0,11,3508000.0
3508,3508999,20.91884163644155,37.20623963709533,0.0884253152319473,522.7272071838379,235.62509727478027,555.8544654846191,20580,3904,16676,16676,0,11,3509000.0
3509,3509999,20.92069976089705,37.213235286901956,0.08843578366819538,522.8449790477753,235.69090342521667,556.1008529663086,20585,3904,16681,16681,0,11,3510000.0
3510,3510999,20.923956082213373,37.22378942226126,0.08847998542138802,523.0623438358307,235.75757789611816,556.4392738342285,20597,3906,16691,16691,0,11,3511000.0
3511,3511999,20.929391337321103,37.241113652027096,0.08866552738785627,523.2288360595703,235.82385778427124,556.6523628234863,20599,3907,16692,16692,0,11,3512000.0
3512,3512999,20.93423212137541,37.253458036827084,0.0887395609124445,523.3982441425323,235.88980650901794,556.8184242248535,20601,3908,16693,16693,0,11,3513000.0
3513,3513999,20.93956877117911,37.268034812313246,0.08886681398604224,523.6078150272369,235.95565509796143,556.9583129882812,20606,3910,16696,16696,0,11,3514000.0
3514,3514999,20.944812874377025,37.28618884990296,0.08898835458168453,523.8238499164581,236.02162981033325,557.074764251709,20610,3912,16698,16698,0,11,3515000.0
3515,3515999,20.949210510620265,37.29421456725733,0.08912414171861127,523.9879031181335,236.08744096755981,557.2516136169434,20615,3913,16702,16702,0,11,3516000.0
3516,3516999,20.955335174022064,37.305153058271884,0.08923223704134386,524.109445810318,236.15419721603394,557.7069625854492,20627,3913,16714,16714,0,11,3517000.0
3517,3517999,20.960707224609596,37.31460346397448,0.08934902018076563,524.2748644351959,236.21999645233154,557.8811874389648,20629,3914,16715,16715,0,11,3518000.0
3518,3518999,20.965336626937646,37.319816964503595,0.08950775408850453,524.4891681671143,236.28534817695618,557.9302520751953,20633,3916,16717,16717,0,11,3519000.0
3519,3519999,20.96871295538853,37.32337800635372,0.08954953245563424,524.6534314155579,236.3508105278015,558.0518188476562,20636,3917,16719,16719,0,11,3520000.0
3520,3520999,20.967939194950098,37.3230385503319,0.08952534935134149,524.8186614513397,236.41747641563416,558.5854454040527,20654,3918,16736,16736,0,11,3521000.0
3521,3521999,20.96648167116787,37.32244582215386,0.08950377072028981,524.9366750717163,236.48250770568848,558.869213104248,20656,3918,16738,16738,0,11,3522000.0
3522,3522999,20.965373006895337,37.32273442928637,0.08948910145875422,525.1058945655823,236.5474808216095,559.0611190795898,20661,3919,16742,16742,0,11,3523000.0
3523,3523999,20.96497833853987,37.32592814205698,0.0894499094642367,525.2761070728302,236.6131730079651,559.1747360229492,20664,3920,16744,16744,0,11,3524000.0
3524,3524999,20.96410666174174,37.324627663390885,0.08943163429248913,525.4020142555237,236.67831325531006,559.4434051513672,20668,3920,16748,16748,0,11,3525000.0
3525,3525999,20.963612595323838,37.3242135874382,0.08941379253282788,525.6201205253601,236.74387550354004,559.625129699707,20679,3922,16757,16757,0,11,3526000.0
3526,3526999,20.962595849791413,37.32228695098181,0.08940437188399264,525.7388882637024,236.80906128883362,559.824649810791,20679,3922,16757,16757,0,11,3527000.0
3527,3527999,20.961946120110404,37.32111493517901,0.08940442556390726,526.0371959209442,236.87604475021362,559.869514465332,20693,3926,16767,16767,0,11,3528000.0
3528,3528999,20.962318643810207,37.322891030967206,0.08940223739035746,526.2583887577057,236.94223260879517,560.0016212463379,20700,3928,16772,16772,0,11,3529000.0
3529,3529999,20.964663418598526,37.33101572304455,0.08943345941689007,526.4289925098419,237.0083191394806,560.2547378540039,20706,3929,16777,16777,0,11,3530000.0
3530,3530999,20.967635184787166,37.338200725487,0.08948852006275376,526.5944397449493,237.0753254890442,560.4722099304199,20711,3930,16781,16781,0,11,3531000.0
3531,3531999,20.97311052675779,37.353600192621165,0.08953930701854218,526.7032968997955,237.13979387283325,560.6986961364746,20712,3930,16782,16782,0,11,3532000.0
3532,3532999,20.979678269174812,37.369829615728904,0.08965866220434193,526.8876531124115,237.20516562461853,560.8268661499023,20714,3931,16783,16783,0,11,3533000.0
3533,3533999,20.987432508208098,37.39184246818528,0.0898257997945835,527.0567300319672,237.2705783843994,560.978889465332,20717,3932,16785,16785,0,11,3534000.0
3534,3534999,20.996629418611445,37.42106548591692,0.09004780276423441,527.1725423336029,237.33556580543518,561.1073570251465,20717,3932,16785,16785,0,11,3535000.0
3535,3535999,21.007973975233043,37.460478199795034,0.09025999727113443,527.3391501903534,237.40164637565613,561.2655639648438,20723,3933,16790,16790,0,11,3536000.0
3536,3536999,21.020433731312707,37.49489018305479,0.09056059980026154,527.5618813037872,237.46801924705505,561.5932388305664,20737,3935,16802,16802,0,11,3537000.0
3537,3537999,21.03244678809056,37.52434357098005,0.09099431397354574,527.7290604114532,237.533625125885,561.779712677002,20739,3936,16803,16803,0,11,3538000.0
3538,3538999,21.045032648888974,37.55259084288819,0.0915511465963853,527.9490911960602,237.59915018081665,561.807861328125,20745,3938,16807,16807,0,11,3539000.0
3539,3539999,21.051994432766584,37.56530230204316,0.09164627610606946,528.1229627132416,237.66540455818176,562.2231636047363,20760,3939,16821,16821,0,11,3540000.0
3540,3540999,21.050980833311414,37.56545114824072,0.09160667806956035,528.2421226501465,237.73354721069336,562.7511024475098,20778,3939,16839,16839,0,11,3541000.0
3541,3541999,21.050582336255264,37.569211161389035,0.09157895942471395,528.3635189533234,237.7994828224182,563.0188140869141,20781,3939,16842,16842,0,11,3542000.0
3542,3542999,21.05112543089211,37.5729770379207,0.09150325323359876,528.4828445911407,237.8650357723236,563.1994895935059,20783,3939,16844,16844,0,11,3543000.0
3543,3543999,21.051310365202482,37.57515464924481,0.09146611261010162,528.6086280345917,237.93056631088257,563.3556327819824,20784,3939,16845,16845,0,11,3544000.0
3544,3544999,21.052026103122593,37.57855839964484,0.09142224075256555,528.8205847740173,237.9969038963318,563.5577354431152,20791,3941,16850,16850,0,11,3545000.0
3545,3545999,21.051857127739698,37.57789282153797,0.09140182747269665,528.9841821193695,238.06278324127197,563.6830940246582,20793,3942,16851,16851,0,11,3546000.0
3546,3546999,21.052476089590634,37.579851246943456,0.09136655089468126,529.1061105728149,238.1287236213684,563.8480377197266,20794,3942,16852,16852,0,11,3547000.0
3547,3547999,21.053299729653293,37.581487778572686,0.09132927730557672,529.4319152832031,238.1957187652588,563.8729782104492,20803,3946,16857,16857,0,11,3548000.0
3548,3548999,21.05513609469574,37.58519785391242,0.0913011587493856,529.5995423793793,238.26380324363708,564.0445976257324,20810,3947,16863,16863,0,11,3549000.0
3549,3549999,21.057428749910923,37.588266137997515,0.09129517494466655,529.7707402706146,238.32977867126465,564.1869087219238,20813,3948,16865,16865,0,11,3550000.0
3550,3550999,21.06025530396464,37.59622695174577,0.09127184783361153,529.8880977630615,238.39664602279663,564.6706619262695,20830,3948,16882,16882,0,11,3551000.0
3551,3551999,21.064220751981768,37.6053490763555,0.09129446838044819,530.1164197921753,238.46280455589294,564.8089027404785,20838,3950,16888,16888,0,11,3552000.0
3552,3552999,21.068707848931936,37.61375375479533,0.09133269615327655,530.2365522384644,238.529123544693,564.9579658508301,20838,3950,16888,16888,0,11,3553000.0
3553,3553999,21.07300546634432,37.62274098305516,0.09143192812191159,530.4068279266357,238.59509420394897,565.0637474060059,20841,3951,16890,16890,0,11,3554000.0
3554,3554999,21.07837639118316,37.63866602405866,0.09152960663747434,530.5287442207336,238.66044521331787,565.2261695861816,20841,3951,16890,16890,0,11,3555000.0
3555,3555999,21.085829143009672,37.65510728403188,0.0916813474452105,530.6494698524475,238.72734141349792,565.4679374694824,20844,3951,16893,16893,0,11,3556000.0
3556,3556999,21.093393636724183,37.674106660960945,0.09183345705531887,530.9817168712616,238.8001265525818,565.4280395507812,20859,3955,16904,16904,0,11,3557000.0
3557,3557999,21.099699803048114,37.68601590609486,0.0920638023218614,531.1918296813965,238.8663306236267,565.5486030578613,20863,3957,16906,16906,0,11,3558000.0
3558,3558999,21.10917578621204,37.70756854659272,0.0924390181480419,531.402375459671,238.93209290504456,565.638069152832,20867,3959,16908,16908,0,11,3559000.0
3559,3559999,21.116178007855506,37.72001519137656,0.09264896830835134,531.5782284736633,238.99774527549744,565.827335357666,20872,3960,16912,16912,0,11,3560000.0
3560,3560999,21.115656171930098,37.72100519547544,0.09261016495038943,531.7545638084412,239.06624245643616,566.4663696289062,20901,3961,16940,16940,0,11,3561000.0
3561,3561999,21.11443373581527,37.72159964967614,0.09257949967849632,531.8700151443481,239.13201761245728,566.6742477416992,20902,3961,16941,16941,0,11,3562000.0
3562,3562999,21.113675056650965,37.721994944042265,0.09255103656516628,531.9928121566772,239.198739528656,566.838077545166,20904,3961,16943,16943,0,11,3563000.0
3563,3563999,21.113209930964835,37.72939622644621,0.09248778576349959,532.11168217659,239.26398491859436,566.9357566833496,20904,3961,16943,16943,0,11,3564000.0
3564,3564999,21.112013331371354,37.72812613437018,0.09246396143747448,532.2774062156677,239.32999897003174,567.1124114990234,20909,3962,16947,16947,0,11,3565000.0
3565,3565999,21.111284444316922,37.72688766071328,0.09244238196844679,532.4538650512695,239.3961956501007,567.2978706359863,20912,3963,16949,16949,0,11,3566000.0
3566,3566999,21.11023899872674,37.726647017106465,0.09241158524437199,532.5754444599152,239.46237587928772,567.4420471191406,20913,3963,16950,16950,0,11,3567000.0
3567,3567999,21.109534715994908,37.72478019952292,0.09239835078716319,532.7018411159515,239.53007173538208,567.5522804260254,20913,3963,16950,16950,0,11,3568000.0
3568,3568999,21.108970122495617,37.723105480145485,0.09237832330912554,532.8655226230621,239.59558749198914,567.6249237060547,20916,3964,16952,16952,0,11,3569000.0
3569,3569999,21.109297361610057,37.72530055730071,0.09235348859995496,532.9860973358154,239.66121888160706,567.7710456848145,20918,3964,16954,16954,0,11,3570000.0
3570,3570999,21.1095757419908,37.72464313090931,0.09232972491664282,533.1638648509979,239.7276647090912,568.0127868652344,20926,3965,16961,16961,0,11,3571000.0
3571,3571999,21.109994143199824,37.72394248655279,0.09231167518272221,533.4236929416656,239.79345631599426,568.0086479187012,20933,3968,16965,16965,0,11,3572000.0
3572,3572999,21.11144004962483,37.72749580320253,0.09231106879249429,533.5481693744659,239.85956931114197,568.2213439941406,20934,3968,16966,16966,0,11,3573000.0
3573,3573999,21.113657542371097,37.73253355769848,0.092308254812558,533.7652807235718,239.9263813495636,568.2707099914551,20940,3970,16970,16970,0,11,3574000.0
3574,3574999,21.11580734010099,37.73557148496225,0.0923341647698096,533.9348809719086,239.99198365211487,568.3214721679688,20942,3971,16971,16971,0,11,3575000.0
3575,3575999,21.1182477178357,37.73736708578193,0.09238843087779736,534.2608108520508,240.0589153766632,568.3488655090332,20954,3975,16979,16979,0,11,3576000.0
3576,3576999,21.121656873181998,37.744859131585514,0.09244048003397598,534.3861308097839,240.12495183944702,568.7723083496094,20967,3975,16992,16992,0,11,3577000.0
3577,3577999,21.125241212450653,37.74936179400467,0.09253998372815109,534.5556533336639,240.1913857460022,569.0834274291992,20991,3976,17015,17015,0,11,3578000.0
3578,3578999,21.128198647756314,37.75243501002214,0.09258791081863438,534.7705419063568,240.2572901248932,569.2781028747559,21012,3978,17034,17034,0,11,3579000.0
3579,3579999,21.132208738876436,37.75702993294388,0.09268846121743501,534.9328727722168,240.3229784965515,569.4487075805664,21017,3979,17038,17038,0,11,3580000.0
3580,3580999,21.134397426093944,37.76189200912229,0.09274029541151163,535.1051552295685,240.38929176330566,569.5788612365723,21036,3980,17056,17056,0,11,3581000.0
3581,3581999,21.132970967914353,37.75956698724035,0.092734673985714,535.2797739505768,240.45702838897705,570.3608283996582,21074,3981,17093,17093,0,11,3582000.0
3582,3582999,21.13112729888666,37.75712098083218,0.09272453051516472,535.3973288536072,240.52382612228394,570.6283264160156,21077,3981,17096,17096,0,11,3583000.0
3583,3583999,21.12930632523618,37.75516871041377,0.09272489029707653,535.535578250885,240.59484696388245,570.8248901367188,21080,3981,17099,17099,0,11,3584000.0
3584,3584999,21.127707904616713,37.752493974467,0.09271568443343414,535.7093114852905,240.66233777999878,570.9616394042969,21089,3982,17107,17107,0,11,3585000.0
3585,3585999,21.126557007185905,37.75199243063607,0.09269278975980222,535.8816118240356,240.73028922080994,571.1621856689453,21092,3983,17109,17109,0,11,3586000.0
3586,3586999,21.125442070400634,37.750255922207316,0.09268330691094417,536.0097963809967,240.79632759094238,571.3173179626465,21092,3983,17109,17109,0,11,3587000.0
3587,3587999,21.1240354073295,37.74799856062706,0.09267754168371511,536.1350717544556,240.8673713207245,571.4272994995117,21092,3983,17109,17109,0,11,3588000.0
3588,3588999,21.123161122348264,37.74754371588013,0.09266102164092938,536.262366771698,240.93293380737305,571.5223426818848,21093,3983,17110,17110,0,11,3589000.0
3589,3589999,21.122399214378653,37.74580427414464,0.09265781068223222,536.4821565151215,240.99952101707458,571.5671195983887,21099,3985,17114,17114,0,11,3590000.0
3590,3590999,21.122297582232658,37.749149040477164,0.09264334545028552,536.6473984718323,241.06558799743652,571.6267929077148,21102,3986,17116,17116,0,11,3591000.0
3591,3591999,21.1230253684363,37.7497669625143,0.092625087398296,536.8786001205444,241.13257312774658,571.9269256591797,21116,3988,17128,17128,0,11,3592000.0
3592,3592999,21.123694249958135,37.74995454976615,0.09263084100969221,537.0201418399811,241.20835900306702,572.0856437683105,21116,3988,17128,17128,0,11,3593000.0
3593,3593999,21.124831855880114,37.75059363100821,0.09265991129382256,537.2379503250122,241.27460050582886,572.1861686706543,21126,3990,17136,17136,0,11,3594000.0
3594,3594999,21.125516891245017,37.75314458352737,0.09267372701312726,537.4082632064819,241.34087944030762,572.3335952758789,21157,3991,17166,17166,0,11,3595000.0
3595,3595999,21.127243677596297,37.75974227637329,0.09268999003176026,537.5801296234131,241.4069628715515,572.4282264709473,21160,3992,17168,17168,0,11,3596000.0
3596,3596999,21.128656520668585,37.76296335651946,0.09272949584364465,537.789787530899,241.47440648078918,572.7009696960449,21184,3994,17190,17190,0,11,3597000.0
3597,3597999,21.12965407569899,37.763841631659766,0.09274083517247189,538.0061054229736,241.54063034057617,572.8163223266602,21190,3996,17194,17194,0,11,3598000.0
3598,3598999,21.130958732457817,37.7652695303448,0.09275839396129582,538.1733841896057,241.60623598098755,572.9071311950684,21195,3997,17198,17198,0,11,3599000.0
3599,3599999,21.133056190260696,37.76785517072995,0.09279519163548511,538.3425965309143,241.67159485816956,573.0464248657227,21200,3998,17202,17202,0,11,3600000.0
3600,3600999,21.131790021148085,37.76626471623574,0.09278262062814702,538.5338442325592,241.74806022644043,573.6168785095215,21215,3999,17216,17216,0,11,3601000.0
3601,3601999,21.129942801940018,37.765061757755525,0.09277359554572062,538.7043237686157,241.81481623649597,573.846004486084,21221,4000,17221,17221,0,11,3602000.0
3602,3602999,21.128352551189625,37.76224333869974,0.09277218224755823,538.9245889186859,241.88243651390076,573.9606971740723,21225,4002,17223,17223,0,11,3603000.0
3603,3603999,21.126770298767923,37.76036341396419,0.09276604359809149,539.0521059036255,241.94886803627014,574.1669883728027,21226,4002,17224,17224,0,11,3604000.0
3604,3604999,21.125606324461184,37.758497775816764,0.09276097077071888,539.3298876285553,242.01653575897217,574.2630729675293,21233,4005,17228,17228,0,11,3605000.0
3605,3605999,21.124589888701117,37.757347602103465,0.09274448288112469,539.5523319244385,242.0836386680603,574.3757972717285,21238,4007,17231,17231,0,11,3606000.0
3606,3606999,21.123577443403356,37.75694977598784,0.09273112587610577,539.7725238800049,242.15071487426758,574.4472961425781,21242,4009,17233,17233,0,11,3607000.0
3607,3607999,21.12320512802178,37.7566534789619,0.09272797133398114,539.9407937526703,242.21932554244995,574.5706901550293,21245,4010,17235,17235,0,11,3608000.0
3608,3608999,21.123555287721526,37.75760801159316,0.09271242094429322,540.0641052722931,242.2855908870697,574.7196159362793,21246,4010,17236,17236,0,11,3609000.0
3609,3609999,21.124501401408104,37.76016208384639,0.09269349927736936,540.2491462230682,242.35335230827332,574.851619720459,21250,4011,17239,17239,0,11,3610000.0
3610,3610999,21.127058546046666,37.76495952640404,0.0926778079140832,540.4643745422363,242.42005562782288,574.9990501403809,21258,4013,17245,17245,0,11,3611000.0
3611,3611999,21.130126713307533,37.774945557439494,0.09268209700814056,540.6807227134705,242.48682761192322,575.0844345092773,21263,4015,17248,17248,0,11,3612000.0
3612,3612999,21.13417844095048,37.78449199429021,0.09271584642714215,540.9609067440033,242.56029343605042,575.1145286560059,21273,4018,17255,17255,0,11,3613000.0
3613,3613999,21.137721940518478,37.79399895194691,0.09271693714848173,541.101042509079,242.6282820701599,575.2937240600586,21273,4018,17255,17255,0,11,3614000.0
3614,3614999,21.142823004466166,37.81247040531241,0.0927693793536406,541.4779715538025,242.6963996887207,575.2478179931641,21286,4023,17263,17263,0,11,3615000.0
3615,3615999,21.14830623371407,37.82396617922751,0.0927897573845402,541.7007236480713,242.76440525054932,575.461669921875,21295,4025,17270,17270,0,11,3616000.0
3616,3616999,21.153931057842627,37.83679877481703,0.0928390515280948,541.9138307571411,242.8332712650299,575.5956954956055,21302,4027,17275,17275,0,11,3617000.0
3617,3617999,21.15921531451374,37.84580840059375,0.09287065748581447,542.0834748744965,242.90051865577698,575.6894416809082,21304,4028,17276,17276,0,11,3618000.0
3618,3618999,21.164008431704517,37.85048494097823,0.09292925630310889,542.205361366272,242.9669177532196,575.8345489501953,21304,4028,17276,17276,0,11,3619000.0
3619,3619999,21.16757531906111,37.85572143434601,0.09303560696200253,542.3757002353668,243.0332431793213,575.9786834716797,21306,4029,17277,17277,0,11,3620000.0
3620,3620999,21.166459760603523,37.85384593356124,0.09302617648298994,542.5421104431152,243.09932279586792,576.2142372131348,21313,4030,17283,17283,0,11,3621000.0
3621,3621999,21.16528013819837,37.852903784904804,0.09302071724080918,542.6669638156891,243.16460180282593,576.397819519043,21314,4030,17284,17284,0,11,3622000.0
3622,3622999,21.16440072122628,37.852686816647164,0.0930123085529575,542.790066242218,243.23012471199036,576.5236282348633,21315,4030,17285,17285,0,11,3623000.0
3623,3623999,21.163562262583277,37.85144401456682,0.09300585659820071,542.9136862754822,243.29511904716492,576.6211166381836,21315,4030,17285,17285,0,11,3624000.0
3624,3624999,21.16258836368851,37.84952502380245,0.09300005433740244,543.0413250923157,243.36058235168457,576.7602958679199,21317,4030,17287,17287,0,11,3625000.0
3625,3625999,21.161874171254517,37.848016130000104,0.09299174995894666,543.2351748943329,243.4264931678772,576.7607955932617,21319,4031,17288,17288,0,11,3626000.0
3626,3626999,21.161160162263624,37.84649259461541,0.09298740224011914,543.4077134132385,243.49249410629272,576.8206596374512,21321,4032,17289,17289,0,11,3627000.0
3627,3627999,21.160816540834855,37.845907524129395,0.09298112119379154,543.6195261478424,243.55810594558716,576.8164482116699,21329,4034,17295,17295,0,11,3628000.0
3628,3628999,21.161468509417006,37.84796895333636,0.09297640840480637,543.7894105911255,243.6244134902954,576.8511390686035,21333,4035,17298,17298,0,11,3629000.0
3629,3629999,21.162075016443396,37.853437232235855,0.09296050205998496,543.9749345779419,243.69088220596313,576.9262351989746,21338,4036,17302,17302,0,11,3630000.0
3630,3630999,21.16348120728077,37.856535684279315,0.09293973397291266,544.0991237163544,243.75649857521057,577.0673942565918,21339,4036,17303,17303,0,11,3631000.0
3631,3631999,21.165514182871803,37.85968166438179,0.09291519785571833,544.2239680290222,243.82127356529236,577.1742553710938,21339,4036,17303,17303,0,11,3632000.0
3632,3632999,21.167002925766923,37.86157144606131,0.09291481735580431,544.3651337623596,243.88656568527222,577.2447929382324,21339,4036,17303,17303,0,11,3633000.0
3633,3633999,21.169088976495644,37.86434942793457,0.09293379338241448,544.5396010875702,243.95216488838196,577.270637512207,21341,4037,17304,17304,0,11,3634000.0
3634,3634999,21.171454312732646,37.87164182941226,0.09292048315181456,544.7693481445312,244.0184817314148,577.2582893371582,21349,4039,17310,17310,0,11,3635000.0
3635,3635999,21.173639995252348,37.87347863259815,0.09294640016774092,544.9431617259979,244.08454489707947,577.2845497131348,21355,4040,17315,17315,0,11,3636000.0
3636,3636999,21.17613970608598,37.87651255877416,0.0929482497775721,545.2260880470276,244.152099609375,577.3525810241699,21372,4043,17329,17329,0,11,3637000.0
3637,3637999,21.17775555489764,37.87925959313112,0.0929313931507112,545.3487780094147,244.21888422966003,577.4597282409668,21372,4043,17329,17329,0,11,3638000.0
3638,3638999,21.179858154032676,37.88256089893645,0.0929248513147739,545.5789036750793,244.28443431854248,577.4448852539062,21378,4045,17333,17333,0,11,3639000.0
3639,3639999,21.18074789863015,37.887579245705,0.09292414667921345,545.8207371234894,244.36603593826294,577.4992256164551,21387,4047,17340,17340,0,11,3640000.0
3640,3640999,21.17960765471834,37.884546583738455,0.09294467591505307,545.9464213848114,244.43124985694885,577.8687210083008,21391,4047,17344,17344,0,11,3641000.0
3641,3641999,21.177895915327948,37.88170165056448,0.09294585856448145,546.0786025524139,244.49689555168152,578.0451469421387,21392,4047,17345,17345,0,11,3642000.0
3642,3642999,21.176087426864946,37.878764096234754,0.09294975856418186,546.2477462291718,244.56387782096863,578.1837768554688,21394,4048,17346,17346,0,11,3643000.0
3643,3643999,21.174278131207334,37.87534432914229,0.09296688167142486,546.366308927536,244.6295382976532,578.2856941223145,21394,4048,17346,17346,0,11,3644000.0
3644,3644999,21.172792002055097,37.8725087334558,0.09296658565820182,546.5452191829681,244.69569563865662,578.353874206543,21402,4049,17353,17353,0,11,3645000.0
3645,3645999,21.17239258076393,37.87110666956276,0.09291622409897438,546.7709300518036,244.7616515159607,578.4495468139648,21410,4051,17359,17359,0,11,3646000.0
3646,3646999,21.171325708096596,37.868339930928926,0.09289297323696988,546.8938210010529,244.82827591896057,578.57373046875,21410,4051,17359,17359,0,11,3647000.0
3647,3647999,21.170135139263017,37.86711794519972,0.09287406206992188,547.1764285564423,244.89468693733215,578.473705291748,21424,4054,17370,17370,0,11,3648000.0
3648,3648999,21.168764805891648,37.86411977822126,0.09286792535642052,547.299375295639,244.96095442771912,578.6298141479492,21424,4054,17370,17370,0,11,3649000.0
3649,3649999,21.16778613697239,37.862007679456596,0.0928542124481343,547.479674577713,245.0283055305481,578.6764297485352,21428,4055,17373,17373,0,11,3650000.0
3650,3650999,21.166898215598707,37.85919675227992,0.09283057321660404,547.7054650783539,245.09461855888367,578.7370491027832,21437,4057,17380,17380,0,11,3651000.0
3651,3651999,21.16707582845311,37.85739180161605,0.09280296882282868,547.8770267963409,245.16054010391235,578.8658981323242,21440,4058,17382,17382,0,11,3652000.0
3652,3652999,21.16719133688128,37.856000484901124,0.09279270676022044,548.0522089004517,245.22638320922852,578.9353866577148,21446,4059,17387,17387,0,11,3653000.0
3653,3653999,21.16816177493324,37.85677600182453,0.09279611229557827,548.2820355892181,245.29275703430176,578.9950866699219,21454,4061,17393,17393,0,11,3654000.0
3654,3654999,21.168695667644407,37.85620835633141,0.09279176505995324,548.5683269500732,245.36403036117554,579.0034675598145,21465,4064,17401,17401,0,11,3655000.0
3655,3655999,21.169918260763577,37.85707959986907,0.09277957998629993,548.6971116065979,245.4310426712036,579.169807434082,21465,4064,17401,17401,0,11,3656000.0
3656,3656999,21.172041930008888,37.85975596924855,0.09274394037185962,548.8634073734283,245.49665904045105,579.3342094421387,21467,4065,17402,17402,0,11,3657000.0
3657,3657999,21.173561713079355,37.86070985527154,0.092717644047141,549.0374646186829,245.56276106834412,579.4024505615234,21469,4066,17403,17403,0,11,3658000.0
3658,3658999,21.17509602195424,37.86242182963239,0.09269207287944403,549.2154903411865,245.62850689888,579.4637794494629,21476,4067,17409,17409,0,11,3659000.0
3659,3659999,21.175133479854768,37.86081712713104,0.09269238352700293,549.3793268203735,245.69363951683044,579.5050735473633,21478,4068,17410,17410,0,11,3660000.0
3660,3660999,21.17486215538524,37.86012834323722,0.09265303542546555,549.494048833847,245.75952315330505,579.7791938781738,21480,4068,17412,17412,0,11,3661000.0
3661,3661999,21.174201789408535,37.858634329895665,0.09262577172971243,549.6361904144287,245.83485770225525,579.8885040283203,21480,4068,17412,17412,0,11,3662000.0
3662,3662999,21.17376175458395,37.85750275879088,0.09259791078918533,549.9115178585052,245.90045595169067,579.8230667114258,21495,4071,17424,17424,0,11,3663000.0
3663,3663999,21.17275610704617,37.85485653815221,0.09258321087538379,550.1957240104675,245.96677899360657,579.7954025268555,21509,4074,17435,17435,0,11,3664000.0
3664,3664999,21.172581454957253,37.85264410136352,0.09255551691451525,550.3714928627014,246.03235721588135,579.8700828552246,21516,4075,17441,17441,0,11,3665000.0
3665,3665999,21.171833646608118,37.85015762249685,0.09254478548617373,550.5434241294861,246.0981318950653,579.900806427002,21518,4076,17442,17442,0,11,3666000.0
3666,3666999,21.171024213027348,37.847594328592585,0.0925310508079854,550.7233173847198,246.16351509094238,579.9376792907715,21520,4077,17443,17443,0,11,3667000.0
3667,3667999,21.17030238661612,37.845152182299735,0.092527929798495,550.8930625915527,246.22937035560608,579.9905967712402,21522,4078,17444,17444,0,11,3668000.0
3668,3668999,21.16984599783663,37.84825696271267,0.09249098319064974,551.1156125068665,246.29504942893982,579.9995155334473,21530,4080,17450,17450,0,11,3669000.0
3669,3669999,21.169644704683773,37.846219533310915,0.0924621990303911,551.2857267856598,246.36224246025085,580.0750694274902,21533,4081,17452,17452,0,11,3670000.0
3670,3670999,21.17016558871691,37.8445258081806,0.09241794703984252,551.4606537818909,246.4277331829071,580.1127433776855,21535,4082,17453,17453,0,11,3671000.0
3671,3671999,21.170077735883332,37.842369851692425,0.09238770386424211,551.6429445743561,246.49310946464539,580.1288642883301,21541,4083,17458,17458,0,11,3672000.0
3672,3672999,21.170524231288027,37.84316288059713,0.0923460591215941,551.7633349895477,246.55880069732666,580.2037887573242,21541,4083,17458,17458,0,11,3673000.0
3673,3673999,21.170764333318594,37.84152979725742,0.09231493249659573,552.0912127494812,246.62515926361084,580.0518913269043,21558,4087,17471,17471,0,11,3674000.0
3674,3674999,21.171567183552796,37.83993055426161,0.09227205270982908,552.3103926181793,246.69126749038696,580.1328125,21562,4089,17473,17473,0,11,3675000.0
3675,3675999,21.172366380489102,37.838568842791304,0.0922361355182365,552.488694190979,246.75696873664856,580.2013282775879,21564,4090,17474,17474,0,11,3676000.0
3676,3676999,21.172951912139837,37.83992052326667,0.09220313452604356,552.7215745449066,246.82275581359863,580.2301445007324,21568,4092,17476,17476,0,11,3677000.0
3677,3677999,21.172086826808208,37.8368212088616,0.09219229348949332,552.8926289081573,246.88754606246948,580.3224639892578,21575,4093,17482,17482,0,11,3678000.0
3678,3678999,21.170174554287133,37.833601378197166,0.09219038520883982,553.0578808784485,246.95367813110352,580.4618949890137,21577,4094,17483,17483,0,11,3679000.0
3679,3679999,21.16810359703003,37.83021924297946,0.09219156177245724,553.3293642997742,247.02026963233948,580.4322547912598,21587,4097,17490,17490,0,11,3680000.0
3680,3680999,21.166230304793036,37.82692775563274,0.09219351749757498,553.5844531059265,247.08770513534546,580.5520477294922,21595,4099,17496,17496,0,11,3681000.0
3681,3681999,21.164323299087318,37.82343518022081,0.09220015422309324,553.8099963665009,247.1549003124237,580.5843849182129,21601,4101,17500,17500,0,11,3682000.0
3682,3682999,21.163114577351084,37.82182843868781,0.09218220286506662,553.9353907108307,247.22263860702515,580.8454322814941,21602,4101,17501,17501,0,11,3683000.0
3683,3683999,21.161431841415602,37.81835323109901,0.09218094108298458,554.0706532001495,247.28884100914001,580.9737129211426,21602,4101,17501,17501,0,11,3684000.0
3684,3684999,21.160286823373582,37.81607971278103,0.0921695094126086,554.2454245090485,247.35420417785645,581.013313293457,21604,4102,17502,17502,0,11,3685000.0
3685,3685999,21.15913059207706,37.81363490135439,0.09215874243440647,554.429797410965,247.42035794258118,581.0972480773926,21608,4103,17505,17505,0,11,3686000.0
3686,3686999,21.15818084222611,37.812274943536195,0.09214210181352445,554.5457870960236,247.48599076271057,581.2182464599609,21608,4103,17505,17505,0,11,3687000.0
3687,3687999,21.157496033520875,37.810145621050985,0.09213549864655324,554.6657388210297,247.55185294151306,581.5327949523926,21610,4103,17507,17507,0,11,3688000.0
3688,3688999,21.157575751243478,37.809070984182796,0.09212551516132916,554.9401350021362,247.61858916282654,581.6370697021484,21616,4106,17510,17510,0,11,3689000.0
3689,3689999,21.158117699942476,37.810584799596676,0.09211033561446158,555.1173906326294,247.68491744995117,581.6786804199219,21618,4107,17511,17511,0,11,3690000.0
3690,3690999,21.158563869625414,37.81010580648777,0.09209226412254712,555.2383000850677,247.7508568763733,581.7809257507324,21618,4107,17511,17511,0,11,3691000.0
3691,3691999,21.159180532409287,37.80991936626048,0.09208959338276623,555.4285442829132,247.81723642349243,581.8519325256348,21620,4108,17512,17512,0,11,3692000.0
3692,3692999,21.160190043505136,37.8099073149038,0.09207202885591004,555.7020883560181,247.88368344306946,581.8919486999512,21642,4111,17531,17531,0,11,3693000.0
3693,3693999,21.161852391399353,37.81278063719086,0.09203038776042372,555.833794593811,247.95182871818542,582.0754737854004,21642,4111,17531,17531,0,11,3694000.0
3694,3694999,21.162658585651734,37.812060296877654,0.09202244071691223,555.962336063385,248.0177698135376,582.1986656188965,21642,4111,17531,17531,0,11,3695000.0
3695,3695999,21.163793821523264,37.811160616621,0.09200786986315768,556.086100101471,248.08302330970764,582.2862167358398,21642,4111,17531,17531,0,11,3696000.0
3696,3696999,21.164597192527697,37.81035565294792,0.09198954461812436,556.2089936733246,248.14863562583923,582.3546829223633,21642,4111,17531,17531,0,11,3697000.0
3697,3697999,21.16333646711882,37.80803819025636,0.09199166937657655,556.4419367313385,248.21453428268433,582.4717636108398,21656,4113,17543,17543,0,11,3698000.0
3698,3698999,21.160741461010783,37.80395878271128,0.09200452270144155,556.5821549892426,248.28580594062805,582.5683517456055,21656,4113,17543,17543,0,11,3699000.0
3699,3699999,21.158699798171757,37.80123913701324,0.09200649097473246,556.7612397670746,248.35232305526733,582.6880683898926,21659,4114,17545,17545,0,11,3700000.0
3700,3700999,21.15656582481449,37.79757009863001,0.09202087287582206,556.8925886154175,248.41805624961853,582.7840919494629,21659,4114,17545,17545,0,11,3701000.0
3701,3701999,21.154411137869875,37.79509614642383,0.09202409457087402,557.0665428638458,248.4843394756317,582.80322265625,21661,4115,17546,17546,0,11,3702000.0
3702,3702999,21.152857122829335,37.79171536928299,0.09202156922858273,557.2490561008453,248.55135250091553,583.0592346191406,21667,4116,17551,17551,0,11,3703000.0
3703,3703999,21.151220141338538,37.78839889737091,0.09202110332220137,557.4292416572571,248.61769270896912,583.1818695068359,21673,4117,17556,17556,0,11,3704000.0
3704,3704999,21.150234866548793,37.78695131564201,0.0920125384140057,557.611597776413,248.6842761039734,583.2416496276855,21675,4118,17557,17557,0,11,3705000.0
3705,3705999,21.149695451131965,37.78884728439882,0.09199066325304439,557.7306191921234,248.7502739429474,583.3703880310059,21675,4118,17557,17557,0,11,3706000.0
3706,3706999,21.148906740979253,37.78731247189588,0.09199601850505879,557.9459064006805,248.81654858589172,583.4341888427734,21679,4120,17559,17559,0,11,3707000.0
3707,3707999,21.149361781989167,37.787795188057956,0.09199598962403577,558.1467072963715,248.88396215438843,583.5467491149902,21684,4121,17563,17563,0,11,3708000.0
3708,3708999,21.15007381153411,37.7890536723102,0.09198443771472808,558.3233325481415,248.95054960250854,583.7485656738281,21688,4122,17566,17566,0,11,3709000.0
3709,3709999,21.151503280811625,37.79568679944962,0.09194651989138392,558.5042824745178,249.01698660850525,583.8160781860352,21692,4123,17569,17569,0,11,3710000.0
3710,3710999,21.15244494284387,37.79625320175834,0.09194256021409808,558.7207369804382,249.08396673202515,583.9007720947266,21700,4125,17575,17575,0,11,3711000.0
3711,3711999,21.153664039208515,37.797935847053814,0.09192672055993767,558.9538671970367,249.1513659954071,583.9430503845215,21704,4127,17577,17577,0,11,3712000.0
3712,3712999,21.154620651791753,37.798002008624316,0.0919186609824123,559.1345553398132,249.21971654891968,584.0435371398926,21706,4128,17578,17578,0,11,3713000.0
3713,3713999,21.156429699092907,37.80151080032476,0.091897381809382,559.3689353466034,249.28672552108765,584.2954788208008,21712,4130,17582,17582,0,11,3714000.0
3714,3714999,21.158089481954978,37.80275087519044,0.09188025663256205,559.486340045929,249.35273385047913,584.5847663879395,21712,4130,17582,17582,0,11,3715000.0
3715,3715999,21.15945005639162,37.803016698810865,0.09187196303837275,559.619470834732,249.4214015007019,584.7252769470215,21712,4130,17582,17582,0,11,3716000.0
3716,3716999,21.16056247857845,37.80292549001494,0.09185232913898944,559.7475519180298,249.48801946640015,584.8345108032227,21712,4130,17582,17582,0,11,3717000.0
3717,3717999,21.16038244573474,37.801163303923936,0.09184549054430524,560.010390996933,249.5538365840912,584.7765235900879,21723,4133,17590,17590,0,11,3718000.0
3718,3718999,21.15885604505899,37.800300411160954,0.09183671928861148,560.1878795623779,249.6201777458191,585.189582824707,21748,4134,17614,17614,0,11,3719000.0
3719,3719999,21.156771785563503,37.7973368643039,0.09184623214522991,560.3174877166748,249.6865532398224,585.3588523864746,21748,4134,17614,17614,0,11,3720000.0
3720,3720999,21.154664015713312,37.79400454950499,0.09185903418402264,560.4475090503693,249.75285601615906,585.4987106323242,21749,4134,17615,17615,0,11,3721000.0
3721,3721999,21.152992031213397,37.79112257736665,0.0918666004882327,560.5640065670013,249.8186891078949,585.5912170410156,21749,4134,17615,17615,0,11,3722000.0
3722,3722999,21.151181790212327,37.78784679320942,0.09187315447936206,560.6900641918182,249.88527917861938,585.7419204711914,21750,4134,17616,17616,0,11,3723000.0
3723,3723999,21.149824547616568,37.785396793569305,0.09187680939335552,560.9230082035065,249.9526126384735,585.792163848877,21755,4136,17619,17619,0,11,3724000.0
3724,3724999,21.148195484503624,37.7823972146809,0.0918810998474513,561.05664229393,250.0188753604889,585.9005737304688,21755,4136,17619,17619,0,11,3725000.0
3725,3725999,21.14657870542267,37.78000256189001,0.09188118435252124,561.1816527843475,250.08550477027893,585.9717597961426,21755,4136,17619,17619,0,11,3726000.0
3726,3726999,21.145593877491546,37.77864407068664,0.09187813697718816,561.3000128269196,250.1516661643982,586.0650444030762,21755,4136,17619,17619,0,11,3727000.0
3727,3727999,21.14432165415851,37.776192769276854,0.0918735492733066,561.4281983375549,250.21800923347473,586.1478614807129,21756,4136,17620,17620,0,11,3728000.0
3728,3728999,21.14319748069684,37.77389626527117,0.0918660465618314,561.6082715988159,250.2855989933014,586.3146743774414,21763,4137,17626,17626,0,11,3729000.0
3729,3729999,21.142742889272466,37.77273982450067,0.09185236562219579,561.738422870636,250.35217714309692,586.3924217224121,21763,4137,17626,17626,0,11,3730000.0
3730,3730999,21.141886005370743,37.77042822798458,0.09184730072699965,561.956221818924,250.4187891483307,586.4170684814453,21770,4139,17631,17631,0,11,3731000.0
3731,3731999,21.141167978883974,37.76917807972483,0.09183873340862814,562.135555267334,250.4861662387848,586.4601058959961,21777,4140,17637,17637,0,11,3732000.0
3732,3732999,21.140253970504872,37.76696142452906,0.09183042928084317,562.326798915863,250.55416440963745,586.5275497436523,21784,4141,17643,17643,0,11,3733000.0
3733,3733999,21.14010526587281,37.768138263610254,0.09180319810328863,562.4543409347534,250.62260103225708,586.7055969238281,21785,4141,17644,17644,0,11,3734000.0
3734,3734999,21.139404710879155,37.76591973351001,0.09180034737128351,562.5784633159637,250.68873620033264,586.8162422180176,21785,4141,17644,17644,0,11,3735000.0
3735,3735999,21.138771149642565,37.76348414993807,0.09179691868268247,562.7517986297607,250.75530362129211,586.8568992614746,21787,4142,17645,17645,0,11,3736000.0
3736,3736999,21.137573491463463,37.76241000121938,0.09177931552877283,562.883661031723,250.82164025306702,586.9317054748535,21787,4142,17645,17645,0,11,3737000.0
3737,3737999,21.135329891366784,37.7594779367346,0.09178476408286407,563.0640420913696,250.88771057128906,587.150333404541,21790,4143,17647,17647,0,11,3738000.0
3738,3738999,21.132928519052367,37.75687841301601,0.09179041012391842,563.2810304164886,250.95423650741577,587.2020721435547,21794,4145,17649,17649,0,11,3739000.0
3739,3739999,21.13075995375713,37.75332607044832,0.09180408090153636,563.4779286384583,251.02977204322815,587.2977256774902,21796,4146,17650,17650,0,11,3740000.0
3740,3740999,21.128976994282052,37.75087664787558,0.09180694710532944,563.6527426242828,251.09628343582153,587.347972869873,21798,4147,17651,17651,0,11,3741000.0
3741,3741999,21.127578721930547,37.7507205517256,0.09179674730595111,563.8813598155975,251.16310334205627,587.4816780090332,21803,4149,17654,17654,0,11,3742000.0
3742,3742999,21.126056839099004,37.74842846619708,0.0917893703247602,564.0057590007782,251.22919631004333,587.6046752929688,21803,4149,17654,17654,0,11,3743000.0
3743,3743999,21.12445525092022,37.74676980950031,0.09178068425470365,564.253937959671,251.29789018630981,587.5889282226562,21807,4151,17656,17656,0,11,3744000.0
3744,3744999,21.12373163818019,37.746058908653744,0.09175766212254521,564.369312286377,251.36386942863464,587.7399406433105,21807,4151,17656,17656,0,11,3745000.0
3745,3745999,21.123158372866417,37.749958995138094,0.09171694829785426,564.4843502044678,251.42991304397583,587.8408012390137,21807,4151,17656,17656,0,11,3746000.0
3746,3746999,21.123430772407172,37.7503473952422,0.09169134342867513,564.6552102565765,251.49635219573975,587.9594802856445,21813,4152,17661,17661,0,11,3747000.0
3747,3747999,21.12401735791409,37.75196423642382,0.09166997995611337,564.7799637317657,251.56275582313538,588.1818313598633,21815,4152,17663,17663,0,11,3748000.0
3748,3748999,21.124796752437128,37.752672564936276,0.09164892798985269,564.9573578834534,251.62886095046997,588.2547378540039,21817,4153,17664,17664,0,11,3749000.0
3749,3749999,21.126461493333128,37.756900559933705,0.09161507278585657,565.2942447662354,251.69803166389465,588.2387046813965,21825,4157,17668,17668,0,11,3750000.0
3750,3750999,21.128660313585645,37.76416820821719,0.09158493115328126,565.520161151886,251.76531791687012,588.3081855773926,21833,4159,17674,17674,0,11,3751000.0
3751,3751999,21.130932114797158,37.77022825108945,0.09158073791239851,565.7390367984772,251.83204531669617,588.3625679016113,21837,4161,17676,17676,0,11,3752000.0
3752,3752999,21.132483115837864,37.77349601822478,0.09158386283493969,565.9679455757141,251.89923858642578,588.4398727416992,21845,4163,17682,17682,0,11,3753000.0
3753,3753999,21.135120016833536,37.78099250959953,0.09155330922877747,566.0932970046997,251.96583795547485,588.6571311950684,21845,4163,17682,17682,0,11,3754000.0
3754,3754999,21.137426276968828,37.783360326121034,0.09153717801054984,566.2773246765137,252.03542470932007,588.7280464172363,21847,4164,17683,17683,0,11,3755000.0
3755,3755999,21.1396164483516,37.7877133178,0.09152606142306352,566.5974617004395,252.10279774665833,588.7362251281738,21860,4168,17692,17692,0,11,3756000.0
3756,3756999,21.140695316334213,37.78714776427617,0.09152902486142178,566.8255207538605,252.16993522644043,588.7310523986816,21864,4170,17694,17694,0,11,3757000.0
3757,3757999,21.1394221861146,37.784303520263826,0.09152888938329884,566.9482061862946,252.23507618904114,588.9389152526855,21867,4170,17697,17697,0,11,3758000.0
3758,3758999,21.137176277373175,37.78180039852193,0.09153333046620049,567.1245970726013,252.30032801628113,589.0476913452148,21869,4171,17698,17698,0,11,3759000.0
3759,3759999,21.135039920351765,37.77899753854244,0.09153265345936057,567.2501080036163,252.36511707305908,589.1568450927734,21870,4171,17699,17699,0,11,3760000.0
3760,3760999,21.133260925768592,37.77709623983706,0.09152866565811835,567.4721112251282,252.4306275844574,589.2045745849609,21876,4173,17703,17703,0,11,3761000.0
3761,3761999,21.132140750806343,37.77882229022894,0.09150717051612178,567.6953842639923,252.49624967575073,589.1937065124512,21885,4175,17710,17710,0,11,3762000.0
3762,3762999,21.130929759913656,37.77681005199523,0.09149624611320184,567.9168455600739,252.56231665611267,589.293628692627,21893,4177,17716,17716,0,11,3763000.0
3763,3763999,21.130011878736305,37.77685227248331,0.09147331216306764,568.0954015254974,252.62743854522705,589.3491172790527,21900,4178,17722,17722,0,11,3764000.0
3764,3764999,21.129044660206343,37.775349511795554,0.09145682106570852,568.3227245807648,252.69294834136963,589.3906059265137,21905,4180,17725,17725,0,11,3765000.0
3765,3765999,21.12806159373267,37.77360287011748,0.09144910309226306,568.5088624954224,252.75869703292847,589.4680824279785,21911,4181,17730,17730,0,11,3766000.0
3766,3766999,21.127719379018302,37.77318639826934,0.09142975293283839,568.6812980175018,252.82422709465027,589.4995727539062,21914,4182,17732,17732,0,11,3767000.0
3767,3767999,21.127219688367255,37.772518453466816,0.09141803186952435,568.9068403244019,252.88992738723755,589.4568481445312,21919,4184,17735,17735,0,11,3768000.0
3768,3768999,21.128067155596682,37.77417079480748,0.09138980113136141,569.0796160697937,252.9569115638733,589.5830154418945,21922,4185,17737,17737,0,11,3769000.0
3769,3769999,21.130548076045844,37.78167967135089,0.09135670273134011,569.3050997257233,253.0228726863861,589.6142730712891,21930,4187,17743,17743,0,11,3770000.0
3770,3770999,21.133256806547834,37.78860338675436,0.09138587090788297,569.5371425151825,253.08849811553955,589.6627807617188,21939,4189,17750,17750,0,11,3771000.0
3771,3771999,21.13743361061359,37.80152589676479,0.09138467799211603,569.6750545501709,253.15386843681335,589.7894439697266,21939,4189,17750,17750,0,11,3772000.0
3772,3772999,21.141233605169255,37.808809997490044,0.09143150536830402,569.9120495319366,253.22016835212708,589.7974090576172,21947,4191,17756,17756,0,11,3773000.0
3773,3773999,21.146285598185813,37.820847387979995,0.09147194476769405,570.1818854808807,253.28640961647034,589.7985191345215,21958,4194,17764,17764,0,11,3774000.0
3774,3774999,21.15149355552163,37.83426247198413,0.09141708322385556,570.409544467926,253.35272359848022,589.9236373901367,21969,4196,17773,17773,0,11,3775000.0
3775,3775999,21.155783615351325,37.84114592037297,0.09140124645014702,570.5213775634766,253.4178581237793,590.1601142883301,21970,4196,17774,17774,0,11,3776000.0
3776,3776999,21.160457525709393,37.84804886255224,0.09143697791200811,570.694498538971,253.48366236686707,590.2467269897461,21972,4197,17775,17775,0,11,3777000.0
3777,3777999,21.16357061030367,37.85092197743408,0.0914496017948282,570.9241981506348,253.54981780052185,590.2588386535645,21980,4199,17781,17781,0,11,3778000.0
3778,3778999,21.163654969782016,37.850252017739805,0.09144120016052504,571.2479741573334,253.6154420375824,590.3090286254883,21993,4203,17790,17790,0,11,3779000.0
3779,3779999,21.16184207282886,37.851657271209774,0.09141788976465326,571.473895072937,253.68308925628662,590.3923416137695,21998,4205,17793,17793,0,11,3780000.0
3780,3780999,21.160340583976485,37.850700833731935,0.0914006899883536,571.5911090373993,253.74854135513306,590.575511932373,21999,4205,17794,17794,0,11,3781000.0
3781,3781999,21.158857373788734,37.84905557700683,0.0913887725088387,571.7706699371338,253.81462621688843,590.6342315673828,22005,4206,17799,17799,0,11,3782000.0
3782,3782999,21.157538468926376,37.84781980996827,0.09137202987150672,572.0034136772156,253.8806607723236,590.6298217773438,22009,4208,17801,17801,0,11,3783000.0
3783,3783999,21.156393370454772,37.84568453603954,0.09135286842039048,572.1910073757172,253.94688296318054,590.822566986084,22011,4209,17802,17802,0,11,3784000.0
3784,3784999,21.155285463528013,37.844954392773865,0.09132885313401307,572.3075420856476,254.0121443271637,590.9334259033203,22011,4209,17802,17802,0,11,3785000.0
3785,3785999,21.15441295450228,37.843712883181176,0.09130962042766877,572.5374326705933,254.07840013504028,590.8667907714844,22019,4211,17808,17808,0,11,3786000.0
3786,3786999,21.15339484591546,37.841887533770574,0.0912968438530326,572.7223117351532,254.14635300636292,590.9561882019043,22021,4212,17809,17809,0,11,3787000.0
3787,3787999,21.153507378660528,37.84434209896514,0.09127782129754414,572.9098129272461,254.2130606174469,591.0061683654785,22024,4213,17811,17811,0,11,3788000.0
3788,3788999,21.155529934454215,37.85130873450955,0.09124050492187907,573.1378757953644,254.27953934669495,591.0316200256348,22045,4215,17830,17830,0,11,3789000.0
3789,3789999,21.15995856424471,37.86542772071342,0.09121277035586417,573.4675760269165,254.3463213443756,591.0503234863281,22056,4219,17837,17837,0,11,3790000.0
3790,3790999,21.164617693031868,37.88182712435683,0.0913266124435067,573.6367139816284,254.41256070137024,591.1638793945312,22058,4220,17838,17838,0,11,3791000.0
3791,3791999,21.1710895120392,37.900145003452394,0.09135401080078176,573.9091081619263,254.4797031879425,591.2184829711914,22083,4223,17860,17860,0,11,3792000.0
3792,3792999,21.178078788352458,37.915181593762725,0.09146454158566841,574.2470517158508,254.5488157272339,591.246768951416,22129,4227,17902,17902,0,11,3793000.0
3793,3793999,21.18583799402271,37.93367154777482,0.09159471430729094,574.5316476821899,254.6159405708313,591.3134078979492,22138,4230,17908,17908,0,11,3794000.0
3794,3794999,21.19382415721842,37.951268460450464,0.09174062469969024,574.7613620758057,254.68422842025757,591.4140510559082,22143,4232,17911,17911,0,11,3795000.0
3795,3795999,21.202881128817875,37.97099622198644,0.09179643843281127,574.9841568470001,254.75046968460083,591.4786987304688,22152,4234,17918,17918,0,11,3796000.0
3796,3796999,21.210474835526625,37.98477589703788,0.09195339119347223,575.2066960334778,254.8172287940979,591.5038223266602,22160,4236,17924,17924,0,11,3797000.0
3797,3797999,21.218583073557284,37.99867750393933,0.09217464525661201,575.3757238388062,254.8833043575287,591.5903205871582,22162,4237,17925,17925,0,11,3798000.0
3798,3798999,21.22367608327095,38.00558954467845,0.09228178910615847,575.6526956558228,254.95126128196716,591.611759185791,22179,4240,17939,17939,0,11,3799000.0
3799,3799999,21.224027484633126,38.00622106768767,0.09223863968332813,575.7849161624908,255.0162868499756,591.8830451965332,22184,4240,17944,17944,0,11,3800000.0
3800,3800999,21.22293385325329,38.00454278149231,0.09220067929446685,575.9618124961853,255.08211064338684,591.9458808898926,22190,4241,17949,17949,0,11,3801000.0
3801,3801999,21.22250045255435,38.0040471086943,0.092152176270892,576.1395256519318,255.1478955745697,592.0470962524414,22198,4242,17956,17956,0,11,3802000.0
3802,3802999,21.22307556513084,38.006687719787806,0.09209952649906072,576.2635691165924,255.21301674842834,592.1000862121582,22198,4242,17956,17956,0,11,3803000.0
3803,3803999,21.222793772227593,38.00581022312695,0.09206838181962429,576.611893415451,255.2793366909027,591.9573440551758,22210,4246,17964,17964,0,11,3804000.0
3804,3804999,21.222924043168774,38.005644697003724,0.09198170612524903,576.7861733436584,255.34533214569092,592.0250816345215,22217,4247,17970,17970,0,11,3805000.0
3805,3805999,21.22311518886268,38.006372474246234,0.09190567690929374,577.0786664485931,255.41143584251404,592.0056915283203,22236,4250,17986,17986,0,11,3806000.0
3806,3806999,21.223645876930053,38.00605524550343,0.09186785952696219,577.1963083744049,255.47734427452087,592.1510047912598,22236,4250,17986,17986,0,11,3807000.0
3807,3807999,21.22444277226286,38.0109754540003,0.09181020830399822,577.3218252658844,255.54269194602966,592.262825012207,22236,4250,17986,17986,0,11,3808000.0
3808,3808999,21.225860575178853,38.01246790433879,0.0917738062074549,577.5019838809967,255.6087989807129,592.2806625366211,22240,4251,17989,17989,0,11,3809000.0
3809,3809999,21.227117297871217,38.014232759969104,0.09172914626909578,577.6746635437012,255.67508459091187,592.3702850341797,22246,4252,17994,17994,0,11,3810000.0
3810,3810999,21.230079964423467,38.0224551256043,0.09171282239229961,577.7964704036713,255.74030876159668,592.4659729003906,22246,4252,17994,17994,0,11,3811000.0
3811,3811999,21.233058952624383,38.02693365651236,0.09172621462331776,577.9360175132751,255.80587434768677,592.5448684692383,22246,4252,17994,17994,0,11,3812000.0
3812,3812999,21.235981054971536,38.030177392360095,0.0917471609453715,578.1145651340485,255.8718979358673,592.6052742004395,22252,4253,17999,17999,0,11,3813000.0
3813,3813999,21.23978164736933,38.03586203957088,0.09180479075359627,578.345988035202,255.9380009174347,592.5351829528809,22265,4255,18010,18010,0,11,3814000.0
3814,3814999,21.244486837575998,38.046018406433106,0.09183736823384403,578.6834609508514,256.00535106658936,592.4773635864258,22284,4259,18025,18025,0,11,3815000.0
3815,3815999,21.249769936626418,38.05523118076305,0.09187767421219006,578.9092853069305,256.07196021080017,592.6192359924316,22293,4261,18032,18032,0,11,3816000.0
3816,3816999,21.254410660224426,38.061447652965576,0.09191094731657279,579.0292253494263,256.13793659210205,592.7579765319824,22293,4261,18032,18032,0,11,3817000.0
3817,3817999,21.25927349558633,38.06812456422133,0.09194686723226064,579.3053848743439,256.2041413784027,592.6784133911133,22307,4264,18043,18043,0,11,3818000.0
3818,3818999,21.263265883904047,38.0718122894525,0.09200554755810142,579.537957906723,256.2709608078003,592.7701072692871,22311,4266,18045,18045,0,11,3819000.0
3819,3819999,21.264981644298572,38.072084388369085,0.09200296392104823,579.6611576080322,256.3363893032074,593.0563812255859,22316,4266,18050,18050,0,11,3820000.0
3820,3820999,21.264126409698925,38.07086228685607,0.09196740593075503,579.8401148319244,256.4027919769287,593.2689208984375,22320,4267,18053,18053,0,11,3821000.0
3821,3821999,21.263153382058004,38.06918811102126,0.0919332315354966,580.0547678470612,256.46922516822815,593.3618240356445,22325,4269,18056,18056,0,11,3822000.0
3822,3822999,21.26278677635596,38.06852228075942,0.09188746350069998,580.1700592041016,256.53624296188354,593.5253295898438,22325,4269,18056,18056,0,11,3823000.0
3823,3823999,21.261592446386427,38.06608087770723,0.09186956489400411,580.3005714416504,256.6023461818695,593.6262245178223,22326,4269,18057,18057,0,11,3824000.0
3824,3824999,21.260599369452606,38.06361613472786,0.09184247995123651,580.5285220146179,256.6698679924011,593.7607269287109,22333,4271,18062,18062,0,11,3825000.0
3825,3825999,21.259603630979505,38.06078498337414,0.09181403849682213,580.7096145153046,256.7368264198303,593.9041519165039,22335,4272,18063,18063,0,11,3826000.0
3826,3826999,21.258818583069324,38.05833114982433,0.09179056099267924,580.8280022144318,256.8033936023712,594.0418510437012,22336,4272,18064,18064,0,11,3827000.0
3827,3827999,21.258053605168364,38.05659522166688,0.09176299108078201,580.9549005031586,256.87037897109985,594.1417236328125,22336,4272,18064,18064,0,11,3828000.0
3828,3828999,21.257471583247572,38.05443831664856,0.09171896492574005,581.2464344501495,256.9378545284271,594.1541175842285,22348,4275,18073,18073,0,11,3829000.0
3829,3829999,21.257169078905697,38.053328361589344,0.0916809206975725,581.4684672355652,257.00546526908875,594.2005729675293,22353,4277,18076,18076,0,11,3830000.0
3830,3830999,21.25695355802968,38.05211511626436,0.09163519512220297,581.5895915031433,257.07250022888184,594.5100708007812,22355,4277,18078,18078,0,11,3831000.0
3831,3831999,21.257788126959884,38.05171241363857,0.0915768385532244,581.7609663009644,257.13889479637146,594.6908569335938,22357,4278,18079,18079,0,11,3832000.0
3832,3832999,21.258342419563423,38.05079650510289,0.09153802730239813,581.9394197463989,257.20553183555603,594.7992630004883,22361,4279,18082,18082,0,11,3833000.0
3833,3833999,21.258867787022176,38.04939466747168,0.09149267000086247,582.0707159042358,257.2725555896759,594.9401931762695,22361,4279,18082,18082,0,11,3834000.0
3834,3834999,21.259290537613424,38.04841481753726,0.09145381696052624,582.349532365799,257.3400013446808,594.935676574707,22367,4282,18085,18085,0,11,3835000.0
3835,3835999,21.260151044832604,38.04787127936668,0.09140497655714797,582.4685425758362,257.40679383277893,595.0786323547363,22367,4282,18085,18085,0,11,3836000.0
3836,3836999,21.261300937801213,38.04758313516529,0.09136803443069763,582.758882522583,257.4738292694092,595.0869293212891,22379,4285,18094,18094,0,11,3837000.0
3837,3837999,21.262425718607055,38.047139478935684,0.09133611271463093,582.9840517044067,257.5404243469238,595.1107978820801,22383,4287,18096,18096,0,11,3838000.0
3838,3838999,21.263404049594925,38.04614552859122,0.09130658008753334,583.2093074321747,257.6066629886627,595.1688537597656,22403,4289,18114,18114,0,11,3839000.0
3839,3839999,21.264931883487762,38.045623035240084,0.09126789060565754,583.3437163829803,257.6727545261383,595.2898406982422,22403,4289,18114,18114,0,11,3840000.0
3840,3840999,21.26537804392287,38.04390529829471,0.09123828722363059,583.459456205368,257.7399182319641,595.3828392028809,22403,4289,18114,18114,0,11,3841000.0
3841,3841999,21.264012243093333,38.041683218699504,0.09122535153398093,583.6251406669617,257.8055341243744,595.6009712219238,22421,4290,18131,18131,0,11,3842000.0
3842,3842999,21.262490169302907,38.04034418736978,0.0912119645030075,583.8007099628448,257.8716378211975,595.6598854064941,22428,4291,18137,18137,0,11,3843000.0
3843,3843999,21.260673432986195,38.03785261320212,0.0912087176216505,584.0785703659058,257.9384272098541,595.6299591064453,22438,4294,18144,18144,0,11,3844000.0
3844,3844999,21.258884350143244,38.035066095929196,0.09120695784461619,584.2034687995911,258.0049192905426,595.7423286437988,22438,4294,18144,18144,0,11,3845000.0
3845,3845999,21.256833529646535,38.031613191758154,0.09120706730488526,584.3269431591034,258.0707485675812,595.8264198303223,22438,4294,18144,18144,0,11,3846000.0
3846,3846999,21.25565712514638,38.02906985747536,0.09120258052452368,584.5059087276459,258.1373436450958,596.0103607177734,22442,4295,18147,18147,0,11,3847000.0
3847,3847999,21.25429137755315,38.026227542218905,0.09119989942884343,584.7346739768982,258.20516896247864,596.0472679138184,22450,4297,18153,18153,0,11,3848000.0
3848,3848999,21.252780197771344,38.023074308225965,0.09120061012131775,584.8586421012878,258.2714133262634,596.1905097961426,22451,4297,18154,18154,0,11,3849000.0
3849,3849999,21.25162629378709,38.020332712495,0.09119687991488212,585.0985507965088,258.3385739326477,596.2165412902832,22455,4299,18156,18156,0,11,3850000.0
3850,3850999,21.250783648632154,38.018274031188426,0.09118416510151583,585.3779029846191,258.40540742874146,596.1802444458008,22467,4302,18165,18165,0,11,3851000.0
3851,3851999,21.24991122218047,38.01630499043565,0.09118320571508087,585.496166229248,258.47209906578064,596.2779121398926,22467,4302,18165,18165,0,11,3852000.0
3852,3852999,21.25002607335393,38.016177009303824,0.091163151194536,585.6132037639618,258.5379390716553,596.5476760864258,22471,4302,18169,18169,0,11,3853000.0
3853,3853999,21.250439138824262,38.01575521387247,0.09111842722720742,585.7977285385132,258.6053898334503,596.6491355895996,22473,4303,18170,18170,0,11,3854000.0
3854,3854999,21.25118691421311,38.02092660511389,0.09105710432764191,585.9157385826111,258.67109966278076,596.7493019104004,22473,4303,18170,18170,0,11,3855000.0
3855,3855999,21.251187358795693,38.019431243251226,0.09101092540790767,586.1418809890747,258.7380690574646,596.7318840026855,22481,4305,18176,18176,0,11,3856000.0
3856,3856999,21.251347466866864,38.0182985651491,0.09098760069894729,586.2723572254181,258.80409049987793,596.8170166015625,22481,4305,18176,18176,0,11,3857000.0
3857,3857999,21.251773484144834,38.01826868842569,0.09093314703291333,586.4991130828857,258.87082171440125,596.8296394348145,22485,4307,18178,18178,0,11,3858000.0
3858,3858999,21.253592985577114,38.01986526839191,0.09084126748710641,586.6383953094482,258.93731594085693,597.2923812866211,22487,4307,18180,18180,0,11,3859000.0
3859,3859999,21.254538319001245,38.01920164514107,0.09079166621797485,586.8145275115967,259.0034673213959,597.4297981262207,22518,4308,18210,18210,0,11,3860000.0
3860,3860999,21.25540219880566,38.01852292659102,0.09075409385296818,586.9317440986633,259.0693166255951,597.5264930725098,22518,4308,18210,18210,0,11,3861000.0
3861,3861999,21.255509581215208,38.01672430785162,0.09074016257375928,587.1590824127197,259.1359488964081,597.5698165893555,22526,4310,18216,18216,0,11,3862000.0
3862,3862999,21.254944194438135,38.016015669043206,0.09072538935863705,587.4404015541077,259.20241618156433,597.6835708618164,22550,4313,18237,18237,0,11,3863000.0
3863,3863999,21.253209943944608,38.013180324437,0.09072809645454982,587.6693923473358,259.26878023147583,597.9270515441895,22562,4315,18247,18247,0,11,3864000.0
3864,3864999,21.25161188711636,38.01104604219252,0.0907203715124999,587.9054548740387,259.3364679813385,598.0747833251953,22572,4317,18255,18255,0,11,3865000.0
3865,3865999,21.250325570405376,38.01002672020426,0.09071105112234623,588.0271651744843,259.40350580215454,598.2625160217285,22573,4317,18256,18256,0,11,3866000.0
3866,3866999,21.248953534345535,38.007929461101654,0.09069635179581348,588.2025809288025,259.4703998565674,598.3655090332031,22575,4318,18257,18257,0,11,3867000.0
3867,3867999,21.247431839378308,38.0059488593771,0.0906925205495378,588.4330368041992,259.53887462615967,598.5876312255859,22585,4320,18265,18265,0,11,3868000.0
3868,3868999,21.24570125575501,38.002549568305334,0.09069046115595603,588.6035461425781,259.60575437545776,598.7261047363281,22587,4321,18266,18266,0,11,3869000.0
3869,3869999,21.24502314601727,38.00282533915034,0.09066424084745184,588.8280384540558,259.67317509651184,598.8279190063477,22591,4323,18268,18268,0,11,3870000.0
3870,3870999,21.244780403047038,38.00197428933918,0.09065190893808539,588.9460680484772,259.73973870277405,598.9434432983398,22591,4323,18268,18268,0,11,3871000.0
3871,3871999,21.244873530734008,38.00293956352966,0.09062379295146483,589.1259515285492,259.8070070743561,599.0463066101074,22594,4324,18270,18270,0,11,3872000.0
3872,3872999,21.2452580878059,38.00302301697239,0.09060076069979206,589.2594316005707,259.8741796016693,599.2617034912109,22596,4324,18272,18272,0,11,3873000.0
3873,3873999,21.245659944466535,38.00237702110411,0.09058129335173226,589.543553352356,259.9417214393616,599.2764625549316,22608,4327,18281,18281,0,11,3874000.0
3874,3874999,21.246602694303352,38.00290928362004,0.09055644956267661,589.6623990535736,260.00875759124756,599.423526763916,22608,4327,18281,18281,0,11,3875000.0
3875,3875999,21.247202052508232,38.00241745078522,0.09053582693005346,589.898565530777,260.0759973526001,599.4893913269043,22616,4329,18287,18287,0,11,3876000.0
3876,3876999,21.247485610134206,38.00155230606275,0.09051917361503448,590.1276481151581,260.14348340034485,599.5017204284668,22631,4331,18300,18300,0,11,3877000.0
3877,3877999,21.247969629244306,38.000632444903665,0.09050574105984854,590.3617851734161,260.21125316619873,599.6425132751465,22651,4333,18318,18318,0,11,3878000.0
3878,3878999,21.248475830887173,38.00007816203654,0.09048448318594393,590.4889810085297,260.2793273925781,599.9028053283691,22652,4333,18319,18319,0,11,3879000.0
3879,3879999,21.248933967255017,37.99960703022714,0.09046510139549113,590.6716277599335,260.34586787223816,600.0035362243652,22683,4334,18349,18349,0,11,3880000.0
3880,3880999,21.249172807664053,37.99811879420899,0.09045477494908061,590.8442289829254,260.4124984741211,600.0444984436035,22685,4335,18350,18350,0,11,3881000.0
3881,3881999,21.24832111826053,37.99538939771372,0.09043932774851482,591.0689771175385,260.47875356674194,600.2479553222656,22695,4337,18358,18358,0,11,3882000.0
3882,3882999,21.24692301064148,37.99247006661016,0.0904234696273114,591.2424507141113,260.5452518463135,600.4076881408691,22699,4338,18361,18361,0,11,3883000.0
3883,3883999,21.24589575285123,37.990220443234726,0.09039772396921342,591.4166851043701,260.6140308380127,600.5875701904297,22705,4339,18366,18366,0,11,3884000.0
3884,3884999,21.244810078101555,37.98793722809412,0.0903785615921553,591.5443532466888,260.67997002601624,600.6799774169922,22705,4339,18366,18366,0,11,3885000.0
3885,3885999,21.243900007709446,37.98595374178858,0.09036148470473104,591.6848011016846,260.7468762397766,600.9225158691406,22710,4339,18371,18371,0,11,3886000.0
3886,3886999,21.24343273698167,37.98488359974689,0.09033088055985106,591.9722428321838,260.8147785663605,600.9982070922852,22716,4342,18374,18374,0,11,3887000.0
3887,3887999,21.24274492866885,37.98259825744299,0.09031079116368812,592.1415505409241,260.8814277648926,601.1390724182129,22723,4343,18380,18380,0,11,3888000.0
3888,3888999,21.24206620734383,37.98048730455878,0.09028424976223193,592.3254797458649,260.9492561817169,601.2608108520508,22725,4344,18381,18381,0,11,3889000.0
3889,3889999,21.24190974586417,37.9795387496894,0.09025364217455378,592.4939885139465,261.0163803100586,601.3625106811523,22727,4345,18382,18382,0,11,3890000.0
3890,3890999,21.24170784890032,37.979316425605596,0.0902232777904386,592.6758012771606,261.0840332508087,601.4330978393555,22732,4346,18386,18386,0,11,3891000.0
3891,3891999,21.24192885175903,37.97917948036502,0.09020379510308918,592.9039859771729,261.1512944698334,601.5205993652344,22739,4348,18391,18391,0,11,3892000.0
3892,3892999,21.242550938224678,37.9793298823848,0.09019946880165786,593.02339220047,261.2173647880554,601.6721038818359,22739,4348,18391,18391,0,11,3893000.0
3893,3893999,21.243394729552076,37.982623143102394,0.09017001769187694,593.2055914402008,261.2843472957611,601.7535514831543,22741,4349,18392,18392,0,11,3894000.0
3894,3894999,21.244443330675672,37.98276831901551,0.09016062613384179,593.5837461948395,261.3522038459778,601.7404899597168,22757,4354,18403,18403,0,11,3895000.0
3895,3895999,21.24560478137688,37.98366469047926,0.09016685148573933,593.7145476341248,261.4188678264618,601.8824005126953,22757,4354,18403,18403,0,11,3896000.0
3896,3896999,21.2474322116939,37.98675787979485,0.0901503764771383,593.9420380592346,261.48627614974976,601.9335594177246,22761,4356,18405,18405,0,11,3897000.0
3897,3897999,21.249395469270503,37.98966314940106,0.09013139934394865,594.2214035987854,261.5537302494049,602.1624755859375,22775,4359,18416,18416,0,11,3898000.0
3898,3898999,21.251112658452882,37.992319707783906,0.09013517385314795,594.3427381515503,261.620393037796,602.342472076416,22775,4359,18416,18416,0,11,3899000.0
3899,3899999,21.25308601020965,37.99614259867266,0.09011913572240315,594.5281736850739,261.6873953342438,602.4489707946777,22780,4360,18420,18420,0,11,3900000.0
3900,3900999,21.25468821800066,37.99657745303122,0.09012570362203431,594.8037230968475,261.75421476364136,602.4067077636719,22786,4363,18423,18423,0,11,3901000.0
3901,3901999,21.255020835018737,37.99517017973059,0.0901232010379922,595.0287778377533,261.82104444503784,602.5128440856934,22797,4365,18432,18432,0,11,3902000.0
3902,3902999,21.254596077629742,37.996575971914524,0.09008543094521215,595.146472454071,261.88633370399475,602.8367156982422,22803,4365,18438,18438,0,11,3903000.0
3903,3903999,21.253215191376643,37.99385316016139,0.09006310665495088,595.319940328598,261.95197796821594,602.9074630737305,22809,4366,18443,18443,0,11,3904000.0
3904,3904999,21.2520914267188,37.991437546970246,0.0900350107547695,595.493955373764,262.01804971694946,603.0105171203613,22815,4367,18448,18448,0,11,3905000.0
3905,3905999,21.250897113818493,37.99015186212414,0.09001452208355554,595.6158134937286,262.0836169719696,603.1065101623535,22815,4367,18448,18448,0,11,3906000.0
3906,3906999,21.249639610362056,37.98781843121343,0.0899926422855607,595.7949728965759,262.1497402191162,603.2530059814453,22820,4368,18452,18452,0,11,3907000.0
3907,3907999,21.2486441002046,37.985503170850734,0.08997431348562512,596.0791471004486,262.2167580127716,603.2996940612793,22827,4371,18456,18456,0,11,3908000.0
3908,3908999,21.247935379314644,37.986147511128124,0.08993000897291026,596.2549240589142,262.2831118106842,603.4057884216309,22835,4372,18463,18463,0,11,3909000.0
3909,3909999,21.247059362260035,37.98374107983254,0.08990259461980277,596.586277961731,262.34983134269714,603.4458351135254,22847,4376,18471,18471,0,11,3910000.0
3910,3910999,21.246873841644987,37.98286898943547,0.08986964752198179,596.7024140357971,262.4157862663269,603.609504699707,22847,4376,18471,18471,0,11,3911000.0
3911,3911999,21.246468880286773,37.981493380490996,0.08984332623237534,596.885843038559,262.4819235801697,603.7587509155273,22881,4377,18504,18504,0,11,3912000.0
3912,3912999,21.246271269970396,37.97989466259027,0.08981766640171085,597.0084028244019,262.5478973388672,603.8911285400391,22883,4377,18506,18506,0,11,3913000.0
3913,3913999,21.247697915791008,37.98725707799818,0.0897507249909768,597.1333696842194,262.61372351646423,604.0944709777832,22885,4377,18508,18508,0,11,3914000.0
3914,3914999,21.248460803633424,37.98710175393504,0.0897180012896911,597.3065240383148,262.68040657043457,604.1833648681641,22887,4378,18509,18509,0,11,3915000.0
3915,3915999,21.249520818380844,37.98703701742774,0.08967724952863698,597.4848866462708,262.7467737197876,604.2842788696289,22894,4379,18515,18515,0,11,3916000.0
3916,3916999,21.250747235847935,37.98727634086278,0.08965422331853101,597.6581010818481,262.81350898742676,604.3710861206055,22896,4380,18516,18516,0,11,3917000.0
3917,3917999,21.25207487317416,37.98799817891923,0.08961693772849222,597.8949084281921,262.8799386024475,604.4078559875488,22900,4382,18518,18518,0,11,3918000.0
3918,3918999,21.253662669514775,37.98913929859842,0.08959189201109952,598.0237407684326,262.94571018218994,604.5587272644043,22902,4382,18520,18520,0,11,3919000.0
3919,3919999,21.255173566222794,37.990001800882624,0.08957712993450051,598.1973204612732,263.01145482063293,604.695369720459,22904,4383,18521,18521,0,11,3920000.0
3920,3920999,21.25618994609695,37.990152268799925,0.08955926015958415,598.362300157547,263.07715606689453,604.8096084594727,22909,4384,18525,18525,0,11,3921000.0
3921,3921999,21.258372380968375,37.994232227792274,0.08954337170588444,598.6910321712494,263.14503169059753,604.7840385437012,22917,4388,18529,18529,0,11,3922000.0
3922,3922999,21.259650312065105,37.994563192018134,0.0895293102028365,598.8218147754669,263.2113404273987,604.9076461791992,22917,4388,18529,18529,0,11,3923000.0
3923,3923999,21.259267184315885,37.99317750501096,0.0895212977930464,598.9980745315552,263.27665066719055,605.1516456604004,22923,4389,18534,18534,0,11,3924000.0
3924,3924999,21.25729523380916,37.99009574272374,0.08951771105122108,599.1709570884705,263.3425805568695,605.3045272827148,22929,4390,18539,18539,0,11,3925000.0
3925,3925999,21.25559302385355,37.98784045269005,0.08950570684850512,599.3598091602325,263.40836906433105,605.3994750976562,22932,4391,18541,18541,0,11,3926000.0
3926,3926999,21.254149058524906,37.98623338767457,0.08949762976188702,599.4864573478699,263.476229429245,605.5163383483887,22932,4391,18541,18541,0,11,3927000.0
3927,3927999,21.252723385845464,37.984086516415694,0.08948899934485077,599.7653832435608,263.54244017601013,605.4946899414062,22943,4394,18549,18549,0,11,3928000.0
3928,3928999,21.25173953124245,37.98258442092619,0.08946701851376371,599.8898487091064,263.60861444473267,605.7604217529297,22948,4394,18554,18554,0,11,3929000.0
3929,3929999,21.250882475007284,37.98019406245774,0.08945209276504518,600.028219461441,263.67515110969543,605.9284133911133,22948,4394,18554,18554,0,11,3930000.0
3930,3930999,21.250085597789102,37.97804811860519,0.08943254939196243,600.2619445323944,263.74133467674255,605.9374160766602,22955,4396,18559,18559,0,11,3931000.0
3931,3931999,21.24917169706571,37.97543376183211,0.08941770266072524,600.3801074028015,263.8086931705475,606.1415977478027,22955,4396,18559,18559,0,11,3932000.0
3932,3932999,21.248508577582346,37.97342006288094,0.08939872910917335,600.5032241344452,263.8748342990875,606.2752075195312,22956,4396,18560,18560,0,11,3933000.0
3933,3933999,21.248450707463203,37.97641506915915,0.08936012744555433,600.6795799732208,263.941379070282,606.3504524230957,22959,4397,18562,18562,0,11,3934000.0
3934,3934999,21.24828040349549,37.97498150142278,0.08933408126517595,600.8627297878265,264.008008480072,606.5534896850586,22966,4398,18568,18568,0,11,3935000.0
3935,3935999,21.24873485810944,37.974930099598005,0.08930091570046805,601.0422060489655,264.07441449165344,606.6638450622559,22968,4399,18569,18569,0,11,3936000.0
3936,3936999,21.249572338134268,37.9749195676687,0.08928484637189793,601.1705319881439,264.1398730278015,606.7849960327148,22968,4399,18569,18569,0,11,3937000.0
3937,3937999,21.25086559375102,37.975675393236116,0.08928797505922847,601.3499593734741,264.205650806427,606.8603019714355,22970,4400,18570,18570,0,11,3938000.0
3938,3938999,21.25168935727029,37.97548213829573,0.08928129379880134,601.4773485660553,264.27137565612793,606.9788551330566,22971,4400,18571,18571,0,11,3939000.0
3939,3939999,21.2533097564623,37.97647141240337,0.08928908662036783,601.6576261520386,264.33804273605347,607.0440673828125,22973,4401,18572,18572,0,11,3940000.0
3940,3940999,21.25521676746659,37.97759158012693,0.08929333691654828,601.8798933029175,264.4039809703827,607.2215194702148,22993,4403,18590,18590,0,11,3941000.0
3941,3941999,21.257485881541704,37.97881408373692,0.08928992683557557,602.0525379180908,264.4720559120178,607.3206253051758,22995,4404,18591,18591,0,11,3942000.0
3942,3942999,21.258664849014146,37.97839796561781,0.08928304897431871,602.2854242324829,264.5393760204315,607.2811241149902,23004,4406,18598,18598,0,11,3943000.0
3943,3943999,21.260053943914556,37.97809650137552,0.08927574866245236,602.4564273357391,264.60578656196594,607.3313331604004,23011,4407,18604,18604,0,11,3944000.0
3944,3944999,21.25979287657532,37.97623207356596,0.08927508259720618,602.5688650608063,264.67078590393066,607.4619102478027,23011,4407,18604,18604,0,11,3945000.0
3945,3945999,21.25859535494699,37.97580496057603,0.08925959332930367,602.6847896575928,264.73581171035767,607.5960693359375,23012,4407,18605,18605,0,11,3946000.0
3946,3946999,21.25724294447566,37.97487004574981,0.08928299968340414,602.8032612800598,264.8009991645813,607.7164611816406,23012,4407,18605,18605,0,11,3947000.0
3947,3947999,21.256650077624837,37.977132356054774,0.0892693744915336,602.9399547576904,264.86652731895447,607.7685394287109,23012,4407,18605,18605,0,11,3948000.0
3948,3948999,21.256796937254467,37.97981737247072,0.08929944964234215,603.081592798233,264.932147026062,607.8427848815918,23013,4407,18606,18606,0,11,3949000.0
3949,3949999,21.257458087650928,37.985270155371225,0.08928600849658697,603.2640397548676,264.99794578552246,607.9377288818359,23021,4408,18613,18613,0,11,3950000.0
3950,3950999,21.257586828165582,37.98699652498649,0.08928745099734614,603.4452247619629,265.06414461135864,608.0050392150879,23026,4409,18617,18617,0,11,3951000.0
3951,3951999,21.258009077049042,37.98990408002718,0.08928488173324711,603.6397490501404,265.13031935691833,608.0423698425293,23028,4410,18618,18618,0,11,3952000.0
3952,3952999,21.25888796636504,37.992661250252326,0.08928677264516016,603.7521059513092,265.1957211494446,608.1420860290527,23028,4410,18618,18618,0,11,3953000.0
3953,3953999,21.259871020336323,37.997862708787856,0.08928263203110864,603.9348392486572,265.26164293289185,608.1367301940918,23033,4411,18622,18622,0,11,3954000.0
3954,3954999,21.26089697537082,38.001019318051476,0.08929601512880814,604.12220454216,265.3283565044403,608.1706390380859,23040,4412,18628,18628,0,11,3955000.0
3955,3955999,21.262712871850916,38.00601385315206,0.08928739898060567,604.2514650821686,265.39434909820557,608.3017349243164,23041,4412,18629,18629,0,11,3956000.0
3956,3956999,21.263835475811195,38.009043498092176,0.08930565582234895,604.5972962379456,265.4617831707001,608.2124176025391,23055,4416,18639,18639,0,11,3957000.0
3957,3957999,21.265458919106624,38.011344513337846,0.0893162225821218,604.7295124530792,265.5275332927704,608.3112182617188,23055,4416,18639,18639,0,11,3958000.0
3958,3958999,21.267299508645,38.01456526551031,0.0893306275023561,604.9064772129059,265.5937342643738,608.3660926818848,23057,4417,18640,18640,0,11,3959000.0
3959,3959999,21.269478503742356,38.01752794908532,0.08935569534577781,605.1496248245239,265.661643743515,608.3103256225586,23063,4419,18644,18644,0,11,3960000.0
3960,3960999,21.2722526526006,38.02167608916989,0.08939747991401492,605.3222031593323,265.727947473526,608.3680152893066,23069,4420,18649,18649,0,11,3961000.0
3961,3961999,21.276862562308853,38.03985755256597,0.08939241306715684,605.5103757381439,265.79457998275757,608.5918922424316,23073,4421,18652,18652,0,11,3962000.0
3962,3962999,21.28045752477905,38.04748278294219,0.0894334567304449,605.631667137146,265.86068320274353,608.6924858093262,23073,4421,18652,18652,0,11,3963000.0
3963,3963999,21.28434788901102,38.0557034641325,0.08948739622264124,605.8592491149902,265.92734241485596,608.7210273742676,23077,4423,18654,18654,0,11,3964000.0
3964,3964999,21.287787349568447,38.06036282945334,0.08950537554265292,606.1924822330475,265.9939785003662,608.6934623718262,23091,4427,18664,18664,0,11,3965000.0
3965,3965999,21.28834886734153,38.06381981418751,0.08949980997717955,606.3678033351898,266.06123995780945,608.8548355102539,23099,4428,18671,18671,0,11,3966000.0
3966,3966999,21.286942528496606,38.06416264557048,0.08948119966214674,606.7121021747589,266.1287817955017,608.7866363525391,23112,4432,18680,18680,0,11,3967000.0
3967,3967999,21.286184158521856,38.06465192061157,0.08946396174282778,606.8816201686859,266.1952488422394,608.9057388305664,23114,4433,18681,18681,0,11,3968000.0
3968,3968999,21.285954442472736,38.06630719372183,0.08945036734180412,607.066508769989,266.26197361946106,608.9930572509766,23117,4434,18683,18683,0,11,3969000.0
3969,3969999,21.285853886086677,38.066812582039425,0.08944718450264522,607.2661526203156,266.32904076576233,609.0305328369141,23120,4435,18685,18685,0,11,3970000.0
3970,3970999,21.28644945125376,38.06843804996016,0.08942398387173256,607.3842310905457,266.39562034606934,609.2362861633301,23120,4435,18685,18685,0,11,3971000.0
3971,3971999,21.287081136083174,38.06983438951745,0.08941025363140909,607.6061689853668,266.46224784851074,609.2969055175781,23128,4437,18691,18691,0,11,3972000.0
3972,3972999,21.28875741725964,38.07421017943185,0.08938202800661721,607.8308308124542,266.52869749069214,609.3107414245605,23138,4439,18699,18699,0,11,3973000.0
3973,3973999,21.290845495944776,38.07916270158069,0.08934513497658325,608.1287569999695,266.5961334705353,609.316837310791,23183,4442,18741,18741,0,11,3974000.0
3974,3974999,21.293347199741422,38.083945839696895,0.08933218021435574,608.3100323677063,266.6631815433502,609.3863334655762,23190,4443,18747,18747,0,11,3975000.0
3975,3975999,21.29779208950009,38.09371994732882,0.08932720943068462,608.4877569675446,266.72994589805603,609.5475234985352,23196,4444,18752,18752,0,11,3976000.0
3976,3976999,21.30303997162173,38.11060807216687,0.08934508036066235,608.8266868591309,266.79752683639526,609.6027336120605,23214,4448,18766,18766,0,11,3977000.0
3977,3977999,21.30854977960909,38.11987958025874,0.0894728845366417,609.1618101596832,266.86547207832336,609.5431480407715,23228,4452,18776,18776,0,11,3978000.0
3978,3978999,21.314160047617182,38.129219366082836,0.08966418889420114,609.335823059082,266.9326033592224,609.5849266052246,23230,4453,18777,18777,0,11,3979000.0
3979,3979999,21.31944443576185,38.14004872319597,0.08982223335319539,609.5181250572205,267.000070810318,609.7177925109863,23248,4454,18794,18794,0,11,3980000.0
3980,3980999,21.326499815928997,38.15603544099116,0.09006786205886552,609.8127624988556,267.06789231300354,609.7398414611816,23259,4457,18802,18802,0,11,3981000.0
3981,3981999,21.333001187222166,38.169224338979504,0.09018737370092922,610.0427803993225,267.1351435184479,609.7940368652344,23264,4459,18805,18805,0,11,3982000.0
3982,3982999,21.33980027546054,38.18185142544845,0.09036598858340616,610.2645306587219,267.2017650604248,609.8759956359863,23268,4461,18807,18807,0,11,3983000.0
3983,3983999,21.34570013144718,38.18993187062714,0.09056478648745825,610.4948287010193,267.26894307136536,609.8777389526367,23272,4463,18809,18809,0,11,3984000.0
3984,3984999,21.352320523495003,38.20055844501756,0.0907679216720233,610.781890630722,267.33855080604553,609.8779449462891,23287,4466,18821,18821,0,11,3985000.0
3985,3985999,21.356781856866938,38.20926487513865,0.09091883630643072,610.9756574630737,267.405072927475,610.0266036987305,23289,4467,18822,18822,0,11,3986000.0
3986,3986999,21.35547824351591,38.208361464008526,0.0908991464305372,611.1527900695801,267.47171211242676,610.1395149230957,23291,4468,18823,18823,0,11,3987000.0
3987,3987999,21.3540979131654,38.20675818232878,0.09088300040979125,611.3816275596619,267.53810262680054,610.1141700744629,23299,4470,18829,18829,0,11,3988000.0
3988,3988999,21.353176578834145,38.20567155191848,0.09086461061713424,611.7173008918762,267.60521841049194,610.065601348877,23340,4474,18866,18866,0,11,3989000.0
3989,3989999,21.35233452883631,38.20578324016034,0.0908460860856557,611.9658567905426,267.6719779968262,610.0167121887207,23354,4476,18878,18878,0,11,3990000.0
3990,3990999,21.351226660389603,38.20377677573384,0.09083431351065163,612.0990533828735,267.7385413646698,610.1887321472168,23354,4476,18878,18878,0,11,3991000.0
3991,3991999,21.35018411255847,38.2017210075996,0.09082029645444356,612.2246284484863,267.805499792099,610.2889785766602,23354,4476,18878,18878,0,11,3992000.0
3992,3992999,21.349598928209513,38.200527023321726,0.09080475421536349,612.3455257415771,267.87308740615845,610.3535079956055,23354,4476,18878,18878,0,11,3993000.0
3993,3993999,21.349318174269694,38.199839739627336,0.09077969768054917,612.4738700389862,267.9389717578888,610.4103355407715,23354,4476,18878,18878,0,11,3994000.0
3994,3994999,21.348864355000497,38.19880857343253,0.09075892311857026,612.6086053848267,268.0049879550934,610.4626197814941,23354,4476,18878,18878,0,11,3995000.0
3995,3995999,21.348517695697947,38.198006656209344,0.09073612062464098,612.9718976020813,268.0727035999298,610.3921318054199,23368,4480,18888,18888,0,11,3996000.0
3996,3996999,21.348945808428365,38.19833245618173,0.09071093679091713,613.1595709323883,268.13971972465515,610.4995079040527,23371,4481,18890,18890,0,11,3997000.0
3997,3997999,21.34978255625608,38.198394084076085,0.09069296897293255,613.2813129425049,268.2060263156891,610.5950126647949,23371,4481,18890,18890,0,11,3998000.0
3998,3998999,21.35170473603122,38.201160502209895,0.09065842702330074,613.4608855247498,268.2720685005188,610.5952186584473,23373,4482,18891,18891,0,11,3999000.0
3999,3999999,21.353140208683243,38.20257186496023,0.0906269732932069,613.6347515583038,268.3387715816498,610.6205215454102,23379,4483,18896,18896,0,11,4000000.0
4000,4000999,21.35454144413566,38.204078751642406,0.09062069219175661,613.7561388015747,268.40524077415466,610.7206115722656,23379,4483,18896,18896,0,11,4001000.0
4001,4001999,21.356134852756387,38.20519587901178,0.09061316146083498,614.0458490848541,268.47193813323975,610.6591796875,23390,4486,18904,18904,0,11,4002000.0
4002,4002999,21.35703050388563,38.204996383786835,0.09060933984965369,614.30681848526,268.54345893859863,610.8826217651367,23399,4488,18911,18911,0,11,4003000.0
4003,4003999,21.358331973955167,38.205656826499464,0.09060716236208499,614.5339202880859,268.6101830005646,611.085033416748,23403,4490,18913,18913,0,11,4004000.0
4004,4004999,21.359455217940393,38.205908310183005,0.09059752954439804,614.6702768802643,268.6851451396942,611.2101211547852,23403,4490,18913,18913,0,11,4005000.0
4005,4005999,21.360426556748894,38.2057212511604,0.09061538322249096,614.84961104393,268.75161504745483,611.298282623291,23405,4491,18914,18914,0,11,4006000.0
4006,4006999,21.36039821237106,38.20441320822424,0.09062515137614624,614.9728562831879,268.81735014915466,611.3814010620117,23405,4491,18914,18914,0,11,4007000.0
4007,4007999,21.358505335362125,38.2012465922225,0.09063280729449363,615.1496286392212,268.8848400115967,611.6812171936035,23413,4492,18921,18921,0,11,4008000.0
4008,4008999,21.356650915691706,38.19922436453976,0.09063428680250118,615.3266704082489,268.95194268226624,611.8404769897461,23416,4493,18923,18923,0,11,4009000.0
4009,4009999,21.35510220407751,38.19958787434208,0.09062449561523,615.4608552455902,269.0189685821533,611.9604225158691,23416,4493,18923,18923,0,11,4010000.0
4010,4010999,21.353283452164607,38.19683024235262,0.09062955478343149,615.7547659873962,269.08632135391235,611.9111404418945,23442,4496,18946,18946,0,11,4011000.0
4011,4011999,21.35165758171695,38.194068155713396,0.09062569909261231,615.8888823986053,269.1551401615143,612.077018737793,23442,4496,18946,18946,0,11,4012000.0
4012,4012999,21.350232636915166,38.19134227701181,0.09062258194185857,616.0749151706696,269.22232031822205,612.2154960632324,23444,4497,18947,18947,0,11,4013000.0
4013,4013999,21.348678721073018,38.18875088483981,0.09061756607512528,616.2044923305511,269.28899097442627,612.3089714050293,23444,4497,18947,18947,0,11,4014000.0
4014,4014999,21.34746058086748,38.18705458710838,0.09060761972872389,616.3895092010498,269.3560483455658,612.3649444580078,23446,4498,18948,18948,0,11,4015000.0
4015,4015999,21.345987608295783,38.18440468892197,0.09060329048926086,616.5287735462189,269.4233055114746,612.4494285583496,23446,4498,18948,18948,0,11,4016000.0
4016,4016999,21.344832796354673,38.18380348459412,0.0905861385246185,616.7118334770203,269.4905445575714,612.4678001403809,23451,4499,18952,18952,0,11,4017000.0
4017,4017999,21.343903325634894,38.181663232652625,0.0905738070977401,616.896110534668,269.5578873157501,612.6755485534668,23454,4500,18954,18954,0,11,4018000.0
4018,4018999,21.34303408868206,38.17957529274039,0.09055956836903234,617.0194141864777,269.62435507774353,612.767147064209,23454,4500,18954,18954,0,11,4019000.0
4019,4019999,21.34307403340638,38.185190615697756,0.09050698870294205,617.2521557807922,269.69292545318604,612.7789649963379,23458,4502,18956,18956,0,11,4020000.0
4020,4020999,21.342781632639035,38.184826786201015,0.09048836266022464,617.4857201576233,269.7610139846802,612.8153228759766,23478,4504,18974,18974,0,11,4021000.0
4021,4021999,21.343277316674616,38.18679488400646,0.09045620300303603,617.6630139350891,269.8280894756317,612.8575782775879,23485,4505,18980,18980,0,11,4022000.0
4022,4022999,21.343358974327,38.185476589307804,0.09045874181493507,617.9493219852448,269.8958239555359,613.0481338500977,23509,4508,19001,19001,0,11,4023000.0
4023,4023999,21.343897129597003,38.18658618040799,0.09043878221981749,618.0772714614868,269.9628632068634,613.2064819335938,23509,4508,19001,19001,0,11,4024000.0
4024,4024999,21.344534543431738,38.18581908693725,0.09042251641622967,618.2663414478302,270.0297439098358,613.277702331543,23527,4509,19018,19018,0,11,4025000.0
4025,4025999,21.343941102285353,38.184070280501594,0.09040658042254957,618.4411025047302,270.09624457359314,613.3300476074219,23530,4510,19020,19020,0,11,4026000.0
4026,4026999,21.342117507195546,38.181536613529445,0.09041183732741465,618.5697975158691,270.16329431533813,613.6694679260254,23534,4510,19024,19024,0,11,4027000.0
4027,4027999,21.340588581951828,38.18060839898334,0.09040393476700759,618.8097486495972,270.2309992313385,613.743968963623,23538,4512,19026,19026,0,11,4028000.0
4028,4028999,21.33870609964251,38.177512802881296,0.09041373421405274,619.1043112277985,270.29988265037537,613.7928237915039,23549,4515,19034,19034,0,11,4029000.0
4029,4029999,21.33688152607219,38.17491904842259,0.09041519546882182,619.2927484512329,270.367555141449,613.8847389221191,23551,4516,19035,19035,0,11,4030000.0
4030,4030999,21.335595737780146,38.17361120700772,0.09039873790091135,619.5774636268616,270.43558955192566,614.1197166442871,23561,4519,19042,19042,0,11,4031000.0
4031,4031999,21.33382141051504,38.17032571162081,0.09040093324916565,619.7012157440186,270.50233817100525,614.2922401428223,23561,4519,19042,19042,0,11,4032000.0
4032,4032999,21.332341819400792,38.16862369131965,0.09039421403753745,620.0463795661926,270.57006669044495,614.2608184814453,23569,4523,19046,19046,0,11,4033000.0
4033,4033999,21.331295141620824,38.172275709678566,0.0903595034473137,620.2242338657379,270.63774943351746,614.4183235168457,23576,4524,19052,19052,0,11,4034000.0
4034,4034999,21.330036250104158,38.17060568243483,0.09035202890199645,620.4129958152771,270.70551228523254,614.4976959228516,23583,4525,19058,19058,0,11,4035000.0
4035,4035999,21.32905357184817,38.169195300651026,0.09033908668590296,620.6423499584198,270.77473521232605,614.6183242797852,23588,4527,19061,19061,0,11,4036000.0
4036,4036999,21.328733404318125,38.17036990024106,0.09030197258836548,620.8221051692963,270.84203028678894,614.8242835998535,23597,4528,19069,19069,0,11,4037000.0
4037,4037999,21.328370433816445,38.16886599956997,0.0902858567765199,620.9482581615448,270.9091536998749,614.9686164855957,23597,4528,19069,19069,0,11,4038000.0
4038,4038999,21.327977894321474,38.168216490152304,0.09026999154660842,621.2306866645813,270.97655391693115,614.9811859130859,23603,4531,19072,19072,0,11,4039000.0
4039,4039999,21.328029050975616,38.169610728665475,0.0902410009451533,621.4725210666656,271.04582476615906,615.0560340881348,23608,4533,19075,19075,0,11,4040000.0
4040,4040999,21.327736705240333,38.16822662640524,0.09022868105789594,621.7111291885376,271.113267660141,615.1309623718262,23616,4535,19081,19081,0,11,4041000.0
4041,4041999,21.32857361154055,38.16822622198527,0.09020735956698533,621.8939218521118,271.1802065372467,615.3023643493652,23622,4536,19086,19086,0,11,4042000.0
4042,4042999,21.328892600663984,38.16723521937114,0.09019308547645011,622.011670589447,271.2464373111725,615.5063934326172,23622,4536,19086,19086,0,11,4043000.0
4043,4043999,21.329667132561035,38.16700568172142,0.09017678594165457,622.2512414455414,271.31322717666626,615.5432968139648,23627,4538,19089,19089,0,11,4044000.0
4044,4044999,21.33069695540543,38.1668080582694,0.09015708694012836,622.4325380325317,271.3800344467163,615.5972671508789,23629,4539,19090,19090,0,11,4045000.0
4045,4045999,21.331028481084402,38.16545994647055,0.09015263115407601,622.6174495220184,271.4481439590454,615.6665267944336,23637,4540,19097,19097,0,11,4046000.0
4046,4046999,21.330206717235356,38.16418837134173,0.0901435776514482,622.753559589386,271.5137929916382,615.9357490539551,23641,4540,19101,19101,0,11,4047000.0
4047,4047999,21.328099650649182,38.16309331342504,0.09014178631720571,622.9825158119202,271.57990646362305,615.9954223632812,23654,4542,19112,19112,0,11,4048000.0
4048,4048999,21.32615417091723,38.16023154665023,0.09014584824159022,623.1129636764526,271.64658188819885,616.1515007019043,23654,4542,19112,19112,0,11,4049000.0
4049,4049999,21.324507705684606,38.158017816201955,0.09014401272428985,623.3014190196991,271.7126741409302,616.207088470459,23658,4543,19115,19115,0,11,4050000.0
4050,4050999,21.322893471037915,38.15519186648901,0.09014080372098299,623.4958338737488,271.7794270515442,616.2625694274902,23660,4544,19116,19116,0,11,4051000.0
4051,4051999,21.321584720835943,38.15269725683596,0.09013599489316126,623.7350409030914,271.8455286026001,616.4389991760254,23667,4546,19121,19121,0,11,4052000.0
4052,4052999,21.320707982215218,38.15111966448167,0.0901331122927933,623.8606576919556,271.9111137390137,616.5582122802734,23667,4546,19121,19121,0,11,4053000.0
4053,4053999,21.32012627240656,38.149861903294436,0.09012036221532149,624.0378448963165,271.976336479187,616.481029510498,23669,4547,19122,19122,0,11,4054000.0
4054,4054999,21.319632949367477,38.148598915216375,0.09012158250712732,624.3386151790619,272.0426342487335,616.4289474487305,23690,4550,19140,19140,0,11,4055000.0
4055,4055999,21.31957977922461,38.14846075064623,0.09011210781915235,624.5217261314392,272.11019706726074,616.563850402832,23705,4551,19154,19154,0,11,4056000.0
4056,4056999,21.319824344404736,38.149360942456816,0.09011189196899394,624.8138616085052,272.17697072029114,616.4262390136719,23716,4554,19162,19162,0,11,4057000.0
4057,4057999,21.32051201807715,38.15057541274164,0.09010962852932314,624.9370350837708,272.245130777359,616.6675033569336,23717,4554,19163,19163,0,11,4058000.0
4058,4058999,21.32135679885382,38.15234873385803,0.09012257734700835,625.2376697063446,272.3124945163727,616.7038955688477,23729,4557,19172,19172,0,11,4059000.0
4059,4059999,21.322498150231585,38.15388826721023,0.09012611524264524,625.417103767395,272.3790092468262,616.835376739502,23731,4558,19173,19173,0,11,4060000.0
4060,4060999,21.323683538463452,38.15497866392148,0.09011862281897598,625.537727355957,272.44462060928345,616.9328536987305,23731,4558,19173,19173,0,11,4061000.0
4061,4061999,21.325325993612356,38.157266693141494,0.09012645675065212,625.8392028808594,272.5119550228119,616.9170303344727,23740,4561,19179,19179,0,11,4062000.0
4062,4062999,21.32702710392885,38.158816320125474,0.09017525226667866,626.0349812507629,272.578973531723,617.0032539367676,23742,4562,19180,19180,0,11,4063000.0
4063,4063999,21.329031156843122,38.16098080601119,0.09015524363305849,626.1624166965485,272.64667439460754,617.1650733947754,23742,4562,19180,19180,0,11,4064000.0
4064,4064999,21.33054293330311,38.16241984162054,0.09013896011943445,626.3926763534546,272.712858915329,617.1746063232422,23746,4564,19182,19182,0,11,4065000.0
4065,4065999,21.332470972331265,38.163897332855676,0.09013181511711121,626.6284959316254,272.7792532444,617.1803703308105,23755,4566,19189,19189,0,11,4066000.0
4066,4066999,21.33368425687688,38.16356309135869,0.09014433584058013,626.8575901985168,272.84659719467163,617.2063751220703,23763,4568,19195,19195,0,11,4067000.0
4067,4067999,21.33496537601683,38.166194236481076,0.09013007248955851,626.9990518093109,272.9126658439636,617.486499786377,23765,4568,19197,19197,0,11,4068000.0
4068,4068999,21.332867070579702,38.162904083823626,0.09013924185050193,627.1924107074738,272.97900390625,617.5893020629883,23767,4569,19198,19198,0,11,4069000.0
4069,4069999,21.3309164443205,38.160502461272706,0.09014586044408668,627.3680164813995,273.04666352272034,617.6208076477051,23784,4570,19214,19214,0,11,4070000.0
4070,4070999,21.329368247393237,38.160605550314656,0.09013441870933758,627.4911060333252,273.1130220890045,617.7117233276367,23784,4570,19214,19214,0,11,4071000.0
4071,4071999,21.32745314244413,38.1574947250402,0.09014474183439014,627.6156053543091,273.17881298065186,617.7685661315918,23784,4570,19214,19214,0,11,4072000.0
4072,4072999,21.32584915902402,38.155084951556454,0.09014376231475218,627.856276512146,273.2455904483795,617.8747978210449,23794,4572,19222,19222,0,11,4073000.0
4073,4073999,21.324405114491462,38.153282096651935,0.09014456184107189,628.0427136421204,273.3120229244232,617.9746627807617,23801,4573,19228,19228,0,11,4074000.0
4074,4074999,21.322815308893944,38.15038078461078,0.09013969445402747,628.1642343997955,273.37855410575867,618.0854988098145,23801,4573,19228,19228,0,11,4075000.0
4075,4075999,21.32141664295721,38.14827964327416,0.0901346566317276,628.3470606803894,273.44562888145447,618.1412506103516,23803,4574,19229,19229,0,11,4076000.0
4076,4076999,21.31977878518842,38.14516071222711,0.09013831260202565,628.5960986614227,273.5128507614136,618.1431732177734,23809,4576,19233,19233,0,11,4077000.0
4077,4077999,21.31859602534935,38.14304985001834,0.0901277222105451,628.7761068344116,273.57959628105164,618.2545928955078,23812,4577,19235,19235,0,11,4078000.0
4078,4078999,21.317633135213683,38.14098847556093,0.09010125040931494,628.9595284461975,273.6460871696472,618.4081230163574,23815,4578,19237,19237,0,11,4079000.0
4079,4079999,21.31716184262508,38.13923682286236,0.09006886126988722,629.1399006843567,273.7124960422516,618.4883155822754,23817,4579,19238,19238,0,11,4080000.0
4080,4080999,21.31684514912514,38.137909038495984,0.09004150564342761,629.3174703121185,273.7789270877838,618.559928894043,23825,4580,19245,19245,0,11,4081000.0
4081,4081999,21.31637830157526,38.135947650649626,0.09000882536447385,629.4453020095825,273.8449139595032,618.6564407348633,23825,4580,19245,19245,0,11,4082000.0
4082,4082999,21.31613316016247,38.13809112347406,0.08996162040315658,629.6826150417328,273.9113595485687,618.6892204284668,23837,4582,19255,19255,0,11,4083000.0
4083,4083999,21.31616205891122,38.13737435427418,0.08992727835273262,629.980541229248,273.97793555259705,618.6545295715332,23850,4585,19265,19265,0,11,4084000.0
4084,4084999,21.31631127454458,38.13632518690041,0.08989117710545014,630.1008975505829,274.04391264915466,618.8026695251465,23850,4585,19265,19265,0,11,4085000.0
4085,4085999,21.316202609104227,38.13462279070407,0.08986407795178808,630.2171173095703,274.10947918891907,618.9276466369629,23851,4585,19266,19266,0,11,4086000.0
4086,4086999,21.31614788917393,38.13285294244781,0.08983761585552219,630.4092221260071,274.17542576789856,618.9415893554688,23853,4586,19267,19267,0,11,4087000.0
4087,4087999,21.316183295422963,38.1310261988695,0.08981094045841487,630.5833449363708,274.24128007888794,619.0014724731445,23860,4587,19273,19273,0,11,4088000.0
4088,4088999,21.31550368251849,38.128746140206154,0.08979828223528796,630.7050874233246,274.30640268325806,619.0969734191895,23860,4587,19273,19273,0,11,4089000.0
4089,4089999,21.314989204643762,38.12721124223335,0.0897151880256809,630.8384273052216,274.3732612133026,619.3928375244141,23865,4587,19278,19278,0,11,4090000.0
4090,4090999,21.313773574315476,38.12458055910959,0.08967909305119282,631.0193696022034,274.4392201900482,619.4770202636719,23870,4588,19282,19282,0,11,4091000.0
4091,4091999,21.31260475904999,38.122337210850276,0.08963678225741534,631.1983044147491,274.50588393211365,619.592643737793,23873,4589,19284,19284,0,11,4092000.0
4092,4092999,21.31154013628589,38.11993687639854,0.08961180797170298,631.3282279968262,274.5714318752289,619.6715240478516,23873,4589,19284,19284,0,11,4093000.0
4093,4093999,21.310837154162417,38.11802144508699,0.08958230620515362,631.5009973049164,274.63769149780273,619.7809677124023,23878,4590,19288,19288,0,11,4094000.0
4094,4094999,21.310749105122206,38.11712917284572,0.08950346628198547,631.8085119724274,274.70442032814026,619.8985481262207,23900,4593,19307,19307,0,11,4095000.0
4095,4095999,21.310447062063755,38.11561397741663,0.08942798254862583,631.9273970127106,274.7706136703491,620.0549087524414,23901,4593,19308,19308,0,11,4096000.0
4096,4096999,21.310395212994457,38.11436235905497,0.08935941326132157,632.0552642345428,274.83634853363037,620.1561737060547,23901,4593,19308,19308,0,11,4097000.0
4097,4097999,21.310206071512862,38.113629911673485,0.0893010452907268,632.2855579853058,274.9026565551758,620.1734657287598,23910,4595,19315,19315,0,11,4098000.0
4098,4098999,21.310185648950117,38.112850727133676,0.08924936113454662,632.5368847846985,274.96951699256897,620.2722053527832,23917,4597,19320,19320,0,11,4099000.0
4099,4099999,21.310264192627947,38.11247333634241,0.08917380865355717,632.7199251651764,275.03639483451843,620.373706817627,23920,4598,19322,19322,0,11,4100000.0
4100,4100999,21.31087486003028,38.112028803915464,0.08910965497764556,632.9101810455322,275.10294556617737,620.5223655700684,23927,4599,19328,19328,0,11,4101000.0
4101,4101999,21.312163831768956,38.11598992425769,0.08908077717830987,633.0866539478302,275.1687698364258,620.6102828979492,23929,4600,19329,19329,0,11,4102000.0
4102,4102999,21.312729411457674,38.11512081209532,0.08904157724176676,633.2721140384674,275.2361855506897,620.6890678405762,23932,4601,19331,19331,0,11,4103000.0
4103,4103999,21.313606845999526,38.11500227586735,0.0890025563830058,633.4598288536072,275.3111398220062,620.7938957214355,23934,4602,19332,19332,0,11,4104000.0
4104,4104999,21.314468448871537,38.115094210589035,0.08896254453406494,633.7010324001312,275.37789726257324,620.8108825683594,23938,4604,19334,19334,0,11,4105000.0
4105,4105999,21.315233478826016,38.11491098215378,0.08892317903928892,633.8308808803558,275.4443790912628,620.9849510192871,23941,4604,19337,19337,0,11,4106000.0
4106,4106999,21.316427672593875,38.114822061058476,0.08889043106940697,634.0722141265869,275.5112335681915,621.0192909240723,23947,4606,19341,19341,0,11,4107000.0
4107,4107999,21.317391401581865,38.114539050743986,0.08886458217362847,634.2661530971527,275.5839545726776,621.1615982055664,23949,4607,19342,19342,0,11,4108000.0
4108,4108999,21.3185125056766,38.11409961019611,0.08885577908542841,634.5536534786224,275.65045261383057,621.1941261291504,23959,4610,19349,19349,0,11,4109000.0
4109,4109999,21.319019911369313,38.1126216711843,0.08884860372389825,634.6780409812927,275.71712017059326,621.3340721130371,23959,4610,19349,19349,0,11,4110000.0
4110,4110999,21.31845491845304,38.1109757184077,0.08884656230550103,634.7917125225067,275.78249883651733,621.6116943359375,23963,4610,19353,19353,0,11,4111000.0
4111,4111999,21.31695214275136,38.1084794046721,0.08884892552297452,634.964465379715,275.8491430282593,621.8193244934082,23967,4611,19356,19356,0,11,4112000.0
4112,4112999,21.316133799160973,38.106817026709344,0.08886352416219956,635.1019246578217,275.9164216518402,621.9582824707031,23967,4611,19356,19356,0,11,4113000.0
4113,4113999,21.31595820521756,38.106769318887864,0.08888084503693117,635.2286906242371,275.98284339904785,622.081672668457,23968,4611,19357,19357,0,11,4114000.0
4114,4114999,21.315847667683006,38.1069527742797,0.08888062205346714,635.4059405326843,276.0498683452606,622.1576499938965,23976,4612,19364,19364,0,11,4115000.0
4115,4115999,21.315947779072882,38.10615460664419,0.0888910826046968,635.7555329799652,276.11747217178345,622.3219871520996,23993,4616,19377,19377,0,11,4116000.0
4116,4116999,21.316073351849376,38.105343759054385,0.08891694014045248,635.9930310249329,276.1852207183838,622.4587478637695,24002,4618,19384,19384,0,11,4117000.0
4117,4117999,21.315910850158122,38.10527834968549,0.08893602639946241,636.2323021888733,276.2537293434143,622.4966506958008,24011,4620,19391,19391,0,11,4118000.0
4118,4118999,21.316030812838846,38.108598635880924,0.08892269341921533,636.4003684520721,276.3206903934479,622.6411285400391,24013,4621,19392,19392,0,11,4119000.0
4119,4119999,21.31654912963323,38.108870629908736,0.08892575023499905,636.5844538211823,276.38785219192505,622.7233619689941,24020,4622,19398,19398,0,11,4120000.0
4120,4120999,21.31698359603804,38.10904119720477,0.08893784124926041,636.711831331253,276.454585313797,622.872688293457,24021,4622,19399,19399,0,11,4121000.0
4121,4121999,21.31824290323249,38.11054711733825,0.0889152954671194,636.8346004486084,276.5217366218567,623.2515678405762,24025,4622,19403,19403,0,11,4122000.0
4122,4122999,21.320157581121244,38.112269312865735,0.08890446478638037,637.0821332931519,276.58922266960144,623.3141860961914,24029,4624,19405,19405,0,11,4123000.0
4123,4123999,21.321938258284913,38.11419602731581,0.08890543855317645,637.2534012794495,276.6556522846222,623.4158172607422,24047,4625,19422,19422,0,11,4124000.0
4124,4124999,21.32408158632155,38.11844896103893,0.08890694501093499,637.3795313835144,276.72205686569214,623.5201568603516,24047,4625,19422,19422,0,11,4125000.0
4125,4125999,21.325893772974197,38.120249105399445,0.08891855302668572,637.7307555675507,276.7895550727844,623.465015411377,24055,4629,19426,19426,0,11,4126000.0
4126,4126999,21.328445210862142,38.123386527537164,0.08894576286874423,637.9062447547913,276.8564450740814,623.5740547180176,24061,4630,19431,19431,0,11,4127000.0
4127,4127999,21.330789903277577,38.125541773425,0.08895986686389734,638.1411209106445,276.92286944389343,623.6882553100586,24067,4632,19435,19435,0,11,4128000.0
4128,4128999,21.33413303851435,38.13374912075627,0.08899303005964965,638.322968006134,276.9893789291382,623.8032760620117,24069,4633,19436,19436,0,11,4129000.0
4129,4129999,21.336766667791274,38.136159242798335,0.08901319075301029,638.512419462204,277.0557658672333,623.8663673400879,24071,4634,19437,19437,0,11,4130000.0
4130,4130999,21.338716977367426,38.13697840675673,0.08904741355094559,638.6312596797943,277.1216847896576,623.9702415466309,24071,4634,19437,19437,0,11,4131000.0
4131,4131999,21.339075258221154,38.13860755429205,0.08903926718786626,638.873361825943,277.18776392936707,624.1349716186523,24087,4636,19451,19451,0,11,4132000.0
4132,4132999,21.33835379676217,38.13864973291199,0.08901555273603357,639.0525012016296,277.2555274963379,624.2705116271973,24094,4637,19457,19457,0,11,4133000.0
4133,4133999,21.337282873331592,38.13741790965157,0.08900173317711246,639.2327883243561,277.32227206230164,624.3781661987305,24096,4638,19458,19458,0,11,4134000.0
4134,4134999,21.336217874226588,38.13647284349364,0.08898649043341067,639.4076175689697,277.3886706829071,624.4962997436523,24100,4639,19461,19461,0,11,4135000.0
4135,4135999,21.335362476834188,38.13628528153715,0.08897010056112842,639.5399806499481,277.4547870159149,624.5908584594727,24101,4639,19462,19462,0,11,4136000.0
4136,4136999,21.33451279945992,38.134378560184125,0.08895740376513916,639.7827968597412,277.52197670936584,624.7524070739746,24108,4641,19467,19467,0,11,4137000.0
4137,4137999,21.33349506721076,38.13209198349911,0.08894975368505142,639.8979778289795,277.5891170501709,624.9528160095215,24108,4641,19467,19467,0,11,4138000.0
4138,4138999,21.332530116580234,38.130062797363095,0.0889345894882525,640.1339755058289,277.65582370758057,624.9928779602051,24112,4643,19469,19469,0,11,4139000.0
4139,4139999,21.331658309879263,38.12863045789834,0.08891986445202182,640.2567021846771,277.72212839126587,625.1337623596191,24112,4643,19469,19469,0,11,4140000.0
4140,4140999,21.33085568137223,38.12656278445884,0.08891009915169035,640.4419622421265,277.7883758544922,625.1812286376953,24116,4644,19472,19472,0,11,4141000.0
4141,4141999,21.3302864506725,38.12594654073918,0.08890712035363257,640.6162531375885,277.8547465801239,625.2786979675293,24119,4645,19474,19474,0,11,4142000.0
4142,4142999,21.33031295994929,38.125377373982786,0.08891142417282094,640.748458147049,277.92122054100037,625.4195823669434,24119,4645,19474,19474,0,11,4143000.0
4143,4143999,21.33126627935562,38.131258012510614,0.08888771579187826,640.877491235733,277.986613035202,625.5002288818359,24119,4645,19474,19474,0,11,4144000.0
4144,4144999,21.332740103042354,38.133801042036616,0.08887985674643051,641.1087980270386,278.0528485774994,625.502555847168,24123,4647,19476,19476,0,11,4145000.0
4145,4145999,21.334806467060773,38.141460920430745,0.08890125488799816,641.2812166213989,278.11983346939087,625.5492515563965,24130,4648,19482,19482,0,11,4146000.0
4146,4146999,21.337718069939303,38.15075373765462,0.0889533410447132,641.4646310806274,278.18621468544006,625.5713081359863,24132,4649,19483,19483,0,11,4147000.0
4147,4147999,21.343524567735635,38.16621530931943,0.08902026651493233,641.7551534175873,278.2528290748596,625.5789756774902,24140,4652,19488,19488,0,11,4148000.0
4148,4148999,21.34924791411104,38.18148727774316,0.08908377615370855,641.8882641792297,278.31940841674805,625.9759902954102,24141,4652,19489,19489,0,11,4149000.0
4149,4149999,21.35439898020333,38.19143682450075,0.08914879646339169,642.0587620735168,278.38556933403015,626.1232223510742,24144,4653,19491,19491,0,11,4150000.0
4150,4150999,21.36044532065735,38.20472706542679,0.08923700225926456,642.342878818512,278.45213532447815,626.1397171020508,24171,4656,19515,19515,0,11,4151000.0
4151,4151999,21.366292102650807,38.21529871535374,0.08933311792464271,642.5792663097382,278.5185925960541,626.1873207092285,24175,4658,19517,19517,0,11,4152000.0
4152,4152999,21.368591682522695,38.21853770031862,0.08936479266997188,642.921703338623,278.5851888656616,626.3871994018555,24190,4662,19528,19528,0,11,4153000.0
4153,4153999,21.366864742015153,38.21647181260062,0.08936376937263302,643.0471017360687,278.65187191963196,626.613094329834,24190,4662,19528,19528,0,11,4154000.0
4154,4154999,21.365414651051758,38.21487782186071,0.08935649255042866,643.1780230998993,278.720041513443,626.7315063476562,24191,4662,19529,19529,0,11,4155000.0
4155,4155999,21.364447407545846,38.21568248771614,0.08933654298401428,643.4115948677063,278.7872395515442,626.7456130981445,24197,4664,19533,19533,0,11,4156000.0
4156,4156999,21.36375103098832,38.2146943327893,0.08931558138163742,643.6607053279877,278.8548858165741,626.851749420166,24236,4666,19570,19570,0,11,4157000.0
4157,4157999,21.362419662041184,38.21211981035817,0.08930970416483675,643.8973333835602,278.922513961792,626.9022064208984,24245,4668,19577,19577,0,11,4158000.0
4158,4158999,21.36121114676446,38.21028820256574,0.08929616602910262,644.0317192077637,278.99599170684814,627.0323829650879,24246,4668,19578,19578,0,11,4159000.0
4159,4159999,21.360364480484147,38.20854060575468,0.08928061417568,644.2112619876862,279.0627212524414,627.074104309082,24248,4669,19579,19579,0,11,4160000.0
4160,4160999,21.359585390824652,38.20755034151271,0.08926340662888332,644.4081444740295,279.13062381744385,627.1151313781738,24250,4670,19580,19580,0,11,4161000.0
4161,4161999,21.359049349640774,38.20656391059352,0.08924302534995154,644.5960204601288,279.19805908203125,627.2127418518066,24259,4671,19588,19588,0,11,4162000.0
4162,4162999,21.35916233550936,38.206459561161545,0.08921072542914954,644.7323796749115,279.2666115760803,627.4859886169434,24261,4671,19590,19590,0,11,4163000.0
4163,4163999,21.359426361081127,38.20620765170599,0.08919244391181347,644.9652762413025,279.3341076374054,627.5652275085449,24281,4673,19608,19608,0,11,4164000.0
4164,4164999,21.36039097710409,38.2076767473692,0.0891609259497319,645.1427612304688,279.40109062194824,627.580982208252,24283,4674,19609,19609,0,11,4165000.0
4165,4165999,21.360920506079786,38.20793628940627,0.0891463394537596,645.3255562782288,279.46857738494873,627.6036529541016,24285,4675,19610,19610,0,11,4166000.0
4166,4166999,21.362786886500405,38.21422614775847,0.08910371783432236,645.5159111022949,279.5362219810486,627.6514434814453,24291,4676,19615,19615,0,11,4167000.0
4167,4167999,21.363491574394132,38.21435644839591,0.08908352892666205,645.8108446598053,279.6038053035736,627.7030639648438,24313,4679,19634,19634,0,11,4168000.0
4168,4168999,21.364226338527068,38.21438103943313,0.08906279342675272,646.0449321269989,279.6725878715515,627.7566261291504,24319,4681,19638,19638,0,11,4169000.0
4169,4169999,21.36504322079787,38.21454136388169,0.0890459267632383,646.2831189632416,279.74051117897034,627.8207397460938,24323,4683,19640,19640,0,11,4170000.0
4170,4170999,21.365214377213285,38.2138969588415,0.08903726388499211,646.5150043964386,279.8073582649231,627.8356742858887,24328,4685,19643,19643,0,11,4171000.0
4171,4171999,21.363530958292152,38.21106168593658,0.08903887117611331,646.6865789890289,279.87353014945984,628.0143890380859,24336,4686,19650,19650,0,11,4172000.0
4172,4172999,21.36146138749948,38.208053943900254,0.08904397979953116,646.8650181293488,279.94030714035034,628.0995903015137,24343,4687,19656,19656,0,11,4173000.0
4173,4173999,21.35972155551591,38.20648043834853,0.08904962010000361,647.0454547405243,280.0070707798004,628.154426574707,24345,4688,19657,19657,0,11,4174000.0
4174,4174999,21.358177597797717,38.204494841095695,0.08904972487964335,647.170435667038,280.07342433929443,628.2379837036133,24346,4688,19658,19658,0,11,4175000.0
4175,4175999,21.357146605067413,38.202766693780035,0.08903688057066361,647.4255447387695,280.1410837173462,628.3057746887207,24353,4690,19663,19663,0,11,4176000.0
4176,4176999,21.356052203330457,38.20101521935444,0.08902887919582736,647.5440604686737,282.3894884586334,628.4330863952637,24353,4690,19663,19663,0,11,4177000.0
4177,4177999,21.354884387261478,38.19934057492016,0.0890475359657078,647.906192779541,282.4573748111725,628.3781967163086,24368,4694,19674,19674,0,11,4178000.0
4178,4178999,21.35522945738949,38.202721173990184,0.08903795157453787,648.0297839641571,282.5244688987732,628.5094108581543,24368,4694,19674,19674,0,11,4179000.0
4179,4179999,21.358134020693917,38.21432984039711,0.08903747572543552,648.2229309082031,282.5925176143646,628.5715103149414,24371,4695,19676,19676,0,11,4180000.0
4180,4180999,21.361619812960615,38.22670329453524,0.08901012949746134,648.5404829978943,282.6619384288788,628.5892181396484,24380,4698,19682,19682,0,11,4181000.0
4181,4181999,21.36802598427989,38.25060340662915,0.08898394831078038,648.7883112430573,282.72966980934143,628.6843605041504,24404,4700,19704,19704,0,11,4182000.0
4182,4182999,21.374969923312666,38.271449350751226,0.0890111413624709,648.9089117050171,282.7965476512909,628.8057670593262,24404,4700,19704,19704,0,11,4183000.0
4183,4183999,21.38296984364265,38.29605578453054,0.08901910830672999,649.2190725803375,282.8639466762543,628.7737884521484,24418,4703,19715,19715,0,11,4184000.0
4184,4184999,21.389688188100873,38.31430019926354,0.08913861852569382,649.5263879299164,282.93169498443604,628.7524757385254,24428,4706,19722,19722,0,11,4185000.0
4185,4185999,21.39789940800571,38.333938789899065,0.08926473494513953,649.8347537517548,282.99953961372375,628.7405776977539,24439,4709,19730,19730,0,11,4186000.0
4186,4186999,21.407134157260593,38.36272139764672,0.08931813474664019,649.9557595252991,283.0690312385559,628.9594497680664,24439,4709,19730,19730,0,11,4187000.0
4187,4187999,21.41432794801126,38.378051575716675,0.0893997073562307,650.1943628787994,283.13673090934753,629.066478729248,24445,4711,19734,19734,0,11,4188000.0
4188,4188999,21.42312672713062,38.399345845667696,0.08954549749757545,650.3221306800842,283.20386242866516,629.1979598999023,24445,4711,19734,19734,0,11,4189000.0
4189,4189999,21.430671934508826,38.41350370036294,0.0897285360617549,650.5740239620209,283.27140951156616,629.1927070617676,24451,4713,19738,19738,0,11,4190000.0
4190,4190999,21.433795652759777,38.42011851881452,0.08980042478620509,650.8412127494812,283.3381781578064,629.2079238891602,24467,4715,19752,19752,0,11,4191000.0
4191,4191999,21.43309433296981,38.42206977602877,0.08977089433349539,651.0953500270844,283.4070429801941,629.4108085632324,24496,4717,19779,19779,0,11,4192000.0
4192,4192999,21.432981159640665,38.42540305179275,0.08973406691131525,651.4024369716644,283.47396755218506,629.4421615600586,24510,4720,19790,19790,0,11,4193000.0
4193,4193999,21.432982225433555,38.426799051817234,0.08970137039057535,651.8470175266266,283.54218792915344,629.4287528991699,24534,4725,19809,19809,0,11,4194000.0
4194,4194999,21.433020943793256,38.42755170240044,0.08967778964176021,652.2743701934814,283.61013674736023,629.3562965393066,24556,4730,19826,19826,0,11,4195000.0
4195,4195999,21.43263941754956,38.426968116831574,0.08965961482200768,652.4663534164429,283.6768352985382,629.5588150024414,24562,4731,19831,19831,0,11,4196000.0
4196,4196999,21.43209124469518,38.42619622851595,0.08964612492904267,652.6606342792511,283.74355578422546,629.6443672180176,24568,4732,19836,19836,0,11,4197000.0
4197,4197999,21.43213003239701,38.42593004007754,0.08962579867974885,652.9126808643341,283.81364011764526,629.6475028991699,24580,4734,19846,19846,0,11,4198000.0
4198,4198999,21.432371806768582,38.4267825701716,0.08960483910213357,653.1016054153442,283.8802218437195,629.650764465332,24582,4735,19847,19847,0,11,4199000.0
4199,4199999,21.432732891267204,38.42751737539728,0.08960016324048681,653.2388777732849,283.9477868080139,629.7756156921387,24582,4735,19847,19847,0,11,4200000.0
4200,4200999,21.433691245230442,38.42963890449206,0.08959830699955595,653.5566120147705,284.0152339935303,629.7571907043457,24595,4738,19857,19857,0,11,4201000.0
4201,4201999,21.434986894899268,38.432326823587545,0.08958245898061912,653.7421424388885,284.0819230079651,629.8912353515625,24598,4739,19859,19859,0,11,4202000.0
4202,4202999,21.437179379702453,38.4357620194221,0.08957701679293006,653.9381906986237,284.148140668869,630.0109443664551,24603,4740,19863,19863,0,11,4203000.0
4203,4203999,21.439298466929625,38.43947698522272,0.08957833936930093,654.1235070228577,284.21617603302,630.1020736694336,24605,4741,19864,19864,0,11,4204000.0
4204,4204999,21.441762324184186,38.44238406770437,0.08958538535166394,654.2486991882324,284.28287839889526,630.2072486877441,24605,4741,19864,19864,0,11,4205000.0
4205,4205999,21.44501188661567,38.44776128856904,0.08960354237886381,654.5543293952942,284.3494851589203,630.1651077270508,24618,4744,19874,19874,0,11,4206000.0
4206,4206999,21.447939676467403,38.451644185374775,0.08962213806310071,654.7975072860718,284.416517496109,630.2006492614746,24626,4746,19880,19880,0,11,4207000.0
4207,4207999,21.451719342442836,38.457737498554366,0.08960778684853565,655.051575422287,284.48270416259766,630.2597846984863,24635,4748,19887,19887,0,11,4208000.0
4208,4208999,21.454665256490536,38.461212394536446,0.0896004277922261,655.2916748523712,284.5489549636841,630.3122749328613,24645,4750,19895,19895,0,11,4209000.0
4209,4209999,21.457999703649513,38.46507550842814,0.08962980717105695,655.5378422737122,284.6156210899353,630.3552589416504,24649,4752,19897,19897,0,11,4210000.0
4210,4210999,21.460128396048553,38.46579889823497,0.08965103703156618,655.7781827449799,284.68236231803894,630.4268913269043,24657,4754,19903,19903,0,11,4211000.0
4211,4211999,21.46067851189314,38.46641073615213,0.08962814512626949,655.9051468372345,284.7493350505829,630.9024238586426,24673,4754,19919,19919,0,11,4212000.0
4212,4212999,21.458983383429146,38.46507443338383,0.0896203962804929,656.141360282898,284.81543350219727,631.1303863525391,24686,4756,19930,19930,0,11,4213000.0
4213,4213999,21.45728829756656,38.462511322375214,0.08962248555984231,656.435647726059,284.8821635246277,631.2615242004395,24703,4759,19944,19944,0,11,4214000.0
4214,4214999,21.45594446023899,38.4602141141846,0.08962137769816292,656.6316010951996,284.94885516166687,631.4447555541992,24711,4760,19951,19951,0,11,4215000.0
4215,4215999,21.4544803365829,38.45773437556755,0.08961778753805882,656.8747818470001,285.01491117477417,631.5156059265137,24720,4762,19958,19958,0,11,4216000.0
4216,4216999,21.453065466724738,38.45593680158623,0.08961201332672142,656.9941637516022,285.08296251296997,631.8174629211426,24724,4762,19962,19962,0,11,4217000.0
4217,4217999,21.451625314929167,38.45340801257732,0.08961244044209016,657.178026676178,285.1486849784851,631.9807014465332,24729,4763,19966,19966,0,11,4218000.0
4218,4218999,21.450210353194066,38.450790371915076,0.08960711384100584,657.4154171943665,285.21493554115295,632.1253318786621,24734,4765,19969,19969,0,11,4219000.0
4219,4219999,21.449267164397202,38.449686872692006,0.08959867262721799,657.5727758407593,285.29370069503784,632.2834205627441,24735,4765,19970,19970,0,11,4220000.0
4220,4220999,21.448435108196566,38.44842453193706,0.08958964148492976,657.7035355567932,285.36108112335205,632.4631233215332,24738,4765,19973,19973,0,11,4221000.0
4221,4221999,21.44749118792063,38.44641157050836,0.0895808970832006,657.8860580921173,285.42724561691284,632.5763626098633,24745,4766,19979,19979,0,11,4222000.0
4222,4222999,21.447025548395064,38.44512450364327,0.08958044295090772,658.1253759860992,285.4935984611511,632.846435546875,24754,4768,19986,19986,0,11,4223000.0
4223,4223999,21.4480953036454,38.44690710159204,0.08959085307780534,658.248108625412,285.55917477607727,633.0347061157227,24754,4768,19986,19986,0,11,4224000.0
4224,4224999,21.449270408231964,38.44877463821424,0.0895914404944762,658.443026304245,285.6251804828644,633.1635055541992,24756,4769,19987,19987,0,11,4225000.0
4225,4225999,21.451039203338766,38.450651071440475,0.08961876023107485,658.7363786697388,285.6916275024414,633.221981048584,24763,4772,19991,19991,0,11,4226000.0
4226,4226999,21.45242905790329,38.45280654993754,0.08964769969064001,658.9279119968414,285.75838446617126,633.3319244384766,24766,4773,19993,19993,0,11,4227000.0
4227,4227999,21.45457711985387,38.459105709387714,0.08966715968717498,659.1276142597198,285.8246214389801,633.4270057678223,24773,4774,19999,19999,0,11,4228000.0
4228,4228999,21.457094170629496,38.46299018025805,0.08969259314946443,659.3674466609955,285.893807888031,633.7569274902344,24802,4776,20026,20026,0,11,4229000.0
4229,4229999,21.459053594534705,38.46573095254795,0.08971731920287995,659.5491485595703,285.95988178253174,633.9347381591797,24804,4777,20027,20027,0,11,4230000.0
4230,4230999,21.460724907513487,38.466335495796976,0.08973666023448812,659.6722846031189,286.025728225708,634.145824432373,24804,4777,20027,20027,0,11,4231000.0
4231,4231999,21.462278091744682,38.46665769361631,0.08975998403288366,659.9109451770782,286.09216046333313,634.2354469299316,24808,4779,20029,20029,0,11,4232000.0
4232,4232999,21.462214698104457,38.46515085916233,0.08976478920397135,660.1014075279236,286.16126704216003,634.4927558898926,24822,4780,20042,20042,0,11,4233000.0
4233,4233999,21.460173646075692,38.46240746896732,0.08977221519123468,660.2855145931244,286.22733783721924,635.0420761108398,24839,4781,20058,20058,0,11,4234000.0
4234,4234999,21.45803510388903,38.46015595907464,0.08977735589380287,660.473385810852,286.29834842681885,635.3582763671875,24850,4782,20068,20068,0,11,4235000.0
4235,4235999,21.455860152657245,38.457058586010206,0.08978326345545073,660.6568822860718,286.3649010658264,635.6723747253418,24862,4783,20079,20079,0,11,4236000.0
4236,4236999,21.454010373739877,38.45432401043448,0.08978839866641397,660.8480784893036,286.4332857131958,635.8608016967773,24867,4784,20083,20083,0,11,4237000.0
4237,4237999,21.45290943714451,38.45315187149144,0.08977454299853682,661.0906894207001,286.5002896785736,636.1936836242676,24881,4786,20095,20095,0,11,4238000.0
4238,4238999,21.451603161008837,38.450745956194886,0.0897676943401301,661.2756407260895,286.56644320487976,636.4327278137207,24889,4787,20102,20102,0,11,4239000.0
4239,4239999,21.450492723732065,38.44899247744028,0.08975552556234445,661.4066772460938,286.6344873905182,636.6234550476074,24890,4787,20103,20103,0,11,4240000.0
4240,4240999,21.449595829925872,38.44736342212304,0.08974465938368958,661.6470303535461,286.7009012699127,636.6866912841797,24894,4789,20105,20105,0,11,4241000.0
4241,4241999,21.44928145132692,38.44749959583916,0.08972912715242964,661.8374195098877,286.76709389686584,636.8450317382812,24899,4790,20109,20109,0,11,4242000.0
4242,4242999,21.44901761957934,38.44695122211733,0.08972051739388998,662.0179164409637,286.8339455127716,637.0130882263184,24906,4791,20115,20115,0,11,4243000.0
4243,4243999,21.448928343372813,38.44599988922868,0.0897143253023508,662.2098186016083,286.9031021595001,637.3487854003906,24915,4792,20123,20123,0,11,4244000.0
4244,4244999,21.449784025237495,38.44606240057696,0.08973136540987603,662.4494965076447,286.9697148799896,637.4856491088867,24920,4794,20126,20126,0,11,4245000.0
4245,4245999,21.451218740598176,38.44952704350676,0.08974802353637434,662.6312410831451,287.03566431999207,637.6127624511719,24927,4795,20132,20132,0,11,4246000.0
4246,4246999,21.452786377951394,38.4510717328339,0.08980395492279303,662.8208608627319,287.1024672985077,637.7494277954102,24929,4796,20133,20133,0,11,4247000.0
4247,4247999,21.45406029683547,38.451952145819824,0.08984367196839027,663.1239323616028,287.17198157310486,637.8322410583496,24937,4799,20138,20138,0,11,4248000.0
4248,4248999,21.456443753982175,38.454871599452936,0.08989831629263512,663.2551820278168,287.23808002471924,638.0285377502441,24939,4799,20140,20140,0,11,4249000.0
4249,4249999,21.458975652855734,38.45739730768662,0.08991059523253642,663.4333899021149,287.3048048019409,638.3113098144531,24949,4800,20149,20149,0,11,4250000.0
4250,4250999,21.461650296918624,38.45974693895036,0.08994587616561112,663.5585415363312,287.37106108665466,638.5652961730957,24949,4800,20149,20149,0,11,4251000.0
4251,4251999,21.463570647079564,38.46077943533715,0.08999377900654781,663.8034677505493,287.43743419647217,638.6567459106445,24953,4802,20151,20151,0,11,4252000.0
4252,4252999,21.465691216671896,38.4617480709835,0.09002547654697257,663.9793691635132,287.5030093193054,638.7425651550293,24955,4803,20152,20152,0,11,4253000.0
4253,4253999,21.46665517343512,38.4630288630045,0.09004082836258631,664.3478834629059,287.5696222782135,638.6949424743652,24965,4807,20158,20158,0,11,4254000.0
4254,4254999,21.464988475650088,38.460221270650614,0.09004076112004644,664.4756677150726,287.63723063468933,639.5168685913086,24996,4807,20189,20189,0,11,4255000.0
4255,4255999,21.462753173001165,38.45772576406401,0.09004660890588823,664.5925333499908,287.70340967178345,639.8469009399414,25001,4807,20194,20194,0,11,4256000.0
4256,4256999,21.460806903911077,38.45539105131761,0.09004981581863514,664.7157847881317,287.7705976963043,640.1014060974121,25006,4807,20199,20199,0,11,4257000.0
4257,4257999,21.459310804892528,38.45369543619426,0.09004982667907124,664.8891613483429,287.836345911026,640.2086372375488,25009,4808,20201,20201,0,11,4258000.0
4258,4258999,21.458113284059362,38.45312201600729,0.09003558578942827,665.0054409503937,287.9025721549988,640.4717712402344,25013,4808,20205,20205,0,11,4259000.0
4259,4259999,21.456803285434543,38.45205274633421,0.09002755644243543,665.2423090934753,287.96980905532837,640.6285552978516,25018,4810,20208,20208,0,11,4260000.0
4260,4260999,21.45538401245119,38.44949495234639,0.0900245947144176,665.4759495258331,288.03600239753723,640.7369842529297,25023,4812,20211,20211,0,11,4261000.0
4261,4261999,21.45414862808089,38.447073688933386,0.09002185119843742,665.7765791416168,288.10234689712524,640.8072662353516,25029,4815,20214,20214,0,11,4262000.0
4262,4262999,21.45293094990851,38.444828400882244,0.09001766782916387,665.954315662384,288.1688950061798,640.9406318664551,25037,4816,20221,20221,0,11,4263000.0
4263,4263999,21.452389257393335,38.44427076236344,0.09000205062169386,666.2468609809875,288.2366964817047,641.0744094848633,25060,4819,20241,20241,0,11,4264000.0
4264,4264999,21.451565771451317,38.44221550650329,0.08999033354497954,666.5438945293427,288.3049740791321,641.2417678833008,25075,4822,20253,20253,0,11,4265000.0
4265,4265999,21.451009130694498,38.440660074665544,0.08997724723364853,666.7228398323059,288.3721215724945,641.7205085754395,25091,4823,20268,20268,0,11,4266000.0
4266,4266999,21.45144345162791,38.441940679521785,0.08995405362383735,666.841629743576,288.43847727775574,641.9370384216309,25091,4823,20268,20268,0,11,4267000.0
4267,4267999,21.451152369549405,38.44004842674297,0.08994906235465006,667.1231186389923,288.50505328178406,642.0189590454102,25115,4826,20289,20289,0,11,4268000.0
4268,4268999,21.45135589825977,38.439550519496144,0.08993511318508607,667.245653629303,288.57123589515686,642.2573471069336,25117,4826,20291,20291,0,11,4269000.0
4269,4269999,21.451650246882195,38.439988363246435,0.08992372177316399,667.4748764038086,288.6375939846039,642.3102111816406,25124,4828,20296,20296,0,11,4270000.0
4270,4270999,21.45177676984891,38.43938499177085,0.08991456867576442,667.7195627689362,288.70466017723083,642.4973068237305,25147,4830,20317,20317,0,11,4271000.0
4271,4271999,21.452595506523483,38.441943704235534,0.0898951525741204,667.8367824554443,288.77102041244507,642.7980995178223,25150,4830,20320,20320,0,11,4272000.0
4272,4272999,21.45257284044552,38.44015802849447,0.08988170001287599,668.0705223083496,288.8365135192871,642.8820610046387,25156,4832,20324,20324,0,11,4273000.0
4273,4273999,21.453035577535218,38.4389512777945,0.08986905171263704,668.2024314403534,288.90826988220215,643.0001182556152,25156,4832,20324,20324,0,11,4274000.0
4274,4274999,21.45269730530584,38.43694913092451,0.08985797253961847,668.497138261795,288.97430062294006,642.9802627563477,25164,4835,20329,20329,0,11,4275000.0
4275,4275999,21.451550587624688,38.43491152398837,0.08985233841313034,668.7429404258728,289.04236102104187,643.5506210327148,25192,4837,20355,20355,0,11,4276000.0
4276,4276999,21.44953567114986,38.432772946730736,0.0898526858779839,668.9286267757416,289.1089403629303,643.8116798400879,25204,4838,20366,20366,0,11,4277000.0
4277,4277999,21.4472875863011,38.42940517160589,0.08985823571347529,669.0456039905548,289.17555236816406,644.0119705200195,25205,4838,20367,20367,0,11,4278000.0
4278,4278999,21.44535955031827,38.4267587169495,0.08986623433358287,669.2231452465057,289.2416203022003,644.1302261352539,25214,4839,20375,20375,0,11,4279000.0
4279,4279999,21.44398241689914,38.42604273187617,0.08985941937098918,669.4641470909119,289.3083465099335,644.1507835388184,25221,4841,20380,20380,0,11,4280000.0
4280,4280999,21.442152018269866,38.4230296421213,0.0898614309787994,669.6421043872833,289.37507581710815,644.5647850036621,25232,4842,20390,20390,0,11,4281000.0
4281,4281999,21.440368773434017,38.42044229907695,0.08986351253105562,669.7585332393646,289.44261360168457,644.8076400756836,25233,4842,20391,20391,0,11,4282000.0
4282,4282999,21.438876741438147,38.41794022640525,0.08986193928101227,669.9476022720337,289.50888323783875,644.9437103271484,25236,4843,20393,20393,0,11,4283000.0
4283,4283999,21.437423188193204,38.41638710842178,0.08985630050209015,670.1288619041443,289.5754165649414,645.0960121154785,25239,4844,20395,20395,0,11,4284000.0
4284,4284999,21.43586882504566,38.41367007435384,0.0898567726080608,670.3632855415344,289.6424071788788,645.1830787658691,25245,4846,20399,20399,0,11,4285000.0
4285,4285999,21.43470193656658,38.41171295455571,0.08985978342346335,670.5416758060455,289.70971751213074,645.3510665893555,25249,4847,20402,20402,0,11,4286000.0
4286,4286999,21.434504393694404,38.412425435823074,0.08985854008368299,670.7178556919098,289.7762155532837,645.6409759521484,25258,4848,20410,20410,0,11,4287000.0
4287,4287999,21.434428643553147,38.411619803594085,0.08984348095663919,670.9451310634613,289.8422920703888,645.7720603942871,25263,4850,20413,20413,0,11,4288000.0
4288,4288999,21.434399020954643,38.410715887484244,0.08982742812340594,671.33931016922,289.9087932109833,645.7004890441895,25278,4855,20423,20423,0,11,4289000.0
4289,4289999,21.435338234416736,38.41303327717844,0.08982934099115303,671.5764720439911,289.9768319129944,645.823356628418,25284,4857,20427,20427,0,11,4290000.0
4290,4290999,21.436416399136508,38.414352754785405,0.08983840508674035,671.704756975174,290.0429584980011,646.0155258178711,25284,4857,20427,20427,0,11,4291000.0
4291,4291999,21.43785996066384,38.416346983414186,0.08984451461921361,671.994654417038,290.1099326610565,646.108512878418,25311,4860,20451,20451,0,11,4292000.0
4292,4292999,21.440117203789764,38.419625995543804,0.08984437426433711,672.1769437789917,290.1788401603699,646.7047500610352,25335,4861,20474,20474,0,11,4293000.0
4293,4293999,21.443270462261278,38.42674848887414,0.08984152448558491,672.4170198440552,290.2458791732788,646.9327926635742,25344,4863,20481,20481,0,11,4294000.0
4294,4294999,21.446875821389117,38.43710370325508,0.0898448665083299,672.5919444561005,290.3129405975342,647.1616134643555,25348,4864,20484,20484,0,11,4295000.0
4295,4295999,21.449179264745812,38.44015713599625,0.08989022140669234,672.8958814144135,290.3799669742584,647.2929382324219,25371,4867,20504,20504,0,11,4296000.0
4296,4296999,21.45031597219195,38.44204622982636,0.08990135978874525,673.0177237987518,290.4472050666809,647.9215240478516,25400,4867,20533,20533,0,11,4297000.0
4297,4297999,21.44861133326632,38.44053904186864,0.08989737493931038,673.2002739906311,290.51438426971436,648.5179862976074,25422,4868,20554,20554,0,11,4298000.0
4298,4298999,21.44678300811301,38.43896206881222,0.08989902759758417,673.379640340805,290.5817584991455,648.7262840270996,25432,4869,20563,20563,0,11,4299000.0
4299,4299999,21.445297633940047,38.437992885896286,0.08990116982127683,673.6171691417694,290.6485583782196,648.9180946350098,25447,4871,20576,20576,0,11,4300000.0
4300,4300999,21.443697205679314,38.43604295208251,0.08989574962071034,673.9071235656738,290.7151503562927,649.0376625061035,25453,4874,20579,20579,0,11,4301000.0
4301,4301999,21.442099248911582,38.43347526220254,0.08990249213886214,674.0332405567169,290.7828974723816,649.3294410705566,25455,4874,20581,20581,0,11,4302000.0
4302,4302999,21.44048797781792,38.43133890183513,0.08990071663287169,674.2120521068573,290.84904885292053,649.4580535888672,25457,4875,20582,20582,0,11,4303000.0
4303,4303999,21.43936360673959,38.42967883764902,0.08989612884097564,674.385986328125,290.914922952652,649.5583114624023,25462,4876,20586,20586,0,11,4304000.0
4304,4304999,21.437963741704863,38.427443964050354,0.08989302290601464,674.5674183368683,290.98115134239197,649.6464653015137,25469,4877,20592,20592,0,11,4305000.0
4305,4305999,21.437027874841498,38.42584299770059,0.08988287133926376,674.8110287189484,291.04881477355957,649.7703819274902,25477,4879,20598,20598,0,11,4306000.0
4306,4306999,21.436273359836953,38.42436165135844,0.08986977886908432,674.9879305362701,291.1158549785614,650.1581115722656,25495,4880,20615,20615,0,11,4307000.0
4307,4307999,21.435811128621527,38.42350926686801,0.08985621388270082,675.3438022136688,291.1833710670471,650.2611312866211,25505,4884,20621,20621,0,11,4308000.0
4308,4308999,21.4348621530228,38.42144737825661,0.08984533079085577,675.7597231864929,291.251482963562,650.3056144714355,25521,4889,20632,20632,0,11,4309000.0
4309,4309999,21.434280022345273,38.419948466412144,0.08983514544972926,676.0072221755981,291.3199095726013,650.4764747619629,25526,4891,20635,20635,0,11,4310000.0
4310,4310999,21.43422087058636,38.42567591003921,0.08981072644774701,676.191596031189,291.38691234588623,650.6514701843262,25528,4892,20636,20636,0,11,4311000.0
4311,4311999,21.434027087135632,38.42464676896138,0.08979572357727705,676.3749656677246,291.4543809890747,650.8192520141602,25549,4893,20656,20656,0,11,4312000.0
4312,4312999,21.43379576640002,38.423173728061606,0.08978335661496917,676.612226486206,291.52088832855225,651.0484886169434,25562,4895,20667,20667,0,11,4313000.0
4313,4313999,21.433503505458397,38.421823627292014,0.08977100153346107,676.9052443504333,291.58861660957336,651.1620903015137,25578,4898,20680,20680,0,11,4314000.0
4314,4314999,21.432910319407846,38.42016265255205,0.08976416840885226,677.0326731204987,291.65458154678345,651.3430595397949,25578,4898,20680,20680,0,11,4315000.0
4315,4315999,21.431702226188563,38.418049280449665,0.08975353173722467,677.4073121547699,291.72427892684937,651.7552680969238,25615,4902,20713,20713,0,11,4316000.0
4316,4316999,21.430264239789114,38.4164467211613,0.08975680438251565,677.8706045150757,291.79184889793396,651.9867630004883,25645,4908,20737,20737,0,11,4317000.0
4317,4317999,21.42964888610622,38.416595538147114,0.08975294892347774,678.122968673706,291.8588397502899,652.1232528686523,25655,4910,20745,20745,0,11,4318000.0
4318,4318999,21.428933039388564,38.416343136060895,0.08974240959685353,678.3643202781677,291.9255540370941,652.2473182678223,25678,4912,20766,20766,0,11,4319000.0
4319,4319999,21.428575661370342,38.41543220495779,0.08971905076376474,678.4839398860931,291.9920325279236,652.6007080078125,25684,4912,20772,20772,0,11,4320000.0
4320,4320999,21.428536642650105,38.41517654563852,0.08971873824384957,678.6002531051636,292.05756759643555,652.8238945007324,25684,4912,20772,20772,0,11,4321000.0
4321,4321999,21.42867609964293,38.414311060272254,0.08971463472487162,678.8950343132019,292.1243715286255,652.8495635986328,25695,4915,20780,20780,0,11,4322000.0
4322,4322999,21.428395266597175,38.4134362595993,0.08971226266516685,679.1433987617493,292.19206070899963,652.9794807434082,25700,4917,20783,20783,0,11,4323000.0
4323,4323999,21.42833351708125,38.41257793925173,0.08970180856845655,679.2751545906067,292.2586159706116,653.2007904052734,25702,4917,20785,20785,0,11,4324000.0
4324,4324999,21.428341059869624,38.41182081901663,0.08970000859914062,679.3866128921509,292.324423789978,653.3644523620605,25704,4917,20787,20787,0,11,4325000.0
4325,4325999,21.429033648942173,38.41174786241299,0.08967558481090387,679.50830078125,292.39071798324585,653.75146484375,25714,4917,20797,20797,0,11,4326000.0
4326,4326999,21.42989199751394,38.413445197587336,0.08966403032465231,679.7030715942383,292.4572660923004,653.9112396240234,25716,4918,20798,20798,0,11,4327000.0
4327,4327999,21.43040179143492,38.4132735188343,0.08966533690987932,679.8780527114868,292.5228087902069,654.0249214172363,25718,4919,20799,20799,0,11,4328000.0
4328,4328999,21.431096245247204,38.413047863888764,0.0896717548236714,680.1132938861847,292.5894215106964,654.1192359924316,25723,4921,20802,20802,0,11,4329000.0
4329,4329999,21.43257169787295,38.416692084099665,0.08967742888536812,680.2952966690063,292.65567541122437,654.2303733825684,25730,4922,20808,20808,0,11,4330000.0
4330,4330999,21.434230769981404,38.41792344609808,0.089697705977967,680.5455274581909,292.7222650051117,654.250545501709,25740,4924,20816,20816,0,11,4331000.0
4331,4331999,21.436846389848046,38.42126726814027,0.08974186826563624,680.6610357761383,292.7886884212494,654.6505928039551,25749,4924,20825,20825,0,11,4332000.0
4332,4332999,21.439292338882524,38.42426155694492,0.08978837182716304,680.8917746543884,292.8543095588684,654.808837890625,25753,4926,20827,20827,0,11,4333000.0
4333,4333999,21.441767162682243,38.42656109284485,0.08984789297232931,681.1248850822449,292.9203407764435,654.9275169372559,25757,4928,20829,20829,0,11,4334000.0
4334,4334999,21.44411971084822,38.4285268535968,0.08991138209253946,681.3083391189575,292.98730301856995,655.0767669677734,25759,4929,20830,20830,0,11,4335000.0
4335,4335999,21.44540679794735,38.42925092062921,0.08990458875892793,681.4904029369354,293.0547332763672,655.3861465454102,25769,4930,20839,20839,0,11,4336000.0
4336,4336999,21.443756355886773,38.428018565331584,0.08989301185836684,681.7365524768829,293.11978793144226,655.7632064819336,25789,4932,20857,20857,0,11,4337000.0
4337,4337999,21.44234537906813,38.43004873186447,0.0898698244263415,681.9755234718323,293.18497467041016,655.9015617370605,25793,4934,20859,20859,0,11,4338000.0
4338,4338999,21.440759086374197,38.427955592527105,0.0898673809358912,682.1510496139526,293.250275850296,656.1007881164551,25799,4935,20864,20864,0,11,4339000.0
4339,4339999,21.439501274314033,38.42665286751542,0.08985646599464459,682.3311095237732,293.3154630661011,656.2182998657227,25808,4936,20872,20872,0,11,4340000.0
4340,4340999,21.43801798604085,38.424447139126364,0.08984914580095749,682.4547688961029,293.380331993103,656.4846878051758,25815,4936,20879,20879,0,11,4341000.0
4341,4341999,21.43693726333702,38.42391366367366,0.08983609059531827,682.7610664367676,293.44756412506104,656.5964851379395,25821,4939,20882,20882,0,11,4342000.0
4342,4342999,21.436309881882455,38.4237292921751,0.08982376717480522,683.1119663715363,293.5131504535675,656.6774749755859,25834,4943,20891,20891,0,11,4343000.0
4343,4343999,21.4356574109416,38.42219771281855,0.08981973186334813,683.2976722717285,293.57886958122253,656.803337097168,25836,4944,20892,20892,0,11,4344000.0
4344,4344999,21.435156064757756,38.4204734189823,0.0898147513399643,683.483776807785,293.6447765827179,656.9500846862793,25843,4945,20898,20898,0,11,4345000.0
4345,4345999,21.435659941621225,38.42143076325953,0.08980153267026303,683.6152868270874,293.7105267047882,657.1616706848145,25848,4945,20903,20903,0,11,4346000.0
4346,4346999,21.436294521592405,38.42223277772047,0.08978951192788298,683.7882251739502,293.77684926986694,657.4154853820801,25857,4946,20911,20911,0,11,4347000.0
4347,4347999,21.437232145061834,38.423092250359204,0.08977738749605046,683.9082596302032,293.84125542640686,657.6255073547363,25858,4946,20912,20912,0,11,4348000.0
4348,4348999,21.4383410380724,38.42443539475224,0.08977325066660224,684.158937215805,293.90652346611023,657.6780548095703,25863,4948,20915,20915,0,11,4349000.0
4349,4349999,21.44018182858083,38.429095419621575,0.08976521667413695,684.2801036834717,293.97120094299316,657.7971305847168,25863,4948,20915,20915,0,11,4350000.0
4350,4350999,21.442139790999814,38.43627338220456,0.08976547758399445,684.462902545929,294.03733921051025,657.892261505127,25866,4949,20917,20917,0,11,4351000.0
4351,4351999,21.444349488599123,38.43911564361462,0.08980065239813606,684.5802538394928,294.1017463207245,658.0084266662598,25866,4949,20917,20917,0,11,4352000.0
4352,4352999,21.446700885391078,38.441821055847576,0.0898176591258858,684.7067058086395,294.172132730484,658.2872428894043,25871,4949,20922,20922,0,11,4353000.0
4353,4353999,21.449382106011132,38.444553842354836,0.08984439441690739,684.8429200649261,294.23702335357666,658.4744834899902,25872,4949,20923,20923,0,11,4354000.0
4354,4354999,21.45175908844582,38.44650009746738,0.08986817942090242,685.1980264186859,294.30259561538696,658.5220603942871,25885,4953,20932,20932,0,11,4355000.0
4355,4355999,21.45442488743302,38.44893098505189,0.08992612102862074,685.4482080936432,294.3680226802826,658.6220245361328,25889,4955,20934,20934,0,11,4356000.0
4356,4356999,21.4551172990601,38.44790525206298,0.08995168283234367,685.5635542869568,294.4326374530792,658.7430152893066,25889,4955,20934,20934,0,11,4357000.0
4357,4357999,21.453496753479286,38.44581229552871,0.08995007206715466,685.869669675827,294.5008842945099,659.3692398071289,25948,4958,20990,20990,0,11,4358000.0
4358,4358999,21.452025726870637,38.44578510328459,0.08994498137471141,686.0450475215912,294.5665702819824,659.6626243591309,25960,4959,21001,21001,0,11,4359000.0
4359,4359999,21.45116391498021,38.445311713978015,0.08993873697220456,686.2321705818176,294.63210225105286,659.8023338317871,25963,4960,21003,21003,0,11,4360000.0
4360,4360999,21.4505929976974,38.444728484898214,0.08993400352665482,686.3602714538574,294.69760179519653,659.9929084777832,25965,4960,21005,21005,0,11,4361000.0
4361,4361999,21.450907453035814,38.44704582340011,0.08989431321793151,686.5411038398743,294.76464915275574,660.236198425293,25972,4961,21011,21011,0,11,4362000.0
4362,4362999,21.451133175631643,38.4474184412409,0.08988391311984112,686.7181539535522,294.8298108577728,660.4722442626953,25976,4962,21014,21014,0,11,4363000.0
4363,4363999,21.450842050957213,38.44616318167722,0.08987847205397292,687.0273885726929,294.8960978984833,660.5445671081543,25986,4965,21021,21021,0,11,4364000.0
4364,4364999,21.450871952511612,38.445510281247806,0.08987737511915417,687.1583917140961,294.96217370033264,660.7222175598145,25987,4965,21022,21022,0,11,4365000.0
4365,4365999,21.450514301735844,38.4441520065445,0.08986832527263922,687.3445901870728,295.02807092666626,660.8176193237305,25990,4966,21024,21024,0,11,4366000.0
4366,4366999,21.450868431666812,38.44396445504318,0.08985883045813314,687.4596471786499,295.0937342643738,661.0667877197266,25996,4966,21030,21030,0,11,4367000.0
4367,4367999,21.45075291427082,38.44316743027098,0.08985283458856108,687.6481368541718,295.1603603363037,661.2956161499023,26005,4967,21038,21038,0,11,4368000.0
4368,4368999,21.451239592074867,38.44325127731177,0.08983890232556946,687.8222782611847,295.2261974811554,661.5205574035645,26008,4968,21040,21040,0,11,4369000.0
4369,4369999,21.451834791064055,38.44399788651989,0.08982374700101381,688.0158789157867,295.2921314239502,661.673023223877,26010,4969,21041,21041,0,11,4370000.0
4370,4370999,21.45235578761677,38.44399986740801,0.08981383007120647,688.324164390564,295.3582661151886,661.7421340942383,26016,4972,21044,21044,0,11,4371000.0
4371,4371999,21.452670553044044,38.44350463154342,0.08980906171741887,688.5022404193878,295.423552274704,661.9209403991699,26020,4973,21047,21047,0,11,4372000.0
4372,4372999,21.453601242843543,38.44452109621888,0.08980039911555637,688.6218326091766,295.48879837989807,662.0935859680176,26023,4973,21050,21050,0,11,4373000.0
4373,4373999,21.45449562163547,38.444888906913604,0.08979603367984013,688.8104574680328,295.55455207824707,662.39111328125,26037,4974,21063,21063,0,11,4374000.0
4374,4374999,21.455461862772392,38.44588600476555,0.08978090430182017,688.9345173835754,295.61939692497253,662.6771812438965,26040,4974,21066,21066,0,11,4375000.0
4375,4375999,21.45627983424166,38.44664309879011,0.08976947814064129,689.2245750427246,295.6853942871094,662.8207931518555,26052,4977,21075,21075,0,11,4376000.0
4376,4376999,21.456860322726815,38.44603288905929,0.08977271132801601,689.4080810546875,295.7506721019745,662.9359397888184,26054,4978,21076,21076,0,11,4377000.0
4377,4377999,21.457147185388738,38.44596543791092,0.08975934651303352,689.5202310085297,295.81549048423767,663.0631523132324,26054,4978,21076,21076,0,11,4378000.0
4378,4378999,21.456873779635046,38.44598490100585,0.08974812727304338,689.637378692627,295.88182973861694,663.4841117858887,26063,4978,21085,21085,0,11,4379000.0
4379,4379999,21.456112105268932,38.447030906417965,0.08972492660812992,689.8862149715424,295.94697976112366,663.5708656311035,26074,4980,21094,21094,0,11,4380000.0
4380,4380999,21.455346289079777,38.446137096226856,0.08971457272220063,690.127964258194,296.01232504844666,663.6722793579102,26081,4982,21099,21099,0,11,4381000.0
4381,4381999,21.45502367924054,38.44619324789081,0.08969635567983869,690.4160106182098,296.0778021812439,663.7891693115234,26093,4985,21108,21108,0,11,4382000.0
4382,4382999,21.455045409695188,38.44639011083212,0.08967430155090694,690.6539554595947,296.1441068649292,663.9024200439453,26100,4987,21113,21113,0,11,4383000.0
4383,4383999,21.45584797699696,38.457200896447404,0.08961490295240271,690.900422334671,296.2095196247101,664.1502685546875,26106,4989,21117,21117,0,11,4384000.0
4384,4384999,21.45553412601495,38.45687426785479,0.08960360709770243,691.1422970294952,296.2749013900757,664.2320137023926,26115,4991,21124,21124,0,11,4385000.0
4385,4385999,21.455698231011826,38.457254645361225,0.08959005357597538,691.3858556747437,296.340430021286,664.330192565918,26119,4993,21126,21126,0,11,4386000.0
4386,4386999,21.45560183063941,38.45736197881426,0.089571478682271,691.5621991157532,296.4071385860443,664.4439544677734,26123,4994,21129,21129,0,11,4387000.0
4387,4387999,21.455933487166007,38.45800488170438,0.08953933243618994,691.6876182556152,296.4730474948883,664.6784057617188,26127,4994,21133,21133,0,11,4388000.0
4388,4388999,21.45658373592284,38.459000493242236,0.0895178017240178,691.8696212768555,296.5386583805084,664.7743530273438,26130,4995,21135,21135,0,11,4389000.0
4389,4389999,21.45696950448741,38.45887074953257,0.0895206368868442,692.119166135788,296.60432052612305,664.980152130127,26145,4997,21148,21148,0,11,4390000.0
4390,4390999,21.45769824625757,38.46046887374089,0.08951320060878865,692.2413663864136,296.66946816444397,665.1854515075684,26145,4997,21148,21148,0,11,4391000.0
4391,4391999,21.458472892857124,38.461053530495626,0.08951222668224312,692.4824674129486,296.7348759174347,665.2296752929688,26152,4999,21153,21153,0,11,4392000.0
4392,4392999,21.45937759573646,38.46170301669364,0.08951238953597618,692.728924036026,296.80126571655273,665.3588790893555,26157,5001,21156,21156,0,11,4393000.0
4393,4393999,21.46043925658551,38.462257130838935,0.08952270943996998,692.8517587184906,296.8664970397949,665.5707473754883,26159,5001,21158,21158,0,11,4394000.0
4394,4394999,21.462546277623524,38.46875784777653,0.0895055245362324,692.9730837345123,296.93193674087524,665.8305816650391,26166,5001,21165,21165,0,11,4395000.0
4395,4395999,21.463992394128393,38.470819624323234,0.08950454920237694,693.1530330181122,296.9973349571228,666.0837211608887,26170,5002,21168,21168,0,11,4396000.0
4396,4396999,21.4652692801753,38.47247316429646,0.08950057173599912,693.4601991176605,297.0626919269562,666.1384620666504,26176,5005,21171,21171,0,11,4397000.0
4397,4397999,21.46664023433094,38.47472869836185,0.08950243360354138,693.6312351226807,297.1272943019867,666.2639122009277,26178,5006,21172,21172,0,11,4398000.0
4398,4398999,21.46715141790265,38.47386620611598,0.08950775882255968,693.879410982132,297.19319200515747,666.3827629089355,26186,5008,21178,21178,0,11,4399000.0
4399,4399999,21.466206706601074,38.47186442042478,0.08950384560588587,694.1259078979492,297.26166343688965,666.9992256164551,26228,5010,21218,21218,0,11,4400000.0
4400,4400999,21.464128494866852,38.47143851990825,0.08950182466739187,694.2407381534576,297.3279914855957,667.4228858947754,26233,5010,21223,21223,0,11,4401000.0
4401,4401999,21.46219477351883,38.46949502181593,0.08950407060461407,694.3562598228455,297.3939187526703,667.7033767700195,26236,5010,21226,21226,0,11,4402000.0
4402,4402999,21.46041034078386,38.46766470096744,0.0895069149530755,694.5350248813629,297.4601619243622,667.9050674438477,26241,5011,21230,21230,0,11,4403000.0
4403,4403999,21.45857436713764,38.46497718910466,0.08951174808844942,694.6539969444275,297.52692770957947,668.1152381896973,26243,5011,21232,21232,0,11,4404000.0
4404,4404999,21.457450300802694,38.46322708335041,0.08950048274553513,694.8359677791595,297.59337425231934,668.4528884887695,26249,5012,21237,21237,0,11,4405000.0
4405,4405999,21.45606967378897,38.46054693404157,0.08950089923199567,695.1935758590698,297.6600532531738,668.4635963439941,26264,5016,21248,21248,0,11,4406000.0
4406,4406999,21.455071076411894,38.45905404873987,0.08950221066078878,695.5025441646576,297.7270357608795,668.5713920593262,26275,5019,21256,21256,0,11,4407000.0
4407,4407999,21.45444092996438,38.45853867883465,0.08950608855300002,695.7423768043518,297.79504227638245,668.7237281799316,26280,5021,21259,21259,0,11,4408000.0
4408,4408999,21.454809055265812,38.46098647443173,0.08949416716039782,695.9165108203888,297.8614704608917,668.9622192382812,26288,5022,21266,21266,0,11,4409000.0
4409,4409999,21.457024950912775,38.468319068997275,0.08947956610746166,696.037121295929,297.92770409584045,669.2039260864258,26291,5022,21269,21269,0,11,4410000.0
4410,4410999,21.46042745816573,38.478787946379626,0.0894932719093442,696.22811627388,297.9965603351593,669.7807922363281,26316,5023,21293,21293,0,11,4411000.0
4411,4411999,21.464885188683407,38.49607769172714,0.08949642723950402,696.5954270362854,298.06352186203003,669.9272193908691,26331,5027,21304,21304,0,11,4412000.0
4412,4412999,21.46933501990507,38.50687139075895,0.08959578399425316,696.7165637016296,298.13156962394714,670.1791725158691,26332,5027,21305,21305,0,11,4413000.0
4413,4413999,21.474305442231888,38.52189255883919,0.08965343516406554,696.9511001110077,298.19786643981934,670.3397827148438,26337,5029,21308,21308,0,11,4414000.0
4414,4414999,21.480397380338072,38.54017705018035,0.08967637877136114,697.073698759079,298.26351499557495,670.5207672119141,26337,5029,21308,21308,0,11,4415000.0
4415,4415999,21.48656523842467,38.55947519469191,0.08980870177846723,697.2533967494965,298.3300151824951,670.7518272399902,26347,5030,21317,21317,0,11,4416000.0
4416,4416999,21.493817498988964,38.574451484540454,0.08988629095480472,697.4259102344513,298.3962912559509,670.9628982543945,26351,5031,21320,21320,0,11,4417000.0
4417,4417999,21.50088716408139,38.58983821315128,0.09000179251112528,697.674572467804,298.4620225429535,671.084114074707,26355,5033,21322,21322,0,11,4418000.0
4418,4418999,21.508465009124308,38.605351710308554,0.0902281046682536,697.9852049350739,298.5276801586151,671.1228675842285,26361,5036,21325,21325,0,11,4419000.0
4419,4419999,21.51425612334708,38.61641837170207,0.0903992929003472,698.2241730690002,298.5931775569916,671.1908187866211,26365,5038,21327,21327,0,11,4420000.0
4420,4420999,21.514033603412265,38.61735342376629,0.09036673044083765,698.4139349460602,298.66071581840515,671.8841743469238,26396,5039,21357,21357,0,11,4421000.0
4421,4421999,21.512248033464907,38.61508820750198,0.0903611528523065,698.5932161808014,298.72736859321594,672.1006011962891,26419,5040,21379,21379,0,11,4422000.0
4422,4422999,21.51082481488577,38.61303918657309,0.09034734851029136,698.7117974758148,298.79323291778564,672.3661651611328,26423,5040,21383,21383,0,11,4423000.0
4423,4423999,21.510106512713882,38.617248015597966,0.09031783388591663,698.9487173557281,298.8592460155487,672.4253768920898,26448,5042,21406,21406,0,11,4424000.0
4424,4424999,21.509616242166004,38.61725588020157,0.09029336437721225,699.1901972293854,298.92568731307983,672.5702972412109,26459,5044,21415,21415,0,11,4425000.0
4425,4425999,21.508994323189043,38.61637407081421,0.09026932736383153,699.4262983798981,298.99295711517334,672.8667984008789,26471,5046,21425,21425,0,11,4426000.0
4426,4426999,21.50790892371722,38.61431931910659,0.09026327419294133,699.6664652824402,299.0596809387207,673.036449432373,26477,5048,21429,21429,0,11,4427000.0
4427,4427999,21.507257091088068,38.612610158126074,0.09025869797188812,699.7869355678558,299.1257531642914,673.2072448730469,26477,5048,21429,21429,0,11,4428000.0
4428,4428999,21.506683457093303,38.61137246728503,0.09024817311493616,699.8997347354889,299.1908872127533,673.3329772949219,26478,5048,21430,21430,0,11,4429000.0
4429,4429999,21.506929082341554,38.6152428996637,0.09021724763029959,700.1445593833923,299.25824666023254,673.4517517089844,26485,5050,21435,21435,0,11,4430000.0
4430,4430999,21.507680541693613,38.616186061978254,0.09022109321319427,700.2578227519989,299.32401490211487,673.6439819335938,26489,5050,21439,21439,0,11,4431000.0
4431,4431999,21.508930584245984,38.617310434710646,0.09023131113931404,700.5578510761261,299.3907082080841,673.8167839050293,26500,5053,21447,21447,0,11,4432000.0
4432,4432999,21.509970839789275,38.61826086957236,0.09025624786465336,700.8071730136871,299.45719504356384,673.927619934082,26514,5055,21459,21459,0,11,4433000.0
4433,4433999,21.51142223494398,38.6201055629281,0.09025886278207074,701.0594148635864,299.5239887237549,674.0304374694824,26520,5057,21463,21463,0,11,4434000.0
4434,4434999,21.513312494878168,38.62341259748072,0.09027245225343306,701.2379796504974,299.59006667137146,674.1891136169434,26526,5058,21468,21468,0,11,4435000.0
4435,4435999,21.515982222992417,38.627582210405706,0.09030064241982216,701.6131660938263,299.6572232246399,674.169979095459,26546,5062,21484,21484,0,11,4436000.0
4436,4436999,21.518058202136885,38.63396517271533,0.09032098293983604,701.8611781597137,299.72450494766235,674.4897842407227,26559,5064,21495,21495,0,11,4437000.0
4437,4437999,21.52064418582574,38.63677049799792,0.09033928553476644,701.9869303703308,299.79128313064575,675.0352363586426,26575,5064,21511,21511,0,11,4438000.0
4438,4438999,21.52339935724676,38.641309301731624,0.09034829677149536,702.222493648529,299.8577241897583,675.1530609130859,26579,5066,21513,21513,0,11,4439000.0
4439,4439999,21.52630632316711,38.64595882262113,0.09039077700866027,702.5290396213531,299.9242298603058,675.1984100341797,26593,5069,21524,21524,0,11,4440000.0
4440,4440999,21.528153589357593,38.647305221443396,0.09042403673433153,702.7053716182709,299.9905562400818,675.3980445861816,26595,5070,21525,21525,0,11,4441000.0
4441,4441999,21.52797724914124,38.646160089483274,0.09043125820585707,702.8295423984528,300.05923223495483,676.2709808349609,26635,5070,21565,21565,0,11,4442000.0
4442,4442999,21.52642134649878,38.644192997336525,0.09042938254271249,703.004385471344,300.12609243392944,676.6531219482422,26650,5071,21579,21579,0,11,4443000.0
4443,4443999,21.5247658929836,38.64292532841907,0.09042974319626074,703.1862530708313,300.1938786506653,676.8260459899902,26660,5072,21588,21588,0,11,4444000.0
4444,4444999,21.522837192599006,38.64058708748074,0.09043903904137729,703.3072934150696,300.2608461380005,677.0489616394043,26664,5072,21592,21592,0,11,4445000.0
4445,4445999,21.52130774800982,38.638222054230646,0.09043735021189814,703.6744863986969,300.32841420173645,677.228687286377,26685,5076,21609,21609,0,11,4446000.0
4446,4446999,21.519715087729587,38.63576006377073,0.09044035118622584,703.7944099903107,300.3945155143738,677.5013961791992,26685,5076,21609,21609,0,11,4447000.0
4447,4447999,21.518204078096158,38.63353664464567,0.0904404757283962,703.9736611843109,300.4606955051422,677.623706817627,26687,5077,21610,21610,0,11,4448000.0
4448,4448999,21.51689894113255,38.63101583938245,0.09044377259581937,704.0938737392426,300.5271067619324,677.8137969970703,26687,5077,21610,21610,0,11,4449000.0
4449,4449999,21.515641271814133,38.62867873938901,0.09044186377916308,704.3303310871124,300.5934808254242,677.8302383422852,26692,5079,21613,21613,0,11,4450000.0
4450,4450999,21.514405257265743,38.62689143394026,0.09043724263545505,704.5160758495331,300.6605660915375,678.013370513916,26699,5080,21619,21619,0,11,4451000.0
4451,4451999,21.513592160288145,38.62480274180353,0.0904304003340114,704.6991925239563,300.72761154174805,678.4217262268066,26717,5081,21636,21636,0,11,4452000.0
4452,4452999,21.512909469447433,38.62353721650623,0.09042356087421244,705.0589179992676,300.7948203086853,678.5532341003418,26727,5085,21642,21642,0,11,4453000.0
4453,4453999,21.511877324060872,38.621118077620544,0.09042385003182574,705.3636240959167,300.8620774745941,678.714958190918,26744,5088,21656,21656,0,11,4454000.0
4454,4454999,21.510995401085683,38.61910315090342,0.09042325909243443,705.6051287651062,300.930237531662,678.8530311584473,26765,5090,21675,21675,0,11,4455000.0
4455,4455999,21.51020465283276,38.61708552026113,0.09041569078837608,705.7245907783508,300.99669766426086,679.0352439880371,26766,5090,21676,21676,0,11,4456000.0
4456,4456999,21.509497272311116,38.61541752241447,0.0904072352974129,705.8465785980225,301.06295919418335,679.2741432189941,26770,5090,21680,21680,0,11,4457000.0
4457,4457999,21.50884664188544,38.61371151856078,0.0903936859661647,706.1525518894196,301.1296145915985,679.4082565307617,26782,5093,21689,21689,0,11,4458000.0
4458,4458999,21.507947151163975,38.611610633103716,0.09039296180318968,706.4492371082306,301.1971299648285,679.5424957275391,26793,5096,21697,21697,0,11,4459000.0
4459,4459999,21.50709188189942,38.60991169108579,0.09038989641994422,706.7583470344543,301.2640187740326,679.5770378112793,26805,5099,21706,21706,0,11,4460000.0
4460,4460999,21.50628723176374,38.61011860500742,0.09031133589930329,707.0717658996582,301.3332459926605,680.182746887207,26849,5102,21747,21747,0,11,4461000.0
4461,4461999,21.504549771676174,38.60760701255573,0.0903122166943493,707.187243938446,301.3995020389557,680.572696685791,26854,5102,21752,21752,0,11,4462000.0
4462,4462999,21.502908032842818,38.606020580778726,0.09031707102692743,707.3766448497772,301.46627402305603,680.8310775756836,26866,5103,21763,21763,0,11,4463000.0
4463,4463999,21.501050249832282,38.60341132456865,0.09032874721964301,707.4992637634277,301.5322070121765,681.0221748352051,26867,5103,21764,21764,0,11,4464000.0
4464,4464999,21.499586020562553,38.60154273892351,0.09032850954868055,707.687374830246,301.5988492965698,681.3768653869629,26882,5104,21778,21778,0,11,4465000.0
4465,4465999,21.49834959394921,38.600098121276666,0.0903242599610895,707.8668458461761,301.66576075553894,681.593879699707,26889,5105,21784,21784,0,11,4466000.0
4466,4466999,21.497067010683903,38.601709762429415,0.09030678099247536,707.9884445667267,301.7317707538605,681.7830810546875,26890,5105,21785,21785,0,11,4467000.0
4467,4467999,21.495453741989685,38.598974322712905,0.09030854898867213,708.2280380725861,301.7986481189728,681.8739929199219,26895,5107,21788,21788,0,11,4468000.0
4468,4468999,21.494080261196498,38.5964972630235,0.09030917948632777,708.4225316047668,301.8661563396454,682.0612030029297,26901,5108,21793,21793,0,11,4469000.0
4469,4469999,21.4926564794309,38.594101022043304,0.09031107052175102,708.5974662303925,301.93328070640564,682.1832046508789,26905,5109,21796,21796,0,11,4470000.0
4470,4470999,21.49174320318819,38.592381416890525,0.09029970985197067,708.7778656482697,302.0003581047058,682.5880241394043,26918,5110,21808,21808,0,11,4471000.0
4471,4471999,21.491156100957284,38.59083465862553,0.09029287379797257,709.0785307884216,302.0669765472412,682.700511932373,26924,5113,21811,21811,0,11,4472000.0
4472,4472999,21.490561397856677,38.5898015580041,0.09028430088441386,709.3805208206177,302.13466906547546,682.8243026733398,26930,5116,21814,21814,0,11,4473000.0
4473,4473999,21.49013639279745,38.58856001023663,0.09027429990054836,709.5583651065826,302.20148038864136,682.9963798522949,26932,5117,21815,21815,0,11,4474000.0
4474,4474999,21.489667495813624,38.58715037173429,0.09026698598030758,709.7396106719971,302.26798272132874,683.1613082885742,26935,5118,21817,21817,0,11,4475000.0
4475,4475999,21.48942536363762,38.58557303367592,0.0902632239188722,709.8561158180237,302.3340153694153,683.337589263916,26935,5118,21817,21817,0,11,4476000.0
4476,4476999,21.489167102748393,38.58385168935444,0.09025622222420193,709.9851293563843,302.40123772621155,683.7335243225098,26944,5118,21826,21826,0,11,4477000.0
4477,4477999,21.489511666608756,38.58336180170256,0.09023899777380184,710.2230355739594,302.46708369255066,683.9041442871094,26948,5120,21828,21828,0,11,4478000.0
4478,4478999,21.489634018434746,38.5822161557391,0.09022646715298543,710.3993463516235,302.53302526474,684.0586433410645,26950,5121,21829,21829,0,11,4479000.0
4479,4479999,21.489564173087583,38.58086691289296,0.09021834668892459,710.7069177627563,302.60002422332764,684.1234931945801,26961,5124,21837,21837,0,11,4480000.0
4480,4480999,21.48913088783723,38.57982846551091,0.09020514758772791,710.892838716507,302.66798877716064,684.3848762512207,26969,5125,21844,21844,0,11,4481000.0
4481,4481999,21.487102255764167,38.57772351186307,0.09021247509924968,711.00812292099,302.73300433158875,684.8666954040527,26978,5125,21853,21853,0,11,4482000.0
4482,4482999,21.48551218594158,38.57849130356762,0.09020011153670415,711.1942863464355,302.79851174354553,685.0574493408203,26984,5126,21858,21858,0,11,4483000.0
4483,4483999,21.483685487084777,38.576241211062175,0.09020041784551536,711.3863985538483,302.8641881942749,685.349292755127,26996,5127,21869,21869,0,11,4484000.0
4484,4484999,21.482285817994505,38.575518918854115,0.09019676689414724,711.5629041194916,302.9291801452637,685.4826889038086,26999,5128,21871,21871,0,11,4485000.0
4485,4485999,21.480690880624753,38.57317263147727,0.090190593970908,711.8733515739441,302.996568441391,685.6346778869629,27009,5131,21878,21878,0,11,4486000.0
4486,4486999,21.479141410432767,38.570662380377705,0.09019316887693107,712.0505907535553,303.06248593330383,685.8497161865234,27011,5132,21879,21879,0,11,4487000.0
4487,4487999,21.4774542754204,38.568003607677525,0.09019221829782631,712.3079714775085,303.1286118030548,685.9965667724609,27016,5134,21882,21882,0,11,4488000.0
4488,4488999,21.47624111859671,38.566078110150436,0.09018834327561265,712.4346737861633,303.1942377090454,686.1624794006348,27016,5134,21882,21882,0,11,4489000.0
4489,4489999,21.474884516607553,38.563424491637534,0.09018525120735588,712.6132242679596,303.2598440647125,686.2833023071289,27024,5135,21889,21889,0,11,4490000.0
4490,4490999,21.473438299610066,38.560895890339474,0.09018571342023918,712.7305963039398,303.326119184494,686.4699859619141,27028,5135,21893,21893,0,11,4491000.0
4491,4491999,21.472575978271973,38.5592729841731,0.0901746013263679,712.8665015697479,303.3924536705017,686.7305488586426,27034,5135,21899,21899,0,11,4492000.0
4492,4492999,21.47203093287794,38.55863119891401,0.09016167555776988,713.1153118610382,303.4576632976532,686.8377914428711,27039,5137,21902,21902,0,11,4493000.0
4493,4493999,21.471637860376376,38.557608700738726,0.09015476323645166,713.2376346588135,303.5225169658661,687.0280113220215,27039,5137,21902,21902,0,11,4494000.0
4494,4494999,21.47108136869671,38.556527930136724,0.09014564426086458,713.4210271835327,303.5886387825012,687.1544647216797,27043,5138,21905,21905,0,11,4495000.0
4495,4495999,21.471077163751026,38.55598518722186,0.09012734653856236,713.5448887348175,303.6541304588318,687.2912254333496,27044,5138,21906,21906,0,11,4496000.0
4496,4496999,21.470815960146915,38.554361443018145,0.09011828996309501,713.6655540466309,303.71981263160706,687.4048919677734,27045,5138,21907,21907,0,11,4497000.0
4497,4497999,21.47041227913726,38.552854573507204,0.0901108588528482,713.8518311977386,303.78551506996155,687.6490821838379,27081,5139,21942,21942,0,11,4498000.0
4498,4498999,21.47042431478403,38.55182505603346,0.09009945819159637,713.9683108329773,303.850026845932,687.824836730957,27081,5139,21942,21942,0,11,4499000.0
4499,4499999,21.470033210778507,38.550059277546886,0.0900915015746282,714.2192306518555,303.9155888557434,687.8361854553223,27085,5141,21944,21944,0,11,4500000.0
4500,4500999,21.47000263156756,38.550385078443696,0.09008039629205011,714.4116535186768,303.981050491333,687.9542655944824,27087,5142,21945,21945,0,11,4501000.0
4501,4501999,21.469542015732085,38.54864833970494,0.09007462483965079,714.5356125831604,304.0459191799164,688.0680961608887,27087,5142,21945,21945,0,11,4502000.0
4502,4502999,21.4689717352669,38.54817943771608,0.09005559431626475,714.6524260044098,304.11256194114685,688.7644805908203,27115,5142,21973,21973,0,11,4503000.0
4503,4503999,21.467477564385533,38.54801979063591,0.09004743658380343,714.7657752037048,304.1784448623657,689.0770034790039,27119,5142,21977,21977,0,11,4504000.0
4504,4504999,21.46610546214294,38.545572023461965,0.09005082287159238,714.8850646018982,304.2447292804718,689.2900161743164,27120,5142,21978,21978,0,11,4505000.0
4505,4505999,21.46490550793786,38.54365671929919,0.09004846869111183,715.0660402774811,304.31038451194763,689.4470252990723,27124,5143,21981,21981,0,11,4506000.0
4506,4506999,21.46336941709326,38.54086691585535,0.09005290618261086,715.2534754276276,304.37642526626587,689.5750045776367,27126,5144,21982,21982,0,11,4507000.0
4507,4507999,21.462553304954486,38.539628163185746,0.09004720724225312,715.3685350418091,304.4421579837799,690.0899314880371,27137,5144,21993,21993,0,11,4508000.0
4508,4508999,21.462010971979606,38.53780217536893,0.09005115989011847,715.7349271774292,304.509094953537,690.1086578369141,27149,5148,22001,22001,0,11,4509000.0
4509,4509999,21.461411654977034,38.536007381114935,0.09005518975332993,716.0411660671234,304.5755546092987,690.2803115844727,27161,5151,22010,22010,0,11,4510000.0
4510,4510999,21.460723423642023,38.534039818995204,0.09005026511389558,716.2193510532379,304.6415693759918,690.4928169250488,27167,5152,22015,22015,0,11,4511000.0
4511,4511999,21.46023408558636,38.53270961267303,0.09004783532423777,716.396874666214,304.7097930908203,690.7081184387207,27172,5153,22019,22019,0,11,4512000.0
4512,4512999,21.459956606124255,38.53099025566061,0.09004410690178843,716.5205209255219,304.77608466148376,690.926456451416,27176,5153,22023,22023,0,11,4513000.0
4513,4513999,21.460054991914436,38.53020786446989,0.09002956168913978,716.8277657032013,304.8425295352936,691.1836891174316,27189,5156,22033,22033,0,11,4514000.0
4514,4514999,21.45997183422963,38.52920886073228,0.09002038457537986,717.0058438777924,304.90729999542236,691.3349914550781,27191,5157,22034,22034,0,11,4515000.0
4515,4515999,21.45996476304198,38.52827960327917,0.09000950406914165,717.3169503211975,304.97468876838684,691.4204483032227,27197,5160,22037,22037,0,11,4516000.0
4516,4516999,21.45985923646824,38.52668703572332,0.0900013130640529,717.5042362213135,305.0402662754059,691.5385208129883,27205,5161,22044,22044,0,11,4517000.0
4517,4517999,21.45996304651659,38.52547347729189,0.08999361154785113,717.7556655406952,305.1063873767853,691.6157455444336,27216,5163,22053,22053,0,11,4518000.0
4518,4518999,21.45988270160701,38.523944708763125,0.08998824871292765,718.0072746276855,305.1727788448334,691.6784553527832,27229,5165,22064,22064,0,11,4519000.0
4519,4519999,21.460197497978605,38.52328416346577,0.08997506841364089,718.251366853714,305.2392830848694,692.0373992919922,27258,5167,22091,22091,0,11,4520000.0
4520,4520999,21.460321419656033,38.52217411287239,0.08997404311782675,718.4389922618866,305.3046989440918,692.2094764709473,27266,5168,22098,22098,0,11,4521000.0
4521,4521999,21.460187210957656,38.52049102736187,0.08997632093791808,718.6793067455292,305.36977910995483,692.2592506408691,27270,5170,22100,22100,0,11,4522000.0
4522,4522999,21.460192266842586,38.51915733942942,0.08997467575043405,718.8563165664673,305.4361979961395,692.4605407714844,27272,5171,22101,22101,0,11,4523000.0
4523,4523999,21.459353454967037,38.51739360462601,0.08996425220718451,718.9718441963196,305.5021481513977,692.8512191772461,27283,5171,22112,22112,0,11,4524000.0
4524,4524999,21.457500599532917,38.515608272367054,0.08996802033211848,719.0858039855957,305.5664451122284,693.1223182678223,27286,5171,22115,22115,0,11,4525000.0
4525,4525999,21.455787410091755,38.51323506957304,0.08996913624107461,719.334883928299,305.6328983306885,693.2468376159668,27298,5173,22125,22125,0,11,4526000.0
4526,4526999,21.453778675516798,38.51059621983481,0.0899736943744811,719.5187368392944,305.69814348220825,693.4672355651855,27306,5174,22132,22132,0,11,4527000.0
4527,4527999,21.45235274136826,38.50979876523162,0.08996760407037663,719.7013132572174,305.7633321285248,693.6045455932617,27309,5175,22134,22134,0,11,4528000.0
4528,4528999,21.450899052050577,38.50760377001746,0.08996374486659287,719.9546384811401,305.8292508125305,693.9239044189453,27327,5177,22150,22150,0,11,4529000.0
4529,4529999,21.449340266224464,38.504835156043484,0.08995896823286842,720.1387491226196,305.89517426490784,694.2260856628418,27329,5178,22151,22151,0,11,4530000.0
4530,4530999,21.4477864871167,38.50221216811705,0.08995364134535555,720.3153035640717,305.96077013015747,694.4166679382324,27332,5179,22153,22153,0,11,4531000.0
4531,4531999,21.446280335464504,38.50014355946507,0.0899481892539008,720.5003142356873,306.02633476257324,694.5763969421387,27335,5180,22155,22155,0,11,4532000.0
4532,4532999,21.444920466967304,38.49788978427669,0.08993891224078499,720.6156935691833,306.0915186405182,694.8076553344727,27339,5180,22159,22159,0,11,4533000.0
4533,4533999,21.443641533285913,38.49561780788078,0.08993408917700141,720.8690917491913,306.1577606201172,694.8853759765625,27349,5182,22167,22167,0,11,4534000.0
4534,4534999,21.442750080378442,38.493937954877985,0.0899182985660193,721.1146130561829,306.22420263290405,695.2425994873047,27363,5184,22179,22179,0,11,4535000.0
4535,4535999,21.442406801293625,38.49389606262716,0.08990204488663267,721.2960674762726,306.28955125808716,695.4853591918945,27365,5185,22180,22180,0,11,4536000.0
4536,4536999,21.441777093933897,38.492491071017746,0.08988904950157162,721.4719576835632,306.3546805381775,695.6731758117676,27367,5186,22181,22181,0,11,4537000.0
4537,4537999,21.441251645883842,38.490885057532665,0.0898774855992065,721.7048830986023,306.42094683647156,695.8270797729492,27371,5188,22183,22183,0,11,4538000.0
4538,4538999,21.44078259616579,38.48936985668545,0.08986999132410178,721.8356971740723,306.4862971305847,695.9940452575684,27371,5188,22183,22183,0,11,4539000.0
4539,4539999,21.440825194092362,38.48850496726265,0.08985174359379133,721.9521496295929,306.55140495300293,696.1742706298828,27374,5188,22186,22186,0,11,4540000.0
4540,4540999,21.44108677192643,38.488157581648366,0.08982875256369527,722.0634751319885,306.61672925949097,696.5410995483398,27383,5188,22195,22195,0,11,4541000.0
4541,4541999,21.44173956697727,38.4879687802022,0.089812970445599,722.2481677532196,306.6825587749481,696.6811790466309,27385,5189,22196,22196,0,11,4542000.0
4542,4542999,21.442355351643197,38.48785768044338,0.08980747128405031,722.4910523891449,306.74774956703186,696.8392295837402,27396,5191,22205,22205,0,11,4543000.0
4543,4543999,21.443326640604223,38.487826397113,0.08979441990107628,722.7386565208435,306.8130946159363,696.8819541931152,27400,5193,22207,22207,0,11,4544000.0
4544,4544999,21.443141461323002,38.48618792429461,0.08978350504872246,722.9903259277344,306.8789732456207,696.9877014160156,27405,5195,22210,22210,0,11,4545000.0
4545,4545999,21.44130448254996,38.48320289608066,0.08978458775538234,723.1099348068237,306.9466428756714,697.8024978637695,27437,5195,22242,22242,0,11,4546000.0
4546,4546999,21.43965844345339,38.48167051480225,0.0897796252248736,723.231201171875,307.01323199272156,698.1389999389648,27441,5195,22246,22246,0,11,4547000.0
4547,4547999,21.438090538257498,38.48119960385103,0.08976924652617002,723.4212021827698,307.0793900489807,698.3665351867676,27447,5196,22251,22251,0,11,4548000.0
4548,4548999,21.436918950829334,38.47965309571406,0.0897603197369905,723.5369427204132,307.1464285850525,698.5419464111328,27447,5196,22251,22251,0,11,4549000.0
4549,4549999,21.436458226661006,38.479478699748356,0.08974736267752903,723.6533939838409,307.2122890949249,698.8672676086426,27453,5196,22257,22257,0,11,4550000.0
4550,4550999,21.435984804417433,38.47839699651315,0.08974583607904307,723.9564802646637,307.2785325050354,699.0399894714355,27459,5199,22260,22260,0,11,4551000.0
4551,4551999,21.43542335542849,38.47800556908349,0.089738699023314,724.2638182640076,307.34518337249756,699.0998878479004,27471,5202,22269,22269,0,11,4552000.0
4552,4552999,21.435336585529395,38.47867294804827,0.08973164795292665,724.5646584033966,307.41205501556396,699.2373352050781,27477,5205,22272,22272,0,11,4553000.0
4553,4553999,21.435516523723333,38.479253196273326,0.08974240056141103,724.9278995990753,307.48039984703064,699.3299217224121,27490,5209,22281,22281,0,11,4554000.0
4554,4554999,21.435880165100624,38.48001319573527,0.0897553976127049,725.115829706192,307.54846715927124,699.6390342712402,27519,5210,22309,22309,0,11,4555000.0
4555,4555999,21.436465156887422,38.48147401600379,0.08976075163701114,725.3701703548431,307.61639189720154,700.0779457092285,27543,5212,22331,22331,0,11,4556000.0
4556,4556999,21.437438132131234,38.48227107116869,0.0897842076017995,725.5477046966553,307.6832718849182,700.4250030517578,27551,5213,22338,22338,0,11,4557000.0
4557,4557999,21.438717760007055,38.48426914736958,0.08979517103204959,725.7302975654602,307.74979519844055,700.6259422302246,27554,5214,22340,22340,0,11,4558000.0
4558,4558999,21.44101073367501,38.48806183163324,0.0897968467616509,726.175047159195,307.8186602592468,700.6762809753418,27576,5219,22357,22357,0,11,4559000.0
4559,4559999,21.44309496187104,38.49083470871118,0.08982074300430276,726.291793346405,307.8851556777954,700.8933753967285,27577,5219,22358,22358,0,11,4560000.0
4560,4560999,21.445038323368685,38.493012797685985,0.08986281485813108,726.4099576473236,307.95191740989685,701.0784912109375,27577,5219,22358,22358,0,11,4561000.0
4561,4561999,21.44756393727991,38.49602174618589,0.08990079391280492,726.6580240726471,308.0195755958557,701.385570526123,27589,5221,22368,22368,0,11,4562000.0
4562,4562999,21.45023990527718,38.499297009660665,0.08995681263904931,726.9689972400665,308.08534574508667,701.4572448730469,27597,5224,22373,22373,0,11,4563000.0
4563,4563999,21.45339961876609,38.502861712259815,0.09003133438387978,727.2697784900665,308.15206813812256,701.578296661377,27608,5227,22381,22381,0,11,4564000.0
4564,4564999,21.45649268833572,38.506061447546024,0.09010593562192704,727.5166339874268,308.218044757843,701.6886253356934,27612,5229,22383,22383,0,11,4565000.0
4565,4565999,21.45858064462448,38.50745589420175,0.09017592742084579,727.694967508316,308.2850947380066,701.9236297607422,27616,5230,22386,22386,0,11,4566000.0
4566,4566999,21.457466171447134,38.50500010853359,0.09017017707149677,727.8844494819641,308.352801322937,702.6218490600586,27648,5231,22417,22417,0,11,4567000.0
4567,4567999,21.45606064098228,38.503267926970885,0.09017325871477266,728.0059070587158,308.42006397247314,702.9333190917969,27653,5231,22422,22422,0,11,4568000.0
4568,4568999,21.45465625633667,38.50212797020154,0.0901653499325159,728.2593653202057,308.4867286682129,703.0871887207031,27660,5233,22427,22427,0,11,4569000.0
4569,4569999,21.453010478798582,38.49932793849346,0.09016799322647773,728.3840634822845,308.5527527332306,703.2528686523438,27661,5233,22428,22428,0,11,4570000.0
4570,4570999,21.4514019802572,38.496638306632825,0.09016600833276411,728.5692715644836,308.61976885795593,703.5015182495117,27670,5234,22436,22436,0,11,4571000.0
4571,4571999,21.45017591491604,38.49459181200079,0.09015846979144904,728.6962189674377,308.68555426597595,703.7511177062988,27671,5234,22437,22437,0,11,4572000.0
4572,4572999,21.448989456058573,38.492976228613024,0.09014967850729838,728.8726308345795,308.7517726421356,703.8906517028809,27676,5235,22441,22441,0,11,4573000.0
4573,4573999,21.447805366746366,38.49145608669306,0.0901385978366771,729.0619723796844,308.8179819583893,704.0451202392578,27678,5236,22442,22442,0,11,4574000.0
4574,4574999,21.446744498964,38.48994211906975,0.09012729018928722,729.3034181594849,308.8840777873993,704.0986480712891,27690,5238,22452,22452,0,11,4575000.0
4575,4575999,21.445953705909396,38.488937845770266,0.09011952608184803,729.4936547279358,308.9508419036865,704.2788276672363,27697,5239,22458,22458,0,11,4576000.0
4576,4576999,21.445724149934257,38.49339125866696,0.09008363663738539,729.6791477203369,309.01741433143616,704.6147308349609,27711,5240,22471,22471,0,11,4577000.0
4577,4577999,21.446357866172914,38.495685819670356,0.09010291240667656,729.8576514720917,309.08302640914917,704.822681427002,27714,5241,22473,22473,0,11,4578000.0
4578,4578999,21.448501457933137,38.50221282492326,0.09011745637961754,729.9742939472198,309.14854431152344,705.0423774719238,27715,5241,22474,22474,0,11,4579000.0
4579,4579999,21.450851694401365,38.50799274974006,0.09017653733907738,730.2851312160492,309.21511936187744,705.0638999938965,27727,5244,22483,22483,0,11,4580000.0
4580,4580999,21.453718724581694,38.51609614073725,0.09022758823558252,730.4652094841003,309.2817268371582,705.204891204834,27731,5245,22486,22486,0,11,4581000.0
4581,4581999,21.45817861456097,38.527254743726196,0.0903194688122172,730.712902545929,309.34825015068054,705.3311462402344,27737,5247,22490,22490,0,11,4582000.0
4582,4582999,21.46268393996661,38.53660001698055,0.09043797936807096,730.9029860496521,309.4165542125702,705.8853759765625,27760,5248,22512,22512,0,11,4583000.0
4583,4583999,21.46753628822798,38.547468731431884,0.09061590326891522,731.0984909534454,309.48317217826843,706.2404327392578,27769,5249,22520,22520,0,11,4584000.0
4584,4584999,21.47173328982277,38.55440034650956,0.09070233978161768,731.2174694538116,309.5499722957611,706.4800910949707,27771,5249,22522,22522,0,11,4585000.0
4585,4585999,21.476454848393335,38.56105451971826,0.09087008235948568,731.4604127407074,309.61634707450867,706.5725936889648,27775,5251,22524,22524,0,11,4586000.0
4586,4586999,21.478628137929782,38.56440145921491,0.09087658648625185,731.7685568332672,309.6835446357727,706.8712005615234,27803,5254,22549,22549,0,11,4587000.0
4587,4587999,21.477392164719735,38.563541488156794,0.0908707921732469,731.9176599979401,309.7596044540405,707.6158828735352,27832,5254,22578,22578,0,11,4588000.0
4588,4588999,21.476191255282476,38.56273258461779,0.0908763143402046,732.0940048694611,309.8266270160675,707.843807220459,27842,5255,22587,22587,0,11,4589000.0
4589,4589999,21.47506087218097,38.56106614866492,0.09086878765534767,732.2209177017212,309.89238595962524,708.0497703552246,27844,5255,22589,22589,0,11,4590000.0
4590,4590999,21.47379732425234,38.55892527297386,0.09086428552097403,732.3986406326294,309.95831084251404,708.1455726623535,27847,5256,22591,22591,0,11,4591000.0
4591,4591999,21.472831120414124,38.558230319601336,0.0908328558547411,732.5755228996277,310.02498388290405,708.4983291625977,27870,5257,22613,22613,0,11,4592000.0
4592,4592999,21.471815575179225,38.55723777941863,0.0908187240019378,732.7685170173645,310.09262704849243,708.6814994812012,27879,5258,22621,22621,0,11,4593000.0
4593,4593999,21.47065927109451,38.55502605437663,0.09081201567142938,732.9516639709473,310.1593472957611,708.8959732055664,27881,5259,22622,22622,0,11,4594000.0
4594,4594999,21.469599307964458,38.55292780859828,0.09080712161286375,733.1425712108612,310.2259063720703,709.0546531677246,27884,5260,22624,22624,0,11,4595000.0
4595,4595999,21.46887713584387,38.551263895549866,0.09080130963374866,733.4592227935791,310.294401884079,709.192081451416,27898,5263,22635,22635,0,11,4596000.0
4596,4596999,21.46865844203459,38.55039651228408,0.09078551677567526,733.5994808673859,310.37233448028564,709.6132888793945,27911,5263,22648,22648,0,11,4597000.0
4597,4597999,21.46847066833382,38.550298784006266,0.0907717873817111,733.7848336696625,310.4384603500366,709.8054885864258,27916,5264,22652,22652,0,11,4598000.0
4598,4598999,21.468377071807957,38.54936866358683,0.09075535079286168,734.3338060379028,310.50901198387146,709.7246246337891,27935,5270,22665,22665,0,11,4599000.0
4599,4599999,21.468476331352832,38.548957538760085,0.09074506120633519,734.4540407657623,310.5754804611206,709.9191131591797,27935,5270,22665,22665,0,11,4600000.0
4600,4600999,21.46917666279753,38.552628795570605,0.09071434590922456,734.7039859294891,310.6430559158325,709.9907302856445,27939,5272,22667,22667,0,11,4601000.0
4601,4601999,21.469554770471508,38.55356797060924,0.09070017473600267,734.8941748142242,310.7096920013428,710.1165466308594,27943,5273,22670,22670,0,11,4602000.0
4602,4602999,21.470468402680858,38.55503619054832,0.09068361433194716,735.0806012153625,310.7761628627777,710.4061164855957,27949,5274,22675,22675,0,11,4603000.0
4603,4603999,21.471130285703044,38.55641716742142,0.09066625357523672,735.3889153003693,310.8430554866791,710.518684387207,27955,5277,22678,22678,0,11,4604000.0
4604,4604999,21.47181173116379,38.55597750158283,0.09064508111448266,735.5050430297852,310.90900230407715,710.6574630737305,27955,5277,22678,22678,0,11,4605000.0
4605,4605999,21.471544859291342,38.55523016932485,0.09062345908843683,735.7837655544281,310.9841630458832,711.2829551696777,27991,5279,22712,22712,0,11,4606000.0
4606,4606999,21.470584478459827,38.55511474010044,0.0906192233345322,735.9028377532959,311.0507810115814,711.6644058227539,27997,5279,22718,22718,0,11,4607000.0
4607,4607999,21.4693262094917,38.55361962033915,0.09061407872469485,736.0211713314056,311.1165015697479,711.9186592102051,28001,5279,22722,22722,0,11,4608000.0
4608,4608999,21.468106613037204,38.5517881826462,0.09061500455746407,736.1392991542816,311.1856083869934,712.0943870544434,28002,5279,22723,22723,0,11,4609000.0
4609,4609999,21.468196493422596,38.55356938273685,0.09058545498695036,736.3250858783722,311.25257873535156,712.4184379577637,28018,5280,22738,22738,0,11,4610000.0
4610,4610999,21.468607131306335,38.55418609923801,0.09060824642673526,736.4994835853577,311.3196015357971,712.6435928344727,28025,5281,22744,22744,0,11,4611000.0
4611,4611999,21.469374792551502,38.55477060442569,0.09062118573721811,736.8122189044952,311.38663935661316,712.7574424743652,28031,5284,22747,22747,0,11,4612000.0
4612,4612999,21.470097210768152,38.557065447317925,0.09063535897504471,737.1246237754822,311.45400738716125,712.8830070495605,28038,5287,22751,22751,0,11,4613000.0
4613,4613999,21.470531664887478,38.556921801796825,0.09065042335546936,737.3717927932739,311.52113795280457,713.0447463989258,28056,5289,22767,22767,0,11,4614000.0
4614,4614999,21.471588867643337,38.558194178792675,0.09067485553109966,737.4850921630859,311.5890471935272,713.2753562927246,28060,5289,22771,22771,0,11,4615000.0
4615,4615999,21.473702198641735,38.561322469183985,0.09069863593896832,737.6035017967224,311.655357837677,713.7108116149902,28070,5289,22781,22781,0,11,4616000.0
4616,4616999,21.475648058997056,38.563791907105745,0.09073768441226371,737.8622703552246,311.72767162323,713.8474349975586,28080,5291,22789,22789,0,11,4617000.0
4617,4617999,21.47713713581904,38.565327666202265,0.09075384903569206,738.1110193729401,311.7949140071869,713.9920997619629,28084,5293,22791,22791,0,11,4618000.0
4618,4618999,21.47899159377124,38.5680124705088,0.0907771711914177,738.4291844367981,311.86258602142334,714.0612106323242,28097,5296,22801,22801,0,11,4619000.0
4619,4619999,21.48108833343758,38.571922685314014,0.09083965962710427,738.6868100166321,311.92947602272034,714.1993713378906,28115,5298,22817,22817,0,11,4620000.0
4620,4620999,21.483158769388563,38.575043821078005,0.09087607213674931,738.9354050159454,311.99649000167847,714.2921981811523,28121,5300,22821,22821,0,11,4621000.0
4621,4621999,21.485841514833115,38.57974401537021,0.09092066870264237,739.0499892234802,312.06488728523254,714.7595138549805,28131,5300,22831,22831,0,11,4622000.0
4622,4622999,21.4888701792167,38.583851661609785,0.09096390030535562,739.2921960353851,312.13094663619995,714.9232330322266,28135,5302,22833,22833,0,11,4623000.0
4623,4623999,21.491180508943227,38.58625534746543,0.09099949247041117,739.5589933395386,312.2042999267578,715.0376243591309,28139,5304,22835,22835,0,11,4624000.0
4624,4624999,21.49314786416439,38.588972362607876,0.09104379305111687,739.8309469223022,312.27791380882263,715.1482162475586,28143,5306,22837,22837,0,11,4625000.0
4625,4625999,21.493881146194905,38.58900201065365,0.09104603057572425,740.1467056274414,312.34564661979675,715.5600166320801,28168,5309,22859,22859,0,11,4626000.0
4626,4626999,21.492533493441748,38.5876621442721,0.09104972080610119,740.2644901275635,312.41166853904724,715.8662033081055,28170,5309,22861,22861,0,11,4627000.0
4627,4627999,21.4914839297768,38.58616471742527,0.09104656594194593,740.5127737522125,312.4775376319885,716.0504112243652,28181,5311,22870,22870,0,11,4628000.0
4628,4628999,21.4905950456986,38.584517728404855,0.09104666654229299,740.6927852630615,312.54330253601074,716.3004455566406,28187,5312,22875,22875,0,11,4629000.0
4629,4629999,21.490137442646024,38.58364540997959,0.09104294962010251,740.9472725391388,312.60988688468933,716.3856391906738,28196,5314,22882,22882,0,11,4630000.0
4630,4630999,21.490017674566314,38.5840938413342,0.09104205083540162,741.1442558765411,312.6753361225128,716.6255950927734,28201,5315,22886,22886,0,11,4631000.0
4631,4631999,21.490080733672283,38.58396506655294,0.09103742452557984,741.463118314743,312.7412133216858,716.656078338623,28211,5318,22893,22893,0,11,4632000.0
4632,4632999,21.48994753766795,38.58283778582251,0.09103878937819498,741.7137553691864,312.8069899082184,716.7753372192383,28215,5320,22895,22895,0,11,4633000.0
4633,4633999,21.48990196524881,38.582034108028395,0.09104648709804153,741.8954334259033,312.87363862991333,716.8945922851562,28223,5321,22902,22902,0,11,4634000.0
4634,4634999,21.49045469462221,38.58489917882084,0.09104801050927402,742.1113629341125,312.9488775730133,717.0944366455078,28236,5322,22914,22914,0,11,4635000.0
4635,4635999,21.490856606343844,38.58521264288548,0.09104732017604489,742.2224116325378,313.01396441459656,717.2416038513184,28237,5322,22915,22915,0,11,4636000.0
4636,4636999,21.492398298978156,38.58857014008694,0.09106005384633564,742.4215092658997,313.0799243450165,717.4282379150391,28241,5323,22918,22918,0,11,4637000.0
4637,4637999,21.494357683940198,38.592477277276956,0.09107923796824391,742.6130921840668,313.1473686695099,717.5850524902344,28244,5324,22920,22920,0,11,4638000.0
4638,4638999,21.49598791263692,38.59459777632256,0.09109122883879328,742.8634705543518,313.2134141921997,717.6385688781738,28248,5326,22922,22922,0,11,4639000.0
4639,4639999,21.498191265526966,38.59828521428473,0.09110214036397424,742.9909274578094,313.27862572669983,717.7837715148926,28249,5326,22923,22923,0,11,4640000.0
4640,4640999,21.50090213761167,38.60233852104559,0.0911181082396858,743.1056308746338,313.34379172325134,717.8989219665527,28249,5326,22923,22923,0,11,4641000.0
4641,4641999,21.503821292168375,38.606633903383724,0.09113260159008707,743.432487487793,313.4094989299774,717.8038597106934,28256,5329,22927,22927,0,11,4642000.0
4642,4642999,21.50743342158976,38.61324830328061,0.09115908184644228,743.6814248561859,313.47590351104736,718.0471076965332,28265,5331,22934,22934,0,11,4643000.0
4643,4643999,21.511176405493995,38.621581336328376,0.09118686710244817,743.940345287323,313.5483567714691,718.1218223571777,28271,5333,22938,22938,0,11,4644000.0
4644,4644999,21.514148253885633,38.62556334059301,0.09122027268943855,744.2005336284637,313.6144094467163,718.210262298584,28275,5335,22940,22940,0,11,4645000.0
4645,4645999,21.516526741443634,38.62766040499985,0.09125176200112317,744.3808546066284,313.68021512031555,718.3690071105957,28277,5336,22941,22941,0,11,4646000.0
4646,4646999,21.516940878054843,38.62945429489672,0.09117144751729322,744.5108609199524,313.74704098701477,718.9189872741699,28299,5336,22963,22963,0,11,4647000.0
4647,4647999,21.51558182055394,38.62879634233171,0.09116821509125228,744.698504447937,313.8129622936249,719.1382827758789,28308,5337,22971,22971,0,11,4648000.0
4648,4648999,21.51443737938236,38.62743661521821,0.09116189319764545,744.8833627700806,313.87929344177246,719.3277587890625,28320,5338,22982,22982,0,11,4649000.0
4649,4649999,21.51368855563694,38.626275860309505,0.09115476470239658,745.0055124759674,313.9457471370697,719.4805641174316,28321,5338,22983,22983,0,11,4650000.0
4650,4650999,21.512951283775184,38.6259111258826,0.09114707860177229,745.2688868045807,314.012814283371,719.533561706543,28344,5340,23004,23004,0,11,4651000.0
4651,4651999,21.51260609981561,38.624830205315824,0.09114523881876646,745.4033439159393,314.08694553375244,719.8646774291992,28349,5340,23009,23009,0,11,4652000.0
4652,4652999,21.51235141501707,38.62404142612156,0.09113553637836702,745.6024787425995,314.16224336624146,719.9839630126953,28353,5341,23012,23012,0,11,4653000.0
4653,4653999,21.511790632778734,38.6224033120829,0.09113758362949997,745.9235112667084,314.22837567329407,720.0452461242676,28365,5344,23021,23021,0,11,4654000.0
4654,4654999,21.51188256520039,38.6225472558802,0.09114157153744595,746.1097049713135,314.29450964927673,720.2120590209961,28374,5345,23029,23029,0,11,4655000.0
4655,4655999,21.512272133061096,38.62342932791988,0.09113963752469822,746.3639602661133,314.3610649108887,720.3278350830078,28386,5347,23039,23039,0,11,4656000.0
4656,4656999,21.512997971857658,38.62456012725348,0.09112660791725757,746.5480241775513,314.42787623405457,720.6272163391113,28399,5348,23051,23051,0,11,4657000.0
4657,4657999,21.514405557624542,38.62857638997969,0.09114326237480286,746.7338562011719,314.4943685531616,720.8246040344238,28401,5349,23052,23052,0,11,4658000.0
4658,4658999,21.515408235018413,38.63040040326427,0.09114194865050218,746.9831261634827,314.5598554611206,720.9131011962891,28405,5351,23054,23054,0,11,4659000.0
4659,4659999,21.51628789481921,38.63087173073771,0.09114677200975818,747.3056704998016,314.6267032623291,721.0312423706055,28411,5354,23057,23057,0,11,4660000.0
4660,4660999,21.517239950795805,38.63178258898556,0.09114862871493246,747.498428106308,314.69250988960266,721.1807670593262,28421,5355,23066,23066,0,11,4661000.0
4661,4661999,21.519155994406944,38.63434386565317,0.09117693905221247,747.6952261924744,314.76040410995483,721.3008193969727,28424,5356,23068,23068,0,11,4662000.0
4662,4662999,21.521254197591716,38.63782648437311,0.09119672360743114,747.8819975852966,314.826828956604,721.6517105102539,28437,5357,23080,23080,0,11,4663000.0
4663,4663999,21.523271230689357,38.63968906292454,0.09119502848375138,748.057293176651,314.8917348384857,721.8453407287598,28439,5358,23081,23081,0,11,4664000.0
4664,4664999,21.524985124624877,38.64023996422645,0.09120783451010506,748.4272060394287,314.9585382938385,721.9549598693848,28460,5362,23098,23098,0,11,4665000.0
4665,4665999,21.526788408679337,38.64159886257563,0.09121178016363485,748.6866538524628,315.02521538734436,722.0745162963867,28464,5364,23100,23100,0,11,4666000.0
4666,4666999,21.527634670371107,38.64136786892021,0.09119751397300746,748.8137350082397,315.0923912525177,722.4512901306152,28474,5364,23110,23110,0,11,4667000.0
4667,4667999,21.526030447126367,38.63955678619076,0.09119966246017108,748.9912543296814,315.1581904888153,722.818675994873,28484,5365,23119,23119,0,11,4668000.0
4668,4668999,21.524338904469378,38.63742377372337,0.09120197509766204,749.2431488037109,315.22375321388245,723.0048446655273,28494,5367,23127,23127,0,11,4669000.0
4669,4669999,21.522725983936137,38.63496752856718,0.09120543564240968,749.492965221405,315.2901813983917,723.2205619812012,28507,5369,23138,23138,0,11,4670000.0
4670,4670999,21.521448432328544,38.63373763171983,0.09120596246282486,749.8031976222992,315.35705375671387,723.2956962585449,28520,5372,23148,23148,0,11,4671000.0
4671,4671999,21.52011955393537,38.6313335684357,0.09120208289299458,750.1201508045197,315.42371916770935,723.7039642333984,28540,5375,23165,23165,0,11,4672000.0
4672,4672999,21.518619641701036,38.62852317451053,0.09120573518828023,750.3078095912933,315.4893343448639,723.9075660705566,28542,5376,23166,23166,0,11,4673000.0
4673,4673999,21.51771457312796,38.62773981271203,0.09120199787452465,750.4915878772736,315.55587935447693,724.079833984375,28544,5377,23167,23167,0,11,4674000.0
4674,4674999,21.516541260022095,38.62541979261049,0.09120692705241595,750.7323966026306,315.62201714515686,724.2594299316406,28559,5379,23180,23180,0,11,4675000.0
4675,4675999,21.51572147665021,38.623690914194256,0.09120614917496095,750.9098377227783,315.687801361084,724.3913955688477,28561,5380,23181,23181,0,11,4676000.0
4676,4676999,21.515004518508732,38.62232509775313,0.09120869202354542,751.041827917099,315.75378608703613,724.5873107910156,28564,5380,23184,23184,0,11,4677000.0
4677,4677999,21.514948358987926,38.62162048012045,0.09119448308880729,751.3602485656738,315.8205494880676,724.8122863769531,28579,5383,23196,23196,0,11,4678000.0
4678,4678999,21.51521438451329,38.62391134158859,0.0911863337096801,751.5420699119568,315.8864846229553,725.0103225708008,28582,5384,23198,23198,0,11,4679000.0
4679,4679999,21.515203550526177,38.62321278557192,0.09117484956187227,751.7921273708344,315.95239067077637,725.123218536377,28586,5386,23200,23200,0,11,4680000.0
4680,4680999,21.51574141374034,38.62342291708598,0.09116369567362925,752.0492377281189,316.0183506011963,725.1940498352051,28591,5388,23203,23203,0,11,4681000.0
4681,4681999,21.516590690707982,38.62426608923147,0.09115605165489804,752.2460463047028,316.08517622947693,725.3249816894531,28594,5389,23205,23205,0,11,4682000.0
4682,4682999,21.517609577629734,38.624570928080736,0.09116478046512899,752.4242749214172,316.150643825531,725.4417304992676,28597,5390,23207,23207,0,11,4683000.0
4683,4683999,21.520293324866277,38.63648069229019,0.09114906824572666,752.6223814487457,316.2171187400818,725.7277755737305,28612,5391,23221,23221,0,11,4684000.0
4684,4684999,21.521943862322548,38.63787495830813,0.09114701725959562,752.8030052185059,316.28216671943665,725.8809852600098,28614,5392,23222,23222,0,11,4685000.0
4685,4685999,21.523558227624747,38.641252337760356,0.09114242236754189,752.9905660152435,316.34744668006897,726.0349082946777,28616,5393,23223,23223,0,11,4686000.0
4686,4686999,21.525004652858755,38.642308483878224,0.09115878744531458,753.3047873973846,316.4135961532593,726.0630111694336,28623,5396,23227,23227,0,11,4687000.0
4687,4687999,21.524887958532474,38.641458931788186,0.09115140384679676,753.5108008384705,316.4807653427124,726.6348266601562,28651,5397,23254,23254,0,11,4688000.0
4688,4688999,21.523628060462244,38.640550561185385,0.09114690090618083,753.6337168216705,316.54845905303955,727.0403671264648,28659,5397,23262,23262,0,11,4689000.0
4689,4689999,21.522498428392993,38.6411799532993,0.09115058844754653,753.814414024353,316.6146023273468,727.2811279296875,28664,5398,23266,23266,0,11,4690000.0
4690,4690999,21.521497435587158,38.64009069621705,0.09114841560626075,754.0011036396027,316.68123602867126,727.5123405456543,28676,5399,23277,23277,0,11,4691000.0
4691,4691999,21.520252871041787,38.63783032587792,0.09114826359498585,754.123544216156,316.74763464927673,727.7194671630859,28678,5399,23279,23279,0,11,4692000.0
4692,4692999,21.519346761472043,38.636258429664466,0.09114446264372567,754.3662626743317,316.81422114372253,727.9819107055664,28687,5401,23286,23286,0,11,4693000.0
4693,4693999,21.518957470213245,38.635905342567845,0.09113155597344635,754.6227288246155,316.88063645362854,728.0788383483887,28696,5403,23293,23293,0,11,4694000.0
4694,4694999,21.51828947033077,38.63405722403426,0.09112869945620172,754.9409778118134,316.9473400115967,728.1571235656738,28702,5406,23296,23296,0,11,4695000.0
4695,4695999,21.51782154388489,38.63367693077019,0.09111883710882163,755.3189239501953,317.01471519470215,728.278076171875,28716,5410,23306,23306,0,11,4696000.0
4696,4696999,21.518167026751822,38.63450877462134,0.09110604090700614,755.5052635669708,317.08147644996643,728.4888305664062,28721,5411,23310,23310,0,11,4697000.0
4697,4697999,21.518592117366904,38.636541820608905,0.09110094541484026,755.6251010894775,317.1489043235779,728.6895751953125,28724,5411,23313,23313,0,11,4698000.0
4698,4698999,21.51949059069968,38.63845004740561,0.09110171814927348,755.7565104961395,317.2159056663513,729.2851409912109,28745,5411,23334,23334,0,11,4699000.0
4699,4699999,21.521266558644502,38.64353875625144,0.09111886143311498,755.9488244056702,317.2831268310547,729.508975982666,28749,5412,23337,23337,0,11,4700000.0
4700,4700999,21.523059202444614,38.64793572938525,0.09112490877124058,756.0740759372711,317.3491299152374,729.6804084777832,28749,5412,23337,23337,0,11,4701000.0
4701,4701999,21.525610370764344,38.654910138162755,0.09112882972926228,756.2640943527222,317.4156177043915,729.7727165222168,28752,5413,23339,23339,0,11,4702000.0
4702,4702999,21.528772893278152,38.66318647804026,0.09113770715460578,756.5140388011932,317.4819235801697,729.877857208252,28759,5415,23344,23344,0,11,4703000.0
4703,4703999,21.53273921572304,38.67404876935527,0.0911382403422879,756.6339752674103,317.5488181114197,730.1770172119141,28764,5415,23349,23349,0,11,4704000.0
4704,4704999,21.53721061545246,38.68457940187008,0.09114406367422367,756.8107438087463,317.61414909362793,730.3524742126465,28766,5416,23350,23350,0,11,4705000.0
4705,4705999,21.54084480970058,38.6939957885632,0.09118398405128936,757.1976101398468,317.6805844306946,730.3865585327148,28781,5420,23361,23361,0,11,4706000.0
4706,4706999,21.54547008088697,38.704348584869486,0.09122116186317042,757.515632390976,317.74727511405945,730.5145225524902,28792,5423,23369,23369,0,11,4707000.0
4707,4707999,21.547717954326988,38.70777018519865,0.09129737423129225,757.7053308486938,317.81593108177185,731.1203804016113,28820,5424,23396,23396,0,11,4708000.0
4708,4708999,21.54596863259539,38.70512936214983,0.09129137202261972,757.9038660526276,317.88213443756104,731.3935508728027,28834,5425,23409,23409,0,11,4709000.0
4709,4709999,21.54505102913415,38.70506535857238,0.09127383049810733,758.0198357105255,317.94904088974,731.6302719116211,28836,5425,23411,23411,0,11,4710000.0
4710,4710999,21.544084445710222,38.70452179960256,0.09126124308377337,758.2103667259216,318.01547050476074,731.7923126220703,28860,5426,23434,23434,0,11,4711000.0
4711,4711999,21.542989352586986,38.70318850338022,0.09125048067162134,758.3943829536438,318.0817096233368,731.880931854248,28867,5427,23440,23440,0,11,4712000.0
4712,4712999,21.542494784917984,38.70203666019288,0.09123414608336344,758.6457624435425,318.1481306552887,732.1996879577637,28880,5429,23451,23451,0,11,4713000.0
4713,4713999,21.54178287472574,38.699915687917816,0.09122655490339182,758.7723417282104,318.2146067619324,732.3947639465332,28881,5429,23452,23452,0,11,4714000.0
4714,4714999,21.54100754486265,38.698020616047174,0.09122306756333842,758.9606969356537,318.28049087524414,732.5245780944824,28883,5430,23453,23453,0,11,4715000.0
4715,4715999,21.540434743985838,38.696637248305215,0.09121308026404729,759.1445322036743,318.3466522693634,732.6329116821289,28892,5431,23461,23461,0,11,4716000.0
4716,4716999,21.539990723927875,38.696866914094635,0.09119758908685782,759.4044103622437,318.41369819641113,732.7620887756348,28900,5433,23467,23467,0,11,4717000.0
4717,4717999,21.53996680968081,38.69605432198635,0.09120438301983069,759.5265378952026,318.4812967777252,732.9393043518066,28902,5433,23469,23469,0,11,4718000.0
4718,4718999,21.540373104420986,38.696264228307015,0.09118791885671806,759.6489210128784,318.5477511882782,733.314811706543,28911,5433,23478,23478,0,11,4719000.0
4719,4719999,21.54099568535336,38.69704772514961,0.09117697614913,759.8948004245758,318.613646030426,733.4371032714844,28916,5435,23481,23481,0,11,4720000.0
4720,4720999,21.542077137568057,38.698627794287226,0.09116764718448556,760.08367395401,318.6802411079407,733.5720710754395,28919,5436,23483,23483,0,11,4721000.0
4721,4721999,21.54397142940114,38.70189878002688,0.09117230156409695,760.2015483379364,318.74595618247986,733.7354545593262,28920,5436,23484,23484,0,11,4722000.0
4722,4722999,21.54687562664223,38.707965308758524,0.09118006792311817,760.4641766548157,318.81289172172546,733.8122940063477,28924,5438,23486,23486,0,11,4723000.0
4723,4723999,21.550890871291063,38.715663385657905,0.09120640798906299,760.7824039459229,318.87924814224243,733.8519706726074,28933,5441,23492,23492,0,11,4724000.0
4724,4724999,21.554617554652822,38.72121150446508,0.09122229079493716,761.0371129512787,318.9467222690582,734.4989280700684,28963,5443,23520,23520,0,11,4725000.0
4725,4725999,21.558874144063616,38.72834461972253,0.0912444964131165,761.2229487895966,319.0126533508301,734.7130546569824,28965,5444,23521,23521,0,11,4726000.0
4726,4726999,21.563561739184752,38.73861509990883,0.09130231031163694,761.4786043167114,319.078729391098,734.7836151123047,28993,5446,23547,23547,0,11,4727000.0
4727,4727999,21.567237645608138,38.7451623110477,0.09137146579347288,761.7481684684753,319.14586091041565,734.8948822021484,28997,5448,23549,23549,0,11,4728000.0
4728,4728999,21.567892601592497,38.745556683251316,0.09139618370748526,761.9373342990875,319.21523785591125,735.6692771911621,29042,5449,23593,23593,0,11,4729000.0
4729,4729999,21.56723654824047,38.74629166020673,0.09138169446231181,762.0550045967102,319.28185415267944,736.1149559020996,29051,5449,23602,23602,0,11,4730000.0
4730,4730999,21.566914663941176,38.74666649750179,0.09135520324053759,762.1746258735657,319.34864473342896,736.4172973632812,29056,5449,23607,23607,0,11,4731000.0
4731,4731999,21.566927746604293,38.747400000912684,0.09133444851877481,762.3617584705353,319.41641306877136,736.6389198303223,29064,5450,23614,23614,0,11,4732000.0
4732,4732999,21.567157797367212,38.748517129963325,0.09130727964698626,762.4788172245026,319.4829909801483,736.9773254394531,29067,5450,23617,23617,0,11,4733000.0
4733,4733999,21.56673193019536,38.74769080185285,0.09129579606608929,762.7234089374542,319.5498082637787,737.1164970397949,29071,5452,23619,23619,0,11,4734000.0
4734,4734999,21.566376012012515,38.74745632008425,0.09128244758058601,763.0456237792969,319.6172664165497,737.2207946777344,29081,5455,23626,23626,0,11,4735000.0
4735,4735999,21.56582397628873,38.74654528803867,0.09128053014116355,763.2295327186584,319.6847951412201,737.374095916748,29084,5456,23628,23628,0,11,4736000.0
4736,4736999,21.565762627553898,38.746575186421516,0.09126599646671762,763.4865517616272,319.7523877620697,737.5109748840332,29095,5458,23637,23637,0,11,4737000.0
4737,4737999,21.56603721955726,38.74694593074959,0.0912547073631983,763.6103506088257,319.81916880607605,737.7514266967773,29097,5458,23639,23639,0,11,4738000.0
4738,4738999,21.566212280096806,38.746336882138706,0.09125221826305419,763.8086433410645,319.88910818099976,738.3230285644531,29118,5459,23659,23659,0,11,4739000.0
4739,4739999,21.566420074238906,38.74568884301855,0.09127351002025819,764.0584464073181,319.95592069625854,738.5204734802246,29123,5461,23662,23662,0,11,4740000.0
4740,4740999,21.566672506689592,38.74541605584637,0.09128024822597358,764.2421107292175,320.02327156066895,738.726863861084,29131,5462,23669,23669,0,11,4741000.0
4741,4741999,21.567394159239658,38.746185267275834,0.09131510963432143,764.838812828064,320.0922074317932,738.7325286865234,29170,5469,23701,23701,0,11,4742000.0
4742,4742999,21.568949227198217,38.7492360376936,0.0913240781968494,765.0189032554626,320.1587562561035,738.9536781311035,29192,5470,23722,23722,0,11,4743000.0
4743,4743999,21.570239470232604,38.750529696962616,0.09133757265269438,765.2005898952484,320.2255938053131,739.3640823364258,29201,5471,23730,23730,0,11,4744000.0
4744,4744999,21.571431917256792,38.75215422802042,0.0913413764138018,765.5174055099487,320.29262590408325,739.4963455200195,29211,5474,23737,23737,0,11,4745000.0
4745,4745999,21.572850982914673,38.75498272115443,0.09133935746107025,765.6395874023438,320.3585216999054,739.7342109680176,29212,5474,23738,23738,0,11,4746000.0
4746,4746999,21.57305754622132,38.757408966870365,0.09132204446136205,765.8309109210968,320.42699813842773,740.424732208252,29243,5475,23768,23768,0,11,4747000.0
4747,4747999,21.571708462950404,38.757001029456745,0.09128779411051136,766.0253808498383,320.4943370819092,740.8018035888672,29256,5476,23780,23780,0,11,4748000.0
4748,4748999,21.569808220968827,38.75419359233774,0.0913063686365776,766.138721704483,320.5613605976105,741.1004981994629,29260,5476,23784,23784,0,11,4749000.0
4749,4749999,21.568263775289587,38.75264027916951,0.09131052101624149,766.3848655223846,320.62789154052734,741.2380523681641,29270,5478,23792,23792,0,11,4750000.0
4750,4750999,21.56685864982472,38.75042336356511,0.09131239901491861,766.4994866847992,320.69550013542175,741.7290840148926,29281,5478,23803,23803,0,11,4751000.0
4751,4751999,21.565504294988997,38.748675928954974,0.0913115820902003,766.6787204742432,320.76219153404236,741.9571762084961,29283,5479,23804,23804,0,11,4752000.0
4752,4752999,21.56384533844592,38.74585747154436,0.09132094196145812,767.009948015213,320.82988452911377,742.0711402893066,29290,5482,23808,23808,0,11,4753000.0
4753,4753999,21.562317382165006,38.74352045703078,0.09132426622569123,767.3284380435944,320.89696073532104,742.193115234375,29296,5485,23811,23811,0,11,4754000.0
4754,4754999,21.560964600432893,38.74124950790307,0.09132683043498657,767.4653012752533,320.9753637313843,742.4292793273926,29299,5485,23814,23814,0,11,4755000.0
4755,4755999,21.559638721969385,38.738860682252415,0.09132568761932836,767.5840401649475,321.04253458976746,742.6426849365234,29303,5485,23818,23818,0,11,4756000.0
4756,4756999,21.559298464237667,38.73792149373409,0.09129949641990631,767.7688519954681,321.109840631485,743.0608024597168,29319,5486,23833,23833,0,11,4757000.0
4757,4757999,21.558975387356732,38.736911017780116,0.091283801484774,768.0302534103394,321.17693614959717,743.2219581604004,29323,5488,23835,23835,0,11,4758000.0
4758,4758999,21.5585160448768,38.735370813120504,0.09127456471693429,768.3552505970001,321.24378871917725,743.2864379882812,29349,5491,23858,23858,0,11,4759000.0
4759,4759999,21.559208056354738,38.73589060599009,0.09125250179150834,768.5330667495728,321.3104462623596,743.4530448913574,29354,5492,23862,23862,0,11,4760000.0
4760,4760999,21.560093222102093,38.7378420594925,0.09123246735823332,768.7863607406616,321.3772897720337,743.5682907104492,29358,5494,23864,23864,0,11,4761000.0
4761,4761999,21.56106072697049,38.73831807754099,0.09121609291470645,768.9730353355408,321.4436454772949,743.7243499755859,29360,5495,23865,23865,0,11,4762000.0
4762,4762999,21.562325145626183,38.741421996295074,0.09119141291528132,769.160472869873,321.5103302001953,744.1264343261719,29374,5496,23878,23878,0,11,4763000.0
4763,4763999,21.56308193566224,38.74192825046249,0.09118920252416363,769.4182507991791,321.5767025947571,744.2966232299805,29384,5498,23886,23886,0,11,4764000.0
4764,4764999,21.56348168684829,38.74099972193204,0.0911892838218803,769.6015701293945,321.64328145980835,744.4380073547363,29386,5499,23887,23887,0,11,4765000.0
4765,4765999,21.563791386380753,38.73990737692068,0.09118752715479073,769.8516800403595,321.7096178531647,744.5841751098633,29390,5501,23889,23889,0,11,4766000.0
4766,4766999,21.563971735223905,38.74284084621782,0.09116376563492745,770.0427420139313,321.7773241996765,745.0064125061035,29407,5502,23905,23905,0,11,4767000.0
4767,4767999,21.56229341441427,38.74033257719503,0.09116978107847751,770.1530594825745,321.84311532974243,745.3490371704102,29410,5502,23908,23908,0,11,4768000.0
4768,4768999,21.56059499104064,38.73771289858985,0.09117991658364477,770.2754909992218,321.90799260139465,745.5443572998047,29411,5502,23909,23909,0,11,4769000.0
4769,4769999,21.558926679184992,38.73521051554151,0.09118913177571786,770.4621629714966,321.9730501174927,745.6956100463867,29416,5503,23913,23913,0,11,4770000.0
4770,4770999,21.557434561588444,38.73295001500376,0.09119634425397494,770.7123818397522,322.0389356613159,745.7697563171387,29426,5505,23921,23921,0,11,4771000.0
4771,4771999,21.556280889273182,38.7305182186487,0.09119667788174224,770.8344631195068,324.63834404945374,746.1544036865234,29432,5505,23927,23927,0,11,4772000.0
4772,4772999,21.555034776957154,38.72836673173241,0.09119951928204939,771.0313930511475,324.7042484283447,746.3418731689453,29434,5506,23928,23928,0,11,4773000.0
4773,4773999,21.553939239164382,38.72603129529088,0.09120137310656473,771.2935929298401,324.7699956893921,746.4520072937012,29438,5508,23930,23930,0,11,4774000.0
4774,4774999,21.55327666951837,38.72459091389946,0.09119413154548761,771.4813606739044,324.83643531799316,746.6358680725098,29447,5509,23938,23938,0,11,4775000.0
4775,4775999,21.55214632984621,38.72249977678457,0.09119512328544421,771.6823008060455,324.9023389816284,746.7455291748047,29449,5510,23939,23939,0,11,4776000.0
4776,4776999,21.55095259972505,38.71999928968628,0.09119588724969663,771.8793070316315,324.97005462646484,746.8683128356934,29456,5511,23945,23945,0,11,4777000.0
4777,4777999,21.550261785504606,38.71827125131237,0.09119137809087596,772.1418967247009,325.03610920906067,747.0126800537109,29462,5513,23949,23949,0,11,4778000.0
4778,4778999,21.549479027480654,38.716018617565375,0.09118339201449033,772.5199525356293,325.10795283317566,747.1969261169434,29491,5516,23975,23975,0,11,4779000.0
4779,4779999,21.549008506051948,38.71479244465724,0.09117004224305691,772.7322006225586,325.1740322113037,747.3496131896973,29493,5517,23976,23976,0,11,4780000.0
4780,4780999,21.548673805093422,38.71336428007777,0.0911587838291722,772.852707862854,325.2396421432495,747.5032920837402,29494,5517,23977,23977,0,11,4781000.0
4781,4781999,21.548249648013442,38.712094551650125,0.09115087835259339,773.0518486499786,325.3058183193207,747.5580444335938,29496,5518,23978,23978,0,11,4782000.0
4782,4782999,21.548460185863807,38.7112344859214,0.09113701869936897,773.3230850696564,325.3721878528595,747.6412353515625,29506,5520,23986,23986,0,11,4783000.0
4783,4783999,21.548556923830255,38.71068733155428,0.09111736923605418,773.5286366939545,325.4390506744385,747.8650512695312,29518,5521,23997,23997,0,11,4784000.0
4784,4784999,21.549229838438357,38.71079105665334,0.09108911579082346,773.7305495738983,325.50509214401245,748.025089263916,29521,5522,23999,23999,0,11,4785000.0
4785,4785999,21.54927918216041,38.70983042025021,0.09107117557901767,773.9360768795013,325.57112407684326,748.168773651123,29523,5523,24000,24000,0,11,4786000.0
4786,4786999,21.549181034250427,38.70837500004536,0.09106250726923393,774.1365866661072,325.6371154785156,748.2638397216797,29526,5524,24002,24002,0,11,4787000.0
4787,4787999,21.549086160558122,38.71050430613557,0.09102075116562958,774.2568185329437,325.7022771835327,748.4127006530762,29529,5524,24005,24005,0,11,4788000.0
4788,4788999,21.54748851578605,38.70926672331374,0.09102444149347988,774.5241158008575,325.7698543071747,748.9441261291504,29559,5526,24033,24033,0,11,4789000.0
4789,4789999,21.545519751540258,38.706097528714096,0.09104256125705401,774.6491370201111,325.8361864089966,749.1635780334473,29562,5526,24036,24036,0,11,4790000.0
4790,4790999,21.543785760963406,38.704211695611576,0.0910540164625635,774.8424339294434,325.9027371406555,749.3180656433105,29595,5527,24068,24068,0,11,4791000.0
4791,4791999,21.542113331218495,38.70132828430498,0.09107298976578015,775.1103413105011,325.9692099094391,749.3883171081543,29600,5529,24071,24071,0,11,4792000.0
4792,4792999,21.54045311989345,38.6989258723132,0.09108325778230675,775.2399353981018,326.03742241859436,749.7438011169434,29607,5529,24078,24078,0,11,4793000.0
4793,4793999,21.538885017877877,38.69663540838608,0.09109338162598435,775.4311060905457,326.10395097732544,749.9475517272949,29616,5530,24086,24086,0,11,4794000.0
4794,4794999,21.53710454885894,38.693834452386746,0.09110635165937742,775.7010867595673,326.17082929611206,750.0623588562012,29621,5532,24089,24089,0,11,4795000.0
4795,4795999,21.535299793167276,38.690905373429686,0.0911210372174891,775.8938388824463,326.23882842063904,750.1909980773926,29624,5533,24091,24091,0,11,4796000.0
4796,4796999,21.53370929897546,38.68825437370364,0.0911290295965993,776.0895054340363,326.3054723739624,750.2893524169922,29628,5534,24094,24094,0,11,4797000.0
4797,4797999,21.532152360136305,38.68588827171995,0.09113884566463437,776.2904009819031,326.3726763725281,750.4605522155762,29640,5535,24105,24105,0,11,4798000.0
4798,4798999,21.530888378651728,38.68343845021189,0.09114209212120894,776.4896783828735,326.439728975296,750.75732421875,29649,5536,24113,24113,0,11,4799000.0
4799,4799999,21.529708979172444,38.68107185064155,0.09114181029058588,776.7601463794708,326.50598788261414,750.8714218139648,29660,5538,24122,24122,0,11,4800000.0
4800,4800999,21.528631744623667,38.67906965126678,0.09114146201676543,777.0972445011139,326.5722978115082,750.9520454406738,29686,5541,24145,24145,0,11,4801000.0
4801,4801999,21.527675431891485,38.67722087684301,0.09114370430831809,777.3592219352722,326.6391100883484,751.1016311645508,29691,5543,24148,24148,0,11,4802000.0
4802,4802999,21.527034485880613,38.67574557806954,0.09113758302178065,777.6236608028412,326.70548462867737,751.1923980712891,29699,5545,24154,24154,0,11,4803000.0
4803,4803999,21.52657039402802,38.67392629336738,0.09113596433459614,777.8418073654175,326.775199174881,751.3590774536133,29705,5546,24159,24159,0,11,4804000.0
4804,4804999,21.52600537147436,38.672043453324115,0.0911333280089528,778.0308074951172,326.8425335884094,751.7225761413574,29717,5547,24170,24170,0,11,4805000.0
4805,4805999,21.525732659932302,38.67203715983204,0.09112293874998778,778.3646676540375,326.9094476699829,751.8328552246094,29723,5550,24173,24173,0,11,4806000.0
4806,4806999,21.52492031598754,38.66976426865194,0.09112622044258067,778.557286977768,326.97811341285706,752.0343170166016,29731,5551,24180,24180,0,11,4807000.0
4807,4807999,21.52393885315178,38.66733286294713,0.09113137047237085,778.9654524326324,327.04492568969727,752.0040855407715,29741,5555,24186,24186,0,11,4808000.0
4808,4808999,21.522894344715304,38.66695748003054,0.091130751718551,779.1569399833679,327.1119906902313,752.4252052307129,29756,5556,24200,24200,0,11,4809000.0
4809,4809999,21.520707773611484,38.66461816190795,0.09114741538051219,779.3522083759308,327.17970418930054,752.6304092407227,29763,5557,24206,24206,0,11,4810000.0
4810,4810999,21.518563391758207,38.66163251698401,0.09116656717166949,779.5348494052887,327.24530053138733,752.7863540649414,29767,5558,24209,24209,0,11,4811000.0
4811,4811999,21.516907353181686,38.66070194461872,0.09117396108703191,779.730183839798,327.31095838546753,753.0550422668457,29779,5559,24220,24220,0,11,4812000.0
4812,4812999,21.51506389421689,38.65799340237485,0.09119134150793928,779.9917557239532,327.37709951400757,753.1673240661621,29783,5561,24222,24222,0,11,4813000.0
4813,4813999,21.513381941337713,38.65569051709573,0.0911979519457553,780.1902747154236,327.4438056945801,753.4869232177734,29794,5562,24232,24232,0,11,4814000.0
4814,4814999,21.51173132288566,38.65364708938347,0.09120482393438523,780.3749568462372,327.50996112823486,753.6461868286133,29801,5563,24238,24238,0,11,4815000.0
4815,4815999,21.51013929412469,38.651051266556166,0.09121533875396048,780.6520292758942,327.5764060020447,753.7066993713379,29810,5565,24245,24245,0,11,4816000.0
4816,4816999,21.508509197343887,38.648489073854925,0.09122221135137809,780.9799904823303,327.6432206630707,753.7591705322266,29827,5568,24259,24259,0,11,4817000.0
4817,4817999,21.50699064140454,38.64616693087313,0.0912299885519976,781.1753072738647,327.7117395401001,753.954906463623,29831,5569,24262,24262,0,11,4818000.0
4818,4818999,21.505828510331717,38.644330070827635,0.09122734733407112,781.3709454536438,327.77801847457886,754.0912628173828,29840,5570,24270,24270,0,11,4819000.0
4819,4819999,21.505376338520108,38.643254588660035,0.09120895993948153,781.8441104888916,327.8455412387848,754.2019386291504,29865,5575,24290,24290,0,11,4820000.0
4820,4820999,21.506593177648845,38.64529228917786,0.09118399476425687,782.0369284152985,327.9116630554199,754.3999328613281,29867,5576,24291,24291,0,11,4821000.0
4821,4821999,21.50834153800541,38.64734858783555,0.09117772666760215,782.2246515750885,327.9777853488922,754.5717620849609,29870,5577,24293,24293,0,11,4822000.0
4822,4822999,21.51070049953784,38.65089217107921,0.09116519385822797,782.4277551174164,328.04456543922424,754.6446571350098,29873,5578,24295,24295,0,11,4823000.0
4823,4823999,21.51300935966413,38.65356262244409,0.09116130202702866,782.6928491592407,328.111136674881,754.7496566772461,29883,5580,24303,24303,0,11,4824000.0
4824,4824999,21.51552553721696,38.65654178230464,0.09116233820562203,782.8216269016266,328.1823978424072,754.9343719482422,29884,5580,24304,24304,0,11,4825000.0
4825,4825999,21.517738969543593,38.658436004472755,0.09116401117013984,783.024275302887,328.25005173683167,755.1786804199219,29896,5581,24315,24315,0,11,4826000.0
4826,4826999,21.519830618095014,38.66020651617837,0.09119552601682634,783.4271037578583,328.3166666030884,755.3137969970703,29917,5585,24332,24332,0,11,4827000.0
4827,4827999,21.5213872667647,38.6623635084698,0.09121159967176096,783.5481016635895,328.3821837902069,755.5267715454102,29917,5585,24332,24332,0,11,4828000.0
4828,4828999,21.522315917329518,38.662207096735926,0.09124038489394048,783.8704895973206,328.4496967792511,755.6238632202148,29927,5588,24339,24339,0,11,4829000.0
4829,4829999,21.521717579854027,38.66080917786529,0.09124213928527547,784.1297109127045,328.5175549983978,756.2611427307129,29958,5590,24368,24368,0,11,4830000.0
4830,4830999,21.51985647817973,38.6580016733977,0.09125252354651459,784.2447376251221,328.58531308174133,756.5940170288086,29964,5590,24374,24374,0,11,4831000.0
4831,4831999,21.518052369734388,38.655389679843765,0.09126054797123895,784.433797121048,328.65146136283875,756.7881660461426,29974,5591,24383,24383,0,11,4832000.0
4832,4832999,21.51653249260618,38.653062813194154,0.09126566509288325,784.7599349021912,328.7185027599335,756.9000129699707,29989,5594,24395,24395,0,11,4833000.0
4833,4833999,21.515227805161842,38.651684798723494,0.09126291431696631,784.9463374614716,328.7861304283142,757.073371887207,29995,5595,24400,24400,0,11,4834000.0
4834,4834999,21.51372710338567,38.64938463279021,0.09126546432586258,785.138747215271,328.8522615432739,757.4190864562988,30002,5596,24406,24406,0,11,4835000.0
4835,4835999,21.51233306682195,38.646980381613446,0.09126853906735732,785.4695327281952,328.9190242290497,757.7316246032715,30067,5599,24468,24468,0,11,4836000.0
4836,4836999,21.51092285919703,38.64476056191884,0.09127120981630199,785.7284879684448,328.985714673996,758.2897758483887,30071,5601,24470,24470,0,11,4837000.0
4837,4837999,21.509740153224993,38.64269092132066,0.0912714071698768,786.1230635643005,329.0534484386444,758.5533332824707,30085,5605,24480,24480,0,11,4838000.0
4838,4838999,21.50842234787549,38.640002531110056,0.091275705674142,786.3165526390076,329.1207845211029,758.867431640625,30090,5606,24484,24484,0,11,4839000.0
4839,4839999,21.507331074647148,38.6381790154849,0.09129313111098447,786.5066440105438,329.18862414360046,759.0842170715332,30097,5607,24490,24490,0,11,4840000.0
4840,4840999,21.50666706307796,38.63638100420892,0.0912835088718037,786.6941668987274,329.2561385631561,759.6502952575684,30121,5608,24513,24513,0,11,4841000.0
4841,4841999,21.50679187035773,38.637601620913756,0.09128460211692746,786.8793499469757,329.3232202529907,759.8755035400391,30124,5609,24515,24515,0,11,4842000.0
4842,4842999,21.50759425865884,38.639241243305186,0.0913070447826313,787.1339809894562,329.3898174762726,760.0576210021973,30135,5611,24524,24524,0,11,4843000.0
4843,4843999,21.50882252653809,38.64078782820692,0.0913407992160229,787.5379526615143,329.45791268348694,760.105396270752,30155,5615,24540,24540,0,11,4844000.0
4844,4844999,21.51063771003713,38.6432586467588,0.09137058793664654,787.8635051250458,329.525066614151,760.2259864807129,30185,5618,24567,24567,0,11,4845000.0
4845,4845999,21.5136543554269,38.652382893014604,0.09138889179425602,787.9872491359711,329.5913608074188,760.4216575622559,30185,5618,24567,24567,0,11,4846000.0
4846,4846999,21.515963799462174,38.654953635059684,0.09143712649065705,788.1032247543335,329.65765023231506,760.7939300537109,30191,5618,24573,24573,0,11,4847000.0
4847,4847999,21.518098978635297,38.65689422483703,0.09147206404821562,788.4903118610382,329.7238793373108,760.8215980529785,30199,5622,24577,24577,0,11,4848000.0
4848,4848999,21.52022344090583,38.65829202571429,0.09155454338926272,788.8206584453583,329.7903597354889,760.9121551513672,30206,5625,24581,24581,0,11,4849000.0
4849,4849999,21.521307394442328,38.65948925355532,0.09161330154747227,789.0065004825592,329.85646200180054,761.078067779541,30208,5626,24582,24582,0,11,4850000.0
4850,4850999,21.521037167449922,38.659060062124745,0.09162887690137833,789.2025713920593,329.92507004737854,761.7036170959473,30242,5627,24615,24615,0,11,4851000.0
4851,4851999,21.519391245338074,38.65678874871386,0.09163628037001004,789.3288140296936,329.99112939834595,761.9417762756348,30246,5627,24619,24619,0,11,4852000.0
4852,4852999,21.517804249917596,38.654762259841704,0.09164028159751081,789.4421231746674,330.0569360256195,762.1363143920898,30248,5627,24621,24621,0,11,4853000.0
4853,4853999,21.516419790289287,38.65365559182918,0.09163828442445243,789.5616369247437,330.12261295318604,762.2927360534668,30249,5627,24622,24622,0,11,4854000.0
4854,4854999,21.51482528897878,38.65158357926587,0.09164627366036959,789.6797106266022,330.1879036426544,762.3855514526367,30249,5627,24622,24622,0,11,4855000.0
4855,4855999,21.513488505519646,38.64960131891943,0.09164652883584579,790.0265429019928,330.2546546459198,762.5313949584961,30263,5630,24633,24633,0,11,4856000.0
4856,4856999,21.51216952393234,38.647288089058186,0.09164706009030021,790.1427018642426,330.3198001384735,762.6860771179199,30264,5630,24634,24634,0,11,4857000.0
4857,4857999,21.51097780996193,38.64591620507798,0.09164408810251023,790.4082653522491,330.38563323020935,762.7680587768555,30275,5632,24643,24643,0,11,4858000.0
4858,4858999,21.509755975940287,38.64420832874024,0.09164090758138665,790.5971217155457,330.45159125328064,762.8548736572266,30278,5633,24645,24645,0,11,4859000.0
4859,4859999,21.508459071550604,38.641696325626526,0.09164451438819088,790.8033268451691,330.5183856487274,762.9904556274414,30282,5634,24648,24648,0,11,4860000.0
4860,4860999,21.507751648599815,38.64060944245394,0.09164075299652763,790.9296536445618,330.5849130153656,763.1285858154297,30283,5634,24649,24649,0,11,4861000.0
4861,4861999,21.50712547006372,38.6393573452157,0.09163119344428694,791.0703783035278,330.65108013153076,763.3880805969238,30288,5634,24654,24654,0,11,4862000.0
4862,4862999,21.507102045201723,38.63913361680064,0.09162534635682407,791.1852495670319,330.7164361476898,763.5473022460938,30289,5634,24655,24655,0,11,4863000.0
4863,4863999,21.507024981989904,38.63859234015596,0.09161833039128497,791.3123826980591,330.7814950942993,763.6644439697266,30289,5634,24655,24655,0,11,4864000.0
4864,4864999,21.507318806270643,38.63822202088099,0.09161761554057135,791.4317240715027,330.8463685512543,763.7477188110352,30289,5634,24655,24655,0,11,4865000.0
4865,4865999,21.508261180639398,38.63923711289892,0.09162626695107501,791.7613677978516,330.91268706321716,763.724723815918,30296,5637,24659,24659,0,11,4866000.0
4866,4866999,21.50942560572382,38.64013552887478,0.09162792439149892,792.0297131538391,330.97931122779846,763.8722915649414,30313,5639,24674,24674,0,11,4867000.0
4867,4867999,21.51092850857614,38.64163294407928,0.09162451532179705,792.2292151451111,331.04657196998596,764.4587669372559,30338,5640,24698,24698,0,11,4868000.0
4868,4868999,21.512358836514505,38.64270145465209,0.0916325826253338,792.4858269691467,331.11266899108887,764.6175804138184,30343,5642,24701,24701,0,11,4869000.0
4869,4869999,21.513555389492275,38.643284556006776,0.09164528857526189,792.6120498180389,331.1789755821228,764.8338661193848,30344,5642,24702,24702,0,11,4870000.0
4870,4870999,21.5145746022172,38.64329181825313,0.09165948115742428,792.7979643344879,331.24521565437317,764.9798164367676,30347,5643,24704,24704,0,11,4871000.0
4871,4871999,21.51450983254443,38.64218656828887,0.09167303886054179,792.9171152114868,331.3128478527069,765.6620597839355,30378,5643,24735,24735,0,11,4872000.0
4872,4872999,21.51331552568219,38.64045299288226,0.09167147181652224,793.1100704669952,331.38189029693604,766.5125503540039,30419,5644,24775,24775,0,11,4873000.0
4873,4873999,21.5120356728616,38.64147933285616,0.09166176460927966,793.2274396419525,331.4482147693634,766.9175643920898,30427,5644,24783,24783,0,11,4874000.0
4874,4874999,21.511066156616717,38.64219166182182,0.09165368657911865,793.3530175685883,331.5158734321594,767.2412986755371,30434,5644,24790,24790,0,11,4875000.0
4875,4875999,21.509866414822287,38.64688881780052,0.09164371130844218,793.5432987213135,331.5826017856598,767.5698738098145,30447,5645,24802,24802,0,11,4876000.0
4876,4876999,21.50907844848166,38.64754019945403,0.09160368901863625,793.8027820587158,331.6500549316406,767.7409400939941,30456,5647,24809,24809,0,11,4877000.0
4877,4877999,21.507524352184834,38.644574356777184,0.09160990776835065,793.9960248470306,331.7196788787842,767.9776573181152,30459,5648,24811,24811,0,11,4878000.0
4878,4878999,21.506009847644275,38.64187229959471,0.09162131740081769,794.255833864212,331.7864489555359,768.087818145752,30464,5650,24814,24814,0,11,4879000.0
4879,4879999,21.50465984171154,38.63936473113108,0.0916180302308578,794.5215640068054,331.854355096817,768.2369155883789,30473,5652,24821,24821,0,11,4880000.0
4880,4880999,21.503400399422695,38.6369516973693,0.09161901606324141,794.6477701663971,331.92123770713806,768.4501876831055,30476,5652,24824,24824,0,11,4881000.0
4881,4881999,21.50263829437509,38.63727657614156,0.09160169611692148,794.8427274227142,331.98865962028503,768.9663314819336,30498,5653,24845,24845,0,11,4882000.0
4882,4882999,21.501771885548678,38.63511693125499,0.09160018795845248,795.1125702857971,332.05599451065063,769.2047958374023,30525,5655,24870,24870,0,11,4883000.0
4883,4883999,21.500938665031207,38.63370431544315,0.09159691327053965,795.2376346588135,332.12940430641174,769.4108772277832,30527,5655,24872,24872,0,11,4884000.0
4884,4884999,21.500134134174715,38.631990200835425,0.09159873778030658,795.4248101711273,332.1961545944214,769.5869140625,30530,5656,24874,24874,0,11,4885000.0
4885,4885999,21.499503211445038,38.63001347855868,0.09160182496891511,795.6178019046783,332.26294231414795,769.701416015625,30533,5657,24876,24876,0,11,4886000.0
4886,4886999,21.49909182176715,38.62839981480838,0.09158990595054439,795.8085770606995,332.3303120136261,770.1232681274414,30546,5658,24888,24888,0,11,4887000.0
4887,4887999,21.498390116348347,38.62626314218427,0.09159024419475237,796.2156744003296,332.39786672592163,770.2128257751465,30575,5662,24913,24913,0,11,4888000.0
4888,4888999,21.497957355655323,38.62539067637693,0.09157579123050719,796.3407597541809,332.4656808376312,770.8157577514648,30603,5662,24941,24941,0,11,4889000.0
4889,4889999,21.497354610056064,38.62737889482546,0.09151253865323683,796.4622700214386,332.53247714042664,771.2938117980957,30611,5662,24949,24949,0,11,4890000.0
4890,4890999,21.496154264967565,38.6258531129313,0.09152972602131293,796.5799539089203,332.5990755558014,771.6944694519043,30618,5662,24956,24956,0,11,4891000.0
4891,4891999,21.49482290541048,38.62427320782289,0.09155154894439588,796.7013218402863,332.6658835411072,772.0851669311523,30627,5662,24965,24965,0,11,4892000.0
4892,4892999,21.493191909178492,38.62138382466622,0.09158020344173656,796.8823883533478,332.73197197914124,772.3200492858887,30630,5663,24967,24967,0,11,4893000.0
4893,4893999,21.491451060262463,38.61826015102673,0.09160666148874119,797.0088443756104,332.80331325531006,772.5194091796875,30630,5663,24967,24967,0,11,4894000.0
4894,4894999,21.489842915253128,38.61574215531144,0.09162736378581504,797.2709155082703,332.8698456287384,772.6279640197754,30640,5665,24975,24975,0,11,4895000.0
4895,4895999,21.488179603989476,38.61332581439933,0.09164897734874211,797.5265033245087,332.93622946739197,772.7944717407227,30649,5667,24982,24982,0,11,4896000.0
4896,4896999,21.48670342785617,38.61094195992443,0.09166696723993806,797.6532642841339,333.0024325847626,773.0006446838379,30651,5667,24984,24984,0,11,4897000.0
4897,4897999,21.485500924666567,38.608989678233385,0.09167696982288331,797.9153344631195,333.06947588920593,773.3507232666016,30665,5669,24996,24996,0,11,4898000.0
4898,4898999,21.484397168316246,38.6067420801012,0.0916850715782348,798.1116917133331,333.13597083091736,773.5552597045898,30668,5670,24998,24998,0,11,4899000.0
4899,4899999,21.48319973313252,38.604182510589744,0.09170226937830006,798.3653240203857,333.20279145240784,773.6509246826172,30673,5672,25001,25001,0,11,4900000.0
4900,4900999,21.482212394047874,38.601958597877115,0.09171336025961718,798.4818034172058,333.2696785926819,773.8109169006348,30673,5672,25001,25001,0,11,4901000.0
4901,4901999,21.481318120401312,38.599878979222154,0.09173639843192216,798.6663463115692,333.3357563018799,773.9670867919922,30681,5673,25008,25008,0,11,4902000.0
4902,4902999,21.48043689911161,38.597625796312784,0.09174797116183664,798.8495700359344,333.40200996398926,774.3302383422852,30691,5674,25017,25017,0,11,4903000.0
4903,4903999,21.479180418196698,38.59501742186249,0.09176579715512412,799.037757396698,333.46822452545166,774.4831352233887,30693,5675,25018,25018,0,11,4904000.0
4904,4904999,21.478380061054324,38.593276505143876,0.09177584224334356,799.227706193924,333.53384041786194,774.5872192382812,30695,5676,25019,25019,0,11,4905000.0
4905,4905999,21.47705719691242,38.59132841138977,0.09179247417821468,799.4931082725525,333.6009511947632,774.9817085266113,30711,5678,25033,25033,0,11,4906000.0
4906,4906999,21.475145994810138,38.58879133621091,0.09181405547273513,799.6093828678131,333.6670515537262,775.2425498962402,30714,5678,25036,25036,0,11,4907000.0
4907,4907999,21.473812074408208,38.58928190361532,0.09182197144977966,799.7247951030731,333.73199701309204,775.4448013305664,30716,5678,25038,25038,0,11,4908000.0
4908,4908999,21.47232813399294,38.58745340869168,0.09184053260741176,799.9183347225189,333.7973370552063,775.563045501709,30720,5679,25041,25041,0,11,4909000.0
4909,4909999,21.470595708772166,38.58467181718852,0.09186527358107288,800.1144061088562,333.86272835731506,775.900089263916,30729,5680,25049,25049,0,11,4910000.0
4910,4910999,21.468779817071955,38.582107594933284,0.09188703718403768,800.3076648712158,333.9284179210663,776.030933380127,30731,5681,25050,25050,0,11,4911000.0
4911,4911999,21.467073522261767,38.57989884770846,0.09189975630585967,800.6432089805603,333.994188785553,776.0237159729004,30738,5684,25054,25054,0,11,4912000.0
4912,4912999,21.465455562805758,38.578119866911095,0.09190823053579644,800.9096095561981,334.06016778945923,776.2079849243164,30744,5686,25058,25058,0,11,4913000.0
4913,4913999,21.46408216363431,38.576854278716894,0.09191215277327736,801.166009426117,334.1257095336914,776.3468856811523,30758,5688,25070,25070,0,11,4914000.0
4914,4914999,21.4630612914537,38.575790201351396,0.09191705993085997,801.3680565357208,334.1919569969177,776.5625991821289,30769,5689,25080,25080,0,11,4915000.0
4915,4915999,21.462321832993872,38.5745172541316,0.09191066653102353,801.4917204380035,334.257426738739,776.8876762390137,30773,5689,25084,25084,0,11,4916000.0
4916,4916999,21.462115702218142,38.573925666646176,0.0918944929493627,801.7465405464172,334.3233916759491,777.0193939208984,30780,5691,25089,25089,0,11,4917000.0
4917,4917999,21.46177348007317,38.57303203016236,0.0918839856444611,802.0958156585693,334.3891668319702,776.9962768554688,30789,5694,25095,25095,0,11,4918000.0
4918,4918999,21.46184208283766,38.57274499671283,0.09188182224002706,802.2811441421509,334.45500802993774,777.2369422912598,30792,5695,25097,25097,0,11,4919000.0
4919,4919999,21.461718754066865,38.57155224906405,0.09186981753975476,802.3939383029938,334.5201082229614,777.4069747924805,30792,5695,25097,25097,0,11,4920000.0
4920,4920999,21.46206963268324,38.57272165244942,0.09185255759152033,802.5835690498352,334.5852494239807,777.6061248779297,30802,5696,25106,25106,0,11,4921000.0
4921,4921999,21.462181225949465,38.57216117718057,0.09183615096000497,802.7705528736115,334.65254759788513,777.9217987060547,30808,5697,25111,25111,0,11,4922000.0
4922,4922999,21.46227446987918,38.571244468262805,0.09182443048516675,803.0273792743683,334.7178008556366,778.0827178955078,30812,5699,25113,25113,0,11,4923000.0
4923,4923999,21.461961796735274,38.56974000274678,0.09181639172892542,803.1520237922668,334.7826817035675,778.2881546020508,30813,5699,25114,25114,0,11,4924000.0
4924,4924999,21.46214507932082,38.56896249231063,0.09180222225985801,803.2750322818756,334.8474495410919,778.4205665588379,30814,5699,25115,25115,0,11,4925000.0
4925,4925999,21.46099837833766,38.56657504917853,0.0918030521670421,803.5460824966431,334.9146864414215,778.9910621643066,30853,5701,25152,25152,0,11,4926000.0
4926,4926999,21.45919491768039,38.564738848517905,0.0918121756645921,803.6595075130463,334.9809205532074,779.3672485351562,30859,5701,25158,25158,0,11,4927000.0
4927,4927999,21.456973258381336,38.56155124004972,0.09183160430972204,803.7755844593048,335.0465626716614,779.6309432983398,30862,5701,25161,25161,0,11,4928000.0
4928,4928999,21.455022007012634,38.559128102342775,0.09184220761492823,803.9672615528107,335.11290168762207,779.8534164428711,30868,5702,25166,25166,0,11,4929000.0
4929,4929999,21.453146828859047,38.55629494568648,0.09185939297172907,804.1612606048584,335.179025888443,779.9709281921387,30870,5703,25167,25167,0,11,4930000.0
4930,4930999,21.45125074551681,38.553331867038395,0.09187253973685272,804.3445234298706,335.2449173927307,780.3003234863281,30878,5704,25174,25174,0,11,4931000.0
4931,4931999,21.44977700044456,38.551174465266875,0.09187687293925062,804.5392830371857,335.3105499744415,780.5173492431641,30883,5705,25178,25178,0,11,4932000.0
4932,4932999,21.448235238430065,38.54864702784774,0.09188442304069278,804.8076870441437,335.3763246536255,780.6117095947266,30887,5707,25180,25180,0,11,4933000.0
4933,4933999,21.44666089186179,38.54633009719884,0.09189144298470653,804.9239656925201,335.4416992664337,780.8237495422363,30889,5707,25182,25182,0,11,4934000.0
4934,4934999,21.445338795274807,38.544256660632094,0.09189319202924373,805.1195406913757,335.5074734687805,780.933895111084,30898,5708,25190,25190,0,11,4935000.0
4935,4935999,21.444103701415283,38.54207002057362,0.09189765373469538,805.3089163303375,335.5735673904419,781.1013641357422,30909,5709,25200,25200,0,11,4936000.0
4936,4936999,21.442851461210616,38.53996581069241,0.09189875017573645,805.5731599330902,335.6399416923523,781.4565200805664,30923,5711,25212,25212,0,11,4937000.0
4937,4937999,21.441922823016967,38.53784961010264,0.09189973442454946,805.8975670337677,335.70521783828735,781.5819053649902,30938,5714,25224,25224,0,11,4938000.0
4938,4938999,21.441009524154275,38.53620375998409,0.09189594813134327,806.3790724277496,335.7713952064514,781.6027984619141,30957,5719,25238,25238,0,11,4939000.0
4939,4939999,21.44042903108041,38.53442396972073,0.0918958918483549,806.7160358428955,335.83739161491394,781.7820701599121,30985,5722,25263,25263,0,11,4940000.0
4940,4940999,21.43961708415302,38.53263322757338,0.09189492768694985,806.9065997600555,335.9029040336609,781.9622230529785,30988,5723,25265,25265,0,11,4941000.0
4941,4941999,21.43888937127177,38.53089429969855,0.09189437561218383,807.019909620285,335.9680109024048,782.1517295837402,30990,5723,25267,25267,0,11,4942000.0
4942,4942999,21.438371755855275,38.52899355452217,0.09189056756497571,807.1411046981812,336.0344841480255,782.6751289367676,31005,5723,25282,25282,0,11,4943000.0
4943,4943999,21.438070030349262,38.5277708892934,0.09188742447270604,807.4149303436279,336.10096406936646,782.8661193847656,31010,5725,25285,25285,0,11,4944000.0
4944,4944999,21.43751253275643,38.52659987093759,0.091883988457104,807.5964152812958,336.1663053035736,783.0664558410645,31012,5726,25286,25286,0,11,4945000.0
4945,4945999,21.436854986052325,38.52465284796379,0.09188522708210856,807.8597016334534,336.23182344436646,783.1699600219727,31016,5728,25288,25288,0,11,4946000.0
4946,4946999,21.435458929526064,38.523127892557255,0.0918883810829404,808.1153602600098,336.2983021736145,783.525074005127,31038,5730,25308,25308,0,11,4947000.0
4947,4947999,21.434137577255207,38.52161182835586,0.09189228583694886,808.2293288707733,336.36279916763306,783.7592086791992,31039,5730,25309,25309,0,11,4948000.0
4948,4948999,21.432517414792482,38.519220666426854,0.09189873107582791,808.4229719638824,336.4299285411835,783.9607391357422,31047,5731,25316,25316,0,11,4949000.0
4949,4949999,21.43107065025792,38.51687955209846,0.09190834465053022,808.6874194145203,336.4957273006439,784.1163139343262,31054,5733,25321,25321,0,11,4950000.0
4950,4950999,21.429837032332163,38.5149256409188,0.0919108325354141,808.8936367034912,336.56100940704346,784.2129974365234,31057,5734,25323,25323,0,11,4951000.0
4951,4951999,21.42843314537845,38.51231207250696,0.09191707946695682,809.0851628780365,336.62683367729187,784.4670753479004,31064,5735,25329,25329,0,11,4952000.0
4952,4952999,21.427360808473065,38.510219649980776,0.0919240946869675,809.3539636135101,336.69303011894226,784.5579566955566,31068,5737,25331,25331,0,11,4953000.0
4953,4953999,21.42622653686296,38.50795741089517,0.09192562820250993,809.5382132530212,336.75794434547424,784.6910514831543,31070,5738,25332,25332,0,11,4954000.0
4954,4954999,21.425566678913437,38.51228634973468,0.09190117090982486,809.8787291049957,336.82395339012146,784.7654724121094,31080,5741,25339,25339,0,11,4955000.0
4955,4955999,21.424447053860604,38.51020624416684,0.0918933509720794,809.9931168556213,336.8890018463135,784.9574699401855,31081,5741,25340,25340,0,11,4956000.0
4956,4956999,21.423506097939836,38.50854711412966,0.09188980539104297,810.1877391338348,336.95590329170227,785.1191520690918,31087,5742,25345,25345,0,11,4957000.0
4957,4957999,21.422492376236878,38.506446334597456,0.09188509940071954,810.3842861652374,337.02124977111816,785.4401664733887,31096,5743,25353,25353,0,11,4958000.0
4958,4958999,21.421525811519952,38.50422278747191,0.09188155961969158,810.5010032653809,337.08569979667664,785.643253326416,31096,5743,25353,25353,0,11,4959000.0
4959,4959999,21.420549972706677,38.50229855866395,0.09187579818054392,810.7606270313263,337.15180921554565,785.7420082092285,31100,5745,25355,25355,0,11,4960000.0
4960,4960999,21.41961755982607,38.50006324714347,0.09187217355289079,811.0379130840302,337.21737360954285,785.9206771850586,31112,5747,25365,25365,0,11,4961000.0
4961,4961999,21.41902470433354,38.49804850534541,0.09186578935323164,811.154034614563,337.28252363204956,786.138111114502,31114,5747,25367,25367,0,11,4962000.0
4962,4962999,21.418611114239827,38.496240091964005,0.09185784167394884,811.2849364280701,337.3484888076782,786.4425582885742,31122,5747,25375,25375,0,11,4963000.0
4963,4963999,21.41857230560759,38.49515501365078,0.09184200716894719,811.47793841362,337.4134120941162,786.6738739013672,31128,5748,25380,25380,0,11,4964000.0
4964,4964999,21.41807119199294,38.49333030608313,0.09183720234510928,811.7379686832428,337.47865056991577,786.8090934753418,31132,5750,25382,25382,0,11,4965000.0
4965,4965999,21.417258412024896,38.49106709919797,0.09183284480321807,811.9289720058441,337.5444583892822,786.9255905151367,31134,5751,25383,25383,0,11,4966000.0
4966,4966999,21.41618236463663,38.48873209807609,0.09182994415514512,812.054737329483,337.6093215942383,787.0989685058594,31134,5751,25383,25383,0,11,4967000.0
4967,4967999,21.415016800637108,38.48865115237207,0.09179384383804412,812.2516493797302,337.6771631240845,787.7111473083496,31164,5752,25412,25412,0,11,4968000.0
4968,4968999,21.41304535052051,38.486665784231356,0.09181757414619529,812.3739199638367,337.7439696788788,788.0181465148926,31171,5752,25419,25419,0,11,4969000.0
4969,4969999,21.410929769209332,38.48369337486354,0.0918354948049328,812.5680847167969,337.80973958969116,788.245532989502,31193,5753,25440,25440,0,11,4970000.0
4970,4970999,21.40889775343318,38.480460574528614,0.09186129871399196,812.6889898777008,337.8801620006561,788.4396820068359,31196,5753,25443,25443,0,11,4971000.0
4971,4971999,21.406987318446618,38.47771607102627,0.09187774996310971,813.030294418335,337.94735383987427,788.7466087341309,31220,5756,25464,25464,0,11,4972000.0
4972,4972999,21.405262817383036,38.474996783842194,0.09189294229090672,813.2873888015747,338.0133237838745,789.0065269470215,31225,5758,25467,25467,0,11,4973000.0
4973,4973999,21.40352762207657,38.47242056589744,0.0919047073185455,813.4757747650146,338.0791435241699,789.2111129760742,31228,5759,25469,25469,0,11,4974000.0
4974,4974999,21.401760880795354,38.46945949794165,0.09191498212167803,813.8901743888855,338.14594531059265,789.2555046081543,31236,5763,25473,25473,0,11,4975000.0
4975,4975999,21.400008388250026,38.46675161388329,0.09192645157523405,814.0043601989746,338.21175169944763,789.4502105712891,31237,5763,25474,25474,0,11,4976000.0
4976,4976999,21.39838655037913,38.46452473977315,0.09193316962902176,814.1929955482483,338.27800607681274,789.650993347168,31243,5764,25479,25479,0,11,4977000.0
4977,4977999,21.39714844865961,38.46231218553853,0.09193223121703453,814.3180022239685,338.344886302948,790.1954460144043,31265,5764,25501,25501,0,11,4978000.0
4978,4978999,21.39576472528429,38.45966330820058,0.09193492578292084,814.7389714717865,338.4124364852905,790.4534301757812,31289,5768,25521,25521,0,11,4979000.0
4979,4979999,21.394665465048014,38.45754980912563,0.09193063884689578,814.8609220981598,338.4781320095062,790.6608276367188,31289,5768,25521,25521,0,11,4980000.0
4980,4980999,21.39363118823822,38.455884160425875,0.09192991313312338,815.1225624084473,338.5452969074249,790.7479400634766,31293,5770,25523,25523,0,11,4981000.0
4981,4981999,21.393239202887496,38.45552348994026,0.09192341188200126,815.3154292106628,338.6118218898773,790.9216041564941,31296,5771,25525,25525,0,11,4982000.0
4982,4982999,21.39280567895135,38.45453148205161,0.09192492188569701,815.4317178726196,338.6774654388428,791.0887832641602,31296,5771,25525,25525,0,11,4983000.0
4983,4983999,21.393176905562022,38.454795034696346,0.09191644242684738,815.5491919517517,338.74342012405396,791.4209823608398,31303,5771,25532,25532,0,11,4984000.0
4984,4984999,21.39373695444971,38.454849472149014,0.09191404319602403,815.8099277019501,338.8086585998535,791.4893455505371,31308,5773,25535,25535,0,11,4985000.0
4985,4985999,21.394058224342416,38.454169403571285,0.09191499809765491,816.145229101181,338.8753776550293,791.6383323669434,31315,5776,25539,25539,0,11,4986000.0
4986,4986999,21.394188386823625,38.45324807695388,0.09192933211804755,816.4875886440277,338.9414710998535,791.6624374389648,31338,5779,25559,25559,0,11,4987000.0
4987,4987999,21.39400648036468,38.452814242741965,0.09192476448927733,816.7709407806396,339.00773215293884,791.8451843261719,31344,5781,25563,25563,0,11,4988000.0
4988,4988999,21.392445077595962,38.45080673909189,0.09193264914312138,816.9000084400177,339.07735228538513,792.638011932373,31377,5781,25596,25596,0,11,4989000.0
4989,4989999,21.3905344661259,38.447716402185705,0.09194605106178322,817.0141446590424,339.1435317993164,792.896858215332,31380,5781,25599,25599,0,11,4990000.0
4990,4990999,21.388913144800537,38.446075309912224,0.09195069993013005,817.1295368671417,339.2092981338501,793.125244140625,31383,5781,25602,25602,0,11,4991000.0
4991,4991999,21.387434397513143,38.44339961144383,0.09196377502273145,817.2480084896088,339.2749192714691,793.2971458435059,31384,5781,25603,25603,0,11,4992000.0
4992,4992999,21.386105088057384,38.441320102516706,0.09196647672908276,817.5114977359772,339.34160447120667,793.5024147033691,31392,5783,25609,25609,0,11,4993000.0
4993,4993999,21.385261597842536,38.43970287665574,0.0919664680459269,817.7805829048157,339.40790605545044,793.7189521789551,31398,5785,25613,25613,0,11,4994000.0
4994,4994999,21.384562890843096,38.438027671689554,0.09196681261426642,817.9676795005798,339.47350788116455,793.8625030517578,31401,5786,25615,25615,0,11,4995000.0
4995,4995999,21.38367670605174,38.43650246041091,0.09196970820471939,818.0891580581665,339.53902435302734,793.9837112426758,31401,5786,25615,25615,0,11,4996000.0
4996,4996999,21.383144432288823,38.43518848290605,0.09197081686911412,818.2828917503357,339.60497784614563,794.0890235900879,31405,5787,25618,25618,0,11,4997000.0
4997,4997999,21.38284338387311,38.43422923123843,0.09196964984108824,818.4098927974701,339.6704761981964,794.2650756835938,31408,5787,25621,25621,0,11,4998000.0
4998,4998999,21.38280959926632,38.433741917890984,0.09197351604253323,818.7591125965118,339.7376461029053,794.3838386535645,31451,5790,25661,25661,0,11,4999000.0
4999,4999999,21.382893680570135,38.433317120190075,0.0919795437794182,818.9536983966827,339.80333161354065,794.591926574707,31454,5791,25663,25663,0,11,5000000.0
5000,5000999,21.38286337106982,38.43264568173437,0.09198932090799283,819.0646886825562,339.8685235977173,794.7497940063477,31454,5791,25663,25663,0,11,5001000.0
5001,5001999,21.382978759406072,38.432304496580954,0.0920088849785311,819.3989818096161,339.93441247940063,794.7576065063477,31462,5794,25668,25668,0,11,5002000.0
5002,5002999,21.383543551026367,38.43284078491584,0.09200473560313127,819.5270462036133,340.00050711631775,794.9450263977051,31464,5794,25670,25670,0,11,5003000.0
5003,5003999,21.384096600529116,38.434348340389505,0.09199653341491554,819.7935311794281,340.0664849281311,794.968677520752,31468,5796,25672,25672,0,11,5004000.0
5004,5004999,21.384848260063926,38.43471233310112,0.09199215808538708,820.1327681541443,340.1349856853485,795.5158805847168,31499,5799,25700,25700,0,11,5005000.0
5005,5005999,21.38568694534476,38.434352899691866,0.09198618420631033,820.3301844596863,340.2016797065735,795.8286361694336,31506,5800,25706,25706,0,11,5006000.0
5006,5006999,21.38593417699051,38.433481826248816,0.09199292921412938,820.6720497608185,340.2681987285614,795.926342010498,31512,5803,25709,25709,0,11,5007000.0
5007,5007999,21.385996023754636,38.43215927987562,0.09200129672224278,820.8575694561005,340.33482456207275,796.0669784545898,31514,5804,25710,25710,0,11,5008000.0
5008,5008999,21.38550668986242,38.43063176217031,0.09200092893624912,820.9799394607544,340.40162682533264,796.364200592041,31523,5804,25719,25719,0,11,5009000.0
5009,5009999,21.383871326322186,38.42803942844151,0.09201768524880205,821.1798453330994,340.47051644325256,797.1476554870605,31566,5805,25761,25761,0,11,5010000.0
5010,5010999,21.382413017176184,38.426398322545104,0.09202998188718736,821.2993476390839,340.5366051197052,797.4473686218262,31573,5805,25768,25768,0,11,5011000.0
5011,5011999,21.380592124599048,38.423440313587754,0.09205386737032861,821.5011868476868,340.6029441356659,797.5800971984863,31575,5806,25769,25769,0,11,5012000.0
5012,5012999,21.379372306098077,38.42239321452416,0.0920557225513744,821.7644793987274,340.67092394828796,797.8203125,31594,5808,25786,25786,0,11,5013000.0
5013,5013999,21.377858186349755,38.42026015787594,0.09206978185945236,821.9536390304565,340.73707365989685,798.0761680603027,31597,5809,25788,25788,0,11,5014000.0
5014,5014999,21.37658466612839,38.4182598827956,0.09207521122866491,822.1456711292267,340.80318999290466,798.2186126708984,31599,5810,25789,25789,0,11,5015000.0
5015,5015999,21.375366794543332,38.41600751064732,0.09208602028417556,822.3578400611877,340.8787431716919,798.3505249023438,31603,5811,25792,25792,0,11,5016000.0
5016,5016999,21.373940946503577,38.413519769365706,0.09209486735037264,822.483617067337,340.9445869922638,798.5091438293457,31604,5811,25793,25793,0,11,5017000.0
5017,5017999,21.373112581734734,38.41928055755114,0.09206009926624692,822.7541406154633,341.0113115310669,798.6459732055664,31611,5813,25798,25798,0,11,5018000.0
5018,5018999,21.37217828747853,38.41730653147776,0.09205206568547375,822.9496939182281,341.0785253047943,799.0524253845215,31628,5814,25814,25814,0,11,5019000.0
5019,5019999,21.371185200433306,38.41490295177598,0.09205373257693061,823.2844214439392,341.1462314128876,799.1869239807129,31637,5817,25820,25820,0,11,5020000.0
5020,5020999,21.37044382674293,38.415603176073795,0.09204284745481828,823.6199898719788,341.2133376598358,799.2347183227539,31644,5820,25824,25824,0,11,5021000.0
5021,5021999,21.369667385716102,38.41377737262469,0.09204098799729166,823.9765722751617,341.28164935112,799.3825187683105,31654,5823,25831,25831,0,11,5022000.0
5022,5022999,21.36905799130395,38.41201432314849,0.09203717353455132,824.1766369342804,341.34853863716125,799.5601806640625,31664,5824,25840,25840,0,11,5023000.0
5023,5023999,21.368232657334424,38.41000240130749,0.09204249193884806,824.4430096149445,341.4171462059021,799.9400177001953,31691,5826,25865,25865,0,11,5024000.0
5024,5024999,21.36727626672144,38.408452043251366,0.0920510362772693,824.6285722255707,341.48325061798096,800.1158599853516,31693,5827,25866,25866,0,11,5025000.0
5025,5025999,21.36631825443443,38.40619055794052,0.09206647052230355,824.9634039402008,341.54937648773193,800.2494659423828,31702,5830,25872,25872,0,11,5026000.0
5026,5026999,21.364927091679125,38.404720283723556,0.09206431242506352,825.09064245224,341.6184000968933,801.0701522827148,31734,5830,25904,25904,0,11,5027000.0
5027,5027999,21.36316599346784,38.40205285069356,0.09208087227506756,825.2107150554657,341.685706615448,801.4565315246582,31743,5830,25913,25913,0,11,5028000.0
5028,5028999,21.361543590068486,38.39982613833551,0.0920937069847716,825.3241696357727,341.7518947124481,801.6969947814941,31747,5830,25917,25917,0,11,5029000.0
5029,5029999,21.360242184167824,38.3985157711513,0.09209851069515385,825.588531255722,341.8210287094116,802.0604515075684,31764,5832,25932,25932,0,11,5030000.0
5030,5030999,21.358759246321334,38.39659577186851,0.09210675778873767,825.705156326294,341.8871603012085,802.3101425170898,31764,5832,25932,25932,0,11,5031000.0
5031,5031999,21.357709881027887,38.395566588394246,0.0921071121286755,826.1191253662109,341.9541356563568,802.3485565185547,31772,5836,25936,25936,0,11,5032000.0
5032,5032999,21.35644906319212,38.39394023487515,0.09210998783524049,826.3161971569061,342.02069187164307,802.574634552002,31774,5837,25937,25937,0,11,5033000.0
5033,5033999,21.355170277064666,38.39194869436028,0.09211405060542344,826.5036737918854,342.08791494369507,802.740234375,31777,5838,25939,25939,0,11,5034000.0
5034,5034999,21.354186121771267,38.39008489174698,0.0921152621490875,826.6219277381897,342.15453577041626,803.0090789794922,31784,5838,25946,25946,0,11,5035000.0
5035,5035999,21.35376296270775,38.38976524714857,0.09210413295008546,826.7399561405182,342.2214891910553,803.4594383239746,31797,5838,25959,25959,0,11,5036000.0
5036,5036999,21.353862271816606,38.38978734067111,0.09210979300366162,826.9259078502655,342.2869939804077,803.6414375305176,31799,5839,25960,25960,0,11,5037000.0
5037,5037999,21.354060856679613,38.3894420592657,0.09211400109207812,827.120623588562,342.3533926010132,803.8510398864746,31802,5840,25962,25962,0,11,5038000.0
5038,5038999,21.35433194144561,38.38907767190134,0.09212092627253121,827.388426065445,342.4199492931366,803.9903221130371,31807,5842,25965,25965,0,11,5039000.0
5039,5039999,21.354492764983096,38.388610789620834,0.09212542803363832,827.5777304172516,342.48630928993225,804.1706199645996,31815,5843,25972,25972,0,11,5040000.0
5040,5040999,21.354974596384366,38.3898941891752,0.0921183612499974,827.7679188251495,342.5523829460144,804.2800750732422,31818,5844,25974,25974,0,11,5041000.0
5041,5041999,21.355170715012505,38.38921730008353,0.0921205413207572,828.0302212238312,342.61944675445557,804.671932220459,31834,5846,25988,25988,0,11,5042000.0
5042,5042999,21.355515102704533,38.38857605584148,0.09212771516494955,828.2231345176697,342.6860468387604,804.8596572875977,31836,5847,25989,25989,0,11,5043000.0
5043,5043999,21.355481703643555,38.387229836473274,0.09212241978041225,828.3361139297485,342.7514023780823,805.0419311523438,31836,5847,25989,25989,0,11,5044000.0
5044,5044999,21.355463321420537,38.38576897011269,0.0921209637577941,828.603066444397,342.8178403377533,805.1300277709961,31840,5849,25991,25991,0,11,5045000.0
5045,5045999,21.355025381793585,38.38436415589608,0.0921224534409365,828.882750749588,342.88696908950806,805.4904479980469,31860,5851,26009,26009,0,11,5046000.0
5046,5046999,21.353435030502666,38.38208245523495,0.09213088418035409,828.9964866638184,342.95192313194275,805.7622032165527,31862,5851,26011,26011,0,11,5047000.0
5047,5047999,21.352889148079825,38.38368991930692,0.0921154215868294,829.124933719635,343.01761770248413,806.0175094604492,31868,5851,26017,26017,0,11,5048000.0
5048,5048999,21.35230731962331,38.383747414460466,0.0921268250386923,829.3159234523773,343.0830109119415,806.1329231262207,31870,5852,26018,26018,0,11,5049000.0
5049,5049999,21.351940045304683,38.38408158297543,0.0921215853979439,829.5168268680573,343.148561000824,806.2131462097168,31872,5853,26019,26019,0,11,5050000.0
5050,5050999,21.352649076491655,38.39293775953164,0.09209857753141237,829.9443690776825,343.2149968147278,806.3703804016113,31894,5857,26037,26037,0,11,5051000.0
5051,5051999,21.352654969882675,38.39341193006774,0.09211213584858957,830.3711733818054,343.2817747592926,806.3810539245605,31904,5861,26043,26043,0,11,5052000.0
5052,5052999,21.35249158405778,38.393185685682575,0.09217561642545158,830.7044956684113,343.34897899627686,806.5625267028809,31910,5864,26046,26046,0,11,5053000.0
5053,5053999,21.353321302705556,38.39604714334201,0.09219357422344132,830.8948094844818,343.41472697257996,806.7187690734863,31913,5865,26048,26048,0,11,5054000.0
5054,5054999,21.354044158209433,38.40244053003209,0.09218874990739123,831.0245985984802,343.48013734817505,806.9402046203613,31917,5865,26052,26052,0,11,5055000.0
5055,5055999,21.354559572133763,38.40245882327134,0.09221885512414352,831.1503818035126,343.5456657409668,807.1025047302246,31918,5865,26053,26053,0,11,5056000.0
5056,5056999,21.355526948424814,38.40333684338148,0.09221395186384773,831.3424687385559,343.61175179481506,807.4119338989258,31929,5866,26063,26063,0,11,5057000.0
5057,5057999,21.356440436473004,38.404249319158474,0.09223739500943495,831.5402789115906,343.6776497364044,807.6134300231934,31932,5867,26065,26065,0,11,5058000.0
5058,5058999,21.356846969519207,38.403933279851145,0.09225335738538754,831.8021328449249,343.74383664131165,807.7816009521484,31937,5869,26068,26068,0,11,5059000.0
5059,5059999,21.357694490544915,38.40439247385753,0.09226371275077039,831.9244067668915,343.80969047546387,807.9727973937988,31939,5869,26070,26070,0,11,5060000.0
5060,5060999,21.35883447498965,38.40530932980653,0.09226342228341222,832.1159307956696,343.87522649765015,808.0356864929199,31947,5870,26077,26077,0,11,5061000.0
5061,5061999,21.359894057007008,38.40604575336542,0.09228734689162577,832.4057216644287,343.9423637390137,808.1904144287109,31960,5872,26088,26088,0,11,5062000.0
5062,5062999,21.361123993759563,38.406670214870104,0.09231884738307139,832.5186712741852,344.00708389282227,808.431095123291,31960,5872,26088,26088,0,11,5063000.0
5063,5063999,21.36218359863319,38.40679811302756,0.09234969017652439,832.7983913421631,344.07293343544006,808.5932922363281,31964,5874,26090,26090,0,11,5064000.0
5064,5064999,21.363035965905453,38.40654741202831,0.0923685777722516,833.0640528202057,344.1402485370636,808.6812782287598,31968,5876,26092,26092,0,11,5065000.0
5065,5065999,21.36313636802417,38.40560045456884,0.0923738165134913,833.263160943985,344.2064940929413,808.9729804992676,31984,5877,26107,26107,0,11,5066000.0
5066,5066999,21.36177851237646,38.40482275101117,0.09235518321076297,833.3800361156464,344.2738080024719,809.5597534179688,32001,5877,26124,26124,0,11,5067000.0
5067,5067999,21.3601330335955,38.40250079177709,0.09235814974028633,833.6383371353149,344.34021759033203,809.7920799255371,32032,5879,26153,26153,0,11,5068000.0
5068,5068999,21.35856939768476,38.40118783301571,0.09235840614693547,833.7576992511749,344.4061143398285,810.0095367431641,32034,5879,26155,26155,0,11,5069000.0
5069,5069999,21.356951834385324,38.39862052283496,0.0923672678426748,833.9590480327606,344.472638130188,810.170337677002,32043,5880,26163,26163,0,11,5070000.0
5070,5070999,21.355772114227328,38.39642905881525,0.0923673577906754,834.1593263149261,344.5389790534973,810.5118103027344,32052,5881,26171,26171,0,11,5071000.0
5071,5071999,21.354706890622158,38.39438493279383,0.09236918136719585,834.3484740257263,344.6050102710724,810.7222099304199,32063,5882,26181,26181,0,11,5072000.0
5072,5072999,21.35412403349088,38.39377558938767,0.09237014782264763,834.6879525184631,344.6715693473816,810.8064117431641,32069,5885,26184,26184,0,11,5073000.0
5073,5073999,21.353883445057697,38.393619169450915,0.09237045111697384,834.9632298946381,344.7392854690552,810.963436126709,32076,5887,26189,26189,0,11,5074000.0
5074,5074999,21.353831698131785,38.393319194147566,0.09238274061774288,835.0808100700378,344.80563974380493,811.2372741699219,32082,5887,26195,26195,0,11,5075000.0
5075,5075999,21.354031527329234,38.39347138917735,0.0923887462055889,835.2745673656464,344.8720633983612,811.429817199707,32088,5888,26200,26200,0,11,5076000.0
5076,5076999,21.35457779413171,38.39392565738641,0.09240294247801772,835.4635252952576,344.9386234283447,811.8773651123047,32100,5889,26211,26211,0,11,5077000.0
5077,5077999,21.355317082659116,38.39474838078601,0.09241616389527962,835.651376247406,345.0037567615509,812.0541496276855,32102,5890,26212,26212,0,11,5078000.0
5078,5078999,21.35621723487093,38.39552527108445,0.0924155248055778,836.146956205368,345.0709755420685,812.0683975219727,32112,5895,26217,26217,0,11,5079000.0
5079,5079999,21.35685692368535,38.395748760057316,0.092430876703396,836.4174818992615,345.1378197669983,812.260124206543,32123,5897,26226,26226,0,11,5080000.0
5080,5080999,21.357732103111342,38.39609790782233,0.09246166734286487,836.539576292038,345.20376420021057,812.4917182922363,32126,5897,26229,26229,0,11,5081000.0
5081,5081999,21.35864323988559,38.39605642538228,0.0924625592198256,836.8053016662598,345.27050518989563,812.8610496520996,32143,5899,26244,26244,0,11,5082000.0
5082,5082999,21.359493300229918,38.39606155799713,0.09246485520180636,836.9971373081207,345.3370032310486,813.0991821289062,32147,5900,26247,26247,0,11,5083000.0
5083,5083999,21.359741920642517,38.39510722650102,0.09247450844122684,837.2549588680267,345.40291380882263,813.3226470947266,32151,5902,26249,26249,0,11,5084000.0
5084,5084999,21.36025811364457,38.394272518817125,0.09247562042906432,837.4442298412323,345.46826815605164,813.4489555358887,32153,5903,26250,26250,0,11,5085000.0
5085,5085999,21.3599954582209,38.39335213477999,0.09246519896327021,837.5650737285614,345.5356614589691,814.0136947631836,32170,5903,26267,26267,0,11,5086000.0
5086,5086999,21.35854634704149,38.39349702939437,0.09245778073396915,837.6734519004822,345.6005802154541,814.3523941040039,32172,5903,26269,26269,0,11,5087000.0
5087,5087999,21.356503909689625,38.39041626595709,0.09247690241126205,837.8721170425415,345.66621136665344,814.5461044311523,32185,5904,26281,26281,0,11,5088000.0
5088,5088999,21.35465363324197,38.38801197943541,0.09249123247068247,837.9849572181702,345.7313232421875,814.8539848327637,32186,5904,26282,26282,0,11,5089000.0
5089,5089999,21.352718185706856,38.385364528385814,0.09250815039902027,838.256026506424,345.79756450653076,814.9536285400391,32193,5906,26287,26287,0,11,5090000.0
5090,5090999,21.351236297005862,38.38302998203309,0.0925093658905426,838.5207312107086,345.86449122428894,815.2328414916992,32202,5908,26294,26294,0,11,5091000.0
5091,5091999,21.349637684568652,38.380583861573236,0.0925162822877923,838.7256016731262,345.93040013313293,815.4158973693848,32204,5909,26295,26295,0,11,5092000.0
5092,5092999,21.347990711438037,38.37812554080298,0.09252228662155182,838.9104781150818,345.9959545135498,815.5650863647461,32207,5910,26297,26297,0,11,5093000.0
5093,5093999,21.34664918826585,38.3762280738714,0.0925253392384131,839.1042647361755,346.0618109703064,815.6824798583984,32210,5911,26299,26299,0,11,5094000.0
5094,5094999,21.345396289774353,38.37424757950728,0.0925289657728775,839.3040225505829,346.12770557403564,815.8910331726074,32216,5912,26304,26304,0,11,5095000.0
5095,5095999,21.344237719035892,38.372300127632116,0.09253587382102557,839.5788309574127,346.19353675842285,815.9890365600586,32221,5914,26307,26307,0,11,5096000.0
5096,5096999,21.343095006378572,38.37003404876895,0.09253611183709332,839.6976616382599,346.25914883613586,816.3631362915039,32228,5914,26314,26314,0,11,5097000.0
5097,5097999,21.342085419715758,38.368052571813976,0.092539428642609,840.0383131504059,346.32468724250793,816.4029083251953,32236,5917,26319,26319,0,11,5098000.0
5098,5098999,21.340962149912162,38.366379485676724,0.09254075551060237,840.3106245994568,346.3909921646118,816.5380783081055,32240,5919,26321,26321,0,11,5099000.0
5099,5099999,21.33997791937227,38.364197224854614,0.09254349853094301,840.5083661079407,346.45658111572266,816.7279052734375,32243,5920,26323,26323,0,11,5100000.0
5100,5100999,21.33920143041986,38.36262558739194,0.09253797075761416,840.6943099498749,346.5224964618683,816.905158996582,32247,5921,26326,26326,0,11,5101000.0
5101,5101999,21.338337906166725,38.3607533951089,0.09253541955117872,840.8194925785065,346.58863949775696,817.1611213684082,32253,5921,26332,26332,0,11,5102000.0
5102,5102999,21.337730399178483,38.35950151945045,0.09253208078915132,841.0088639259338,346.6539831161499,817.4219856262207,32258,5922,26336,26336,0,11,5103000.0
5103,5103999,21.336702308174544,38.35711763299734,0.09253064976665992,841.2773234844208,346.71966886520386,817.5276298522949,32262,5924,26338,26338,0,11,5104000.0
5104,5104999,21.336041578220378,38.35528124804219,0.0925275207400128,841.3937609195709,346.78501868247986,817.7161254882812,32262,5924,26338,26338,0,11,5105000.0
5105,5105999,21.33500928891396,38.353660263492706,0.09252616034721306,841.6045815944672,346.85136246681213,817.8535194396973,32264,5925,26339,26339,0,11,5106000.0
5106,5106999,21.333365639354273,38.35087931787203,0.09253743320712904,841.8023970127106,346.92074155807495,818.5022506713867,32293,5926,26367,26367,0,11,5107000.0
5107,5107999,21.331336717423905,38.34866763967657,0.09254970978205768,841.9952306747437,346.9874131679535,818.8357620239258,32304,5927,26377,26377,0,11,5108000.0
5108,5108999,21.329465578983385,38.34594460926909,0.09256011688763988,842.1130647659302,347.05327820777893,819.0524139404297,32306,5927,26379,26379,0,11,5109000.0
5109,5109999,21.327554501278374,38.34321807617007,0.09257549663589804,842.2277393341064,347.11985301971436,819.2594528198242,32309,5927,26382,26382,0,11,5110000.0
5110,5110999,21.325628454974165,38.34018323574066,0.09258841952455055,842.5927443504333,347.1886131763458,819.4351768493652,32325,5930,26395,26395,0,11,5111000.0
5111,5111999,21.32373352806351,38.337201630730426,0.09260102769002199,842.7096531391144,347.25481152534485,819.7156295776367,32326,5930,26396,26396,0,11,5112000.0
5112,5112999,21.321842907717073,38.334233438223485,0.09261420145234311,842.9779179096222,347.32091546058655,819.789134979248,32338,5932,26406,26406,0,11,5113000.0
5113,5113999,21.320106017434547,38.331892776585626,0.09262275223370253,843.2411162853241,347.3881552219391,819.8720893859863,32342,5934,26408,26408,0,11,5114000.0
5114,5114999,21.318551839695054,38.32986308595288,0.0926258704044648,843.3688082695007,347.45557832717896,820.0339622497559,32343,5934,26409,26409,0,11,5115000.0
5115,5115999,21.31694542052695,38.32715092360089,0.09263533527635304,843.6545107364655,347.52306389808655,820.1154861450195,32351,5936,26415,26415,0,11,5116000.0
5116,5116999,21.31582178926262,38.32529838460635,0.09263370903255408,843.7799880504608,347.59118008613586,820.5873184204102,32369,5936,26433,26433,0,11,5117000.0
5117,5117999,21.315484349459943,38.32457349404612,0.09262523114481536,843.899781703949,347.6577606201172,820.9796180725098,32379,5936,26443,26443,0,11,5118000.0
5118,5118999,21.315611926874123,38.3240593960559,0.09261541970141407,844.171010017395,347.7241735458374,821.0537261962891,32383,5938,26445,26445,0,11,5119000.0
5119,5119999,21.31630021527893,38.32753132836355,0.09259449431194355,844.4307663440704,347.7902090549469,821.1829452514648,32388,5940,26448,26448,0,11,5120000.0
5120,5120999,21.316638133083583,38.32815203563987,0.09258837445865942,844.643152475357,347.8580424785614,821.3235321044922,32391,5941,26450,26450,0,11,5121000.0
5121,5121999,21.31706290993977,38.32859375524134,0.09258856231655577,844.7546036243439,347.92427587509155,821.4912719726562,32392,5941,26451,26451,0,11,5122000.0
5122,5122999,21.31801808357465,38.32998045943024,0.09258603966591761,844.8716771602631,347.99037432670593,821.8064804077148,32398,5941,26457,26457,0,11,5123000.0
5123,5123999,21.31849282801387,38.33023284677285,0.09259313495876331,844.9864387512207,348.05575346946716,822.0098190307617,32399,5941,26458,26458,0,11,5124000.0
5124,5124999,21.318038961677395,38.32875992356966,0.09260136540500274,845.4793872833252,348.12251806259155,822.0168380737305,32411,5946,26465,26465,0,11,5125000.0
5125,5125999,21.318156125090837,38.32816547099759,0.09261036191687444,845.6721861362457,348.18794345855713,822.1351661682129,32413,5947,26466,26466,0,11,5126000.0
5126,5126999,21.31814671115378,38.32740381401174,0.09263252886042428,845.8007271289825,348.25349259376526,822.2973327636719,32414,5947,26467,26467,0,11,5127000.0
5127,5127999,21.316819042959025,38.3254797705902,0.09262984950861208,845.9264831542969,348.3224403858185,823.1785697937012,32450,5947,26503,26503,0,11,5128000.0
5128,5128999,21.315280050132397,38.32351909786995,0.09262692088558988,846.0459358692169,348.3896086215973,823.5198783874512,32454,5947,26507,26507,0,11,5129000.0
5129,5129999,21.313780830948723,38.32114596582573,0.09263184226281695,846.2317700386047,348.4559426307678,823.7454986572266,32458,5948,26510,26510,0,11,5130000.0
5130,5130999,21.312300642225008,38.319514964935934,0.09263632795274135,846.3462340831757,348.5218257904053,823.9524307250977,32460,5948,26512,26512,0,11,5131000.0
5131,5131999,21.3109481829795,38.317244109226394,0.09263531380367351,846.5392105579376,348.58921933174133,824.3123092651367,32472,5949,26523,26523,0,11,5132000.0
5132,5132999,21.30993847878033,38.31548871097113,0.09263199761490881,846.8169131278992,348.6572048664093,824.5309677124023,32477,5951,26526,26526,0,11,5133000.0
5133,5133999,21.308769205787332,38.31333396024055,0.09263457400680075,847.0092422962189,348.7234983444214,824.6828651428223,32480,5952,26528,26528,0,11,5134000.0
5134,5134999,21.307688200170695,38.31123466508105,0.09263429318286942,847.2193102836609,348.79821825027466,824.8463821411133,32482,5953,26529,26529,0,11,5135000.0
5135,5135999,21.306502652708563,38.31140087989045,0.09262623220266253,847.4853460788727,348.8647050857544,824.9528160095215,32487,5955,26532,26532,0,11,5136000.0
5136,5136999,21.3056464431224,38.30988999210842,0.09263670239136079,847.6779358386993,348.93132519721985,825.1463813781738,32494,5956,26538,26538,0,11,5137000.0
5137,5137999,21.30528150433326,38.30946260503374,0.09263691290665099,847.8056719303131,349.0010347366333,825.4935340881348,32503,5956,26547,26547,0,11,5138000.0
5138,5138999,21.305296215512318,38.31185399946851,0.09263062324702176,848.0759220123291,349.0682256221771,825.6635627746582,32509,5958,26551,26551,0,11,5139000.0
5139,5139999,21.3058289311749,38.31555000692722,0.0926398528165614,848.1894083023071,349.13364148139954,825.8462677001953,32509,5958,26551,26551,0,11,5140000.0
5140,5140999,21.30660732181561,38.31657871407683,0.09268785809035307,848.4510183334351,349.19976902008057,825.9432792663574,32513,5960,26553,26553,0,11,5141000.0
5141,5141999,21.30794462582184,38.3190574464076,0.09271622313827987,848.6406917572021,349.26582431793213,826.0676116943359,32516,5961,26555,26555,0,11,5142000.0
5142,5142999,21.30928312976012,38.3209710609063,0.09277783722793453,848.8459010124207,349.3334038257599,826.2050361633301,32521,5962,26559,26559,0,11,5143000.0
5143,5143999,21.311268698928995,38.32472023292834,0.09283598393571968,849.0447218418121,349.40178179740906,826.7195472717285,32545,5963,26582,26582,0,11,5144000.0
5144,5144999,21.313331349851147,38.32774879087018,0.0928743917519872,849.3983578681946,349.46959495544434,826.972038269043,32566,5966,26600,26600,0,11,5145000.0
5145,5145999,21.31463210804924,38.328476276316785,0.09291624442407409,849.7403075695038,349.536110162735,827.1939544677734,32575,5969,26606,26606,0,11,5146000.0
5146,5146999,21.316028835975867,38.32888089065826,0.09297939218498708,849.9300382137299,349.6021797657013,827.3224906921387,32577,5970,26607,26607,0,11,5147000.0
5147,5147999,21.317108470611913,38.329789626020066,0.09306637723049649,850.2109317779541,349.6691851615906,827.6010932922363,32590,5972,26618,26618,0,11,5148000.0
5148,5148999,21.31586673352415,38.32768785726366,0.09307318261455233,850.4064543247223,349.7391834259033,828.4902610778809,32633,5973,26660,26660,0,11,5149000.0
5149,5149999,21.314576273489912,38.326212142961616,0.09307382238568795,850.5229780673981,349.8056824207306,828.8709907531738,32641,5973,26668,26668,0,11,5150000.0
5150,5150999,21.31320241977304,38.32402841209303,0.09308077275833637,850.6481490135193,349.8720006942749,829.1170692443848,32644,5973,26671,26671,0,11,5151000.0
5151,5151999,21.312144590208998,38.32419787043204,0.09306649723848559,850.7758793830872,349.93935108184814,829.4345436096191,32650,5973,26677,26677,0,11,5152000.0
5152,5152999,21.31074652300548,38.325367814387356,0.09305813300918031,850.9700384140015,350.0060293674469,829.6755256652832,32652,5974,26678,26678,0,11,5153000.0
5153,5153999,21.30927383871737,38.32272402037083,0.09306449029935526,851.1614501476288,350.0724866390228,829.8496322631836,32655,5975,26680,26680,0,11,5154000.0
5154,5154999,21.30820445450415,38.32097871420301,0.09306187600969085,851.351114988327,350.1392776966095,830.0065612792969,32658,5976,26682,26682,0,11,5155000.0
5155,5155999,21.307006878825845,38.319452789411145,0.09305809424060507,851.4632511138916,350.2064280509949,830.214183807373,32661,5976,26685,26685,0,11,5156000.0
5156,5156999,21.305769501457785,38.31761435637484,0.09305834426001525,851.7389352321625,350.2737069129944,830.2987632751465,32668,5978,26690,26690,0,11,5157000.0
5157,5157999,21.30486598293706,38.31581592093908,0.09305745034285651,851.9461841583252,350.34229588508606,830.846305847168,32691,5979,26712,26712,0,11,5158000.0
5158,5158999,21.304100419520235,38.316410667161676,0.09304259767996925,852.2205951213837,350.40984058380127,831.0321998596191,32698,5981,26717,26717,0,11,5159000.0
5159,5159999,21.303068103007444,38.31420496885523,0.09304572368883046,852.4142146110535,350.4761731624603,831.2131690979004,32700,5982,26718,26718,0,11,5160000.0
5160,5160999,21.30218583774049,38.31261179014742,0.09304402220726571,852.7754099369049,350.54442167282104,831.2714424133301,32706,5985,26721,26721,0,11,5161000.0
5161,5161999,21.30135368474225,38.312854802070646,0.09303907471820128,853.125958442688,350.61258149147034,831.3840980529785,32717,5988,26729,26729,0,11,5162000.0
5162,5162999,21.30029012796177,38.3106222860515,0.09305007745675486,853.242603302002,350.6792793273926,831.7979965209961,32723,5988,26735,26735,0,11,5163000.0
5163,5163999,21.29891350880505,38.30806359146707,0.09306329404199443,853.3593616485596,350.74590706825256,831.994140625,32723,5988,26735,26735,0,11,5164000.0
5164,5164999,21.297602385662014,38.306408985137395,0.0930771051514866,853.6325731277466,350.8124895095825,832.0835342407227,32728,5990,26738,26738,0,11,5165000.0
5165,5165999,21.29586540310798,38.3034602386919,0.0930939519443974,853.8305943012238,350.88230633735657,832.8586082458496,32764,5991,26773,26773,0,11,5166000.0
5166,5166999,21.294171320891742,38.30116613352173,0.09310678088824531,853.9502103328705,350.95017290115356,833.2381057739258,32772,5991,26781,26781,0,11,5167000.0
5167,5167999,21.292570199935742,38.29974229283545,0.09311431350367538,854.0724821090698,351.016725063324,833.4582176208496,32774,5991,26783,26783,0,11,5168000.0
5168,5168999,21.290929718430775,38.296984547782145,0.09312581935640396,854.2739725112915,351.08478593826294,833.8488998413086,32785,5992,26793,26793,0,11,5169000.0
5169,5169999,21.289539582023355,38.29503919324825,0.09313305321200849,854.4649274349213,351.1511015892029,834.0717353820801,32787,5993,26794,26794,0,11,5170000.0
5170,5170999,21.28838242055061,38.293327545065594,0.0931340556230813,854.6522243022919,351.21749567985535,834.2589645385742,32790,5994,26796,26796,0,11,5171000.0
5171,5171999,21.287256459800734,38.292485181056065,0.09312931121355528,855.0001020431519,351.28469800949097,834.3544006347656,32796,5997,26799,26799,0,11,5172000.0
5172,5172999,21.286020368054285,38.290583870506225,0.09312957765248087,855.1946713924408,351.3521773815155,834.5331802368164,32799,5998,26801,26801,0,11,5173000.0
5173,5173999,21.285157772239764,38.28936892580762,0.09312506084591732,855.3224158287048,351.4202241897583,834.7976341247559,32806,5998,26808,26808,0,11,5174000.0
5174,5174999,21.284125477318206,38.28761546448136,0.09311753239793408,855.4363882541656,351.48801589012146,835.2787170410156,32820,5998,26822,26822,0,11,5175000.0
5175,5175999,21.283359522346856,38.28617065393487,0.0931117184287823,855.7773311138153,351.55457735061646,835.4032135009766,32833,6001,26832,26832,0,11,5176000.0
5176,5176999,21.282979617696547,38.28594564217,0.09309779469504142,856.1190252304077,351.62173533439636,835.5775527954102,32841,6004,26837,26837,0,11,5177000.0
5177,5177999,21.282573835050904,38.284874019851635,0.0930971051984324,856.3132646083832,351.68850660324097,835.7602043151855,32844,6005,26839,26839,0,11,5178000.0
5178,5178999,21.281662427776766,38.28314223242798,0.09309540932789773,856.6628353595734,351.756472826004,835.8339691162109,32851,6008,26843,26843,0,11,5179000.0
5179,5179999,21.281547515924345,38.282680595359096,0.09308077692264538,856.8620591163635,351.8239006996155,835.9560127258301,32854,6009,26845,26845,0,11,5180000.0
5180,5180999,21.28095863411565,38.281058521552325,0.09307686040443053,856.978175163269,351.89067792892456,836.4197540283203,32866,6009,26857,26857,0,11,5181000.0
5181,5181999,21.280445993308387,38.27944023554038,0.09306790412206634,857.4089484214783,351.95805859565735,836.4595108032227,32874,6013,26861,26861,0,11,5182000.0
5182,5182999,21.279835077854166,38.27806340310215,0.09305896992812779,857.5995264053345,352.0243606567383,836.6971015930176,32878,6014,26864,26864,0,11,5183000.0
5183,5183999,21.279661372793097,38.28045259217071,0.09303178236360188,857.864497423172,352.09058713912964,836.7709693908691,32883,6016,26867,26867,0,11,5184000.0
5184,5184999,21.279023775518592,38.281000961056016,0.0930163433656721,858.0617814064026,352.15843176841736,837.0516891479492,32894,6017,26877,26877,0,11,5185000.0
5185,5185999,21.277548027559426,38.27921154212003,0.0930177114931725,858.1762199401855,352.22638750076294,837.4135627746582,32901,6017,26884,26884,0,11,5186000.0
5186,5186999,21.275936400368696,38.27780062344578,0.09302026874298086,858.3727440834045,352.2917511463165,837.5962867736816,32906,6018,26888,26888,0,11,5187000.0
5187,5187999,21.274578756057174,38.276840693052556,0.09302134476563728,858.6458990573883,352.35806584358215,837.7407455444336,32912,6020,26892,26892,0,11,5188000.0
5188,5188999,21.2734092276268,38.27499963495921,0.09302259130786494,858.7750527858734,352.42807149887085,837.9291076660156,32915,6020,26895,26895,0,11,5189000.0
5189,5189999,21.27267950821598,38.2741304543696,0.0930144176676283,859.1305747032166,352.49418234825134,838.1264457702637,32928,6023,26905,26905,0,11,5190000.0
5190,5190999,21.271771397280947,38.27248327567793,0.09301034621418713,859.3254029750824,352.5596616268158,838.3175048828125,32930,6024,26906,26906,0,11,5191000.0
5191,5191999,21.270869181859524,38.270621540220915,0.09300475666374997,859.595963716507,352.62609219551086,838.4084587097168,32934,6026,26908,26908,0,11,5192000.0
5192,5192999,21.269849047704458,38.268461256173964,0.09300376902658025,859.7228353023529,352.69180703163147,838.5867691040039,32935,6026,26909,26909,0,11,5193000.0
5193,5193999,21.269013523475895,38.266681222782225,0.09300014382869703,859.8473250865936,352.7572979927063,838.7386245727539,32936,6026,26910,26910,0,11,5194000.0
5194,5194999,21.268446797281005,38.266140970201825,0.09299727265732194,860.1309792995453,352.823912858963,838.8330268859863,32953,6028,26925,26925,0,11,5195000.0
5195,5195999,21.26778432253082,38.26429174687907,0.09298969331393325,860.4918138980865,352.89220333099365,839.1413993835449,32974,6031,26943,26943,0,11,5196000.0
5196,5196999,21.26733607918179,38.263153300775436,0.09298033006393724,860.6926279067993,352.95773005485535,839.3800354003906,32976,6032,26944,26944,0,11,5197000.0
5197,5197999,21.266564332077223,38.26146572991208,0.09297773355338645,860.8070614337921,353.022830247879,839.5873947143555,32977,6032,26945,26945,0,11,5198000.0
5198,5198999,21.266227628863277,38.26276772015203,0.09295971465506969,861.1495654582977,353.0887942314148,839.6557006835938,32984,6035,26949,26949,0,11,5199000.0
5199,5199999,21.265559670546782,38.260884452182,0.0929572957816458,861.2641236782074,353.15440583229065,839.8391799926758,32984,6035,26949,26949,0,11,5200000.0
5200,5200999,21.264832043418615,38.258957106477204,0.0929558284978711,861.3864831924438,353.2193217277527,839.9651756286621,32984,6035,26949,26949,0,11,5201000.0
5201,5201999,21.264244345028384,38.25787292977953,0.09295603116205342,861.5886409282684,353.2866096496582,840.2134246826172,32991,6036,26955,26955,0,11,5202000.0
5202,5202999,21.263511428008723,38.256077948294376,0.09295574158519482,861.856057882309,353.35216307640076,840.2899589538574,32996,6038,26958,26958,0,11,5203000.0
5203,5203999,21.262405046843906,38.253737876903685,0.0929592208539507,862.1354494094849,353.4188904762268,840.4219970703125,33000,6040,26960,26960,0,11,5204000.0
5204,5204999,21.26113492282512,38.251331228430466,0.09296253217287309,862.3420495986938,353.4845435619354,840.5168991088867,33002,6041,26961,26961,0,11,5205000.0
5205,5205999,21.26004944300395,38.249139900150645,0.0929689074954908,862.5367796421051,353.551509141922,841.0105247497559,33033,6042,26991,26991,0,11,5206000.0
5206,5206999,21.258430637761528,38.24651560788183,0.092981403536187,862.6531870365143,353.61806058883667,841.3000869750977,33038,6042,26996,26996,0,11,5207000.0
5207,5207999,21.25663818162598,38.243749644414756,0.09299484864682506,862.8542938232422,353.68393874168396,841.5137405395508,33048,6043,27005,27005,0,11,5208000.0
5208,5208999,21.254947113336602,38.2409645230534,0.09301099462704476,862.9704229831696,353.74937176704407,841.6860961914062,33049,6043,27006,27006,0,11,5209000.0
5209,5209999,21.25337684495694,38.23837410735207,0.09302456906646839,863.1661307811737,353.8149242401123,841.7946014404297,33052,6044,27008,27008,0,11,5210000.0
5210,5210999,21.25226933494821,38.23737448774319,0.09302076325588715,863.28142619133,353.88124442100525,842.2253189086914,33060,6044,27016,27016,0,11,5211000.0
5211,5211999,21.2507784666808,38.23484061192605,0.09302914370614357,863.6204776763916,353.94755935668945,842.3850135803223,33079,6047,27032,27032,0,11,5212000.0
5212,5212999,21.24935639103899,38.23236946269607,0.0930359943401512,863.9007103443146,354.0150649547577,842.6115989685059,33086,6049,27037,27037,0,11,5213000.0
5213,5213999,21.248093538123594,38.2300201244757,0.09304202836427677,864.0979824066162,354.0818431377411,842.8014678955078,33089,6050,27039,27039,0,11,5214000.0
5214,5214999,21.247049101420675,38.228394458952465,0.09304310952742012,864.2953794002533,354.14854073524475,843.0137825012207,33097,6051,27046,27046,0,11,5215000.0
5215,5215999,21.245968659865746,38.22653126179331,0.0930487773850538,864.4888126850128,354.21551275253296,843.3007011413574,33112,6052,27060,27060,0,11,5216000.0
5216,5216999,21.24472566547074,38.22405742180925,0.09305490901720881,864.760933637619,354.2823808193207,843.5354232788086,33126,6054,27072,27072,0,11,5217000.0
5217,5217999,21.243506508646654,38.22162574481435,0.09306069750958956,865.0295536518097,354.3481183052063,843.654956817627,33130,6056,27074,27074,0,11,5218000.0
5218,5218999,21.242591020622697,38.219867706923665,0.09306386520818144,865.3026838302612,354.41421699523926,843.7980041503906,33134,6058,27076,27076,0,11,5219000.0
5219,5219999,21.24174403456971,38.218126186551366,0.09306490058729555,865.5718586444855,354.481831073761,843.9581108093262,33162,6060,27102,27102,0,11,5220000.0
5220,5220999,21.241273796435898,38.21731936814122,0.09306473599563192,865.6903681755066,354.5475130081177,844.1580963134766,33165,6060,27105,27105,0,11,5221000.0
5221,5221999,21.24070783512822,38.215770667879546,0.09306410209186466,865.8143653869629,354.61396980285645,844.5533866882324,33176,6060,27116,27116,0,11,5222000.0
5222,5222999,21.24039324687607,38.21474367859247,0.09305462181628044,866.0848844051361,354.6811034679413,844.6886749267578,33180,6062,27118,27118,0,11,5223000.0
5223,5223999,21.239891313693274,38.214355098830616,0.09304527970542209,866.4333412647247,354.74746775627136,844.8174285888672,33186,6065,27121,27121,0,11,5224000.0
5224,5224999,21.23905131066904,38.21338163815203,0.09303531632216455,866.7921140193939,354.8139719963074,844.833984375,33192,6068,27124,27124,0,11,5225000.0
5225,5225999,21.23831702757159,38.211422756776955,0.0930286507032595,866.9216120243073,354.88160824775696,845.2511711120605,33204,6068,27136,27136,0,11,5226000.0
5226,5226999,21.236862852102924,38.21038723623894,0.09303357345719931,867.3433392047882,354.94719409942627,845.4589462280273,33233,6072,27161,27161,0,11,5227000.0
5227,5227999,21.235039637321208,38.20764753614374,0.09304744591751812,867.5387518405914,355.01267313957214,845.7597999572754,33243,6073,27170,27170,0,11,5228000.0
5228,5228999,21.233146932969966,38.20468306618451,0.09306330412830821,867.7427854537964,355.0779781341553,845.948070526123,33247,6074,27173,27173,0,11,5229000.0
5229,5229999,21.231489864918945,38.20204232823145,0.09307536694298546,868.0112464427948,355.14316177368164,846.0376663208008,33252,6076,27176,27176,0,11,5230000.0
5230,5230999,21.230315771866728,38.20035299275629,0.09307074782370106,868.3657329082489,355.20992159843445,846.3286361694336,33265,6079,27186,27186,0,11,5231000.0
5231,5231999,21.228739353731708,38.19767019233878,0.09308062236961212,868.6379480361938,355.2775025367737,846.5146179199219,33276,6081,27195,27195,0,11,5232000.0
5232,5232999,21.227353725933842,38.19569198655462,0.09308507100570229,868.831921339035,355.3432493209839,846.6892585754395,33278,6082,27196,27196,0,11,5233000.0
5233,5233999,21.22606297471886,38.193904016034246,0.09308717231259944,869.1035685539246,355.4091958999634,846.7901306152344,33283,6084,27199,27199,0,11,5234000.0
5234,5234999,21.224692867080982,38.19146781767513,0.09309166786282608,869.225371837616,355.4747622013092,847.0179748535156,33286,6084,27202,27202,0,11,5235000.0
5235,5235999,21.22330842874825,38.189010716631124,0.09309867146053064,869.425368309021,355.54100036621094,847.1692123413086,33291,6085,27206,27206,0,11,5236000.0
5236,5236999,21.222298715596626,38.18732082450597,0.09309270424071292,869.7790849208832,355.60760736465454,847.4635429382324,33307,6088,27219,27219,0,11,5237000.0
5237,5237999,21.22111323706957,38.1853444627461,0.09309432516576932,869.9827079772949,355.6729838848114,847.6296539306641,33309,6089,27220,27220,0,11,5238000.0
5238,5238999,21.21978847684834,38.18308404908954,0.09309839989631497,870.1034698486328,355.7379038333893,847.8125953674316,33309,6089,27220,27220,0,11,5239000.0
5239,5239999,21.21885209615392,38.18107895130072,0.09308849511634765,870.297933101654,355.8030478954315,847.9409980773926,33312,6090,27222,27222,0,11,5240000.0
5240,5240999,21.217766598728684,38.18022516217576,0.09307993575972195,870.4251863956451,355.86816787719727,848.0737190246582,33313,6090,27223,27223,0,11,5241000.0
5241,5241999,21.216677167419284,38.17798369501226,0.09308047564387045,870.6174886226654,355.9335696697235,848.1931266784668,33317,6091,27226,27226,0,11,5242000.0
5242,5242999,21.215843348464205,38.17618492741359,0.09307176787426152,870.8081820011139,356.0006215572357,848.4915618896484,33326,6092,27234,27234,0,11,5243000.0
5243,5243999,21.214766562332553,38.17390297371317,0.09306968870599086,871.0823359489441,356.0661609172821,848.6215515136719,33334,6094,27240,27240,0,11,5244000.0
5244,5244999,21.213407907098226,38.17132965003371,0.09307447896416032,871.2854709625244,356.1315085887909,848.7732200622559,33340,6095,27245,27245,0,11,5245000.0
5245,5245999,21.21205258734572,38.168925650493776,0.09307869048041606,871.6493735313416,356.19927525520325,848.8349189758301,33346,6098,27248,27248,0,11,5246000.0
5246,5246999,21.210669921138322,38.16633192746837,0.093087030757942,871.7797677516937,356.2678883075714,849.6195755004883,33377,6098,27279,27279,0,11,5247000.0
5247,5247999,21.2085855529855,38.16344908312542,0.0931028433844795,871.8903396129608,356.33451533317566,849.9609527587891,33381,6098,27283,27283,0,11,5248000.0
5248,5248999,21.206738652826985,38.160773361408054,0.09311519433588411,872.0040323734283,356.4003779888153,850.265754699707,33386,6098,27288,27288,0,11,5249000.0
5249,5249999,21.205139000234983,38.158120340151164,0.09312965739702683,872.1153316497803,356.4659583568573,850.4480133056641,33387,6098,27289,27289,0,11,5250000.0
5250,5250999,21.20359727896209,38.15560683744159,0.09314074066445555,872.2351169586182,356.5323565006256,850.694694519043,33390,6098,27292,27292,0,11,5251000.0
5251,5251999,21.202539503740066,38.15445481019149,0.09313841615284368,872.5140509605408,356.5994644165039,850.9301414489746,33397,6100,27297,27297,0,11,5252000.0
5252,5252999,21.201129250005543,38.152608175934056,0.0931429965007039,872.7138931751251,356.6652753353119,851.0451622009277,33399,6101,27298,27298,0,11,5253000.0
5253,5253999,21.19997251960949,38.15085592411244,0.09314704545745778,872.9868001937866,356.73141169548035,851.1509399414062,33405,6103,27302,27302,0,11,5254000.0
5254,5254999,21.198791405444346,38.148854194319135,0.09315054461420003,873.2593233585358,356.79794216156006,851.231861114502,33411,6105,27306,27306,0,11,5255000.0
5255,5255999,21.197602984447755,38.14671205227563,0.09315736804102848,873.5459773540497,356.8647301197052,851.4358062744141,33421,6107,27314,27314,0,11,5256000.0
5256,5256999,21.19655914623121,38.14464135406416,0.09316036812397399,873.8270707130432,356.9317636489868,851.6391487121582,33439,6109,27330,27330,0,11,5257000.0
5257,5257999,21.19562555452253,38.142753070260234,0.09315940610575957,874.029935836792,356.9999268054962,852.0678405761719,33457,6110,27347,27347,0,11,5258000.0
5258,5258999,21.19481255585347,38.14110850029887,0.09315731266452065,874.4561150074005,357.06718587875366,852.1061325073242,33485,6114,27371,27371,0,11,5259000.0
5259,5259999,21.193847965453955,38.13909344311855,0.0931567759258356,874.6498219966888,357.1330544948578,852.2524223327637,33487,6115,27372,27372,0,11,5260000.0
5260,5260999,21.193449038566317,38.13994536439356,0.09313822605012445,874.9367587566376,357.2000970840454,852.3659820556641,33493,6117,27376,27376,0,11,5261000.0
5261,5261999,21.193013316328354,38.139359038786054,0.09313356399532624,875.0574939250946,357.2658874988556,852.5156173706055,33493,6117,27376,27376,0,11,5262000.0
5262,5262999,21.192653717200347,38.13965137919204,0.09312280363986336,875.2610716819763,357.3335609436035,852.7618827819824,33500,6118,27382,27382,0,11,5263000.0
5263,5263999,21.192473683731084,38.138820649746954,0.09311923226142127,875.3716726303101,357.39889097213745,853.0341949462891,33501,6118,27383,27383,0,11,5264000.0
5264,5264999,21.19216225134063,38.13857257113781,0.09311867017279973,875.5740106105804,357.46503019332886,853.1915664672852,33503,6119,27384,27384,0,11,5265000.0
5265,5265999,21.191460049779025,38.136778094606086,0.09311807230456404,875.8585975170135,357.53065156936646,853.2419395446777,33511,6121,27390,27390,0,11,5266000.0
5266,5266999,21.19047602504163,38.134724092344705,0.09312314230154317,876.2219612598419,357.59735798835754,853.3078880310059,33517,6124,27393,27393,0,11,5267000.0
5267,5267999,21.18931640949914,38.13417182200026,0.09311846550778202,876.341558933258,357.66615772247314,854.1136054992676,33550,6124,27426,27426,0,11,5268000.0
5268,5268999,21.187649816013803,38.13180568171295,0.09312534528372107,876.4585499763489,357.7321939468384,854.4048957824707,33554,6124,27430,27430,0,11,5269000.0
5269,5269999,21.1863214102898,38.13061640770787,0.09312842735883164,876.5734581947327,357.7980637550354,854.6255493164062,33556,6124,27432,27432,0,11,5270000.0
5270,5270999,21.184994090766082,38.12876984686947,0.09313773617578547,876.7733824253082,357.8643682003021,854.7536277770996,33565,6125,27440,27440,0,11,5271000.0
5271,5271999,21.18405412663922,38.12729078568371,0.09313655022860123,876.9851386547089,357.9317126274109,855.0256309509277,33575,6126,27449,27449,0,11,5272000.0
5272,5272999,21.18298880362672,38.12507014624624,0.09313879781967915,877.1929016113281,357.9981544017792,855.2662887573242,33586,6127,27459,27459,0,11,5273000.0
5273,5273999,21.182054800720454,38.124305620750086,0.0931092954895012,877.3862082958221,358.06442427635193,855.3985366821289,33589,6128,27461,27461,0,11,5274000.0
5274,5274999,21.181026245874776,38.12262178418777,0.09309866039878556,877.5816967487335,358.13075280189514,855.5421867370605,33591,6129,27462,27462,0,11,5275000.0
5275,5275999,21.180019689565878,38.12056276805884,0.09310123132209669,878.0055150985718,358.19781851768494,855.5652160644531,33608,6133,27475,27475,0,11,5276000.0
5276,5276999,21.17926981621796,38.12152291807101,0.09309537898778164,878.1308109760284,358.2641406059265,855.8086128234863,33613,6133,27480,27480,0,11,5277000.0
5277,5277999,21.17832582761724,38.119410906993444,0.09309176121871177,878.4917542934418,358.33175110816956,855.9758148193359,33635,6136,27499,27499,0,11,5278000.0
5278,5278999,21.178012173415894,38.118248676024976,0.09309099620101247,878.6956858634949,358.39827251434326,856.2294540405273,33639,6137,27502,27502,0,11,5279000.0
5279,5279999,21.177474543840397,38.1166718110962,0.09309543062842929,878.9736182689667,358.46466040611267,856.3470611572266,33643,6139,27504,27504,0,11,5280000.0
5280,5280999,21.17747448781006,38.118067491401305,0.09308236865210862,879.2497470378876,358.53100776672363,856.473876953125,33647,6141,27506,27506,0,11,5281000.0
5281,5281999,21.177415604233275,38.117449775726826,0.0930764319805103,879.4585418701172,358.5988094806671,856.6390228271484,33649,6142,27507,27507,0,11,5282000.0
5282,5282999,21.177491673811605,38.116814584677954,0.09307191323450781,879.7325274944305,358.66543102264404,856.776050567627,33657,6144,27513,27513,0,11,5283000.0
5283,5283999,21.177665236285872,38.117627282125135,0.09305549271397473,880.0055246353149,358.73293113708496,857.2581329345703,33683,6146,27537,27537,0,11,5284000.0
5284,5284999,21.177997324491315,38.11702316004477,0.09304399902242078,880.1220111846924,358.799791097641,857.629695892334,33688,6146,27542,27542,0,11,5285000.0
5285,5285999,21.178141932388414,38.11613335431421,0.09303211354115004,880.4035732746124,358.8662555217743,857.7792129516602,33693,6148,27545,27545,0,11,5286000.0
5286,5286999,21.178225855711982,38.114822647342315,0.09302244975624285,880.7611086368561,358.9328336715698,857.8552627563477,33723,6151,27572,27572,0,11,5287000.0
5287,5287999,21.178127739010023,38.113390039280745,0.09301039137909806,880.8766405582428,358.99959206581116,858.0306167602539,33723,6151,27572,27572,0,11,5288000.0
5288,5288999,21.176997560749133,38.11211643342252,0.09300101773266256,881.0889043807983,359.07017493247986,858.9509773254395,33770,6152,27618,27618,0,11,5289000.0
5289,5289999,21.17541423207156,38.109937150738176,0.09301172185973083,881.2097220420837,359.13791036605835,859.332836151123,33778,6152,27626,27626,0,11,5290000.0
5290,5290999,21.173804137403003,38.10742567121892,0.09302887215543842,881.3263049125671,359.20476770401,859.6342163085938,33781,6152,27629,27629,0,11,5291000.0
5291,5291999,21.1725484373552,38.1054267993457,0.09303314717790434,881.5303406715393,359.2718629837036,859.859546661377,33786,6153,27633,27633,0,11,5292000.0
5292,5292999,21.17130141014246,38.10330290362431,0.09303766673643943,881.7294433116913,359.3384745121002,860.1954498291016,33790,6154,27636,27636,0,11,5293000.0
5293,5293999,21.169942550382473,38.10146527631069,0.09303788659352497,881.926685333252,359.4048717021942,860.3666114807129,33798,6155,27643,27643,0,11,5294000.0
5294,5294999,21.169018972216232,38.099806152478344,0.09303897252491611,882.1999139785767,359.47238636016846,860.4895553588867,33803,6157,27646,27646,0,11,5295000.0
5295,5295999,21.168023295356274,38.097942700153354,0.09304047136593696,882.3142700195312,359.5387089252472,860.6784553527832,33804,6157,27647,27647,0,11,5296000.0
5296,5296999,21.167070080160627,38.09595301180283,0.09304055789078103,882.5124247074127,359.60518741607666,860.8125686645508,33811,6158,27653,27653,0,11,5297000.0
5297,5297999,21.16650041530047,38.094750807680484,0.09303939514977833,882.7138357162476,359.6734070777893,861.3260345458984,33832,6159,27673,27673,0,11,5298000.0
5298,5298999,21.166196477100065,38.093260974954184,0.09304538294553888,883.0705678462982,359.74120020866394,861.4693336486816,33841,6162,27679,27679,0,11,5299000.0
5299,5299999,21.16559692587996,38.091565638772714,0.09304961695440739,883.4293279647827,359.80900621414185,861.5509605407715,33847,6165,27682,27682,0,11,5300000.0
5300,5300999,21.1652196465534,38.090693172728756,0.09306513064477195,883.7136890888214,359.8767671585083,861.6998023986816,33851,6167,27684,27684,0,11,5301000.0
5301,5301999,21.16478716015823,38.089338510942476,0.09307339706449147,883.9996328353882,359.94446539878845,861.8330574035645,33857,6169,27688,27688,0,11,5302000.0
5302,5302999,21.164180358266382,38.08783928033848,0.0930804669006231,884.19420337677,360.011394739151,862.1749229431152,33865,6170,27695,27695,0,11,5303000.0
5303,5303999,21.16352667812605,38.086141793080586,0.09309511630488387,884.5527062416077,360.07807207107544,862.2623748779297,33873,6173,27700,27700,0,11,5304000.0
5304,5304999,21.162756091840567,38.08396778846411,0.09310416339700689,884.7589976787567,360.1444787979126,862.357795715332,33875,6174,27701,27701,0,11,5305000.0
5305,5305999,21.161490081412353,38.083627085635214,0.09310240571368522,884.9601044654846,360.21448802948,863.195499420166,33914,6175,27739,27739,0,11,5306000.0
5306,5306999,21.160026507504917,38.08298954923536,0.09310995222165719,885.0805644989014,360.28093910217285,863.5247077941895,33919,6175,27744,27744,0,11,5307000.0
5307,5307999,21.158342979517638,38.08036498898333,0.09313342808095115,885.2013785839081,360.3476300239563,863.7653884887695,33923,6175,27748,27748,0,11,5308000.0
5308,5308999,21.15699018025585,38.07889003680134,0.09314880968298334,885.4017174243927,360.41523003578186,864.1072807312012,33940,6176,27764,27764,0,11,5309000.0
5309,5309999,21.15545057308911,38.07638524793721,0.09316628656141046,885.5234868526459,360.48247933387756,864.395923614502,33940,6176,27764,27764,0,11,5310000.0
5310,5310999,21.15388686507802,38.07426222072061,0.09317894333423526,885.6404266357422,360.54843640327454,864.5836601257324,33940,6176,27764,27764,0,11,5311000.0
5311,5311999,21.152432910946214,38.0726237941985,0.09318367291911689,885.8489537239075,360.61612153053284,864.7203979492188,33942,6177,27765,27765,0,11,5312000.0
5312,5312999,21.15097771785189,38.07060104137448,0.09318754908146698,886.2791380882263,360.6834714412689,864.8187255859375,33952,6181,27771,27771,0,11,5313000.0
5313,5313999,21.149758403896683,38.06865686550263,0.09319102340430518,886.3951835632324,360.7501072883606,865.040096282959,33956,6181,27775,27775,0,11,5314000.0
5314,5314999,21.148816326521093,38.067245033204955,0.09318512169780879,886.5868878364563,360.8169574737549,865.3789253234863,33969,6182,27787,27787,0,11,5315000.0
5315,5315999,21.1480597335499,38.066889882634655,0.09317447458155093,886.8618636131287,360.8834309577942,865.5952072143555,33973,6184,27789,27789,0,11,5316000.0
5316,5316999,21.14733918903529,38.06634358312975,0.09316699130819284,887.2214305400848,360.9504518508911,865.7208480834961,33980,6187,27793,27793,0,11,5317000.0
5317,5317999,21.146642946725198,38.06523906102101,0.09315793035773123,887.4172277450562,361.01670932769775,865.8536720275879,33982,6188,27794,27794,0,11,5318000.0
5318,5318999,21.14563524532639,38.06351729730192,0.09315758397481588,887.5315339565277,361.08386421203613,866.0123100280762,33983,6188,27795,27795,0,11,5319000.0
5319,5319999,21.14493449382759,38.0619157151377,0.09315060495074678,887.734815120697,361.15042543411255,866.1506881713867,33987,6189,27798,27798,0,11,5320000.0
5320,5320999,21.14468692524989,38.06117556810355,0.09313627584235418,887.933274269104,361.21741795539856,866.5391311645508,33999,6190,27809,27809,0,11,5321000.0
5321,5321999,21.14430033592748,38.05993731897701,0.09313674627447766,888.1288285255432,361.28341603279114,866.7432518005371,34001,6191,27810,27810,0,11,5322000.0
5322,5322999,21.143604928682883,38.05808260413794,0.09313195330895574,888.4063649177551,361.3505403995514,866.9027709960938,34005,6193,27812,27812,0,11,5323000.0
5323,5323999,21.143019457413782,38.056550630688406,0.09312635807564984,888.6023554801941,361.4166338443756,867.0276069641113,34007,6194,27813,27813,0,11,5324000.0
5324,5324999,21.142217164787578,38.05493151838375,0.09312387308887504,888.7229619026184,361.48393177986145,867.3306427001953,34015,6194,27821,27821,0,11,5325000.0
5325,5325999,21.140705697665624,38.05399791366574,0.09312780182597469,888.9188542366028,361.55021953582764,867.7164726257324,34026,6195,27831,27831,0,11,5326000.0
5326,5326999,21.139320920884387,38.05222693329382,0.09313396306385502,889.1314759254456,361.61602663993835,867.8882827758789,34031,6196,27835,27835,0,11,5327000.0
5327,5327999,21.137902293555907,38.05027456933695,0.09314039208590275,889.3408441543579,361.68134570121765,868.0240058898926,34034,6197,27837,27837,0,11,5328000.0
5328,5328999,21.136608843494006,38.04843616417183,0.09314697955081042,889.5341629981995,361.74633717536926,868.1447143554688,34058,6198,27860,27860,0,11,5329000.0
5329,5329999,21.135476079648885,38.046713871962986,0.09314565121436358,889.8246166706085,361.8125238418579,868.4364318847656,34070,6200,27870,27870,0,11,5330000.0
5330,5330999,21.134233010199306,38.04433411393587,0.0931517278388041,890.1923570632935,361.87842535972595,868.524585723877,34081,6203,27878,27878,0,11,5331000.0
5331,5331999,21.13296701614283,38.04262950273224,0.09315038488928729,890.3885931968689,361.94401478767395,868.6684265136719,34083,6204,27879,27879,0,11,5332000.0
5332,5332999,21.13160785138694,38.04033770891176,0.09315529324664218,890.7461383342743,362.01011848449707,868.6989059448242,34099,6207,27892,27892,0,11,5333000.0
5333,5333999,21.130441324101987,38.038071878012836,0.09316010067583891,890.9476277828217,362.0772316455841,868.8412208557129,34102,6208,27894,27894,0,11,5334000.0
5334,5334999,21.129468877960694,38.036391829468656,0.09315855888604141,891.0651843547821,362.1431064605713,869.0520935058594,34107,6208,27899,27899,0,11,5335000.0
5335,5335999,21.12828676641133,38.034503535982246,0.09315900971287783,891.2744410037994,362.2093894481659,869.2652168273926,34115,6209,27906,27906,0,11,5336000.0
5336,5336999,21.1274359921938,38.03268680238628,0.09315771771812809,891.555520772934,362.2744355201721,869.3829078674316,34119,6211,27908,27908,0,11,5337000.0
5337,5337999,21.12633071767969,38.030523506681746,0.09316067060198774,891.758766412735,362.34000277519226,869.6057739257812,34130,6212,27918,27918,0,11,5338000.0
5338,5338999,21.125604737606526,38.02935958215446,0.09315678617583545,891.9658823013306,362.4056980609894,869.7665138244629,34133,6213,27920,27920,0,11,5339000.0
5339,5339999,21.12481527413113,38.027695171385886,0.09315313566031569,892.1714894771576,362.4716956615448,869.8957443237305,34135,6214,27921,27921,0,11,5340000.0
5340,5340999,21.124245061256072,38.026427071592174,0.09315021283520442,892.2987160682678,362.5368492603302,870.0302352905273,34135,6214,27921,27921,0,11,5341000.0
5341,5341999,21.12369753641281,38.02501199181621,0.09314500603389908,892.4962499141693,362.60219526290894,870.254322052002,34146,6215,27931,27931,0,11,5342000.0
5342,5342999,21.12352432930863,38.02565842868758,0.09313115270823225,892.6869630813599,362.6665368080139,870.3570327758789,34148,6216,27932,27932,0,11,5343000.0
5343,5343999,21.122919659022255,38.02393209726749,0.09313095798551874,892.9858214855194,362.73201036453247,870.4449195861816,34154,6218,27936,27936,0,11,5344000.0
5344,5344999,21.121807646935718,38.02158450401355,0.09313472883241047,893.1866862773895,362.7969353199005,870.5250968933105,34156,6219,27937,27937,0,11,5345000.0
5345,5345999,21.12081729820493,38.01938912241041,0.09313972566931972,893.4744770526886,362.8646285533905,870.999828338623,34186,6221,27965,27965,0,11,5346000.0
5346,5346999,21.119214805177812,38.01737233501418,0.09314738441085002,893.5943200588226,362.93098640441895,871.4151268005371,34194,6221,27973,27973,0,11,5347000.0
5347,5347999,21.117333636605007,38.014397459428636,0.09315830332491948,893.7111320495605,362.99738073349,871.6757888793945,34197,6221,27976,27976,0,11,5348000.0
5348,5348999,21.115618159070873,38.011710028701216,0.0931693161898296,893.8276271820068,363.0633633136749,871.8784103393555,34198,6221,27977,27977,0,11,5349000.0
5349,5349999,21.1141373463464,38.009782333250904,0.09317368289790373,894.0235967636108,363.12929487228394,872.0206031799316,34202,6222,27980,27980,0,11,5350000.0
5350,5350999,21.112871357064524,38.00795052527892,0.09317105429696126,894.1427655220032,363.1959571838379,872.4408302307129,34208,6222,27986,27986,0,11,5351000.0
5351,5351999,21.11172125629061,38.005751723493916,0.09317703142209643,894.4157147407532,363.26217436790466,872.5915832519531,34217,6224,27993,27993,0,11,5352000.0
5352,5352999,21.110483798536176,38.003996316090316,0.09318054385636487,894.7704668045044,363.32896089553833,872.7833442687988,34227,6227,28000,28000,0,11,5353000.0
5353,5353999,21.110817025392855,38.006614932858156,0.0931699650900063,894.9817852973938,363.404456615448,873.0098991394043,34254,6228,28026,28026,0,11,5354000.0
5354,5354999,21.111127357162665,38.0072928115689,0.09316645217118402,895.2650744915009,363.47139954566956,873.2417068481445,34266,6230,28036,28036,0,11,5355000.0
5355,5355999,21.111616552662902,38.008319126350194,0.09316182589462318,895.3921573162079,363.5418360233307,873.6432952880859,34277,6230,28047,28047,0,11,5356000.0
5356,5356999,21.112914222688495,38.010477727067396,0.09313883603156037,895.5026054382324,363.60800337791443,874.0044250488281,34279,6230,28049,28049,0,11,5357000.0
5357,5357999,21.114246747808746,38.012494827358516,0.09313648555387555,895.6138253211975,363.67344903945923,874.235954284668,34280,6230,28050,28050,0,11,5358000.0
5358,5358999,21.116174606398083,38.01530032579314,0.09313457807328474,895.9800939559937,363.74030447006226,874.3738899230957,34289,6233,28056,28056,0,11,5359000.0
5359,5359999,21.117952276776975,38.01803814598006,0.09314370918351944,896.2587425708771,363.8072302341461,874.5234985351562,34294,6235,28059,28059,0,11,5360000.0
5360,5360999,21.119772521254717,38.020061622754326,0.09315562572273894,896.464563369751,363.87406730651855,874.7574653625488,34299,6236,28063,28063,0,11,5361000.0
5361,5361999,21.121625707202718,38.02259529997139,0.09313924680636532,896.5771498680115,363.94113302230835,875.2666053771973,34312,6236,28076,28076,0,11,5362000.0
5362,5362999,21.12383269436168,38.024874636489386,0.09314074394461258,896.7733161449432,364.0066006183624,875.4617576599121,34316,6237,28079,28079,0,11,5363000.0
5363,5363999,21.125259394883514,38.02585825683952,0.09314389208101026,897.0451114177704,364.072217464447,875.5925636291504,34320,6239,28081,28081,0,11,5364000.0
5364,5364999,21.12569751311014,38.02500973598878,0.09316106091141196,897.2475197315216,364.1380400657654,875.7728881835938,34322,6240,28082,28082,0,11,5365000.0
5365,5365999,21.125200712343958,38.02357991323169,0.09315103808197134,897.4500644207001,364.2112772464752,876.2917289733887,34340,6241,28099,28099,0,11,5366000.0
5366,5366999,21.123535237966177,38.02147082813275,0.09315919645067139,897.5600552558899,364.27627205848694,876.5792465209961,34342,6241,28101,28101,0,11,5367000.0
5367,5367999,21.12196326908225,38.019174290581624,0.09316482296147122,897.8445360660553,364.3433246612549,876.8073234558105,34354,6243,28111,28111,0,11,5368000.0
5368,5368999,21.12055070930501,38.017161753675474,0.0931732480470272,898.1151390075684,364.4092619419098,876.9809074401855,34359,6245,28114,28114,0,11,5369000.0
5369,5369999,21.11923573052965,38.01550391210382,0.09317146732155157,898.3903293609619,364.4753758907318,877.2676200866699,34375,6247,28128,28128,0,11,5370000.0
5370,5370999,21.117939100424987,38.01331549779059,0.0931736859590303,898.6002278327942,364.5418484210968,877.5010528564453,34377,6248,28129,28129,0,11,5371000.0
5371,5371999,21.11654210877457,38.01108622925217,0.09317937319728797,898.8007347583771,364.6078231334686,877.6695289611816,34379,6249,28130,28130,0,11,5372000.0
5372,5372999,21.11512816554585,38.008868880219204,0.09318507478701943,899.0849666595459,364.67345237731934,877.7316627502441,34383,6251,28132,28132,0,11,5373000.0
5373,5373999,21.113715859162383,38.006424676330624,0.0931917249822225,899.2813358306885,364.73901629447937,877.8746147155762,34386,6252,28134,28134,0,11,5374000.0
5374,5374999,21.11257891076992,38.00498476922075,0.09319127073596145,899.5673832893372,364.80627274513245,877.9454498291016,34393,6254,28139,28139,0,11,5375000.0
5375,5375999,21.11136398954851,38.00287692577452,0.09318696940447735,899.6821644306183,364.8724944591522,878.2710609436035,34401,6254,28147,28147,0,11,5376000.0
5376,5376999,21.110399175830747,38.001000585982254,0.09318597134844053,899.8954925537109,364.93810749053955,878.4600639343262,34404,6255,28149,28149,0,11,5377000.0
5377,5377999,21.10973590692171,37.99970286869706,0.09317477716618594,900.0068197250366,365.0038251876831,878.5976753234863,34404,6255,28149,28149,0,11,5378000.0
5378,5378999,21.108800416192157,37.99784533503788,0.09316645183614047,900.2062001228333,365.06936955451965,878.7117958068848,34406,6256,28150,28150,0,11,5379000.0
5379,5379999,21.108122151025658,37.99600835985987,0.09315660008435411,900.4887404441833,365.1356248855591,878.7332382202148,34412,6258,28154,28154,0,11,5380000.0
5380,5380999,21.107656507461108,37.99485790892902,0.09314669911257911,900.8557415008545,365.20215582847595,878.7904853820801,34428,6261,28167,28167,0,11,5381000.0
5381,5381999,21.10726310372771,37.993626447118714,0.09314326188620192,900.9806697368622,365.2680287361145,879.2178993225098,34439,6261,28178,28178,0,11,5382000.0
5382,5382999,21.107094426494793,37.99249421655093,0.09313496702632407,901.0949544906616,365.33365869522095,879.4609222412109,34439,6261,28178,28178,0,11,5383000.0
5383,5383999,21.10678935086829,37.99101633877302,0.09313655453043668,901.3777062892914,365.3997070789337,879.622184753418,34443,6263,28180,28180,0,11,5384000.0
5384,5384999,21.106609517639562,37.98976814917178,0.09314040638741794,901.5796356201172,365.4657759666443,879.7491722106934,34445,6264,28181,28181,0,11,5385000.0
5385,5385999,21.10601926238992,37.98790041651298,0.09314691674075415,901.7850441932678,365.533474445343,880.2857093811035,34472,6265,28207,28207,0,11,5386000.0
5386,5386999,21.104683084421044,37.986378806345265,0.09315032510789001,901.8962268829346,365.60073256492615,880.6953010559082,34479,6265,28214,28214,0,11,5387000.0
5387,5387999,21.103158329297447,37.98465304223511,0.09315183067916921,902.014169216156,365.66716170310974,881.026180267334,34486,6265,28221,28221,0,11,5388000.0
5388,5388999,21.10210198021738,37.98772881499504,0.0931308074350401,902.2169644832611,365.73356580734253,881.2474212646484,34491,6266,28225,28225,0,11,5389000.0
5389,5389999,21.10087640271028,37.98565149628236,0.09312385273828017,902.3320033550262,365.8006193637848,881.4425468444824,34492,6266,28226,28226,0,11,5390000.0
5390,5390999,21.0999820868281,37.983770574152224,0.09311162247482352,902.5320217609406,365.86757493019104,881.8623580932617,34506,6267,28239,28239,0,11,5391000.0
5391,5391999,21.09891165336235,37.98154447217058,0.0931126219612779,902.7287912368774,365.93350863456726,882.0880470275879,34510,6268,28242,28242,0,11,5392000.0
5392,5392999,21.098012536586218,37.97988484987658,0.09310637709424607,903.0961427688599,366.00053334236145,882.1592063903809,34523,6271,28252,28252,0,11,5393000.0
5393,5393999,21.096982045993062,37.97785664904645,0.09310659121181741,903.3755638599396,366.0673940181732,882.3272933959961,34535,6273,28262,28262,0,11,5394000.0
5394,5394999,21.09599560357703,37.97583811592849,0.09310377406581616,903.7289209365845,366.13434886932373,882.4509429931641,34550,6276,28274,28274,0,11,5395000.0
5395,5395999,21.095503003290784,37.97464405061103,0.09309491550925186,903.8454682826996,366.20076513290405,882.7255706787109,34556,6276,28280,28280,0,11,5396000.0
5396,5396999,21.09510508497705,37.97402788528161,0.09307820531102495,904.128960609436,366.2690737247467,883.193717956543,34581,6278,28303,28303,0,11,5397000.0
5397,5397999,21.09482835389971,37.97289175454776,0.09307488398326957,904.4143648147583,366.33603954315186,883.4014167785645,34594,6280,28314,28314,0,11,5398000.0
5398,5398999,21.09471094466489,37.971817588234515,0.09306914119002896,904.5346791744232,366.40232825279236,883.6101341247559,34595,6280,28315,28315,0,11,5399000.0
5399,5399999,21.09505816696013,37.97214698102341,0.09306760067176056,904.8164792060852,366.4694724082947,883.7419662475586,34600,6282,28318,28318,0,11,5400000.0
5400,5400999,21.095769236687858,37.97568636305797,0.09306948118505665,905.1042976379395,366.53694581985474,883.8586158752441,34608,6284,28324,28324,0,11,5401000.0
5401,5401999,21.098037430832576,37.98692210570226,0.09302895383020782,905.2261173725128,366.60479950904846,884.0970039367676,34608,6284,28324,28324,0,11,5402000.0
5402,5402999,21.100036441407827,37.990607825611114,0.09303197943553176,905.3488340377808,366.670884847641,884.437442779541,34614,6284,28330,28330,0,11,5403000.0
5403,5403999,21.102324089298858,37.994529962494354,0.09306658491207631,905.4641788005829,366.73590183258057,884.6099319458008,34614,6284,28330,28330,0,11,5404000.0
5404,5404999,21.104348714300006,37.99681705292366,0.09307561383889773,905.8273525238037,366.80173778533936,884.6189613342285,34627,6287,28340,28340,0,11,5405000.0
5405,5405999,21.106168676464968,37.99874251774894,0.09309317387074645,906.1049268245697,366.8684847354889,884.7156105041504,34631,6289,28342,28342,0,11,5406000.0
5406,5406999,21.10642848665599,37.99942536729028,0.09309265832076441,906.306914806366,366.9369525909424,885.3275451660156,34661,6290,28371,28371,0,11,5407000.0
5407,5407999,21.10490326988128,38.00358363481487,0.09306190295170913,906.425684928894,367.0040514469147,885.6370658874512,34667,6290,28377,28377,0,11,5408000.0
5408,5408999,21.10351381156885,38.00240471318521,0.0930514759969765,906.5499324798584,367.0701048374176,885.8836402893066,34670,6290,28380,28380,0,11,5409000.0
5409,5409999,21.101893390199837,38.00002346000908,0.09305927790907043,906.8313167095184,367.13646245002747,885.9768714904785,34701,6292,28409,28409,0,11,5410000.0
5410,5410999,21.100448718348975,37.998043916241805,0.0930580693053058,907.027801990509,367.2025537490845,886.0888786315918,34710,6293,28417,28417,0,11,5411000.0
5411,5411999,21.09912340545857,37.99593972526283,0.0930564914794727,907.3126649856567,367.2696998119354,886.4703216552734,34721,6295,28426,28426,0,11,5412000.0
5412,5412999,21.097559625904168,37.99335311740825,0.09305937244752116,907.4290170669556,367.3358197212219,886.6917953491211,34722,6295,28427,28427,0,11,5413000.0
5413,5413999,21.09622287425969,37.99178780575679,0.09305838992703952,907.7838344573975,367.4041292667389,886.8214721679688,34730,6298,28432,28432,0,11,5414000.0
5414,5414999,21.094991332210647,37.99004135659556,0.09305863433319639,907.9806261062622,367.4712162017822,886.9687843322754,34733,6299,28434,28434,0,11,5415000.0
5415,5415999,21.093648688904867,37.98781545234796,0.09305845230865206,908.1884574890137,367.53882360458374,887.155818939209,34738,6300,28438,28438,0,11,5416000.0
5416,5416999,21.092561639357108,37.98607102766095,0.09305866068087087,908.3922486305237,367.60578894615173,887.2801780700684,34746,6301,28445,28445,0,11,5417000.0
5417,5417999,21.091683067225386,37.98399743285709,0.09305517758897675,908.6775829792023,367.67368936538696,887.5634002685547,34758,6303,28455,28455,0,11,5418000.0
5418,5418999,21.090905286419183,37.98220546221835,0.0930516904701898,908.9603929519653,367.74052023887634,887.7412033081055,34763,6305,28458,28458,0,11,5419000.0
5419,5419999,21.090335777271207,37.98122641076588,0.09304894124389163,909.2419059276581,367.80715918540955,887.8278694152832,34767,6307,28460,28460,0,11,5420000.0
5420,5420999,21.089964489188723,37.9799080458845,0.09303803281939749,909.4327867031097,367.8731756210327,887.9516525268555,34770,6308,28462,28462,0,11,5421000.0
5421,5421999,21.089937948593285,37.97986655518217,0.09302614140467746,909.7237322330475,367.9411344528198,888.0171356201172,34776,6310,28466,28466,0,11,5422000.0
5422,5422999,21.08982748231385,37.97908555910704,0.09302385386004386,910.0162725448608,368.00781416893005,888.1360702514648,34781,6312,28469,28469,0,11,5423000.0
5423,5423999,21.0902086309193,37.979014517604924,0.0930032376188864,910.1416509151459,368.07653975486755,888.7894020080566,34805,6312,28493,28493,0,11,5424000.0
5424,5424999,21.09062486284837,37.978492568853845,0.09298426779744151,910.2686274051666,368.1427352428436,889.0201263427734,34805,6312,28493,28493,0,11,5425000.0
5425,5425999,21.091216043221728,37.978392953096446,0.09297699590042852,910.3804364204407,368.2087049484253,889.2086524963379,34807,6312,28495,28495,0,11,5426000.0
5426,5426999,21.091065700334504,37.97699855905987,0.09297256575704538,910.8221938610077,368.2756652832031,889.278980255127,34820,6316,28504,28504,0,11,5427000.0
5427,5427999,21.090232567091082,37.97517405812325,0.09297292145583125,910.955812215805,368.34579944610596,890.0424957275391,34854,6316,28538,28538,0,11,5428000.0
5428,5428999,21.088789576295962,37.97362556610405,0.09298221516087735,911.0820910930634,368.41402196884155,890.5447883605957,34867,6316,28551,28551,0,11,5429000.0
5429,5429999,21.087176173870166,37.971565789249205,0.09299708291808739,911.280923128128,368.48063588142395,890.7801895141602,34875,6317,28558,28558,0,11,5430000.0
5430,5430999,21.0856278254237,37.96942098045923,0.09301103135353761,911.4006955623627,368.54669880867004,890.9605026245117,34877,6317,28560,28560,0,11,5431000.0
5431,5431999,21.084167210031044,37.967074463206885,0.09301880115642458,911.5241098403931,368.61410427093506,891.3258018493652,34883,6317,28566,28566,0,11,5432000.0
5432,5432999,21.082773540174276,37.96450244158227,0.09302730570631357,911.719423532486,368.6806175708771,891.4698257446289,34885,6318,28567,28567,0,11,5433000.0
5433,5433999,21.081430987362975,37.96291148868576,0.09303517912637671,911.8404040336609,368.7468183040619,891.6445922851562,34885,6318,28567,28567,0,11,5434000.0
5434,5434999,21.080126087107423,37.96064589110393,0.09304165680476295,911.952550649643,368.8130714893341,891.805061340332,34887,6318,28569,28569,0,11,5435000.0
5435,5435999,21.079076359331886,37.9626779014742,0.0930263085987002,912.1544630527496,368.87964248657227,891.9286880493164,34891,6319,28572,28572,0,11,5436000.0
5436,5436999,21.07782078457805,37.960523704341156,0.09303244308376601,912.5194563865662,368.9472761154175,892.1380729675293,34914,6322,28592,28592,0,11,5437000.0
5437,5437999,21.077020254142237,37.9587548621047,0.0930269572681296,912.809079170227,369.0149223804474,892.4177169799805,34940,6324,28616,28616,0,11,5438000.0
5438,5438999,21.07603790198006,37.956607002872715,0.09302370754324252,913.012882232666,372.0279998779297,892.5761833190918,34943,6325,28618,28618,0,11,5439000.0
5439,5439999,21.075123476689594,37.9546227828889,0.0930242848275814,913.468549489975,372.0956447124481,892.6089973449707,34953,6329,28624,28624,0,11,5440000.0
5440,5440999,21.074203786994346,37.952576412490444,0.09302652924328214,913.604884147644,372.16316986083984,892.8676338195801,34955,6329,28626,28626,0,11,5441000.0
5441,5441999,21.073222201572943,37.9503221889124,0.09303203586177189,913.8994133472443,372.23118829727173,893.1298637390137,34967,6331,28636,28636,0,11,5442000.0
5442,5442999,21.0719289787582,37.947824269934756,0.09304549878717117,914.0994555950165,372.2977259159088,893.3566207885742,34970,6332,28638,28638,0,11,5443000.0
5443,5443999,21.070682019870137,37.945422712753356,0.09305701411671008,914.3912100791931,372.36494851112366,893.4963493347168,34974,6334,28640,28640,0,11,5444000.0
5444,5444999,21.069601480275402,37.94367702241368,0.0930644727719514,914.6001105308533,372.434645652771,894.1888847351074,35010,6335,28675,28675,0,11,5445000.0
5445,5445999,21.06802578228666,37.941276722231336,0.09307420553154333,914.7174770832062,372.5040044784546,894.6176490783691,35017,6335,28682,28682,0,11,5446000.0
5446,5446999,21.06661448693452,37.93953423914039,0.09308354484814396,914.8497107028961,372.5716254711151,894.9042282104492,35020,6335,28685,28685,0,11,5447000.0
5447,5447999,21.065526726920435,37.94327425939375,0.09308014547948018,915.1413414478302,372.63913798332214,895.0523948669434,35026,6337,28689,28689,0,11,5448000.0
5448,5448999,21.064529867728858,37.942836887011815,0.0930784954871624,915.44761967659,372.70839619636536,895.4427871704102,35088,6339,28749,28749,0,11,5449000.0
5449,5449999,21.063122865686207,37.94022487055696,0.09308767205445101,915.6639404296875,372.7771599292755,895.6919174194336,35090,6340,28750,28750,0,11,5450000.0
5450,5450999,21.061713332435914,37.93801263186722,0.0930924403545016,915.9562668800354,372.84466195106506,895.8353462219238,35094,6342,28752,28752,0,11,5451000.0
5451,5451999,21.06045641753323,37.936286660964214,0.09309536785000982,916.259105682373,372.91279768943787,895.9467582702637,35100,6344,28756,28756,0,11,5452000.0
5452,5452999,21.059157324677198,37.93395743610916,0.093100427006235,916.3789277076721,372.98042249679565,896.2272911071777,35106,6344,28762,28762,0,11,5453000.0
5453,5453999,21.05783490625976,37.93200058583734,0.09310156085989774,916.5002417564392,373.0484480857849,896.3972091674805,35107,6344,28763,28763,0,11,5454000.0
5454,5454999,21.05717718024777,37.930611780948446,0.09309362138159627,916.6288094520569,373.11664628982544,896.8644638061523,35118,6344,28774,28774,0,11,5455000.0
5455,5455999,21.056505624983828,37.92896076030606,0.09309410551963915,916.8436503410339,373.18430042266846,897.0562477111816,35120,6345,28775,28775,0,11,5456000.0
5456,5456999,21.055942432321658,37.92748503901694,0.0930858869228045,917.2155563831329,373.2518701553345,897.1851539611816,35127,6348,28779,28779,0,11,5457000.0
5457,5457999,21.055313412041563,37.9261062157735,0.0930803071224463,917.5189101696014,373.319864988327,897.3248863220215,35132,6350,28782,28782,0,11,5458000.0
5458,5458999,21.055162168712723,37.92688378182192,0.09307039574303777,917.81640791893,373.3881974220276,897.448356628418,35142,6352,28790,28790,0,11,5459000.0
5459,5459999,21.054847048098964,37.92728911376859,0.09306465694067145,918.0214531421661,373.4554748535156,897.5819396972656,35144,6353,28791,28791,0,11,5460000.0
5460,5460999,21.05495360565043,37.92713391219076,0.09304868828958801,918.149466753006,373.5233452320099,898.0098342895508,35153,6353,28800,28800,0,11,5461000.0
5461,5461999,21.055067452884316,37.926341436025204,0.09304976175920221,918.4473392963409,373.59165501594543,898.1698799133301,35163,6355,28808,28808,0,11,5462000.0
5462,5462999,21.054660710525987,37.92508502155642,0.09304550738259865,918.6510503292084,373.65847182273865,898.3007278442383,35165,6356,28809,28809,0,11,5463000.0
5463,5463999,21.054262574070016,37.92375415769329,0.09304426151350431,918.9359698295593,373.7256016731262,898.4410514831543,35173,6358,28815,28815,0,11,5464000.0
5464,5464999,21.053569317776383,37.92505676341675,0.09303384427950845,919.1526525020599,373.7961299419403,899.0147399902344,35198,6359,28839,28839,0,11,5465000.0
5465,5465999,21.051904964463393,37.9228658594389,0.09303933867987202,919.2746031284332,373.8624451160431,899.4765625,35214,6359,28855,28855,0,11,5466000.0
5466,5466999,21.050372422248127,37.920783647363336,0.09304227140547294,919.5673289299011,373.9294159412384,899.7322044372559,35228,6361,28867,28867,0,11,5467000.0
5467,5467999,21.049019586559186,37.919406373857065,0.09304529949470808,919.6953537464142,373.99569845199585,899.9830627441406,35234,6361,28873,28873,0,11,5468000.0
5468,5468999,21.04750149162619,37.916904597307834,0.09305041671592806,919.9061126708984,374.06439685821533,900.1392250061035,35238,6362,28876,28876,0,11,5469000.0
5469,5469999,21.046339681782797,37.91517364623771,0.09303678733583343,920.0232684612274,374.13001322746277,900.4745712280273,35245,6362,28883,28883,0,11,5470000.0
5470,5470999,21.04510120998591,37.91325482893664,0.09303786798222713,920.3253231048584,374.19644236564636,900.5814056396484,35250,6364,28886,28886,0,11,5471000.0
5471,5471999,21.04380317528352,37.911040217058485,0.0930411913803516,920.6315729618073,374.26366806030273,900.6682777404785,35254,6366,28888,28888,0,11,5472000.0
5472,5472999,21.042621252375433,37.90902366640587,0.09304113635122957,920.8331320285797,374.33243799209595,900.7892189025879,35257,6367,28890,28890,0,11,5473000.0
5473,5473999,21.041635265815913,37.90737312321536,0.09303894276644886,921.1330041885376,374.3990671634674,900.9432601928711,35275,6369,28906,28906,0,11,5474000.0
5474,5474999,21.040360374334714,37.90508672396575,0.09304037515288732,921.3339879512787,374.4652292728424,901.1065711975098,35279,6370,28909,28909,0,11,5475000.0
5475,5475999,21.03970025077378,37.903356709483774,0.09303605832063555,921.4627578258514,374.5314824581146,901.4589881896973,35285,6370,28915,28915,0,11,5476000.0
5476,5476999,21.038743082922416,37.901419106107156,0.0930361966006873,921.6709136962891,374.5993947982788,901.6070747375488,35288,6371,28917,28917,0,11,5477000.0
5477,5477999,21.03789257075107,37.90046045481534,0.0930339594031061,921.9661686420441,374.666184425354,901.7494430541992,35296,6373,28923,28923,0,11,5478000.0
5478,5478999,21.037085268075018,37.898585660659165,0.0930328238882181,922.1686854362488,374.7326250076294,901.9063987731934,35299,6374,28925,28925,0,11,5479000.0
5479,5479999,21.036252860453253,37.89693434633984,0.09302869730339336,922.4571719169617,374.7995617389679,902.0381507873535,35303,6376,28927,28927,0,11,5480000.0
5480,5480999,21.03536678981685,37.8950744384532,0.09303105721146732,922.5814592838287,374.86555457115173,902.188907623291,35303,6376,28927,28927,0,11,5481000.0
5481,5481999,21.03455123906395,37.89310515224852,0.09302935247983302,922.7795996665955,374.932003736496,902.4532356262207,35310,6377,28933,28933,0,11,5482000.0
5482,5482999,21.03380731236353,37.89148018069691,0.09302325513410825,923.0698862075806,374.99806094169617,902.5771293640137,35314,6379,28935,28935,0,11,5483000.0
5483,5483999,21.032711562814352,37.889335425106204,0.09302080466720097,923.351634979248,375.06401228904724,902.6548538208008,35319,6381,28938,28938,0,11,5484000.0
5484,5484999,21.03147467977672,37.886926508104935,0.09302098956549976,923.735036611557,375.1322157382965,902.7274284362793,35327,6384,28943,28943,0,11,5485000.0
5485,5485999,21.030846643420524,37.88548809615214,0.09301123234373154,924.0236778259277,375.20136046409607,903.4601173400879,35387,6386,29001,29001,0,11,5486000.0
5486,5486999,21.029074698621564,37.882800911376755,0.0930233355858503,924.1365208625793,375.2677311897278,903.7964401245117,35393,6386,29007,29007,0,11,5487000.0
5487,5487999,21.02790242880112,37.88340327494512,0.09300982027781735,924.2625358104706,375.3338396549225,904.0967559814453,35399,6386,29013,29013,0,11,5488000.0
5488,5488999,21.02649885554992,37.88113781486347,0.09301661623823865,924.377049446106,375.39976024627686,904.2899971008301,35401,6386,29015,29015,0,11,5489000.0
5489,5489999,21.025493302903623,37.87953650186714,0.09301456964942334,924.5764994621277,375.4658188819885,904.5300331115723,35408,6387,29021,29021,0,11,5490000.0
5490,5490999,21.02492602433282,37.8787011570464,0.09300681041079673,924.7808237075806,375.5315737724304,904.8640899658203,35416,6388,29028,29028,0,11,5491000.0
5491,5491999,21.023955761926032,37.876605377341214,0.0930084829156117,925.1528072357178,375.5988895893097,904.9139137268066,35423,6391,29032,29032,0,11,5492000.0
5492,5492999,21.02317827245424,37.875182531014836,0.09300925987510178,925.2741796970367,375.6644968986511,905.1297721862793,35424,6391,29033,29033,0,11,5493000.0
5493,5493999,21.022302779226482,37.87332495587036,0.09301469771017234,925.3985629081726,375.7299065589905,905.299560546875,35425,6391,29034,29034,0,11,5494000.0
5494,5494999,21.02173636187858,37.871699299085165,0.09301546810477479,925.6767284870148,375.7960901260376,905.4327239990234,35441,6393,29048,29048,0,11,5495000.0
5495,5495999,21.02130421500636,37.870492776731105,0.09300815237871296,925.8855693340302,375.8649580478668,905.8007698059082,35453,6394,29059,29059,0,11,5496000.0
5496,5496999,21.021089477799784,37.86951931791417,0.09300820333529769,926.0910675525665,375.930433511734,906.0436248779297,35457,6395,29062,29062,0,11,5497000.0
5497,5497999,21.020603477633085,37.86819460596365,0.09301014018744691,926.3786392211914,375.9961497783661,906.1851196289062,35469,6397,29072,29072,0,11,5498000.0
5498,5498999,21.020204638795494,37.866917224408574,0.0930080311802044,926.6628713607788,376.0627820491791,906.2984580993652,35473,6399,29074,29074,0,11,5499000.0
5499,5499999,21.02012880179129,37.86877879201535,0.09299581691236114,926.7783935070038,376.12786746025085,906.4894485473633,35475,6399,29076,29076,0,11,5500000.0
5500,5500999,21.019901057008827,37.874863048569964,0.09297535589833728,926.9863636493683,376.1935098171234,906.599308013916,35479,6400,29079,29079,0,11,5501000.0
5501,5501999,21.019449846008005,37.873648271836025,0.09296977452537591,927.1892242431641,376.2597379684448,906.9839210510254,35493,6401,29092,29092,0,11,5502000.0
5502,5502999,21.01933128344257,37.8722967225133,0.09296024583084106,927.3851931095123,376.32486152648926,907.187255859375,35495,6402,29093,29093,0,11,5503000.0
5503,5503999,21.018791015030136,37.87055835276947,0.09295232318491709,927.501797914505,376.3900282382965,907.4218673706055,35496,6402,29094,29094,0,11,5504000.0
5504,5504999,21.0180786347205,37.868419442134154,0.09295238030193465,927.7820093631744,376.4554920196533,907.4883804321289,35500,6404,29096,29096,0,11,5505000.0
5505,5505999,21.01719643299861,37.86636021856823,0.09295571716597562,927.9915208816528,376.521360874176,907.8763732910156,35510,6405,29105,29105,0,11,5506000.0
5506,5506999,21.015584408237462,37.86430135020823,0.0929602073373319,928.1038026809692,376.58588433265686,908.1309432983398,35511,6405,29106,29106,0,11,5507000.0
5507,5507999,21.0140906582934,37.86253056334747,0.09296296505130874,928.2309136390686,376.65155816078186,908.3545455932617,35516,6405,29111,29111,0,11,5508000.0
5508,5508999,21.01275054753118,37.860450070330664,0.09297046191813396,928.3485913276672,376.71610617637634,908.4835319519043,35517,6405,29112,29112,0,11,5509000.0
5509,5509999,21.011404234038114,37.85828394921219,0.09297737368111336,928.4700994491577,376.7815897464752,908.6104965209961,35518,6405,29113,29113,0,11,5510000.0
5510,5510999,21.0099038309043,37.85568306567993,0.09298361207206585,928.9295547008514,376.84783029556274,908.8830986022949,35537,6409,29128,29128,0,11,5511000.0
5511,5511999,21.008336434904212,37.853082780108394,0.09299174237560104,929.0472085475922,376.91296553611755,909.1151924133301,35540,6409,29131,29131,0,11,5512000.0
5512,5512999,21.00684704837514,37.85091210870818,0.09299876598286738,929.2453038692474,376.9787962436676,909.2024841308594,35542,6410,29132,29132,0,11,5513000.0
5513,5513999,21.005343095917826,37.84837116575331,0.0930047674715504,929.4608557224274,377.0443072319031,909.3586578369141,35546,6411,29135,29135,0,11,5514000.0
5514,5514999,21.003959175873966,37.84578498486656,0.09301325415438244,929.5832357406616,377.10910415649414,909.5309219360352,35549,6411,29138,29138,0,11,5515000.0
5515,5515999,21.003260308336888,37.86008718845251,0.09294296126797463,929.7094578742981,377.17395067214966,909.6694526672363,35551,6411,29140,29140,0,11,5516000.0
5516,5516999,21.002226081971333,37.85787185618615,0.09294311996383509,930.010776758194,377.24004578590393,909.8954124450684,35562,6413,29149,29149,0,11,5517000.0
5517,5517999,21.001270058793757,37.85584013724444,0.09294362140922185,930.2054822444916,377.30532717704773,910.0388259887695,35564,6414,29150,29150,0,11,5518000.0
5518,5518999,21.00010237803277,37.853690281323395,0.0929440089501552,930.5005970001221,377.370400428772,910.0920562744141,35568,6416,29152,29152,0,11,5519000.0
5519,5519999,20.99928715245969,37.853380581459696,0.09293547565111016,930.7841465473175,377.4356758594513,910.1995964050293,35573,6418,29155,29155,0,11,5520000.0
5520,5520999,20.99865668405615,37.85214948424254,0.09293120048020376,930.9934964179993,377.5012583732605,910.3053436279297,35577,6419,29158,29158,0,11,5521000.0
5521,5521999,20.998040081538132,37.85102031012382,0.09293214061815014,931.2089939117432,377.566415309906,910.4267807006836,35585,6420,29165,29165,0,11,5522000.0
5522,5522999,20.99738596178939,37.84938518899963,0.09293052992162087,931.4111278057098,377.63197088241577,910.7463493347168,35595,6421,29174,29174,0,11,5523000.0
5523,5523999,20.99676732652224,37.84782529270653,0.09293485935683499,931.6128771305084,377.69645142555237,910.8167266845703,35600,6422,29178,29178,0,11,5524000.0
5524,5524999,20.9960461920315,37.84611460118823,0.09293593178656645,931.894935131073,377.7614834308624,910.9345359802246,35604,6424,29180,29180,0,11,5525000.0
5525,5525999,20.995058042466194,37.84395139480149,0.09293832588808415,932.1811232566833,377.8274655342102,911.0181465148926,35608,6426,29182,29182,0,11,5526000.0
5526,5526999,20.994026694669184,37.842128768988985,0.09293748151706804,932.3875975608826,377.89499163627625,911.7453994750977,35630,6427,29203,29203,0,11,5527000.0
5527,5527999,20.99258535794561,37.84002538027611,0.09293737427893001,932.5076818466187,377.96219515800476,912.0930824279785,35634,6427,29207,29207,0,11,5528000.0
5528,5528999,20.991269365255555,37.83822320927961,0.09293884482431669,932.7090682983398,378.02849078178406,912.4012832641602,35642,6428,29214,29214,0,11,5529000.0
5529,5529999,20.99000498144743,37.83612127779975,0.09294870578988335,932.8209807872772,378.0943269729614,912.6287384033203,35644,6428,29216,29216,0,11,5530000.0
5530,5530999,20.988899435671744,37.83599435072578,0.09293996106661351,932.9321267604828,378.1609914302826,912.8243446350098,35646,6428,29218,29218,0,11,5531000.0
5531,5531999,20.987683069724827,37.8339486764921,0.09294101734015303,933.2203764915466,378.2249186038971,913.0966453552246,35663,6430,29233,29233,0,11,5532000.0
5532,5532999,20.986403536100745,37.831673953221085,0.09294418683269523,933.4907960891724,378.28979897499084,913.2374725341797,35675,6432,29243,29243,0,11,5533000.0
5533,5533999,20.985142960769924,37.829759514303085,0.09294601123019997,933.6824309825897,378.35230803489685,913.3756675720215,35678,6433,29245,29245,0,11,5534000.0
5534,5534999,20.98387752754862,37.827489360757106,0.09294889483024638,933.9083361625671,378.4286279678345,913.5367660522461,35681,6434,29247,29247,0,11,5535000.0
5535,5535999,20.982993702531598,37.825667594844994,0.0929481128235774,934.1790885925293,378.4919767379761,913.6970634460449,35696,6436,29260,29260,0,11,5536000.0
5536,5536999,20.98219135072703,37.824013306890706,0.09294428169150326,934.4617834091187,378.5566437244415,913.806957244873,35704,6438,29266,29266,0,11,5537000.0
5537,5537999,20.98143126541205,37.822142740067264,0.09294129968907583,934.742844581604,378.6210732460022,914.415210723877,35735,6440,29295,29295,0,11,5538000.0
5538,5538999,20.98077827821694,37.82059288284155,0.09293949090566678,935.0206274986267,378.6846363544464,914.5808601379395,35746,6442,29304,29304,0,11,5539000.0
5539,5539999,20.980134834640303,37.81919250196485,0.09293478411307021,935.1300582885742,378.7474739551544,914.7715911865234,35746,6442,29304,29304,0,11,5540000.0
5540,5540999,20.97975238368422,37.81822359785638,0.09292748491005598,935.4098949432373,378.8111152648926,914.8978042602539,35752,6444,29308,29308,0,11,5541000.0
5541,5541999,20.97919796868479,37.816756383974216,0.09292191618856926,935.6138505935669,378.87492656707764,915.0452995300293,35755,6445,29310,29310,0,11,5542000.0
5542,5542999,20.97866042883417,37.81517570160174,0.09292113573715621,935.7242476940155,378.9377770423889,915.1830749511719,35755,6445,29310,29310,0,11,5543000.0
5543,5543999,20.97854595354596,37.81397393941893,0.09291602805007493,935.832043170929,379.00294184684753,915.5561141967773,35762,6445,29317,29317,0,11,5544000.0
5544,5544999,20.97809748358764,37.81265757793666,0.09291009390194749,936.1033234596252,379.06568717956543,915.6902961730957,35767,6447,29320,29320,0,11,5545000.0
5545,5545999,20.97755586790829,37.8110627987217,0.09290514798320859,936.389023065567,379.13106513023376,915.7332649230957,35771,6449,29322,29322,0,11,5546000.0
5546,5546999,20.976860217013876,37.8092920841794,0.0929003475209631,936.6674840450287,379.19337153434753,915.8607177734375,35775,6451,29324,29324,0,11,5547000.0
5547,5547999,20.976414246362836,37.807805382521266,0.09287578843949251,936.7901759147644,379.25640749931335,916.556453704834,35787,6451,29336,29336,0,11,5548000.0
5548,5548999,20.975438703081956,37.806973951300535,0.09286028886419528,936.9041013717651,379.3212687969208,916.8619613647461,35790,6451,29339,29339,0,11,5549000.0
5549,5549999,20.97447869137464,37.80503196601909,0.09284934585348514,937.0186879634857,379.3877475261688,917.0749855041504,35792,6451,29341,29341,0,11,5550000.0
5550,5550999,20.973441070277207,37.80289425411636,0.09284613648768592,937.2963616847992,379.45322036743164,917.1992797851562,35797,6453,29344,29344,0,11,5551000.0
5551,5551999,20.972451848987927,37.80094802960094,0.09284118545853359,937.4170379638672,379.5188148021698,917.3638648986816,35798,6453,29345,29345,0,11,5552000.0
5552,5552999,20.971578839849617,37.798776404232726,0.09283545687041805,937.6245641708374,379.5833568572998,917.6750106811523,35815,6454,29361,29361,0,11,5553000.0
5553,5553999,20.970599343929912,37.79669134138335,0.09283400697040267,937.743040561676,379.6481490135193,917.847526550293,35815,6454,29361,29361,0,11,5554000.0
5554,5554999,20.96959120228579,37.794748051033665,0.09283358371710282,937.9326312541962,379.7106728553772,917.9781875610352,35818,6455,29363,29363,0,11,5555000.0
5555,5555999,20.968651919276503,37.79270000589943,0.09282934747346638,938.2158336639404,379.7765603065491,918.0194206237793,35824,6457,29367,29367,0,11,5556000.0
5556,5556999,20.967985655259536,37.79109937857587,0.09282375800095188,938.3394088745117,379.8393383026123,918.2120933532715,35825,6457,29368,29368,0,11,5557000.0
5557,5557999,20.967467677049253,37.78983946983327,0.09282105183045941,938.4600057601929,379.90192461013794,918.3520278930664,35827,6457,29370,29370,0,11,5558000.0
5558,5558999,20.96767580573818,37.789982977925014,0.09280991019984264,938.7389233112335,379.96546816825867,918.6210403442383,35842,6459,29383,29383,0,11,5559000.0
5559,5559999,20.967691485887986,37.78887470473216,0.09280503190261313,938.9440484046936,380.02830958366394,918.7520446777344,35852,6460,29392,29392,0,11,5560000.0
5560,5560999,20.967579555181104,37.7879710576164,0.09279639639009163,939.1444528102875,380.091814994812,918.8768653869629,35854,6461,29393,29393,0,11,5561000.0
5561,5561999,20.967917792148143,37.787962731790145,0.09278853886169525,939.3374300003052,380.15446305274963,919.0076675415039,35857,6462,29395,29395,0,11,5562000.0
5562,5562999,20.96863822677619,37.78860529784876,0.09277660185687853,939.5323042869568,380.2180001735687,919.1226387023926,35861,6463,29398,29398,0,11,5563000.0
5563,5563999,20.969041389095228,37.788254612696036,0.0927687228808366,939.6424946784973,380.27978777885437,919.2586059570312,35863,6463,29400,29400,0,11,5564000.0
5564,5564999,20.969907147913915,37.78838695875268,0.09276287326054,939.8550589084625,380.3439326286316,919.8391189575195,35888,6464,29424,29424,0,11,5565000.0
5565,5565999,20.970450964471116,37.78781413254478,0.09275895845469773,940.0553524494171,380.40632796287537,920.0462341308594,35891,6465,29426,29426,0,11,5566000.0
5566,5566999,20.97079067238019,37.787067402679064,0.09275544263668856,940.1745238304138,380.4684615135193,920.2068328857422,35891,6465,29426,29426,0,11,5567000.0
5567,5567999,20.97100059200929,37.78595877590479,0.09274691413941749,940.3629508018494,380.5306770801544,920.3060340881348,35893,6466,29427,29427,0,11,5568000.0
5568,5568999,20.970209816928335,37.784207271926014,0.0927466356895984,940.4898023605347,380.5980236530304,921.1044425964355,35925,6466,29459,29459,0,11,5569000.0
5569,5569999,20.968918994860665,37.78246405565845,0.092755217164743,940.6857225894928,380.66353821754456,921.4639778137207,35946,6467,29479,29479,0,11,5570000.0
5570,5570999,20.967632256161636,37.78044273300697,0.0927602180821755,940.8052384853363,380.7295138835907,921.7119598388672,35950,6467,29483,29483,0,11,5571000.0
5571,5571999,20.96672603742487,37.77896340141637,0.09276158104300591,940.929949760437,380.7926287651062,921.927978515625,35952,6467,29485,29485,0,11,5572000.0
5572,5572999,20.96582671129334,37.77729371252966,0.09275906572646875,941.0530688762665,380.85952734947205,922.3308448791504,35958,6467,29491,29491,0,11,5573000.0
5573,5573999,20.964795793622752,37.775625893624806,0.09275768183187771,941.1700012683868,380.9251084327698,922.5596809387207,35959,6467,29492,29492,0,11,5574000.0
5574,5574999,20.963686212870694,37.77370902741676,0.09275951576031904,941.2942543029785,380.9955027103424,922.7067794799805,35959,6467,29492,29492,0,11,5575000.0
5575,5575999,20.962616814243653,37.77178047887155,0.0927591365817293,941.4926726818085,381.06146931648254,922.8363304138184,35963,6468,29495,29495,0,11,5576000.0
5576,5576999,20.961513915766783,37.7696280406632,0.09276392805009936,942.0189642906189,381.1274309158325,922.781005859375,35982,6473,29509,29509,0,11,5577000.0
5577,5577999,20.960590232900355,37.76788265925103,0.0927581024410069,942.1589074134827,381.206360578537,923.3622970581055,36004,6473,29531,29531,0,11,5578000.0
5578,5578999,20.960085424058317,37.768436261814045,0.09274257649868611,942.3571491241455,381.2708749771118,923.6759262084961,36010,6474,29536,29536,0,11,5579000.0
5579,5579999,20.959101144324002,37.766181937868296,0.09274382280357685,942.467978477478,381.3341579437256,923.8838348388672,36011,6474,29537,29537,0,11,5580000.0
5580,5580999,20.95828063502129,37.76443354947206,0.09274431929156313,942.8269853591919,381.39922428131104,923.9786643981934,36019,6477,29542,29542,0,11,5581000.0
5581,5581999,20.957452829871148,37.76231854928858,0.09274969664778276,943.1142609119415,381.4634053707123,924.0953559875488,36024,6479,29545,29545,0,11,5582000.0
5582,5582999,20.956954687550223,37.761223015698775,0.09274863239291742,943.2270617485046,381.52989745140076,924.4248962402344,36030,6479,29551,29551,0,11,5583000.0
5583,5583999,20.955975191092897,37.75899802776783,0.09275775978266976,943.3451194763184,381.59549617767334,924.6670417785645,36031,6479,29552,29552,0,11,5584000.0
5584,5584999,20.954851192444483,37.75667525872661,0.09276934751709076,943.6261870861053,381.6589298248291,924.7522773742676,36035,6481,29554,29554,0,11,5585000.0
5585,5585999,20.954388164149776,37.755850726808994,0.09274531078947512,943.7526569366455,381.7236511707306,925.4083480834961,36051,6481,29570,29570,0,11,5586000.0
5586,5586999,20.95371906036619,37.7552415075396,0.09272878646959315,943.8637170791626,381.78884100914,925.8166007995605,36056,6481,29575,29575,0,11,5587000.0
5587,5587999,20.952916111070525,37.75357134740664,0.09272940296046872,944.061497926712,381.85399627685547,926.0828628540039,36081,6482,29599,29599,0,11,5588000.0
5588,5588999,20.951902798953075,37.75163376377261,0.09273534431871455,944.2635040283203,381.9182724952698,926.2141380310059,36092,6483,29609,29609,0,11,5589000.0
5589,5589999,20.95120618832182,37.75031379431021,0.09272860809088279,944.7060689926147,381.98387145996094,926.4736595153809,36119,6487,29632,29632,0,11,5590000.0
5590,5590999,20.950143705717863,37.74871997572269,0.09272604273409024,944.821754693985,382.0494158267975,926.6983604431152,36119,6487,29632,29632,0,11,5591000.0
5591,5591999,20.949200782739524,37.74682570721251,0.09272377604458415,945.0140953063965,382.11233830451965,926.8442535400391,36121,6488,29633,29633,0,11,5592000.0
5592,5592999,20.948118600206758,37.74479494860453,0.09272607182558501,945.2955315113068,382.17711639404297,926.9288673400879,36126,6490,29636,29636,0,11,5593000.0
5593,5593999,20.947286023155993,37.74297404518211,0.09272133681756156,945.4095373153687,382.24167370796204,927.1450958251953,36130,6490,29640,29640,0,11,5594000.0
5594,5594999,20.94679010660697,37.74213305377789,0.09270974373838925,945.6220238208771,382.3082549571991,927.357494354248,36147,6491,29656,29656,0,11,5595000.0
5595,5595999,20.94629381960966,37.74044712287368,0.09270066413050337,945.8412642478943,382.37289595603943,927.6065406799316,36152,6492,29660,29660,0,11,5596000.0
5596,5596999,20.945800368193574,37.73914723851039,0.09269387000856866,945.9616339206696,382.43735671043396,927.7779655456543,36152,6492,29660,29660,0,11,5597000.0
5597,5597999,20.945443794977272,37.73813469827537,0.092684662748586,946.1601569652557,382.50010681152344,927.8927040100098,36154,6493,29661,29661,0,11,5598000.0
5598,5598999,20.945209612612487,37.73678253694326,0.09267514984589398,946.3566181659698,382.5638723373413,927.9523658752441,36164,6494,29670,29670,0,11,5599000.0
5599,5599999,20.944722636096635,37.735555980710494,0.09266784024771746,946.5438718795776,382.62664771080017,928.0870094299316,36166,6495,29671,29671,0,11,5600000.0
5600,5600999,20.94447770303587,37.7342797021971,0.09265765890461286,946.7417778968811,382.69321727752686,928.3961143493652,36177,6496,29681,29681,0,11,5601000.0
5601,5601999,20.944578640130405,37.73481400776832,0.09263912258676998,946.8544206619263,382.7583932876587,928.6111297607422,36177,6496,29681,29681,0,11,5602000.0
5602,5602999,20.944293406572864,37.7332596267237,0.09263214156834054,946.9703941345215,382.82239985466003,928.7815284729004,36177,6496,29681,29681,0,11,5603000.0
5603,5603999,20.943890951588333,37.73169001652573,0.09262833988215802,947.2533805370331,382.8872323036194,928.803337097168,36181,6498,29683,29683,0,11,5604000.0
5604,5604999,20.94363954267078,37.73038710585259,0.09261991111664125,947.373969078064,382.94931054115295,928.9363975524902,36181,6498,29683,29683,0,11,5605000.0
5605,5605999,20.94266456791889,37.73011282422623,0.09261302687912776,947.4914584159851,383.01472330093384,929.468620300293,36192,6498,29694,29694,0,11,5606000.0
5606,5606999,20.94137536193987,37.72851469251733,0.09261133354162787,947.6068794727325,383.0767283439636,929.6568794250488,36193,6498,29695,29695,0,11,5607000.0
5607,5607999,20.940426725805796,37.72708019021876,0.09260944755386347,947.724844455719,383.1389501094818,929.8070182800293,36194,6498,29696,29696,0,11,5608000.0
5608,5608999,20.939448494125944,37.72525098337489,0.09261180269197244,947.9227964878082,383.2026400566101,929.8868141174316,36197,6499,29698,29698,0,11,5609000.0
5609,5609999,20.938665625567065,37.72364867046816,0.09260816390332949,948.1346061229706,383.26477241516113,930.0245971679688,36210,6500,29710,29710,0,11,5610000.0
5610,5610999,20.937977479721162,37.72225206564882,0.09260339656289474,948.3498048782349,383.33585810661316,930.2188529968262,36213,6501,29712,29712,0,11,5611000.0
5611,5611999,20.93728225130486,37.72072704087334,0.09259889474715932,948.5592541694641,383.3968436717987,930.354606628418,36216,6502,29714,29714,0,11,5612000.0
5612,5612999,20.93669669753199,37.71949203501359,0.09259630289215981,948.8367896080017,383.45842242240906,930.3746604919434,36223,6504,29719,29719,0,11,5613000.0
5613,5613999,20.93627231447443,37.71860436218041,0.09259282200841967,948.9502704143524,383.5198383331299,930.539234161377,36223,6504,29719,29719,0,11,5614000.0
5614,5614999,20.93602108380731,37.717691647909454,0.09258925366179549,949.1446218490601,383.5815989971161,930.7065048217773,36228,6505,29723,29723,0,11,5615000.0
5615,5615999,20.935624108249772,37.71648080690568,0.0925857120746042,949.3544344902039,383.64657187461853,930.9154090881348,36236,6506,29730,29730,0,11,5616000.0
5616,5616999,20.935513186892504,37.71610273694158,0.09258288459722053,949.5639369487762,383.7088301181793,931.0290451049805,36246,6507,29739,29739,0,11,5617000.0
5617,5617999,20.935511055009968,37.71760318928836,0.09256484982233781,949.6799867153168,383.7716763019562,931.2009010314941,36246,6507,29739,29739,0,11,5618000.0
5618,5618999,20.93590529778219,37.71863830437887,0.09255821740211312,949.8760631084442,383.83306765556335,931.3291816711426,36249,6508,29741,29741,0,11,5619000.0
5619,5619999,20.936182187212626,37.718412928064744,0.09254773216797274,949.9982907772064,383.89823269844055,931.4622650146484,36249,6508,29741,29741,0,11,5620000.0
5620,5620999,20.936734693147717,37.718039842413496,0.09253942111752611,950.1207482814789,383.95980286598206,931.551513671875,36249,6508,29741,29741,0,11,5621000.0
5621,5621999,20.937398403261245,37.71822040739536,0.09253107630847013,950.3283414840698,384.02282190322876,931.7296905517578,36254,6509,29745,29745,0,11,5622000.0
5622,5622999,20.938168300997468,37.71847060325969,0.09251595930249623,950.4381000995636,384.0865066051483,931.9034080505371,36254,6509,29745,29745,0,11,5623000.0
5623,5623999,20.938648053082087,37.718141949175916,0.0925063655401781,950.5757660865784,384.1499352455139,932.0133476257324,36254,6509,29745,29745,0,11,5624000.0
5624,5624999,20.93906587064227,37.71759214726277,0.09250286094355875,950.7707979679108,384.21137523651123,932.0848197937012,36256,6510,29746,29746,0,11,5625000.0
5625,5625999,20.938569698505113,37.715745557820405,0.0924980969458068,950.9814908504486,384.2728898525238,932.1402854919434,36265,6511,29754,29754,0,11,5626000.0
5626,5626999,20.937155049764634,37.714624624213855,0.09250137019522808,951.0999162197113,384.34007930755615,932.9318084716797,36293,6511,29782,29782,0,11,5627000.0
5627,5627999,20.93530788934124,37.71202760158223,0.09251426152359221,951.2895789146423,384.4012131690979,933.1840171813965,36299,6512,29787,29787,0,11,5628000.0
5628,5628999,20.93377112663157,37.71034494383611,0.09252438920705153,951.5841374397278,384.46524119377136,933.3795585632324,36317,6514,29803,29803,0,11,5629000.0
5629,5629999,20.932119857035147,37.70780370840606,0.09254036071337346,951.6881954669952,384.5270256996155,933.5813484191895,36318,6514,29804,29804,0,11,5630000.0
5630,5630999,20.930730312817985,37.706059056023285,0.09254353848958108,951.9626893997192,384.589928150177,933.860107421875,36332,6516,29816,29816,0,11,5631000.0
5631,5631999,20.929250470440916,37.703746845834225,0.0925514129303816,952.1489868164062,384.6520667076111,934.0914878845215,36337,6517,29820,29820,0,11,5632000.0
5632,5632999,20.92761196821279,37.70112210457098,0.09256077668703155,952.5138258934021,384.715457201004,934.164867401123,36344,6520,29824,29824,0,11,5633000.0
5633,5633999,20.926027760172218,37.69851256444713,0.09257108647112433,952.6291477680206,384.7786662578583,934.419750213623,36346,6520,29826,29826,0,11,5634000.0
5634,5634999,20.924847542866896,37.69662157277858,0.09257571257490582,952.8248784542084,384.8436155319214,934.5556716918945,36351,6521,29830,29830,0,11,5635000.0
5635,5635999,20.92429432958968,37.69603718317759,0.09256962873284813,952.9470188617706,384.9062592983246,934.8051452636719,36358,6521,29837,29837,0,11,5636000.0
5636,5636999,20.924314270751644,37.69692273762566,0.0925644402223822,953.1619181632996,384.9731192588806,935.2088813781738,36369,6522,29847,29847,0,11,5637000.0
5637,5637999,20.92453765544422,37.69699288950513,0.09257750995100866,953.2654302120209,385.0347583293915,935.4753723144531,36370,6522,29848,29848,0,11,5638000.0
5638,5638999,20.925672620680334,37.7016307165414,0.09256074837212003,953.4681463241577,385.09694600105286,935.6797103881836,36376,6523,29853,29853,0,11,5639000.0
5639,5639999,20.927649409453768,37.70839982804698,0.09253913418552451,953.6585600376129,385.15944242477417,935.8233299255371,36379,6524,29855,29855,0,11,5640000.0
5640,5640999,20.92951535011564,37.71432413717453,0.09256718197332259,953.7664144039154,385.22143602371216,936.0220565795898,36381,6524,29857,29857,0,11,5641000.0
5641,5641999,20.931348689353197,37.719096212982095,0.09257221873670696,953.9662454128265,385.28644323349,936.121410369873,36384,6525,29859,29859,0,11,5642000.0
5642,5642999,20.934659413682326,37.72784752679513,0.09259826748839906,954.2380471229553,385.349249124527,936.4826965332031,36397,6527,29870,29870,0,11,5643000.0
5643,5643999,20.937242076043287,37.73407413357583,0.09261614996193623,954.3541741371155,385.4147403240204,936.6930122375488,36397,6527,29870,29870,0,11,5644000.0
5644,5644999,20.939449615539683,37.73829352546402,0.09264353402120473,954.5554559230804,385.4765784740448,936.76611328125,36402,6528,29874,29874,0,11,5645000.0
5645,5645999,20.940901485887515,37.74061548154357,0.09262991788656671,954.8382971286774,385.53905630111694,936.8871154785156,36406,6530,29876,29876,0,11,5646000.0
5646,5646999,20.940031998623695,37.740354621458884,0.09263800716519,954.9530711174011,385.60150814056396,937.346248626709,36415,6530,29885,29885,0,11,5647000.0
5647,5647999,20.938670424845895,37.73931360844087,0.09263658967775357,955.0599994659424,385.66105937957764,937.529468536377,36417,6530,29887,29887,0,11,5648000.0
5648,5648999,20.937170224080262,37.73766444438774,0.0926434055253803,955.1835074424744,385.7225196361542,937.6914978027344,36419,6530,29889,29889,0,11,5649000.0
5649,5649999,20.9357045026488,37.73553387612392,0.09264858522190489,955.2996578216553,385.78443694114685,937.7888412475586,36419,6530,29889,29889,0,11,5650000.0
5650,5650999,20.93446318035552,37.73413801117699,0.09264626129389786,955.4284155368805,385.84688806533813,938.0821380615234,36426,6530,29896,29896,0,11,5651000.0
5651,5651999,20.93308596434519,37.732123929236735,0.0926484405372453,955.6339378356934,385.90891695022583,938.1921119689941,36428,6531,29897,29897,0,11,5652000.0
5652,5652999,20.931779326212617,37.733861391692216,0.09263652801129973,955.8428103923798,385.9707238674164,938.2750968933105,36431,6532,29899,29899,0,11,5653000.0
5653,5653999,20.93050338101692,37.73167808199485,0.0926408308578448,956.0383358001709,386.0325872898102,938.3600044250488,36433,6533,29900,29900,0,11,5654000.0
5654,5654999,20.92939698653158,37.72966755987174,0.09264280481277032,956.2366495132446,386.09431195259094,938.4609909057617,36436,6534,29902,29902,0,11,5655000.0
5655,5655999,20.92852851397848,37.72800636810459,0.09263962262747139,956.3541176319122,386.15623140335083,938.6223449707031,36440,6534,29906,29906,0,11,5656000.0
5656,5656999,20.92799112072424,37.72714755256928,0.09262797168899406,956.7298974990845,386.2198066711426,938.8768081665039,36462,6537,29925,29925,0,11,5657000.0
5657,5657999,20.927401978173705,37.72562655979819,0.09262188357026568,956.8504507541656,386.283394575119,939.0744705200195,36462,6537,29925,29925,0,11,5658000.0
5658,5658999,20.926717687095607,37.72393994303808,0.09261623380333783,957.054402589798,386.35226941108704,939.1636047363281,36465,6538,29927,29927,0,11,5659000.0
5659,5659999,20.926383598723575,37.72285027810347,0.09260669031781621,957.3582420349121,386.41569232940674,939.2015762329102,36479,6540,29939,29939,0,11,5660000.0
5660,5660999,20.926187915167834,37.721877920718754,0.09259394342492433,957.5523142814636,386.4786114692688,939.3341102600098,36482,6541,29941,29941,0,11,5661000.0
5661,5661999,20.92597109011937,37.720784482430815,0.09258833219617801,957.6678960323334,386.5398418903351,939.5106544494629,36483,6541,29942,29942,0,11,5662000.0
5662,5662999,20.92625901665593,37.72204567889415,0.09256638948202589,957.9607610702515,386.60258746147156,939.7424049377441,36498,6543,29955,29955,0,11,5663000.0
5663,5663999,20.926726490474426,37.72198616970827,0.09255029678543047,958.0636014938354,386.6647779941559,940.0095748901367,36498,6543,29955,29955,0,11,5664000.0
5664,5664999,20.92660343901261,37.72085871628822,0.09254837758212053,958.2520151138306,386.7261302471161,940.1834526062012,36500,6544,29956,29956,0,11,5665000.0
5665,5665999,20.92678851441251,37.72022143386533,0.09253974444740465,958.4427983760834,386.78770899772644,940.2906265258789,36502,6545,29957,29957,0,11,5666000.0
5666,5666999,20.926048804190234,37.718529255713236,0.09253684902420023,958.6501870155334,386.85004353523254,940.7988548278809,36515,6546,29969,29969,0,11,5667000.0
5667,5667999,20.924490671320534,37.71644134339894,0.09254377695286686,958.7605037689209,386.9130699634552,941.2842292785645,36523,6546,29977,29977,0,11,5668000.0
5668,5668999,20.922704342025387,37.713655330126926,0.0925559158253193,958.8742620944977,386.97643184661865,941.5851745605469,36525,6546,29979,29979,0,11,5669000.0
5669,5669999,20.921132380055496,37.711164252490065,0.09256723543786849,958.9825065135956,387.0392825603485,941.8249282836914,36529,6546,29983,29983,0,11,5670000.0
5670,5670999,20.919739999967934,37.70965314608812,0.09257439694374037,959.1048154830933,387.10380482673645,941.9897308349609,36530,6546,29984,29984,0,11,5671000.0
5671,5671999,20.91828886896958,37.707337497919006,0.0925713777072803,959.2300155162811,387.16726636886597,942.3744812011719,36536,6546,29990,29990,0,11,5672000.0
5672,5672999,20.91687112924132,37.704972366380936,0.0925743314595816,959.3390307426453,387.2300670146942,942.5853424072266,36536,6546,29990,29990,0,11,5673000.0
5673,5673999,20.91570261198638,37.703129120180655,0.09257676732715758,959.5464925765991,387.2957639694214,942.6850738525391,36538,6547,29991,29991,0,11,5674000.0
5674,5674999,20.91459341042155,37.70190923775373,0.0925826561222276,959.820592880249,387.3587815761566,942.774543762207,36542,6549,29993,29993,0,11,5675000.0
5675,5675999,20.91400695770451,37.702165059442784,0.09258533079318632,960.0159623622894,387.42219257354736,942.9441986083984,36545,6550,29995,29995,0,11,5676000.0
5676,5676999,20.914012867842278,37.70385142864726,0.09259425938485222,960.3036069869995,387.48703503608704,943.119514465332,36561,6552,30009,30009,0,11,5677000.0
5677,5677999,20.91465426202691,37.706700960918305,0.09256666662232171,960.4284906387329,387.5511522293091,943.7359466552734,36585,6552,30033,30033,0,11,5678000.0
5678,5678999,20.915244343367146,37.708001175083204,0.09259494476841434,960.5367512702942,387.61430048942566,944.0005683898926,36588,6552,30036,30036,0,11,5679000.0
5679,5679999,20.91599959882553,37.710205456873766,0.09258677234873947,960.7427229881287,387.67914485931396,944.1507835388184,36617,6553,30064,30064,0,11,5680000.0
5680,5680999,20.91715962731255,37.713261026212805,0.09258210714716653,961.01438331604,387.7406144142151,944.266414642334,36621,6555,30066,30066,0,11,5681000.0
5681,5681999,20.918445902274048,37.71627550937457,0.0926028882988672,961.1278245449066,387.80337262153625,944.402717590332,36621,6555,30066,30066,0,11,5682000.0
5682,5682999,20.919162383440227,37.71734934845919,0.09265276266959033,961.3228940963745,387.86588883399963,944.4644012451172,36625,6556,30069,30069,0,11,5683000.0
5683,5683999,20.920883905892534,37.72042734164595,0.09265545171237177,961.4368567466736,387.92922353744507,944.878978729248,36631,6556,30075,30075,0,11,5684000.0
5684,5684999,20.92250936305234,37.722887413117206,0.09268851101619902,961.5556259155273,387.99340534210205,945.0598106384277,36631,6556,30075,30075,0,11,5685000.0
5685,5685999,20.92416541536689,37.727734515217335,0.09268128362856509,961.6674492359161,388.0547969341278,945.1896896362305,36631,6556,30075,30075,0,11,5686000.0
5686,5686999,20.925245143474328,37.72856826093647,0.0926910177964233,962.0361933708191,388.1175708770752,945.2378349304199,36644,6559,30085,30085,0,11,5687000.0
5687,5687999,20.92511066587004,37.72880533290351,0.09268250920245347,962.2455818653107,388.1815221309662,945.9684982299805,36670,6560,30110,30110,0,11,5688000.0
5688,5688999,20.923682180637115,37.726757628565366,0.09268377581045084,962.3640804290771,388.2477889060974,946.311107635498,36672,6560,30112,30112,0,11,5689000.0
5689,5689999,20.922366588123516,37.72507904437977,0.09267511656035954,962.557567358017,388.3108332157135,946.5011672973633,36677,6561,30116,30116,0,11,5690000.0
5690,5690999,20.921153542108897,37.723543567224624,0.09266810874881759,962.761342048645,388.3738536834717,946.6728744506836,36688,6562,30126,30126,0,11,5691000.0
5691,5691999,20.91998452678126,37.721691962367466,0.09267221453467034,962.8722434043884,388.43614411354065,946.8401985168457,36690,6562,30128,30128,0,11,5692000.0
5692,5692999,20.919175027011164,37.72018846976951,0.09266174764269897,963.16006731987,388.4992792606354,947.1485290527344,36709,6564,30145,30145,0,11,5693000.0
5693,5693999,20.91830259662932,37.71850588952301,0.09265415214769823,963.3509001731873,388.5614502429962,947.3303070068359,36712,6565,30147,30147,0,11,5694000.0
5694,5694999,20.917695216050763,37.71725325711811,0.0926530144795441,963.554694890976,388.62468457221985,947.472599029541,36719,6566,30153,30153,0,11,5695000.0
5695,5695999,20.917210176402403,37.71642579588941,0.09263570605081795,963.6608867645264,388.6875948905945,947.6175880432129,36719,6566,30153,30153,0,11,5696000.0
5696,5696999,20.91710240926135,37.715869148497944,0.0926250934139643,963.9487717151642,388.75181770324707,947.7913932800293,36740,6568,30172,30172,0,11,5697000.0
5697,5697999,20.917029477731802,37.71578732329964,0.0926133440360486,964.1655054092407,388.81603169441223,947.9818496704102,36750,6569,30181,30181,0,11,5698000.0
5698,5698999,20.916983849472846,37.71511266440144,0.09259936888354636,964.2805716991425,388.8805675506592,948.369800567627,36757,6569,30188,30188,0,11,5699000.0
5699,5699999,20.917598042141112,37.71801470547552,0.09256936481312694,964.5574014186859,388.94379448890686,948.4819526672363,36769,6571,30198,30198,0,11,5700000.0
5700,5700999,20.91788904220618,37.71784143575839,0.09255623096976617,964.7534415721893,389.00876212120056,948.6249656677246,36771,6572,30199,30199,0,11,5701000.0
5701,5701999,20.91853712737408,37.71811652750854,0.09254340849480491,964.882075548172,389.0715842247009,948.7771339416504,36772,6572,30200,30200,0,11,5702000.0
5702,5702999,20.91890082362253,37.71770865393853,0.09252884090402724,965.0037751197815,389.13677287101746,948.9130668640137,36773,6572,30201,30201,0,11,5703000.0
5703,5703999,20.91946590369656,37.71771900112333,0.09251013955378762,965.1094167232513,389.1988739967346,949.0329856872559,36774,6572,30202,30202,0,11,5704000.0
5704,5704999,20.920428653440865,37.71792431420928,0.09247425088086902,965.2308008670807,389.26282262802124,949.7249870300293,36801,6572,30229,30229,0,11,5705000.0
5705,5705999,20.92111493140383,37.719118528196645,0.09244683770962836,965.350604057312,389.32504773139954,949.9479103088379,36801,6572,30229,30229,0,11,5706000.0
5706,5706999,20.92170944223347,37.718802072205165,0.09243184006310301,965.4626681804657,389.38763904571533,950.1060066223145,36801,6572,30229,30229,0,11,5707000.0
5707,5707999,20.92212034165784,37.71815464953892,0.092414988350625,965.5768897533417,389.4498505592346,950.2391510009766,36801,6572,30229,30229,0,11,5708000.0
5708,5708999,20.9215015146874,37.71658906251126,0.09240922536030982,965.7746052742004,389.51515769958496,950.9248733520508,36827,6573,30254,30254,0,11,5709000.0
5709,5709999,20.920221492146702,37.71504328462866,0.0924139994190899,965.9841210842133,389.57960629463196,951.3361892700195,36848,6574,30274,30274,0,11,5710000.0
5710,5710999,20.918967015585434,37.71441200364044,0.09241473924401522,966.2729299068451,389.6439266204834,951.5350112915039,36882,6576,30306,30306,0,11,5711000.0
5711,5711999,20.917781414473296,37.71300205409541,0.09242189601992512,966.3895950317383,389.70773100852966,951.7422332763672,36884,6576,30308,30308,0,11,5712000.0
5712,5712999,20.91657076814683,37.71161379236565,0.09242364588691487,966.5076377391815,389.771511554718,952.0377159118652,36886,6576,30310,30310,0,11,5713000.0
5713,5713999,20.91505526150533,37.70906765609348,0.09243508411278312,966.7049868106842,389.83654046058655,952.1970634460449,36890,6577,30313,30313,0,11,5714000.0
5714,5714999,20.913780494759198,37.706957828323596,0.09244296641754313,966.8196182250977,389.90028643608093,952.3569717407227,36890,6577,30313,30313,0,11,5715000.0
5715,5715999,20.912693592987143,37.705513525105324,0.09244462405313891,966.9369113445282,389.96360039711,952.4813995361328,36890,6577,30313,30313,0,11,5716000.0
5716,5716999,20.91142055892167,37.70355788367908,0.09245327277968118,967.3079950809479,390.0285861492157,952.511905670166,36911,6580,30331,30331,0,11,5717000.0
5717,5717999,20.910277740628676,37.70130558592491,0.09246154481919544,967.6799697875977,390.0931930541992,952.7795257568359,36937,6583,30354,30354,0,11,5718000.0
5718,5718999,20.909297494216336,37.699096286791644,0.09246293655024496,967.805543422699,390.15770959854126,953.1991577148438,36946,6583,30363,30363,0,11,5719000.0
5719,5719999,20.908479733975373,37.69734125831123,0.09246582237946199,968.0020985603333,390.2213637828827,953.3611145019531,36950,6584,30366,30366,0,11,5720000.0
5720,5720999,20.90775999026357,37.69550299231535,0.09247061994409167,968.3706524372101,390.2854311466217,953.3777961730957,36956,6587,30369,30369,0,11,5721000.0
5721,5721999,20.90707159747373,37.69381421464989,0.09247666844141611,968.5763962268829,390.34999775886536,953.5521965026855,36959,6588,30371,30371,0,11,5722000.0
5722,5722999,20.90637318259549,37.691997955922005,0.09248354093063405,968.8638741970062,390.41523599624634,953.7336921691895,36976,6590,30386,30386,0,11,5723000.0
5723,5723999,20.905804670165118,37.690278980781514,0.09248877631474983,969.0614771842957,390.4777834415436,953.9231452941895,36979,6591,30388,30388,0,11,5724000.0
5724,5724999,20.904613567703066,37.687862132950684,0.09250416046497778,969.1850650310516,390.5428683757782,954.0800285339355,36979,6591,30388,30388,0,11,5725000.0
5725,5725999,20.903713938367094,37.686913408044035,0.09250640560046308,969.3107907772064,390.606068611145,954.676628112793,36994,6591,30403,30403,0,11,5726000.0
5726,5726999,20.90261211786115,37.68510509609891,0.09250099999038841,969.4227843284607,390.6688425540924,955.1659317016602,36999,6591,30408,30408,0,11,5727000.0
5727,5727999,20.901690124330283,37.68452969465034,0.09249972836367815,969.5417954921722,390.7331733703613,955.4731063842773,37002,6591,30411,30411,0,11,5728000.0
5728,5728999,20.900747680931786,37.68441079562003,0.09249347748531489,969.6523158550262,390.7973837852478,955.6610298156738,37003,6591,30412,30412,0,11,5729000.0
5729,5729999,20.899960128771628,37.68319854956594,0.0924891230813899,969.9285178184509,390.8613176345825,956.1096725463867,37027,6593,30434,30434,0,11,5730000.0
5730,5730999,20.899396502141776,37.68272123908197,0.0924822320079326,970.1209931373596,390.9247100353241,956.324161529541,37029,6594,30435,30435,0,11,5731000.0
5731,5731999,20.898615096281898,37.68134879331745,0.09248247631630568,970.331788778305,390.99011993408203,956.4862060546875,37031,6595,30436,30436,0,11,5732000.0
5732,5732999,20.897730544195607,37.679559317758056,0.09247914110113586,970.442563533783,391.0531311035156,956.6949577331543,37031,6595,30436,30436,0,11,5733000.0
5733,5733999,20.89698088935116,37.67776552445921,0.09247616979769568,970.6453759670258,391.1180384159088,956.8716163635254,37035,6596,30439,30439,0,11,5734000.0
5734,5734999,20.89678250016261,37.67764088161038,0.09245834493120308,970.7565579414368,391.1808331012726,957.0632934570312,37037,6596,30441,30441,0,11,5735000.0
5735,5735999,20.896670964808944,37.67663396792731,0.09244022979977584,970.9548490047455,391.24471163749695,957.5159568786621,37050,6597,30453,30453,0,11,5736000.0
5736,5736999,20.896307971327087,37.675434536291824,0.09242895889812286,971.2438719272614,391.3088011741638,957.5891418457031,37061,6599,30462,30462,0,11,5737000.0
5737,5737999,20.896021777178934,37.674082758587296,0.09241692522518563,971.5293781757355,391.37202882766724,957.6720924377441,37065,6601,30464,30464,0,11,5738000.0
5738,5738999,20.896005567279815,37.67397261354456,0.09240192483228704,971.6384637355804,391.43447637557983,957.8358688354492,37065,6601,30464,30464,0,11,5739000.0
5739,5739999,20.896027208489663,37.67411187196798,0.0923866023441412,971.8394656181335,391.4976649284363,957.9587478637695,37067,6602,30465,30465,0,11,5740000.0
5740,5740999,20.89592587757031,37.672879044077405,0.0923671102541459,971.9481132030487,391.55921840667725,958.216854095459,37072,6602,30470,30470,0,11,5741000.0
5741,5741999,20.896261037114847,37.67215351797184,0.09235322536763457,972.1398243904114,391.6222290992737,958.4692611694336,37076,6603,30473,30473,0,11,5742000.0
5742,5742999,20.896678334527177,37.67164241558989,0.0923459219539059,972.2466361522675,391.6830461025238,958.6390914916992,37076,6603,30473,30473,0,11,5743000.0
5743,5743999,20.89709821000088,37.67095820641441,0.09234187806738547,972.4411835670471,391.7439863681793,958.7035484313965,37080,6604,30476,30476,0,11,5744000.0
5744,5744999,20.897414978776144,37.67277314463408,0.09232073499321514,972.6595027446747,391.80696415901184,958.7895927429199,37082,6605,30477,30477,0,11,5745000.0
5745,5745999,20.897820705840708,37.67190233600434,0.09226903083512739,972.7680037021637,391.8681712150574,959.1488304138184,37090,6605,30485,30485,0,11,5746000.0
5746,5746999,20.898845436931914,37.67349550433605,0.09222387516875252,972.886727809906,391.9291846752167,959.3567008972168,37094,6605,30489,30489,0,11,5747000.0
5747,5747999,20.90006182831344,37.675640533577976,0.09218351106063849,973.0078127384186,391.99394488334656,959.5970420837402,37100,6605,30495,30495,0,11,5748000.0
5748,5748999,20.900959721330253,37.6763787456545,0.09214996272289788,973.2130007743835,392.0575702190399,959.600700378418,37102,6606,30496,30496,0,11,5749000.0
5749,5749999,20.901566101855167,37.67689712566102,0.0921346316107654,973.4244244098663,392.1198511123657,959.775333404541,37109,6607,30502,30502,0,11,5750000.0
5750,5750999,20.902097066863572,37.67644154135236,0.09211697573043554,973.6278729438782,392.1833543777466,959.9884262084961,37112,6608,30504,30504,0,11,5751000.0
5751,5751999,20.902529122026596,37.675992769914714,0.09211301515270498,973.741025686264,392.2455484867096,960.1729545593262,37113,6608,30505,30505,0,11,5752000.0
5752,5752999,20.903199275166507,37.676428481278556,0.09212432414495009,973.9393227100372,392.3112196922302,960.2991027832031,37115,6609,30506,30506,0,11,5753000.0
5753,5753999,20.90370495909637,37.676031269219365,0.09211506215847298,974.1432583332062,392.37348985671997,960.3884506225586,37118,6610,30508,30508,0,11,5754000.0
5754,5754999,20.904449431284508,37.67641194948761,0.09212562473920372,974.3446419239044,392.43480587005615,960.5624656677246,37122,6611,30511,30511,0,11,5755000.0
5755,5755999,20.90508345905024,37.6772269398463,0.09213459293333137,974.5495872497559,392.49806690216064,960.8387031555176,37131,6612,30519,30519,0,11,5756000.0
5756,5756999,20.906245783628503,37.678201425376045,0.09215060583270429,974.6605792045593,392.55855560302734,960.9992370605469,37131,6612,30519,30519,0,11,5757000.0
5757,5757999,20.90777459268802,37.68089377462988,0.09216733301343027,974.883686542511,392.62218284606934,961.0903396606445,37142,6613,30529,30529,0,11,5758000.0
5758,5758999,20.909169553705944,37.683446230221406,0.09219137846878078,974.9931008815765,392.6847577095032,961.2114334106445,37142,6613,30529,30529,0,11,5759000.0
5759,5759999,20.911271201702355,37.68832870689572,0.0922010720665365,975.1114966869354,392.7490050792694,961.3078765869141,37142,6613,30529,30529,0,11,5760000.0
5760,5760999,20.913220599895475,37.69181180226368,0.09221665394955592,975.3358588218689,392.8144099712372,961.3930816650391,37144,6614,30530,30530,0,11,5761000.0
5761,5761999,20.915759307748022,37.69874775207456,0.09222439605548172,975.4501821994781,392.87613558769226,961.6056938171387,37146,6614,30532,30532,0,11,5762000.0
5762,5762999,20.918116338295196,37.70203270783401,0.0922786121290079,975.6483085155487,392.9380443096161,961.6938934326172,37150,6615,30535,30535,0,11,5763000.0
5763,5763999,20.919831894332063,37.703821994156264,0.0923035931628522,975.7734115123749,392.99946093559265,961.7845687866211,37150,6615,30535,30535,0,11,5764000.0
5764,5764999,20.921052136741896,37.704038652388384,0.09230485758687657,975.9780073165894,393.06122612953186,961.8103179931641,37152,6616,30536,30536,0,11,5765000.0
5765,5765999,20.92164675583068,37.70423484073153,0.09231044333820537,976.1042461395264,393.1239814758301,962.3385696411133,37171,6616,30555,30555,0,11,5766000.0
5766,5766999,20.921008066455446,37.70414622173104,0.0922873516569549,976.2245318889618,393.188672542572,962.7405052185059,37177,6616,30561,30561,0,11,5767000.0
5767,5767999,20.92033009143816,37.702974173985105,0.09227554986584563,976.337042093277,393.2511863708496,962.9803085327148,37178,6616,30562,30562,0,11,5768000.0
5768,5768999,20.91933897675265,37.70112415046332,0.09227473439258371,976.5330481529236,393.3141841888428,963.2119140625,37183,6617,30566,30566,0,11,5769000.0
5769,5769999,20.918544327964295,37.6996866655757,0.09227166702805312,976.7329905033112,393.3776504993439,963.2991256713867,37185,6618,30567,30567,0,11,5770000.0
5770,5770999,20.917833754329152,37.69800981741826,0.09226513585399543,976.8499629497528,393.4400155544281,963.7311325073242,37191,6618,30573,30573,0,11,5771000.0
5771,5771999,20.91719553775989,37.69641217551614,0.0922535635967654,977.0623047351837,393.5074200630188,963.923583984375,37196,6619,30577,30577,0,11,5772000.0
5772,5772999,20.916493030425823,37.69462353068023,0.0922464823651038,977.5077967643738,393.5732524394989,964.045524597168,37215,6623,30592,30592,0,11,5773000.0
5773,5773999,20.915776194592613,37.692689448929904,0.0922433286739307,977.7999250888824,393.6389145851135,964.2130661010742,37225,6625,30600,30600,0,11,5774000.0
5774,5774999,20.91507416037592,37.690864826768305,0.09223852455967618,977.9224276542664,393.7035937309265,964.4703330993652,37231,6625,30606,30606,0,11,5775000.0
5775,5775999,20.914372201225394,37.68922613585528,0.09221965576934898,978.1250548362732,393.7670512199402,964.5986480712891,37234,6626,30608,30608,0,11,5776000.0
5776,5776999,20.914084456320754,37.68779237541066,0.09220435802100824,978.4089477062225,393.83003664016724,965.0715713500977,37256,6628,30628,30628,0,11,5777000.0
5777,5777999,20.913654577594343,37.68630479512891,0.09219389480188334,978.6085002422333,393.8950996398926,965.2815475463867,37258,6629,30629,30629,0,11,5778000.0
5778,5778999,20.913359921198655,37.684969888576035,0.09218708432589284,978.7266569137573,393.95870637893677,965.4762420654297,37259,6629,30630,30630,0,11,5779000.0
5779,5779999,20.91331180708941,37.6842750671989,0.09216981621392384,978.9212050437927,394.02077198028564,965.6112785339355,37261,6630,30631,30631,0,11,5780000.0
5780,5780999,20.913043088087303,37.68304091760132,0.09215850248074331,979.03018450737,394.0833706855774,965.7814750671387,37261,6630,30631,30631,0,11,5781000.0
5781,5781999,20.91290399306828,37.68186078792873,0.09214707605780026,979.3226480484009,394.14657187461853,966.0515098571777,37271,6632,30639,30639,0,11,5782000.0
5782,5782999,20.9127410667343,37.68071225230146,0.0921408673809081,979.5460107326508,394.2159307003021,966.2987022399902,37274,6633,30641,30641,0,11,5783000.0
5783,5783999,20.912394689559203,37.6794085009855,0.09213045092681627,979.6585736274719,394.27837777137756,966.4994010925293,37274,6633,30641,30641,0,11,5784000.0
5784,5784999,20.91180431801044,37.677641908870065,0.0921309749896706,979.9506320953369,394.3433380126953,966.5950317382812,37285,6635,30650,30650,0,11,5785000.0
5785,5785999,20.91123336520522,37.676444159888646,0.0921288724654108,980.234326839447,394.40564584732056,966.6719665527344,37290,6637,30653,30653,0,11,5786000.0
5786,5786999,20.90988084028792,37.674038050242174,0.0921315278864292,980.3616156578064,394.46813893318176,967.076229095459,37301,6637,30664,30664,0,11,5787000.0
5787,5787999,20.908691443637235,37.67212522704532,0.09212896945592353,980.5713467597961,394.5388882160187,967.198356628418,37304,6638,30666,30666,0,11,5788000.0
5788,5788999,20.907518634425234,37.67000304681054,0.09212462667719512,980.7893121242523,394.6057860851288,967.3341674804688,37307,6639,30668,30668,0,11,5789000.0
5789,5789999,20.906521468662717,37.668955041772485,0.09211754093708491,980.9885907173157,394.66858863830566,967.4270629882812,37318,6640,30678,30678,0,11,5790000.0
5790,5790999,20.905619187854803,37.66769822360023,0.09210705192271951,981.3791353702545,394.73194909095764,967.6061134338379,37338,6643,30695,30695,0,11,5791000.0
5791,5791999,20.904737751665177,37.66589976364121,0.09209909222167101,981.4911971092224,394.79420232772827,967.7756423950195,37338,6643,30695,30695,0,11,5792000.0
5792,5792999,20.90387831791188,37.66389586122537,0.09209207493970062,981.6125102043152,394.8564190864563,967.9089431762695,37339,6643,30696,30696,0,11,5793000.0
5793,5793999,20.903168793407225,37.662678217252044,0.09208019781325483,981.7281258106232,394.9178133010864,967.9842796325684,37339,6643,30696,30696,0,11,5794000.0
5794,5794999,20.902690748156694,37.66111488439224,0.09206892182971438,981.9380223751068,394.98272132873535,968.0513000488281,37342,6644,30698,30698,0,11,5795000.0
5795,5795999,20.902290779340177,37.66026408038814,0.09205468840592246,982.1445596218109,395.04806900024414,968.1483154296875,37345,6645,30700,30700,0,11,5796000.0
5796,5796999,20.90189961940833,37.65874709937187,0.09204190702242332,982.4430882930756,395.1110575199127,968.3822746276855,37365,6647,30718,30718,0,11,5797000.0
5797,5797999,20.90202611328501,37.658358717426914,0.09202761970153461,982.5612342357635,395.17579078674316,968.545581817627,37365,6647,30718,30718,0,11,5798000.0
5798,5798999,20.901809341380275,37.657438129495766,0.09201441196029914,982.7711243629456,395.2388422489166,968.6456031799316,37369,6648,30721,30721,0,11,5799000.0
5799,5799999,20.901935796885525,37.656884496276156,0.09200170937912877,982.9666786193848,395.301340341568,968.7273330688477,37371,6649,30722,30722,0,11,5800000.0
5800,5800999,20.90160207776947,37.65555325587792,0.09199059288000333,983.1826634407043,395.3654053211212,968.7871742248535,37376,6650,30726,30726,0,11,5801000.0
5801,5801999,20.901538053993068,37.654605184470896,0.09198504027313137,983.2957797050476,395.427805185318,968.9468002319336,37376,6650,30726,30726,0,11,5802000.0
5802,5802999,20.901426070788823,37.65350260848041,0.0919749426748181,983.4114410877228,395.4898626804352,969.3134307861328,37381,6650,30731,30731,0,11,5803000.0
5803,5803999,20.901453262988436,37.65273532831149,0.0919655841132142,983.6354503631592,395.5629029273987,969.4505958557129,37383,6651,30732,30732,0,11,5804000.0
5804,5804999,20.90110492082498,37.65124783641553,0.0919620180313141,983.8324902057648,395.6255021095276,969.5631065368652,37385,6652,30733,30733,0,11,5805000.0
5805,5805999,20.900559233248796,37.64934092591405,0.09195528079968929,984.2045464515686,395.68822741508484,969.6076965332031,37391,6655,30736,30736,0,11,5806000.0
5806,5806999,20.89995393988196,37.647500345947876,0.09193716957144804,984.3223297595978,395.75078320503235,970.0948638916016,37401,6655,30746,30746,0,11,5807000.0
5807,5807999,20.89935952306251,37.64665300773624,0.0919116878564914,984.5212800502777,395.814790725708,970.3273468017578,37413,6656,30757,30757,0,11,5808000.0
5808,5808999,20.898933159367754,37.646043434792524,0.09188653568627492,984.6369545459747,395.87735056877136,970.5720329284668,37414,6656,30758,30758,0,11,5809000.0
5809,5809999,20.898432072461333,37.6447247718671,0.09187923225838424,984.8459982872009,395.940642118454,970.7276382446289,37418,6657,30761,30761,0,11,5810000.0
5810,5810999,20.89781266598607,37.64337084810192,0.09187015018710554,984.9850912094116,396.0105631351471,970.8708076477051,37418,6657,30761,30761,0,11,5811000.0
5811,5811999,20.89739677388872,37.64253704612289,0.09185072858859955,985.19029545784,396.07242941856384,971.2252349853516,37426,6658,30768,30768,0,11,5812000.0
5812,5812999,20.897103787849236,37.64181917757548,0.09183154727701681,985.3898358345032,396.13522028923035,971.4276123046875,37429,6659,30770,30770,0,11,5813000.0
5813,5813999,20.89690197808611,37.64064791517567,0.09181526912344173,985.5964367389679,396.2004702091217,971.5561218261719,37439,6660,30779,30779,0,11,5814000.0
5814,5814999,20.896814722160272,37.63974472373449,0.09180073521893628,985.7063834667206,396.2641839981079,971.698558807373,37439,6660,30779,30779,0,11,5815000.0
5815,5815999,20.896728015744852,37.63895418494539,0.09178519381106376,986.1619386672974,396.328369140625,971.7389831542969,37485,6664,30821,30821,0,11,5816000.0
5816,5816999,20.896990942230403,37.638504314211914,0.09177832070733682,986.2925231456757,396.3942070007324,971.9570007324219,37486,6664,30822,30822,0,11,5817000.0
5817,5817999,20.89765960763236,37.63906789874604,0.09177986788487524,986.5065016746521,396.45900559425354,972.4887390136719,37519,6665,30854,30854,0,11,5818000.0
5818,5818999,20.89826786363374,37.63916310153538,0.09179014439804889,986.6212277412415,396.52182722091675,972.6750297546387,37520,6665,30855,30855,0,11,5819000.0
5819,5819999,20.899126337048834,37.64002639019263,0.09180707166806745,986.8187999725342,396.5846211910248,972.756103515625,37522,6666,30856,30856,0,11,5820000.0
5820,5820999,20.900351602865314,37.64204438134006,0.09182321974212071,987.0292148590088,396.6507604122162,972.8934669494629,37525,6667,30858,30858,0,11,5821000.0
5821,5821999,20.901606650863528,37.643884311587385,0.09187520197678467,987.2410690784454,396.7142856121063,972.9837646484375,37527,6668,30859,30859,0,11,5822000.0
5822,5822999,20.903298176671814,37.64650901036201,0.09191511106376715,987.435628414154,396.7770788669586,973.0714836120605,37529,6669,30860,30860,0,11,5823000.0
5823,5823999,20.90609325727208,37.65150688855701,0.09195513940588418,987.5734457969666,396.8401246070862,973.3828239440918,37531,6669,30862,30862,0,11,5824000.0
5824,5824999,20.909191428008686,37.6587425893155,0.09196343299622312,987.6898415088654,396.90184688568115,973.5293884277344,37531,6669,30862,30862,0,11,5825000.0
5825,5825999,20.912090978747162,37.66490729582051,0.0920028989500945,987.8951714038849,396.9646966457367,973.6246948242188,37533,6670,30863,30863,0,11,5826000.0
5826,5826999,20.91439415808828,37.667705602956154,0.09204544556202499,988.0146939754486,397.02712416648865,973.7310562133789,37533,6670,30863,30863,0,11,5827000.0
5827,5827999,20.914225999744357,37.66703949461121,0.0920307922318866,988.1496248245239,397.0907824039459,974.3863067626953,37549,6670,30879,30879,0,11,5828000.0
5828,5828999,20.913166576628267,37.666020760443594,0.0920153505565916,988.3458344936371,397.1535584926605,974.643798828125,37554,6671,30883,30883,0,11,5829000.0
5829,5829999,20.912252618822304,37.665312455382775,0.09200356969538548,988.6421146392822,397.2190341949463,974.8541679382324,37562,6673,30889,30889,0,11,5830000.0
5830,5830999,20.91127663339251,37.66371655107503,0.09199965434302748,988.7519154548645,397.2816390991211,975.0423164367676,37562,6673,30889,30889,0,11,5831000.0
5831,5831999,20.910532373761598,37.66233127447559,0.09199026202832927,988.8604052066803,397.34424567222595,975.2428817749023,37564,6673,30891,30891,0,11,5832000.0
5832,5832999,20.910005692525612,37.66124194081389,0.09197643696806046,988.9836013317108,397.4084439277649,975.6568717956543,37570,6673,30897,30897,0,11,5833000.0
5833,5833999,20.909433375266275,37.65973259668491,0.09196968148550266,989.1850543022156,397.4722204208374,975.8402824401855,37572,6674,30898,30898,0,11,5834000.0
5834,5834999,20.909082526608593,37.6587544076914,0.09196633029538182,989.383670091629,397.5356287956238,975.9860076904297,37574,6675,30899,30899,0,11,5835000.0
5835,5835999,20.90924489796144,37.66149229061007,0.09195607679788165,989.4977269172668,397.5983953475952,976.1161003112793,37574,6675,30899,30899,0,11,5836000.0
5836,5836999,20.909716108589365,37.662191865345115,0.09196170627753186,989.6132833957672,397.6650171279907,976.2938957214355,37577,6675,30902,30902,0,11,5837000.0
5837,5837999,20.910737668447954,37.66360671392065,0.09197523412473896,989.9080815315247,397.72941493988037,976.4011764526367,37588,6677,30911,30911,0,11,5838000.0
5838,5838999,20.9121039494801,37.66535165677725,0.09201394896325776,990.1088123321533,397.7931911945343,976.7620735168457,37601,6678,30923,30923,0,11,5839000.0
5839,5839999,20.9133469650947,37.66641255968501,0.09204393955934698,990.4837782382965,397.8570878505707,976.8085174560547,37618,6681,30937,30937,0,11,5840000.0
5840,5840999,20.914956720215393,37.6679607429957,0.09206941309290084,990.6879043579102,397.9234058856964,976.9625015258789,37621,6682,30939,30939,0,11,5841000.0
5841,5841999,20.917026608262066,37.672297437820795,0.0920973500932658,990.8846020698547,397.98681902885437,977.1011276245117,37623,6683,30940,30940,0,11,5842000.0
5842,5842999,20.91937285059191,37.677436059243725,0.09213636439148731,991.079229593277,398.0498116016388,977.2394638061523,37626,6684,30942,30942,0,11,5843000.0
5843,5843999,20.921495234587038,37.67997793467599,0.09217037505546155,991.2081310749054,398.1174831390381,977.7965240478516,37642,6684,30958,30958,0,11,5844000.0
5844,5844999,20.924225451766336,37.68586592148704,0.09221944203682697,991.3221814632416,398.18058729171753,978.1163520812988,37644,6684,30960,30960,0,11,5845000.0
5845,5845999,20.92642316381672,37.689146057809005,0.09227445120699751,991.4371860027313,398.2434117794037,978.3105087280273,37644,6684,30960,30960,0,11,5846000.0
5846,5846999,20.929314867771215,37.69352100352834,0.09233687734838336,991.7206945419312,398.3065845966339,978.4188804626465,37656,6686,30970,30970,0,11,5847000.0
5847,5847999,20.930657057049732,37.694690614225,0.09235129553394994,991.9175560474396,398.3694431781769,978.78759765625,37668,6687,30981,30981,0,11,5848000.0
5848,5848999,20.929720244827305,37.694759379770275,0.09234459352818669,992.0311975479126,398.4353141784668,979.6049118041992,37690,6687,31003,31003,0,11,5849000.0
5849,5849999,20.928733241461376,37.69361637245264,0.09234797724519017,992.1387622356415,398.49881887435913,979.905445098877,37692,6687,31005,31005,0,11,5850000.0
5850,5850999,20.927641469230604,37.691858684207475,0.0923522154009726,992.3341913223267,398.56257796287537,980.0867156982422,37696,6688,31008,31008,0,11,5851000.0
5851,5851999,20.926565116481623,37.689951273901855,0.09235613364004669,992.4581029415131,398.62584257125854,980.3809471130371,37698,6688,31010,31010,0,11,5852000.0
5852,5852999,20.925540644988857,37.69157565961013,0.09234134689014584,992.5668933391571,398.6890387535095,980.6115570068359,37698,6688,31010,31010,0,11,5853000.0
5853,5853999,20.92444683578934,37.6894585224919,0.09234595749092234,992.844250202179,398.7523777484894,980.6629486083984,37710,6690,31020,31020,0,11,5854000.0
5854,5854999,20.923203764285518,37.68718203163356,0.09235329570938511,993.038756608963,398.81589818000793,980.8115081787109,37712,6691,31021,31021,0,11,5855000.0
5855,5855999,20.92206229933523,37.68540677843777,0.09235554804589663,993.167227268219,398.8822498321533,980.9696960449219,37714,6691,31023,31023,0,11,5856000.0
5856,5856999,20.920951920301153,37.68347536975195,0.09235782048494612,993.3830788135529,398.94786977767944,981.0782012939453,37724,6692,31032,31032,0,11,5857000.0
5857,5857999,20.920143394419693,37.68183209682583,0.0923564605137942,993.4957613945007,399.0124571323395,981.5067253112793,37739,6692,31047,31047,0,11,5858000.0
5858,5858999,20.919400866562423,37.68025148592267,0.09235500504469685,993.6076059341431,399.07615423202515,981.6709365844727,37740,6692,31048,31048,0,11,5859000.0
5859,5859999,20.918504421426608,37.67824031322851,0.09235798746531221,993.7297124862671,399.13907504081726,981.8042831420898,37741,6692,31049,31049,0,11,5860000.0
5860,5860999,20.917681237207987,37.67652231193258,0.09236068857077318,993.9423394203186,399.2030255794525,981.8901710510254,37748,6693,31055,31055,0,11,5861000.0
5861,5861999,20.916968693484332,37.67511512776219,0.09236245956092537,994.0697765350342,399.26621413230896,982.0149230957031,37750,6693,31057,31057,0,11,5862000.0
5862,5862999,20.916091897424945,37.673171701257125,0.09236898847764474,994.1757211685181,399.32926630973816,982.3214302062988,37753,6693,31060,31060,0,11,5863000.0
5863,5863999,20.91521843291261,37.67139009766172,0.09237445633947583,994.3778021335602,399.3936107158661,982.4208717346191,37757,6694,31063,31063,0,11,5864000.0
5864,5864999,20.914270001117735,37.66940142588279,0.09237820993391788,994.4988300800323,399.4558916091919,982.7474136352539,37763,6694,31069,31069,0,11,5865000.0
5865,5865999,20.913961538968355,37.668990773413505,0.09233244666804996,994.6947350502014,399.520503282547,983.3000106811523,37775,6695,31080,31080,0,11,5866000.0
5866,5866999,20.91362350716719,37.669042140210095,0.09230202017698619,994.8956527709961,399.584520816803,983.5775260925293,37778,6696,31082,31082,0,11,5867000.0
5867,5867999,20.912873714168622,37.66738666629448,0.09228495742299792,995.0936117172241,399.64810371398926,983.7062759399414,37783,6697,31086,31086,0,11,5868000.0
5868,5868999,20.912801292674047,37.667778969662976,0.09225241058810463,995.2961575984955,399.7105827331543,984.1493797302246,37796,6698,31098,31098,0,11,5869000.0
5869,5869999,20.91276557284075,37.667502027246876,0.09222263294150812,995.4096229076385,399.7749819755554,984.3976936340332,37797,6698,31099,31099,0,11,5870000.0
5870,5870999,20.91250249459263,37.66612911741996,0.09220590698842068,995.8836510181427,399.8438198566437,984.4319267272949,37813,6702,31111,31111,0,11,5871000.0
5871,5871999,20.91225314013737,37.66631700345613,0.09219101108775918,996.085595369339,399.90839886665344,984.6244316101074,37823,6703,31120,31120,0,11,5872000.0
5872,5872999,20.912127118228465,37.66519761351256,0.09217120025330583,996.2796139717102,399.9708116054535,984.8341217041016,37827,6704,31123,31123,0,11,5873000.0
5873,5873999,20.911942764023244,37.6640735847379,0.0921561782273338,996.3947131633759,400.0343499183655,984.999340057373,37827,6704,31123,31123,0,11,5874000.0
5874,5874999,20.91234771571982,37.66356000065613,0.09212335563482843,996.5145001411438,400.09912633895874,985.3581771850586,37834,6704,31130,31130,0,11,5875000.0
5875,5875999,20.91266701662235,37.66277016029322,0.0920986849482891,996.6352481842041,400.16236877441406,985.5437889099121,37834,6704,31130,31130,0,11,5876000.0
5876,5876999,20.91288912552155,37.662268683233656,0.09208355084906383,996.92427110672,400.2257468700409,985.5776290893555,37846,6706,31140,31140,0,11,5877000.0
5877,5877999,20.913161410582166,37.66169740891357,0.09207158610256072,997.2076334953308,400.2900276184082,985.6919059753418,37850,6708,31142,31142,0,11,5878000.0
5878,5878999,20.913367206615938,37.661466666846714,0.09206259748738344,997.4100770950317,400.35332703590393,985.8122863769531,37852,6709,31143,31143,0,11,5879000.0
5879,5879999,20.913883959108077,37.66114216167279,0.09204412646294602,997.6048271656036,400.4178786277771,985.9379463195801,37861,6710,31151,31151,0,11,5880000.0
5880,5880999,20.91547534001821,37.662149258333656,0.09200131924604049,997.8037495613098,400.47957038879395,986.194408416748,37869,6711,31158,31158,0,11,5881000.0
5881,5881999,20.916770069137495,37.662169818536796,0.09196470655803612,998.0020563602448,400.54232716560364,986.3170356750488,37879,6712,31167,31167,0,11,5882000.0
5882,5882999,20.91753827343268,37.66168960315671,0.09195070091441115,998.3198080062866,400.6066904067993,986.317554473877,37891,6714,31177,31177,0,11,5883000.0
5883,5883999,20.918483384743592,37.66243010708583,0.09192303887818176,998.4284474849701,400.6693458557129,986.4365653991699,37891,6714,31177,31177,0,11,5884000.0
5884,5884999,20.918771949391395,37.663409338662845,0.09189267850255467,998.5543653964996,400.7318093776703,986.7965927124023,37899,6714,31185,31185,0,11,5885000.0
5885,5885999,20.917866603618197,37.66125002735922,0.09188146432564992,998.7082936763763,400.80484676361084,987.0788841247559,37904,6714,31190,31190,0,11,5886000.0
5886,5886999,20.916982214585104,37.659408830859704,0.09187513717244011,998.8175563812256,400.867333650589,987.2503776550293,37906,6714,31192,31192,0,11,5887000.0
5887,5887999,20.916198508510902,37.65765073703101,0.09186810980078997,999.1064867973328,400.93144488334656,987.294563293457,37917,6716,31201,31201,0,11,5888000.0
5888,5888999,20.915495108298217,37.656322291349845,0.09186155675325425,999.2349798679352,400.9945149421692,987.4412879943848,37918,6716,31202,31202,0,11,5889000.0
5889,5889999,20.915212306716402,37.65527621892305,0.09185430855554211,999.3661873340607,401.0573556423187,987.7314910888672,37924,6716,31208,31208,0,11,5890000.0
5890,5890999,20.915298448173562,37.658249286263,0.09183091142073208,999.4830782413483,401.1200144290924,987.8776512145996,37924,6716,31208,31208,0,11,5891000.0
5891,5891999,20.914944250874903,37.656973296317254,0.09182326371711114,999.6817514896393,401.1831262111664,987.9655342102051,37926,6717,31209,31209,0,11,5892000.0
5892,5892999,20.91464889801455,37.65581483050915,0.09182021296202558,999.8147711753845,401.2492105960846,988.0593185424805,37926,6717,31209,31209,0,11,5893000.0
5893,5893999,20.914521427144166,37.65476081254707,0.09181944151377286,1000.0253522396088,401.3114175796509,988.0804100036621,37930,6718,31212,31212,0,11,5894000.0
5894,5894999,20.914406386228862,37.653594522868325,0.09181998314132556,1000.2344381809235,401.37571954727173,988.1216621398926,37937,6719,31218,31218,0,11,5895000.0
5895,5895999,20.91422591265039,37.65212402005164,0.09181302922761447,1000.3556904792786,401.4382607936859,988.3383369445801,37941,6719,31222,31222,0,11,5896000.0
5896,5896999,20.914542447240105,37.651845780451154,0.09180750993548858,1000.5678079128265,401.50117349624634,988.4087104797363,37944,6720,31224,31224,0,11,5897000.0
5897,5897999,20.91496766459642,37.65433922465559,0.09179933136851459,1000.7723805904388,401.56378269195557,988.4577941894531,37946,6721,31225,31225,0,11,5898000.0
5898,5898999,20.915265098205236,37.65411418615676,0.09179754060728607,1000.9786553382874,401.6292293071747,988.5482521057129,37948,6722,31226,31226,0,11,5899000.0
5899,5899999,20.915582170104994,37.65357632159098,0.09179414577295075,1001.1027796268463,401.6919984817505,988.6378974914551,37948,6722,31226,31226,0,11,5900000.0
5900,5900999,20.917088027517433,37.65537375446886,0.09179824574011564,1001.3269698619843,401.7572684288025,988.6192741394043,37950,6723,31227,31227,0,11,5901000.0
5901,5901999,20.918066303643187,37.655944818730035,0.09179904374174108,1001.5358560085297,401.8202340602875,988.7980041503906,37953,6724,31229,31229,0,11,5902000.0
5902,5902999,20.918960825181273,37.65577644542017,0.09180214889210048,1001.648243188858,401.882447719574,988.8846893310547,37953,6724,31229,31229,0,11,5903000.0
5903,5903999,20.919507803204116,37.655549149683566,0.09179852837980729,1001.8591601848602,401.9455609321594,988.8629570007324,37955,6725,31230,31230,0,11,5904000.0
5904,5904999,20.920249852828732,37.6552917533096,0.09179904365022584,1001.9843552112579,402.0101640224457,988.9348754882812,37955,6725,31230,31230,0,11,5905000.0
5905,5905999,20.919673220719396,37.65374079814016,0.09180010232771196,1002.186395406723,402.0735592842102,989.5045280456543,37976,6726,31250,31250,0,11,5906000.0
5906,5906999,20.918160581982573,37.65244157472221,0.09179848779347455,1002.3114070892334,402.13684248924255,989.8041229248047,37979,6726,31253,31253,0,11,5907000.0
5907,5907999,20.91682310438441,37.650747217454935,0.09179875308944263,1002.4251019954681,402.19823384284973,990.0468406677246,37982,6726,31256,31256,0,11,5908000.0
5908,5908999,20.915844469549405,37.64980708928532,0.09179665426002137,1002.5467793941498,402.2633731365204,990.2361221313477,37984,6726,31258,31258,0,11,5909000.0
5909,5909999,20.914658082675153,37.64783517834515,0.09179658416547498,1002.6541583538055,402.32581782341003,990.3937835693359,37984,6726,31258,31258,0,11,5910000.0
5910,5910999,20.913559553466953,37.64578739509789,0.09179808971187087,1002.7691295146942,402.3885154724121,990.7964363098145,37990,6726,31264,31264,0,11,5911000.0
5911,5911999,20.912388514815408,37.64365540151704,0.0918014710862477,1002.9730594158173,402.45240116119385,990.9434928894043,37992,6727,31265,31265,0,11,5912000.0
5912,5912999,20.91147111403418,37.64211838320644,0.09180292656629774,1003.0883665084839,402.5183939933777,991.1039199829102,37993,6727,31266,31266,0,11,5913000.0
5913,5913999,20.910503327576446,37.64040067499208,0.09180147935873295,1003.2971782684326,402.5811324119568,991.2376327514648,37995,6728,31267,31267,0,11,5914000.0
5914,5914999,20.909897988264955,37.641613540916005,0.09178396162805624,1003.409886598587,402.64373254776,991.4202117919922,37999,6728,31271,31271,0,11,5915000.0
5915,5915999,20.90930306421042,37.64055986293276,0.09177920109811477,1003.5317423343658,402.70639276504517,991.7476005554199,38002,6728,31274,31274,0,11,5916000.0
5916,5916999,20.9090097899115,37.640042835819344,0.09176892694908023,1003.7355365753174,402.7687261104584,991.9928207397461,38033,6729,31304,31304,0,11,5917000.0
5917,5917999,20.908745100547907,37.63903855253642,0.09176441588159612,1004.0290849208832,402.8315362930298,992.138240814209,38040,6731,31309,31309,0,11,5918000.0
5918,5918999,20.90877138840379,37.63871515227354,0.0917712887942439,1004.2292680740356,402.89405059814453,992.2893676757812,38043,6732,31311,31311,0,11,5919000.0
5919,5919999,20.90901077663267,37.64011618075495,0.09176222429346292,1004.3338379859924,402.95693945884705,992.4445495605469,38043,6732,31311,31311,0,11,5920000.0
5920,5920999,20.909317405552756,37.639946205872086,0.09177702358794138,1004.5482349395752,403.0198612213135,992.5721549987793,38045,6733,31312,31312,0,11,5921000.0
5921,5921999,20.90976444139024,37.64002481207425,0.0917879766291444,1004.6637518405914,403.08508944511414,993.0380363464355,38049,6733,31316,31316,0,11,5922000.0
5922,5922999,20.910288614027927,37.64015813463357,0.09178162850790839,1004.8738257884979,403.1494212150574,993.2051887512207,38051,6734,31317,31317,0,11,5923000.0
5923,5923999,20.910497385581532,37.6401531923646,0.09177470101236263,1004.9790341854095,403.21091198921204,993.3773651123047,38051,6734,31317,31317,0,11,5924000.0
5924,5924999,20.91070710634205,37.63954963829397,0.09178071218522876,1005.1014680862427,403.2725291252136,993.4999465942383,38051,6734,31317,31317,0,11,5925000.0
5925,5925999,20.910146192721488,37.63805128371005,0.09179507415675259,1005.2178254127502,403.3348696231842,993.7791442871094,38056,6734,31322,31322,0,11,5926000.0
5926,5926999,20.9085108260358,37.635581768062046,0.09180306668495819,1005.3440463542938,403.3984868526459,993.9595718383789,38057,6734,31323,31323,0,11,5927000.0
5927,5927999,20.90722344062345,37.63387306558773,0.09180174542473629,1005.6276550292969,403.46176290512085,993.9777717590332,38063,6736,31327,31327,0,11,5928000.0
5928,5928999,20.906012458574388,37.6321993225365,0.09180095481568906,1005.9279057979584,403.52470088005066,993.9854888916016,38076,6738,31338,31338,0,11,5929000.0
5929,5929999,20.905059279286228,37.631480035836276,0.09179898921213869,1006.0543324947357,403.59039306640625,994.1308135986328,38076,6738,31338,31338,0,11,5930000.0
5930,5930999,20.904199732307497,37.62975714382577,0.09179299360554638,1006.2629215717316,403.6530418395996,994.3997535705566,38092,6739,31353,31353,0,11,5931000.0
5931,5931999,20.903192449039718,37.627866350067585,0.09179158534491783,1006.4709372520447,403.7158486843109,994.4492454528809,38096,6740,31356,31356,0,11,5932000.0
5932,5932999,20.902387123240292,37.626439957492835,0.09178597170460012,1006.6813516616821,403.7799541950226,994.5565414428711,38098,6741,31357,31357,0,11,5933000.0
5933,5933999,20.901476134613734,37.62454569535919,0.09178423769498245,1006.8884327411652,403.8426432609558,994.6001510620117,38108,6742,31366,31366,0,11,5934000.0
5934,5934999,20.901012304364574,37.62331731934663,0.09178296354154158,1007.0999319553375,403.905752658844,994.6852073669434,38111,6743,31368,31368,0,11,5935000.0
5935,5935999,20.900977173472334,37.622833722073175,0.09177543094016571,1007.2174954414368,403.96870851516724,994.8116035461426,38112,6743,31369,31369,0,11,5936000.0
5936,5936999,20.901296396332263,37.623329215810514,0.0917679833662216,1007.3338227272034,404.0325379371643,995.0861587524414,38116,6743,31373,31373,0,11,5937000.0
5937,5937999,20.90182256631306,37.623816367518025,0.09176153949229282,1007.638179063797,404.0974180698395,995.1525001525879,38123,6745,31378,31378,0,11,5938000.0
5938,5938999,20.902337612596224,37.62415553490602,0.09175821440897036,1007.7675569057465,404.1604652404785,995.3162651062012,38124,6745,31379,31379,0,11,5939000.0
5939,5939999,20.90284053481092,37.62451097159757,0.09175738605782502,1007.8851866722107,404.2229428291321,995.4671363830566,38124,6745,31379,31379,0,11,5940000.0
5940,5940999,20.90369685974472,37.625451012515626,0.09174686877367577,1008.1076591014862,404.2967576980591,995.5290641784668,38134,6746,31388,31388,0,11,5941000.0
5941,5941999,20.904969594187083,37.62677886823684,0.09173885738327525,1008.4835062026978,404.3603150844574,995.5070838928223,38146,6749,31397,31397,0,11,5942000.0
5942,5942999,20.90588392250239,37.627514826932604,0.09173073170446644,1008.6037685871124,404.42413353919983,995.9018516540527,38150,6749,31401,31401,0,11,5943000.0
5943,5943999,20.90655488788931,37.627761168864694,0.0917260435785443,1008.8215713500977,404.48832511901855,996.0694274902344,38155,6750,31405,31405,0,11,5944000.0
5944,5944999,20.907232883790975,37.62786099308641,0.09171913173055912,1009.023690700531,404.55233216285706,996.1220932006836,38157,6751,31406,31406,0,11,5945000.0
5945,5945999,20.90758405605424,37.62724993027417,0.09172146729887154,1009.1452639102936,404.6143653392792,996.2138786315918,38157,6751,31406,31406,0,11,5946000.0
5946,5946999,20.90652114923175,37.62557878407226,0.09172110945675438,1009.2574150562286,404.6771652698517,996.8095817565918,38167,6751,31416,31416,0,11,5947000.0
5947,5947999,20.905324332763524,37.62390791156538,0.09172056170862442,1009.372264623642,404.74009227752686,997.1300926208496,38168,6751,31417,31417,0,11,5948000.0
5948,5948999,20.90443747805612,37.62296277121047,0.09171716916406181,1009.5900084972382,404.810040473938,997.3137092590332,38172,6752,31420,31420,0,11,5949000.0
5949,5949999,20.903558583078144,37.62125113341485,0.09171849285911082,1009.7087852954865,404.8735373020172,997.4957084655762,38174,6752,31422,31422,0,11,5950000.0
5950,5950999,20.902679797066675,37.619435647343145,0.09172114104895357,1009.829980134964,404.9367368221283,997.779613494873,38177,6752,31425,31425,0,11,5951000.0
5951,5951999,20.902208662536946,37.61913495680751,0.09171023200633288,1010.1191828250885,404.9990198612213,997.9917640686035,38182,6754,31428,31428,0,11,5952000.0
5952,5952999,20.901342865229722,37.61747637269337,0.09170628577590845,1010.3218483924866,405.0629940032959,998.1331367492676,38185,6755,31430,31430,0,11,5953000.0
5953,5953999,20.900670398584467,37.61588479089321,0.09170497548041046,1010.4439325332642,405.1265287399292,998.2882690429688,38185,6755,31430,31430,0,11,5954000.0
5954,5954999,20.90021463578748,37.61510153232204,0.09170452769273774,1010.553760766983,405.1894202232361,998.4107856750488,38185,6755,31430,31430,0,11,5955000.0
5955,5955999,20.899828440916053,37.61390414702339,0.09170167842944477,1010.7608773708344,405.25302505493164,998.5502853393555,38190,6756,31434,31434,0,11,5956000.0
5956,5956999,20.899386447582565,37.612908465483756,0.0916996093673863,1010.9734609127045,405.31727147102356,998.9570388793945,38205,6757,31448,31448,0,11,5957000.0
5957,5957999,20.899338972809282,37.61197138940393,0.09169467299343903,1011.0909111499786,405.38149404525757,999.4436378479004,38219,6757,31462,31462,0,11,5958000.0
5958,5958999,20.899352711776377,37.612017881343,0.09169171493132022,1011.3738875389099,405.4454069137573,999.5605163574219,38223,6759,31464,31464,0,11,5959000.0
5959,5959999,20.899649549314876,37.61230105022588,0.09168620069354627,1011.579915523529,405.50975346565247,999.7303161621094,38226,6760,31466,31466,0,11,5960000.0
5960,5960999,20.899640977196917,37.61166878067842,0.09168409044657655,1011.8670332431793,405.5736587047577,999.8052215576172,38230,6762,31468,31468,0,11,5961000.0
5961,5961999,20.900135874591776,37.6122796733916,0.09168288962341886,1011.9841725826263,405.63795924186707,999.9694595336914,38230,6762,31468,31468,0,11,5962000.0
5962,5962999,20.900321247746383,37.611834873488306,0.09168589889022305,1012.1898443698883,405.7017970085144,1000.2356605529785,38241,6763,31478,31478,0,11,5963000.0
5963,5963999,20.900567096748464,37.6114651957991,0.09167764182082783,1012.2987842559814,405.7654173374176,1000.4754943847656,38242,6763,31479,31479,0,11,5964000.0
5964,5964999,20.90078546711388,37.61114338681117,0.09167076325778323,1012.4169125556946,405.8277189731598,1000.6464385986328,38242,6763,31479,31479,0,11,5965000.0
5965,5965999,20.90146302467219,37.61113461413056,0.09166033825909414,1012.6279733181,405.8903434276581,1000.7066268920898,38244,6764,31480,31480,0,11,5966000.0
5966,5966999,20.901133656396475,37.609829311469475,0.09165485075169266,1012.830141544342,405.95272612571716,1000.805980682373,38252,6765,31487,31487,0,11,5967000.0
5967,5967999,20.90020121917068,37.60930043204232,0.0916463757729582,1013.0245161056519,406.015056848526,1001.4283447265625,38266,6766,31500,31500,0,11,5968000.0
5968,5968999,20.89902921187813,37.60720507481775,0.09164573837605561,1013.2233810424805,406.0785608291626,1001.6876487731934,38270,6767,31503,31503,0,11,5969000.0
5969,5969999,20.897820632641352,37.60511432397651,0.09164769303887343,1013.5977120399475,406.14375948905945,1001.865406036377,38288,6770,31518,31518,0,11,5970000.0
5970,5970999,20.897025035082464,37.60364512090843,0.09164801630517716,1013.7145645618439,406.20716762542725,1002.072883605957,38289,6770,31519,31519,0,11,5971000.0
5971,5971999,20.896357234409226,37.60251004110286,0.0916417120624392,1013.8303034305573,406.2706186771393,1002.3744277954102,38293,6770,31523,31523,0,11,5972000.0
5972,5972999,20.895884113166275,37.60148403737652,0.09163309158809885,1014.1222567558289,406.3360347747803,1002.5740242004395,38298,6772,31526,31526,0,11,5973000.0
5973,5973999,20.89547510301475,37.60326178817956,0.09161580215192178,1014.3263566493988,406.4010512828827,1002.7092704772949,38300,6773,31527,31527,0,11,5974000.0
5974,5974999,20.894850923608796,37.60167165178273,0.09161253759679633,1014.6139559745789,406.4644956588745,1002.7994956970215,38304,6775,31529,31529,0,11,5975000.0
5975,5975999,20.89447267662291,37.60046975420093,0.09161245703365883,1014.9858872890472,406.53041911125183,1002.8605003356934,38335,6778,31557,31557,0,11,5976000.0
5976,5976999,20.894449157261583,37.600344422995995,0.09160784132167066,1015.105073928833,406.5952365398407,1003.0390319824219,38335,6778,31557,31557,0,11,5977000.0
5977,5977999,20.894807393362218,37.601067727997986,0.09160532304050895,1015.2239747047424,406.6600270271301,1003.4277038574219,38341,6778,31563,31563,0,11,5978000.0
5978,5978999,20.8954679546597,37.60343562317435,0.09158522897353116,1015.5164995193481,406.72520995140076,1003.6038284301758,38345,6780,31565,31565,0,11,5979000.0
5979,5979999,20.896133475696853,37.60414596843742,0.09157653882474948,1015.7287147045135,406.7894263267517,1003.7418098449707,38355,6781,31574,31574,0,11,5980000.0
5980,5980999,20.897138519978064,37.60606271460298,0.09156245263963159,1015.843097448349,406.85308718681335,1003.8676719665527,38355,6781,31574,31574,0,11,5981000.0
5981,5981999,20.897907884537403,37.6069040212078,0.09155959835010108,1016.1361315250397,406.9172532558441,1003.885814666748,38359,6783,31576,31576,0,11,5982000.0
5982,5982999,20.899008665569294,37.608521245596044,0.09155432766739746,1016.2588329315186,406.98044443130493,1004.0756759643555,38360,6783,31577,31577,0,11,5983000.0
5983,5983999,20.900269495884682,37.6099765663382,0.09153580357383428,1016.5626397132874,407.04493141174316,1004.505744934082,38388,6785,31603,31603,0,11,5984000.0
5984,5984999,20.90154446632676,37.6114938340587,0.09152735631475972,1016.6771831512451,407.1086299419403,1004.8635101318359,38393,6785,31608,31608,0,11,5985000.0
5985,5985999,20.9030388728333,37.61321454807797,0.09151972504005856,1016.7947063446045,407.1718039512634,1005.0636825561523,38393,6785,31608,31608,0,11,5986000.0
5986,5986999,20.90483021736003,37.61572415560281,0.09151558653183733,1016.9974174499512,407.23555994033813,1005.1948547363281,38402,6786,31616,31616,0,11,5987000.0
5987,5987999,20.905588968339735,37.615854789056016,0.09149747320846435,1017.1125576496124,407.2980432510376,1005.3088455200195,38402,6786,31616,31616,0,11,5988000.0
5988,5988999,20.904412069792617,37.61422358042011,0.09149939298553023,1017.3136193752289,407.3626163005829,1006.241828918457,38422,6787,31635,31635,0,11,5989000.0
5989,5989999,20.90307773427998,37.612496789739644,0.0915000861512657,1017.5116493701935,407.4259150028229,1006.4920501708984,38434,6788,31646,31646,0,11,5990000.0
5990,5990999,20.901875612798086,37.61125277095883,0.09150344975528946,1017.6245114803314,407.48911690711975,1006.764518737793,38439,6788,31651,31651,0,11,5991000.0
5991,5991999,20.900714131882257,37.609390411100925,0.09151008631439717,1017.8329341411591,407.5529110431671,1006.9765281677246,38443,6789,31654,31654,0,11,5992000.0
5992,5992999,20.899682102210846,37.60773760986594,0.09150879170319326,1017.9403343200684,407.61614203453064,1007.3607635498047,38447,6789,31658,31658,0,11,5993000.0
5993,5993999,20.89854817875658,37.60577076109847,0.09151245063739077,1018.0555832386017,407.67993569374084,1007.5574073791504,38448,6789,31659,31659,0,11,5994000.0
5994,5994999,20.897422627134702,37.60362238380515,0.09151679373065214,1018.4444427490234,407.74775791168213,1007.6499633789062,38462,6792,31670,31670,0,11,5995000.0
5995,5995999,20.89670032267784,37.60271524929433,0.09151819401646533,1018.6553964614868,407.8118431568146,1007.7858581542969,38473,6793,31680,31680,0,11,5996000.0
5996,5996999,20.895819603166373,37.60142658123888,0.09152126161892393,1018.8617146015167,407.87562084198,1007.9344863891602,38476,6794,31682,31682,0,11,5997000.0
5997,5997999,20.89531127198307,37.600601170580106,0.0915149594918504,1018.9775052070618,407.93999123573303,1008.3991813659668,38491,6794,31697,31697,0,11,5998000.0
5998,5998999,20.894779721767296,37.59958151934148,0.0915173054200481,1019.0922091007233,408.00336027145386,1008.6111602783203,38493,6794,31699,31699,0,11,5999000.0
5999,5999999,20.894275024638077,37.59863952820266,0.09151780348720229,1019.2068266868591,408.0662045478821,1008.7613410949707,38494,6794,31700,31700,0,11,6000000.0
6000,6000999,20.89388446123523,37.59784944622034,0.09152269065664509,1019.3341250419617,408.12906765937805,1008.8642768859863,38494,6794,31700,31700,0,11,6001000.0
6001,6001999,20.893394374512916,37.59661793624772,0.09152513178430222,1019.5375499725342,408.19309306144714,1008.9578742980957,38497,6795,31702,31702,0,11,6002000.0
6002,6002999,20.892581145636978,37.59479072301172,0.09153190954722157,1019.6534199714661,408.25655341148376,1009.2784652709961,38502,6795,31707,31707,0,11,6003000.0
6003,6003999,20.891763632788635,37.593176205139514,0.09153503104651706,1019.7730150222778,408.31869673728943,1009.4275970458984,38502,6795,31707,31707,0,11,6004000.0
6004,6004999,20.890691891191874,37.59107258417987,0.09154133781432083,1019.8891053199768,408.3805193901062,1009.5169563293457,38502,6795,31707,31707,0,11,6005000.0
6005,6005999,20.89010125404817,37.59006796234684,0.09153230162732917,1020.0945100784302,408.44463777542114,1010.0606918334961,38513,6796,31717,31717,0,11,6006000.0
6006,6006999,20.88902833008201,37.58853484642687,0.09153546703903714,1020.4664876461029,408.5085027217865,1010.2090301513672,38528,6799,31729,31729,0,11,6007000.0
6007,6007999,20.888448853404228,37.59514031063166,0.09149601283549036,1020.6741874217987,408.5721173286438,1010.3806648254395,38533,6800,31733,31733,0,11,6008000.0
6008,6008999,20.88802897262809,37.597733235775586,0.09148517946811985,1020.8795392513275,408.63906025886536,1010.7093658447266,38539,6801,31738,31738,0,11,6009000.0
6009,6009999,20.887081060688356,37.59604126304265,0.09148593608414979,1020.9922785758972,408.70239663124084,1010.9348258972168,38539,6801,31738,31738,0,11,6010000.0
6010,6010999,20.88617940296687,37.59442645187456,0.09148513352890786,1021.3781011104584,408.7670900821686,1011.0084457397461,38546,6804,31742,31742,0,11,6011000.0
6011,6011999,20.885177864873246,37.59255300710682,0.09148753863406489,1021.5018649101257,408.83189702033997,1011.2274627685547,38546,6804,31742,31742,0,11,6012000.0
6012,6012999,20.884386196011953,37.59117118297869,0.09148601630304276,1021.7875277996063,408.8966646194458,1011.3030853271484,38558,6806,31752,31752,0,11,6013000.0
6013,6013999,20.883878289404358,37.59003091794558,0.09147914727367956,1021.9006414413452,408.9606146812439,1011.5037994384766,38559,6806,31753,31753,0,11,6014000.0
6014,6014999,20.883506095711738,37.588947260558975,0.09146841458980837,1022.2953767776489,409.0264344215393,1011.7485389709473,38574,6809,31765,31765,0,11,6015000.0
6015,6015999,20.88309448923129,37.587775767849436,0.09146010886694056,1022.4228012561798,409.0903105735779,1011.9609794616699,38574,6809,31765,31765,0,11,6016000.0
6016,6016999,20.882610557526732,37.5863062675372,0.09145398835650842,1022.7105555534363,409.1539080142975,1012.0093612670898,38586,6811,31775,31775,0,11,6017000.0
6017,6017999,20.88239691147578,37.58548651728171,0.09144687811503449,1023.0023348331451,409.21882247924805,1012.1359443664551,38598,6813,31785,31785,0,11,6018000.0
6018,6018999,20.882299093370715,37.58615819134178,0.09143034541908246,1023.2072942256927,409.2835726737976,1012.2396125793457,38600,6814,31786,31786,0,11,6019000.0
6019,6019999,20.882161663915088,37.58507336008161,0.09142581894020418,1023.3230090141296,409.34964966773987,1012.3936195373535,38600,6814,31786,31786,0,11,6020000.0
6020,6020999,20.88243180082397,37.58495049639074,0.09141244604277787,1023.537061214447,409.4145076274872,1012.6948394775391,38607,6815,31792,31792,0,11,6021000.0
6021,6021999,20.882435474567767,37.58435600119125,0.09140167897337215,1023.831741809845,409.4793903827667,1012.7821502685547,38612,6817,31795,31795,0,11,6022000.0
6022,6022999,20.882282868270465,37.58316879089835,0.09139469517546772,1023.9505214691162,409.54276037216187,1012.9360656738281,38612,6817,31795,31795,0,11,6023000.0
6023,6023999,20.88203308140252,37.58165430527497,0.0913851266197202,1024.153202533722,409.60605359077454,1013.0184097290039,38614,6818,31796,31796,0,11,6024000.0
6024,6024999,20.881443128020862,37.580121779666065,0.09138260143785859,1024.4509603977203,409.6690249443054,1013.182933807373,38634,6820,31814,31814,0,11,6025000.0
6025,6025999,20.88058316667455,37.57967626963819,0.0913730038141991,1024.6607222557068,409.7327802181244,1013.4758415222168,38642,6821,31821,31821,0,11,6026000.0
6026,6026999,20.879275454394353,37.577393349323486,0.09137525475508901,1024.7787449359894,409.79530787467957,1013.6165313720703,38642,6821,31821,31821,0,11,6027000.0
6027,6027999,20.87800937896208,37.5758217536219,0.091374359732601,1024.8945846557617,409.8601083755493,1013.8304100036621,38646,6821,31825,31825,0,11,6028000.0
6028,6028999,20.87684416187421,37.57383193103413,0.09137561704311137,1025.1014320850372,409.9229803085327,1013.9310531616211,38655,6822,31833,31833,0,11,6029000.0
6029,6029999,20.875812807322603,37.57219705316304,0.09137280302617712,1025.2238376140594,409.9858331680298,1014.2368049621582,38661,6822,31839,31839,0,11,6030000.0
6030,6030999,20.875089318623335,37.57137569375152,0.09136650357416642,1025.4221370220184,410.04934310913086,1014.3687019348145,38664,6823,31841,31841,0,11,6031000.0
6031,6031999,20.87422147230348,37.56945224631049,0.09136617756978405,1025.6403214931488,410.1128695011139,1014.5221977233887,38666,6824,31842,31842,0,11,6032000.0
6032,6032999,20.873261422905067,37.5673965482036,0.09136508577563052,1025.8414134979248,410.17599081993103,1014.6422309875488,38673,6825,31848,31848,0,11,6033000.0
6033,6033999,20.872532644127133,37.565698061302534,0.09136520435413664,1025.9579901695251,410.2390878200531,1014.7700424194336,38674,6825,31849,31849,0,11,6034000.0
6034,6034999,20.87187450473815,37.56436628890561,0.09136071879740482,1026.2598011493683,410.30337285995483,1014.8584213256836,38684,6827,31857,31857,0,11,6035000.0
6035,6035999,20.87143722737961,37.562862870938424,0.09135028314241345,1026.3795795440674,410.3672661781311,1015.1031799316406,38688,6827,31861,31861,0,11,6036000.0
6036,6036999,20.871191383820612,37.56164225612523,0.09133983056327355,1026.4941449165344,410.42997336387634,1015.2472877502441,38689,6827,31862,31862,0,11,6037000.0
6037,6037999,20.870891120409777,37.56069563084838,0.09132945235886503,1026.7039535045624,410.49305272102356,1015.3324775695801,38691,6828,31863,31863,0,11,6038000.0
6038,6038999,20.870674646121213,37.55944203855768,0.09132064925113459,1026.922222852707,410.5587682723999,1015.3865242004395,38693,6829,31864,31864,0,11,6039000.0
6039,6039999,20.870268463495346,37.558103097210996,0.0913124108346629,1027.0374772548676,410.62162494659424,1015.5216064453125,38693,6829,31864,31864,0,11,6040000.0
6040,6040999,20.869760454494944,37.55658451298309,0.09130514580729177,1027.2445240020752,410.6843464374542,1015.5211715698242,38695,6830,31865,31865,0,11,6041000.0
6041,6041999,20.869544104491435,37.55556166953483,0.09129235796743562,1027.370784521103,410.74759793281555,1015.7063446044922,38698,6830,31868,31868,0,11,6042000.0
6042,6042999,20.86907701561081,37.55395162620728,0.0912885821765923,1027.481714963913,410.81305408477783,1015.8675193786621,38699,6830,31869,31869,0,11,6043000.0
6043,6043999,20.86864329084015,37.55249439522825,0.09128248882201218,1027.7004442214966,410.87878346443176,1015.9172821044922,38701,6831,31870,31870,0,11,6044000.0
6044,6044999,20.868078141055122,37.55093864679845,0.09128281946883665,1027.9029688835144,410.9414687156677,1015.9622840881348,38703,6832,31871,31871,0,11,6045000.0
6045,6045999,20.867147904163712,37.54884360771338,0.09128950017269544,1028.125093460083,411.0061078071594,1016.4833297729492,38730,6833,31897,31897,0,11,6046000.0
6046,6046999,20.865858550417574,37.54793455648904,0.091294795450366,1028.236168384552,411.071741104126,1016.8413352966309,38734,6833,31901,31901,0,11,6047000.0
6047,6047999,20.864357319024002,37.54634891811646,0.09130500146514753,1028.5274374485016,411.135600566864,1016.9876365661621,38769,6835,31934,31934,0,11,6048000.0
6048,6048999,20.86278445067162,37.543989640297504,0.09131945909305161,1028.7298946380615,411.19875025749207,1017.1956405639648,38773,6836,31937,31937,0,11,6049000.0
6049,6049999,20.86142199952338,37.54198455168228,0.0913299393204402,1028.952172756195,411.2720699310303,1017.338306427002,38779,6837,31942,31942,0,11,6050000.0
6050,6050999,20.860123273814306,37.53965913391302,0.09133866071390218,1029.1753759384155,411.3485128879547,1017.7054481506348,38786,6838,31948,31948,0,11,6051000.0
6051,6051999,20.858802352886297,37.537473485397875,0.09135302677025559,1029.3778567314148,411.41098737716675,1017.9574584960938,38794,6839,31955,31955,0,11,6052000.0
6052,6052999,20.857558033693177,37.53516140834547,0.09136789306226023,1029.4952244758606,411.47367811203003,1018.1252403259277,38795,6839,31956,31956,0,11,6053000.0
6053,6053999,20.85630294512273,37.53295491027215,0.09137828611335941,1029.6968252658844,411.53667092323303,1018.2749176025391,38799,6840,31959,31959,0,11,6054000.0
6054,6054999,20.855273915024583,37.5310233626307,0.09138650179677388,1029.8248031139374,411.6042277812958,1018.5416412353516,38805,6840,31965,31965,0,11,6055000.0
6055,6055999,20.8540560243515,37.52889951174032,0.09140029435034847,1030.0305182933807,411.6682825088501,1018.7312507629395,38816,6841,31975,31975,0,11,6056000.0
6056,6056999,20.85300456753033,37.52691544196716,0.09140676195609487,1030.1395633220673,411.7309160232544,1019.1630859375,38820,6841,31979,31979,0,11,6057000.0
6057,6057999,20.851956493562284,37.52494566957757,0.09141525397077999,1030.252188205719,411.7922296524048,1019.3967094421387,38820,6841,31979,31979,0,11,6058000.0
6058,6058999,20.85072627241867,37.52258847525059,0.09142838037060408,1030.3731632232666,411.8573863506317,1019.5675849914551,38821,6841,31980,31980,0,11,6059000.0
6059,6059999,20.849700973665332,37.5209010092359,0.0914313517858577,1030.574744939804,411.91968846321106,1019.6696891784668,38823,6842,31981,31981,0,11,6060000.0
6060,6060999,20.84877923506305,37.519278717291755,0.09144091572280488,1030.7792162895203,411.9853332042694,1019.8093566894531,38825,6843,31982,31982,0,11,6061000.0
6061,6061999,20.84773798484713,37.51726460787516,0.09145053789114055,1030.9865500926971,412.04835271835327,1020.090648651123,38830,6844,31986,31986,0,11,6062000.0
6062,6062999,20.847196238892753,37.516148538356184,0.09145616559963254,1031.1840229034424,412.111896276474,1020.3413009643555,38840,6845,31995,31995,0,11,6063000.0
6063,6063999,20.84646805738143,37.51490219809823,0.09146323448262106,1031.3955903053284,412.174693107605,1020.5444488525391,38843,6846,31997,31997,0,11,6064000.0
6064,6064999,20.84573520132333,37.51343301497723,0.09147005332635738,1031.5058000087738,412.23667645454407,1020.7017631530762,38843,6846,31997,31997,0,11,6065000.0
6065,6065999,20.844554691411524,37.511242366869084,0.09148327656806143,1031.708866596222,412.29949259757996,1020.8099937438965,38845,6847,31998,31998,0,11,6066000.0
6066,6066999,20.843440011780217,37.50909473258993,0.09149177847157242,1031.8258123397827,412.36188864707947,1021.1108627319336,38847,6847,32000,32000,0,11,6067000.0
6067,6067999,20.842116847393005,37.506821486641485,0.09149927493518184,1031.950502872467,412.4248216152191,1021.2391052246094,38848,6847,32001,32001,0,11,6068000.0
6068,6068999,20.84107151447035,37.505229723665245,0.0915023111917318,1032.160850763321,412.4870114326477,1021.2950897216797,38858,6848,32010,32010,0,11,6069000.0
6069,6069999,20.839972883104185,37.50318819766842,0.09151036931008372,1032.3644759654999,412.5493302345276,1021.3079528808594,38860,6849,32011,32011,0,11,6070000.0
6070,6070999,20.83920402857886,37.50163895611149,0.0915128678803917,1032.476662158966,412.611599445343,1021.4754905700684,38861,6849,32012,32012,0,11,6071000.0
6071,6071999,20.838340045238827,37.4996854649076,0.09151673091438894,1032.5900342464447,412.67331290245056,1021.5707664489746,38861,6849,32012,32012,0,11,6072000.0
6072,6072999,20.837581448555213,37.498101281721276,0.09151764356206693,1032.7228302955627,412.7360279560089,1021.6403694152832,38861,6849,32012,32012,0,11,6073000.0
6073,6073999,20.83690679576926,37.49651040147298,0.09151935013941204,1032.9341769218445,412.80011010169983,1021.6662940979004,38867,6850,32017,32017,0,11,6074000.0
6074,6074999,20.8365526908156,37.49533207766741,0.09151401296636996,1033.1362760066986,412.8612551689148,1021.7383308410645,38870,6851,32019,32019,0,11,6075000.0
6075,6075999,20.835947787669216,37.49412515216881,0.09151380796716424,1033.355906009674,412.92612767219543,1021.8037147521973,38872,6852,32020,32020,0,11,6076000.0
6076,6076999,20.83558725151479,37.492728307148866,0.09150524813590333,1033.5712978839874,412.99173521995544,1021.9771194458008,38880,6853,32027,32027,0,11,6077000.0
6077,6077999,20.835332645665158,37.49129026051197,0.09149577978545143,1033.8802812099457,413.0546438694,1022.004280090332,38888,6855,32033,32033,0,11,6078000.0
6078,6078999,20.83485688865769,37.489642626413165,0.09149379249306244,1034.1742670536041,413.1175608634949,1022.0448532104492,38892,6857,32035,32035,0,11,6079000.0
6079,6079999,20.83438575585706,37.48800980808625,0.0914902701693463,1034.2999775409698,413.18047523498535,1022.186767578125,38892,6857,32035,32035,0,11,6080000.0
6080,6080999,20.833951223038312,37.48639047396594,0.09149114189767182,1034.6242842674255,413.24538588523865,1022.1487922668457,38900,6859,32041,32041,0,11,6081000.0
6081,6081999,20.833290624108216,37.48451830207177,0.09149303954092514,1034.83207821846,413.30813455581665,1022.2379989624023,38902,6860,32042,32042,0,11,6082000.0
6082,6082999,20.83272636527743,37.48285411881019,0.09149330117197252,1035.0355954170227,413.37314438819885,1022.5116806030273,38907,6861,32046,32046,0,11,6083000.0
6083,6083999,20.832238887026634,37.48201132040776,0.09149222461301021,1035.1554744243622,413.43517780303955,1022.6668510437012,38907,6861,32046,32046,0,11,6084000.0
6084,6084999,20.831450686127095,37.48008927207337,0.09150005140652506,1035.2671575546265,413.4973518848419,1022.7533645629883,38907,6861,32046,32046,0,11,6085000.0
6085,6085999,20.830465813033914,37.47800271061383,0.09150893783287994,1035.6614339351654,413.5618348121643,1022.7291030883789,38913,6864,32049,32049,0,11,6086000.0
6086,6086999,20.830044178740277,37.476401174872564,0.09149151772604147,1035.9609236717224,413.62557458877563,1023.1979484558105,38943,6866,32077,32077,0,11,6087000.0
6087,6087999,20.828918664674834,37.47442301877364,0.09148499028653112,1036.0931735038757,413.6962540149689,1023.5809478759766,38954,6866,32088,32088,0,11,6088000.0
6088,6088999,20.827984000805085,37.473117589583765,0.09147111087756188,1036.2267706394196,413.7674069404602,1023.8057899475098,38960,6866,32094,32094,0,11,6089000.0
6089,6089999,20.827154114728476,37.47160350255748,0.09146248499376874,1036.3429453372955,413.8339066505432,1024.0153465270996,38967,6866,32101,32101,0,11,6090000.0
6090,6090999,20.826490778407244,37.46986172193191,0.09144422927268836,1036.5499885082245,413.89791536331177,1024.2602767944336,38979,6867,32112,32112,0,11,6091000.0
6091,6091999,20.826273241004206,37.469242698378906,0.09137162868624127,1036.76243185997,413.9614808559418,1024.4500198364258,38982,6868,32114,32114,0,11,6092000.0
6092,6092999,20.825833610138854,37.46912255029254,0.0913371173210964,1037.1529664993286,414.02765130996704,1024.497501373291,38999,6871,32128,32128,0,11,6093000.0
6093,6093999,20.825589272771303,37.468071238817885,0.09130124992834243,1037.3568847179413,414.09112548828125,1024.6299629211426,39001,6872,32129,32129,0,11,6094000.0
6094,6094999,20.825049133469307,37.466456755748275,0.09127897965936693,1037.7481818199158,414.1558337211609,1024.688632965088,39022,6875,32147,32147,0,11,6095000.0
6095,6095999,20.824773040322324,37.46524894485608,0.09125046460261765,1037.9594383239746,414.2211079597473,1024.871379852295,39033,6876,32157,32157,0,11,6096000.0
6096,6096999,20.82460951447867,37.46385552430453,0.09122919748277114,1038.261553287506,414.2856261730194,1025.179931640625,39042,6878,32164,32164,0,11,6097000.0
6097,6097999,20.824621893753314,37.46245020992688,0.09120443663243993,1038.5599248409271,414.35110425949097,1025.4592094421387,39049,6880,32169,32169,0,11,6098000.0
6098,6098999,20.824354273747502,37.461200942563984,0.09118852404870137,1038.6714293956757,414.41429686546326,1025.6416969299316,39049,6880,32169,32169,0,11,6099000.0
6099,6099999,20.82416577190746,37.46000605234701,0.09117228830891655,1038.891919374466,414.4841547012329,1025.7885971069336,39054,6881,32173,32173,0,11,6100000.0
6100,6100999,20.823800574389168,37.45846389220247,0.09115869576488511,1039.3595895767212,414.5492482185364,1025.7447624206543,39062,6885,32177,32177,0,11,6101000.0
6101,6101999,20.823562487755247,37.45697987623769,0.0911480364432461,1039.6564028263092,414.6164708137512,1025.8804626464844,39070,6887,32183,32183,0,11,6102000.0
6102,6102999,20.823582486601197,37.45576247555404,0.09111804608568563,1039.9628472328186,414.68075728416443,1025.9880676269531,39076,6889,32187,32187,0,11,6103000.0
6103,6103999,20.824137536514705,37.45516326609706,0.09108152504654576,1040.1738255023956,414.74490451812744,1026.1255645751953,39080,6890,32190,32190,0,11,6104000.0
6104,6104999,20.824517606832668,37.45508130770604,0.09104563738854787,1040.3944323062897,414.80998492240906,1026.1801452636719,39082,6891,32191,32191,0,11,6105000.0
6105,6105999,20.824293241429633,37.45351389772911,0.09102971857566333,1040.6846060752869,414.8727869987488,1026.1961517333984,39086,6893,32193,32193,0,11,6106000.0
6106,6106999,20.823958390483902,37.45189217122,0.09101749686259009,1040.8035507202148,414.935156583786,1026.3352127075195,39087,6893,32194,32194,0,11,6107000.0
6107,6107999,20.823714737815905,37.450720215836824,0.09100031042052215,1040.9325351715088,414.9988663196564,1026.8234405517578,39094,6893,32201,32201,0,11,6108000.0
6108,6108999,20.822976362568564,37.449747865144865,0.09098861930702762,1041.3933997154236,415.0628242492676,1026.8843803405762,39107,6897,32210,32210,0,11,6109000.0
6109,6109999,20.822112437184558,37.44783533040278,0.09097878909457613,1041.5975811481476,415.12529969215393,1027.0559692382812,39112,6898,32214,32214,0,11,6110000.0
6110,6110999,20.821381996415717,37.44590120020667,0.09097176204529178,1041.71803689003,415.18944692611694,1027.1991539001465,39112,6898,32214,32214,0,11,6111000.0
6111,6111999,20.82105239141402,37.444675417611265,0.09095296047743984,1041.9210231304169,415.2533378601074,1027.4281768798828,39118,6899,32219,32219,0,11,6112000.0
6112,6112999,20.821065634156593,37.44392794098493,0.09091153029876542,1042.2254955768585,415.3219542503357,1027.596794128418,39130,6901,32229,32229,0,11,6113000.0
6113,6113999,20.820797550578423,37.44271886970504,0.09089101903439645,1042.3376338481903,415.38558626174927,1027.7869033813477,39131,6901,32230,32230,0,11,6114000.0
6114,6114999,20.820570715099308,37.441432546654156,0.09086478000607279,1042.6364436149597,415.44962191581726,1027.8507385253906,39142,6903,32239,32239,0,11,6115000.0
6115,6115999,20.820145258406953,37.439898057146806,0.09084518631882932,1042.7720034122467,415.5227041244507,1027.9834327697754,39143,6903,32240,32240,0,11,6116000.0
6116,6116999,20.820001560121725,37.43893423359295,0.09082469325569487,1043.0677824020386,415.58799719810486,1028.0375862121582,39164,6905,32259,32259,0,11,6117000.0
6117,6117999,20.81976484931864,37.43748575920076,0.0908081629355435,1043.2815811634064,415.6531140804291,1028.2346229553223,39171,6906,32265,32265,0,11,6118000.0
6118,6118999,20.820001332490044,37.43637628502257,0.0907848847907321,1043.3970665931702,415.7179718017578,1028.3719024658203,39172,6906,32266,32266,0,11,6119000.0
6119,6119999,20.820116306893947,37.43534804344784,0.0907653075869781,1043.8825662136078,415.7818863391876,1028.284740447998,39191,6910,32281,32281,0,11,6120000.0
6120,6120999,20.82004713635063,37.434110062700356,0.09074634792998215,1044.0922582149506,415.84899139404297,1028.3864936828613,39193,6911,32282,32282,0,11,6121000.0
6121,6121999,20.819974798861416,37.43314449177499,0.09072964127649008,1044.2957208156586,415.9126753807068,1028.500156402588,39196,6912,32284,32284,0,11,6122000.0
6122,6122999,20.81978063926855,37.43212302744652,0.09071534715904583,1044.5949635505676,415.97645688056946,1028.5163269042969,39200,6914,32286,32286,0,11,6123000.0
6123,6123999,20.819813092973376,37.431140195484495,0.09069627488827436,1044.815224647522,416.04356360435486,1028.9799537658691,39205,6915,32290,32290,0,11,6124000.0
6124,6124999,20.820051069883593,37.430120683090394,0.09067737274857013,1044.9311907291412,416.1083633899689,1029.2640495300293,39205,6915,32290,32290,0,11,6125000.0
6125,6125999,20.820075218920206,37.42887239472835,0.09066278110607873,1045.0518352985382,416.1716823577881,1029.4310417175293,39205,6915,32290,32290,0,11,6126000.0
6126,6126999,20.820112766396427,37.42760672676637,0.0906523175387639,1045.4478750228882,416.2387282848358,1029.4688529968262,39219,6918,32301,32301,0,11,6127000.0
6127,6127999,20.81981477098666,37.42650218046044,0.09064338962210938,1045.6566197872162,416.3023507595062,1029.5680389404297,39222,6919,32303,32303,0,12,6128000.0
6128,6128999,20.819139681283247,37.42491702165695,0.09064005322518975,1046.0507369041443,416.36678743362427,1030.1347694396973,39247,6922,32325,32325,0,12,6129000.0
6129,6129999,20.818378302020378,37.42333834816891,0.09063840405747858,1046.173853635788,416.4301917552948,1030.3776550292969,39251,6922,32329,32329,0,12,6130000.0
6130,6130999,20.817432256621853,37.421288290393704,0.09064116709605774,1046.4642174243927,416.49472761154175,1030.4991989135742,39259,6924,32335,32335,0,12,6131000.0
6131,6131999,20.816827138177093,37.42026554620354,0.0906386553691253,1046.5801446437836,416.5580382347107,1030.6346244812012,39260,6924,32336,32336,0,12,6132000.0
6132,6132999,20.816267060843327,37.41916975525784,0.09062766631134189,1046.698518037796,416.62097930908203,1030.9070167541504,39263,6924,32339,32339,0,12,6133000.0
6133,6133999,20.81547874248497,37.417272061599924,0.09062717326520664,1046.8163902759552,416.6843087673187,1031.0640716552734,39264,6924,32340,32340,0,12,6134000.0
6134,6134999,20.81480068221372,37.41587109235313,0.09062229077003625,1047.209727525711,416.74984097480774,1031.0731773376465,39270,6927,32343,32343,0,12,6135000.0
6135,6135999,20.813945014160648,37.41376447947167,0.09062576109725062,1047.5289318561554,416.8212652206421,1031.1637268066406,39278,6929,32349,32349,0,12,6136000.0
6136,6136999,20.813095900884758,37.41171046010141,0.09062731490414055,1047.6530528068542,416.88467955589294,1031.299934387207,39278,6929,32349,32349,0,12,6137000.0
6137,6137999,20.812465509976658,37.40985770129415,0.0906257892430602,1047.7657997608185,416.94840025901794,1031.7172470092773,39283,6929,32354,32354,0,12,6138000.0
6138,6138999,20.81204339237654,37.408286112437224,0.09062320112685385,1047.8860697746277,417.01195788383484,1031.8886260986328,39283,6929,32354,32354,0,12,6139000.0
6139,6139999,20.811291646654347,37.40635158580849,0.09062682827798696,1048.0932524204254,417.0764067173004,1031.9514465332031,39285,6930,32355,32355,0,12,6140000.0
6140,6140999,20.810708849414848,37.40443467882967,0.09063077358389204,1048.2978236675262,417.14038825035095,1032.0505714416504,39288,6931,32357,32357,0,12,6141000.0
6141,6141999,20.810128258384104,37.40267603862218,0.0906367407097457,1048.5039002895355,417.20420026779175,1032.1436958312988,39297,6932,32365,32365,0,12,6142000.0
6142,6142999,20.809625316259268,37.40092628303952,0.0906329511263152,1048.6304154396057,417.2675669193268,1032.3025970458984,39297,6932,32365,32365,0,12,6143000.0
6143,6143999,20.808951461467466,37.39897890012106,0.0906339374397066,1048.7566106319427,417.33045291900635,1032.4166717529297,39298,6932,32366,32366,0,12,6144000.0
6144,6144999,20.80862963291075,37.39894012222625,0.0906257820535985,1049.0630984306335,417.39373993873596,1032.4678840637207,39305,6934,32371,32371,0,12,6145000.0
6145,6145999,20.807585140736716,37.39730316878251,0.09063271654755789,1049.2860226631165,417.45748710632324,1032.9788208007812,39319,6935,32384,32384,0,12,6146000.0
6146,6146999,20.806371031218625,37.395639292506864,0.09064450545326441,1049.488930463791,417.52164578437805,1033.1870231628418,39324,6936,32388,32388,0,12,6147000.0
6147,6147999,20.805376082297872,37.394391521083044,0.09065057126262699,1049.6914703845978,417.5860946178436,1033.3737564086914,39330,6937,32393,32393,0,12,6148000.0
6148,6148999,20.804317080610467,37.39254976238443,0.09065852934402863,1050.0808598995209,417.650178194046,1033.6297874450684,39346,6940,32406,32406,0,12,6149000.0
6149,6149999,20.803287483443803,37.390790327005035,0.09066493985804491,1050.2873611450195,417.714218378067,1033.834629058838,39349,6941,32408,32408,0,12,6150000.0
6150,6150999,20.802203302817748,37.38882581900795,0.09066972293045228,1050.4982855319977,417.78076004981995,1033.9897994995117,39353,6942,32411,32411,0,12,6151000.0
6151,6151999,20.800982820556975,37.38673202222175,0.09067719980824063,1050.8022148609161,417.8451452255249,1034.0804824829102,39357,6944,32413,32413,0,12,6152000.0
6152,6152999,20.800080431047927,37.38575418040748,0.09067587472518002,1051.00639295578,417.9118709564209,1034.2179107666016,39360,6945,32415,32415,0,12,6153000.0
6153,6153999,20.799177785140206,37.38446169610172,0.09064633670569955,1051.3111090660095,417.97782039642334,1034.2861404418945,39372,6947,32425,32425,0,12,6154000.0
6154,6154999,20.798777961115515,37.38370636072417,0.09063099411301101,1051.4363234043121,418.04458570480347,1034.6847229003906,39381,6947,32434,32434,0,12,6155000.0
6155,6155999,20.798167621113702,37.38230073019189,0.09062615760214499,1051.6359479427338,418.1067385673523,1034.7941818237305,39384,6948,32436,32436,0,12,6156000.0
6156,6156999,20.797261933746412,37.380290505263815,0.09062476305874223,1052.121018409729,418.17116379737854,1034.7684211730957,39408,6952,32456,32456,0,12,6157000.0
6157,6157999,20.79671009326624,37.37889878768034,0.09062248697929576,1052.3183438777924,418.2344753742218,1034.9131889343262,39410,6953,32457,32457,0,12,6158000.0
6158,6158999,20.79612420825241,37.37744676404933,0.09061964979457848,1052.537581205368,418.30154037475586,1035.009033203125,39412,6954,32458,32458,0,12,6159000.0
6159,6159999,20.79549669804083,37.375912087067015,0.0906164705439465,1052.6567597389221,418.3657217025757,1035.1320991516113,39412,6954,32458,32458,0,12,6160000.0
6160,6160999,20.795195720135187,37.37476640932545,0.09060688559547336,1052.767344236374,418.4294092655182,1035.4675903320312,39421,6954,32467,32467,0,12,6161000.0
6161,6161999,20.794780048396436,37.373225883399435,0.09059736908754012,1053.0685498714447,418.49264574050903,1035.5129318237305,39425,6956,32469,32469,0,12,6162000.0
6162,6162999,20.794312345239405,37.37178319107486,0.09059182692983736,1053.1785118579865,418.55405497550964,1035.620319366455,39425,6956,32469,32469,0,12,6163000.0
6163,6163999,20.793748688184444,37.370180941277304,0.0905869413992616,1053.3895902633667,418.6172864437103,1035.6786918640137,39427,6957,32470,32470,0,12,6164000.0
6164,6164999,20.792956978324245,37.36815200375291,0.09058746894343994,1053.508968114853,418.68005084991455,1035.965419769287,39433,6957,32476,32476,0,12,6165000.0
6165,6165999,20.79210926896373,37.36763435143012,0.09058340995515857,1053.7330753803253,418.7430970668793,1036.1961479187012,39446,6958,32488,32488,0,12,6166000.0
6166,6166999,20.791236816553837,37.366080050517155,0.09057839939378742,1053.843552827835,418.8053557872772,1036.3581771850586,39447,6958,32489,32489,0,12,6167000.0
6167,6167999,20.79026044712803,37.3642068579581,0.09057818177341359,1054.0634784698486,418.8710980415344,1036.430763244629,39449,6959,32490,32490,0,12,6168000.0
6168,6168999,20.789495555304505,37.36271072051897,0.09057575328673784,1054.2709908485413,418.9339861869812,1036.52876663208,39453,6960,32493,32493,0,12,6169000.0
6169,6169999,20.788597290270175,37.36149254666276,0.09057397728957739,1054.4934666156769,419.00163435935974,1036.6758918762207,39458,6961,32497,32497,0,12,6170000.0
6170,6170999,20.787601153068806,37.359484585022344,0.09057789376660652,1054.7017014026642,419.06450963020325,1036.7239036560059,39461,6962,32499,32499,0,12,6171000.0
6171,6171999,20.786621501215368,37.357688343155,0.09058101606021574,1054.9255228042603,419.1269905567169,1036.769245147705,39463,6963,32500,32500,0,12,6172000.0
6172,6172999,20.78573321899922,37.35588951195094,0.09058383756460908,1055.0413625240326,419.18925738334656,1036.8681564331055,39464,6963,32501,32501,0,12,6173000.0
6173,6173999,20.784660642891144,37.3538291583799,0.09058366676669405,1055.2548089027405,419.25329065322876,1036.919506072998,39467,6964,32503,32503,0,12,6174000.0
6174,6174999,20.784045013566807,37.35480995249812,0.09056361330364782,1055.3735988140106,419.31560707092285,1037.0032691955566,39467,6964,32503,32503,0,12,6175000.0
6175,6175999,20.78328756589384,37.353104334006055,0.09056057351192137,1055.5869686603546,419.37837195396423,1037.1771545410156,39473,6965,32508,32508,0,12,6176000.0
6176,6176999,20.782954849158724,37.35207837119133,0.0905500572060618,1055.7895150184631,419.4411635398865,1037.1877098083496,39477,6966,32511,32511,0,12,6177000.0
6177,6177999,20.782354423447277,37.35075860623392,0.09054294589366774,1056.1020205020905,419.5073199272156,1037.2280769348145,39481,6968,32513,32513,0,12,6178000.0
6178,6178999,20.782491275218298,37.35038861170408,0.09053054578874464,1056.3135976791382,419.57054376602173,1037.3239440917969,39483,6969,32514,32514,0,12,6179000.0
6179,6179999,20.782437201870426,37.34973803582994,0.09052766988544869,1056.4268712997437,419.63315415382385,1037.440601348877,39483,6969,32514,32514,0,12,6180000.0
6180,6180999,20.782652995255493,37.349440951043526,0.09052203372529,1056.6360001564026,419.69578289985657,1037.4638633728027,39486,6970,32516,32516,0,12,6181000.0
6181,6181999,20.78318377713417,37.34981988251566,0.09051592347972559,1056.7632565498352,419.7586762905121,1037.626163482666,39488,6970,32518,32518,0,12,6182000.0
6182,6182999,20.783763963725956,37.35004085332589,0.09049717177328198,1056.8970873355865,419.82717394828796,1037.6901512145996,39488,6970,32518,32518,0,12,6183000.0
6183,6183999,20.783840252151506,37.349182432766646,0.09048701451427088,1057.1148977279663,419.89150285720825,1037.73388671875,39490,6971,32519,32519,0,12,6184000.0
6184,6184999,20.7836569527319,37.34804839269628,0.0904790506263442,1057.4281837940216,419.9549939632416,1037.714687347412,39502,6973,32529,32529,0,12,6185000.0
6185,6185999,20.783057347000437,37.34646091267196,0.09047690987180235,1057.53817820549,420.0175025463104,1038.1245651245117,39512,6973,32539,32539,0,12,6186000.0
6186,6186999,20.781644345545708,37.34416144641803,0.09048355022061183,1057.746572971344,420.080806016922,1038.4094581604004,39517,6974,32543,32543,0,12,6187000.0
6187,6187999,20.78045420012772,37.342899694822016,0.09047937496776892,1057.9628641605377,420.1467328071594,1038.9626731872559,39578,6975,32603,32603,0,12,6188000.0
6188,6188999,20.779388703419723,37.341667578712844,0.0904749763200502,1058.0861277580261,420.2109725475311,1039.485279083252,39581,6975,32606,32606,0,12,6189000.0
6189,6189999,20.77811011148786,37.339420667523925,0.09048055461198534,1058.3765449523926,420.2742438316345,1039.635799407959,39602,6977,32625,32625,0,12,6190000.0
6190,6190999,20.77706850011149,37.337459737410555,0.09047774892763483,1058.4926297664642,420.3356022834778,1040.033359527588,39609,6977,32632,32632,0,12,6191000.0
6191,6191999,20.77610216856442,37.335571249829826,0.0904745458084194,1058.7910842895508,420.3983771800995,1040.1696853637695,39614,6979,32635,32635,0,12,6192000.0
6192,6192999,20.775197172736135,37.333739547995116,0.09047329735743781,1058.9144756793976,420.4620201587677,1040.3493919372559,39614,6979,32635,32635,0,12,6193000.0
6193,6193999,20.774287268017424,37.33177178453111,0.09047298071734144,1059.1192581653595,420.5246434211731,1040.4514503479004,39617,6980,32637,32637,0,12,6194000.0
6194,6194999,20.7734855031345,37.3300999437142,0.0904715435997242,1059.332516670227,420.58737111091614,1040.5956230163574,39619,6981,32638,32638,0,12,6195000.0
6195,6195999,20.77291921494509,37.32858209539321,0.09046711040760547,1059.5392541885376,420.6498029232025,1040.7089881896973,39622,6982,32640,32640,0,12,6196000.0
6196,6196999,20.772540840162993,37.32726479091338,0.09046543386350525,1059.7565138339996,420.7143397331238,1041.0488739013672,39662,6983,32679,32679,0,12,6197000.0
6197,6197999,20.77201830857349,37.325660319356906,0.09046652427786006,1059.8828632831573,420.7767584323883,1041.2406196594238,39662,6983,32679,32679,0,12,6198000.0
6198,6198999,20.771478288432494,37.3240078620312,0.09046654845036217,1060.0081732273102,420.8387689590454,1041.3532752990723,39662,6983,32679,32679,0,12,6199000.0
6199,6199999,20.771280359050884,37.322989583283615,0.09046433521736841,1060.2075126171112,420.9009928703308,1041.4290466308594,39664,6984,32680,32680,0,12,6200000.0
6200,6200999,20.771138436147893,37.321907702841344,0.09046673776709002,1060.3324210643768,420.9663972854614,1041.5470123291016,39665,6984,32681,32681,0,12,6201000.0
6201,6201999,20.771026853042333,37.321946465181874,0.09046690586048689,1060.5486800670624,421.0291841030121,1041.6973838806152,39670,6985,32685,32685,0,12,6202000.0
6202,6202999,20.771195821100928,37.32099783515222,0.09045526900511536,1060.7577271461487,421.0918879508972,1041.900188446045,39675,6986,32689,32689,0,12,6203000.0
6203,6203999,20.771317872681134,37.31999786209974,0.09045188635552226,1060.8740804195404,421.15403485298157,1042.057689666748,39676,6986,32690,32690,0,12,6204000.0
6204,6204999,20.77118803246207,37.318592230591115,0.09045037556827962,1061.1651692390442,421.21645879745483,1042.096321105957,39688,6988,32700,32700,0,12,6205000.0
6205,6205999,20.77068834395783,37.31681024730869,0.09044816653469623,1061.2752389907837,421.2783966064453,1042.2281036376953,39688,6988,32700,32700,0,12,6206000.0
6206,6206999,20.769967723785182,37.314727288380645,0.09044827369457809,1061.6534254550934,421.34273314476013,1042.4467163085938,39709,6991,32718,32718,0,12,6207000.0
6207,6207999,20.768857259799532,37.31261512480348,0.09045070549981549,1061.863936662674,421.4068052768707,1042.5932388305664,39721,6992,32729,32729,0,12,6208000.0
6208,6208999,20.767866967190475,37.310804225032356,0.09044911155148283,1061.9731183052063,421.46905732154846,1042.7433815002441,39723,6992,32731,32731,0,12,6209000.0
6209,6209999,20.76684651504428,37.308689700512886,0.09045087907581673,1062.1919481754303,421.53342366218567,1043.221393585205,39785,6993,32792,32792,0,12,6210000.0
6210,6210999,20.766198051001822,37.30718184336207,0.09044307410879349,1062.3989491462708,421.596798658371,1043.580909729004,39797,6994,32803,32803,0,12,6211000.0
6211,6211999,20.765510045858512,37.305570797844254,0.09044029087512251,1062.6101071834564,421.6592810153961,1043.717960357666,39800,6995,32805,32805,0,12,6212000.0
6212,6212999,20.764728125109453,37.30394281908157,0.09044198102847678,1062.8230245113373,421.7249426841736,1043.7577743530273,39802,6996,32806,32806,0,12,6213000.0
6213,6213999,20.763967296835993,37.30242932162175,0.09044134373599033,1063.132268667221,421.7886073589325,1043.808925628662,39807,6998,32809,32809,0,12,6214000.0
6214,6214999,20.763106800964685,37.30061487816848,0.09044142124134824,1063.3416759967804,421.85344552993774,1043.8899841308594,39809,6999,32810,32810,0,12,6215000.0
6215,6215999,20.76218890765348,37.2988583679823,0.0904449163243134,1063.7229702472687,421.9169337749481,1043.8004570007324,39817,7002,32815,32815,0,12,6216000.0
6216,6216999,20.761736207534714,37.2980257019344,0.09043992984834426,1063.8496160507202,421.98299837112427,1044.0105209350586,39820,7002,32818,32818,0,12,6217000.0
6217,6217999,20.761014835188856,37.296195851282064,0.09043929847973475,1064.0630362033844,422.0471684932709,1044.074073791504,39822,7003,32819,32819,0,12,6218000.0
6218,6218999,20.76028292943383,37.29444573398617,0.09043564525153258,1064.2712740898132,422.1105360984802,1044.1287422180176,39833,7004,32829,32829,0,12,6219000.0
6219,6219999,20.759517343966344,37.292673602736706,0.09043267672762978,1064.5816156864166,422.17726945877075,1044.1718101501465,39837,7006,32831,32831,0,12,6220000.0
6220,6220999,20.75867166122641,37.29095852532788,0.0904308167850767,1064.9765529632568,422.2414951324463,1044.1874961853027,39845,7009,32836,32836,0,12,6221000.0
6221,6221999,20.757967413517747,37.28957126671324,0.09042813208472589,1065.0948717594147,422.3062148094177,1044.32954788208,39846,7009,32837,32837,0,12,6222000.0
6222,6222999,20.757296673453286,37.28814519026659,0.09042305589682509,1065.3944296836853,422.37000584602356,1044.3757667541504,39858,7011,32847,32847,0,12,6223000.0
6223,6223999,20.756735120740302,37.28651479802156,0.09041696546551115,1065.608005285263,422.43581438064575,1044.461742401123,39861,7012,32849,32849,0,12,6224000.0
6224,6224999,20.756117684110574,37.284951499591294,0.09041214264033925,1065.8235046863556,422.4982490539551,1044.5549011230469,39871,7013,32858,32858,0,12,6225000.0
6225,6225999,20.75536186961432,37.28306565158295,0.09041094533716676,1066.034904718399,422.56510305404663,1044.594383239746,39881,7014,32867,32867,0,12,6226000.0
6226,6226999,20.754442371612825,37.28098340811633,0.09041176169872489,1066.153978586197,422.6273763179779,1044.7007293701172,39881,7014,32867,32867,0,12,6227000.0
6227,6227999,20.753480343458634,37.280010063947934,0.0904125389483661,1066.2787585258484,422.69180822372437,1044.9650840759277,39887,7014,32873,32873,0,12,6228000.0
6228,6228999,20.752336237977453,37.278112407374095,0.0904165266353315,1066.4935219287872,422.7552692890167,1045.0815925598145,39894,7015,32879,32879,0,12,6229000.0
6229,6229999,20.751040627817193,37.27585258974518,0.09042371432473306,1066.6184947490692,422.81808710098267,1045.1836318969727,39895,7015,32880,32880,0,12,6230000.0
6230,6230999,20.75013926669062,37.27562807523568,0.09042560520992582,1066.9182074069977,422.88146710395813,1045.1719360351562,39914,7017,32897,32897,0,12,6231000.0
6231,6231999,20.7489156521413,37.27344196301156,0.09043098036438535,1067.1367146968842,422.9454782009125,1045.3618774414062,39924,7018,32906,32906,0,12,6232000.0
6232,6232999,20.74813940532554,37.27176387224477,0.0904308782643356,1067.353083372116,423.00966024398804,1045.4941101074219,39926,7019,32907,32907,0,12,6233000.0
6233,6233999,20.747393638173683,37.27032663685089,0.09042872080540865,1067.5584490299225,423.07394194602966,1045.5522956848145,39930,7020,32910,32910,0,12,6234000.0
6234,6234999,20.746708301810084,37.26894949573811,0.09042889282113431,1067.869601726532,423.13832354545593,1045.619140625,39934,7022,32912,32912,0,12,6235000.0
6235,6235999,20.746038438854356,37.26749385113954,0.09043306245971361,1068.087804555893,423.20156717300415,1045.7120628356934,39938,7023,32915,32915,0,12,6236000.0
6236,6236999,20.745600139834185,37.26674970662662,0.09043136135657737,1068.2092876434326,423.2704064846039,1045.8600006103516,39940,7023,32917,32917,0,12,6237000.0
6237,6237999,20.745302317905864,37.26598846999693,0.09042275754858276,1068.3314847946167,423.33534574508667,1046.2488632202148,39942,7023,32919,32919,0,12,6238000.0
6238,6238999,20.745099220913,37.26569957554983,0.09040859419190395,1068.5379853248596,423.3985872268677,1046.4497451782227,39945,7024,32921,32921,0,12,6239000.0
6239,6239999,20.744853775373485,37.264716128529315,0.09039877057147228,1068.7426931858063,423.4616107940674,1046.5764541625977,39947,7025,32922,32922,0,12,6240000.0
6240,6240999,20.744520491109487,37.26364270881648,0.09039392922346456,1068.896903038025,423.53502893447876,1046.7234840393066,39948,7025,32923,32923,0,12,6241000.0
6241,6241999,20.744224294276176,37.26246677323135,0.0903839814813936,1069.116555929184,423.59910893440247,1046.8394355773926,39950,7026,32924,32924,0,12,6242000.0
6242,6242999,20.744048272590867,37.26203106228358,0.09037201061044375,1069.2337074279785,423.6622965335846,1046.9352073669434,39950,7026,32924,32924,0,12,6243000.0
6243,6243999,20.74394044231377,37.26114865845509,0.09036019188380351,1069.4419157505035,423.72660994529724,1047.0390739440918,39953,7027,32926,32926,0,12,6244000.0
6244,6244999,20.743902476380285,37.26042864685616,0.09034772740978281,1069.5537390708923,423.78912711143494,1047.152400970459,39954,7027,32927,32927,0,12,6245000.0
6245,6245999,20.743737957540006,37.259138279083345,0.09033434161163523,1070.0356984138489,423.8523588180542,1047.06689453125,39963,7031,32932,32932,0,12,6246000.0
6246,6246999,20.743492785843937,37.25791382105951,0.09032816309094349,1070.159924507141,423.91472339630127,1047.1770324707031,39963,7031,32932,32932,0,12,6247000.0
6247,6247999,20.74295532051243,37.25643111312614,0.09032446047433818,1070.270800113678,423.97682905197144,1047.278450012207,39964,7031,32933,32933,0,12,6248000.0
6248,6248999,20.74186449571605,37.25456418019952,0.09032549481196994,1070.4034581184387,424.0554447174072,1047.8463554382324,39975,7031,32944,32944,0,12,6249000.0
6249,6249999,20.740550421192403,37.25270411640096,0.09032801813830893,1070.5148177146912,424.1191828250885,1048.0589714050293,39975,7031,32944,32944,0,12,6250000.0
6250,6250999,20.73945840046254,37.251306838177705,0.09033094738273695,1070.811464548111,424.18281173706055,1048.206356048584,39984,7033,32951,32951,0,12,6251000.0
6251,6251999,20.738610287045482,37.24998167027123,0.09033240053573577,1071.016488790512,424.24635648727417,1048.3382530212402,39989,7034,32955,32955,0,12,6252000.0
6252,6252999,20.737558570624174,37.24803268379602,0.09033489232094771,1071.1383833885193,424.30991411209106,1048.6531982421875,39991,7034,32957,32957,0,12,6253000.0
6253,6253999,20.736527844728887,37.2459443954571,0.09033776917800995,1071.340027809143,424.3730969429016,1048.7904739379883,39994,7035,32959,32959,0,12,6254000.0
6254,6254999,20.73545009991413,37.24433528727428,0.09033793764937015,1071.6430990695953,424.4369912147522,1048.9187545776367,39999,7037,32962,32962,0,12,6255000.0
6255,6255999,20.734821866002026,37.24356272638227,0.09033395935764976,1071.9382982254028,424.5017304420471,1049.0600662231445,40004,7039,32965,32965,0,12,6256000.0
6256,6256999,20.73402058662054,37.24201327999098,0.09033251107563078,1072.0578191280365,424.56779432296753,1049.1984596252441,40004,7039,32965,32965,0,12,6257000.0
6257,6257999,20.733417708395645,37.240709490359805,0.09033005787860526,1072.274446964264,424.63162899017334,1049.3191223144531,40010,7040,32970,32970,0,12,6258000.0
6258,6258999,20.73303070590537,37.23956419128447,0.09033038083414102,1072.480015039444,424.6952176094055,1049.5430946350098,40016,7041,32975,32975,0,12,6259000.0
6259,6259999,20.73302591281595,37.23925571851481,0.09032130065855148,1072.5970993041992,424.75821256637573,1049.7060356140137,40016,7041,32975,32975,0,12,6260000.0
6260,6260999,20.73276984423801,37.238179619229165,0.09032068740607624,1072.89412856102,424.8220965862274,1049.7636795043945,40049,7043,33006,33006,0,12,6261000.0
6261,6261999,20.732601167390545,37.23742703018156,0.0903176097923426,1073.014422416687,424.88793206214905,1049.9248657226562,40049,7043,33006,33006,0,12,6262000.0
6262,6262999,20.7330055477535,37.23780501446256,0.09030072206596873,1073.1370916366577,424.9519534111023,1050.0498695373535,40050,7043,33007,33007,0,12,6263000.0
6263,6263999,20.733287764900208,37.23793522882822,0.09029851067511896,1073.2554190158844,425.0176479816437,1050.1855583190918,40050,7043,33007,33007,0,12,6264000.0
6264,6264999,20.733591855622766,37.23758799042782,0.09029302286518015,1073.6514139175415,425.0826072692871,1050.400161743164,40056,7046,33010,33010,0,12,6265000.0
6265,6265999,20.734228816867972,37.23765224887402,0.09029040254713638,1073.7737181186676,425.1500279903412,1050.7391510009766,40057,7046,33011,33011,0,12,6266000.0
6266,6266999,20.734766014030242,37.23757058592903,0.0902868376664675,1073.9850051403046,425.21477150917053,1050.9079513549805,40059,7047,33012,33012,0,12,6267000.0
6267,6267999,20.73501796105277,37.23666674421393,0.09028458246413862,1074.2704617977142,425.2765054702759,1051.0236473083496,40092,7049,33043,33043,0,12,6268000.0
6268,6268999,20.734847356186542,37.235478943373536,0.0902855912743522,1074.4812352657318,425.3380365371704,1051.125877380371,40095,7050,33045,33045,0,12,6269000.0
6269,6269999,20.73382132283487,37.23363072965078,0.09029400011825106,1074.6006467342377,425.39949083328247,1051.6627159118652,40102,7050,33052,33052,0,12,6270000.0
6270,6270999,20.732643227923248,37.2315998915611,0.09030517114389736,1074.8146438598633,425.461332321167,1051.8733139038086,40110,7051,33059,33059,0,12,6271000.0
6271,6271999,20.73154774014635,37.230236435582405,0.09031298930108822,1074.9404261112213,425.5273451805115,1052.0277061462402,40111,7051,33060,33060,0,12,6272000.0
6272,6272999,20.730312428771597,37.228141673273115,0.09032174034534357,1075.063639163971,425.5904059410095,1052.2208786010742,40115,7051,33064,33064,0,12,6273000.0
6273,6273999,20.72914618120816,37.22604030039869,0.09033289373729814,1075.190290927887,425.65398812294006,1052.4565773010254,40116,7051,33065,33065,0,12,6274000.0
6274,6274999,20.728219812563136,37.224943660511784,0.0903356513029282,1075.3963718414307,425.7174117565155,1052.5856590270996,40119,7052,33067,33067,0,12,6275000.0
6275,6275999,20.727054973532304,37.223094568955474,0.09034205551767505,1075.689770936966,425.7807936668396,1052.6312713623047,40131,7054,33077,33077,0,12,6276000.0
6276,6276999,20.72602624349165,37.22148159220072,0.09034837667905682,1075.8161408901215,425.84569907188416,1052.7934455871582,40135,7054,33081,33081,0,12,6277000.0
6277,6277999,20.724954535615783,37.21958686497388,0.0903541735071417,1075.944566488266,425.9149398803711,1052.8843460083008,40135,7054,33081,33081,0,12,6278000.0
6278,6278999,20.724076934878447,37.217997362045004,0.09035773905432709,1076.1544160842896,425.97975301742554,1053.2756996154785,40143,7055,33088,33088,0,12,6279000.0
6279,6279999,20.72326207995033,37.216502311772054,0.09036057509170858,1076.276684999466,426.04611015319824,1053.489158630371,40143,7055,33088,33088,0,12,6280000.0
6280,6280999,20.72236566979425,37.21470411838012,0.09036934917189232,1076.5837123394012,426.1124429702759,1053.5544891357422,40150,7057,33093,33093,0,12,6281000.0
6281,6281999,20.721743026474805,37.21341211452169,0.0903698880641236,1076.706213235855,426.17631483078003,1053.6970825195312,40150,7057,33093,33093,0,12,6282000.0
6282,6282999,20.721017765178697,37.211985299593614,0.09037911069135429,1076.9084532260895,426.2402403354645,1053.8119850158691,40160,7058,33102,33102,0,12,6283000.0
6283,6283999,20.72009824315921,37.21022757046401,0.09039103035922802,1077.1266491413116,426.3066771030426,1054.0097618103027,40166,7059,33107,33107,0,12,6284000.0
6284,6284999,20.7190260208779,37.20817936150024,0.09040024238475064,1077.3406426906586,426.3700964450836,1054.1248741149902,40197,7060,33137,33137,0,12,6285000.0
6285,6285999,20.717856795670837,37.205943661226364,0.09041732118476853,1077.5491893291473,426.4327163696289,1054.1895866394043,40200,7061,33139,33139,0,12,6286000.0
6286,6286999,20.716961622470087,37.20444401311015,0.09042233851560799,1077.762367963791,426.495968580246,1054.6454963684082,40212,7062,33150,33150,0,12,6287000.0
6287,6287999,20.715996553550227,37.20303246663537,0.09042914383127021,1077.9049184322357,426.5707094669342,1054.8703842163086,40213,7062,33151,33151,0,12,6288000.0
6288,6288999,20.715107988832695,37.203152343927805,0.09048339665099125,1078.1246137619019,426.6363151073456,1055.0057220458984,40218,7063,33155,33155,0,12,6289000.0
6289,6289999,20.71411899700739,37.20189294882031,0.090494265201292,1078.3383376598358,426.705607175827,1055.1288719177246,40228,7064,33164,33164,0,12,6290000.0
6290,6290999,20.713203983915957,37.20046437018725,0.09050150582337202,1078.4621453285217,426.77265214920044,1055.48579788208,40233,7064,33169,33169,0,12,6291000.0
6291,6291999,20.71208602330094,37.198643949632945,0.090507350672978,1078.5840375423431,426.8392024040222,1055.6305694580078,40233,7064,33169,33169,0,12,6292000.0
6292,6292999,20.711057578379314,37.19689559763742,0.09051351586681389,1078.9843928813934,426.9069187641144,1055.6705741882324,40248,7067,33181,33181,0,12,6293000.0
6293,6293999,20.70998646414092,37.195158269439254,0.09051749285961819,1079.287347793579,426.97312211990356,1055.7655220031738,40253,7069,33184,33184,0,12,6294000.0
6294,6294999,20.708997995894617,37.193245473905556,0.0905209476436567,1079.4040701389313,427.03643131256104,1055.9103393554688,40253,7069,33184,33184,0,12,6295000.0
6295,6295999,20.70796901363478,37.191225346170455,0.0905240728478045,1079.5387604236603,427.10185194015503,1056.153434753418,40258,7069,33189,33189,0,12,6296000.0
6296,6296999,20.707322653097794,37.19000186109137,0.0905214352877064,1079.7439436912537,427.1655285358429,1056.337490081787,40265,7070,33195,33195,0,12,6297000.0
6297,6297999,20.706665667652516,37.18847792334612,0.09051958095054391,1079.9461121559143,427.2288782596588,1056.4433784484863,40268,7071,33197,33197,0,12,6298000.0
6298,6298999,20.70610612538971,37.18726514438356,0.09051653794232306,1080.1655976772308,427.29540848731995,1056.516616821289,40270,7072,33198,33198,0,12,6299000.0
6299,6299999,20.705669062893637,37.1861450070274,0.09050768111661522,1080.3757994174957,427.35934829711914,1056.5974922180176,40272,7073,33199,33199,0,12,6300000.0
6300,6300999,20.705193069078426,37.18479979418332,0.09050162138405127,1080.4904301166534,427.42231607437134,1056.7030181884766,40272,7073,33199,33199,0,12,6301000.0
6301,6301999,20.70488796135027,37.18365333258855,0.09049591101932819,1080.6112775802612,427.4861786365509,1056.9410095214844,40278,7073,33205,33205,0,12,6302000.0
6302,6302999,20.7047247518853,37.18273210252948,0.09048109310158758,1080.7301075458527,427.54932951927185,1057.1857147216797,40280,7073,33207,33207,0,12,6303000.0
6303,6303999,20.70458334933597,37.18264933680922,0.09046801928060144,1080.9470133781433,427.6156551837921,1057.2929611206055,40284,7074,33210,33210,0,12,6304000.0
6304,6304999,20.70430444930411,37.181533993396926,0.09046450907565318,1081.258736371994,427.6825647354126,1057.3411178588867,40288,7076,33212,33212,0,12,6305000.0
6305,6305999,20.703880810518054,37.18070640377459,0.09045515585362196,1081.3671152591705,427.7453262805939,1057.4618186950684,40288,7076,33212,33212,0,12,6306000.0
6306,6306999,20.7036456773439,37.180999413893815,0.09043583692838641,1081.6774814128876,427.8097417354584,1057.8319396972656,40310,7078,33232,33232,0,12,6307000.0
6307,6307999,20.70269189486766,37.180042820721184,0.09043622191365941,1081.8043496608734,427.87318420410156,1058.0638427734375,40311,7078,33233,33233,0,12,6308000.0
6308,6308999,20.70163011991553,37.17810333023527,0.0904422200856504,1082.1312036514282,427.9444899559021,1058.1484375,40327,7080,33247,33247,0,12,6309000.0
6309,6309999,20.700895220230713,37.177258561240734,0.09044295137872782,1082.3588907718658,428.0186548233032,1058.275161743164,40332,7081,33251,33251,0,12,6310000.0
6310,6310999,20.700173612280683,37.17580626715347,0.09044171255291378,1082.658854484558,428.0836458206177,1058.4946098327637,40350,7083,33267,33267,0,12,6311000.0
6311,6311999,20.69937282603311,37.173917215071704,0.09043744106860807,1083.0551357269287,428.14757204055786,1058.7101821899414,40362,7086,33276,33276,0,12,6312000.0
6312,6312999,20.698492934662873,37.17202267319356,0.09043697201331125,1083.3510506153107,428.2112374305725,1058.8954963684082,40369,7088,33281,33281,0,12,6313000.0
6313,6313999,20.697893064221528,37.17095019900493,0.09042897027178831,1083.4673371315002,428.27400040626526,1059.0728340148926,40369,7088,33281,33281,0,12,6314000.0
6314,6314999,20.697003181691475,37.16909182924605,0.09042772835644763,1083.7721235752106,428.3387384414673,1059.164234161377,40408,7090,33318,33318,0,12,6315000.0
6315,6315999,20.69641730344766,37.16813711792278,0.09042414358473516,1083.902824640274,428.4099090099335,1059.3183555603027,40409,7090,33319,33319,0,12,6316000.0
6316,6316999,20.695629067454664,37.16687886180321,0.09041880870298125,1084.0313129425049,428.4737956523895,1059.6032905578613,40414,7090,33324,33324,0,12,6317000.0
6317,6317999,20.69521158305552,37.16567873950313,0.09040769940269633,1084.2421000003815,428.53698348999023,1059.7200775146484,40417,7091,33326,33326,0,12,6318000.0
6318,6318999,20.694689432385825,37.1658505360069,0.0903943533910827,1084.3579244613647,428.6014597415924,1059.8324394226074,40417,7091,33326,33326,0,12,6319000.0
6319,6319999,20.694077755086983,37.16452641006597,0.09038988873455855,1084.6722085475922,428.6651291847229,1059.8721160888672,40421,7093,33328,33328,0,12,6320000.0
6320,6320999,20.693480187830854,37.16295800614592,0.09038541559544233,1084.9600493907928,428.72733879089355,1059.9118728637695,40426,7095,33331,33331,0,12,6321000.0
6321,6321999,20.69304250666412,37.161626295721575,0.0903790028156165,1085.171215057373,428.7937180995941,1060.0058135986328,40428,7096,33332,33332,0,12,6322000.0
6322,6322999,20.6926158747237,37.16034627889246,0.09037150156102547,1085.3875801563263,428.8598144054413,1060.1267585754395,40433,7097,33336,33336,0,12,6323000.0
6323,6323999,20.69246224055152,37.15929105923056,0.09036262176027754,1085.5910048484802,428.923180103302,1060.2234840393066,40435,7098,33337,33337,0,12,6324000.0
6324,6324999,20.69192847694131,37.15782839528142,0.09035554369583643,1085.710914850235,428.9887924194336,1060.3534889221191,40436,7098,33338,33338,0,12,6325000.0
6325,6325999,20.691307397258374,37.15614308591144,0.09035109082482062,1085.826847076416,429.0524663925171,1060.4350395202637,40436,7098,33338,33338,0,12,6326000.0
6326,6326999,20.6906738341914,37.155051233761185,0.09034641309377911,1085.9661490917206,429.11534333229065,1060.526668548584,40436,7098,33338,33338,0,12,6327000.0
6327,6327999,20.689658100562724,37.15330862701437,0.09034626024869874,1086.1713254451752,429.17829751968384,1061.0343627929688,40450,7099,33351,33351,0,12,6328000.0
6328,6328999,20.688881928038793,37.152334087581295,0.09034283040823832,1086.2808678150177,429.24227809906006,1061.2970924377441,40452,7099,33353,33353,0,12,6329000.0
6329,6329999,20.687936646332464,37.151513045870175,0.09034145478127342,1086.5902512073517,429.3063895702362,1061.490493774414,40464,7101,33363,33363,0,12,6330000.0
6330,6330999,20.68692132364377,37.14957549082955,0.09034558368062318,1086.9873893260956,429.37098145484924,1061.62548828125,40481,7104,33377,33377,0,12,6331000.0
6331,6331999,20.685908535753345,37.147539332454635,0.09034818936915734,1087.1051561832428,429.4341633319855,1061.898151397705,40486,7104,33382,33382,0,12,6332000.0
6332,6332999,20.68525707718347,37.146007003191336,0.09034371260393392,1087.3234298229218,429.49798583984375,1062.0451622009277,40488,7105,33383,33383,0,12,6333000.0
6333,6333999,20.68433920285499,37.144173185026744,0.09034250853093917,1087.4437444210052,429.56127738952637,1062.2300720214844,40489,7105,33384,33384,0,12,6334000.0
6334,6334999,20.68365384365519,37.14257879749262,0.09033879479682616,1087.6615958213806,429.624614238739,1062.3068237304688,40491,7106,33385,33385,0,12,6335000.0
6335,6335999,20.682857005488703,37.141706031247814,0.0903336747259903,1087.9512221813202,429.68779850006104,1062.385597229004,40511,7108,33403,33403,0,12,6336000.0
6336,6336999,20.682251654125427,37.14012451849314,0.09032855078798385,1088.1683068275452,429.75097465515137,1062.5210494995117,40514,7109,33405,33405,0,12,6337000.0
6337,6337999,20.681804591170657,37.13847223858203,0.0903175218660649,1088.310124874115,429.8139007091522,1062.777675628662,40518,7109,33409,33409,0,12,6338000.0
6338,6338999,20.681714631780707,37.13705315860831,0.09029919306960388,1088.4214730262756,429.8779718875885,1062.9301834106445,40518,7109,33409,33409,0,12,6339000.0
6339,6339999,20.681609510582533,37.13615905774539,0.0902829027570361,1088.540916442871,429.94070839881897,1063.0544929504395,40519,7109,33410,33410,0,12,6340000.0
6340,6340999,20.681421017829052,37.134674190292095,0.09027114012594073,1088.7541296482086,430.00305223464966,1063.1121559143066,40521,7110,33411,33411,0,12,6341000.0
6341,6341999,20.68097082287641,37.1329262728838,0.0902634144810851,1088.9682078361511,430.06597781181335,1063.176113128662,40524,7111,33413,33413,0,12,6342000.0
6342,6342999,20.68088851712649,37.13183163828352,0.09025022520105896,1089.1823365688324,430.1285238265991,1063.2323570251465,40528,7112,33416,33416,0,12,6343000.0
6343,6343999,20.68096073350573,37.13055588580437,0.09022919055888923,1089.4838399887085,430.1930367946625,1063.4686584472656,40535,7114,33421,33421,0,12,6344000.0
6344,6344999,20.68127433589875,37.12944134867058,0.0902047898608378,1089.6816000938416,430.2556610107422,1063.5861549377441,40538,7115,33423,33423,0,12,6345000.0
6345,6345999,20.681291620454743,37.128139492757406,0.09018756549782769,1089.892166852951,430.3183562755585,1063.663475036621,40540,7116,33424,33424,0,12,6346000.0
6346,6346999,20.681014102788854,37.1265450523937,0.09017624067283969,1090.0945842266083,430.38134145736694,1063.7337532043457,40543,7117,33426,33426,0,12,6347000.0
6347,6347999,20.680300987611517,37.12464694571183,0.09017323529906851,1090.3058245182037,430.44510197639465,1064.1336669921875,40557,7118,33439,33439,0,12,6348000.0
6348,6348999,20.679642509936432,37.12469811825918,0.09016543898449403,1090.594908952713,430.5079667568207,1064.3291969299316,40566,7120,33446,33446,0,12,6349000.0
6349,6349999,20.678792273710624,37.124442265372224,0.09015571324166805,1090.8018867969513,430.5711510181427,1064.4647903442383,40569,7121,33448,33448,0,12,6350000.0
6350,6350999,20.678084982004787,37.12320514116931,0.09014400244739729,1091.100392818451,430.63402795791626,1064.6331367492676,40581,7123,33458,33458,0,12,6351000.0
6351,6351999,20.677382739646948,37.12179471817791,0.09014013962411449,1091.301486492157,430.6969392299652,1064.7234840393066,40583,7124,33459,33459,0,12,6352000.0
6352,6352999,20.676563580621465,37.12036463775475,0.0901353756756541,1091.6085088253021,430.76210379600525,1064.9673538208008,40595,7126,33469,33469,0,12,6353000.0
6353,6353999,20.67580697604608,37.11875912850348,0.09012840241294418,1091.924479007721,430.82708644866943,1065.0402641296387,40607,7128,33479,33479,0,12,6354000.0
6354,6354999,20.67513618394371,37.117329662811535,0.09012495773857099,1092.0398287773132,430.8900394439697,1065.1573371887207,40607,7128,33479,33479,0,12,6355000.0
6355,6355999,20.674455780729456,37.11594604409476,0.0901312736417822,1092.1528022289276,430.95293736457825,1065.274917602539,40608,7128,33480,33480,0,12,6356000.0
6356,6356999,20.673946757305227,37.11540479700079,0.09012481560111874,1092.4716646671295,431.01661372184753,1065.3683128356934,40622,7130,33492,33492,0,12,6357000.0
6357,6357999,20.67340974637509,37.11415772453646,0.09012440524346477,1092.855978012085,431.08095836639404,1065.392894744873,40637,7133,33504,33504,0,12,6358000.0
6358,6358999,20.673551666020902,37.113816548396215,0.09012178011965188,1093.1719529628754,431.14792108535767,1065.6177253723145,40651,7135,33516,33516,0,12,6359000.0
6359,6359999,20.674302041973625,37.114908102159674,0.09011078433423692,1093.4035604000092,431.21134090423584,1065.7428283691406,40653,7136,33517,33517,0,12,6360000.0
6360,6360999,20.674801576812666,37.115480867459134,0.09009937408690594,1093.6143696308136,431.2748911380768,1065.8092651367188,40655,7137,33518,33518,0,12,6361000.0
6361,6361999,20.67554190736043,37.11622003143702,0.09008638909208433,1093.7257359027863,431.3405249118805,1065.9208793640137,40655,7137,33518,33518,0,12,6362000.0
6362,6362999,20.67645415266692,37.11695458766296,0.09007274817465316,1093.934311389923,431.4056580066681,1066.04154586792,40657,7138,33519,33519,0,12,6363000.0
6363,6363999,20.67774895823356,37.11909751746658,0.09006474739823145,1094.1503279209137,431.4689018726349,1066.0934410095215,40660,7139,33521,33521,0,12,6364000.0
6364,6364999,20.679057538503134,37.119972589633406,0.0900548764293041,1094.5416209697723,431.5328998565674,1066.210849761963,40682,7142,33540,33540,0,12,6365000.0
6365,6365999,20.680551148800195,37.12075231378639,0.09005510267355532,1094.6513347625732,431.5950622558594,1066.3424377441406,40682,7142,33540,33540,0,12,6366000.0
6366,6366999,20.681692350559732,37.12104917740065,0.09004814155146901,1094.7896299362183,431.6601686477661,1066.4297561645508,40682,7142,33540,33540,0,12,6367000.0
6367,6367999,20.682362803993666,37.12067939971224,0.09004311349181837,1095.0948255062103,431.7231707572937,1066.4366302490234,40687,7144,33543,33543,0,12,6368000.0
6368,6368999,20.68209776262344,37.1193439737519,0.09003284634385345,1095.302917957306,431.78637075424194,1066.7098274230957,40698,7145,33553,33553,0,12,6369000.0
6369,6369999,20.681839265871368,37.12125176064436,0.09000397279664663,1095.516943693161,431.85044860839844,1066.862663269043,40703,7146,33557,33557,0,12,6370000.0
6370,6370999,20.68148555906228,37.12163328547423,0.08998657775010421,1095.6362807750702,431.9138948917389,1067.057746887207,40707,7146,33561,33561,0,12,6371000.0
6371,6371999,20.68091453498187,37.12022467788126,0.08997864809800016,1095.8446884155273,431.97723388671875,1067.1760139465332,40720,7147,33573,33573,0,12,6372000.0
6372,6372999,20.680423394287356,37.11878330287967,0.08997317557818918,1095.9613568782806,432.04153275489807,1067.3127555847168,40721,7147,33574,33574,0,12,6373000.0
6373,6373999,20.680107488889625,37.118884288408566,0.08995357720096997,1096.2894217967987,432.10937213897705,1067.5482711791992,40739,7149,33590,33590,0,12,6374000.0
6374,6374999,20.6797210835695,37.1175479249626,0.08994132566920088,1096.5969994068146,432.1744132041931,1067.6327629089355,40744,7151,33593,33593,0,12,6375000.0
6375,6375999,20.67938924655675,37.11642750160327,0.08993354329750647,1096.9049756526947,432.2390298843384,1067.7168807983398,40750,7153,33597,33597,0,12,6376000.0
6376,6376999,20.67903403389259,37.115086301334124,0.08992825198158472,1097.117956161499,432.3058850765228,1067.890281677246,40754,7154,33600,33600,0,12,6377000.0
6377,6377999,20.678643493084596,37.11369200635514,0.0899272548744453,1097.5230884552002,432.37092208862305,1067.9095077514648,40773,7157,33616,33616,0,12,6378000.0
6378,6378999,20.67860346122375,37.11369106442324,0.08992463352973878,1097.6557278633118,432.4364273548126,1068.0833129882812,40774,7157,33617,33617,0,12,6379000.0
6379,6379999,20.678717999237684,37.11284287841246,0.08992754046720741,1097.9576017856598,432.5010325908661,1068.6042594909668,40784,7159,33625,33625,0,12,6380000.0
6380,6380999,20.678916992951283,37.11219120136461,0.0899384612264349,1098.0796377658844,432.567501783371,1068.8707656860352,40784,7159,33625,33625,0,12,6381000.0
6381,6381999,20.6792430786765,37.11170416073253,0.08994459394540977,1098.3859069347382,432.6346707344055,1068.9478645324707,40788,7161,33627,33627,0,12,6382000.0
6382,6382999,20.679812145812235,37.111855892360104,0.08994780497716515,1098.6984593868256,432.7022964954376,1069.0184516906738,40792,7163,33629,33629,0,12,6383000.0
6383,6383999,20.680461882177266,37.112148852227385,0.08997354635603405,1098.9094412326813,432.7678928375244,1069.1636924743652,40794,7164,33630,33630,0,12,6384000.0
6384,6384999,20.681062838426808,37.112172850164846,0.08997447360584676,1099.0225265026093,432.8326017856598,1069.3336181640625,40796,7164,33632,33632,0,12,6385000.0
6385,6385999,20.682145553931484,37.112707137696134,0.08998895626300751,1099.3268692493439,432.8966820240021,1069.5009574890137,40804,7166,33638,33638,0,12,6386000.0
6386,6386999,20.683127456509133,37.113772394150985,0.08999674470549857,1099.7276043891907,432.9592456817627,1069.5491752624512,40813,7169,33644,33644,0,12,6387000.0
6387,6387999,20.684251241725946,37.11401634466772,0.09000205643937653,1099.8397393226624,433.0221917629242,1069.6991691589355,40813,7169,33644,33644,0,12,6388000.0
6388,6388999,20.684906183378367,37.11374138684878,0.08999700052305248,1100.0477459430695,433.08505058288574,1069.7482681274414,40816,7170,33646,33646,0,12,6389000.0
6389,6389999,20.68472563460039,37.11265502758568,0.08998015181060348,1100.169145822525,433.1484513282776,1070.1874694824219,40825,7170,33655,33655,0,12,6390000.0
6390,6390999,20.68426992404991,37.111786239956665,0.08996433646936342,1100.4693744182587,433.21231985092163,1070.3966217041016,40836,7172,33664,33664,0,12,6391000.0
6391,6391999,20.683699843965574,37.11005537454486,0.08995054780371814,1100.5773251056671,433.2750759124756,1070.5816841125488,40838,7172,33666,33666,0,12,6392000.0
6392,6392999,20.683248165927886,37.10879655904055,0.08993877921961724,1101.0613324642181,433.3403923511505,1070.6268577575684,40865,7176,33689,33689,0,12,6393000.0
6393,6393999,20.683292575277783,37.10871519029254,0.08991763909157535,1101.1747033596039,433.4036729335785,1070.763515472412,40865,7176,33689,33689,0,12,6394000.0
6394,6394999,20.683132637218826,37.10763974887178,0.08990195554743807,1101.396362543106,433.4678943157196,1071.0897064208984,40873,7177,33696,33696,0,12,6395000.0
6395,6395999,20.682987685540148,37.10669437459797,0.08989136527043007,1101.5066273212433,433.5320084095001,1071.2741088867188,40873,7177,33696,33696,0,12,6396000.0
6396,6396999,20.682970156077484,37.1059087823114,0.08988200418949177,1101.7190504074097,433.5995264053345,1071.4107055664062,40876,7178,33698,33698,0,12,6397000.0
6397,6397999,20.682902888295843,37.10489980524335,0.08987029951947723,1101.922977924347,433.6630074977875,1071.5144386291504,40879,7179,33700,33700,0,12,6398000.0
6398,6398999,20.683131167781326,37.105426534509995,0.08985679701623883,1102.0446376800537,433.72608494758606,1071.648868560791,40881,7179,33702,33702,0,12,6399000.0
6399,6399999,20.683449830018994,37.10487527458921,0.08984336893023648,1102.3652958869934,433.7906711101532,1071.6535034179688,40895,7181,33714,33714,0,12,6400000.0
6400,6400999,20.68386005754269,37.104339181140894,0.0898326906015533,1102.4974706172943,433.8560914993286,1072.0211601257324,40901,7181,33720,33720,0,12,6401000.0
6401,6401999,20.6845013999813,37.10406905636635,0.08982453242320232,1102.6064138412476,433.91870522499084,1072.160732269287,40901,7181,33720,33720,0,12,6402000.0
6402,6402999,20.68490940907144,37.10354437385568,0.08981772488190276,1102.7121486663818,433.98144245147705,1072.291805267334,40902,7181,33721,33721,0,12,6403000.0
6403,6403999,20.685247883107287,37.103053687642394,0.08980733097656868,1103.114910364151,434.0464143753052,1072.2336196899414,40909,7184,33725,33725,0,12,6404000.0
6404,6404999,20.685646776480965,37.102649381693695,0.08980037483156844,1103.2398869991302,434.1108958721161,1072.3975296020508,40909,7184,33725,33725,0,12,6405000.0
6405,6405999,20.685983969361644,37.10193942526531,0.08979335224019791,1103.4617335796356,434.17559480667114,1072.586269378662,40912,7185,33727,33727,0,12,6406000.0
6406,6406999,20.686801732643232,37.10175442539999,0.08977743308097696,1103.6821403503418,437.6947751045227,1072.9745826721191,40917,7186,33731,33731,0,12,6407000.0
6407,6407999,20.687360335650084,37.101271740757404,0.08976589642416,1103.8956952095032,437.75845313072205,1073.1696548461914,40920,7187,33733,33733,0,12,6408000.0
6408,6408999,20.68786875194612,37.100580091798385,0.08975411279572176,1104.2252411842346,437.82447385787964,1073.1818389892578,40925,7189,33736,33736,0,12,6409000.0
6409,6409999,20.688205511161954,37.099746465881594,0.08974061212192741,1104.4398546218872,437.889196395874,1073.3043098449707,40927,7190,33737,33737,0,12,6410000.0
6410,6410999,20.687904880974145,37.09833298253427,0.08972545868879189,1104.7737469673157,437.95394802093506,1073.6853294372559,40947,7192,33755,33755,0,12,6411000.0
6411,6411999,20.68783751309486,37.098544159055564,0.08969639545502861,1105.0017569065094,438.0211343765259,1074.0476379394531,40958,7193,33765,33765,0,12,6412000.0
6412,6412999,20.687348927976227,37.098055301095926,0.08968118344578646,1105.213969707489,438.0837414264679,1074.2425956726074,40968,7194,33774,33774,0,12,6413000.0
6413,6413999,20.686976959998415,37.0984769404163,0.08965665139709522,1105.4228134155273,438.1463212966919,1074.3983116149902,40972,7195,33777,33777,0,12,6414000.0
6414,6414999,20.68669648931796,37.09716858076125,0.08963442054571202,1105.646283864975,438.21264576911926,1074.6677627563477,40989,7196,33793,33793,0,12,6415000.0
6415,6415999,20.686332331482994,37.09661023057163,0.0896207543533808,1106.2632155418396,438.2779049873352,1074.6612739562988,41009,7201,33808,33808,0,12,6416000.0
6416,6416999,20.68588940407051,37.09528537775505,0.08960604230819891,1106.4788081645966,438.34408164024353,1074.830165863037,41012,7202,33810,33810,0,12,6417000.0
6417,6417999,20.685571698905246,37.09506374097529,0.08958513089784892,1106.9894661903381,438.4113209247589,1074.8226509094238,41046,7206,33840,33840,0,12,6418000.0
6418,6418999,20.685124653461916,37.09368425715416,0.08957225357575604,1107.2120802402496,438.47698163986206,1074.9282035827637,41050,7207,33843,33843,0,12,6419000.0
6419,6419999,20.6848867764981,37.09255055687442,0.08955704178941559,1107.5328960418701,438.5419092178345,1075.2543601989746,41073,7209,33864,33864,0,12,6420000.0
6420,6420999,20.68480218855108,37.09148662583387,0.08953743742693432,1107.779610157013,438.609756231308,1075.4946784973145,41076,7210,33866,33866,0,12,6421000.0
6421,6421999,20.684613883237787,37.090408038298406,0.08952258633655108,1107.894005060196,438.6735374927521,1075.6435203552246,41077,7210,33867,33867,0,12,6422000.0
6422,6422999,20.684526909421397,37.08933953029246,0.08950614252209776,1108.010478258133,438.737181186676,1075.7573738098145,41077,7210,33867,33867,0,12,6423000.0
6423,6423999,20.684439118734343,37.0881453365115,0.08948930424406654,1108.2256393432617,438.8028120994568,1075.8674964904785,41079,7211,33868,33868,0,12,6424000.0
6424,6424999,20.68438656221841,37.086850278013074,0.08947332672411457,1108.4458103179932,438.8669373989105,1076.0737495422363,41084,7212,33872,33872,0,12,6425000.0
6425,6425999,20.68418526758042,37.086454994216716,0.08945902473997303,1108.6701889038086,438.9322361946106,1076.2849426269531,41092,7213,33879,33879,0,12,6426000.0
6426,6426999,20.683720559099818,37.08599996977117,0.08945107854112389,1108.8870251178741,438.9966197013855,1076.4296264648438,41094,7214,33880,33880,0,12,6427000.0
6427,6427999,20.682978506573257,37.08419537817931,0.08945322160038383,1109.2146408557892,439.0602526664734,1076.6449928283691,41103,7216,33887,33887,0,12,6428000.0
6428,6428999,20.68235306201472,37.08295137691234,0.08944939033123256,1109.4277997016907,439.12441396713257,1076.8951263427734,41110,7217,33893,33893,0,12,6429000.0
6429,6429999,20.681577241798497,37.08131711117679,0.0894536434662615,1109.5559344291687,439.18874645233154,1077.0779914855957,41111,7217,33894,33894,0,12,6430000.0
6430,6430999,20.68103912113968,37.08028163485953,0.08944942313666515,1109.8781189918518,439.2535364627838,1077.141399383545,41124,7219,33905,33905,0,12,6431000.0
6431,6431999,20.680341184965258,37.078838167526065,0.0894467438679104,1110.018473625183,439.3237512111664,1077.5438079833984,41134,7219,33915,33915,0,12,6432000.0
6432,6432999,20.679965693069132,37.078244353141535,0.08943943425738443,1110.236661195755,439.38854122161865,1077.725975036621,41137,7220,33917,33917,0,12,6433000.0
6433,6433999,20.6794534905613,37.07726208255862,0.08943782829810443,1110.4539997577667,439.45317459106445,1077.840934753418,41139,7221,33918,33918,0,12,6434000.0
6434,6434999,20.679104522767346,37.07667763499554,0.08942653932598899,1110.6794319152832,439.5205798149109,1077.9158401489258,41141,7222,33919,33919,0,12,6435000.0
6435,6435999,20.678662074365608,37.075891344588484,0.08942336535582496,1110.904568195343,439.5897750854492,1078.0668029785156,41152,7223,33929,33929,0,12,6436000.0
6436,6436999,20.678450068959695,37.07527418363544,0.08941926853008098,1111.1306626796722,439.656063079834,1078.1562957763672,41154,7224,33930,33930,0,12,6437000.0
6437,6437999,20.67862632720102,37.0748460376614,0.08940895763693346,1111.4499402046204,439.7210350036621,1078.4195365905762,41170,7226,33944,33944,0,12,6438000.0
6438,6438999,20.678610477480728,37.074003914570504,0.08940286753049242,1111.5739114284515,439.7874689102173,1078.5824890136719,41170,7226,33944,33944,0,12,6439000.0
6439,6439999,20.678804716599174,37.07360108708381,0.08939548298585664,1111.7036187648773,439.8548288345337,1078.688850402832,41170,7226,33944,33944,0,12,6440000.0
6440,6440999,20.679256223766014,37.07426333278893,0.08938323957997951,1111.911783695221,439.9208116531372,1078.7693977355957,41173,7227,33946,33946,0,12,6441000.0
6441,6441999,20.679433375592836,37.073709869712125,0.08937736503019933,1112.236577987671,439.9861843585968,1078.786060333252,41178,7229,33949,33949,0,12,6442000.0
6442,6442999,20.679951712279127,37.07378563672542,0.08937456855849868,1112.4529802799225,440.0503089427948,1078.8531341552734,41180,7230,33950,33950,0,12,6443000.0
6443,6443999,20.680667059244247,37.074314919573865,0.08936268155662064,1112.585133075714,440.1147549152374,1079.102207183838,41184,7230,33954,33954,0,12,6444000.0
6444,6444999,20.68107975658611,37.074084449895395,0.08935123831109981,1112.8116192817688,440.18069410324097,1079.21826171875,41187,7231,33956,33956,0,12,6445000.0
6445,6445999,20.681587854792305,37.074864125050524,0.08934132862088306,1113.0420470237732,440.2476224899292,1079.2525215148926,41189,7232,33957,33957,0,12,6446000.0
6446,6446999,20.681848222901056,37.07442686141509,0.08933136045140255,1113.1600680351257,440.31328678131104,1079.37113571167,41189,7232,33957,33957,0,12,6447000.0
6447,6447999,20.68181346576058,37.07338625870317,0.08931403890991652,1113.2984733581543,440.3770785331726,1079.7217407226562,41202,7232,33970,33970,0,12,6448000.0
6448,6448999,20.68157225229674,37.07329220425282,0.08930722906785538,1113.607144832611,440.4405345916748,1079.876365661621,41221,7234,33987,33987,0,12,6449000.0
6449,6449999,20.682020463891405,37.074072260152526,0.08929923132648498,1113.8132214546204,440.5038208961487,1080.003818511963,41231,7235,33996,33996,0,12,6450000.0
6450,6450999,20.682343426131553,37.07439518241516,0.08928554024488666,1114.2245721817017,440.5680000782013,1080.1015319824219,41257,7238,34019,34019,0,12,6451000.0
6451,6451999,20.682993641800664,37.07496609480391,0.08927977320483171,1114.4519267082214,440.63515162467957,1080.2967796325684,41264,7239,34025,34025,0,12,6452000.0
6452,6452999,20.68413680968038,37.077158422550525,0.089262447409163,1114.7672226428986,440.69950890541077,1080.4512634277344,41271,7241,34030,34030,0,12,6453000.0
6453,6453999,20.685058107904634,37.0776164016653,0.08926379488298286,1114.9814066886902,440.76346039772034,1080.5608139038086,41273,7242,34031,34031,0,12,6454000.0
6454,6454999,20.686386495818358,37.07905069854497,0.08926914376921224,1115.2948698997498,440.8276720046997,1080.631549835205,41277,7244,34033,34033,0,12,6455000.0
6455,6455999,20.68761886060555,37.08062727161554,0.08928008506125207,1115.6001884937286,440.89388370513916,1080.729621887207,41289,7246,34043,34043,0,12,6456000.0
6456,6456999,20.688976550976168,37.08184220799403,0.08928687617422781,1116.0152571201324,440.95887899398804,1080.6944427490234,41314,7249,34065,34065,0,12,6457000.0
6457,6457999,20.690575800753937,37.08396230924897,0.08930088735145192,1116.2541933059692,441.0235493183136,1080.9620819091797,41327,7250,34077,34077,0,12,6458000.0
6458,6458999,20.692006357892406,37.08541447974345,0.0893244133019494,1116.4654586315155,441.0870032310486,1081.0880241394043,41330,7251,34079,34079,0,12,6459000.0
6459,6459999,20.693462802466435,37.08650368792546,0.08934595631992237,1116.6895744800568,441.1560688018799,1081.229549407959,41334,7252,34082,34082,0,12,6460000.0
6460,6460999,20.69500576238006,37.08801713565235,0.08937390645075627,1116.9064161777496,441.2195918560028,1081.3246612548828,41336,7253,34083,34083,0,12,6461000.0
6461,6461999,20.69666531884188,37.089490815834175,0.08939533969222302,1117.2274808883667,441.2846360206604,1081.4251556396484,41340,7255,34085,34085,0,12,6462000.0
6462,6462999,20.698100083149892,37.09038802168257,0.08941817330393842,1117.4389231204987,441.3481879234314,1081.4756698608398,41342,7256,34086,34086,0,12,6463000.0
6463,6463999,20.699601197591303,37.091561746055596,0.0894395264480482,1117.5545544624329,441.4123933315277,1081.6438179016113,41343,7256,34087,34087,0,12,6464000.0
6464,6464999,20.700849572514496,37.09231292201096,0.08944553463821114,1117.7845180034637,441.4782717227936,1081.7094078063965,41346,7257,34089,34089,0,12,6465000.0
6465,6465999,20.702018976509667,37.09275739508704,0.08946260262406436,1117.992868423462,441.54164385795593,1081.7288856506348,41352,7258,34094,34094,0,12,6466000.0
6466,6466999,20.70278445425407,37.092457972244624,0.08946463871569299,1118.3126680850983,441.60598039627075,1081.7272872924805,41357,7260,34097,34097,0,12,6467000.0
6467,6467999,20.702715005915266,37.09154972682486,0.08945668610515878,1118.5307836532593,441.67368602752686,1082.3269691467285,41370,7261,34109,34109,0,12,6468000.0
6468,6468999,20.701740207905484,37.090158842632384,0.08945101360317254,1118.6541721820831,441.73994994163513,1082.609935760498,41371,7261,34110,34110,0,12,6469000.0
6469,6469999,20.700741083649458,37.088918384302474,0.08945016426180474,1118.870460987091,441.8085639476776,1082.790901184082,41380,7262,34118,34118,0,12,6470000.0
6470,6470999,20.699753556260102,37.08760403008757,0.08945258660574873,1119.1792995929718,441.872727394104,1082.91748046875,41385,7264,34121,34121,0,12,6471000.0
6471,6471999,20.698975353674456,37.08651947454611,0.08944865175596639,1119.4791791439056,441.93653297424316,1082.9945945739746,41397,7266,34131,34131,0,12,6472000.0
6472,6472999,20.698013665514882,37.08511577827774,0.08944642899580624,1119.7894389629364,442.00209045410156,1083.1694793701172,41405,7268,34137,34137,0,12,6473000.0
6473,6473999,20.69734635766454,37.0844855302581,0.08944150571961806,1119.8991906642914,442.0651729106903,1083.3225135803223,41405,7268,34137,34137,0,12,6474000.0
6474,6474999,20.69680054259447,37.08366748017234,0.08943543911003804,1120.3252925872803,442.1302447319031,1083.3675003051758,41412,7271,34141,34141,0,12,6475000.0
6475,6475999,20.69634590520623,37.08269951089914,0.08943001118086369,1120.4431710243225,442.1918525695801,1083.5230979919434,41413,7271,34142,34142,0,12,6476000.0
6476,6476999,20.695921267004117,37.08158639019107,0.08942811515090732,1120.5714151859283,442.2563741207123,1083.7216911315918,41415,7271,34144,34144,0,12,6477000.0
6477,6477999,20.69614669025672,37.08177657973106,0.08941947797105565,1120.787487745285,442.31969118118286,1083.8094329833984,41417,7272,34145,34145,0,12,6478000.0
6478,6478999,20.696604806546606,37.082042841413724,0.08941785388021972,1121.1006622314453,442.3837196826935,1083.9075660705566,41430,7274,34156,34156,0,12,6479000.0
6479,6479999,20.697167284455173,37.08275774225704,0.0894149583545023,1121.2147192955017,442.4463891983032,1084.0114974975586,41430,7274,34156,34156,0,12,6480000.0
6480,6480999,20.697942148364387,37.08377616875468,0.08940376161705099,1121.5332071781158,442.51013827323914,1084.0620613098145,41436,7276,34160,34160,0,12,6481000.0
6481,6481999,20.698962042634193,37.08480666039925,0.08939570500045935,1121.846610546112,442.5750982761383,1084.1232872009277,41443,7278,34165,34165,0,12,6482000.0
6482,6482999,20.7000562647924,37.086224226002194,0.08939447794124267,1122.2827835083008,442.6489338874817,1084.148292541504,41463,7281,34182,34182,0,12,6483000.0
6483,6483999,20.701149260586263,37.087456472693546,0.08939038146607925,1122.5102298259735,442.7159388065338,1084.3225479125977,41467,7282,34185,34185,0,12,6484000.0
6484,6484999,20.702495703853,37.0897905036686,0.08938103029672795,1122.7311053276062,442.7825689315796,1084.5727806091309,41471,7283,34188,34188,0,12,6485000.0
6485,6485999,20.703594201139634,37.09111512512438,0.08937046383730884,1122.8400974273682,442.8451430797577,1084.7103996276855,41471,7283,34188,34188,0,12,6486000.0
6486,6486999,20.704520123527217,37.09168213614739,0.08937019149854109,1123.2457511425018,442.9119231700897,1084.7077598571777,41478,7286,34192,34192,0,12,6487000.0
6487,6487999,20.704982387411764,37.09133713701676,0.08937517865798172,1123.5643117427826,442.97615575790405,1084.731777191162,41490,7288,34202,34202,0,12,6488000.0
6488,6488999,20.704789129190935,37.090774144181324,0.08936124308425497,1123.691044807434,443.04384541511536,1085.087215423584,41498,7288,34210,34210,0,12,6489000.0
6489,6489999,20.703943883131046,37.08943556307621,0.08935839437163229,1123.812305688858,443.10667872428894,1085.254940032959,41498,7288,34210,34210,0,12,6490000.0
6490,6490999,20.703302912465393,37.088586869942255,0.0893531844630161,1123.9313225746155,443.1711776256561,1085.3910522460938,41499,7288,34211,34211,0,12,6491000.0
6491,6491999,20.702597517116967,37.08742068112209,0.08934984395263246,1124.1567738056183,443.23607778549194,1085.4792556762695,41504,7289,34215,34215,0,12,6492000.0
6492,6492999,20.701929143666632,37.08596230449493,0.08934531320414596,1124.2769706249237,443.3000259399414,1085.5877647399902,41505,7289,34216,34216,0,12,6493000.0
6493,6493999,20.70124217925132,37.084798826770495,0.08932566018334043,1124.5793843269348,443.3635799884796,1085.7969856262207,41526,7291,34235,34235,0,12,6494000.0
6494,6494999,20.70073335139881,37.083541283558375,0.08930566183256305,1124.8969449996948,443.42736864089966,1085.8830909729004,41531,7293,34238,34238,0,12,6495000.0
6495,6495999,20.700187225836153,37.08486648807297,0.08927502712650837,1125.4071407318115,443.4919192790985,1085.85152053833,41541,7297,34244,34244,0,12,6496000.0
6496,6496999,20.69937779175054,37.08322906789264,0.08927177483540816,1125.6289739608765,443.55594539642334,1085.983097076416,41545,7298,34247,34247,0,12,6497000.0
6497,6497999,20.698839970827212,37.082072903801354,0.08925908052133436,1125.939781665802,443.62152099609375,1086.1028060913086,41559,7300,34259,34259,0,12,6498000.0
6498,6498999,20.698609514755095,37.08170489753803,0.08924635964341554,1126.0570607185364,443.68468475341797,1086.2250366210938,41559,7300,34259,34259,0,12,6499000.0
6499,6499999,20.69875035746107,37.081240129481984,0.0892352909658406,1126.1857783794403,443.7493522167206,1086.4524383544922,41563,7300,34263,34263,0,12,6500000.0
6500,6500999,20.698878377930555,37.0806999470561,0.08922560270558233,1126.39604306221,443.81217432022095,1086.5050430297852,41574,7301,34273,34273,0,12,6501000.0
6501,6501999,20.698761386657043,37.07972374031775,0.08923323453838328,1126.509729385376,443.87475776672363,1086.6337585449219,41574,7301,34273,34273,0,12,6502000.0
6502,6502999,20.699342406196667,37.07991075256445,0.08923906152862682,1126.815933227539,443.9382393360138,1086.65531539917,41579,7303,34276,34276,0,12,6503000.0
6503,6503999,20.699976133015173,37.080997635734796,0.08923507114293583,1127.0331258773804,444.00429582595825,1086.719009399414,41581,7304,34277,34277,0,12,6504000.0
6504,6504999,20.700959872871504,37.082286542054284,0.08923974674537305,1127.5391414165497,444.06931829452515,1086.6943283081055,41608,7308,34300,34300,0,12,6505000.0
6505,6505999,20.702307826932767,37.08381879180151,0.08924288895912336,1127.7726836204529,444.1351923942566,1086.9683265686035,41616,7309,34307,34307,0,12,6506000.0
6506,6506999,20.703913845198635,37.08694003619434,0.0892407201269827,1128.1822428703308,444.1999034881592,1086.9691467285156,41632,7312,34320,34320,0,12,6507000.0
6507,6507999,20.705527165099785,37.090753372942544,0.08923720420513492,1128.3164343833923,444.26349568367004,1087.0779266357422,41632,7312,34320,34320,0,12,6508000.0
6508,6508999,20.706291653374883,37.09109287515009,0.08924596249376726,1128.6188325881958,444.3268220424652,1087.0852966308594,41636,7314,34322,34322,0,12,6509000.0
6509,6509999,20.706565044759717,37.09137929247321,0.08922509013736679,1128.8253319263458,444.39170956611633,1087.4010009765625,41651,7315,34336,34336,0,12,6510000.0
6510,6510999,20.70625843687274,37.090839297854686,0.08920257277743748,1128.9598717689514,444.45914912223816,1087.6770515441895,41655,7315,34340,34340,0,12,6511000.0
6511,6511999,20.705563196777035,37.089289731091796,0.08919261133644063,1129.0722711086273,444.5232126712799,1087.8703384399414,41657,7315,34342,34342,0,12,6512000.0
6512,6512999,20.70499120768519,37.08810080330488,0.08918372220894333,1129.373012304306,444.58773398399353,1087.97216796875,41662,7317,34345,34345,0,12,6513000.0
6513,6513999,20.7046069688682,37.08684025234783,0.08917424034583155,1129.4993584156036,444.6532635688782,1088.0997695922852,41662,7317,34345,34345,0,12,6514000.0
6514,6514999,20.70405295694841,37.0851838139344,0.08916006294681178,1129.6131384372711,444.7168138027191,1088.4393730163574,41667,7317,34350,34350,0,12,6515000.0
6515,6515999,20.70372532755044,37.08391757984022,0.08914612397393828,1129.8234000205994,444.78063559532166,1088.5374374389648,41670,7318,34352,34352,0,12,6516000.0
6516,6516999,20.70323655006223,37.08243084082642,0.08913866964019002,1130.0374836921692,444.84570050239563,1088.643325805664,41672,7319,34353,34353,0,12,6517000.0
6517,6517999,20.70284793207816,37.081060898702596,0.08912813998097124,1130.3401277065277,444.91023206710815,1088.72119140625,41676,7321,34355,34355,0,12,6518000.0
6518,6518999,20.702678926828785,37.08022328534453,0.08911432011676224,1130.6743965148926,444.97557830810547,1088.7592086791992,41681,7323,34358,34358,0,12,6519000.0
6519,6519999,20.702819406583128,37.07937182237937,0.08908502605031854,1130.8966343402863,445.04280495643616,1089.2230491638184,41688,7324,34364,34364,0,12,6520000.0
6520,6520999,20.70312000121494,37.078654907854705,0.08905107969502646,1131.0094854831696,445.10789728164673,1089.4653663635254,41688,7324,34364,34364,0,12,6521000.0
6521,6521999,20.703339587780754,37.07763004383101,0.08902644221986511,1131.3323438167572,445.1733477115631,1089.5468292236328,41701,7326,34375,34375,0,12,6522000.0
6522,6522999,20.70368994213496,37.076673043660676,0.08900616153922458,1131.7540583610535,445.2406210899353,1089.5327682495117,41716,7329,34387,34387,0,12,6523000.0
6523,6523999,20.704442145058938,37.07609977826894,0.08897428473372548,1132.24565243721,445.30491280555725,1089.732063293457,41750,7333,34417,34417,0,12,6524000.0
6524,6524999,20.70410909222549,37.07461742923155,0.08896841677742817,1132.4677865505219,445.37032556533813,1090.0601081848145,41761,7334,34427,34427,0,12,6525000.0
6525,6525999,20.70327858855019,37.07368747680719,0.08897128424700418,1132.7844789028168,445.4391260147095,1090.2770881652832,41775,7336,34439,34439,0,12,6526000.0
6526,6526999,20.70240928712217,37.07258734413592,0.08897247999936309,1133.006103515625,445.50461602211,1090.466537475586,41789,7337,34452,34452,0,12,6527000.0
6527,6527999,20.70146395860306,37.070655322329735,0.08897709800063636,1133.1259388923645,445.5684390068054,1090.7956085205078,41793,7337,34456,34456,0,12,6528000.0
6528,6528999,20.700673591782138,37.06879371488484,0.08898057679458882,1133.5520570278168,445.6360192298889,1090.8614387512207,41806,7340,34466,34466,0,12,6529000.0
6529,6529999,20.69976667570152,37.06687744489034,0.08898476166409885,1133.7706863880157,445.7009971141815,1091.0431861877441,41810,7341,34469,34469,0,12,6530000.0
6530,6530999,20.698978431970147,37.065169517548185,0.08898656379232206,1134.1843752861023,445.7663948535919,1091.068157196045,41817,7344,34473,34473,0,12,6531000.0
6531,6531999,20.69819963018581,37.06339165770073,0.08898826038136853,1134.3962824344635,445.8321452140808,1091.2068557739258,41822,7345,34477,34477,0,12,6532000.0
6532,6532999,20.6977024986333,37.06169427869502,0.08897812314202225,1134.6114132404327,445.8988211154938,1091.4479637145996,41827,7346,34481,34481,0,12,6533000.0
6533,6533999,20.697576476932184,37.060563261927435,0.08896283385522918,1134.9226496219635,445.96524834632874,1091.5198020935059,41861,7348,34513,34513,0,12,6534000.0
6534,6534999,20.697218449750313,37.05897299391831,0.08895121032697317,1135.141025543213,446.0295717716217,1091.644515991211,41865,7349,34516,34516,0,12,6535000.0
6535,6535999,20.69705525033331,37.05773329294541,0.08893984764323837,1135.4549067020416,446.0948734283447,1091.6884155273438,41870,7351,34519,34519,0,12,6536000.0
6536,6536999,20.69690784714066,37.05666914767523,0.08892649594971935,1135.6835324764252,446.16051173210144,1091.7354316711426,41880,7352,34528,34528,0,12,6537000.0
6537,6537999,20.6967597157291,37.055168902254124,0.08891152161524907,1136.0158998966217,446.2278997898102,1092.0484161376953,41890,7354,34536,34536,0,12,6538000.0
6538,6538999,20.696974860752437,37.054049335330554,0.08888632416918862,1136.615073442459,446.29438829421997,1092.281093597412,41913,7359,34554,34554,0,12,6539000.0
6539,6539999,20.69705507837747,37.052755625288256,0.08886228466922652,1136.7336747646332,446.3587820529938,1092.500690460205,41913,7359,34554,34554,0,12,6540000.0
6540,6540999,20.696757816353607,37.051162876757125,0.08885283489351992,1137.138677597046,446.4240388870239,1092.466724395752,41930,7362,34568,34568,0,12,6541000.0
6541,6541999,20.69638534560383,37.05122164340119,0.0888334170353734,1137.6352007389069,446.48925161361694,1092.893123626709,41958,7366,34592,34592,0,12,6542000.0
6542,6542999,20.695805513072457,37.049719545066914,0.08882102949263082,1137.7624864578247,446.5532488822937,1093.168846130371,41961,7366,34595,34595,0,12,6543000.0
6543,6543999,20.695587927675955,37.05044883252424,0.08879957737398858,1138.08158993721,446.61928844451904,1093.2369346618652,41977,7368,34609,34609,0,12,6544000.0
6544,6544999,20.695028686452382,37.049075372295086,0.08879380527194314,1138.307281255722,446.68439960479736,1093.3930397033691,41987,7369,34618,34618,0,12,6545000.0
6545,6545999,20.694821311766987,37.04809545918088,0.08878239223706497,1138.433369398117,446.7487621307373,1093.6927032470703,41992,7369,34623,34623,0,12,6546000.0
6546,6546999,20.694673720983317,37.04703189264749,0.08876689061336107,1138.6449291706085,446.81511926651,1093.7903442382812,41995,7370,34625,34625,0,12,6547000.0
6547,6547999,20.694250549662787,37.045887445687875,0.08875732767830691,1138.96941280365,446.87943840026855,1093.8817901611328,41999,7372,34627,34627,0,12,6548000.0
6548,6548999,20.693939995744618,37.044599747777454,0.0887450656677301,1139.0817251205444,446.9452848434448,1094.0125885009766,42000,7372,34628,34628,0,12,6549000.0
6549,6549999,20.693624009933462,37.04353011495425,0.08872949631686533,1139.2934849262238,447.01023411750793,1094.1358337402344,42004,7373,34631,34631,0,12,6550000.0
6550,6550999,20.693447758872903,37.042527060681714,0.08871378175390987,1139.5156111717224,447.0747711658478,1094.4471817016602,42011,7374,34637,34637,0,12,6551000.0
6551,6551999,20.693422229528952,37.042403506188954,0.08869395416358639,1139.8404006958008,447.14154076576233,1094.626880645752,42024,7376,34648,34648,0,12,6552000.0
6552,6552999,20.693168828893594,37.041307233383996,0.08868064213266724,1140.0482239723206,447.2078974246979,1094.768669128418,42028,7377,34651,34651,0,12,6553000.0
6553,6553999,20.69297171050773,37.04072349905847,0.08867008131684384,1140.2565021514893,447.2728316783905,1094.871696472168,42030,7378,34652,34652,0,12,6554000.0
6554,6554999,20.692716505959627,37.03963453687979,0.08866131736039606,1140.4789686203003,447.3405647277832,1094.9885902404785,42033,7379,34654,34654,0,12,6555000.0
6555,6555999,20.692589381492525,37.03853777809316,0.0886473003630065,1140.696622133255,447.4044814109802,1095.0744400024414,42036,7380,34656,34656,0,12,6556000.0
6556,6556999,20.692451711695327,37.03744460307667,0.0886387846314457,1141.0072927474976,447.46843338012695,1095.1907806396484,42046,7382,34664,34664,0,12,6557000.0
6557,6557999,20.692169859944954,37.036211763018805,0.08862609963981027,1141.1241402626038,447.53272128105164,1095.301124572754,42046,7382,34664,34664,0,12,6558000.0
6558,6558999,20.69189440317572,37.034833169170035,0.08861970071491909,1141.2402296066284,447.59642028808594,1095.3889427185059,42046,7382,34664,34664,0,12,6559000.0
6559,6559999,20.691403294709534,37.03376789340886,0.08860935235394352,1141.4596977233887,447.6608169078827,1095.6389999389648,42066,7383,34683,34683,0,12,6560000.0
6560,6560999,20.69147933265281,37.03863005660213,0.08857121026306802,1141.5779094696045,447.7263288497925,1095.9562454223633,42069,7383,34686,34686,0,12,6561000.0
6561,6561999,20.69072858962808,37.037190124014415,0.0885658362559123,1141.9073090553284,447.792763710022,1096.0933456420898,42086,7385,34701,34701,0,12,6562000.0
6562,6562999,20.690169728576365,37.03670464724001,0.08855539231152398,1142.1326274871826,447.86138582229614,1096.2285804748535,42092,7386,34706,34706,0,12,6563000.0
6563,6563999,20.689505636576065,37.03523388339124,0.08855279396749971,1142.2648429870605,447.93269991874695,1096.4524688720703,42094,7386,34708,34708,0,12,6564000.0
6564,6564999,20.688940439585796,37.034150020107454,0.08854585759402234,1142.574096441269,447.99876379966736,1096.6389045715332,42108,7388,34720,34720,0,12,6565000.0
6565,6565999,20.688287582188007,37.033075962662764,0.08853680613436021,1142.879156112671,448.0630793571472,1096.7210731506348,42119,7390,34729,34729,0,12,6566000.0
6566,6566999,20.687726563120343,37.03167326123334,0.0885291864956339,1143.2955181598663,448.1286063194275,1096.8271942138672,42125,7393,34732,34732,0,12,6567000.0
6567,6567999,20.687442804094516,37.031200862986296,0.08851658299182064,1143.6070773601532,448.19390535354614,1096.9718399047852,42132,7395,34737,34737,0,12,6568000.0
6568,6568999,20.687208991919007,37.030350388120496,0.0885057387490209,1143.7362909317017,448.25864362716675,1097.1596641540527,42133,7395,34738,34738,0,12,6569000.0
6569,6569999,20.68675589898218,37.02913068679854,0.08849758040237676,1143.864979982376,448.32680678367615,1097.4439888000488,42137,7395,34742,34742,0,12,6570000.0
6570,6570999,20.68677173121755,37.028661414139506,0.08848078593200048,1143.9977388381958,448.4024975299835,1097.6715202331543,42138,7395,34743,34743,0,12,6571000.0
6571,6571999,20.68696266428042,37.02844114582997,0.08847062672152795,1144.205435037613,448.4648337364197,1097.84761428833,42140,7396,34744,34744,0,12,6572000.0
6572,6572999,20.687160217885168,37.027955163743705,0.0884658182377982,1144.6113274097443,448.5305600166321,1097.893627166748,42148,7399,34749,34749,0,12,6573000.0
6573,6573999,20.687781359090486,37.02828248999951,0.08846147127104287,1144.828959941864,448.5960726737976,1097.9919815063477,42150,7400,34750,34750,0,12,6574000.0
6574,6574999,20.688405752318545,37.0287011561452,0.08846354939727341,1144.943906545639,448.6617486476898,1098.1511611938477,42151,7400,34751,34751,0,12,6575000.0
6575,6575999,20.69000654374622,37.031350676998386,0.08848189499872117,1145.0633943080902,448.7271738052368,1098.3958320617676,42155,7400,34755,34755,0,12,6576000.0
6576,6576999,20.691437884638805,37.0325065890917,0.08847863108742526,1145.276861190796,448.7920768260956,1098.5938720703125,42157,7401,34756,34756,0,12,6577000.0
6577,6577999,20.693215845159685,37.03600301931754,0.08848946915608669,1145.8073608875275,448.864714384079,1098.5661544799805,42167,7405,34762,34762,0,12,6578000.0
6578,6578999,20.694905693066378,37.03772396669815,0.08851424012276743,1146.0211894512177,448.9332628250122,1098.781120300293,42170,7406,34764,34764,0,12,6579000.0
6579,6579999,20.695758477359362,37.03792053266446,0.08854040499572002,1146.2357952594757,448.99806332588196,1098.8822898864746,42173,7407,34766,34766,0,12,6580000.0
6580,6580999,20.695894659901334,37.037936880660254,0.0885446204375373,1146.3587472438812,449.0650165081024,1099.4477729797363,42193,7407,34786,34786,0,12,6581000.0
6581,6581999,20.695102824296406,37.036900725753554,0.08853861414405628,1146.572746515274,449.1288778781891,1099.6968994140625,42200,7408,34792,34792,0,12,6582000.0
6582,6582999,20.6946041716644,37.036569806794425,0.0885319249029991,1146.779037952423,449.19299960136414,1099.872901916504,42212,7409,34803,34803,0,12,6583000.0
6583,6583999,20.694531114940517,37.038705128704144,0.08851202529907842,1146.89883852005,449.2581527233124,1100.0906829833984,42215,7409,34806,34806,0,12,6584000.0
6584,6584999,20.694308050615867,37.037874858002,0.0885028359821235,1147.1218202114105,449.32310032844543,1100.1871299743652,42222,7410,34812,34812,0,12,6585000.0
6585,6585999,20.69433263056022,37.03774133869433,0.08849691609215404,1147.532809495926,449.38767647743225,1100.4318351745605,42239,7413,34826,34826,0,12,6586000.0
6586,6586999,20.69427350256688,37.03691069420002,0.08849651285514148,1147.8417954444885,449.45155596733093,1100.5088539123535,42244,7415,34829,34829,0,12,6587000.0
6587,6587999,20.694358442453577,37.03694790138987,0.08849336243961337,1147.9797885417938,449.52742433547974,1100.6614303588867,42244,7415,34829,34829,0,12,6588000.0
6588,6588999,20.694549278645127,37.03724415743481,0.08849632428467291,1148.189926147461,449.5904972553253,1100.7484893798828,42246,7416,34830,34830,0,12,6589000.0
6589,6589999,20.69491282064833,37.037542160758896,0.08849713158527284,1148.3084270954132,449.65475368499756,1100.8950691223145,42247,7416,34831,34831,0,12,6590000.0
6590,6590999,20.695559022036225,37.038444775747585,0.08849983429945485,1148.6436517238617,449.71904587745667,1100.9411964416504,42251,7418,34833,34833,0,12,6591000.0
6591,6591999,20.696532601514054,37.0398700053419,0.08851033289920818,1148.9619636535645,449.784316778183,1101.2486877441406,42264,7420,34844,34844,0,12,6592000.0
6592,6592999,20.69766195209113,37.0414721130713,0.08853816005795612,1149.1838359832764,449.8485767841339,1101.3686904907227,42266,7421,34845,34845,0,12,6593000.0
6593,6593999,20.699488257233618,37.04661883139593,0.08854990949910402,1149.4983899593353,449.913206577301,1101.4115257263184,42270,7423,34847,34847,0,12,6594000.0
6594,6594999,20.700648338754625,37.04784877516724,0.08857227057426675,1149.6184232234955,449.9768500328064,1101.5621795654297,42270,7423,34847,34847,0,12,6595000.0
6595,6595999,20.70270422365124,37.053560740976316,0.08860140787698856,1149.9285912513733,450.0414352416992,1101.568416595459,42282,7425,34857,34857,0,12,6596000.0
6596,6596999,20.70482558918302,37.059933287035356,0.08864616390498892,1150.2409889698029,450.10540080070496,1101.5610847473145,42288,7427,34861,34861,0,12,6597000.0
6597,6597999,20.70707813864986,37.06370922362492,0.08868981073306748,1150.459892988205,450.17095375061035,1101.720615386963,42293,7428,34865,34865,0,12,6598000.0
6598,6598999,20.709056556360476,37.067828399072276,0.0887339161599674,1150.6833682060242,450.2379779815674,1101.903408050537,42296,7429,34867,34867,0,12,6599000.0
6599,6599999,20.711532778876485,37.07178950530418,0.08877151454857213,1150.8075714111328,450.304074048996,1102.0196990966797,42296,7429,34867,34867,0,12,6600000.0
6600,6600999,20.7130825151754,37.07374137571752,0.08881087821790712,1151.022539138794,450.3684780597687,1102.0700912475586,42307,7430,34877,34877,0,12,6601000.0
6601,6601999,20.712691892334945,37.07271029392236,0.08881059913290013,1151.3426854610443,450.43415236473083,1102.6185188293457,42328,7432,34896,34896,0,12,6602000.0
6602,6602999,20.711514633931387,37.07123235123008,0.0888118970243944,1151.7529923915863,450.4984178543091,1102.8005065917969,42353,7435,34918,34918,0,12,6603000.0
6603,6603999,20.710611045900475,37.07014346462577,0.08880671428026199,1151.9634623527527,450.5625705718994,1103.051471710205,42362,7436,34926,34926,0,12,6604000.0
6604,6604999,20.709661983765145,37.06878823959071,0.08880606593102647,1152.2709352970123,450.6285960674286,1103.197422027588,42376,7438,34938,34938,0,12,6605000.0
6605,6605999,20.708897253331294,37.067703999461834,0.08880253990712927,1152.5875453948975,450.6928720474243,1103.4021835327148,42393,7440,34953,34953,0,12,6606000.0
6606,6606999,20.707985993433038,37.06617714096968,0.08880004491075877,1152.7015218734741,450.756139755249,1103.7338523864746,42395,7440,34955,34955,0,12,6607000.0
6607,6607999,20.707031271440158,37.064463125935745,0.08879848197581075,1152.809820652008,450.81894063949585,1103.92728805542,42396,7440,34956,34956,0,12,6608000.0
6608,6608999,20.706117095406643,37.0627788934304,0.08879780023619233,1153.3076651096344,450.88427209854126,1103.9538803100586,42405,7444,34961,34961,0,12,6609000.0
6609,6609999,20.705197233905963,37.0609587149001,0.08879821449914882,1153.42635846138,450.94893884658813,1104.1495246887207,42408,7444,34964,34964,0,12,6610000.0
6610,6610999,20.704485870156404,37.05969081203385,0.088795384052617,1153.9392416477203,451.0139515399933,1104.1728057861328,42417,7448,34969,34969,0,12,6611000.0
6611,6611999,20.703854661391663,37.05826312838083,0.08879168401653215,1154.0603930950165,451.0776069164276,1104.4241752624512,42419,7448,34971,34971,0,12,6612000.0
6612,6612999,20.70355245030287,37.057696671045235,0.08878744054400645,1154.1923677921295,451.1412887573242,1104.6053733825684,42419,7448,34971,34971,0,12,6613000.0
6613,6613999,20.703068331086328,37.056338994549165,0.08878076966351323,1154.6066501140594,451.2050006389618,1104.5780220031738,42431,7451,34980,34980,0,12,6614000.0
6614,6614999,20.702809527267394,37.05530154659062,0.08877657300922948,1154.9344210624695,451.2707669734955,1104.6232643127441,42436,7453,34983,34983,0,12,6615000.0
6615,6615999,20.702444249236304,37.053931021318206,0.08877098137966499,1155.1406512260437,451.335125207901,1104.7278213500977,42438,7454,34984,34984,0,12,6616000.0
6616,6616999,20.702431856226152,37.053325416219394,0.08876543872388354,1155.270092010498,451.398024559021,1104.8516387939453,42438,7454,34984,34984,0,12,6617000.0
6617,6617999,20.702366390881238,37.05259756004533,0.08876086033894282,1155.5905816555023,451.4624733924866,1105.003547668457,42472,7456,35016,35016,0,12,6618000.0
6618,6618999,20.70223378112744,37.05158281113578,0.08874760378511859,1155.708196401596,451.5272710323334,1105.1453132629395,42473,7456,35017,35017,0,12,6619000.0
6619,6619999,20.70213449740926,37.05055139486648,0.08873961979769007,1155.92271733284,451.5911409854889,1105.2215156555176,42476,7457,35019,35019,0,12,6620000.0
6620,6620999,20.701832276585026,37.049295729345324,0.08872894142491516,1156.04487991333,451.65665459632874,1105.3093528747559,42476,7457,35019,35019,0,12,6621000.0
6621,6621999,20.701484894383377,37.04795918583079,0.08871829528783193,1156.1688458919525,451.7189271450043,1105.381950378418,42476,7457,35019,35019,0,12,6622000.0
6622,6622999,20.70085083167151,37.047481035234846,0.08870381677280237,1156.292247056961,451.7832865715027,1105.774269104004,42486,7457,35029,35029,0,12,6623000.0
6623,6623999,20.699903213529424,37.046189078881774,0.0886969485062239,1156.4227504730225,451.84745359420776,1105.995807647705,42488,7457,35031,35031,0,12,6624000.0
6624,6624999,20.698836755788562,37.04430555129238,0.08869321185893941,1156.536250591278,451.9117043018341,1106.1333618164062,42489,7457,35032,35032,0,12,6625000.0
6625,6625999,20.69796462466615,37.04252504801163,0.08869426182725049,1156.7509021759033,451.9762246608734,1106.2770385742188,42502,7458,35044,35044,0,12,6626000.0
6626,6626999,20.69726212628819,37.04114160178155,0.08868830261674221,1156.9733672142029,452.039719581604,1106.4617004394531,42509,7459,35050,35050,0,12,6627000.0
6627,6627999,20.696720136980385,37.03982981073015,0.08868036829032921,1157.392690896988,452.1087522506714,1106.4313125610352,42515,7462,35053,35053,0,12,6628000.0
6628,6628999,20.696087950962237,37.03830730640646,0.08867073938944481,1157.9063045978546,452.1743357181549,1106.4855422973633,42524,7466,35058,35058,0,12,6629000.0
6629,6629999,20.69534887702771,37.03679179252471,0.08866575906527685,1158.4245777130127,452.24116945266724,1106.5640411376953,42542,7470,35072,35072,0,12,6630000.0
6630,6630999,20.694712204103872,37.0353328215168,0.08865681458857477,1158.5555446147919,452.3170819282532,1106.7446823120117,42543,7470,35073,35073,0,12,6631000.0
6631,6631999,20.694076444333394,37.033721832738685,0.08864417208506692,1158.7763464450836,452.3810751438141,1106.868148803711,42545,7471,35074,35074,0,12,6632000.0
6632,6632999,20.693555665966368,37.03236836007221,0.08862380305720352,1158.9972820281982,452.4473431110382,1107.1279792785645,42552,7472,35080,35080,0,12,6633000.0
6633,6633999,20.692966482606483,37.030931260424616,0.0886121015240301,1159.3050360679626,452.51202630996704,1107.2015953063965,42557,7474,35083,35083,0,12,6634000.0
6634,6634999,20.692473035520333,37.03000308507074,0.08860255757885938,1159.4273793697357,452.5758559703827,1107.3400993347168,42557,7474,35083,35083,0,12,6635000.0
6635,6635999,20.69215778713239,37.028779561438405,0.0885917682455557,1160.0322501659393,452.64042925834656,1107.1690635681152,42585,7479,35106,35106,0,12,6636000.0
6636,6636999,20.69169675408807,37.027794095812986,0.08857912480161823,1160.2557318210602,452.7062089443207,1107.2901611328125,42587,7480,35107,35107,0,12,6637000.0
6637,6637999,20.691323650549574,37.02645613369608,0.08856779277120719,1160.5747582912445,452.77144503593445,1107.332363128662,42592,7482,35110,35110,0,12,6638000.0
6638,6638999,20.691225811816274,37.0253683707858,0.08854456992439186,1161.080595254898,452.8366439342499,1107.4850883483887,42607,7486,35121,35121,0,12,6639000.0
6639,6639999,20.691143339110624,37.024358808273384,0.08852051391120008,1161.2107350826263,452.90411138534546,1107.6756019592285,42607,7486,35121,35121,0,12,6640000.0
6640,6640999,20.691065388042908,37.02527110222083,0.0884985032854314,1161.3241953849792,452.9685368537903,1107.7815971374512,42607,7486,35121,35121,0,12,6641000.0
6641,6641999,20.690657313824406,37.023773971951655,0.0884891605361845,1161.8411388397217,453.0341513156891,1107.7043228149414,42626,7490,35136,35136,0,12,6642000.0
6642,6642999,20.690130905681023,37.02213028307937,0.08848950450253423,1162.0777730941772,453.10010600090027,1107.9152488708496,42641,7491,35150,35150,0,12,6643000.0
6643,6643999,20.689173599893905,37.02094533118584,0.08848939533880251,1162.3978340625763,453.16413140296936,1108.0517082214355,42652,7493,35159,35159,0,12,6644000.0
6644,6644999,20.688167386673992,37.01930113354058,0.0884863298361519,1162.6126158237457,453.22914814949036,1108.177833557129,42656,7494,35162,35162,0,12,6645000.0
6645,6645999,20.68717853243603,37.0176289921416,0.08848958341619495,1162.930538892746,453.2941081523895,1108.2970657348633,42665,7496,35169,35169,0,12,6646000.0
6646,6646999,20.686511166709852,37.016162680832345,0.08848944450976226,1163.1571083068848,453.35926389694214,1108.407699584961,42668,7497,35171,35171,0,12,6647000.0
6647,6647999,20.68571220367865,37.014460844272385,0.08848560350846002,1163.3774993419647,453.4244089126587,1108.7034797668457,42675,7498,35177,35177,0,12,6648000.0
6648,6648999,20.68508245148665,37.01284522969743,0.0884785285910461,1163.684154510498,453.48929953575134,1108.8581085205078,42679,7500,35179,35179,0,12,6649000.0
6649,6649999,20.68443797915172,37.01123718962637,0.08847990363275171,1164.0043635368347,453.5554008483887,1108.91215133667,42684,7502,35182,35182,0,12,6650000.0
6650,6650999,20.683850023211498,37.009861132314626,0.08847514662226852,1164.3192875385284,453.6208803653717,1109.0501747131348,42689,7504,35185,35185,0,12,6651000.0
6651,6651999,20.683392988551756,37.00880131355088,0.08846587769642766,1164.4451875686646,453.6860017776489,1109.264877319336,42692,7504,35188,35188,0,12,6652000.0
6652,6652999,20.683147087568813,37.00776501708532,0.0884603980026426,1164.6525044441223,453.75164890289307,1109.3061866760254,42694,7505,35189,35189,0,12,6653000.0
6653,6653999,20.68295991839556,37.006880120298284,0.08845021580984447,1164.8678259849548,453.8163683414459,1109.845947265625,42700,7506,35194,35194,0,12,6654000.0
6654,6654999,20.682692388040575,37.005876877109266,0.08844598420663541,1164.9910564422607,453.88219451904297,1110.0546607971191,42700,7506,35194,35194,0,12,6655000.0
6655,6655999,20.682428003691673,37.00556668965685,0.08843753987072922,1165.4028987884521,453.94604325294495,1110.1247329711914,42743,7509,35234,35234,0,12,6656000.0
6656,6656999,20.682072824915995,37.00438656676645,0.08843357918578099,1165.6251747608185,454.0111999511719,1110.2275009155273,42745,7510,35235,35235,0,12,6657000.0
6657,6657999,20.682132982886838,37.00428226970208,0.08843076991655163,1165.9403882026672,454.0778319835663,1110.3206977844238,42756,7512,35244,35244,0,12,6658000.0
6658,6658999,20.682071760980552,37.00356218502574,0.08842136738190609,1166.0539758205414,454.1416676044464,1110.444911956787,42756,7512,35244,35244,0,12,6659000.0
6659,6659999,20.682614704885456,37.00354980627985,0.08836538808845562,1166.3737771511078,454.208687543869,1110.6639709472656,42765,7514,35251,35251,0,12,6660000.0
6660,6660999,20.68311251382845,37.00326158138393,0.08832082195299207,1166.5867953300476,454.27275109291077,1110.7649955749512,42767,7515,35252,35252,0,12,6661000.0
6661,6661999,20.683453389933355,37.00260761987422,0.08828915472800292,1166.7141268253326,454.33679485321045,1110.8996200561523,42767,7515,35252,35252,0,12,6662000.0
6662,6662999,20.68340285596567,37.001371524054356,0.08827271161611228,1167.0295877456665,454.4003105163574,1110.9658203125,42779,7517,35262,35262,0,12,6663000.0
6663,6663999,20.683433565419563,37.00159354635987,0.08826384557757583,1167.3379225730896,454.46443700790405,1111.284164428711,42791,7519,35272,35272,0,12,6664000.0
6664,6664999,20.683283003821906,37.00145313094859,0.0882534615657774,1167.5548558235168,454.5318682193756,1111.5292320251465,42793,7520,35273,35273,0,12,6665000.0
6665,6665999,20.682647909821224,37.00050434543765,0.08824204003322811,1167.7605402469635,454.5961663722992,1111.6366500854492,42801,7521,35280,35280,0,12,6666000.0
6666,6666999,20.682147626118592,36.999495961207046,0.08823468277487845,1168.0802733898163,454.6607859134674,1111.747169494629,42808,7523,35285,35285,0,12,6667000.0
6667,6667999,20.681986705791378,36.9991910029818,0.08822581080953484,1168.3944792747498,454.7246284484863,1111.8398475646973,42814,7525,35289,35289,0,12,6668000.0
6668,6668999,20.681719220645462,36.99851692148372,0.08821943096142093,1168.810714483261,454.79176354408264,1112.0718955993652,42824,7528,35296,35296,0,12,6669000.0
6669,6669999,20.681869331194626,36.99855518233574,0.08819873505596298,1168.931325674057,454.8591673374176,1112.3268089294434,42825,7528,35297,35297,0,12,6670000.0
6670,6670999,20.681865108855035,36.99856843660443,0.0881794642581184,1169.3395116329193,454.924702167511,1112.4494361877441,42836,7531,35305,35305,0,12,6671000.0
6671,6671999,20.68184723826716,36.99812254031228,0.08815507570070125,1169.7452154159546,454.990483045578,1112.5783958435059,42852,7534,35318,35318,0,12,6672000.0
6672,6672999,20.682036221888595,36.997973908625184,0.08813197607045209,1169.8674337863922,455.0556561946869,1112.771656036377,42854,7534,35320,35320,0,12,6673000.0
6673,6673999,20.682369886371397,36.998786015328264,0.08809612830712499,1170.1909093856812,455.1207036972046,1112.8883209228516,42868,7536,35332,35332,0,12,6674000.0
6674,6674999,20.682993453547667,36.99927403589617,0.08805930164280462,1170.3024015426636,455.1853759288788,1113.1881942749023,42869,7536,35333,35333,0,12,6675000.0
6675,6675999,20.683427361803105,36.999353789795975,0.0880391268723677,1170.5160913467407,455.2500162124634,1113.3016052246094,42871,7537,35334,35334,0,12,6676000.0
6676,6676999,20.684368202753532,37.00074284502781,0.08802005897533027,1170.729449748993,455.3155286312103,1113.4181098937988,42882,7538,35344,35344,0,12,6677000.0
6677,6677999,20.685394741321904,37.00235287670539,0.08801899863819451,1170.9502921104431,455.37976121902466,1113.513328552246,42884,7539,35345,35345,0,12,6678000.0
6678,6678999,20.686231530675514,37.00319471957329,0.08801023016242893,1171.368513584137,455.4444782733917,1113.5158157348633,42890,7542,35348,35348,0,12,6679000.0
6679,6679999,20.687558963126705,37.0055235622833,0.08800413555288233,1171.6858577728271,455.508912563324,1113.859661102295,42904,7544,35360,35360,0,12,6680000.0
6680,6680999,20.689124621193166,37.00825906527175,0.087969584387942,1171.9017260074615,455.5749638080597,1114.1819229125977,42906,7545,35361,35361,0,12,6681000.0
6681,6681999,20.690766991728456,37.010904932832936,0.08795099152811847,1172.016128540039,455.6407992839813,1114.4024925231934,42906,7545,35361,35361,0,12,6682000.0
6682,6682999,20.6929188353095,37.01453993141769,0.08794873026833983,1172.4114203453064,455.7040798664093,1114.4609298706055,42923,7548,35375,35375,0,12,6683000.0
6683,6683999,20.69439088254928,37.01745847687693,0.08794667837667991,1172.522715806961,455.7663609981537,1114.6083869934082,42923,7548,35375,35375,0,12,6684000.0
6684,6684999,20.694858560697725,37.019925521891054,0.08792826075485083,1172.6536040306091,455.8347475528717,1115.3023147583008,42948,7548,35400,35400,0,12,6685000.0
6685,6685999,20.695062959022806,37.03024562826583,0.08786705703729736,1172.9860334396362,455.94137930870056,1115.6288566589355,42967,7550,35417,35417,0,12,6686000.0
6686,6686999,20.694766247021366,37.03079049592666,0.08785802030812484,1173.207967042923,456.0069372653961,1115.8798789978027,42977,7551,35426,35426,0,12,6687000.0
6687,6687999,20.694659559009757,37.03379233599126,0.08782738295896897,1173.4264225959778,456.0731062889099,1116.231430053711,42989,7552,35437,35437,0,12,6688000.0
6688,6688999,20.693985137544367,37.03294935141773,0.08782760898314157,1173.5448188781738,456.1398591995239,1116.5354614257812,42994,7552,35442,35442,0,12,6689000.0
6689,6689999,20.69376848059259,37.03531218470563,0.08781962848495195,1173.75697016716,456.2048091888428,1116.704257965088,42998,7553,35445,35445,0,12,6690000.0
6690,6690999,20.693585157384277,37.03543065778475,0.08782760424393854,1174.0748703479767,456.2715263366699,1116.781681060791,43002,7555,35447,35447,0,12,6691000.0
6691,6691999,20.6931857140412,37.03438809314577,0.08783224309613769,1174.2939836978912,456.33775663375854,1116.9313888549805,43007,7556,35451,35451,0,12,6692000.0
6692,6692999,20.69361059093198,37.03577015003865,0.08784992090296406,1174.4155657291412,456.4030668735504,1117.1453971862793,43011,7556,35455,35455,0,12,6693000.0
6693,6693999,20.69382133174046,37.03647482034365,0.08784455372953548,1174.5356471538544,456.46751046180725,1117.4328231811523,43016,7556,35460,35460,0,12,6694000.0
6694,6694999,20.694670698824915,37.03838477222858,0.08786755483351527,1174.9442863464355,456.5332522392273,1117.490219116211,43033,7559,35474,35474,0,12,6695000.0
6695,6695999,20.695690325379047,37.04481357263693,0.0878431336404869,1175.0736219882965,456.5981276035309,1117.5963325500488,43033,7559,35474,35474,0,12,6696000.0
6696,6696999,20.696680443320083,37.046563049659035,0.08786407219022552,1175.4848337173462,456.66407465934753,1117.5581321716309,43047,7562,35485,35485,0,12,6697000.0
6697,6697999,20.697682518395556,37.04928644538562,0.08785059896413261,1175.7056329250336,456.7292935848236,1117.7147483825684,43050,7563,35487,35487,0,12,6698000.0
6698,6698999,20.69937763860486,37.055371995136966,0.08785240515936199,1176.1182224750519,456.794073343277,1117.75732421875,43059,7566,35493,35493,0,12,6699000.0
6699,6699999,20.70001031750437,37.055801295672616,0.08783362799903427,1176.3389723300934,456.8586440086365,1117.9384078979492,43070,7567,35503,35503,0,12,6700000.0
6700,6700999,20.699889998396646,37.05730726487693,0.0878190678635804,1176.456815958023,456.9232425689697,1118.2175674438477,43074,7567,35507,35507,0,12,6701000.0
6701,6701999,20.699483577653243,37.05709686414536,0.0878108516268582,1176.572390794754,456.98641085624695,1118.3753509521484,43075,7567,35508,35508,0,12,6702000.0
6702,6702999,20.699615511652837,37.05786857236962,0.087799619377114,1176.7857649326324,457.05107259750366,1118.4867515563965,43085,7568,35517,35517,0,12,6703000.0
6703,6703999,20.6996434235016,37.058109464340625,0.08776735879617803,1177.1121044158936,457.11647367477417,1118.7977104187012,43106,7570,35536,35536,0,12,6704000.0
6704,6704999,20.699551562199503,37.05790337035965,0.0877644921359616,1177.4297940731049,457.182550907135,1118.9702949523926,43117,7572,35545,35545,0,12,6705000.0
6705,6705999,20.699815866129768,37.05820130702512,0.08776189332534845,1177.937658548355,457.24717235565186,1118.975025177002,43126,7576,35550,35550,0,12,6706000.0
6706,6706999,20.700011675560813,37.05845183457229,0.08775901122622853,1178.2474043369293,457.3121802806854,1119.0379333496094,43130,7578,35552,35552,0,12,6707000.0
6707,6707999,20.700815009733752,37.06020366190201,0.08775177292325742,1178.4716877937317,457.3774206638336,1119.194969177246,43134,7579,35555,35555,0,12,6708000.0
6708,6708999,20.701558372147275,37.061471589498275,0.08773771628331084,1178.7905366420746,457.4422514438629,1119.3508071899414,43141,7581,35560,35560,0,12,6709000.0
6709,6709999,20.702780241656964,37.06286875369964,0.08772851306382512,1179.0132794380188,457.5074460506439,1119.4866561889648,43144,7582,35562,35562,0,12,6710000.0
6710,6710999,20.703549466793945,37.06384291153848,0.08772364503721919,1179.319890499115,457.57235836982727,1119.5298156738281,43149,7584,35565,35565,0,12,6711000.0
6711,6711999,20.704581549460865,37.06527748453908,0.08772564468435906,1179.927523136139,457.6382784843445,1119.4682121276855,43160,7589,35571,35571,0,12,6712000.0
6712,6712999,20.70593127443249,37.06794842113627,0.08772508528175116,1180.1411080360413,457.70370173454285,1119.6225090026855,43162,7590,35572,35572,0,12,6713000.0
6713,6713999,20.70715405353083,37.06933516278634,0.08772873380057111,1180.5564119815826,457.76830768585205,1119.6114463806152,43168,7593,35575,35575,0,12,6714000.0
6714,6714999,20.708769192248166,37.072481428444746,0.08770938825461416,1180.7732038497925,457.833544254303,1119.7989311218262,43171,7594,35577,35577,0,12,6715000.0
6715,6715999,20.709882654031958,37.073523242402146,0.08770946635731314,1181.281944513321,457.9015202522278,1119.7931327819824,43179,7598,35581,35581,0,12,6716000.0
6716,6716999,20.711171594983742,37.07455925395626,0.08772743174892328,1181.4021036624908,457.9657106399536,1119.930980682373,43179,7598,35581,35581,0,12,6717000.0
6717,6717999,20.712339724748205,37.07543877808482,0.08773445692347581,1181.6137371063232,458.0293502807617,1119.964443206787,43183,7599,35584,35584,0,12,6718000.0
6718,6718999,20.712709892721836,37.076524528657096,0.08770934245947815,1181.933590888977,458.093079328537,1120.186611175537,43199,7601,35598,35598,0,12,6719000.0
6719,6719999,20.71228610771552,37.077886160075956,0.08768853722439873,1182.1475734710693,458.1560568809509,1120.3531684875488,43206,7602,35604,35604,0,12,6720000.0
6720,6720999,20.711613932777013,37.076816544823906,0.08768227531917405,1182.3791830539703,458.2205913066864,1120.4575881958008,43209,7603,35606,35606,0,12,6721000.0
6721,6721999,20.711059181754212,37.075874554157714,0.08767079434135339,1182.6061372756958,458.28509402275085,1120.5480499267578,43213,7604,35609,35609,0,12,6722000.0
6722,6722999,20.710790024437543,37.07591713618605,0.08765655177380838,1182.8247396945953,458.3488793373108,1120.6237754821777,43218,7605,35613,35613,0,12,6723000.0
6723,6723999,20.7105896959763,37.075195050085796,0.08764229065355844,1183.1462409496307,458.4133961200714,1120.8907623291016,43228,7607,35621,35621,0,12,6724000.0
6724,6724999,20.710290085382525,37.07420911967438,0.08763645265207431,1183.362487077713,458.47812271118164,1120.98637008667,43230,7608,35622,35622,0,12,6725000.0
6725,6725999,20.710245572623087,37.07381198884014,0.08762989085947126,1183.6726849079132,458.5433843135834,1121.038158416748,43235,7610,35625,35625,0,12,6726000.0
6726,6726999,20.710132392124997,37.07323388156397,0.08762162183917732,1183.894817829132,458.60797238349915,1121.185432434082,43238,7611,35627,35627,0,12,6727000.0
6727,6727999,20.710513932872356,37.073800526042774,0.08760796313970343,1184.3144373893738,458.6721680164337,1121.1703720092773,43261,7614,35647,35647,0,12,6728000.0
6728,6728999,20.71070687351669,37.073723689401056,0.087601737583903,1184.446120262146,458.7364511489868,1121.3600845336914,43263,7614,35649,35649,0,12,6729000.0
6729,6729999,20.71121586906991,37.07363759391654,0.08759093190402478,1184.5619106292725,458.79944491386414,1121.5368423461914,43264,7614,35650,35650,0,12,6730000.0
6730,6730999,20.711836928240068,37.07409975690227,0.08757986411607077,1184.6803617477417,458.86226749420166,1121.6364669799805,43264,7614,35650,35650,0,12,6731000.0
6731,6731999,20.712144715158715,37.07389734792534,0.0875787959223373,1185.1085941791534,458.92785811424255,1121.6509857177734,43270,7617,35653,35653,0,12,6732000.0
6732,6732999,20.712464809613344,37.07358660237353,0.08757097080173615,1185.4268107414246,458.99184560775757,1121.696834564209,43280,7619,35661,35661,0,12,6733000.0
6733,6733999,20.713201827542264,37.07407299849764,0.08756604846343774,1185.537635087967,459.05474305152893,1121.8298301696777,43280,7619,35661,35661,0,12,6734000.0
6734,6734999,20.713568515467042,37.073682447939056,0.08755775773506491,1185.7622714042664,459.1191415786743,1121.8745155334473,43291,7620,35671,35671,0,12,6735000.0
6735,6735999,20.71393731897147,37.07325226757575,0.08755032874758628,1186.0736827850342,459.181991815567,1121.918285369873,43295,7622,35673,35673,0,12,6736000.0
6736,6736999,20.714292782987606,37.072941740272704,0.08754001915081067,1186.389816045761,459.2458620071411,1121.9811820983887,43304,7624,35680,35680,0,12,6737000.0
6737,6737999,20.71466206667836,37.07239181247821,0.08753219075173224,1186.6160910129547,459.30993270874023,1122.0471572875977,43306,7625,35681,35681,0,12,6738000.0
6738,6738999,20.714379350172514,37.07108399725931,0.08753172757879457,1186.7355227470398,459.3736062049866,1122.2663955688477,43309,7625,35684,35684,0,12,6739000.0
6739,6739999,20.713397024182253,37.06942171144575,0.08753490752183424,1186.843663930893,459.4368824958801,1122.7476654052734,43320,7625,35695,35695,0,12,6740000.0
6740,6740999,20.712405590636806,37.068317763677676,0.08753532626186322,1186.9630982875824,459.5006015300751,1122.9335632324219,43322,7625,35697,35697,0,12,6741000.0
6741,6741999,20.711510211910323,37.066994665440916,0.08753558835070285,1187.3738639354706,459.5658733844757,1123.09619140625,43331,7628,35703,35703,0,12,6742000.0
6742,6742999,20.710731616778705,37.06553148374233,0.08753535610207286,1187.5909543037415,459.6294023990631,1123.2315101623535,43334,7629,35705,35705,0,12,6743000.0
6743,6743999,20.710181578913783,37.06407987590787,0.08752893806124773,1187.8114297389984,459.69501519203186,1123.5688667297363,43342,7630,35712,35712,0,12,6744000.0
6744,6744999,20.709455045479565,37.062456805872564,0.08753448451136414,1188.1326513290405,459.75893354415894,1123.6823768615723,43346,7632,35714,35714,0,12,6745000.0
6745,6745999,20.70890579111802,37.06129508389778,0.08753887118487103,1188.3419513702393,459.8229820728302,1123.8322944641113,43348,7633,35715,35715,0,12,6746000.0
6746,6746999,20.708398521780104,37.060421000293346,0.08753660253487494,1188.6625559329987,459.8885269165039,1123.976749420166,43353,7635,35718,35718,0,12,6747000.0
6747,6747999,20.70785775052297,37.059299498227595,0.08753845385300107,1188.7739844322205,459.95169472694397,1124.1605491638184,43354,7635,35719,35719,0,12,6748000.0
6748,6748999,20.7075702305297,37.0589238441882,0.08753813353068263,1188.8898463249207,460.0161666870117,1124.417194366455,43359,7635,35724,35724,0,12,6749000.0
6749,6749999,20.707262660191105,37.05769231446047,0.08754472347243003,1189.0005695819855,460.0773868560791,1124.665672302246,43363,7635,35728,35728,0,12,6750000.0
6750,6750999,20.70721513427613,37.05697354045355,0.08754194653368919,1189.3129394054413,460.1401355266571,1124.7216873168945,43367,7637,35730,35730,0,12,6751000.0
6751,6751999,20.70739411317422,37.05848811468318,0.08752836489966742,1189.6426923274994,460.20476484298706,1124.8003540039062,43400,7639,35761,35761,0,12,6752000.0
6752,6752999,20.70755857499874,37.05831157952397,0.08752525445815107,1190.0620567798615,460.26890301704407,1124.8315353393555,43406,7642,35764,35764,0,12,6753000.0
6753,6753999,20.708124312006532,37.058841019681125,0.0875232850120381,1190.2874550819397,460.33568143844604,1124.9625625610352,43418,7643,35775,35775,0,12,6754000.0
6754,6754999,20.70880095254039,37.06083064118054,0.0875153002335286,1190.412513256073,460.3985447883606,1125.1863594055176,43422,7643,35779,35779,0,12,6755000.0
6755,6755999,20.709786444644482,37.06172688894969,0.08751722238071158,1190.8126826286316,460.4617078304291,1125.2065315246582,43428,7646,35782,35782,0,12,6756000.0
6756,6756999,20.710569966976465,37.062452805843186,0.08751460663515953,1191.024127960205,460.52555203437805,1125.3139610290527,43431,7647,35784,35784,0,12,6757000.0
6757,6757999,20.71138184675975,37.06301403511213,0.08751665495418437,1191.2458579540253,460.5903182029724,1125.375717163086,43433,7648,35785,35785,0,12,6758000.0
6758,6758999,20.711390063002195,37.06229694103413,0.08751644724034446,1191.579400062561,460.6595096588135,1125.541576385498,43439,7650,35789,35789,0,12,6759000.0
6759,6759999,20.71095469347082,37.0619897530412,0.08751479843965515,1191.7011909484863,460.72204637527466,1125.6760368347168,43439,7650,35789,35789,0,12,6760000.0
6760,6760999,20.710986244509584,37.0629655502227,0.08750753797675426,1191.8163313865662,460.7852952480316,1125.7821960449219,43439,7650,35789,35789,0,12,6761000.0
6761,6761999,20.71134682051846,37.063813323920485,0.08750041538510289,1192.1334652900696,460.84922909736633,1125.8460502624512,43444,7652,35792,35792,0,12,6762000.0
6762,6762999,20.71215323563532,37.06513101523644,0.08748546502271215,1192.3618392944336,460.9132902622223,1125.9874877929688,43448,7653,35795,35795,0,12,6763000.0
6763,6763999,20.713309600099493,37.067156488501304,0.08746676504856843,1192.5878469944,460.977520942688,1126.1027374267578,43451,7654,35797,35797,0,12,6764000.0
6764,6764999,20.71426005711175,37.06818366944786,0.08745718508977907,1192.8939716815948,461.0422594547272,1126.10933303833,43455,7656,35799,35799,0,12,6765000.0
6765,6765999,20.715555062646263,37.07043517774165,0.08744515850017831,1193.2134521007538,461.1058485507965,1126.172492980957,43459,7658,35801,35801,0,12,6766000.0
6766,6766999,20.716539709943223,37.07170442401555,0.08743773147006828,1193.3464078903198,461.17720246315,1126.3009757995605,43459,7658,35801,35801,0,12,6767000.0
6767,6767999,20.71748732095712,37.07270959881223,0.08743892403049547,1193.5799670219421,461.23999428749084,1126.329044342041,43461,7659,35802,35802,0,12,6768000.0
6768,6768999,20.719306672501524,37.075410115798555,0.08741201104359275,1193.8000583648682,461.30433773994446,1126.4665756225586,43467,7660,35807,35807,0,12,6769000.0
6769,6769999,20.720881033058483,37.07789045864053,0.08740331396972967,1194.2231307029724,461.36761713027954,1126.4531784057617,43475,7663,35812,35812,0,12,6770000.0
6770,6770999,20.722089038844967,37.07961527661618,0.08740109471477742,1194.7364041805267,461.4320387840271,1126.355484008789,43492,7667,35825,35825,0,12,6771000.0
6771,6771999,20.723311962504773,37.08110988838648,0.08740149564410471,1195.1597049236298,461.4969413280487,1126.3587913513184,43498,7670,35828,35828,0,12,6772000.0
6772,6772999,20.72490980187281,37.08274643724355,0.08743611517633398,1195.3833906650543,461.5623080730438,1126.4590034484863,43500,7671,35829,35829,0,12,6773000.0
6773,6773999,20.7262778202416,37.08424959178862,0.08744381130954582,1195.705668926239,461.6267147064209,1126.5334739685059,43515,7673,35842,35842,0,12,6774000.0
6774,6774999,20.727771222067265,37.085992205844605,0.08743900727945164,1195.9148366451263,461.6904048919678,1126.601661682129,43527,7674,35853,35853,0,12,6775000.0
6775,6775999,20.728987339046036,37.08759572374037,0.08743857244484654,1196.2317762374878,461.7547266483307,1126.6128387451172,43531,7676,35855,35855,0,12,6776000.0
6776,6776999,20.730271002116613,37.08860630530321,0.08743930024633795,1196.4485874176025,461.819295167923,1126.6780166625977,43533,7677,35856,35856,0,12,6777000.0
6777,6777999,20.73081252162495,37.08848513539716,0.08743717219999714,1196.9763033390045,461.8841640949249,1126.5592765808105,43541,7681,35860,35860,0,12,6778000.0
6778,6778999,20.730020543195266,37.08752354802181,0.08743572432053281,1197.1899988651276,461.95140194892883,1126.8912200927734,43552,7682,35870,35870,0,12,6779000.0
6779,6779999,20.728951311766004,37.08652907795079,0.08743286238469006,1197.3163073062897,462.01578426361084,1127.1014785766602,43552,7682,35870,35870,0,12,6780000.0
6780,6780999,20.727950649580364,37.084858529186555,0.08743160584821086,1197.538227558136,462.08108353614807,1127.2422904968262,43556,7683,35873,35873,0,12,6781000.0
6781,6781999,20.727159161072795,37.08477357434159,0.08742257835332345,1197.6628272533417,462.1456227302551,1127.3619384765625,43558,7683,35875,35875,0,12,6782000.0
6782,6782999,20.726330365631892,37.0832065673108,0.08741512094397019,1197.9817600250244,462.2117507457733,1127.6475982666016,43570,7685,35885,35885,0,12,6783000.0
6783,6783999,20.72548121509754,37.08148965515574,0.08741285379664021,1198.2986707687378,462.27686166763306,1127.7881393432617,43574,7687,35887,35887,0,12,6784000.0
6784,6784999,20.724642558234123,37.080103253808794,0.08741659415040692,1198.6065211296082,462.3410258293152,1127.8854141235352,43578,7689,35889,35889,0,12,6785000.0
6785,6785999,20.723912975182174,37.078628729317344,0.0874152193692258,1198.8157060146332,462.4057559967041,1128.0535278320312,43581,7690,35891,35891,0,12,6786000.0
6786,6786999,20.723349006418022,37.077960306630665,0.08740912019560865,1199.0281636714935,462.47259616851807,1128.1877174377441,43584,7691,35893,35893,0,12,6787000.0
6787,6787999,20.722735598607354,37.07662409543173,0.08740700809855861,1199.1575891971588,462.53725504875183,1128.3573989868164,43584,7691,35893,35893,0,12,6788000.0
6788,6788999,20.722297980944468,37.07553139042318,0.08740019488907791,1199.3822605609894,462.6023631095886,1128.6817779541016,43593,7692,35901,35901,0,12,6789000.0
6789,6789999,20.722058118680945,37.0748708530413,0.0873933322664715,1199.5934863090515,462.665575504303,1128.8236541748047,43595,7693,35902,35902,0,12,6790000.0
6790,6790999,20.72197886052854,37.074319509821606,0.08738144375035406,1200.0061933994293,462.7299892902374,1128.8467063903809,43602,7696,35906,35906,0,12,6791000.0
6791,6791999,20.721945366181412,37.0735859126558,0.0873765041965111,1200.4373977184296,462.79608178138733,1128.8881568908691,43608,7699,35909,35909,0,12,6792000.0
6792,6792999,20.72190956009925,37.072981748911815,0.0873730101493716,1200.6689624786377,462.87132501602173,1129.0493927001953,43611,7700,35911,35911,0,12,6793000.0
6793,6793999,20.72215645819593,37.07289173875375,0.087375204836461,1200.9843347072601,462.93639969825745,1129.111442565918,43615,7702,35913,35913,0,12,6794000.0
6794,6794999,20.72260542345229,37.073069808866656,0.08736331803035413,1201.1113681793213,463.000497341156,1129.3195152282715,43618,7702,35916,35916,0,12,6795000.0
6795,6795999,20.723478418250398,37.07355752016582,0.08735717693010725,1201.2212035655975,463.0659193992615,1129.4554901123047,43618,7702,35916,35916,0,12,6796000.0
6796,6796999,20.7241649757126,37.07364169069123,0.08735165054849525,1201.5410552024841,463.12926173210144,1129.53031539917,43622,7704,35918,35918,0,12,6797000.0
6797,6797999,20.724783961086523,37.07357495125319,0.08736405048252638,1201.6713645458221,463.1928663253784,1129.622802734375,43622,7704,35918,35918,0,12,6798000.0
6798,6798999,20.724907299458764,37.07299517105268,0.0873613308062745,1201.7888638973236,463.25799679756165,1129.968921661377,43630,7704,35926,35926,0,12,6799000.0
6799,6799999,20.724028450680645,37.071793202664736,0.08735818762122582,1202.0062744617462,463.32362031936646,1130.4124145507812,43645,7705,35940,35940,0,12,6800000.0
6800,6800999,20.723328747191086,37.07055103215652,0.08735828033848048,1202.3222525119781,463.3888130187988,1130.6404304504395,43650,7707,35943,35943,0,12,6801000.0
6801,6801999,20.7230188559411,37.07009390520418,0.08734422645276019,1202.6403148174286,463.4547998905182,1130.8231201171875,43665,7709,35956,35956,0,12,6802000.0
6802,6802999,20.722907762209402,37.069709004357165,0.08733933807075545,1202.9714493751526,463.5215389728546,1130.9224891662598,43679,7711,35968,35968,0,12,6803000.0
6803,6803999,20.722818097961806,37.06929425946153,0.08732616168983742,1203.1871490478516,463.5862545967102,1131.1854248046875,43684,7712,35972,35972,0,12,6804000.0
6804,6804999,20.722776371411705,37.068494070281275,0.0873222333885485,1203.5076816082,463.65146231651306,1131.277889251709,43688,7714,35974,35974,0,12,6805000.0
6805,6805999,20.722536382941684,37.06788536174726,0.08731274153813551,1203.6284582614899,463.7174472808838,1131.414649963379,43688,7714,35974,35974,0,12,6806000.0
6806,6806999,20.722424374601022,37.06739473287148,0.0873063337304123,1203.957304239273,463.7825653553009,1131.450626373291,43695,7716,35979,35979,0,12,6807000.0
6807,6807999,20.722498260362144,37.0670925323571,0.08730193336195802,1204.1693797111511,463.84553360939026,1131.5377616882324,43706,7717,35989,35989,0,12,6808000.0
6808,6808999,20.722541816308468,37.06649140388403,0.08728803515020911,1204.4899876117706,463.91051149368286,1131.6024856567383,43722,7719,36003,36003,0,12,6809000.0
6809,6809999,20.72265217513542,37.065819808165585,0.08727039176428653,1204.7033393383026,463.9753170013428,1131.8796310424805,43737,7720,36017,36017,0,12,6810000.0
6810,6810999,20.72317775889151,37.06614278449001,0.08727492562416972,1204.9298667907715,464.04301404953003,1132.0050163269043,43739,7721,36018,36018,0,12,6811000.0
6811,6811999,20.723760992187643,37.0662176125834,0.08726157623892472,1205.2453365325928,464.10689544677734,1132.0493240356445,43743,7723,36020,36020,0,12,6812000.0
6812,6812999,20.724594849464832,37.066714167026774,0.08726282441393851,1205.3644745349884,464.1725604534149,1132.1739234924316,43743,7723,36020,36020,0,12,6813000.0
6813,6813999,20.725455201569112,37.06719243572164,0.08726684449212052,1205.6877892017365,464.23703265190125,1132.2424964904785,43776,7725,36051,36051,0,12,6814000.0
6814,6814999,20.726318744346752,37.06765690374794,0.08726328645337034,1206.1173424720764,464.30531764030457,1132.2638626098633,43784,7728,36056,36056,0,12,6815000.0
6815,6815999,20.727408139914825,37.06802696672749,0.08725114670169742,1206.3464567661285,464.3701868057251,1132.54740524292,43791,7729,36062,36062,0,12,6816000.0
6816,6816999,20.728598988891694,37.06862029611899,0.08724818204065332,1206.556247472763,464.4331419467926,1132.641315460205,43793,7730,36063,36063,0,12,6817000.0
6817,6817999,20.729728774192477,37.06901523796091,0.0872449506956936,1206.8688912391663,464.4979438781738,1132.720932006836,43798,7732,36066,36066,0,12,6818000.0
6818,6818999,20.730572262748353,37.06911803182726,0.08724612272248389,1207.3940267562866,464.56342816352844,1132.6543502807617,43814,7736,36078,36078,0,12,6819000.0
6819,6819999,20.73006015255333,37.06848075688594,0.08723664944006826,1207.6134161949158,464.6272072792053,1132.9231414794922,43830,7737,36093,36093,0,12,6820000.0
6820,6820999,20.729203793011692,37.06755624218521,0.08723474542759235,1207.8349163532257,464.6916928291321,1133.059944152832,43832,7738,36094,36094,0,12,6821000.0
6821,6821999,20.728307683114696,37.06606590470203,0.08723842009934213,1207.9574732780457,464.7552750110626,1133.2105674743652,43834,7738,36096,36096,0,12,6822000.0
6822,6822999,20.727542534153287,37.06463062769818,0.08723773799505175,1208.070199728012,464.82046031951904,1133.3773574829102,43836,7738,36098,36098,0,12,6823000.0
6823,6823999,20.726768390837513,37.063384676476865,0.08723810018610134,1208.3864097595215,464.8859841823578,1133.5143241882324,43841,7740,36101,36101,0,12,6824000.0
6824,6824999,20.726234697600766,37.06260737531634,0.08723747732172915,1208.598541021347,464.95056080818176,1133.6516418457031,43844,7741,36103,36103,0,12,6825000.0
6825,6825999,20.7256691981277,37.061534579887294,0.08723757794175546,1208.814749956131,465.01446175575256,1133.7406997680664,43846,7742,36104,36104,0,12,6826000.0
6826,6826999,20.72510779236857,37.0602647210805,0.08724170888331606,1209.043327331543,465.07968068122864,1133.8546447753906,43849,7743,36106,36106,0,12,6827000.0
6827,6827999,20.724516550717826,37.05916553926064,0.08724392876292564,1209.2624671459198,465.1442494392395,1133.9580993652344,43852,7744,36108,36108,0,12,6828000.0
6828,6828999,20.72411273323677,37.05833097842509,0.08724451907116082,1209.584802865982,465.20993876457214,1134.076244354248,43862,7746,36116,36116,0,12,6829000.0
6829,6829999,20.724070600342355,37.05789621251958,0.08724098624076948,1209.8103024959564,465.2755970954895,1134.1817245483398,43864,7747,36117,36117,0,12,6830000.0
6830,6830999,20.724287473673744,37.059893217662434,0.08723777492968432,1209.9319849014282,465.34019899368286,1134.3190956115723,43865,7747,36118,36118,0,12,6831000.0
6831,6831999,20.72450408355861,37.061057647329136,0.08724007484079266,1210.3605756759644,465.4050991535187,1134.301528930664,43871,7750,36121,36121,0,12,6832000.0
6832,6832999,20.724766661585896,37.06137231540979,0.08723745571302477,1210.4917290210724,465.4807617664337,1134.4350242614746,43871,7750,36121,36121,0,12,6833000.0
6833,6833999,20.72482311174605,37.06085729463195,0.0872351559122756,1210.7200288772583,465.54819083213806,1134.5586013793945,43875,7751,36124,36124,0,12,6834000.0
6834,6834999,20.72479364871319,37.06119870582934,0.087231922481105,1210.8327498435974,465.6121211051941,1134.6413307189941,43875,7751,36124,36124,0,12,6835000.0
6835,6835999,20.724525344293586,37.061241739543966,0.08723483848178526,1211.1541934013367,465.6774034500122,1134.9382286071777,43899,7753,36146,36146,0,12,6836000.0
6836,6836999,20.724011762575977,37.06084907250355,0.08724453429563706,1211.2673292160034,465.7427215576172,1135.1575355529785,43900,7753,36147,36147,0,12,6837000.0
6837,6837999,20.724277452899912,37.06636526940999,0.08724588456445215,1211.3871529102325,465.8110854625702,1135.3406867980957,43902,7753,36149,36149,0,12,6838000.0
6838,6838999,20.724163797486973,37.066341270580814,0.08722073452284751,1211.7040870189667,465.87573075294495,1135.4311714172363,43909,7755,36154,36154,0,12,6839000.0
6839,6839999,20.72428889477981,37.067324556135524,0.0872431873338062,1212.0160994529724,465.93979930877686,1135.6374130249023,43915,7757,36158,36158,0,12,6840000.0
6840,6840999,20.724246849224702,37.06679078461899,0.08724469048311367,1212.647840499878,466.00510025024414,1135.671127319336,43929,7762,36167,36167,0,12,6841000.0
6841,6841999,20.724192481721364,37.06632673768588,0.08724374425444181,1213.0558722019196,466.0716595649719,1135.7698364257812,43935,7765,36170,36170,0,12,6842000.0
6842,6842999,20.72432966249903,37.06850058869147,0.08724213339240872,1213.2692348957062,466.136563539505,1135.958610534668,43938,7766,36172,36172,0,12,6843000.0
6843,6843999,20.72460429658562,37.06819986604213,0.08724637614406361,1213.492171049118,466.20158982276917,1136.0690689086914,43941,7767,36174,36174,0,12,6844000.0
6844,6844999,20.725153181950883,37.06853037557861,0.08724029166398595,1213.9067137241364,466.2669713497162,1136.265151977539,43952,7770,36182,36182,0,12,6845000.0
6845,6845999,20.72621511955814,37.071467478263486,0.08723037249543386,1214.2373328208923,466.3430619239807,1136.3792839050293,43956,7772,36184,36184,0,12,6846000.0
6846,6846999,20.726862465266905,37.072021709250755,0.08723567732301518,1214.5522079467773,466.4070291519165,1136.5004615783691,43961,7774,36187,36187,0,12,6847000.0
6847,6847999,20.728046748400352,37.0730833641079,0.08725040875837276,1214.8753576278687,466.4722464084625,1136.5854759216309,43965,7776,36189,36189,0,12,6848000.0
6848,6848999,20.728966122350176,37.07386116590295,0.08727848382604286,1215.0869982242584,466.53689789772034,1136.7421798706055,43967,7777,36190,36190,0,12,6849000.0
6849,6849999,20.730112840273215,37.07549761006551,0.08728967833896051,1215.1998238563538,466.60228061676025,1136.8733444213867,43967,7777,36190,36190,0,12,6850000.0
6850,6850999,20.7310395974059,37.07616141815675,0.08729520281934255,1215.4163539409637,466.66717314720154,1137.0134887695312,43969,7778,36191,36191,0,12,6851000.0
6851,6851999,20.732493784296036,37.078862490057126,0.08729297889411891,1215.8512654304504,466.73634243011475,1137.0307426452637,43975,7781,36194,36194,0,12,6852000.0
6852,6852999,20.733603511579883,37.08056043954757,0.08730063887953965,1215.973699092865,466.7999038696289,1137.1413078308105,43975,7781,36194,36194,0,12,6853000.0
6853,6853999,20.734380112907644,37.080706569427534,0.08730381625755401,1216.2964053153992,466.8647401332855,1137.1422119140625,43979,7783,36196,36196,0,12,6854000.0
6854,6854999,20.734862886172106,37.08134884248047,0.08727828073263189,1216.5163209438324,466.9304141998291,1137.4273414611816,43989,7784,36205,36205,0,12,6855000.0
6855,6855999,20.734897744873727,37.08145115115786,0.08725806082102938,1216.6345601081848,466.9938793182373,1137.591121673584,43990,7784,36206,36206,0,12,6856000.0
6856,6856999,20.73515596200699,37.082582421812056,0.08724267660936924,1216.7655119895935,467.0600538253784,1137.7238426208496,43990,7784,36206,36206,0,12,6857000.0
6857,6857999,20.735247763586504,37.08330309451384,0.08722442737206137,1216.9921140670776,467.12637758255005,1137.8098335266113,44002,7785,36217,36217,0,12,6858000.0
6858,6858999,20.735556928243504,37.083828050987755,0.0871934064232942,1217.3330132961273,467.1909029483795,1137.858570098877,44024,7787,36237,36237,0,12,6859000.0
6859,6859999,20.73605080499307,37.08477584938025,0.08717491391526744,1217.4495832920074,467.25468492507935,1138.0349006652832,44024,7787,36237,36237,0,12,6860000.0
6860,6860999,20.73617055160615,37.08452747458649,0.08716076710998599,1217.679146528244,467.3186209201813,1138.115520477295,44027,7788,36239,36239,0,12,6861000.0
6861,6861999,20.736625339199993,37.08481591775391,0.08715572058646759,1218.100668668747,467.38323068618774,1138.0897216796875,44042,7791,36251,36251,0,12,6862000.0
6862,6862999,20.73714629982964,37.08510020072491,0.08715757750409148,1218.320007801056,467.44785475730896,1138.156135559082,44045,7792,36253,36253,0,12,6863000.0
6863,6863999,20.73788022022791,37.085769243071375,0.08713777468774542,1218.5383431911469,467.5114116668701,1138.2312622070312,44058,7793,36265,36265,0,12,6864000.0
6864,6864999,20.738949010100363,37.08667518275168,0.08712815450430311,1218.663225889206,467.57789635658264,1138.5291175842285,44063,7793,36270,36270,0,12,6865000.0
6865,6865999,20.7400019603336,37.087688914992974,0.08712870990028643,1218.8750972747803,467.64093017578125,1138.6380157470703,44068,7794,36274,36274,0,12,6866000.0
6866,6866999,20.740660335715347,37.0878848570802,0.08713900692244447,1219.2939364910126,467.70573830604553,1138.671989440918,44082,7797,36285,36285,0,12,6867000.0
6867,6867999,20.74185711653626,37.08892509019116,0.08714999394739142,1219.5178513526917,467.7695543766022,1138.8136711120605,44084,7798,36286,36286,0,12,6868000.0
6868,6868999,20.742982259409576,37.08986259189137,0.08716857626648788,1219.6306564807892,467.8324565887451,1138.9448013305664,44084,7798,36286,36286,0,12,6869000.0
6869,6869999,20.74408818700431,37.090431954406846,0.08717622884536846,1219.8524737358093,467.8965845108032,1139.0061721801758,44096,7799,36297,36297,0,12,6870000.0
6870,6870999,20.745163750452868,37.09199281684533,0.08717954605500511,1219.985541343689,467.9597079753876,1139.3004913330078,44098,7799,36299,36299,0,12,6871000.0
6871,6871999,20.746094063986618,37.09251099092764,0.08718959353307953,1220.092829465866,468.0219717025757,1139.4696426391602,44098,7799,36299,36299,0,12,6872000.0
6872,6872999,20.74710328345686,37.093095184961875,0.0871994467064392,1220.2152309417725,468.08785581588745,1139.5886840820312,44098,7799,36299,36299,0,12,6873000.0
6873,6873999,20.747241582704635,37.09215998056679,0.08719397265903261,1220.5378589630127,468.15197348594666,1139.620376586914,44102,7801,36301,36301,0,12,6874000.0
6874,6874999,20.747541191322057,37.094194532459625,0.08717490452670651,1220.654441356659,468.21724462509155,1140.147445678711,44113,7801,36312,36312,0,12,6875000.0
6875,6875999,20.74722116083451,37.095195252716046,0.08717179931414498,1220.8788874149323,468.28232526779175,1140.2737426757812,44124,7802,36322,36322,0,12,6876000.0
6876,6876999,20.746730787427445,37.094229387079174,0.08717237474603357,1221.0923414230347,468.346209526062,1140.4510765075684,44136,7803,36333,36333,0,12,6877000.0
6877,6877999,20.746341001006694,37.093159695601265,0.08716755738729964,1221.2052700519562,468.41005754470825,1140.6099243164062,44138,7803,36335,36335,0,12,6878000.0
6878,6878999,20.746141148966302,37.09237589295625,0.08715610564539122,1221.3218569755554,468.4748275279999,1140.8884963989258,44142,7803,36339,36339,0,12,6879000.0
6879,6879999,20.74596174755096,37.09192684717215,0.08714821501254388,1221.6410729885101,468.5389482975006,1140.9668235778809,44146,7805,36341,36341,0,12,6880000.0
6880,6880999,20.74571202274247,37.09089974532842,0.08714808478371605,1221.9568598270416,468.6034655570984,1141.057804107666,44151,7807,36344,36344,0,12,6881000.0
6881,6881999,20.745551530305466,37.09045218436154,0.08714656623541661,1222.1869761943817,468.66805934906006,1141.1733512878418,44153,7808,36345,36345,0,12,6882000.0
6882,6882999,20.745519108571433,37.090085787467345,0.08714046853578616,1222.4185628890991,468.73574328422546,1141.2485160827637,44155,7809,36346,36346,0,12,6883000.0
6883,6883999,20.745703968573416,37.089980152529485,0.08713037806367918,1222.5326685905457,468.8014245033264,1141.5386695861816,44162,7809,36353,36353,0,12,6884000.0
6884,6884999,20.746505234993386,37.09112237793857,0.08712560496235833,1222.7626929283142,468.86476945877075,1141.6636772155762,44164,7810,36354,36354,0,12,6885000.0
6885,6885999,20.747677862036397,37.093073794183745,0.08713338683426897,1223.1799356937408,468.92961263656616,1141.678955078125,44170,7813,36357,36357,0,12,6886000.0
6886,6886999,20.748588015412466,37.09408253741526,0.08714465076684264,1223.6234502792358,468.9955186843872,1141.6513748168945,44176,7816,36360,36360,0,12,6887000.0
6887,6887999,20.74986547816221,37.096512432648744,0.08718497094728495,1223.946041584015,469.0614469051361,1141.7603569030762,44189,7818,36371,36371,0,12,6888000.0
6888,6888999,20.751105380922585,37.09807316108655,0.0872132462730828,1224.0713350772858,469.1258327960968,1141.9787254333496,44193,7818,36375,36375,0,12,6889000.0
6889,6889999,20.75266130277773,37.10017194066195,0.08721012959213215,1224.1843054294586,469.1896252632141,1142.1071395874023,44193,7818,36375,36375,0,12,6890000.0
6890,6890999,20.754059305550097,37.10182631761069,0.08721648887349343,1224.5068073272705,469.2538871765137,1142.1189270019531,44197,7820,36377,36377,0,12,6891000.0
6891,6891999,20.754920358007784,37.10218641051646,0.08722435801241513,1224.7216036319733,469.31663155555725,1142.1585159301758,44199,7821,36378,36378,0,12,6892000.0
6892,6892999,20.755172616361303,37.102626999835884,0.08720313062628271,1225.1502039432526,469.38012647628784,1142.3893852233887,44216,7824,36392,36392,0,12,6893000.0
6893,6893999,20.754766807376082,37.10295261987484,0.08718480492682246,1225.2592179775238,469.44252252578735,1142.6124267578125,44218,7824,36394,36394,0,12,6894000.0
6894,6894999,20.754073869132856,37.101741614469255,0.08718117207117781,1225.3771347999573,469.5062656402588,1142.7611465454102,44218,7824,36394,36394,0,12,6895000.0
6895,6895999,20.75349759144564,37.10061714521598,0.08717776374746289,1225.495642900467,469.5687692165375,1142.890926361084,44220,7824,36396,36396,0,12,6896000.0
6896,6896999,20.7530267276778,37.099532003264656,0.08716907978576693,1225.7168922424316,469.63226532936096,1143.0831909179688,44228,7825,36403,36403,0,12,6897000.0
6897,6897999,20.752733615875094,37.0983391556349,0.0871599596273891,1225.9326167106628,469.69451332092285,1143.2404479980469,44231,7826,36405,36405,0,12,6898000.0
6898,6898999,20.752181637150663,37.09735807036549,0.08715153152755395,1226.1602172851562,469.76103472709656,1143.374870300293,44235,7827,36408,36408,0,12,6899000.0
6899,6899999,20.75159875463414,37.095865773201034,0.0871476917967472,1226.4807698726654,469.8255228996277,1143.4011001586914,44242,7829,36413,36413,0,12,6900000.0
6900,6900999,20.751071202774607,37.09451349574939,0.08714306486454826,1226.9972994327545,469.890163898468,1143.3861083984375,44261,7833,36428,36428,0,12,6901000.0
6901,6901999,20.75050855705135,37.0930332568897,0.08713927065608429,1227.2184710502625,469.95385694503784,1143.541576385498,44264,7834,36430,36430,0,12,6902000.0
6902,6902999,20.750066499350364,37.0921861151942,0.08712692954961165,1227.5430030822754,470.01855659484863,1143.7326583862305,44281,7836,36445,36445,0,12,6903000.0
6903,6903999,20.74960725461578,37.09095714118052,0.08712402401068753,1227.7512674331665,470.0812408924103,1143.8472175598145,44292,7837,36455,36455,0,12,6904000.0
6904,6904999,20.74932489951774,37.09002409757495,0.08711906771437417,1227.9766006469727,470.1498830318451,1143.9518432617188,44294,7838,36456,36456,0,12,6905000.0
6905,6905999,20.74905593307078,37.08898117456212,0.08711878247910276,1228.110095024109,470.2158524990082,1144.0700073242188,44294,7838,36456,36456,0,12,6906000.0
6906,6906999,20.74886981270301,37.08811183946391,0.08711550219806874,1228.443781375885,470.28263425827026,1144.0933952331543,44298,7840,36458,36458,0,12,6907000.0
6907,6907999,20.748818925993675,37.08747038896571,0.0871139276336167,1228.6653106212616,470.3476643562317,1144.175868988037,44301,7841,36460,36460,0,12,6908000.0
6908,6908999,20.74858955928569,37.08634710751318,0.08711289897538321,1229.0859200954437,470.4103693962097,1144.1978759765625,44313,7844,36469,36469,0,12,6909000.0
6909,6909999,20.748426107737078,37.08538429420381,0.08710791220577818,1229.4046788215637,470.4745705127716,1144.3308486938477,44317,7846,36471,36471,0,12,6910000.0
6910,6910999,20.748154910304034,37.084296828223906,0.08710600896939291,1229.5261137485504,470.5405502319336,1144.462142944336,44317,7846,36471,36471,0,12,6911000.0
6911,6911999,20.74752073938321,37.082689727198726,0.08710927840817773,1230.0594148635864,470.6054496765137,1144.3894271850586,44325,7850,36475,36475,0,12,6912000.0
6912,6912999,20.746787643019037,37.081281196476155,0.08711017959119571,1230.3849647045135,470.670330286026,1144.6106872558594,44340,7852,36488,36488,0,12,6913000.0
6913,6913999,20.746039584669496,37.079979416435265,0.08709741868567067,1230.700894355774,470.73409271240234,1144.7095069885254,44345,7854,36491,36491,0,12,6914000.0
6914,6914999,20.745174134946648,37.07888230411082,0.08709446016247191,1230.9256641864777,470.79915022850037,1144.8366088867188,44349,7855,36494,36494,0,12,6915000.0
6915,6915999,20.744425708265315,37.0775531653854,0.08708896367012986,1231.0359470844269,470.8637194633484,1145.0122871398926,44353,7855,36498,36498,0,12,6916000.0
6916,6916999,20.74367516324351,37.07599615034256,0.08708096035170598,1231.4591369628906,470.92903113365173,1145.0321464538574,44368,7858,36510,36510,0,12,6917000.0
6917,6917999,20.74351386315082,37.075610976274135,0.08705376739679394,1231.692331790924,470.9957549571991,1145.390121459961,44376,7859,36517,36517,0,12,6918000.0
6918,6918999,20.743360438620602,37.07510551062988,0.08703583394190051,1232.1117429733276,471.0601089000702,1145.4462852478027,44391,7862,36529,36529,0,12,6919000.0
6919,6919999,20.743141097562205,37.07471952545849,0.08701589917182784,1232.3446576595306,471.1288857460022,1145.565731048584,44394,7863,36531,36531,0,12,6920000.0
6920,6920999,20.742867623241725,37.07446038839752,0.0870019512200354,1232.5624015331268,471.1939969062805,1145.7108001708984,44401,7864,36537,36537,0,12,6921000.0
6921,6921999,20.74314589455146,37.07557175451198,0.08699960721733868,1232.785347700119,471.25942635536194,1145.8390464782715,44405,7865,36540,36540,0,12,6922000.0
6922,6922999,20.74347359621019,37.07877328297382,0.08699495873977714,1233.0203490257263,471.3273103237152,1146.0643463134766,44411,7866,36545,36545,0,12,6923000.0
6923,6923999,20.74408153350728,37.080491568349764,0.08697470508444238,1233.1401665210724,471.3926055431366,1146.2252006530762,44411,7866,36545,36545,0,12,6924000.0
6924,6924999,20.744809112743532,37.08307423196792,0.08697039183402788,1233.5591413974762,471.457710981369,1146.2507095336914,44428,7869,36559,36559,0,12,6925000.0
6925,6925999,20.74526599329003,37.08340984450921,0.08697265095954532,1233.787267446518,471.5222260951996,1146.326072692871,44430,7870,36560,36560,0,12,6926000.0
6926,6926999,20.746355426663342,37.085716226251975,0.0869655788391448,1233.9016292095184,471.5853183269501,1146.4523582458496,44430,7870,36560,36560,0,12,6927000.0
6927,6927999,20.747367707545212,37.08764854899396,0.08697002173182922,1234.2393691539764,471.65001583099365,1146.5025367736816,44436,7872,36564,36564,0,12,6928000.0
6928,6928999,20.748211452269203,37.08919331859821,0.08697569841943631,1234.3569605350494,471.7139618396759,1146.6973991394043,44438,7872,36566,36566,0,12,6929000.0
6929,6929999,20.74884620824015,37.0899920915997,0.08697979021146296,1234.5846271514893,471.7841098308563,1146.7742958068848,44440,7873,36567,36567,0,12,6930000.0
6930,6930999,20.749377748148728,37.09024252055257,0.08698172510323665,1234.9050118923187,471.84718441963196,1146.7730331420898,44445,7875,36570,36570,0,12,6931000.0
6931,6931999,20.749806534695097,37.09030669175584,0.08697889115718804,1235.2237696647644,471.91029691696167,1146.777431488037,44459,7877,36582,36582,0,12,6932000.0
6932,6932999,20.750021469390155,37.091126615158785,0.08694777911037777,1235.4483540058136,471.9745502471924,1147.1481819152832,44472,7878,36594,36594,0,12,6933000.0
6933,6933999,20.749592026988307,37.09027710116217,0.08693988524731666,1235.7608304023743,472.0391299724579,1147.270118713379,44476,7880,36596,36596,0,12,6934000.0
6934,6934999,20.74924158740133,37.089388479159254,0.08692574637308703,1236.3806595802307,472.1041874885559,1147.2517127990723,44498,7885,36613,36613,0,12,6935000.0
6935,6935999,20.74908761232533,37.08881566143213,0.08690754488474328,1236.5895957946777,472.1689372062683,1147.445327758789,44509,7886,36623,36623,0,12,6936000.0
6936,6936999,20.74906205450398,37.08846530643655,0.08688678838500885,1236.8038756847382,472.23381638526917,1147.8036651611328,44527,7887,36640,36640,0,12,6937000.0
6937,6937999,20.74877076203208,37.087290623607736,0.08687238040168388,1237.1261503696442,472.2987411022186,1147.917911529541,44531,7889,36642,36642,0,12,6938000.0
6938,6938999,20.7485900247737,37.08629763362499,0.08686100460214397,1237.4661059379578,472.3762619495392,1148.0026512145996,44536,7891,36645,36645,0,12,6939000.0
6939,6939999,20.74863928924177,37.085837597749034,0.08684178933429254,1237.6872415542603,472.44168305397034,1148.1749382019043,44542,7892,36650,36650,0,12,6940000.0
6940,6940999,20.748568047693347,37.085131651148515,0.08682950989647875,1238.3847138881683,472.5047242641449,1148.119686126709,44569,7898,36671,36671,0,12,6941000.0
6941,6941999,20.74874227178235,37.08702011268911,0.08680527302708407,1238.7182376384735,472.57162261009216,1148.2457389831543,44611,7900,36711,36711,0,12,6942000.0
6942,6942999,20.74932513077668,37.087380977907536,0.08678437552192886,1238.8430950641632,472.63789224624634,1148.6254196166992,44616,7900,36716,36716,0,12,6943000.0
6943,6943999,20.749769211768704,37.08712398291553,0.08677240410332554,1239.271256685257,472.7017424106598,1148.675636291504,44623,7903,36720,36720,0,12,6944000.0
6944,6944999,20.750526547620012,37.08751968230157,0.0867543313127983,1239.5991780757904,472.7682595252991,1148.764804840088,44639,7905,36734,36734,0,12,6945000.0
6945,6945999,20.751485428608213,37.08813845514937,0.08673612305533085,1239.9157977104187,472.8320767879486,1148.8283386230469,44643,7907,36736,36736,0,12,6946000.0
6946,6946999,20.752161784260228,37.08827228498645,0.0867362969782034,1240.2513856887817,472.8981759548187,1148.8868141174316,44647,7909,36738,36738,0,12,6947000.0
6947,6947999,20.753022374462006,37.088706539843734,0.08673547726463116,1240.4711349010468,472.9623031616211,1149.0030479431152,44649,7910,36739,36739,0,12,6948000.0
6948,6948999,20.75422502093748,37.08938491884975,0.08671139746107559,1240.9949579238892,473.02854776382446,1149.168170928955,44660,7914,36746,36746,0,12,6949000.0
6949,6949999,20.755243080143867,37.089713107648365,0.08670251721890132,1241.1219336986542,473.09617829322815,1149.332862854004,44660,7914,36746,36746,0,12,6950000.0
6950,6950999,20.756086626786107,37.08984536241149,0.08670247276555532,1241.3406183719635,473.1610848903656,1149.4274406433105,44671,7915,36756,36756,0,12,6951000.0
6951,6951999,20.756454031161326,37.08921462770626,0.08670985924828889,1241.5600497722626,473.22447967529297,1149.4882850646973,44673,7916,36757,36757,0,12,6952000.0
6952,6952999,20.756676932675145,37.08972919610537,0.08668753766569426,1241.7784972190857,473.2893805503845,1149.7639274597168,44681,7917,36764,36764,0,12,6953000.0
6953,6953999,20.756615926548452,37.08979971799092,0.08667890067158135,1241.8956053256989,473.35332226753235,1149.959228515625,44682,7917,36765,36765,0,12,6954000.0
6954,6954999,20.756413781855194,37.08951399356008,0.08667005269187322,1242.114590883255,473.4178080558777,1150.1943244934082,44689,7918,36771,36771,0,12,6955000.0
6955,6955999,20.756351153707257,37.089401219628925,0.08666298688057683,1242.335642337799,473.4841642379761,1150.3353576660156,44695,7919,36776,36776,0,12,6956000.0
6956,6956999,20.756483401004555,37.08945463706199,0.08665291014532683,1242.5506341457367,473.54898715019226,1150.5829887390137,44702,7920,36782,36782,0,12,6957000.0
6957,6957999,20.756923707409825,37.089943204207025,0.08665538785865734,1242.8899619579315,473.61747694015503,1150.7173042297363,44715,7922,36793,36793,0,12,6958000.0
6958,6958999,20.757436765953877,37.09032675892212,0.0866446437938363,1243.101794719696,473.68230509757996,1150.8584251403809,44718,7923,36795,36795,0,12,6959000.0
6959,6959999,20.757833276007382,37.09118688004525,0.08663673906099467,1243.2177546024323,473.74826979637146,1151.0371551513672,44720,7923,36797,36797,0,12,6960000.0
6960,6960999,20.759028172759493,37.09499767628541,0.08662931320164857,1243.439846754074,473.81340289115906,1151.163417816162,44725,7924,36801,36801,0,12,6961000.0
6961,6961999,20.760163809603384,37.09656948076915,0.08662868405041213,1243.6655707359314,473.878954410553,1151.3409538269043,44732,7925,36807,36807,0,12,6962000.0
6962,6962999,20.761900797416597,37.10190445595017,0.08665152593088654,1243.88853931427,473.9440643787384,1151.512825012207,44735,7926,36809,36809,0,12,6963000.0
6963,6963999,20.76337295600609,37.10385997153774,0.08665429417544113,1244.2200140953064,474.0126976966858,1151.575496673584,44739,7928,36811,36811,0,12,6964000.0
6964,6964999,20.765023475857156,37.106819432681284,0.08667839605458527,1244.4361124038696,474.07766342163086,1151.6499290466309,44741,7929,36812,36812,0,12,6965000.0
6965,6965999,20.767121258921605,37.110666766044666,0.0867263472894233,1244.7653093338013,474.14208483695984,1151.742317199707,44745,7931,36814,36814,0,12,6966000.0
6966,6966999,20.768652065151162,37.112708108954656,0.08676592261785965,1244.8868119716644,474.20925092697144,1151.9540328979492,44747,7931,36816,36816,0,12,6967000.0
6967,6967999,20.771033112242975,37.11652774664104,0.0867872000758092,1245.2020201683044,474.2741298675537,1152.0236015319824,44751,7933,36818,36818,0,12,6968000.0
6968,6968999,20.77313280415595,37.121357324851296,0.08680949700550467,1245.6162734031677,474.3395802974701,1152.0254745483398,44762,7936,36826,36826,0,12,6969000.0
6969,6969999,20.774148062209235,37.12519330887556,0.0867898651865181,1245.7399532794952,474.4046971797943,1152.4215202331543,44772,7936,36836,36836,0,12,6970000.0
6970,6970999,20.77483780472458,37.130628236313385,0.0867685763763858,1245.8553371429443,474.4681947231293,1152.7016944885254,44776,7936,36840,36840,0,12,6971000.0
6971,6971999,20.77562679867154,37.135174208471845,0.08675211529284121,1246.1837556362152,474.53598833084106,1152.810073852539,44792,7938,36854,36854,0,12,6972000.0
6972,6972999,20.776045169309562,37.13740327542431,0.08674204482501502,1246.503122329712,474.6002027988434,1153.0927352905273,44804,7940,36864,36864,0,12,6973000.0
6973,6973999,20.776711435094107,37.14037219331098,0.08672909498135817,1246.9288725852966,474.6663863658905,1153.155101776123,44819,7943,36876,36876,0,12,6974000.0
6974,6974999,20.77747106556748,37.14354215564016,0.08670831625568598,1247.1511960029602,474.7315411567688,1153.3210639953613,44822,7944,36878,36878,0,12,6975000.0
6975,6975999,20.777956360117564,37.14534927419088,0.0866971282268536,1247.566354751587,474.7972719669342,1153.3710670471191,44830,7947,36883,36883,0,12,6976000.0
6976,6976999,20.779448006301575,37.153758475969425,0.08666974266677507,1247.7979843616486,474.86298656463623,1153.5328636169434,44834,7948,36886,36886,0,12,6977000.0
6977,6977999,20.780704824938727,37.156340455662054,0.08666118104274378,1248.0171990394592,474.92876267433167,1153.727195739746,44844,7949,36895,36895,0,12,6978000.0
6978,6978999,20.78176522968325,37.15758894351338,0.08666299294948754,1248.231651544571,474.9927725791931,1153.8693351745605,44847,7950,36897,36897,0,12,6979000.0
6979,6979999,20.783012245626164,37.159758927261436,0.0866621367114484,1248.6568701267242,475.05881118774414,1153.8969650268555,44853,7953,36900,36900,0,12,6980000.0
6980,6980999,20.784265480193746,37.1627899206817,0.08666521629838941,1249.078447818756,475.12405347824097,1153.9033126831055,44870,7956,36914,36914,0,12,6981000.0
6981,6981999,20.78565826495931,37.16450803915885,0.08667853042837625,1249.5073871612549,475.1903712749481,1153.958625793457,44876,7959,36917,36917,0,12,6982000.0
6982,6982999,20.787724414616132,37.16913074533289,0.086713060353801,1249.8390262126923,475.25747871398926,1154.054458618164,44880,7961,36919,36919,0,12,6983000.0
6983,6983999,20.78936289770608,37.17263028527585,0.08670567465539636,1249.961730003357,475.32236671447754,1154.2880363464355,44884,7961,36923,36923,0,12,6984000.0
6984,6984999,20.791046361381646,37.1760562104415,0.08671580927119027,1250.0675973892212,475.3853178024292,1154.4486503601074,44884,7961,36923,36923,0,12,6985000.0
6985,6985999,20.792549032626333,37.177706766832785,0.08673252893331274,1250.3871133327484,475.4491364955902,1154.520004272461,44895,7963,36932,36932,0,12,6986000.0
6986,6986999,20.79367471756856,37.178440105545725,0.08674899482381127,1250.9194691181183,475.51444697380066,1154.4525184631348,44903,7967,36936,36936,0,12,6987000.0
6987,6987999,20.79380499972315,37.17898774182341,0.08674294986527054,1251.3545649051666,475.58030796051025,1154.524356842041,44928,7970,36958,36958,0,12,6988000.0
6988,6988999,20.79319035947925,37.17840617600397,0.08673260125358451,1251.5946879386902,475.6463580131531,1154.6792678833008,44942,7971,36971,36971,0,12,6989000.0
6989,6989999,20.792701496476013,37.17799262373861,0.08672192796575162,1251.9279458522797,475.7115616798401,1154.7463188171387,44964,7973,36991,36991,0,12,6990000.0
6990,6990999,20.792266827706978,37.17706132241407,0.08671375466210007,1252.148696422577,475.7750298976898,1154.8924407958984,44968,7974,36994,36994,0,12,6991000.0
6991,6991999,20.792036922167064,37.176418519577794,0.08670016165236194,1252.2831172943115,475.84077978134155,1155.1557273864746,44977,7974,37003,37003,0,12,6992000.0
6992,6992999,20.79188507546092,37.17580356298285,0.08668869150335723,1252.4251248836517,475.915655374527,1155.3973922729492,44978,7974,37004,37004,0,12,6993000.0
6993,6993999,20.791536057625105,37.17462185820774,0.08668454565374806,1252.743153333664,475.98019647598267,1155.4894218444824,44983,7976,37007,37007,0,12,6994000.0
6994,6994999,20.79158878840284,37.17427291412359,0.08667558520162166,1252.861979007721,476.04389095306396,1155.646369934082,44983,7976,37007,37007,0,12,6995000.0
6995,6995999,20.791645151284655,37.17439515624791,0.08666841670782666,1252.976279258728,476.1092441082001,1155.737678527832,44983,7976,37007,37007,0,12,6996000.0
6996,6996999,20.791782061472954,37.17421149688824,0.08666524571967138,1253.3147423267365,476.17665815353394,1155.7548866271973,44989,7978,37011,37011,0,12,6997000.0
6997,6997999,20.7922201916346,37.17433377378221,0.086653995941955,1253.6458621025085,476.241574048996,1155.9404296875,45008,7980,37028,37028,0,12,6998000.0
6998,6998999,20.792452765953705,37.174144130226985,0.08664746482810426,1253.8794412612915,476.30449318885803,1156.000259399414,45020,7981,37039,37039,0,12,6999000.0
6999,6999999,20.792982118860454,37.174703151616384,0.08664119041219975,1254.203198671341,476.36955428123474,1156.0215911865234,45025,7983,37042,37042,0,12,7000000.0
7000,7000999,20.793318883971615,37.174705200810635,0.08663214237387973,1254.7331709861755,476.4348566532135,1155.9908981323242,45043,7987,37056,37056,0,12,7001000.0
7001,7001999,20.793699171536822,37.17466972355329,0.08662536377154118,1254.9629483222961,476.4990758895874,1156.0839538574219,45045,7988,37057,37057,0,12,7002000.0
7002,7002999,20.794252821658542,37.17513855522558,0.08661908515823213,1255.1968832015991,476.5633382797241,1156.1552047729492,45047,7989,37058,37058,0,12,7003000.0
7003,7003999,20.79438703624013,37.174936327907986,0.08660663121500656,1255.421549797058,476.6255123615265,1156.2998886108398,45051,7990,37061,37061,0,12,7004000.0
7004,7004999,20.794840276513373,37.17496540049179,0.0865987641868654,1255.5525238513947,476.7001507282257,1156.3930778503418,45051,7990,37061,37061,0,12,7005000.0
7005,7005999,20.794871801233686,37.17416259474343,0.08659755123013368,1255.9847507476807,476.76401448249817,1156.263385772705,45057,7993,37064,37064,0,12,7006000.0
7006,7006999,20.794536184626825,37.173067224452005,0.08659579234834858,1256.4251646995544,476.8285095691681,1156.2045059204102,45065,7996,37069,37069,0,12,7007000.0
7007,7007999,20.79400214989471,37.17175827212357,0.0865891949440677,1256.5446047782898,476.89156222343445,1156.5463027954102,45072,7996,37076,37076,0,12,7008000.0
7008,7008999,20.793119480210823,37.170404828644934,0.08658251955959118,1256.6584787368774,476.95526146888733,1156.7228202819824,45073,7996,37077,37077,0,12,7009000.0
7009,7009999,20.7920863553033,37.16880095185294,0.08657851743036515,1256.9694533348083,477.02067708969116,1156.787021636963,45077,7998,37079,37079,0,12,7010000.0
7010,7010999,20.791256089827623,37.167711974512734,0.08657438779906412,1257.2886934280396,477.084433555603,1156.9304466247559,45083,8000,37083,37083,0,12,7011000.0
7011,7011999,20.79058769398671,37.16694559239202,0.08656651381379232,1257.6233847141266,477.1487431526184,1157.0608711242676,45092,8002,37090,37090,0,12,7012000.0
7012,7012999,20.79011273677716,37.16617324397099,0.08655874905599548,1257.9620792865753,477.2143669128418,1157.3832931518555,45110,8004,37106,37106,0,12,7013000.0
7013,7013999,20.78952387986823,37.16570235808017,0.0865536010991712,1258.2729551792145,477.279718875885,1157.5276985168457,45114,8006,37108,37108,0,12,7014000.0
7014,7014999,20.789065129727668,37.164733828444945,0.08654900676468269,1258.699224948883,477.3443133831024,1157.572280883789,45120,8009,37111,37111,0,12,7015000.0
7015,7015999,20.788498477989894,37.163661055252,0.08654609575283168,1258.9351270198822,477.41410636901855,1157.6996231079102,45123,8010,37113,37113,0,12,7016000.0
7016,7016999,20.78821940786235,37.16315711149127,0.0865405673558034,1259.068454504013,477.4819588661194,1157.8284530639648,45123,8010,37113,37113,0,12,7017000.0
7017,7017999,20.78804796475482,37.16256958845159,0.08652893631150893,1259.2897214889526,477.5471782684326,1157.9822082519531,45127,8011,37116,37116,0,12,7018000.0
7018,7018999,20.787903938628038,37.16231590859815,0.08651371033832578,1259.515507221222,477.61537432670593,1158.099941253662,45130,8012,37118,37118,0,12,7019000.0
7019,7019999,20.787603387414823,37.16180054877058,0.08649775377560676,1259.9432418346405,477.67924880981445,1158.1067199707031,45137,8015,37122,37122,0,12,7020000.0
7020,7020999,20.787582337734104,37.161514619947376,0.08648708820331341,1260.381840467453,477.743923664093,1158.1093788146973,45143,8018,37125,37125,0,12,7021000.0
7021,7021999,20.787606024122223,37.16262839975617,0.08646823137508353,1260.712875843048,477.80710315704346,1158.1171417236328,45148,8020,37128,37128,0,12,7022000.0
7022,7022999,20.787390883934957,37.16183282542919,0.08646221352440941,1260.8215925693512,477.86901450157166,1158.27978515625,45148,8020,37128,37128,0,12,7023000.0
7023,7023999,20.787224745786617,37.160867763090565,0.08645375763666885,1261.0443086624146,477.93099761009216,1158.399429321289,45150,8021,37129,37129,0,12,7024000.0
7024,7024999,20.787204713801458,37.16030699518707,0.0864466388966959,1261.250461101532,477.9931995868683,1158.4728965759277,45152,8022,37130,37130,0,12,7025000.0
7025,7025999,20.78710713941146,37.15948892379831,0.08643954576705604,1261.477908372879,478.0589179992676,1158.5304908752441,45154,8023,37131,37131,0,12,7026000.0
7026,7026999,20.787048501400005,37.15874514033823,0.08643142705370177,1261.5999233722687,478.12334847450256,1158.615135192871,45154,8023,37131,37131,0,12,7027000.0
7027,7027999,20.78699556963867,37.159401402723546,0.08641647807606034,1262.0339374542236,478.18934655189514,1158.5968742370605,45162,8026,37136,37136,0,12,7028000.0
7028,7028999,20.786055259379985,37.158625962447736,0.08640929463411162,1262.1533234119415,478.25292801856995,1159.027057647705,45174,8026,37148,37148,0,12,7029000.0
7029,7029999,20.78503636263229,37.15742779865453,0.08640405086134362,1262.378001689911,478.31883001327515,1159.1523208618164,45177,8027,37150,37150,0,12,7030000.0
7030,7030999,20.784255487651556,37.15821143268517,0.08638808084665772,1262.8145582675934,478.3849947452545,1159.2850151062012,45194,8030,37164,37164,0,12,7031000.0
7031,7031999,20.783404601636153,37.15669428976588,0.0863823595245704,1263.143704175949,478.44956159591675,1159.373966217041,45208,8032,37176,37176,0,12,7032000.0
7032,7032999,20.782758010132095,37.15555883586429,0.08637237983074775,1263.2631933689117,478.5143415927887,1159.800449371338,45217,8032,37185,37185,0,12,7033000.0
7033,7033999,20.782152123020097,37.15470325817229,0.08636426611107895,1263.6848855018616,478.5793044567108,1159.8738098144531,45223,8035,37188,37188,0,12,7034000.0
7034,7034999,20.781521640767455,37.15358952034284,0.08635717014837696,1263.7979729175568,478.6426947116852,1160.0723876953125,45223,8035,37188,37188,0,12,7035000.0
7035,7035999,20.78086734571865,37.15226814122069,0.08635003746215542,1264.1199622154236,478.7065236568451,1160.1063041687012,45227,8037,37190,37190,0,12,7036000.0
7036,7036999,20.780466688222088,37.15152242248468,0.08634077316740818,1264.2291014194489,478.770934343338,1160.2760276794434,45227,8037,37190,37190,0,12,7037000.0
7037,7037999,20.779790128662995,37.15004347253136,0.08633538556994491,1264.3536970615387,478.83537554740906,1160.435619354248,45230,8037,37193,37193,0,12,7038000.0
7038,7038999,20.779288778921213,37.14904476533425,0.08632710490325168,1264.4817306995392,478.90074944496155,1160.675220489502,45234,8037,37197,37197,0,12,7039000.0
7039,7039999,20.778936719371806,37.148220703369816,0.08631786163994304,1264.8959202766418,478.96435737609863,1160.7136497497559,45250,8040,37210,37210,0,12,7040000.0
7040,7040999,20.778614802312614,37.147233715270154,0.08630689229391131,1265.134483575821,479.03554916381836,1160.8020248413086,45253,8041,37212,37212,0,12,7041000.0
7041,7041999,20.778409297520138,37.14788424602897,0.08629196802410988,1265.5685031414032,479.10237193107605,1160.8401412963867,45259,8044,37215,37215,0,12,7042000.0
7042,7042999,20.77833428146194,37.14747692607691,0.08627830941808268,1265.781892299652,479.1666793823242,1160.9492874145508,45261,8045,37216,37216,0,12,7043000.0
7043,7043999,20.77840075359251,37.14722564098579,0.08626797481350557,1266.0139937400818,479.23012804985046,1160.9919815063477,45264,8046,37218,37218,0,12,7044000.0
7044,7044999,20.778242431108985,37.14628224180351,0.0862580631502694,1266.242291688919,479.2944016456604,1161.082878112793,45267,8047,37220,37220,0,12,7045000.0
7045,7045999,20.778566330027626,37.146010247862655,0.08624528507369866,1266.3683454990387,479.3609552383423,1161.237018585205,45268,8047,37221,37221,0,12,7046000.0
7046,7046999,20.778771234142145,37.14551039640393,0.08623405125177397,1266.6853833198547,479.42530846595764,1161.2674674987793,45272,8049,37223,37223,0,12,7047000.0
7047,7047999,20.778947632514278,37.14488387565409,0.08622498543860369,1267.1241726875305,479.4899709224701,1161.2714729309082,45278,8052,37226,37226,0,12,7048000.0
7048,7048999,20.778754585043522,37.144108507563146,0.08621667733351335,1267.3401606082916,479.5548679828644,1161.494400024414,45286,8053,37233,37233,0,12,7049000.0
7049,7049999,20.778195703720662,37.14384801044157,0.08620907276774004,1267.864886045456,479.6207535266876,1161.5362968444824,45307,8057,37250,37250,0,12,7050000.0
7050,7050999,20.777475417804474,37.142939291798776,0.0862054905218066,1268.080439567566,479.6849796772003,1161.6961135864258,45309,8058,37251,37251,0,12,7051000.0
7051,7051999,20.776900458761737,37.14229387252803,0.0861962269094999,1268.5183763504028,479.75029277801514,1161.7914848327637,45333,8061,37272,37272,0,12,7052000.0
7052,7052999,20.77644065057165,37.142027453331146,0.08618478012536435,1268.7393028736115,479.81507444381714,1161.882999420166,45343,8062,37281,37281,0,12,7053000.0
7053,7053999,20.77641992976102,37.14271660631326,0.08616050858607982,1268.9666078090668,479.88031339645386,1162.129280090332,45349,8063,37286,37286,0,12,7054000.0
7054,7054999,20.77620265468312,37.14205474328333,0.0861439813178404,1269.2839140892029,479.944536447525,1162.2113342285156,45354,8065,37289,37289,0,12,7055000.0
7055,7055999,20.776320795014875,37.14314174945149,0.08612676852716983,1269.5064888000488,480.00927925109863,1162.2927703857422,45356,8066,37290,37290,0,12,7056000.0
7056,7056999,20.776067939608733,37.14251360757903,0.08613496611028104,1269.632092475891,480.0743420124054,1162.4205474853516,45357,8066,37291,37291,0,12,7057000.0
7057,7057999,20.77608867643745,37.14242765987292,0.08612482925169229,1269.751299381256,480.1377115249634,1162.5097274780273,45357,8066,37291,37291,0,12,7058000.0
7058,7058999,20.77604935830555,37.142031946096694,0.08611481950045186,1270.1852588653564,480.203351020813,1162.543342590332,45377,8069,37308,37308,0,12,7059000.0
7059,7059999,20.776577012008175,37.14374506598801,0.08609756246260769,1270.531084537506,480.26829195022583,1162.6510581970215,45391,8071,37320,37320,0,12,7060000.0
7060,7060999,20.77705646667637,37.144099141468196,0.0860873171818336,1270.9447178840637,480.3337264060974,1162.7147750854492,45407,8074,37333,37333,0,12,7061000.0
7061,7061999,20.777654819943614,37.145530381435904,0.08608034851156998,1271.1753568649292,480.39958357810974,1162.7584991455078,45419,8075,37344,37344,0,12,7062000.0
7062,7062999,20.778358822380053,37.1465305911536,0.08608068776862532,1271.602157831192,480.4637277126312,1162.768268585205,45425,8078,37347,37347,0,12,7063000.0
7063,7063999,20.77973773777625,37.14924895073654,0.08607960110847757,1272.033988237381,480.52920508384705,1162.7600708007812,45439,8081,37358,37358,0,12,7064000.0
7064,7064999,20.780701754832688,37.151138640975766,0.08607956216132195,1272.3674235343933,480.5943808555603,1162.7740898132324,45443,8083,37360,37360,0,12,7065000.0
7065,7065999,20.782050146186943,37.15410327996272,0.08606563460820016,1272.5845274925232,480.6566994190216,1162.9949798583984,45447,8084,37363,37363,0,12,7066000.0
7066,7066999,20.78340257786903,37.1568383214306,0.08606217383695502,1273.24715924263,480.7222661972046,1162.8970832824707,45461,8089,37372,37372,0,12,7067000.0
7067,7067999,20.78504528194539,37.16106135990569,0.08606722869706351,1273.3710722923279,480.7872476577759,1163.0987129211426,45461,8089,37372,37372,0,12,7068000.0
7068,7068999,20.786473263757223,37.16311677009056,0.08608586159148834,1273.693753004074,480.85183548927307,1163.1683540344238,45472,8091,37381,37381,0,12,7069000.0
7069,7069999,20.786699012554838,37.16300684927962,0.08607470005481543,1274.2249999046326,480.91580080986023,1163.3336639404297,45493,8095,37398,37398,0,12,7070000.0
7070,7070999,20.786396641829402,37.16318364529165,0.0860582889117466,1274.333368062973,480.9786949157715,1163.5014419555664,45494,8095,37399,37399,0,12,7071000.0
7071,7071999,20.786072677248868,37.162856053363974,0.08605098771676656,1274.5528886318207,481.0429456233978,1163.6135482788086,45497,8096,37401,37401,0,12,7072000.0
7072,7072999,20.786112718825805,37.1640456611322,0.08603203102598811,1274.7716364860535,481.10722851753235,1163.6945915222168,45500,8097,37403,37403,0,12,7073000.0
7073,7073999,20.786557153675602,37.16614296136252,0.08600691379658987,1274.9975984096527,481.1716642379761,1163.7809600830078,45503,8098,37405,37405,0,12,7074000.0
7074,7074999,20.78666679303187,37.166102184086085,0.08599244335381573,1275.1115789413452,481.2353959083557,1164.154312133789,45509,8098,37411,37411,0,12,7075000.0
7075,7075999,20.787689883953995,37.16843951017346,0.08598604085736428,1275.5556585788727,481.3028223514557,1164.2057037353516,45525,8101,37424,37424,0,12,7076000.0
7076,7076999,20.788650585117253,37.17045822997166,0.08597917207432759,1275.9784109592438,481.3681426048279,1164.26566696167,45534,8104,37430,37430,0,12,7077000.0
7077,7077999,20.789297545064382,37.17109953317134,0.08598391977453301,1276.0892119407654,481.43173122406006,1164.4681816101074,45535,8104,37431,37431,0,12,7078000.0
7078,7078999,20.79039769162877,37.17249031354182,0.08598630919989436,1276.3290038108826,481.49717903137207,1164.5957870483398,45538,8105,37433,37433,0,12,7079000.0
7079,7079999,20.79215312579055,37.17577016225978,0.08600632766019678,1276.7562391757965,481.561936378479,1164.7196502685547,45550,8108,37442,37442,0,12,7080000.0
7080,7080999,20.794083020841867,37.178891833746356,0.08600761773730137,1277.079752922058,481.62654161453247,1164.813777923584,45554,8110,37444,37444,0,12,7081000.0
7081,7081999,20.79584345326522,37.182248903460604,0.08602338753846195,1277.1946668624878,481.6905167102814,1164.95414352417,45554,8110,37444,37444,0,12,7082000.0
7082,7082999,20.797897701807152,37.18531313783707,0.08603878782249896,1277.6280493736267,481.75533652305603,1164.9875030517578,45570,8113,37457,37457,0,12,7083000.0
7083,7083999,20.800055612859598,37.189193819410555,0.08607819224035207,1277.8540420532227,481.8212604522705,1165.0760765075684,45572,8114,37458,37458,0,12,7084000.0
7084,7084999,20.802536658389066,37.19286894410802,0.08614910775003504,1278.3872935771942,481.88611817359924,1165.0977401733398,45590,8118,37472,37472,0,12,7085000.0
7085,7085999,20.804958961400576,37.19634337499822,0.0861672121487943,1279.021024465561,481.950923204422,1165.1619758605957,45615,8123,37492,37492,0,12,7086000.0
7086,7086999,20.8078056437597,37.20131436505305,0.08620433443586029,1279.1367318630219,482.0165071487427,1165.3323020935059,45615,8123,37492,37492,0,12,7087000.0
7087,7087999,20.81043819115075,37.20570690135996,0.08625555317169198,1279.3592977523804,482.08260846138,1165.3905487060547,45617,8124,37493,37493,0,12,7088000.0
7088,7088999,20.81274024153412,37.20936328003363,0.08631869195468223,1279.7907650470734,482.1464431285858,1165.3532485961914,45633,8127,37506,37506,0,12,7089000.0
7089,7089999,20.814720082711766,37.21401753386233,0.08634038972278935,1280.2150325775146,482.2106981277466,1165.3788757324219,45639,8130,37509,37509,0,12,7090000.0
7090,7090999,20.814236792865618,37.21411860396615,0.08632521367477808,1280.6581101417542,482.2756841182709,1165.706886291504,45668,8133,37535,37535,0,12,7091000.0
7091,7091999,20.814249554455586,37.21550494073562,0.0863019050659416,1281.0078573226929,482.34166622161865,1165.8650856018066,45674,8135,37539,37539,0,12,7092000.0
7092,7092999,20.81431425495002,37.21815335375424,0.08628746848278801,1281.2313845157623,482.40719079971313,1166.0209617614746,45677,8136,37541,37541,0,12,7093000.0
7093,7093999,20.81447124555977,37.21847710463301,0.08626874027785403,1281.3597309589386,482.47409439086914,1166.2984008789062,45679,8136,37543,37543,0,12,7094000.0
7094,7094999,20.814824790584026,37.21891561993381,0.08625260172275084,1281.8047587871552,482.5405924320221,1166.475917816162,45717,8139,37578,37578,0,12,7095000.0
7095,7095999,20.815309976098508,37.21956613893356,0.08623940237756045,1282.022582769394,482.6051061153412,1166.6115379333496,45719,8140,37579,37579,0,12,7096000.0
7096,7096999,20.816123778080435,37.221156230984924,0.08622453773815886,1282.2352147102356,482.6691219806671,1166.7311248779297,45721,8141,37580,37580,0,12,7097000.0
7097,7097999,20.817112939283078,37.22235166685939,0.08621644397672168,1282.661205291748,482.73607325553894,1166.7965278625488,45735,8144,37591,37591,0,12,7098000.0
7098,7098999,20.81840333567866,37.22496689853484,0.08621385847319973,1282.890724182129,482.80112957954407,1166.9042739868164,45737,8145,37592,37592,0,12,7099000.0
7099,7099999,20.821298314261085,37.23417962696848,0.08618243574776097,1283.2300975322723,482.86629605293274,1167.0429229736328,45747,8147,37600,37600,0,12,7100000.0
7100,7100999,20.82373510251049,37.238725254039785,0.08620706852919713,1283.553014755249,482.9311263561249,1167.1274299621582,45751,8149,37602,37602,0,12,7101000.0
7101,7101999,20.82580787084986,37.24272590404064,0.08623482704216034,1283.8923115730286,482.9967505931854,1167.1948547363281,45765,8151,37614,37614,0,12,7102000.0
7102,7102999,20.828739844063197,37.24960990025129,0.08626860561365757,1284.3133630752563,483.06114172935486,1167.2072715759277,45776,8154,37622,37622,0,12,7103000.0
7103,7103999,20.831488437050037,37.25644774784874,0.08630762823584648,1284.6365633010864,483.1262023448944,1167.2756576538086,45789,8156,37633,37633,0,12,7104000.0
7104,7104999,20.834331850934966,37.26412821727474,0.08633849906676871,1285.3735508918762,483.1928176879883,1167.2207489013672,45828,8162,37666,37666,0,12,7105000.0
7105,7105999,20.83707879842612,37.2689967486591,0.08637381177353043,1285.807270526886,483.2582004070282,1167.3024101257324,45837,8165,37672,37672,0,12,7106000.0
7106,7106999,20.839499349309182,37.272969320996644,0.08642262239087684,1286.1255812644958,483.3235762119293,1167.3628845214844,45849,8167,37682,37682,0,12,7107000.0
7107,7107999,20.841101186096463,37.27567850022342,0.08646324232624103,1286.3599972724915,483.39156222343445,1167.4673080444336,45861,8168,37693,37693,0,12,7108000.0
7108,7108999,20.841697545519953,37.27926618526377,0.08642079106749578,1286.677486896515,483.4547564983368,1167.8109283447266,45884,8170,37714,37714,0,12,7109000.0
7109,7109999,20.84202695611847,37.28493937074728,0.08638794216881873,1286.9133820533752,483.52257537841797,1168.002613067627,45898,8171,37727,37727,0,12,7110000.0
7110,7110999,20.842359432472723,37.28586656337814,0.08637138878243622,1287.1333725452423,483.58740186691284,1168.1328430175781,45902,8172,37730,37730,0,12,7111000.0
7111,7111999,20.842801131775435,37.28772895265963,0.08634970162218358,1287.4633831977844,483.652295589447,1168.186752319336,45907,8174,37733,37733,0,12,7112000.0
7112,7112999,20.84350078300404,37.289342538587746,0.08635408946808021,1288.00767660141,483.71780276298523,1168.300968170166,45919,8178,37741,37741,0,12,7113000.0
7113,7113999,20.844633906546985,37.291443137487384,0.08636560710680208,1288.3445291519165,483.7833182811737,1168.4704895019531,45923,8180,37743,37743,0,12,7114000.0
7114,7114999,20.845995491863295,37.29480831446275,0.08641050602548483,1288.6741037368774,483.84883213043213,1168.5913925170898,45931,8182,37749,37749,0,12,7115000.0
7115,7115999,20.84753289151104,37.298270180288554,0.08645423416264852,1289.3161883354187,483.9165577888489,1168.5969123840332,45951,8187,37764,37764,0,12,7116000.0
7116,7116999,20.849649287006617,37.307094915616524,0.0864849002139525,1289.5292134284973,483.98082089424133,1168.7351150512695,45955,8188,37767,37767,0,12,7117000.0
7117,7117999,20.85260720074364,37.317056952648734,0.0865055395873845,1289.7555661201477,484.04519295692444,1168.9105110168457,45960,8189,37771,37771,0,12,7118000.0
7118,7118999,20.85579719268425,37.325321265733294,0.08660628090730449,1289.9751687049866,484.109174489975,1168.9896354675293,45962,8190,37772,37772,0,12,7119000.0
7119,7119999,20.858847653130198,37.3327934673722,0.08667860376160708,1290.4083256721497,484.1734857559204,1168.9780921936035,45968,8193,37775,37775,0,12,7120000.0
7120,7120999,20.86174142046237,37.34170934208525,0.08675177415188295,1290.8415656089783,484.23875641822815,1168.9648704528809,45975,8196,37779,37779,0,12,7121000.0
7121,7121999,20.86542662827832,37.3518770152678,0.0868563090081017,1291.2731709480286,484.30424213409424,1168.9540557861328,45981,8199,37782,37782,0,12,7122000.0
7122,7122999,20.869637358295268,37.364241639125176,0.08703261189647693,1291.59809923172,484.3683354854584,1169.0671882629395,45986,8201,37785,37785,0,12,7123000.0
7123,7123999,20.873243258317824,37.37442674751554,0.08712830094474255,1291.828414440155,484.4334704875946,1169.2851829528809,45991,8202,37789,37789,0,12,7124000.0
7124,7124999,20.87761957993573,37.38491445234586,0.08722243091942439,1292.0487339496613,484.49732971191406,1169.361083984375,45999,8203,37796,37796,0,12,7125000.0
7125,7125999,20.881259561918863,37.39384015390222,0.08735146128176474,1292.6042284965515,484.5629334449768,1169.3167419433594,46017,8207,37810,37810,0,12,7126000.0
7126,7126999,20.884533552395112,37.40015654889984,0.08752246252075835,1292.9400534629822,484.638290643692,1169.376693725586,46021,8209,37812,37812,0,12,7127000.0
7127,7127999,20.885971400232975,37.40354539368552,0.08751395418829067,1293.0707485675812,484.7053027153015,1169.7981605529785,46032,8209,37823,37823,0,12,7128000.0
7128,7128999,20.88613981021726,37.40488549528398,0.08749550908145631,1293.1840925216675,484.76846408843994,1170.0074081420898,46034,8209,37825,37825,0,12,7129000.0
7129,7129999,20.886420179937414,37.407356517467925,0.08748282666012908,1293.3213531970978,484.84310245513916,1170.1881561279297,46035,8209,37826,37826,0,12,7130000.0
7130,7130999,20.886387650601407,37.407924625798714,0.08747477856609243,1293.4514336585999,484.9080731868744,1170.2945098876953,46036,8209,37827,37827,0,12,7131000.0
7131,7131999,20.886601325992743,37.408763614227944,0.08745357883012772,1293.571212530136,484.9720859527588,1170.5901222229004,46042,8209,37833,37833,0,12,7132000.0
7132,7132999,20.88681428125935,37.40934223700123,0.08744067903378117,1293.8057594299316,485.0354676246643,1170.6982116699219,46052,8210,37842,37842,0,12,7133000.0
7133,7133999,20.886720041396533,37.40970761939025,0.08743015718489777,1294.1392691135406,485.09886264801025,1170.7627449035645,46058,8212,37846,37846,0,12,7134000.0
7134,7134999,20.88679812790724,37.410599942486726,0.08742128669643756,1294.249255180359,485.16284465789795,1170.9044494628906,46058,8212,37846,37846,0,12,7135000.0
7135,7135999,20.886823548655975,37.4105999637142,0.08741615241314293,1294.7007479667664,485.23407673835754,1170.8543434143066,46074,8215,37859,37859,0,12,7136000.0
7136,7136999,20.88695907467631,37.41080991867565,0.08740700130398638,1294.9258432388306,485.2985465526581,1171.09716796875,46081,8216,37865,37865,0,12,7137000.0
7137,7137999,20.887073953329192,37.41072344028798,0.08740110800577261,1295.3818066120148,485.36940932273865,1171.0627517700195,46087,8219,37868,37868,0,12,7138000.0
7138,7138999,20.887119229757126,37.41026274518996,0.0874032160569127,1295.6065595149994,485.4322519302368,1171.1607627868652,46090,8220,37870,37870,0,12,7139000.0
7139,7139999,20.887252823860855,37.4097988047079,0.08739622828331606,1295.8343904018402,485.4967453479767,1171.2258605957031,46092,8221,37871,37871,0,12,7140000.0
7140,7140999,20.887583672724066,37.40956010809282,0.08740486357774024,1296.1631295681,485.5621078014374,1171.2396659851074,46104,8223,37881,37881,0,12,7141000.0
7141,7141999,20.887810317142417,37.41013361073532,0.08739340683045105,1296.511193037033,485.627477645874,1171.4147033691406,46110,8225,37885,37885,0,12,7142000.0
7142,7142999,20.887899517726563,37.409335170374824,0.08739011159271914,1296.6295206546783,485.6951115131378,1171.5578155517578,46110,8225,37885,37885,0,12,7143000.0
7143,7143999,20.88785697701063,37.40816046790278,0.08738609189893054,1296.750824213028,485.7567925453186,1171.6599731445312,46110,8225,37885,37885,0,12,7144000.0
7144,7144999,20.88748574998402,37.40702393081793,0.08737781587946081,1297.0809206962585,485.8218882083893,1172.0077476501465,46133,8227,37906,37906,0,12,7145000.0
7145,7145999,20.887170293355656,37.40683617944119,0.08736853311671133,1297.407681941986,485.88685488700867,1172.1155014038086,46150,8229,37921,37921,0,12,7146000.0
7146,7146999,20.8868986234143,37.40694307352444,0.08736884998104233,1297.6201045513153,485.9486882686615,1172.3133964538574,46155,8230,37925,37925,0,12,7147000.0
7147,7147999,20.88645520486939,37.40561187544268,0.08736387491107589,1297.8453571796417,486.01511001586914,1172.5571060180664,46159,8231,37928,37928,0,12,7148000.0
7148,7148999,20.88641082995971,37.40622110414962,0.08735959915249314,1298.071702003479,486.07879161834717,1172.6889762878418,46162,8232,37930,37930,0,12,7149000.0
7149,7149999,20.886637754515426,37.40676402257381,0.08735427756550951,1298.3951721191406,486.14252829551697,1172.7899856567383,46168,8234,37934,37934,0,12,7150000.0
7150,7150999,20.88663229193798,37.40671933468327,0.08734867077818764,1298.5111536979675,486.2071783542633,1172.9302787780762,46168,8234,37934,37934,0,12,7151000.0
7151,7151999,20.886738188800372,37.407150198802476,0.08734372192259188,1298.8481614589691,486.2738878726959,1172.9671325683594,46173,8236,37937,37937,0,12,7152000.0
7152,7152999,20.88737903549639,37.407387215351946,0.087341710652729,1299.0655982494354,486.33850026130676,1173.2351036071777,46180,8237,37943,37943,0,12,7153000.0
7153,7153999,20.888501092957995,37.41065477172455,0.08733307731465922,1299.5062940120697,486.40254306793213,1173.2772407531738,46188,8240,37948,37948,0,12,7154000.0
7154,7154999,20.88934360191777,37.411563183979816,0.08734557269413601,1299.6141693592072,486.4659426212311,1173.4568634033203,46189,8240,37949,37949,0,12,7155000.0
7155,7155999,20.890037388867963,37.41201417014772,0.08734667923397166,1299.9408898353577,486.5293312072754,1173.5173835754395,46202,8242,37960,37960,0,12,7156000.0
7156,7156999,20.890630915924543,37.412087042470844,0.08735738434279239,1300.3677248954773,486.5938048362732,1173.5859146118164,46213,8245,37968,37968,0,12,7157000.0
7157,7157999,20.891618872701116,37.41273985062411,0.0873343534267571,1300.6974329948425,486.6600396633148,1173.746883392334,46221,8247,37974,37974,0,12,7158000.0
7158,7158999,20.892792683840828,37.415732226434535,0.08733827083686008,1300.9194655418396,486.7239167690277,1173.8648681640625,46225,8248,37977,37977,0,12,7159000.0
7159,7159999,20.89315491558851,37.41527793367863,0.08735243008671711,1301.2555799484253,486.79129123687744,1173.8806114196777,46229,8250,37979,37979,0,12,7160000.0
7160,7160999,20.893260444100346,37.414673232114176,0.08737280096957378,1301.4721648693085,486.8536899089813,1174.0644264221191,46236,8251,37985,37985,0,12,7161000.0
7161,7161999,20.894013032184716,37.424425793269364,0.08733713928180897,1301.6914525032043,486.91797614097595,1174.4758110046387,46248,8252,37996,37996,0,12,7162000.0
7162,7162999,20.893892173521117,37.428600676884656,0.08731050664759321,1301.8128442764282,486.98175263404846,1174.6908683776855,46248,8252,37996,37996,0,12,7163000.0
7163,7163999,20.89351445139395,37.428330329132564,0.08730776894146974,1302.1402926445007,487.04633498191833,1174.8189430236816,46257,8254,38003,38003,0,12,7164000.0
7164,7164999,20.89347025839766,37.429426926247615,0.0873005953001994,1302.463764667511,487.1098909378052,1174.871982574463,46270,8256,38014,38014,0,12,7165000.0
7165,7165999,20.893859144805308,37.43028424139732,0.08729232466115,1302.5886464118958,487.1743769645691,1175.2340774536133,46276,8256,38020,38020,0,12,7166000.0
7166,7166999,20.89414615369108,37.43064202611803,0.08728509837813148,1303.037353515625,487.2395861148834,1175.336311340332,46282,8259,38023,38023,0,12,7167000.0
7167,7167999,20.89448310937947,37.431172257315566,0.08728507346963577,1303.5761904716492,487.3034145832062,1175.3560218811035,46307,8263,38044,38044,0,12,7168000.0
7168,7168999,20.894888017960955,37.431563855657714,0.08728069971335062,1303.8014497756958,487.3672652244568,1175.5245780944824,46311,8264,38047,38047,0,12,7169000.0
7169,7169999,20.895507538058443,37.43198110804654,0.0872786664493228,1303.9127552509308,487.43244314193726,1175.7131652832031,46312,8264,38048,38048,0,12,7170000.0
7170,7170999,20.896427129329464,37.43540016911678,0.08727424643986503,1304.1564545631409,487.49716329574585,1175.8186378479004,46314,8265,38049,38049,0,12,7171000.0
7171,7171999,20.897278859335216,37.43691956866408,0.08726909509838898,1304.4779388904572,487.5604336261749,1176.0598793029785,46340,8267,38073,38073,0,12,7172000.0
7172,7172999,20.898135261562036,37.43770226359666,0.08726298148447131,1304.6986191272736,487.6249258518219,1176.197063446045,46342,8268,38074,38074,0,12,7173000.0
7173,7173999,20.89918281776237,37.43892858711127,0.0872714660955286,1305.25030875206,487.6908049583435,1176.17622756958,46360,8272,38088,38088,0,12,7174000.0
7174,7174999,20.900339414005327,37.44187993719688,0.08727158584119543,1305.3746223449707,487.7668511867523,1176.337802886963,46360,8272,38088,38088,0,12,7175000.0
7175,7175999,20.901592269169797,37.44324160563778,0.08728626636037984,1305.707900762558,487.8320310115814,1176.3772277832031,46374,8274,38100,38100,0,12,7176000.0
7176,7176999,20.902589974118126,37.44382808844793,0.08728366005090615,1306.0891678333282,487.90130734443665,1176.44828414917,46387,8276,38111,38111,0,12,7177000.0
7177,7177999,20.90364016041935,37.445125524381204,0.08727652522557883,1306.3064665794373,487.9649803638458,1176.576976776123,46389,8277,38112,38112,0,12,7178000.0
7178,7178999,20.904596290300443,37.445898296778985,0.08728386496946883,1306.6418478488922,488.02834939956665,1176.5958824157715,46403,8279,38124,38124,0,12,7179000.0
7179,7179999,20.90532220623773,37.446048211111595,0.08728479962754954,1306.9746029376984,488.0918478965759,1176.646224975586,46407,8281,38126,38126,0,12,7180000.0
7180,7180999,20.906363831653287,37.44750307583265,0.08729415708357757,1307.402364730835,488.15524888038635,1176.6477355957031,46415,8284,38131,38131,0,12,7181000.0
7181,7181999,20.906448094713408,37.448050773366745,0.08728942816336505,1307.6346263885498,488.22222781181335,1176.9860343933105,46429,8285,38144,38144,0,12,7182000.0
7182,7182999,20.906117130236822,37.447977149696925,0.08727214599619759,1307.9674673080444,488.28666281700134,1177.1534004211426,46434,8287,38147,38147,0,12,7183000.0
7183,7183999,20.9058374250822,37.448075984826914,0.08725752542977261,1308.0856428146362,488.3503186702728,1177.368236541748,46436,8287,38149,38149,0,12,7184000.0
7184,7184999,20.905648044707867,37.44767174491658,0.08724863873676136,1308.5357794761658,488.41622281074524,1177.3922157287598,46448,8290,38158,38158,0,12,7185000.0
7185,7185999,20.90552183340628,37.44700456074902,0.08724605176768085,1308.9618093967438,488.48084807395935,1177.5858001708984,46487,8293,38194,38194,0,12,7186000.0
7186,7186999,20.905487226214394,37.44734100718705,0.0872355971979546,1309.187141418457,488.54472160339355,1177.8629341125488,46491,8294,38197,38197,0,12,7187000.0
7187,7187999,20.905951343050464,37.447635150655195,0.08723509356037906,1309.4017322063446,488.60902762413025,1177.9915390014648,46504,8295,38209,38209,0,12,7188000.0
7188,7188999,20.906440347635737,37.448291423449895,0.08723411957855953,1309.72522854805,488.67291355133057,1178.0577850341797,46508,8297,38211,38211,0,12,7189000.0
7189,7189999,20.906956206487326,37.44886991209578,0.08723442951610316,1309.9425010681152,488.73536348342896,1178.1078071594238,46513,8298,38215,38215,0,12,7190000.0
7190,7190999,20.907769638137434,37.45006315722958,0.08724324306100473,1310.266358613968,488.7978513240814,1178.1918678283691,46519,8300,38219,38219,0,12,7191000.0
7191,7191999,20.908924293176195,37.45153832792735,0.08726334891053078,1310.8086802959442,488.86198687553406,1178.3650207519531,46533,8304,38229,38229,0,12,7192000.0
7192,7192999,20.910269524387655,37.453901460968595,0.08728343299615593,1311.1378800868988,488.9252450466156,1178.5004768371582,46547,8306,38241,38241,0,12,7193000.0
7193,7193999,20.911772220912116,37.457364055166046,0.08731721837286743,1311.3720910549164,488.9904444217682,1178.6128158569336,46560,8307,38253,38253,0,12,7194000.0
7194,7194999,20.91308116066035,37.4587709705148,0.08736200080289414,1311.5937304496765,489.0548322200775,1178.6946411132812,46562,8308,38254,38254,0,12,7195000.0
7195,7195999,20.914853551817338,37.46154549373939,0.0873950207911025,1311.9275093078613,489.12274050712585,1178.770751953125,46575,8310,38265,38265,0,12,7196000.0
7196,7196999,20.916642720048664,37.4638576592456,0.08744504153780053,1312.059820652008,489.1941468715668,1178.8881492614746,46575,8310,38265,38265,0,12,7197000.0
7197,7197999,20.918607257135346,37.46644885559465,0.08747548781432124,1312.552225112915,489.2669951915741,1178.9850845336914,46611,8313,38298,38298,0,12,7198000.0
7198,7198999,20.920499940389476,37.46880190807309,0.08752097205916765,1312.6715726852417,489.333443403244,1179.1272811889648,46611,8313,38298,38298,0,12,7199000.0
7199,7199999,20.922458317448626,37.47225005173912,0.08758268427366478,1312.8080732822418,489.4093427658081,1179.2417488098145,46611,8313,38298,38298,0,12,7200000.0
7200,7200999,20.92438293686517,37.4743500374596,0.08767124128588721,1313.1498837471008,489.4738121032715,1179.2171821594238,46615,8315,38300,38300,0,12,7201000.0
7201,7201999,20.92556367540131,37.476507498467626,0.08770987016239262,1313.2680089473724,489.5377769470215,1179.5125465393066,46621,8315,38306,38306,0,12,7202000.0
7202,7202999,20.925412419445937,37.47668051785573,0.08769660770170651,1313.6066665649414,489.60546255111694,1179.719295501709,46642,8317,38325,38325,0,12,7203000.0
7203,7203999,20.92505485640752,37.47578870615033,0.08769269210095576,1313.9437828063965,489.6728868484497,1179.818447113037,46659,8319,38340,38340,0,12,7204000.0
7204,7204999,20.925000780997834,37.47567201212307,0.0876853480020412,1314.2755308151245,489.7386360168457,1179.938835144043,46667,8321,38346,38346,0,12,7205000.0
7205,7205999,20.925525820739917,37.47681909793259,0.08767444194404539,1314.6231305599213,489.8050239086151,1180.016056060791,46680,8323,38357,38357,0,12,7206000.0
7206,7206999,20.926575970020238,37.47888662551967,0.08765963097490237,1314.9436204433441,489.87171268463135,1180.2949981689453,46695,8325,38370,38370,0,12,7207000.0
7207,7207999,20.928049960040813,37.48157902295451,0.08766288484889362,1315.4871785640717,489.93764209747314,1180.3354415893555,46712,8329,38383,38383,0,12,7208000.0
7208,7208999,20.93015270699575,37.48603508566744,0.08767702304595704,1315.812998533249,490.0044527053833,1180.4335289001465,46717,8331,38386,38386,0,12,7209000.0
7209,7209999,20.931999869450802,37.489347318093714,0.08770797876097647,1315.9299771785736,490.0700354576111,1180.6291313171387,46718,8331,38387,38387,0,12,7210000.0
7210,7210999,20.934337019258233,37.49373839504808,0.08775466317895508,1316.159096956253,490.1353487968445,1180.7586555480957,46731,8332,38399,38399,0,12,7211000.0
7211,7211999,20.93685239939137,37.498274704120206,0.08778551116385469,1316.5997741222382,490.2016637325287,1180.955093383789,46754,8335,38419,38419,0,12,7212000.0
7212,7212999,20.93939777399498,37.50295533341241,0.08781654148730134,1316.7188529968262,490.26875400543213,1181.1111450195312,46754,8335,38419,38419,0,12,7213000.0
7213,7213999,20.94165144296486,37.50609379012655,0.08786592022618489,1317.0597195625305,490.3340480327606,1181.17582321167,46758,8337,38421,38421,0,12,7214000.0
7214,7214999,20.94425235049377,37.510228376930506,0.08792162857848762,1317.492733001709,490.3994336128235,1181.2092475891113,46764,8340,38424,38424,0,12,7215000.0
7215,7215999,20.9469480741432,37.51868038099225,0.08796823326082481,1317.9372971057892,490.4636170864105,1181.2240905761719,46770,8343,38427,38427,0,12,7216000.0
7216,7216999,20.949144264735523,37.521721685844284,0.08803402262870719,1318.1675436496735,490.52857422828674,1181.3383445739746,46772,8344,38428,38428,0,12,7217000.0
7217,7217999,20.95204451037462,37.527240198441376,0.0880751506312456,1318.3910164833069,490.59507298469543,1181.6161155700684,46777,8345,38432,38432,0,12,7218000.0
7218,7218999,20.954692526570472,37.53082380723152,0.08810834953909386,1318.504221200943,490.661527633667,1181.7637405395508,46777,8345,38432,38432,0,12,7219000.0
7219,7219999,20.957484880958706,37.53507620113355,0.08815978829393867,1318.9441199302673,490.726398229599,1181.7542877197266,46793,8348,38445,38445,0,12,7220000.0
7220,7220999,20.95946130338111,37.53712712516852,0.0882209023662095,1319.2716410160065,490.79073333740234,1181.8187103271484,46797,8350,38447,38447,0,12,7221000.0
7221,7221999,20.959546617023996,37.537012171231375,0.08821396199469012,1319.6131002902985,490.8595106601715,1182.2235984802246,46814,8352,38462,38462,0,12,7222000.0
7222,7222999,20.958929250702603,37.536446992978654,0.08820095905931236,1319.8369181156158,490.92470145225525,1182.3812942504883,46819,8353,38466,38466,0,12,7223000.0
7223,7223999,20.958363879522015,37.5355358393675,0.08819517799337329,1320.1736896038055,490.9890847206116,1182.46732711792,46828,8355,38473,38473,0,12,7224000.0
7224,7224999,20.958026703456277,37.534916307535795,0.08818236103506438,1320.2999560832977,491.06216502189636,1182.618724822998,46829,8355,38474,38474,0,12,7225000.0
7225,7225999,20.957761627332548,37.53429294013464,0.08816745051977348,1320.638655424118,491.12966227531433,1182.8281517028809,46845,8357,38488,38488,0,12,7226000.0
7226,7226999,20.957794417215748,37.53420392048222,0.088151182232177,1320.9813919067383,491.1965732574463,1182.9455070495605,46849,8359,38490,38490,0,12,7227000.0
7227,7227999,20.957637695271337,37.53364426420943,0.08814555036619498,1321.3178691864014,491.2624611854553,1183.0187492370605,46853,8361,38492,38492,0,12,7228000.0
7228,7228999,20.957618345088637,37.53323580934976,0.0881387367671268,1321.4315354824066,491.3274645805359,1183.1931037902832,46855,8361,38494,38494,0,12,7229000.0
7229,7229999,20.957830969312532,37.53399982076338,0.08812242994741948,1321.5497875213623,491.39367723464966,1183.3322448730469,46856,8361,38495,38495,0,12,7230000.0
7230,7230999,20.95809719494898,37.533689521568554,0.08810967503354583,1321.8831369876862,491.45999789237976,1183.5153121948242,46870,8363,38507,38507,0,12,7231000.0
7231,7231999,20.958464931867756,37.533902621169155,0.08809262939299412,1322.2229540348053,491.52611207962036,1183.6290855407715,46874,8365,38509,38509,0,12,7232000.0
7232,7232999,20.958701279549427,37.533651243806595,0.08808326048289405,1322.7665479183197,491.5922510623932,1183.6756553649902,46897,8369,38528,38528,0,12,7233000.0
7233,7233999,20.958876625537922,37.533374634697864,0.08807370575854379,1323.1087579727173,491.66006112098694,1183.7247619628906,46901,8371,38530,38530,0,12,7234000.0
7234,7234999,20.959283659002388,37.53351294753183,0.08806703701254748,1323.4364528656006,491.7261230945587,1183.8513717651367,46905,8373,38532,38532,0,12,7235000.0
7235,7235999,20.959521985982626,37.533009646866766,0.0880541393313593,1323.6584014892578,491.7918381690979,1184.1157684326172,46916,8374,38542,38542,0,12,7236000.0
7236,7236999,20.960087143280408,37.5331983237088,0.08804623962648195,1324.0967690944672,491.8564279079437,1184.2302207946777,46930,8377,38553,38553,0,12,7237000.0
7237,7237999,20.960299212891204,37.53256011696142,0.08804412186027943,1324.4392383098602,491.9233810901642,1184.3595886230469,46944,8379,38565,38565,0,12,7238000.0
7238,7238999,20.960324300766043,37.53170194526306,0.0880463873642775,1324.5541107654572,491.98789048194885,1184.487922668457,46944,8379,38565,38565,0,12,7239000.0
7239,7239999,20.95993937969541,37.53073255036503,0.0880389647043488,1324.6774010658264,492.052529335022,1184.787223815918,46952,8379,38573,38573,0,12,7240000.0
7240,7240999,20.959515568731224,37.53081493647746,0.08802418616093488,1325.139250278473,492.1190321445465,1184.8218154907227,46959,8382,38577,38577,0,12,7241000.0
7241,7241999,20.958844840453146,37.530182249818345,0.0880161065681605,1325.2659678459167,492.18506026268005,1185.0111846923828,46961,8382,38579,38579,0,12,7242000.0
7242,7242999,20.958432229510922,37.52991078649208,0.08800458245932397,1325.384642124176,492.2500550746918,1185.1524467468262,46962,8382,38580,38580,0,12,7243000.0
7243,7243999,20.958033452038315,37.529766329827595,0.08799186553010863,1325.7338330745697,492.31893396377563,1185.340431213379,46971,8384,38587,38587,0,12,7244000.0
7244,7244999,20.95772432597876,37.529213440032535,0.08798229711226768,1325.9726917743683,492.3859016895294,1185.4821662902832,46976,8385,38591,38591,0,12,7245000.0
7245,7245999,20.9574236713483,37.52850630248942,0.08797843789337256,1326.3079023361206,492.4530212879181,1185.5680923461914,46985,8387,38598,38598,0,12,7246000.0
7246,7246999,20.957289230367028,37.528254529213434,0.08797260430721554,1326.7590186595917,492.52013874053955,1185.5772285461426,46992,8390,38602,38602,0,12,7247000.0
7247,7247999,20.957163707476433,37.52768469464542,0.08796708609019521,1327.0983591079712,492.5861403942108,1185.6531944274902,46998,8392,38606,38606,0,12,7248000.0
7248,7248999,20.95751444531873,37.528058956501475,0.08795884717819602,1327.324833869934,492.6524004936218,1185.888328552246,47005,8393,38612,38612,0,12,7249000.0
7249,7249999,20.957908400707073,37.52843969252472,0.0879542147496788,1327.5580651760101,492.7173798084259,1185.9962997436523,47007,8394,38613,38613,0,12,7250000.0
7250,7250999,20.958367998661636,37.53013503540478,0.0879441303235804,1327.9164130687714,492.78370213508606,1186.045238494873,47013,8396,38617,38617,0,12,7251000.0
7251,7251999,20.958592888089495,37.52991117294234,0.08794551852448951,1328.2484636306763,492.8512420654297,1186.0996017456055,47017,8398,38619,38619,0,12,7252000.0
7252,7252999,20.95902383183744,37.52994769922327,0.08795042853552615,1328.4745869636536,492.9163749217987,1186.202304840088,47019,8399,38620,38620,0,12,7253000.0
7253,7253999,20.95944741466629,37.52967205928052,0.08795328899215638,1328.8178343772888,492.98229122161865,1186.2759284973145,47025,8401,38624,38624,0,12,7254000.0
7254,7254999,20.96019141902164,37.53013624590712,0.08795326059219422,1328.935540676117,493.047003030777,1186.5405006408691,47028,8401,38627,38627,0,12,7255000.0
7255,7255999,20.96081523260946,37.53008775250614,0.0879600818678773,1329.1672570705414,493.1142101287842,1186.6593208312988,47030,8402,38628,38628,0,12,7256000.0
7256,7256999,20.961626197936948,37.53084812108379,0.0879589446606508,1329.4024775028229,493.17939734458923,1186.7143669128418,47032,8403,38629,38629,0,12,7257000.0
7257,7257999,20.962286530378478,37.53159808261445,0.0879667852075019,1329.6383130550385,493.2439754009247,1186.797378540039,47034,8404,38630,38630,0,12,7258000.0
7258,7258999,20.962537561144323,37.532644023255685,0.08795021599146913,1330.0663199424744,493.30956053733826,1187.1757469177246,47075,8407,38668,38668,0,12,7259000.0
7259,7259999,20.962789287483616,37.53402854445204,0.08794262101308115,1330.5266735553741,493.372953414917,1187.3331108093262,47104,8410,38694,38694,0,12,7260000.0
7260,7260999,20.962631726860142,37.53455719653397,0.0879496435024999,1330.642488002777,493.4367821216583,1187.5850677490234,47106,8410,38696,38696,0,12,7261000.0
7261,7261999,20.962409403396055,37.53376026613034,0.0879443037240899,1330.867704153061,493.50016832351685,1187.7162628173828,47108,8411,38697,38697,0,12,7262000.0
7262,7262999,20.96239700362398,37.53370801199707,0.08793428285880212,1331.0910494327545,493.5645730495453,1187.9775924682617,47113,8412,38701,38701,0,12,7263000.0
7263,7263999,20.962371890544237,37.53317945052904,0.08792847595664555,1331.5416090488434,493.62850308418274,1187.9548377990723,47126,8415,38711,38711,0,12,7264000.0
7264,7264999,20.962444456867377,37.53301137917805,0.08792093903397613,1331.7783133983612,493.69215846061707,1188.1253204345703,47129,8416,38713,38713,0,12,7265000.0
7265,7265999,20.962351041139602,37.5329707444478,0.0879133866338474,1331.8879725933075,493.7546842098236,1188.3010749816895,47131,8416,38715,38715,0,12,7266000.0
7266,7266999,20.962735785720202,37.535275863913604,0.08789748703700095,1332.0081446170807,493.81927156448364,1188.47074508667,47133,8416,38717,38717,0,12,7267000.0
7267,7267999,20.963003804580897,37.535287261235986,0.08789473195232456,1332.2303261756897,493.8843026161194,1188.6404342651367,47139,8417,38722,38722,0,12,7268000.0
7268,7268999,20.96341775935128,37.53577791731333,0.08789204199170064,1332.572951078415,493.9493935108185,1188.7893829345703,47149,8419,38730,38730,0,12,7269000.0
7269,7269999,20.96380140331577,37.53593969614453,0.08789493041165841,1332.695806980133,494.0119550228119,1188.9169311523438,47149,8419,38730,38730,0,12,7270000.0
7270,7270999,20.964302018385425,37.53600242413865,0.08791169674199883,1333.0383274555206,494.07591700553894,1188.976692199707,47155,8421,38734,38734,0,12,7271000.0
7271,7271999,20.96484201473985,37.536206714426214,0.08791473306264908,1333.255027294159,494.13901233673096,1189.09619140625,47159,8422,38737,38737,0,12,7272000.0
7272,7272999,20.96574182833811,37.53742285527298,0.08791989507830034,1333.4847588539124,494.20361948013306,1189.3435897827148,47166,8423,38743,38743,0,12,7273000.0
7273,7273999,20.967000209515124,37.53923609842712,0.08791945632860387,1333.704164981842,494.26625633239746,1189.4766464233398,47168,8424,38744,38744,0,12,7274000.0
7274,7274999,20.96783185920045,37.53985358363262,0.08794114517027074,1333.925486087799,494.32878828048706,1189.545566558838,47170,8425,38745,38745,0,12,7275000.0
7275,7275999,20.967715457444715,37.539366283944965,0.08793843849715322,1334.165005683899,494.3936846256256,1190.8900032043457,47193,8426,38767,38767,0,12,7276000.0
7276,7276999,20.967720596694555,37.54027348777366,0.08795590325857439,1334.283667087555,494.4606873989105,1191.9201393127441,47199,8426,38773,38773,0,12,7277000.0
7277,7277999,20.967490360476532,37.54015478076207,0.08795009356326944,1334.4191930294037,494.5271694660187,1192.763271331787,47203,8426,38777,38777,0,12,7278000.0
7278,7278999,20.967507599936006,37.54028386172553,0.08793002609720102,1334.5412113666534,494.58922362327576,1193.5310592651367,47206,8426,38780,38780,0,12,7279000.0
7279,7279999,20.96756557613431,37.54017684336552,0.08793416654469466,1334.8647277355194,494.65150904655457,1193.9351081848145,47220,8428,38792,38792,0,12,7280000.0
7280,7280999,20.96761809230114,37.54025241443073,0.08793244625712537,1335.0850925445557,494.71573758125305,1194.2523384094238,47225,8429,38796,38796,0,12,7281000.0
7281,7281999,20.9675214458693,37.540139763894906,0.08793257332850113,1335.5227808952332,494.77816939353943,1194.4453506469727,47238,8432,38806,38806,0,12,7282000.0
7282,7282999,20.967535571407257,37.5401019459102,0.08793818783669682,1335.761961221695,494.84358406066895,1194.8528099060059,47243,8433,38810,38810,0,12,7283000.0
7283,7283999,20.968119839597495,37.5414124711759,0.08793063638258103,1336.2214498519897,494.90748286247253,1195.078525543213,47268,8436,38832,38832,0,12,7284000.0
7284,7284999,20.96880882856342,37.54261042840437,0.08793060518035467,1336.5482625961304,494.97106647491455,1195.5312767028809,47279,8438,38841,38841,0,12,7285000.0
7285,7285999,20.96942634274682,37.54342812955466,0.08792778960169512,1336.6723940372467,495.0329258441925,1195.8795356750488,47281,8438,38843,38843,0,12,7286000.0
7286,7286999,20.970289706608366,37.54468677894577,0.08793631687477188,1337.106538772583,495.09664964675903,1196.1077117919922,47298,8441,38857,38857,0,12,7287000.0
7287,7287999,20.971242938748173,37.54576362650173,0.08795818282152879,1337.3341870307922,495.15989685058594,1196.3426780700684,47310,8442,38868,38868,0,12,7288000.0
7288,7288999,20.972577493599044,37.54791325276857,0.08796225750903752,1337.7866463661194,495.2244942188263,1196.4349479675293,47316,8445,38871,38871,0,12,7289000.0
7289,7289999,20.974157952229085,37.55156829957534,0.08796658239032795,1337.9165132045746,495.2898268699646,1196.8055992126465,47317,8445,38872,38872,0,12,7290000.0
7290,7290999,20.975502984035078,37.5528701046562,0.0879618484282807,1338.0260894298553,495.3534574508667,1197.047592163086,47317,8445,38872,38872,0,12,7291000.0
7291,7291999,20.97707499070706,37.55520023485678,0.08796676927003722,1338.1508824825287,495.41694259643555,1197.2377395629883,47318,8445,38873,38873,0,12,7292000.0
7292,7292999,20.978441922746335,37.55667338947279,0.08798237796204633,1338.3795142173767,495.4806387424469,1197.2336349487305,47320,8446,38874,38874,0,12,7293000.0
7293,7293999,20.97886877154497,37.55659657848009,0.08798476750781636,1338.7168004512787,495.5432744026184,1197.4139518737793,47347,8448,38899,38899,0,12,7294000.0
7294,7294999,20.978344695600704,37.55635349789194,0.08797345695724179,1338.9538066387177,495.6089653968811,1197.855613708496,47353,8449,38904,38904,0,12,7295000.0
7295,7295999,20.97805029394695,37.556334569022134,0.08796145900843833,1339.0710785388947,495.67314314842224,1198.2008666992188,47354,8449,38905,38905,0,12,7296000.0
7296,7296999,20.97774292711866,37.556073746111224,0.08795227078252166,1339.518562555313,495.73772382736206,1198.252742767334,47373,8452,38921,38921,0,12,7297000.0
7297,7297999,20.977515727371905,37.555287734203176,0.08794355416053701,1339.8693115711212,495.80407428741455,1198.4775009155273,47386,8454,38932,38932,0,12,7298000.0
7298,7298999,20.977625751006364,37.55577374156728,0.0879318456050503,1340.0954458713531,495.86916065216064,1198.9656219482422,47397,8455,38942,38942,0,12,7299000.0
7299,7299999,20.977563227245998,37.55534009361278,0.08792420354627728,1340.3207228183746,495.93309235572815,1199.130630493164,47408,8456,38952,38952,0,12,7300000.0
7300,7300999,20.9776286246514,37.55488064045935,0.08791525592975447,1340.5481100082397,495.99759793281555,1199.3471946716309,47421,8457,38964,38964,0,12,7301000.0
7301,7301999,20.977892906131302,37.55485545107422,0.08790442392909414,1340.7675213813782,496.0615887641907,1199.4819297790527,47423,8458,38965,38965,0,12,7302000.0
7302,7302999,20.97842062426516,37.55558089714498,0.0878949954533359,1341.0996298789978,496.12620186805725,1199.5700149536133,47428,8460,38968,38968,0,12,7303000.0
7303,7303999,20.979043581788876,37.55634927839615,0.08788450692021255,1341.3305196762085,496.19093322753906,1199.739200592041,47433,8461,38972,38972,0,12,7304000.0
7304,7304999,20.97983226499074,37.55666565828432,0.0878739781854968,1341.554111480713,496.25703620910645,1200.0838432312012,47450,8462,38988,38988,0,12,7305000.0
7305,7305999,20.980624625322037,37.55743476036106,0.08786997568854915,1341.8817973136902,496.3212568759918,1200.2351760864258,47464,8464,39000,39000,0,12,7306000.0
7306,7306999,20.98144043051226,37.55815246349324,0.08786033971128604,1342.1152930259705,496.3850953578949,1200.3448066711426,47472,8465,39007,39007,0,12,7307000.0
7307,7307999,20.982327326313566,37.55894308368981,0.08785765036723947,1342.2338116168976,496.44952487945557,1200.5209045410156,47473,8465,39008,39008,0,12,7308000.0
7308,7308999,20.983616265183993,37.5600738944225,0.08786846139163684,1342.3564987182617,496.51475524902344,1200.6561393737793,47473,8465,39008,39008,0,12,7309000.0
7309,7309999,20.984774200681457,37.56088785886746,0.08786492030711623,1342.4988725185394,496.58359932899475,1200.8750915527344,47475,8465,39010,39010,0,12,7310000.0
7310,7310999,20.986493761945336,37.563528765600836,0.08784263404515569,1342.7271265983582,496.6472792625427,1201.0552978515625,47480,8466,39014,39014,0,12,7311000.0
7311,7311999,20.987835597437847,37.56501397735259,0.08784226657829275,1342.9498264789581,496.70981216430664,1201.1408004760742,47491,8467,39024,39024,0,12,7312000.0
7312,7312999,20.98956459113789,37.5677389052528,0.08785351406949549,1343.2953820228577,496.7759521007538,1201.231876373291,47505,8469,39036,39036,0,12,7313000.0
7313,7313999,20.9905809446066,37.568676281302466,0.08786920103661744,1343.6286470890045,496.8406836986542,1201.3370323181152,47515,8471,39044,39044,0,12,7314000.0
7314,7314999,20.99030533942055,37.56845167868502,0.0878548913040259,1343.7584872245789,496.9141731262207,1201.7945518493652,47518,8471,39047,39047,0,12,7315000.0
7315,7315999,20.98975504308308,37.567693656870524,0.08784464529734848,1344.0966610908508,496.9792070388794,1201.945499420166,47522,8473,39049,39049,0,12,7316000.0
7316,7316999,20.989316218260118,37.56715043339651,0.08783223399361084,1344.7517895698547,497.0440938472748,1201.86376953125,47554,8478,39076,39076,0,12,7317000.0
7317,7317999,20.988679889683002,37.565863336179426,0.08782310586912923,1344.9833011627197,497.109477519989,1202.0787620544434,47558,8479,39079,39079,0,12,7318000.0
7318,7318999,20.988444709966192,37.56600020348679,0.08780629180075283,1345.206783771515,497.17460465431213,1202.4434776306152,47576,8480,39096,39096,0,12,7319000.0
7319,7319999,20.988327052909273,37.56526402805946,0.08779445247371642,1345.545110464096,497.2396671772003,1202.6796913146973,47590,8482,39108,39108,0,12,7320000.0
7320,7320999,20.988032082431715,37.564355028210784,0.08778359039934058,1345.768649339676,497.3044755458832,1202.8344764709473,47597,8483,39114,39114,0,12,7321000.0
7321,7321999,20.98779780319954,37.56358051582428,0.08777752675511141,1346.315052986145,497.3704206943512,1202.8729133605957,47605,8487,39118,39118,0,12,7322000.0
7322,7322999,20.98793222987125,37.563579574279856,0.08776636666856463,1346.5479836463928,497.4358375072479,1203.0811500549316,47609,8488,39121,39121,0,12,7323000.0
7323,7323999,20.988127424011726,37.56336898324361,0.08775655847255481,1346.7740120887756,497.50136160850525,1203.240135192871,47612,8489,39123,39123,0,12,7324000.0
7324,7324999,20.988628782015542,37.564752702109836,0.08774122935586326,1346.8941798210144,497.5660741329193,1203.727523803711,47616,8489,39127,39127,0,12,7325000.0
7325,7325999,20.988940223946415,37.566085669375965,0.08772065012329766,1347.1348011493683,497.63688111305237,1204.0334167480469,47628,8490,39138,39138,0,12,7326000.0
7326,7326999,20.98944228778794,37.56615689202517,0.08770619642367805,1347.4662897586823,497.7006814479828,1204.253116607666,47642,8492,39150,39150,0,12,7327000.0
7327,7327999,20.990084066896625,37.56851118820142,0.08768484535785859,1347.582944393158,497.76357913017273,1204.4102172851562,47642,8492,39150,39150,0,12,7328000.0
7328,7328999,20.990686126530388,37.568720216185206,0.0876733915219925,1347.811508178711,497.8276150226593,1204.5469207763672,47644,8493,39151,39151,0,12,7329000.0
7329,7329999,20.99108505005345,37.56857968027223,0.087670773090611,1348.032663345337,497.8914530277252,1204.6930236816406,47646,8494,39152,39152,0,12,7330000.0
7330,7330999,20.99192637183728,37.57007047039444,0.08765372141813643,1348.159478187561,497.95477199554443,1204.9241371154785,47646,8494,39152,39152,0,12,7331000.0
7331,7331999,20.99312027887021,37.57125650483726,0.08762682120656995,1348.3907289505005,498.01878905296326,1204.9829750061035,47657,8495,39162,39162,0,12,7332000.0
7332,7332999,20.994003950325617,37.57162134613204,0.08761298207686674,1348.6156206130981,498.0828275680542,1205.0747833251953,47668,8496,39172,39172,0,12,7333000.0
7333,7333999,20.99471562444313,37.5715452349131,0.08760747242729228,1349.0615751743317,498.1471929550171,1205.0533065795898,47681,8499,39182,39182,0,12,7334000.0
7334,7334999,20.99524111448157,37.57206046433348,0.08759260532482871,1349.4071788787842,498.21288681030273,1205.4635314941406,47694,8501,39193,39193,0,12,7335000.0
7335,7335999,20.99450008820656,37.57124599401762,0.08758513147672486,1349.525314092636,498.27790117263794,1205.9167976379395,47699,8501,39198,39198,0,12,7336000.0
7336,7336999,20.994216768264796,37.572770832021064,0.08756571151095172,1349.756469964981,498.3440947532654,1206.1522216796875,47704,8502,39202,39202,0,12,7337000.0
7337,7337999,20.994006962027235,37.57414722108375,0.08754829765361705,1349.9822120666504,498.4087550640106,1206.3398132324219,47709,8503,39206,39206,0,12,7338000.0
7338,7338999,20.99388604752892,37.575439403802015,0.08752881407001634,1350.2076041698456,498.47410917282104,1206.5116691589355,47713,8504,39209,39209,0,12,7339000.0
7339,7339999,20.994333010991706,37.57774851000619,0.08750666786040007,1350.3341598510742,498.5393922328949,1206.8916282653809,47718,8504,39214,39214,0,12,7340000.0
7340,7340999,20.994490881422433,37.57847191330435,0.08749006665281533,1350.5696725845337,498.6068398952484,1207.0626831054688,47729,8505,39224,39224,0,12,7341000.0
7341,7341999,20.99449299542501,37.57853703882808,0.08748589406155105,1350.7943165302277,498.67104029655457,1207.1705856323242,47731,8506,39225,39225,0,12,7342000.0
7342,7342999,20.994606927971027,37.57911094706305,0.08747917895180346,1351.0224206447601,498.73479986190796,1207.264305114746,47735,8507,39228,39228,0,12,7343000.0
7343,7343999,20.99502014054873,37.580507482858984,0.0874656127398783,1351.3550646305084,498.7997043132782,1207.3305397033691,47739,8509,39230,39230,0,12,7344000.0
7344,7344999,20.99538643477623,37.58098616607035,0.0874883019857372,1351.6851806640625,498.863694190979,1207.4894638061523,47749,8511,39238,39238,0,12,7345000.0
7345,7345999,20.99609098185393,37.5822397304776,0.0874796618021707,1351.9132640361786,498.9280159473419,1207.6923713684082,47751,8512,39239,39239,0,12,7346000.0
7346,7346999,20.996308349063323,37.58206003478457,0.08747389673834283,1352.1340227127075,498.9918532371521,1207.8409690856934,47763,8513,39250,39250,0,12,7347000.0
7347,7347999,20.997082235396853,37.58342145895561,0.08746864292651557,1352.4755427837372,499.05645871162415,1207.855655670166,47768,8515,39253,39253,0,12,7348000.0
7348,7348999,20.99779466259221,37.584161364981114,0.08747335785313826,1352.7146575450897,499.1282892227173,1208.066333770752,47770,8516,39254,39254,0,12,7349000.0
7349,7349999,20.99823015222057,37.584381560700336,0.08746838780544919,1353.079196691513,499.1976509094238,1208.1183586120605,47784,8518,39266,39266,0,12,7350000.0
7350,7350999,20.999015784741754,37.58550711623581,0.08745302770504826,1353.3121628761292,499.2617280483246,1208.5205078125,47790,8519,39271,39271,0,12,7351000.0
7351,7351999,20.999752846907228,37.58600427128775,0.08744802212895486,1353.41996717453,499.32528018951416,1208.787540435791,47792,8519,39273,39273,0,12,7352000.0
7352,7352999,21.00050961505607,37.58680744813397,0.08744346649424162,1353.5389070510864,499.38902378082275,1209.008586883545,47793,8519,39274,39274,0,12,7353000.0
7353,7353999,21.00122753421976,37.5870486444722,0.08745248640464931,1353.8699395656586,499.4531054496765,1209.0887298583984,47800,8521,39279,39279,0,12,7354000.0
7354,7354999,21.001866804561594,37.5878553420689,0.08745385806332162,1354.3198175430298,499.5167841911316,1209.3660049438477,47806,8524,39282,39282,0,12,7355000.0
7355,7355999,21.00130601670928,37.58753924807221,0.08744714813808285,1354.5437264442444,499.58177161216736,1209.900722503662,47811,8525,39286,39286,0,12,7356000.0
7356,7356999,21.00122733016054,37.58827569425163,0.08743163906557039,1354.9736847877502,499.6467912197113,1210.0561218261719,47831,8528,39303,39303,0,12,7357000.0
7357,7357999,21.001176758021682,37.5885779861201,0.08742428938347446,1355.0964300632477,499.71203112602234,1210.2594718933105,47832,8528,39304,39304,0,12,7358000.0
7358,7358999,21.001197159544976,37.589142216933034,0.08740793625307197,1355.4342696666718,499.77682399749756,1210.4320945739746,47847,8530,39317,39317,0,12,7359000.0
7359,7359999,21.001071723467195,37.5888496059536,0.08740296752580368,1355.7726912498474,499.8408591747284,1210.5089416503906,47861,8532,39329,39329,0,12,7360000.0
7360,7360999,21.001702074224752,37.59356820990555,0.08738984284778417,1356.2258625030518,499.9062032699585,1210.5932998657227,47886,8535,39351,39351,0,12,7361000.0
7361,7361999,21.002338454241972,37.5943903883393,0.08738667169497494,1356.445319890976,499.9687955379486,1210.723804473877,47888,8536,39352,39352,0,12,7362000.0
7362,7362999,21.002934517491067,37.59538804608574,0.08738415184604276,1356.7810304164886,500.03324460983276,1210.8243255615234,47901,8538,39363,39363,0,12,7363000.0
7363,7363999,21.00361576137865,37.59596011908502,0.08737834890493079,1357.0069088935852,500.0980167388916,1210.9359741210938,47913,8539,39374,39374,0,12,7364000.0
7364,7364999,21.00465969395449,37.59813616883592,0.0873657161033412,1357.236005783081,500.1640977859497,1211.5027770996094,47923,8540,39383,39383,0,12,7365000.0
7365,7365999,21.005286351351984,37.59847493064282,0.0873597403698928,1357.4757828712463,500.23004126548767,1211.8168640136719,47936,8541,39395,39395,0,12,7366000.0
7366,7366999,21.00624899012154,37.59997816591276,0.08736353924933482,1357.701764345169,500.2936444282532,1211.919662475586,47938,8542,39396,39396,0,12,7367000.0
7367,7367999,21.007322318392287,37.6013553412121,0.08736322320679235,1357.9337017536163,500.3592736721039,1212.049461364746,47941,8543,39398,39398,0,12,7368000.0
7368,7368999,21.008259135566526,37.602033453136386,0.08737292150274423,1358.0431997776031,500.42060804367065,1212.212718963623,47942,8543,39399,39399,0,12,7369000.0
7369,7369999,21.0098884544288,37.6048321458655,0.08736638135556418,1358.386766910553,500.4836630821228,1212.3669929504395,47949,8545,39404,39404,0,12,7370000.0
7370,7370999,21.011110704725468,37.60611990791179,0.08737247145339022,1358.7397339344025,500.54922223091125,1212.3797035217285,47974,8547,39427,39427,0,12,7371000.0
7371,7371999,21.012063813940227,37.606874589850605,0.08737777714345174,1358.8513009548187,500.6120798587799,1212.528091430664,47974,8547,39427,39427,0,12,7372000.0
7372,7372999,21.012240922553215,37.60713366589361,0.08737155602904301,1359.0860226154327,500.6777837276459,1212.9529037475586,47980,8548,39432,39432,0,12,7373000.0
7373,7373999,21.011989774375778,37.60889232686282,0.08735466968917738,1359.4224236011505,500.7418620586395,1213.2550811767578,47995,8550,39445,39445,0,12,7374000.0
7374,7374999,21.011768173661203,37.60823505372359,0.08734720861495315,1359.6584260463715,500.8084170818329,1213.5367965698242,48002,8551,39451,39451,0,12,7375000.0
7375,7375999,21.011655370821252,37.608100032144655,0.08733690562443241,1359.8934683799744,500.87346482276917,1213.6623039245605,48005,8552,39453,39453,0,12,7376000.0
7376,7376999,21.011731918262118,37.60834244865938,0.08732636252327253,1360.347655057907,500.93898272514343,1214.0321006774902,48017,8555,39462,39462,0,12,7377000.0
7377,7377999,21.01211208037017,37.61003177059744,0.08731542967417216,1360.6761894226074,501.0041389465332,1214.2212944030762,48040,8557,39483,39483,0,12,7378000.0
7378,7378999,21.01237025280165,37.61019534152435,0.08731442498973396,1361.0154480934143,501.0691270828247,1214.3518257141113,48044,8559,39485,39485,0,12,7379000.0
7379,7379999,21.01271480740763,37.61033162929187,0.0873196786656446,1361.25794506073,501.13953161239624,1214.5306358337402,48047,8560,39487,39487,0,12,7380000.0
7380,7380999,21.013157690058513,37.61071592380336,0.0873198739324651,1361.5233690738678,501.214234828949,1214.66353225708,48049,8561,39488,39488,0,12,7381000.0
7381,7381999,21.01402608129907,37.61302860520829,0.08730907101794627,1361.8683078289032,501.2808735370636,1214.9351997375488,48060,8563,39497,39497,0,12,7382000.0
7382,7382999,21.014808992088366,37.613537081366175,0.08730144274771723,1361.9932069778442,501.3546597957611,1215.1396179199219,48060,8563,39497,39497,0,12,7383000.0
7383,7383999,21.015487318900913,37.61566012287375,0.08729348621914657,1362.2253036499023,501.41908836364746,1215.2430229187012,48062,8564,39498,39498,0,12,7384000.0
7384,7384999,21.01612349998981,37.61588347549661,0.08729603233761674,1362.6736602783203,501.484210729599,1215.292106628418,48068,8567,39501,39501,0,12,7385000.0
7385,7385999,21.016754927613764,37.61614708011907,0.08729753936028173,1362.9052739143372,501.54919934272766,1215.387149810791,48070,8568,39502,39502,0,12,7386000.0
7386,7386999,21.017334896442755,37.616120480477214,0.08729860209640239,1363.2505145072937,501.61345624923706,1215.4223518371582,48079,8570,39509,39509,0,12,7387000.0
7387,7387999,21.018224314852077,37.61647288634733,0.0872952281312025,1363.4832623004913,501.6777217388153,1215.7202072143555,48087,8571,39516,39516,0,12,7388000.0
7388,7388999,21.019064350319844,37.6185007670409,0.08728742599284667,1363.7013320922852,501.74155926704407,1215.8830184936523,48089,8572,39517,39517,0,12,7389000.0
7389,7389999,21.020004146493267,37.618935228664256,0.08729082656086173,1363.8210136890411,501.80658531188965,1216.0564270019531,48090,8572,39518,39518,0,12,7390000.0
7390,7390999,21.020726571508128,37.61884198756541,0.08730061331613015,1364.064440727234,501.8703501224518,1216.1430320739746,48092,8573,39519,39519,0,12,7391000.0
7391,7391999,21.02093616450715,37.619584026110104,0.08729488385630546,1364.3022739887238,501.93356490135193,1216.5749626159668,48104,8574,39530,39530,0,12,7392000.0
7392,7392999,21.020468517128066,37.61972240752424,0.08728668190307531,1364.4257926940918,501.9972491264343,1216.9761085510254,48107,8574,39533,39533,0,12,7393000.0
7393,7393999,21.019744713384345,37.61858087532982,0.08728463719047597,1364.653843164444,502.0602581501007,1217.246467590332,48121,8575,39546,39546,0,12,7394000.0
7394,7394999,21.01919176413798,37.618563302788516,0.08727908440449128,1364.7796981334686,502.12282395362854,1217.4574699401855,48124,8575,39549,39549,0,12,7395000.0
7395,7395999,21.0189292186273,37.618525217444414,0.08727052770520538,1364.9147713184357,502.1905827522278,1217.686653137207,48126,8575,39551,39551,0,12,7396000.0
7396,7396999,21.018598952885856,37.61780633278861,0.08726589254828887,1365.463211297989,502.2575008869171,1217.8128128051758,48176,8579,39597,39597,0,12,7397000.0
7397,7397999,21.01827348670079,37.61676813431697,0.08726519103515418,1365.7001731395721,502.3307566642761,1217.9780311584473,48181,8580,39601,39601,0,12,7398000.0
7398,7398999,21.018013450511067,37.61592071993033,0.08726337068902146,1365.932736158371,502.3942816257477,1218.059684753418,48194,8581,39613,39613,0,12,7399000.0
7399,7399999,21.017807809330506,37.61523571690308,0.08726942257727399,1366.057476758957,502.45862579345703,1218.2024955749512,48195,8581,39614,39614,0,12,7400000.0
7400,7400999,21.017859188279832,37.615373296491114,0.0872687811167362,1366.1896967887878,502.5220367908478,1218.3244018554688,48197,8581,39616,39616,0,12,7401000.0
7401,7401999,21.018157173000013,37.61572152444707,0.0872762747907101,1366.4144568443298,502.5846905708313,1218.5294456481934,48210,8582,39628,39628,0,12,7402000.0
7402,7402999,21.01839572521475,37.615955809141425,0.08730012551680544,1366.5243964195251,502.64781522750854,1218.7413482666016,48210,8582,39628,39628,0,12,7403000.0
7403,7403999,21.01840247800717,37.61586776748885,0.08730501162836879,1366.6572716236115,502.7111032009125,1218.9073524475098,48210,8582,39628,39628,0,12,7404000.0
7404,7404999,21.01898634603427,37.61760489739605,0.0873150262634581,1366.9910113811493,502.77688455581665,1218.9950408935547,48214,8584,39630,39630,0,12,7405000.0
7405,7405999,21.019691302213726,37.61935580586608,0.08732968973350796,1367.214908838272,502.8395473957062,1219.1227645874023,48216,8585,39631,39631,0,12,7406000.0
7406,7406999,21.0205896439839,37.62242757469407,0.08735288540643649,1367.4575662612915,502.90513467788696,1219.2168807983398,48227,8586,39641,39641,0,12,7407000.0
7407,7407999,21.021882738560944,37.62534192510915,0.0873469416795003,1367.5736486911774,502.9678523540497,1219.4961280822754,48230,8586,39644,39644,0,12,7408000.0
7408,7408999,21.023541055084113,37.63213315245319,0.08731534579773148,1367.9175975322723,503.0328347682953,1219.5527610778809,48242,8588,39654,39654,0,12,7409000.0
7409,7409999,21.024436237031022,37.63397844915451,0.0873238076634113,1368.1374893188477,503.09598183631897,1219.6725540161133,48244,8589,39655,39655,0,12,7410000.0
7410,7410999,21.02473621302284,37.63460986232086,0.08733138293994958,1368.4894535541534,503.1646363735199,1219.7655563354492,48258,8591,39667,39667,0,12,7411000.0
7411,7411999,21.024352649664422,37.63575641605058,0.0873186009499971,1368.836960554123,503.22788977622986,1220.3076400756836,48267,8593,39674,39674,0,12,7412000.0
7412,7412999,21.02341194113173,37.634395698241846,0.0873200694293963,1368.9555988311768,503.2934112548828,1220.5365180969238,48267,8593,39674,39674,0,12,7413000.0
7413,7413999,21.022682852857805,37.63340672544116,0.08731664828425889,1369.3109104633331,503.3638114929199,1220.618824005127,48293,8595,39698,39698,0,12,7414000.0
7414,7414999,21.0219700377955,37.632384109399574,0.08731461845288424,1369.78781747818,503.4363098144531,1220.702781677246,48328,8598,39730,39730,0,12,7415000.0
7415,7415999,21.02169193464598,37.633153684182815,0.08729568814219546,1369.9035303592682,503.5014867782593,1220.9977493286133,48331,8598,39733,39733,0,12,7416000.0
7416,7416999,21.021241471368306,37.63220102553021,0.08729192210921954,1370.1329514980316,503.5648651123047,1221.124942779541,48333,8599,39734,39734,0,12,7417000.0
7417,7417999,21.020970702933877,37.6316847024321,0.08728662666029885,1370.5731947422028,503.62809205055237,1221.189064025879,48344,8602,39742,39742,0,12,7418000.0
7418,7418999,21.020689935336545,37.63096102018176,0.08728287875331464,1370.917332649231,503.6924772262573,1221.346076965332,48358,8604,39754,39754,0,12,7419000.0
7419,7419999,21.020455413984735,37.63041238440644,0.08727572730918509,1371.0358247756958,503.7562999725342,1221.5668258666992,48360,8604,39756,39756,0,12,7420000.0
7420,7420999,21.020618484220673,37.63050536584361,0.08726610624737996,1371.2608222961426,503.81933760643005,1221.7473945617676,48364,8605,39759,39759,0,12,7421000.0
7421,7421999,21.020678571136756,37.63002164081411,0.08725744453159412,1371.3840482234955,503.8827428817749,1221.9697723388672,48364,8605,39759,39759,0,12,7422000.0
7422,7422999,21.021018544279368,37.6303250269339,0.08724607371030557,1371.7208681106567,503.9462676048279,1222.1357307434082,48380,8607,39773,39773,0,12,7423000.0
7423,7423999,21.021533174542604,37.63259902721097,0.08723393495373233,1372.071406841278,504.00992131233215,1222.275032043457,48385,8609,39776,39776,0,12,7424000.0
7424,7424999,21.021960302142407,37.63284946716983,0.08724317074566956,1372.1863293647766,504.07344675064087,1222.4343757629395,48385,8609,39776,39776,0,12,7425000.0
7425,7425999,21.022248207501722,37.63287651821185,0.08724660479381274,1372.3181133270264,504.1378872394562,1222.5247917175293,48385,8609,39776,39776,0,12,7426000.0
7426,7426999,21.02300228541131,37.633985361210804,0.0872430059899173,1372.435118675232,504.2017056941986,1222.757667541504,48387,8609,39778,39778,0,12,7427000.0
7427,7427999,21.02341450813032,37.63437045787258,0.08723280126990385,1372.7716267108917,504.26509737968445,1222.7595138549805,48401,8611,39790,39790,0,12,7428000.0
7428,7428999,21.023751919574067,37.63539609540574,0.08722878675752876,1373.000678062439,504.3286397457123,1222.8558654785156,48404,8612,39792,39792,0,12,7429000.0
7429,7429999,21.023896833332785,37.63530493223362,0.0872255578181893,1373.3291037082672,504.3913633823395,1222.9109687805176,48411,8614,39797,39797,0,12,7430000.0
7430,7430999,21.023625002029704,37.635084626057186,0.08721391672495538,1373.444680929184,504.4551181793213,1223.4100036621094,48420,8614,39806,39806,0,12,7431000.0
7431,7431999,21.022492583427482,37.63313711137249,0.08722071190607839,1373.5690417289734,504.5209686756134,1223.6633644104004,48420,8614,39806,39806,0,12,7432000.0
7432,7432999,21.021682680162396,37.63365136608684,0.08721280597911718,1373.8040609359741,504.58472514152527,1223.8501358032227,48424,8615,39809,39809,0,12,7433000.0
7433,7433999,21.02081090159488,37.63260146828209,0.08721401838135923,1374.1450219154358,504.6495690345764,1223.9973907470703,48432,8617,39815,39815,0,12,7434000.0
7434,7434999,21.02020996185237,37.63170593772549,0.08721003503257785,1374.37171292305,504.7137451171875,1224.2302742004395,48436,8618,39818,39818,0,12,7435000.0
7435,7435999,21.019513138482296,37.630283118546366,0.08721180803599082,1374.6088528633118,504.7787296772003,1224.3612060546875,48439,8619,39820,39820,0,12,7436000.0
7436,7436999,21.018734523513828,37.62881145099584,0.08721221524233302,1374.8607318401337,504.8523588180542,1224.4976387023926,48442,8620,39822,39822,0,12,7437000.0
7437,7437999,21.018106242672946,37.62762827397793,0.0872134921726836,1375.0962624549866,504.9169936180115,1224.595069885254,48444,8621,39823,39823,0,12,7438000.0
7438,7438999,21.017676061892953,37.626662753321,0.08720877599465826,1375.2144129276276,504.98111867904663,1224.7609519958496,48446,8621,39825,39825,0,12,7439000.0
7439,7439999,21.01723345809912,37.625823913545524,0.08720514973249383,1375.4600172042847,505.0453140735626,1224.8212852478027,48451,8622,39829,39829,0,12,7440000.0
7440,7440999,21.016754028312754,37.62440069478369,0.08720252760888003,1375.8093667030334,505.1105513572693,1225.0827674865723,48464,8624,39840,39840,0,12,7441000.0
7441,7441999,21.01643940069239,37.62335135287309,0.08719523409946883,1376.155826807022,505.17445945739746,1225.2063446044922,48478,8626,39852,39852,0,12,7442000.0
7442,7442999,21.016123661576195,37.62245151362637,0.08719265371289409,1376.4910604953766,505.23872113227844,1225.2909126281738,48483,8628,39855,39855,0,12,7443000.0
7443,7443999,21.015653229757774,37.621054833071454,0.08719177146554213,1376.7300243377686,505.3033826351166,1225.408203125,48485,8629,39856,39856,0,12,7444000.0
7444,7444999,21.015310211035214,37.61990267419721,0.08718185023648894,1376.8434529304504,505.36580991744995,1225.536491394043,48485,8629,39856,39856,0,12,7445000.0
7445,7445999,21.014971777451656,37.61866071227532,0.08716857310465087,1376.9719214439392,505.43108105659485,1225.6862335205078,48485,8629,39856,39856,0,12,7446000.0
7446,7446999,21.014998533594575,37.617747676716746,0.08715080959104415,1377.0951135158539,505.49427580833435,1225.8227996826172,48485,8629,39856,39856,0,12,7447000.0
7447,7447999,21.014706787355475,37.61650874576388,0.087134538064772,1377.213359117508,505.55638456344604,1225.914794921875,48485,8629,39856,39856,0,12,7448000.0
7448,7448999,21.014425401313563,37.61540018843512,0.08712177771183371,1377.3352591991425,505.61921310424805,1225.963924407959,48485,8629,39856,39856,0,12,7449000.0
7449,7449999,21.01414468038348,37.614733317264225,0.08710496159189607,1377.6737079620361,505.68091344833374,1226.2557067871094,48496,8631,39865,39865,0,12,7450000.0
7450,7450999,21.013428555019523,37.61327668820722,0.08710240415863435,1377.8962569236755,505.74511075019836,1226.546615600586,48501,8632,39869,39869,0,12,7451000.0
7451,7451999,21.012867639875203,37.612088691467754,0.0870970513080992,1378.02086353302,505.81760573387146,1226.8225936889648,48501,8632,39869,39869,0,12,7452000.0
7452,7452999,21.012281452179895,37.61105018761834,0.08709228483244091,1378.3611042499542,505.88147735595703,1226.8969078063965,48521,8634,39887,39887,0,12,7453000.0
7453,7453999,21.01164856010753,37.60976066347805,0.08708846388954017,1378.8282163143158,505.9482009410858,1226.9135818481445,48540,8637,39903,39903,0,12,7454000.0
7454,7454999,21.011373419611314,37.6089864093778,0.08707960251145419,1379.274393081665,506.0132825374603,1227.3233222961426,48573,8640,39933,39933,0,12,7455000.0
7455,7455999,21.01097646853249,37.60771273597677,0.08707830919328452,1379.400074005127,506.0803279876709,1227.5664710998535,48573,8640,39933,39933,0,12,7456000.0
7456,7456999,21.010692929566616,37.60693058083988,0.08707560794652702,1379.6486427783966,506.1535487174988,1227.6739921569824,48578,8641,39937,39937,0,12,7457000.0
7457,7457999,21.010379813012097,37.606738259238064,0.08707818373252663,1379.8745770454407,506.21815490722656,1227.8144493103027,48581,8642,39939,39939,0,12,7458000.0
7458,7458999,21.010320537664892,37.60662053337376,0.08707415114284178,1380.0073573589325,506.28512692451477,1228.026554107666,48583,8642,39941,39941,0,12,7459000.0
7459,7459999,21.010110023036997,37.60566971435842,0.08706706647440976,1380.1285355091095,506.3492364883423,1228.3919715881348,48586,8642,39944,39944,0,12,7460000.0
7460,7460999,21.01027802223806,37.60539436800469,0.08704913041987905,1380.3547406196594,506.41399812698364,1228.7301445007324,48600,8643,39957,39957,0,12,7461000.0
7461,7461999,21.01018777999008,37.604631435653346,0.08703831816242358,1380.583966255188,506.479287147522,1228.8809127807617,48602,8644,39958,39958,0,12,7462000.0
7462,7462999,21.010342432321565,37.60439967921993,0.08702682305128373,1380.7029809951782,506.54367303848267,1229.099941253662,48603,8644,39959,39959,0,12,7463000.0
7463,7463999,21.010605305921832,37.604175723139484,0.08701659051879507,1380.9371180534363,506.6098644733429,1229.1735801696777,48605,8645,39960,39960,0,12,7464000.0
7464,7464999,21.010754965921528,37.60383575936919,0.08700888579607902,1381.0586547851562,506.67341232299805,1229.317741394043,48605,8645,39960,39960,0,12,7465000.0
7465,7465999,21.011584163642922,37.60420439745939,0.08698408574238792,1381.188800573349,506.7387957572937,1229.5540466308594,48607,8645,39962,39962,0,12,7466000.0
7466,7466999,21.012957744974067,37.6061005265911,0.08694084445473238,1381.4097244739532,506.80282282829285,1229.686595916748,48614,8646,39968,39968,0,12,7467000.0
7467,7467999,21.013721315001543,37.6061975605609,0.08692570158294144,1381.5334515571594,506.8665282726288,1229.8176460266113,48614,8646,39968,39968,0,12,7468000.0
7468,7468999,21.01425596362786,37.60579941892956,0.08690680951083263,1381.7735965251923,506.9298825263977,1229.8808860778809,48616,8647,39969,39969,0,12,7469000.0
7469,7469999,21.014181179608865,37.60478502414928,0.0869023623264269,1381.8971712589264,506.9940161705017,1230.328727722168,48624,8647,39977,39977,0,12,7470000.0
7470,7470999,21.013602003082266,37.605759268179085,0.08689792512652372,1382.247241973877,507.0621500015259,1230.6239776611328,48631,8649,39982,39982,0,12,7471000.0
7471,7471999,21.01270959612413,37.60447570135389,0.0869043521573758,1382.4709923267365,507.1278963088989,1230.8521575927734,48633,8650,39983,39983,0,12,7472000.0
7472,7472999,21.012134341732306,37.6033430213679,0.08690421492851774,1382.5869543552399,507.1908447742462,1231.0565223693848,48635,8650,39985,39985,0,12,7473000.0
7473,7473999,21.011759334914558,37.60356265215723,0.08689815998289896,1382.9238812923431,507.25552558898926,1231.127799987793,48650,8652,39998,39998,0,12,7474000.0
7474,7474999,21.01136763216284,37.60245453446655,0.08689919259112322,1383.1564168930054,507.32199215888977,1231.485580444336,48664,8653,40011,40011,0,12,7475000.0
7475,7475999,21.01105099686345,37.60188443155879,0.08689856616682401,1383.2685415744781,507.3851101398468,1231.6640625,48664,8653,40011,40011,0,12,7476000.0
7476,7476999,21.010917412168194,37.60116044778109,0.08690322103165093,1383.3837361335754,507.45119428634644,1231.8287200927734,48665,8653,40012,40012,0,12,7477000.0
7477,7477999,21.011042823903882,37.60157922330114,0.08691288482121817,1383.6159927845001,507.5150022506714,1232.0122909545898,48668,8654,40014,40014,0,12,7478000.0
7478,7478999,21.011176150974503,37.6013897137704,0.08691674696488738,1383.7322444915771,507.57976603507996,1232.1383666992188,48668,8654,40014,40014,0,12,7479000.0
7479,7479999,21.011563455516978,37.60156096135774,0.08692092547948371,1384.2986345291138,507.6443462371826,1232.3433723449707,48693,8658,40035,40035,0,12,7480000.0
7480,7480999,21.01199478036014,37.60165410357481,0.08692859059100466,1384.7436878681183,507.70827317237854,1232.4196891784668,48711,8661,40050,40050,0,12,7481000.0
7481,7481999,21.01224557552507,37.60133843597831,0.08693801936802281,1384.969654083252,507.7718734741211,1232.553424835205,48713,8662,40051,40051,0,12,7482000.0
7482,7482999,21.012548772568348,37.60133269858623,0.0869381325739752,1385.0857248306274,507.84007573127747,1232.7011985778809,48713,8662,40051,40051,0,12,7483000.0
7483,7483999,21.0129021616513,37.60104341112227,0.08694071979165974,1385.317957162857,507.90415120124817,1232.792308807373,48715,8663,40052,40052,0,12,7484000.0
7484,7484999,21.01328629608069,37.60088410583365,0.08694608233428958,1385.4400525093079,507.9677662849426,1232.9265975952148,48715,8663,40052,40052,0,12,7485000.0
7485,7485999,21.01375914637451,37.600587306906164,0.0869296300811696,1385.6708953380585,508.032427072525,1233.4062690734863,48720,8664,40056,40056,0,12,7486000.0
7486,7486999,21.014465751656086,37.60082189043537,0.08691676312251462,1386.0133039951324,508.098925113678,1233.624610900879,48753,8666,40087,40087,0,12,7487000.0
7487,7487999,21.014697019882135,37.60006005192599,0.08690752900188947,1386.1255769729614,508.1631906032562,1233.8099327087402,48753,8666,40087,40087,0,12,7488000.0
7488,7488999,21.014811719687234,37.59927208258009,0.08689639066011212,1386.5918300151825,508.2281620502472,1233.8385581970215,48798,8669,40129,40129,0,12,7489000.0
7489,7489999,21.014518241133022,37.59822212508392,0.08689209061866066,1387.0547108650208,508.2926115989685,1234.3603210449219,48815,8672,40143,40143,0,12,7490000.0
7490,7490999,21.013701774753596,37.596620219318325,0.08689787498535528,1387.4102058410645,508.3596827983856,1234.777759552002,48833,8674,40159,40159,0,12,7491000.0
7491,7491999,21.012865844697497,37.59490082625958,0.08690617906067821,1387.5306391716003,508.42412519454956,1235.089542388916,48835,8674,40161,40161,0,12,7492000.0
7492,7492999,21.01218612498381,37.59382755302824,0.08690724799165439,1387.75350689888,508.4889986515045,1235.281852722168,48840,8675,40165,40165,0,12,7493000.0
7493,7493999,21.01147564266454,37.59234953650478,0.08690706227980016,1388.093778848648,508.5550448894501,1235.5718955993652,48848,8677,40171,40171,0,12,7494000.0
7494,7494999,21.010754989699628,37.59095489978332,0.0869074543701619,1388.4290869235992,508.62041997909546,1235.696689605713,48875,8679,40196,40196,0,12,7495000.0
7495,7495999,21.00993325077689,37.589240556767116,0.08691230167904296,1388.5537931919098,508.687335729599,1235.880760192871,48875,8679,40196,40196,0,12,7496000.0
7496,7496999,21.00921772194351,37.58766133848628,0.08691727711962205,1388.7798380851746,508.75103664398193,1236.0125770568848,48877,8680,40197,40197,0,12,7497000.0
7497,7497999,21.00847221921344,37.58624089081864,0.0869234053302318,1389.1299829483032,508.81610918045044,1236.088981628418,48883,8682,40201,40201,0,12,7498000.0
7498,7498999,21.00785773558008,37.58473127813364,0.08692242696025998,1389.2530596256256,508.88093090057373,1236.5687408447266,48884,8682,40202,40202,0,12,7499000.0
7499,7499999,21.00736908810114,37.5833131447111,0.08692430766820114,1389.374811410904,508.94500398635864,1236.7762870788574,48884,8682,40202,40202,0,12,7500000.0
7500,7500999,21.006702762601996,37.58187847079092,0.0869285835332152,1389.599904537201,509.00952076911926,1236.9000205993652,48888,8683,40205,40205,0,12,7501000.0
7501,7501999,21.006233969141306,37.580651484379786,0.08693586036021383,1389.8258464336395,509.0742766857147,1237.0127143859863,48890,8684,40206,40206,0,12,7502000.0
7502,7502999,21.005777428195927,37.5800743742187,0.08694014220373436,1390.067269563675,509.1419892311096,1237.121669769287,48892,8685,40207,40207,0,12,7503000.0
7503,7503999,21.005420223927572,37.57985619575003,0.08693758931004969,1390.3007729053497,509.2065589427948,1237.4155082702637,48896,8686,40210,40210,0,12,7504000.0
7504,7504999,21.00471889182538,37.57823012326017,0.08694627234547381,1390.4231884479523,509.2699522972107,1237.5669555664062,48896,8686,40210,40210,0,12,7505000.0
7505,7505999,21.0041462416046,37.57741947847387,0.08694970650219536,1390.648371219635,509.3347096443176,1237.912223815918,48911,8687,40224,40224,0,12,7506000.0
7506,7506999,21.003548377720556,37.57733049817507,0.08694526453660822,1390.8783373832703,509.3988661766052,1238.2177124023438,48918,8688,40230,40230,0,12,7507000.0
7507,7507999,21.002649245852446,37.57571607814308,0.08695498312395555,1390.9929583072662,509.46452379226685,1238.4922676086426,48920,8688,40232,40232,0,12,7508000.0
7508,7508999,21.001908279205377,37.57445758378426,0.0869602815040802,1391.5572528839111,509.5306644439697,1238.6198081970215,48944,8692,40252,40252,0,12,7509000.0
7509,7509999,21.001124203292708,37.573192685524766,0.08696795679053082,1391.9051823616028,509.5962164402008,1238.9918212890625,48952,8694,40258,40258,0,12,7510000.0
7510,7510999,21.000312634221746,37.57163665641758,0.08696960991878833,1392.1456108093262,509.66338658332825,1239.1940536499023,48955,8695,40260,40260,0,12,7511000.0
7511,7511999,20.999332138375802,37.56986145745533,0.08697419876316093,1392.271896123886,509.7282521724701,1239.37984085083,48956,8695,40261,40261,0,12,7512000.0
7512,7512999,20.99866629264223,37.5686997945628,0.0869704930073707,1392.4946370124817,509.79291129112244,1239.5264205932617,48958,8696,40262,40262,0,12,7513000.0
7513,7513999,20.998192792445188,37.56796019459231,0.0869665734363313,1392.729124546051,509.86159443855286,1239.679100036621,48962,8697,40265,40265,0,12,7514000.0
7514,7514999,20.997662753205343,37.566860964743825,0.08695607082995438,1393.0673940181732,509.92587399482727,1239.891201019287,48969,8699,40270,40270,0,12,7515000.0
7515,7515999,20.997312624484405,37.56584929785425,0.08694947174193568,1393.4077789783478,509.9907691478729,1239.9358825683594,48975,8701,40274,40274,0,12,7516000.0
7516,7516999,20.996828158893,37.56476627453847,0.08694263913595446,1393.6353585720062,510.0543260574341,1240.0768775939941,48978,8702,40276,40276,0,12,7517000.0
7517,7517999,20.996602918313698,37.56383419493174,0.08693551513145048,1394.1027293205261,510.12045979499817,1240.092887878418,49007,8705,40302,40302,0,12,7518000.0
7518,7518999,20.996263721794005,37.56279565351756,0.08692839891800441,1394.4406564235687,510.184623003006,1240.2309455871582,49021,8707,40314,40314,0,12,7519000.0
7519,7519999,20.996270442750973,37.56299766416758,0.0869120739884951,1394.6699423789978,510.2493963241577,1240.296371459961,49023,8708,40315,40315,0,12,7520000.0
7520,7520999,20.996347057914228,37.56236860794408,0.08689424849796168,1394.7986550331116,510.3188147544861,1240.6590881347656,49024,8708,40316,40316,0,12,7521000.0
7521,7521999,20.996244817334237,37.56165582950063,0.08687621543345414,1395.0276536941528,510.38331151008606,1240.8030166625977,49026,8709,40317,40317,0,12,7522000.0
7522,7522999,20.99615153966228,37.56059286441239,0.08686248437609734,1395.263991355896,510.44827818870544,1240.8567008972168,49028,8710,40318,40318,0,12,7523000.0
7523,7523999,20.995822892662396,37.559294207799304,0.08685709691742094,1395.6035840511322,510.51304292678833,1240.9295196533203,49033,8712,40321,40321,0,12,7524000.0
7524,7524999,20.995363528745052,37.55876055559975,0.08684812790925334,1395.8403079509735,510.5765976905823,1241.4469528198242,49053,8713,40340,40340,0,12,7525000.0
7525,7525999,20.994553197460384,37.557906234273084,0.08684781750843651,1396.1746304035187,510.6399405002594,1241.682144165039,49064,8715,40349,40349,0,12,7526000.0
7526,7526999,20.993800844196524,37.55705897040025,0.08684520025998943,1396.4087810516357,510.70338582992554,1241.9407119750977,49069,8716,40353,40353,0,12,7527000.0
7527,7527999,20.99305520348126,37.55554424769111,0.08684610931382486,1396.5224492549896,510.76715993881226,1242.118465423584,49069,8716,40353,40353,0,12,7528000.0
7528,7528999,20.99263729028953,37.55463013020675,0.0868381726206886,1396.8698484897614,510.8312044143677,1242.5359954833984,49087,8718,40369,40369,0,12,7529000.0
7529,7529999,20.992158464947412,37.55341305213136,0.08683573904210495,1397.0913140773773,510.89499068260193,1242.7334785461426,49094,8719,40375,40375,0,12,7530000.0
7530,7530999,20.991364532304864,37.551747949910734,0.08683568194677893,1397.223403453827,510.95881605148315,1242.9102630615234,49094,8719,40375,40375,0,12,7531000.0
7531,7531999,20.99073133805527,37.55035972436738,0.0868380666608064,1397.4488990306854,511.0226106643677,1243.0336875915527,49125,8720,40405,40405,0,12,7532000.0
7532,7532999,20.989977664461982,37.54885207814903,0.08684229835285351,1397.5730056762695,511.08634901046753,1243.1733779907227,49127,8720,40407,40407,0,12,7533000.0
7533,7533999,20.989426870658008,37.54753983049835,0.08684535723377573,1397.7186901569366,511.1624917984009,1243.4894714355469,49130,8720,40410,40410,0,12,7534000.0
7534,7534999,20.98910370620183,37.546443001138975,0.08684009483536503,1397.8444983959198,511.2256302833557,1243.7390670776367,49131,8720,40411,40411,0,12,7535000.0
7535,7535999,20.98890011914919,37.5455634290326,0.08683598189640374,1397.9591233730316,511.29260754585266,1243.8723487854004,49131,8720,40411,40411,0,12,7536000.0
7536,7536999,20.988819018282157,37.54622385913884,0.08683107768417586,1398.3097705841064,511.3566987514496,1243.922248840332,49135,8722,40413,40413,0,12,7537000.0
7537,7537999,20.988771256615667,37.54589749481006,0.08682497148310864,1398.439216375351,511.4298355579376,1244.0615425109863,49135,8722,40413,40413,0,12,7538000.0
7538,7538999,20.98876518806142,37.54509297036886,0.08682018872199437,1398.6780576705933,511.49408197402954,1244.1048431396484,49137,8723,40414,40414,0,12,7539000.0
7539,7539999,20.9889102950399,37.54457872903794,0.08681454863897364,1399.0291066169739,511.5584931373596,1244.2575759887695,49151,8725,40426,40426,0,12,7540000.0
7540,7540999,20.989360138322297,37.544447534875204,0.08680904275819779,1399.1406588554382,511.6219370365143,1244.417911529541,49151,8725,40426,40426,0,12,7541000.0
7541,7541999,20.98957055956481,37.54401339075397,0.08679972208071385,1399.2783203125,511.68570375442505,1244.5196495056152,49151,8725,40426,40426,0,12,7542000.0
7542,7542999,20.989471539680913,37.543068654508076,0.08679795746541596,1399.6362402439117,511.7566981315613,1244.5091438293457,49165,8727,40438,40438,0,12,7543000.0
7543,7543999,20.98912880388082,37.541930561263605,0.08679246495411819,1400.0199117660522,511.82532143592834,1244.9846305847168,49183,8729,40454,40454,0,12,7544000.0
7544,7544999,20.98901001048564,37.54332083691484,0.08677128418438396,1400.1300728321075,511.8883442878723,1245.3656616210938,49185,8729,40456,40456,0,12,7545000.0
7545,7545999,20.988774928799618,37.54264733382018,0.08675620270930462,1400.3648743629456,511.95260214805603,1245.595687866211,49190,8730,40460,40460,0,12,7546000.0
7546,7546999,20.98860238174328,37.542694426633815,0.08674424850131268,1400.592452764511,512.0174276828766,1245.806224822998,49195,8731,40464,40464,0,12,7547000.0
7547,7547999,20.988410067043766,37.54190774086029,0.08672658965649416,1400.7254312038422,512.091968536377,1246.1637840270996,49197,8731,40466,40466,0,12,7548000.0
7548,7548999,20.98829690540083,37.5413334692917,0.08671580532339174,1400.8605065345764,512.1670653820038,1246.4462776184082,49198,8731,40467,40467,0,12,7549000.0
7549,7549999,20.988225407973538,37.54062121263616,0.08670447425221695,1400.9711937904358,512.2306323051453,1246.618148803711,49198,8731,40467,40467,0,12,7550000.0
7550,7550999,20.98810289895957,37.540367350848804,0.08669429341279733,1401.4232106208801,512.2941997051239,1246.6346282958984,49209,8734,40475,40475,0,12,7551000.0
7551,7551999,20.987958010236714,37.53945692834903,0.08668983161382104,1401.6618719100952,512.3642795085907,1246.8761749267578,49223,8735,40488,40488,0,12,7552000.0
7552,7552999,20.988058132600887,37.53912522421716,0.08667590078677168,1401.780635356903,512.4285814762115,1247.092372894287,49225,8735,40490,40490,0,12,7553000.0
7553,7553999,20.988864449857903,37.539058539697635,0.08662698221787535,1401.890128850937,512.4916987419128,1247.5266418457031,49227,8735,40492,40492,0,12,7554000.0
7554,7554999,20.98981730488054,37.539142937244165,0.08657567058359583,1402.1258840560913,512.5605189800262,1247.7475280761719,49229,8736,40493,40493,0,12,7555000.0
7555,7555999,20.990360684250355,37.53856025347765,0.08653667942799492,1402.349510192871,512.6236720085144,1247.873908996582,49231,8737,40494,40494,0,12,7556000.0
7556,7556999,20.99084099431879,37.538196514668996,0.08650642532616981,1402.7201609611511,512.6947228908539,1247.930004119873,49236,8739,40497,40497,0,12,7557000.0
7557,7557999,20.99122067905879,37.53756338905061,0.08647883854980443,1402.9492766857147,512.7591359615326,1248.0441093444824,49248,8740,40508,40508,0,12,7558000.0
7558,7558999,20.99168089409205,37.53690432537514,0.08643574754033834,1403.0770134925842,512.828590631485,1248.296054840088,49248,8740,40508,40508,0,12,7559000.0
7559,7559999,20.993078945908874,37.537401445032366,0.08636034505455126,1403.1877534389496,512.8927323818207,1248.4542274475098,49248,8740,40508,40508,0,12,7560000.0
7560,7560999,20.993867733299357,37.53691332254917,0.08630994609798748,1403.5450203418732,512.9573101997375,1248.4815406799316,49272,8742,40530,40530,0,12,7561000.0
7561,7561999,20.994231433551114,37.536005480398096,0.0862773706337856,1403.6549932956696,513.0205538272858,1248.5866165161133,49272,8742,40530,40530,0,12,7562000.0
7562,7562999,20.994232494891424,37.535034660264365,0.08625623506712943,1403.9087195396423,513.0867326259613,1248.8319816589355,49280,8743,40537,40537,0,12,7563000.0
7563,7563999,20.99374830209007,37.534276118080825,0.08624398330131822,1404.0298218727112,513.1502196788788,1249.098819732666,49282,8743,40539,40539,0,12,7564000.0
7564,7564999,20.993323589471267,37.533378773770245,0.08622666274419155,1404.2627353668213,513.2137429714203,1249.256748199463,49295,8744,40551,40551,0,12,7565000.0
7565,7565999,20.992960028208188,37.53219967831919,0.08621365697926198,1404.6200284957886,513.2776157855988,1249.357177734375,49302,8746,40556,40556,0,12,7566000.0
7566,7566999,20.992478191008335,37.53092599071838,0.08620415703202966,1404.848798751831,513.3417296409607,1249.5962715148926,49307,8747,40560,40560,0,12,7567000.0
7567,7567999,20.992148083782325,37.52970932162039,0.08619368478158662,1404.9796857833862,513.4049551486969,1249.9294929504395,49311,8747,40564,40564,0,12,7568000.0
7568,7568999,20.991433588759893,37.52804907102889,0.08619342862161539,1405.1977665424347,513.4665484428406,1250.0665969848633,49318,8748,40570,40570,0,12,7569000.0
7569,7569999,20.990846788142168,37.526747808093084,0.08619124494308017,1405.3223433494568,513.5300042629242,1250.1690521240234,49318,8748,40570,40570,0,12,7570000.0
7570,7570999,20.990193321294317,37.525548636457984,0.08619075370070961,1405.5572934150696,513.594850063324,1250.2703437805176,49321,8749,40572,40572,0,12,7571000.0
7571,7571999,20.989497097879102,37.523861641397566,0.08619036642437794,1405.676546573639,513.6585636138916,1250.374797821045,49322,8749,40573,40573,0,12,7572000.0
7572,7572999,20.989291154477474,37.52288842586509,0.08617801999688757,1405.8091711997986,513.7225699424744,1250.6729011535645,49324,8749,40575,40575,0,12,7573000.0
7573,7573999,20.98917290692737,37.52167167714552,0.08615970507396975,1406.1521978378296,513.786340713501,1250.7851676940918,49340,8751,40589,40589,0,12,7574000.0
7574,7574999,20.988958350194036,37.52078199424157,0.08614212897068885,1406.3872392177582,513.8506109714508,1250.9047088623047,49342,8752,40590,40590,0,12,7575000.0
7575,7575999,20.98889303913907,37.5196665444205,0.08613629681624868,1406.6317677497864,513.9149096012115,1250.9792022705078,49352,8753,40599,40599,0,12,7576000.0
7576,7576999,20.989063897990242,37.520294241917874,0.08614740386572906,1406.8685562610626,513.9789552688599,1251.0953826904297,49364,8754,40610,40610,0,12,7577000.0
7577,7577999,20.98978654108571,37.52175684577349,0.08615893025112231,1406.9936587810516,514.0431389808655,1251.2357139587402,49364,8754,40610,40610,0,12,7578000.0
7578,7578999,20.991382336180926,37.524914061424646,0.08612825447110661,1407.1103019714355,514.106508731842,1251.4589881896973,49365,8754,40611,40611,0,12,7579000.0
7579,7579999,20.993011507858004,37.53086586637618,0.08611877697040748,1407.3407888412476,514.1699740886688,1251.5470962524414,49377,8755,40622,40622,0,12,7580000.0
7580,7580999,20.994194221008435,37.53254498164682,0.08609903815140063,1407.6932373046875,514.2339742183685,1251.5461692810059,49399,8757,40642,40642,0,12,7581000.0
7581,7581999,20.995044891192805,37.533846965667095,0.08610782559624619,1407.9253242015839,514.2975294589996,1251.7104454040527,49407,8758,40649,40649,0,12,7582000.0
7582,7582999,20.994390183814733,37.532686888933426,0.086102266444398,1408.3830716609955,514.3639385700226,1252.1823921203613,49423,8761,40662,40662,0,12,7583000.0
7583,7583999,20.994060868097698,37.532636481795194,0.08608601795546589,1408.6277964115143,514.429027557373,1252.457160949707,49425,8762,40663,40663,0,12,7584000.0
7584,7584999,20.993849169534617,37.532432758160645,0.08607294509147145,1409.2166464328766,514.4960243701935,1252.5510139465332,49445,8766,40679,40679,0,12,7585000.0
7585,7585999,20.993525126683558,37.53202110061806,0.08605831402057851,1409.565640926361,514.5615093708038,1252.7316436767578,49455,8768,40687,40687,0,12,7586000.0
7586,7586999,20.99333891237643,37.53110615889218,0.08604952886855888,1409.7852771282196,514.6251301765442,1253.2386512756348,49467,8769,40698,40698,0,12,7587000.0
7587,7587999,20.993291832197958,37.5306568031369,0.0860397028032468,1409.9109132289886,514.6906831264496,1253.511318206787,49467,8769,40698,40698,0,12,7588000.0
7588,7588999,20.993343665024767,37.53056134115546,0.08602963387769258,1410.023776292801,514.7557399272919,1253.667106628418,49467,8769,40698,40698,0,12,7589000.0
7589,7589999,20.993759806733777,37.53119659870438,0.08601679389235861,1410.1405143737793,514.8212189674377,1253.8595428466797,49467,8769,40698,40698,0,12,7590000.0
7590,7590999,20.994521983069674,37.5328326682915,0.08602027224099418,1410.3722522258759,514.8865122795105,1253.9656524658203,49469,8770,40699,40699,0,12,7591000.0
7591,7591999,20.995419049869565,37.53469563892032,0.08601788261721399,1410.6209104061127,514.9525194168091,1254.3391609191895,49474,8771,40703,40703,0,12,7592000.0
7592,7592999,20.996318204873408,37.5366143749218,0.08601964083907265,1410.962926864624,515.0175676345825,1254.5786972045898,49478,8773,40705,40705,0,12,7593000.0
7593,7593999,20.997618191280726,37.53930780113845,0.08601413445618611,1411.0818710327148,515.0820188522339,1254.7835235595703,49478,8773,40705,40705,0,12,7594000.0
7594,7594999,20.99919976058522,37.542407457474425,0.08601116672035891,1411.4318273067474,515.1489553451538,1254.817470550537,49482,8775,40707,40707,0,12,7595000.0
7595,7595999,21.001071703924012,37.54621869698632,0.08603487471271776,1411.5540912151337,515.2137370109558,1254.9926948547363,49482,8775,40707,40707,0,12,7596000.0
7596,7596999,21.003101615047246,37.55032942059933,0.08604742295271484,1411.6746788024902,515.2777452468872,1255.1157722473145,49482,8775,40707,40707,0,12,7597000.0
7597,7597999,21.004793297174658,37.5531464018291,0.0860568605685258,1411.9182035923004,515.3433651924133,1255.3940048217773,49492,8776,40716,40716,0,12,7598000.0
7598,7598999,21.00626057290296,37.55558636333204,0.0860567228308341,1412.155642747879,515.4087517261505,1255.5260734558105,49494,8777,40717,40717,0,12,7599000.0
7599,7599999,21.008045418824466,37.55829720288096,0.08606001676536967,1412.273458480835,515.4728057384491,1255.6576805114746,49494,8777,40717,40717,0,12,7600000.0
7600,7600999,21.009015859363586,37.55968177593754,0.08605974356535606,1412.3967263698578,515.5362401008606,1255.7673568725586,49494,8777,40717,40717,0,12,7601000.0
7601,7601999,21.00865790101029,37.560001541449736,0.08604601668789691,1412.6309752464294,515.6008532047272,1256.2025451660156,49502,8778,40724,40724,0,12,7602000.0
7602,7602999,21.007998797054217,37.55910994111564,0.0860357064153392,1412.7473216056824,519.8748331069946,1256.439281463623,49502,8778,40724,40724,0,12,7603000.0
7603,7603999,21.007393499561655,37.55805144214917,0.08602998307902743,1412.977819442749,519.9379990100861,1256.5531921386719,49504,8779,40725,40725,0,12,7604000.0
7604,7604999,21.0070583535057,37.55799503155485,0.08601931466908042,1413.724023103714,520.0040655136108,1256.5299110412598,49524,8784,40740,40740,0,12,7605000.0
7605,7605999,21.006618787727902,37.55699936838026,0.08601095398611092,1413.8613905906677,520.0730619430542,1257.0035934448242,49526,8784,40742,40742,0,12,7606000.0
7606,7606999,21.00614038093609,37.55570984840939,0.08600279882917716,1414.1017293930054,520.1381697654724,1257.2302589416504,49537,8785,40752,40752,0,12,7607000.0
7607,7607999,21.005636101879094,37.55438159084479,0.0859946171345024,1414.2129034996033,520.2031865119934,1257.4313926696777,49537,8785,40752,40752,0,12,7608000.0
7608,7608999,21.005279903086745,37.55367237657141,0.08598258070358178,1414.326759815216,520.2695829868317,1257.5487251281738,49537,8785,40752,40752,0,12,7609000.0
7609,7609999,21.004992521507205,37.55269377855857,0.08596808488604346,1414.4618425369263,520.3350775241852,1257.714744567871,49538,8785,40753,40753,0,12,7610000.0
7610,7610999,21.004551143563422,37.551563823090085,0.08596044140983417,1414.5894618034363,520.4002845287323,1257.8307151794434,49538,8785,40753,40753,0,12,7611000.0
7611,7611999,21.00435894168559,37.550565674402606,0.08594529960251518,1414.9732286930084,520.4669940471649,1258.0896301269531,49543,8787,40756,40756,0,12,7612000.0
7612,7612999,21.00418258528423,37.54978783939513,0.08593842257795836,1415.2146079540253,520.5347919464111,1258.250400543213,49556,8788,40768,40768,0,12,7613000.0
7613,7613999,21.004100347776973,37.54904254999339,0.08592898302821972,1415.4577538967133,520.5992650985718,1258.3369407653809,49559,8789,40770,40770,0,12,7614000.0
7614,7614999,21.004141144173015,37.548428644210524,0.08591611527236065,1415.712480545044,520.6676638126373,1258.3996543884277,49569,8790,40779,40779,0,12,7615000.0
7615,7615999,21.00419701107102,37.54777359910264,0.0859105918896157,1415.8311412334442,520.7324678897858,1258.5026473999023,49569,8790,40779,40779,0,12,7616000.0
7616,7616999,21.004324315745087,37.547131999287686,0.08591354547204566,1415.968024969101,520.7979776859283,1258.5851860046387,49569,8790,40779,40779,0,12,7617000.0
7617,7617999,21.004818271048084,37.547273451151646,0.0859090240291932,1416.3327622413635,520.8606011867523,1258.9755744934082,49583,8792,40791,40791,0,12,7618000.0
7618,7618999,21.00529042618302,37.548167575225385,0.0858957471074343,1416.4511370658875,520.9279692173004,1259.222755432129,49585,8792,40793,40793,0,12,7619000.0
7619,7619999,21.005792438631854,37.54802947710993,0.08589266017744679,1416.5717513561249,520.9925079345703,1259.412395477295,49586,8792,40794,40794,0,12,7620000.0
7620,7620999,21.005897110699213,37.547182268763,0.0858869727792394,1416.8181781768799,521.0569145679474,1259.4595069885254,49592,8793,40799,40799,0,12,7621000.0
7621,7621999,21.005478672478787,37.54629219253494,0.08587958557599984,1417.073201417923,521.1210463047028,1260.1044425964355,49602,8794,40808,40808,0,12,7622000.0
7622,7622999,21.005015830839987,37.54587974029957,0.08586971995990578,1417.442046403885,521.1870844364166,1260.4812507629395,49612,8796,40816,40816,0,12,7623000.0
7623,7623999,21.004498719681976,37.544618382898406,0.08586449557945985,1417.6751759052277,521.250725030899,1260.6936569213867,49615,8797,40818,40818,0,12,7624000.0
7624,7624999,21.00437821609049,37.54452893405646,0.08584565880612205,1418.031908273697,521.3167684078217,1260.9617195129395,49634,8799,40835,40835,0,12,7625000.0
7625,7625999,21.00400960749792,37.54429562261181,0.0858317869710652,1418.1700174808502,521.3871078491211,1261.3155670166016,49638,8799,40839,40839,0,12,7626000.0
7626,7626999,21.003827793178182,37.54381687533941,0.08581804714863828,1418.2923221588135,521.450747013092,1261.4977989196777,49638,8799,40839,40839,0,12,7627000.0
7627,7627999,21.003693232481996,37.54319266359355,0.08580080989937588,1418.532024383545,521.5161414146423,1261.6028175354004,49640,8800,40840,40840,0,12,7628000.0
7628,7628999,21.00382854464395,37.54332045201021,0.08578566142596566,1418.6506090164185,521.5816044807434,1261.7939834594727,49640,8800,40840,40840,0,12,7629000.0
7629,7629999,21.00389657080651,37.54313648565027,0.08577299134759053,1418.7755002975464,521.6483047008514,1262.0956726074219,49640,8800,40840,40840,0,12,7630000.0
7630,7630999,21.00453931348978,37.544033390374906,0.08575171527859204,1418.9036746025085,521.7141396999359,1262.3780097961426,49641,8800,40841,40841,0,12,7631000.0
7631,7631999,21.004990422484276,37.54423473839453,0.0857409359817668,1419.024204492569,521.7801249027252,1262.524513244629,49642,8800,40842,40842,0,12,7632000.0
7632,7632999,21.005926075487956,37.54576865211495,0.08572953828139329,1419.2763516902924,521.8453617095947,1262.580665588379,49646,8801,40845,40845,0,12,7633000.0
7633,7633999,21.006677164082525,37.546606409543514,0.08571938904889376,1419.6346917152405,521.9107246398926,1262.6081275939941,49661,8803,40858,40858,0,12,7634000.0
7634,7634999,21.00739735047538,37.54749382157818,0.08571751517712656,1420.12056183815,521.9758849143982,1262.8044929504395,49673,8806,40867,40867,0,12,7635000.0
7635,7635999,21.007879867989686,37.54779741650062,0.08571776347778837,1420.2446055412292,522.0405700206757,1262.968906402588,49673,8806,40867,40867,0,12,7636000.0
7636,7636999,21.008358143290028,37.548197587280406,0.08571295247332789,1420.492380619049,522.1059873104095,1263.3213195800781,49682,8807,40875,40875,0,12,7637000.0
7637,7637999,21.00794502233358,37.54852288329318,0.08570448805446595,1420.6135621070862,522.1708781719208,1263.6699829101562,49685,8807,40878,40878,0,12,7638000.0
7638,7638999,21.007660590960754,37.54858595202265,0.08569750975027379,1420.966236591339,522.2361834049225,1263.8014488220215,49690,8809,40881,40881,0,12,7639000.0
7639,7639999,21.00709095487523,37.548630410111656,0.08569413061851461,1421.208240032196,522.3023843765259,1264.0001258850098,49699,8810,40889,40889,0,12,7640000.0
7640,7640999,21.00637237080829,37.5472303356517,0.08569546998044486,1421.5714020729065,522.3695225715637,1264.2915573120117,49704,8812,40892,40892,0,12,7641000.0
7641,7641999,21.005794261853353,37.54612489643832,0.08569526764634383,1421.6931064128876,522.4362351894379,1264.4782600402832,49704,8812,40892,40892,0,12,7642000.0
7642,7642999,21.005091701916804,37.54476954993729,0.08569731337153907,1421.8156588077545,522.5010492801666,1264.5962257385254,49704,8812,40892,40892,0,12,7643000.0
7643,7643999,21.004464834451174,37.54341505101438,0.08569728342198601,1421.9352493286133,522.566153049469,1264.729965209961,49704,8812,40892,40892,0,12,7644000.0
7644,7644999,21.003937416812303,37.54246736233005,0.08569692440619703,1422.1852841377258,522.6316738128662,1264.8323211669922,49735,8813,40922,40922,0,12,7645000.0
7645,7645999,21.003377589402174,37.54110999970646,0.08569324294888525,1422.4306190013885,522.6991674900055,1265.0812683105469,49740,8814,40926,40926,0,12,7646000.0
7646,7646999,21.00303022001575,37.54042055731168,0.08568993795578461,1422.7828476428986,522.7643232345581,1265.1831436157227,49748,8816,40932,40932,0,12,7647000.0
7647,7647999,21.00253829080515,37.53923384772009,0.08568486554551269,1423.0265181064606,522.8302030563354,1265.3091659545898,49751,8817,40934,40934,0,12,7648000.0
7648,7648999,21.002026694404925,37.537819961455924,0.08568117059142055,1423.2672426700592,522.8961200714111,1265.3944549560547,49753,8818,40935,40935,0,12,7649000.0
7649,7649999,21.00160529788003,37.53674747963651,0.08567991037901757,1423.632428407669,522.9625296592712,1265.3998985290527,49759,8820,40939,40939,0,12,7650000.0
7650,7650999,21.00126972874657,37.53575139151368,0.08567452991126034,1423.9908602237701,523.0264792442322,1265.4854888916016,49763,8822,40941,40941,0,12,7651000.0
7651,7651999,21.000884023933178,37.53463497669708,0.08566777635769174,1424.1156587600708,523.09153175354,1265.837013244629,49765,8822,40943,40943,0,12,7652000.0
7652,7652999,21.000682201761087,37.53375908616784,0.08565904170509953,1424.354476928711,523.1567571163177,1265.9972381591797,49775,8823,40952,40952,0,12,7653000.0
7653,7653999,21.000415030695898,37.5328729101514,0.08565539498559838,1424.483355998993,523.221132516861,1266.0965156555176,49775,8823,40952,40952,0,12,7654000.0
7654,7654999,21.00001933014588,37.53167345425813,0.08565451565760063,1424.6073696613312,523.2856798171997,1266.1949081420898,49775,8823,40952,40952,0,12,7655000.0
7655,7655999,20.999933011262538,37.53504453956635,0.08563065630131539,1425.101612329483,523.3481035232544,1266.478889465332,49814,8826,40988,40988,0,12,7656000.0
7656,7656999,20.999547906930054,37.534966100537034,0.08561994474849921,1425.2191524505615,523.4121925830841,1266.7252807617188,49815,8826,40989,40989,0,12,7657000.0
7657,7657999,20.999127634808996,37.535067137252,0.08561239809205745,1425.350210428238,523.476450920105,1266.9205932617188,49817,8826,40991,40991,0,12,7658000.0
7658,7658999,20.998690957348458,37.53419584678158,0.08560969188016099,1425.5893852710724,523.5423238277435,1266.9697914123535,49829,8827,41002,41002,0,12,7659000.0
7659,7659999,20.999093864861837,37.53488060587748,0.08558100550309056,1425.861069202423,523.6098258495331,1267.234432220459,49833,8828,41005,41005,0,12,7660000.0
7660,7660999,20.999637573396818,37.535462008606906,0.08557483455927783,1426.1023726463318,523.6747543811798,1267.3946228027344,49836,8829,41007,41007,0,12,7661000.0
7661,7661999,21.000298704120677,37.53603637018504,0.08557630216477463,1426.2308974266052,523.7391910552979,1267.5684280395508,49836,8829,41007,41007,0,12,7662000.0
7662,7662999,21.001011964245226,37.5371415163399,0.08558087593111408,1426.4744112491608,523.8051731586456,1267.6754035949707,49839,8830,41009,41009,0,12,7663000.0
7663,7663999,21.00164288037143,37.53786648685754,0.08557810256947196,1426.8402931690216,523.8699061870575,1267.7333793640137,49851,8832,41019,41019,0,12,7664000.0
7664,7664999,21.002445179912076,37.53857607849361,0.08559031561379793,1426.9646573066711,523.9359874725342,1267.886474609375,49851,8832,41019,41019,0,12,7665000.0
7665,7665999,21.00363331790934,37.54038778337318,0.085583404733659,1427.2134156227112,524.0004150867462,1268.172836303711,49865,8833,41032,41032,0,12,7666000.0
7666,7666999,21.00501489122187,37.5429040940291,0.08558770624205314,1427.5823957920074,524.0640997886658,1268.0961570739746,49873,8835,41038,41038,0,12,7667000.0
7667,7667999,21.00596420118718,37.54399562455934,0.085592208047794,1427.8313519954681,524.1304750442505,1268.307502746582,49883,8836,41047,41047,0,12,7668000.0
7668,7668999,21.00762808662803,37.54682566920094,0.08562103673316257,1427.9555752277374,524.195068359375,1268.4792289733887,49883,8836,41047,41047,0,12,7669000.0
7669,7669999,21.008901857144632,37.54857602207645,0.08564033602998034,1428.0764033794403,524.2588977813721,1268.6338195800781,49884,8836,41048,41048,0,12,7670000.0
7670,7670999,21.010486005734574,37.5511688725501,0.08566676435799947,1428.212572813034,524.3221809864044,1268.8110122680664,49884,8836,41048,41048,0,12,7671000.0
7671,7671999,21.012620164753542,37.55554280548379,0.08566019829124549,1428.337172985077,524.3879842758179,1268.9470443725586,49884,8836,41048,41048,0,12,7672000.0
7672,7672999,21.014462460707847,37.558591432334985,0.085669905823477,1428.45374751091,524.4512417316437,1269.0699882507324,49884,8836,41048,41048,0,12,7673000.0
7673,7673999,21.01623836074974,37.56118818593535,0.08567496879706848,1428.5854818820953,524.5174431800842,1269.1354484558105,49884,8836,41048,41048,0,12,7674000.0
7674,7674999,21.01695415366099,37.56204250388216,0.08567883363734496,1428.7265448570251,524.5842022895813,1269.593635559082,49888,8836,41052,41052,0,12,7675000.0
7675,7675999,21.01670613496073,37.5616649383781,0.08566396321355862,1428.9670798778534,524.6488687992096,1270.0177192687988,49893,8837,41056,41056,0,12,7676000.0
7676,7676999,21.016590172556462,37.561611385762276,0.0856511651704488,1429.2008998394012,524.7139468193054,1270.2646827697754,49906,8838,41068,41068,0,12,7677000.0
7677,7677999,21.016616401243567,37.5618519664537,0.08563665552279698,1429.3340125083923,524.7794961929321,1270.5216979980469,49907,8838,41069,41069,0,12,7678000.0
7678,7678999,21.016551324158467,37.561370478887,0.08562200939567521,1429.5821208953857,524.846447467804,1270.806827545166,49910,8839,41071,41071,0,12,7679000.0
7679,7679999,21.017072486998835,37.561795238102555,0.08560374944431792,1429.6946785449982,524.9096274375916,1271.1564903259277,49912,8839,41073,41073,0,12,7680000.0
7680,7680999,21.01737618472572,37.56157832853904,0.08559806567519235,1429.8061771392822,524.9756627082825,1271.3632202148438,49912,8839,41073,41073,0,12,7681000.0
7681,7681999,21.017609948046488,37.56184493973513,0.08559131013534393,1430.1567397117615,525.0404438972473,1271.4672927856445,49920,8841,41079,41079,0,12,7682000.0
7682,7682999,21.018147107656322,37.5623928868751,0.08558621810035227,1430.5030353069305,525.1059195995331,1271.5930442810059,49938,8843,41095,41095,0,12,7683000.0
7683,7683999,21.01909147514691,37.563883522152565,0.08557962635468663,1430.7417726516724,525.1706190109253,1271.8399200439453,49950,8844,41106,41106,0,12,7684000.0
7684,7684999,21.019947403651763,37.564718154356655,0.08558441547257178,1430.9854443073273,525.2386376857758,1272.2368202209473,49964,8845,41119,41119,0,12,7685000.0
7685,7685999,21.020919943452448,37.565693921658905,0.08558518554736616,1431.3435995578766,525.3041205406189,1272.3794784545898,49974,8847,41127,41127,0,12,7686000.0
7686,7686999,21.021635973071312,37.56621165328802,0.08559504634758996,1431.4730381965637,525.368810415268,1272.5775413513184,49975,8847,41128,41128,0,12,7687000.0
7687,7687999,21.02280919046978,37.56770952247736,0.08561781446626848,1431.5951430797577,525.4331047534943,1272.7011528015137,49975,8847,41128,41128,0,12,7688000.0
7688,7688999,21.023997802795297,37.56894512280718,0.08564106136059246,1432.1995193958282,525.501876115799,1272.6862258911133,50006,8851,41155,41155,0,12,7689000.0
7689,7689999,21.02505650215413,37.570142644511876,0.0856602673019411,1432.3204247951508,525.5663619041443,1272.9579315185547,50007,8851,41156,41156,0,12,7690000.0
7690,7690999,21.026051207961206,37.57133086266175,0.08566958142498915,1432.43847322464,525.6308827400208,1273.1135330200195,50007,8851,41156,41156,0,12,7691000.0
7691,7691999,21.02659006271317,37.5715647445808,0.08569008185111648,1432.8954951763153,525.6950325965881,1273.1498527526855,50013,8854,41159,41159,0,12,7692000.0
7692,7692999,21.02696020791065,37.57133090926807,0.08569430585165394,1433.2391605377197,525.7595579624176,1273.1937103271484,50017,8856,41161,41161,0,12,7693000.0
7693,7693999,21.026776211347848,37.5706977025478,0.08568557798083098,1433.7290649414062,525.8278179168701,1273.4909362792969,50042,8859,41183,41183,0,12,7694000.0
7694,7694999,21.026087433270554,37.57108512066438,0.08567665491005394,1433.955724477768,525.892956495285,1273.7432403564453,50054,8860,41194,41194,0,12,7695000.0
7695,7695999,21.0255080258484,37.57078976900582,0.08567385281519646,1434.304899930954,525.9604527950287,1273.9073333740234,50073,8862,41211,41211,0,12,7696000.0
7696,7696999,21.024724257031114,37.569533424698974,0.08567224000312434,1434.6638395786285,526.0258479118347,1274.0610389709473,50088,8864,41224,41224,0,12,7697000.0
7697,7697999,21.0240773266582,37.56849083415238,0.085666624460632,1434.7917094230652,526.093663930893,1274.4017219543457,50091,8864,41227,41227,0,12,7698000.0
7698,7698999,21.023616566418784,37.56739043075148,0.08566150776211812,1434.909509897232,526.1602077484131,1274.6363792419434,50091,8864,41227,41227,0,12,7699000.0
7699,7699999,21.02302989051734,37.56604402513931,0.08566556478148146,1435.0243964195251,526.2234904766083,1274.8200492858887,50091,8864,41227,41227,0,12,7700000.0
7700,7700999,21.022521191358845,37.56482483395109,0.08566810708691008,1435.3803372383118,526.2892603874207,1274.8404846191406,50095,8866,41229,41229,0,12,7701000.0
7701,7701999,21.022358918781315,37.56482480508337,0.08566514745209752,1435.6260612010956,526.3556215763092,1275.0198707580566,50102,8867,41235,41235,0,12,7702000.0
7702,7702999,21.022364038090505,37.564408933883634,0.0856718081117458,1435.7501120567322,526.4204573631287,1275.1643524169922,50102,8867,41235,41235,0,12,7703000.0
7703,7703999,21.022441759193278,37.56404822932016,0.08567118035619214,1435.8661801815033,526.4866759777069,1275.4229011535645,50103,8867,41236,41236,0,12,7704000.0
7704,7704999,21.022648969956197,37.564120555406106,0.08567440162172935,1436.0997264385223,526.5513067245483,1275.5447387695312,50115,8868,41247,41247,0,12,7705000.0
7705,7705999,21.022939569466345,37.56409072468901,0.08567731038597337,1436.344251871109,526.6160748004913,1275.601001739502,50125,8869,41256,41256,0,12,7706000.0
7706,7706999,21.023745103583607,37.56508099316514,0.08568352569887228,1436.6953041553497,526.6810369491577,1275.592487335205,50132,8871,41261,41261,0,12,7707000.0
7707,7707999,21.02426787906248,37.5654414091329,0.08569553650792139,1437.0355360507965,526.7462015151978,1275.686321258545,50145,8873,41272,41272,0,12,7708000.0
7708,7708999,21.02505330536658,37.56609274915671,0.08570828787054141,1437.2797718048096,526.8130083084106,1275.8964385986328,50158,8874,41284,41284,0,12,7709000.0
7709,7709999,21.026085810974124,37.567096022254375,0.08571212313306842,1437.397888660431,526.8765602111816,1276.0609703063965,50158,8874,41284,41284,0,12,7710000.0
7710,7710999,21.02661977275528,37.56709762227599,0.08571591950118407,1437.519377231598,526.9405319690704,1276.2009353637695,50158,8874,41284,41284,0,12,7711000.0
7711,7711999,21.02711697644069,37.567618062128936,0.08571311393516723,1437.9831776618958,527.0051872730255,1276.200527191162,50164,8877,41287,41287,0,12,7712000.0
7712,7712999,21.026992991748266,37.566674287574976,0.08571023355075635,1438.1086988449097,527.0697906017303,1276.5673446655273,50167,8877,41290,41290,0,12,7713000.0
7713,7713999,21.02648289947815,37.56675569713869,0.0856965282332145,1438.2333931922913,527.1381297111511,1276.8645324707031,50168,8877,41291,41291,0,12,7714000.0
7714,7714999,21.02609282124855,37.56620952139805,0.08568681367317066,1438.3488578796387,527.2031588554382,1277.0338554382324,50168,8877,41291,41291,0,12,7715000.0
7715,7715999,21.02555528840835,37.565353563151014,0.0856809228654073,1438.8343250751495,527.2696211338043,1277.059585571289,50192,8880,41312,41312,0,12,7716000.0
7716,7716999,21.025016619667934,37.5641742117289,0.0856721512528047,1439.0691022872925,527.3346190452576,1277.2447090148926,50205,8881,41324,41324,0,12,7717000.0
7717,7717999,21.024912959303755,37.56395451739592,0.08565838236102608,1439.3127369880676,527.4019870758057,1277.5748405456543,50212,8882,41330,41330,0,12,7718000.0
7718,7718999,21.02450694427639,37.56279584419986,0.08564533110419426,1439.7689645290375,527.4662189483643,1277.648983001709,50227,8885,41342,41342,0,12,7719000.0
7719,7719999,21.024421113503063,37.56221923994762,0.08562569871379733,1440.004686832428,527.531121969223,1277.7879524230957,50239,8886,41353,41353,0,12,7720000.0
7720,7720999,21.02425985732446,37.56146613783934,0.08560096173625864,1440.121318101883,527.5954167842865,1277.9414100646973,50239,8886,41353,41353,0,12,7721000.0
7721,7721999,21.02424437317858,37.56079169684237,0.08557747522951131,1440.3568353652954,527.6602096557617,1278.0485801696777,50243,8887,41356,41356,0,12,7722000.0
7722,7722999,21.02436073557669,37.56018014208196,0.08554871053059898,1440.5943892002106,527.7253220081329,1278.377670288086,50257,8888,41369,41369,0,12,7723000.0
7723,7723999,21.024722586730288,37.5598650825333,0.08550299771147307,1440.9388976097107,527.7904307842255,1278.5831985473633,50261,8890,41371,41371,0,12,7724000.0
7724,7724999,21.024993281057935,37.559446964112155,0.08546802354536265,1441.060123205185,527.8560547828674,1278.7720489501953,50261,8890,41371,41371,0,12,7725000.0
7725,7725999,21.025454463946723,37.55941358930786,0.08543822790765065,1441.2929649353027,527.9208335876465,1278.8766593933105,50263,8891,41372,41372,0,12,7726000.0
7726,7726999,21.025752883896516,37.55948142889954,0.08541303975721792,1441.4162650108337,527.9855265617371,1279.033992767334,50263,8891,41372,41372,0,12,7727000.0
7727,7727999,21.026160424099885,37.55922933028755,0.08538548041799332,1441.660407781601,528.0511646270752,1279.1088027954102,50275,8892,41383,41383,0,12,7728000.0
7728,7728999,21.026890573630684,37.559466474735494,0.08533521033839642,1441.7826571464539,528.1154038906097,1279.403751373291,50275,8892,41383,41383,0,12,7729000.0
7729,7729999,21.027999739119828,37.56001355044446,0.08527851772267614,1442.0135424137115,528.180412530899,1279.5597038269043,50277,8893,41384,41384,0,12,7730000.0
7730,7730999,21.028703474939533,37.55985259442362,0.08523426786335309,1442.2535762786865,528.244517326355,1279.682445526123,50279,8894,41385,41385,0,12,7731000.0
7731,7731999,21.029000463856722,37.559127549408025,0.08520736217855762,1442.4941828250885,528.3100426197052,1279.7607040405273,50283,8895,41388,41388,0,12,7732000.0
7732,7732999,21.028701225449698,37.558106332921035,0.08519844588979153,1442.8490438461304,528.3758723735809,1280.2195930480957,50300,8897,41403,41403,0,12,7733000.0
7733,7733999,21.02773150603247,37.556372031674826,0.08520055364044232,1442.961796283722,528.4403147697449,1280.5725708007812,50301,8897,41404,41404,0,12,7734000.0
7734,7734999,21.02676527834294,37.554747283255175,0.08520268021580302,1443.4195401668549,528.5050966739655,1280.7154960632324,50308,8900,41408,41408,0,12,7735000.0
7735,7735999,21.026148361762267,37.55410351818086,0.08519806749599446,1443.6527841091156,528.5712871551514,1280.9908561706543,50311,8901,41410,41410,0,12,7736000.0
7736,7736999,21.0257264835258,37.55332326184887,0.08519069899499099,1443.8877110481262,528.6367700099945,1281.2616729736328,50324,8902,41422,41422,0,12,7737000.0
7737,7737999,21.025373639455566,37.55299801896609,0.0851864307143444,1444.0049471855164,528.7021484375,1281.5567779541016,50324,8902,41422,41422,0,12,7738000.0
7738,7738999,21.025031886430774,37.552679873631895,0.08517747127971675,1444.2340166568756,528.767947435379,1281.710521697998,50326,8903,41423,41423,0,12,7739000.0
7739,7739999,21.02489638372055,37.55279907000584,0.08517142078223328,1444.594441652298,528.8346436023712,1281.7907676696777,50340,8905,41435,41435,0,12,7740000.0
7740,7740999,21.02478231483625,37.55275421869284,0.08516468279325162,1444.8308095932007,528.9003765583038,1281.9177780151367,50343,8906,41437,41437,0,12,7741000.0
7741,7741999,21.02483255332584,37.553889162668334,0.08515219062114032,1445.065432548523,528.9641470909119,1282.072826385498,50348,8907,41441,41441,0,12,7742000.0
7742,7742999,21.025305817099504,37.55542384692071,0.08513932797547363,1445.1843881607056,529.0292248725891,1282.455078125,50349,8907,41442,41442,0,12,7743000.0
7743,7743999,21.025555149412693,37.555509215373355,0.08512865611192799,1445.4131948947906,529.0946538448334,1282.6508255004883,50351,8908,41443,41443,0,12,7744000.0
7744,7744999,21.025734995246218,37.555805337094604,0.08512078206080487,1445.639343738556,529.1596264839172,1282.7991104125977,50362,8909,41453,41453,0,12,7745000.0
7745,7745999,21.026537018556464,37.55806794978344,0.08510682279228832,1445.7587440013885,529.2247076034546,1282.917079925537,50362,8909,41453,41453,0,12,7746000.0
7746,7746999,21.02692950279957,37.560009897708724,0.08509876895116986,1446.3401515483856,529.2904162406921,1282.8716850280762,50381,8913,41468,41468,0,12,7747000.0
7747,7747999,21.027364472993977,37.560275783962275,0.08509603248144415,1446.6989200115204,529.3563413619995,1282.9470252990723,50385,8915,41470,41470,0,12,7748000.0
7748,7748999,21.028184667782046,37.561261067428546,0.08508784485991827,1446.8281104564667,529.4240067005157,1283.5015830993652,50385,8915,41470,41470,0,12,7749000.0
7749,7749999,21.02886082049537,37.56159687400154,0.08508492759788966,1446.944501399994,529.4920470714569,1283.7797241210938,50385,8915,41470,41470,0,12,7750000.0
7750,7750999,21.029526663294412,37.56185201731332,0.08509034929480241,1447.060269355774,529.5562465190887,1283.9737701416016,50385,8915,41470,41470,0,12,7751000.0
7751,7751999,21.02988053314222,37.56174048778655,0.08509224096636803,1447.4050500392914,529.6213836669922,1284.0419692993164,50392,8917,41475,41475,0,12,7752000.0
7752,7752999,21.029694138124185,37.56130437335363,0.08508611559215273,1447.7694294452667,529.6869082450867,1284.7154693603516,50423,8919,41504,41504,0,12,7753000.0
7753,7753999,21.029193118490355,37.56072188762556,0.08508333001967372,1448.0033497810364,529.7537474632263,1284.998462677002,50426,8920,41506,41506,0,12,7754000.0
7754,7754999,21.02863336433714,37.55953673004825,0.08508643852410513,1448.1190829277039,529.8191831111908,1285.2454299926758,50426,8920,41506,41506,0,12,7755000.0
7755,7755999,21.02821906442586,37.55859288732493,0.08508344612701291,1448.2466900348663,529.8873991966248,1285.580898284912,50429,8920,41509,41509,0,12,7756000.0
7756,7756999,21.027621968191994,37.557336182268116,0.08508327749865019,1448.3663024902344,529.9520664215088,1285.8408164978027,50430,8920,41510,41510,0,12,7757000.0
7757,7757999,21.02718512873785,37.55628702812602,0.08508040674797845,1448.4847366809845,530.016851902008,1286.011619567871,50430,8920,41510,41510,0,12,7758000.0
7758,7758999,21.02662292798633,37.55499968109664,0.08507706942442494,1448.6064434051514,530.0820784568787,1286.1309204101562,50430,8920,41510,41510,0,12,7759000.0
7759,7759999,21.026109829561587,37.55392467013342,0.08507483012402595,1448.7295863628387,530.1471552848816,1286.2641944885254,50430,8920,41510,41510,0,12,7760000.0
7760,7760999,21.025953326224467,37.55325329341578,0.08506765680938722,1448.9727470874786,530.2121052742004,1286.5332069396973,50435,8921,41514,41514,0,12,7761000.0
7761,7761999,21.025826751453664,37.552285605854436,0.08505836207736928,1449.091837644577,530.2768256664276,1286.8636741638184,50435,8921,41514,41514,0,12,7762000.0
7762,7762999,21.025687889090275,37.551371591612984,0.08504644345930623,1449.2097539901733,530.3422877788544,1287.0211791992188,50435,8921,41514,41514,0,12,7763000.0
7763,7763999,21.02559070969993,37.55054432909093,0.08504395247812346,1449.448311328888,530.4080362319946,1287.0772590637207,50437,8922,41515,41515,0,12,7764000.0
7764,7764999,21.0254283556901,37.54946825937895,0.08503686344888484,1449.5688905715942,530.4727740287781,1287.207675933838,50437,8922,41515,41515,0,12,7765000.0
7765,7765999,21.025274399518995,37.548442130146945,0.08502578977300412,1449.825264930725,530.5386204719543,1287.4951515197754,50441,8923,41518,41518,0,12,7766000.0
7766,7766999,21.025021998817277,37.54727130189471,0.08501837419787706,1449.9393258094788,530.6032454967499,1287.6684188842773,50441,8923,41518,41518,0,12,7767000.0
7767,7767999,21.02464858773922,37.54689396277621,0.08501116393320818,1450.171138048172,530.6680262088776,1287.762596130371,50445,8924,41521,41521,0,12,7768000.0
7768,7768999,21.025128342716975,37.550263268585866,0.08497569693399165,1450.4007380008698,530.7329585552216,1288.3259735107422,50461,8925,41536,41536,0,12,7769000.0
7769,7769999,21.02532659825014,37.55170828947248,0.08496073655470127,1450.5224471092224,530.7972264289856,1288.6334037780762,50462,8925,41537,41537,0,12,7770000.0
7770,7770999,21.025160300195502,37.55176498947716,0.0849408823211184,1450.7507936954498,530.8618786334991,1288.8458557128906,50465,8926,41539,41539,0,12,7771000.0
7771,7771999,21.025720628277128,37.553708105402976,0.08491722663967105,1450.9872410297394,530.9276223182678,1289.24072265625,50468,8927,41541,41541,0,12,7772000.0
7772,7772999,21.0264224697188,37.555764870806485,0.08488813377755255,1451.3479182720184,530.9941582679749,1289.4124374389648,50481,8929,41552,41552,0,12,7773000.0
7773,7773999,21.026865796362127,37.55662998944712,0.08488004169134533,1451.6920580863953,531.0595107078552,1289.5597534179688,50485,8931,41554,41554,0,12,7774000.0
7774,7774999,21.02764890895407,37.55809509722718,0.08487709002501098,1451.8008816242218,531.124222278595,1289.751262664795,50485,8931,41554,41554,0,12,7775000.0
7775,7775999,21.02877940903511,37.562225418454496,0.08485521281537234,1452.0340790748596,531.1897168159485,1289.8684730529785,50487,8932,41555,41555,0,12,7776000.0
7776,7776999,21.029870879351332,37.56425170135426,0.08483443088329956,1452.2740292549133,531.254980802536,1290.2088012695312,50491,8933,41558,41558,0,12,7777000.0
7777,7777999,21.031371294468467,37.56666840580114,0.08480759698763185,1452.3821494579315,531.3190724849701,1290.4114685058594,50491,8933,41558,41558,0,12,7778000.0
7778,7778999,21.03295409674938,37.56980013190925,0.08478188405249154,1452.7359330654144,531.384626865387,1290.4652976989746,50505,8935,41570,41570,0,12,7779000.0
7779,7779999,21.034571527278175,37.57274004973119,0.08476920188469572,1453.3271462917328,531.4525537490845,1290.480323791504,50513,8939,41574,41574,0,12,7780000.0
7780,7780999,21.036341815508745,37.57609170167194,0.08475319167251483,1453.4490039348602,531.5174555778503,1290.6437644958496,50513,8939,41574,41574,0,12,7781000.0
7781,7781999,21.037757716623958,37.57854259327253,0.08474673178945435,1453.813369512558,531.5825536251068,1290.7149658203125,50527,8941,41586,41586,0,12,7782000.0
7782,7782999,21.03949781063311,37.58193373995437,0.08474412771777129,1453.9276847839355,531.6469597816467,1291.0143432617188,50527,8941,41586,41586,0,12,7783000.0
7783,7783999,21.040979786428284,37.58408540270714,0.08473180483838239,1454.0464375019073,531.7139248847961,1291.1669006347656,50527,8941,41586,41586,0,12,7784000.0
7784,7784999,21.042851554346882,37.58696812797645,0.08474122346011526,1454.1602034568787,531.7792189121246,1291.2682418823242,50527,8941,41586,41586,0,12,7785000.0
7785,7785999,21.04412760239758,37.5885348520282,0.08475020241819997,1454.628571510315,531.8445057868958,1291.229160308838,50542,8944,41598,41598,0,12,7786000.0
7786,7786999,21.04405706314404,37.587746786804935,0.08474431310356856,1454.8641774654388,531.9091534614563,1291.6781616210938,50566,8945,41621,41621,0,12,7787000.0
7787,7787999,21.043551380093408,37.586880485205626,0.08473536112439717,1455.2405087947845,531.9754757881165,1291.910732269287,50591,8947,41644,41644,0,12,7788000.0
7788,7788999,21.043038521931425,37.58600713228381,0.08472852945159615,1455.5859804153442,532.0397548675537,1292.0280647277832,50595,8949,41646,41646,0,12,7789000.0
7789,7789999,21.042590906427932,37.585400038014996,0.08472677464554157,1455.8374736309052,532.1058547496796,1292.2069053649902,50600,8950,41650,41650,0,12,7790000.0
7790,7790999,21.04208494518732,37.58420981731619,0.08472105494678872,1455.9550533294678,532.1708748340607,1292.5228004455566,50601,8950,41651,41651,0,12,7791000.0
7791,7791999,21.041869373920942,37.583515419353255,0.08471776681399645,1456.1999394893646,532.2380933761597,1292.724105834961,50604,8951,41653,41653,0,12,7792000.0
7792,7792999,21.04197780218381,37.583485585619535,0.08471746485420228,1456.3226125240326,532.3015875816345,1292.9327087402344,50604,8951,41653,41653,0,12,7793000.0
7793,7793999,21.04242967247825,37.58505043228262,0.08470649724254808,1456.6798236370087,532.3665444850922,1292.983959197998,50620,8953,41667,41667,0,12,7794000.0
7794,7794999,21.04276302975127,37.585332981018624,0.0847039565002563,1457.0290296077728,532.4315385818481,1293.076072692871,50631,8955,41676,41676,0,12,7795000.0
7795,7795999,21.04340000187754,37.58648972294545,0.08470164927952084,1457.1573622226715,532.4954228401184,1293.2134284973145,50631,8955,41676,41676,0,12,7796000.0
7796,7796999,21.044438076527758,37.58984196524383,0.08468552158420894,1457.3917632102966,532.5596296787262,1293.4817352294922,50643,8956,41687,41687,0,12,7797000.0
7797,7797999,21.045314848246004,37.59103411219784,0.08466830042653384,1457.6405382156372,532.6234655380249,1293.6203269958496,50645,8957,41688,41688,0,12,7798000.0
7798,7798999,21.045909620047926,37.59190696833512,0.08466275001156098,1457.9896438121796,532.687483549118,1293.5878677368164,50652,8959,41693,41693,0,12,7799000.0
7799,7799999,21.046475762047915,37.592549612668755,0.0846600853969105,1458.2187983989716,532.7519648075104,1293.7324104309082,50654,8960,41694,41694,0,12,7800000.0
7800,7800999,21.04745057079449,37.59395897439395,0.08467145743268412,1458.3426613807678,532.8196024894714,1293.9305572509766,50654,8960,41694,41694,0,12,7801000.0
7801,7801999,21.04813777020122,37.59480587335137,0.08467104603513198,1458.5868816375732,532.8865423202515,1294.1840896606445,50664,8961,41703,41703,0,12,7802000.0
7802,7802999,21.048776781541036,37.595108856486725,0.08465835747203965,1458.9387657642365,532.9505033493042,1294.347999572754,50672,8963,41709,41709,0,12,7803000.0
7803,7803999,21.04952415372293,37.59651141534038,0.08464359600039617,1459.1746709346771,533.01575756073,1294.4807624816895,50674,8964,41710,41710,0,12,7804000.0
7804,7804999,21.04971177151681,37.59604055373328,0.08464345362586545,1459.295318365097,533.0820755958557,1294.5793800354004,50674,8964,41710,41710,0,12,7805000.0
7805,7805999,21.04953942416089,37.595815086788996,0.08464534887036901,1459.5422174930573,533.1471025943756,1295.0081405639648,50685,8965,41720,41720,0,12,7806000.0
7806,7806999,21.04878762846311,37.59704929368673,0.08463972941869602,1459.8915750980377,533.2127664089203,1295.337173461914,50707,8967,41740,41740,0,12,7807000.0
7807,7807999,21.047988731429932,37.596108415813525,0.08464143571788463,1460.0077493190765,533.2768213748932,1295.5927429199219,50709,8967,41742,41742,0,12,7808000.0
7808,7808999,21.047118706835068,37.59447959283502,0.08464910356649491,1460.251404762268,533.3433740139008,1295.7339096069336,50720,8968,41752,41752,0,12,7809000.0
7809,7809999,21.046238823364863,37.592833577676586,0.08465114356711378,1460.7220418453217,533.4086647033691,1295.8264274597168,50737,8971,41766,41766,0,12,7810000.0
7810,7810999,21.045777315839548,37.591905967308136,0.08464963769647271,1460.838109254837,533.47287774086,1296.129795074463,50738,8971,41767,41767,0,12,7811000.0
7811,7811999,21.045486757339074,37.59100358249984,0.08464869819964704,1461.0641260147095,533.5372054576874,1296.292881011963,50742,8972,41770,41770,0,12,7812000.0
7812,7812999,21.04561588326668,37.59091502152752,0.0846495806953439,1461.3108127117157,533.6046853065491,1296.3833541870117,50752,8973,41779,41779,0,12,7813000.0
7813,7813999,21.045882201152654,37.59161106748322,0.08464448816659109,1461.7945699691772,533.6712334156036,1296.4414138793945,50767,8976,41791,41791,0,12,7814000.0
7814,7814999,21.046494406384436,37.592564493603206,0.08465090577088374,1462.0315034389496,533.7362914085388,1296.6700439453125,50774,8977,41797,41797,0,12,7815000.0
7815,7815999,21.047214671628552,37.59408492917344,0.08466401067246987,1462.161375284195,533.8025465011597,1296.9914360046387,50776,8977,41799,41799,0,12,7816000.0
7816,7816999,21.04781195713067,37.59515978845272,0.08466880520726783,1462.512985944748,533.8669409751892,1297.1526794433594,50780,8979,41801,41801,0,12,7817000.0
7817,7817999,21.048302799843217,37.59585486593317,0.08467913000311034,1462.6359412670135,533.9319169521332,1297.2973098754883,50780,8979,41801,41801,0,12,7818000.0
7818,7818999,21.04905717660391,37.59798330059641,0.0846825543512405,1462.8749363422394,533.995050907135,1297.3970680236816,50782,8980,41802,41802,0,12,7819000.0
7819,7819999,21.04977152062845,37.59935681894625,0.08470597619891163,1463.115255355835,534.0621159076691,1297.4963340759277,50784,8981,41803,41803,0,12,7820000.0
7820,7820999,21.050279822330484,37.59986846437057,0.08470246453920027,1463.3543133735657,534.1269698143005,1297.7096977233887,50792,8982,41810,41810,0,12,7821000.0
7821,7821999,21.051040478316096,37.60130926859348,0.08470265628706342,1463.4826929569244,534.1917724609375,1297.8769340515137,50792,8982,41810,41810,0,12,7822000.0
7822,7822999,21.05182516349278,37.60306151214837,0.08469953720874013,1463.721881866455,534.2574994564056,1297.9787826538086,50803,8983,41820,41820,0,12,7823000.0
7823,7823999,21.052485122835634,37.60453066259015,0.08469465880052995,1463.963053703308,534.3244385719299,1298.059928894043,50806,8984,41822,41822,0,12,7824000.0
7824,7824999,21.052347153897145,37.60475857699456,0.08468975332938677,1464.2139472961426,534.3889465332031,1298.4331283569336,50818,8985,41833,41833,0,12,7825000.0
7825,7825999,21.05190473985387,37.60404165070337,0.08469027253985273,1464.334447145462,534.456885099411,1298.6303825378418,50818,8985,41833,41833,0,12,7826000.0
7826,7826999,21.051555666077526,37.603128625179984,0.08468196460506272,1464.6933872699738,534.5217604637146,1298.7929458618164,50838,8987,41851,41851,0,12,7827000.0
7827,7827999,21.05116091398434,37.602412812573235,0.08467214976015058,1464.816879272461,534.5855538845062,1298.9408264160156,50839,8987,41852,41852,0,12,7828000.0
7828,7828999,21.050953856209727,37.60193419008246,0.08465792666506644,1465.06893992424,534.6500821113586,1299.26566696167,50853,8988,41865,41865,0,12,7829000.0
7829,7829999,21.050633276435597,37.600912277180726,0.08464873397597605,1465.3087635040283,534.7165749073029,1299.4553604125977,50855,8989,41866,41866,0,12,7830000.0
7830,7830999,21.050380073448768,37.60003062455957,0.08463047777393395,1465.549635887146,534.7798745632172,1299.577564239502,50857,8990,41867,41867,0,12,7831000.0
7831,7831999,21.05014029296193,37.599263739830086,0.0846163927843776,1465.6717891693115,534.8438041210175,1299.7150611877441,50858,8990,41868,41868,0,12,7832000.0
7832,7832999,21.05002043616215,37.598751969900995,0.08460260928856389,1466.047934770584,534.9109263420105,1299.749095916748,50862,8992,41870,41870,0,12,7833000.0
7833,7833999,21.050042452482764,37.59827841397626,0.08458991820153883,1466.1691372394562,534.9755840301514,1300.013988494873,50865,8992,41873,41873,0,12,7834000.0
7834,7834999,21.049954710973235,37.59751338161268,0.08457541685795844,1466.304134607315,535.0423357486725,1300.2087097167969,50865,8992,41873,41873,0,12,7835000.0
7835,7835999,21.04980769709256,37.596615638878596,0.08456183477374712,1466.538253068924,535.1064579486847,1300.3061981201172,50867,8993,41874,41874,0,12,7836000.0
7836,7836999,21.049738959566834,37.595756044986494,0.08455357108870809,1466.78417801857,535.1703720092773,1300.3885688781738,50869,8994,41875,41875,0,12,7837000.0
7837,7837999,21.04952276843503,37.59477451421562,0.08454371292464147,1467.1419236660004,535.2346053123474,1300.3397827148438,50873,8996,41877,41877,0,12,7838000.0
7838,7838999,21.049433512406136,37.593998210549316,0.084534392887464,1467.2726645469666,535.3023898601532,1300.48433303833,50873,8996,41877,41877,0,12,7839000.0
7839,7839999,21.049402828558232,37.59311907365258,0.08452077866285546,1467.3954412937164,535.3665080070496,1300.7421188354492,50875,8996,41879,41879,0,12,7840000.0
7840,7840999,21.049501728810988,37.59225891776608,0.08450285441645433,1467.504287481308,535.4300746917725,1300.8935012817383,50875,8996,41879,41879,0,12,7841000.0
7841,7841999,21.04925098773873,37.59109938202301,0.08449655770742559,1467.6357340812683,535.4966049194336,1300.9859504699707,50875,8996,41879,41879,0,12,7842000.0
7842,7842999,21.048992962892857,37.59052454660249,0.08448526076205509,1468.1053166389465,535.5616745948792,1301.004981994629,50881,8999,41882,41882,0,12,7843000.0
7843,7843999,21.04875074335377,37.59189479245017,0.08448156578517263,1468.2233259677887,535.6250739097595,1301.323715209961,50881,8999,41882,41882,0,12,7844000.0
7844,7844999,21.04822075795789,37.59119642282445,0.08448018349263209,1468.5953986644745,535.6902368068695,1301.348533630371,50894,9001,41893,41893,0,12,7845000.0
7845,7845999,21.047848040989777,37.591133111727025,0.08447750809501242,1469.070590019226,535.7561848163605,1301.4001274108887,50901,9004,41897,41897,0,12,7846000.0
7846,7846999,21.047728982908247,37.59178367019813,0.08446925800901128,1469.5520610809326,535.8228542804718,1301.3713912963867,50910,9007,41903,41903,0,12,7847000.0
7847,7847999,21.04809837754954,37.59298897013164,0.0844675419251335,1469.6852269172668,535.8865859508514,1301.6466255187988,50910,9007,41903,41903,0,12,7848000.0
7848,7848999,21.048282865495747,37.59338477034661,0.08446517707654722,1469.8022537231445,535.9522411823273,1301.805274963379,50910,9007,41903,41903,0,12,7849000.0
7849,7849999,21.04900113995578,37.59511408131828,0.08446980638790158,1470.0459625720978,536.0184059143066,1301.8398551940918,50912,9008,41904,41904,0,12,7850000.0
7850,7850999,21.04978620177508,37.59677930934123,0.08448642365209902,1470.2852742671967,536.0821075439453,1301.9105834960938,50915,9009,41906,41906,0,12,7851000.0
7851,7851999,21.050871104690696,37.599252475949925,0.08449020301102106,1470.540603876114,536.1494166851044,1301.9789390563965,50922,9010,41912,41912,0,12,7852000.0
7852,7852999,21.052457807322224,37.60345540749424,0.08450532549712941,1470.6693375110626,536.2148139476776,1302.1658668518066,50922,9010,41912,41912,0,12,7853000.0
7853,7853999,21.054790003817175,37.61200168726323,0.08452780365196977,1471.029087305069,536.2812702655792,1302.420810699463,50947,9012,41935,41935,0,12,7854000.0
7854,7854999,21.056897234204392,37.617357541443994,0.08454526057372613,1471.4937026500702,536.3450973033905,1302.470085144043,50962,9015,41947,41947,0,12,7855000.0
7855,7855999,21.058029423575288,37.61889576832048,0.08457158757503513,1471.6068348884583,536.4082458019257,1302.6456909179688,50962,9015,41947,41947,0,12,7856000.0
7856,7856999,21.060198452410912,37.62375135488135,0.08461407364848061,1471.8552544116974,536.4742076396942,1302.7109260559082,50964,9016,41948,41948,0,12,7857000.0
7857,7857999,21.061884078054927,37.62764946554247,0.0846472505188195,1472.2448499202728,536.5440320968628,1302.7291564941406,50968,9018,41950,41950,0,12,7858000.0
7858,7858999,21.063581059574744,37.63009254444132,0.08467285438946659,1472.3653583526611,536.6072273254395,1302.9986457824707,50968,9018,41950,41950,0,12,7859000.0
7859,7859999,21.065618536761452,37.63388011718415,0.08470878952968997,1472.5985941886902,536.6742475032806,1303.1232604980469,50970,9019,41951,41951,0,12,7860000.0
7860,7860999,21.06756135688639,37.63729334985609,0.08473846301472943,1472.7203397750854,536.7373697757721,1303.258358001709,50970,9019,41951,41951,0,12,7861000.0
7861,7861999,21.06919751454901,37.63986518545861,0.08478297022061287,1472.9601395130157,536.8011729717255,1303.3345794677734,50972,9020,41952,41952,0,12,7862000.0
7862,7862999,21.069703961885764,37.64065391271368,0.08477366163025346,1473.4369168281555,536.8738965988159,1303.9253463745117,50989,9023,41966,41966,0,12,7863000.0
7863,7863999,21.07040897781171,37.64335604288478,0.08476613167256164,1473.693085193634,536.9457890987396,1304.282455444336,51001,9024,41977,41977,0,12,7864000.0
7864,7864999,21.070956985402386,37.64530616298162,0.08476565598455144,1474.0460016727448,537.0112526416779,1304.5313301086426,51020,9026,41994,41994,0,12,7865000.0
7865,7865999,21.07178888606839,37.647287264027305,0.08475068567976352,1474.2788984775543,537.0762312412262,1304.8318824768066,51034,9027,42007,42007,0,12,7866000.0
7866,7866999,21.072424898679557,37.64857855999114,0.08473172376706795,1474.6336286067963,537.1417071819305,1305.246379852295,51041,9029,42012,42012,0,12,7867000.0
7867,7867999,21.073381128577147,37.65062665251609,0.08471822911118909,1474.760669708252,537.207275390625,1305.5371704101562,51043,9029,42014,42014,0,12,7868000.0
7868,7868999,21.074051752437654,37.65114680737411,0.08471246068184168,1474.9933664798737,537.2722163200378,1305.687297821045,51045,9030,42015,42015,0,12,7869000.0
7869,7869999,21.074923900827397,37.65199947731616,0.08471101517380675,1475.1034140586853,537.336332321167,1305.8808135986328,51046,9030,42016,42016,0,12,7870000.0
7870,7870999,21.076035425544045,37.65367460914597,0.08471103008423164,1475.4801378250122,537.403103351593,1305.9513626098633,51062,9032,42030,42030,0,12,7871000.0
7871,7871999,21.07727605454324,37.6558167034908,0.08471213169384284,1475.5920424461365,537.4676978588104,1306.2653198242188,51065,9032,42033,42033,0,12,7872000.0
7872,7872999,21.07867417307293,37.65781064060132,0.08471918272906853,1475.705626964569,537.531040430069,1306.5998611450195,51065,9032,42033,42033,0,12,7873000.0
7873,7873999,21.0800718504763,37.65985011732643,0.08472996914773356,1475.9505710601807,537.5958406925201,1306.7342567443848,51067,9033,42034,42034,0,12,7874000.0
7874,7874999,21.08180886872733,37.66470711849217,0.08474346500398622,1476.1874434947968,537.6594860553741,1306.8236351013184,51079,9034,42045,42045,0,12,7875000.0
7875,7875999,21.083599199031937,37.668895603967535,0.08474405834542953,1476.4233911037445,537.7245802879333,1306.894676208496,51081,9035,42046,42046,0,12,7876000.0
7876,7876999,21.085347664735103,37.671617551015466,0.0847675971258619,1476.5465095043182,537.7895781993866,1307.0303344726562,51081,9035,42046,42046,0,12,7877000.0
7877,7877999,21.087162809079082,37.67395865479641,0.0847846524756043,1477.132487297058,537.8560800552368,1307.3533935546875,51104,9039,42065,42065,0,12,7878000.0
7878,7878999,21.089230638301178,37.676727448073414,0.08481147519587018,1477.3696115016937,537.9213509559631,1307.6273727416992,51108,9040,42068,42068,0,12,7879000.0
7879,7879999,21.091089875580003,37.67895550456348,0.08483269102712665,1477.4835333824158,537.9859836101532,1307.864429473877,51108,9040,42068,42068,0,12,7880000.0
7880,7880999,21.092192440807242,37.67986273086195,0.08483964474082095,1477.6117684841156,538.0541026592255,1308.027057647705,51108,9040,42068,42068,0,12,7881000.0
7881,7881999,21.092540567899196,37.680031867709225,0.08482868003139932,1478.0843369960785,538.118102312088,1308.6036682128906,51119,9043,42076,42076,0,12,7882000.0
7882,7882999,21.092137813811924,37.679141841328665,0.08482542079242938,1478.4472267627716,538.1855335235596,1308.9678993225098,51133,9045,42088,42088,0,12,7883000.0
7883,7883999,21.091813100669267,37.67904752920788,0.08481725542357177,1478.6780989170074,538.2501244544983,1309.2053146362305,51145,9046,42099,42099,0,12,7884000.0
7884,7884999,21.091418092939612,37.678265798897485,0.08481154889427867,1478.9082329273224,538.3149285316467,1309.404525756836,51158,9047,42111,42111,0,12,7885000.0
7885,7885999,21.090970822635303,37.677275086713536,0.0848100422161,1479.1632618904114,538.3894591331482,1309.785312652588,51163,9048,42115,42115,0,12,7886000.0
7886,7886999,21.09053687571457,37.67616655144338,0.08481144451769185,1479.3915302753448,538.4533314704895,1309.9628372192383,51175,9049,42126,42126,0,12,7887000.0
7887,7887999,21.09047482895841,37.676229104667506,0.08480803701098794,1479.6273682117462,538.5171589851379,1310.065544128418,51186,9050,42136,42136,0,12,7888000.0
7888,7888999,21.090124236470302,37.67537429666154,0.08480636040731993,1479.8722400665283,538.5896711349487,1310.1913566589355,51190,9051,42139,42139,0,12,7889000.0
7889,7889999,21.090171129015925,37.675014954695676,0.08480363906346888,1480.1295938491821,538.6576356887817,1310.2760734558105,51195,9052,42143,42143,0,12,7890000.0
7890,7890999,21.09024486723058,37.676156830183544,0.08479509146183783,1480.4961249828339,538.7226510047913,1310.746150970459,51218,9054,42164,42164,0,12,7891000.0
7891,7891999,21.09030114080686,37.67566853682524,0.0847928352134355,1480.6134974956512,538.7892062664032,1310.9914360046387,51218,9054,42164,42164,0,12,7892000.0
7892,7892999,21.09036958562045,37.6751008165341,0.08479135945776572,1480.8609063625336,538.855260848999,1311.1159629821777,51220,9055,42165,42165,0,12,7893000.0
7893,7893999,21.09028401534157,37.6742298996314,0.08478756163846701,1481.1043255329132,538.9210784435272,1311.2426681518555,51224,9056,42168,42168,0,12,7894000.0
7894,7894999,21.09029594858158,37.673447402482694,0.08478260357501177,1481.5841126441956,538.9870729446411,1311.48099899292,51243,9059,42184,42184,0,12,7895000.0
7895,7895999,21.09008320007122,37.672295540929596,0.08477961972363846,1481.695790052414,539.0513908863068,1311.704517364502,51243,9059,42184,42184,0,12,7896000.0
7896,7896999,21.08967849937327,37.67098279633122,0.08478128944128693,1481.8106515407562,539.1179578304291,1311.844741821289,51243,9059,42184,42184,0,12,7897000.0
7897,7897999,21.08965090811341,37.67052052725959,0.08477022124742217,1482.06121134758,539.1912710666656,1312.2978973388672,51257,9060,42197,42197,0,12,7898000.0
7898,7898999,21.08945262354466,37.67043309745458,0.08475192878804483,1482.3060910701752,539.2629570960999,1312.4789962768555,51269,9061,42208,42208,0,12,7899000.0
7899,7899999,21.089235970741747,37.66971049889646,0.08472649717026337,1482.6571788787842,539.3280789852142,1312.6723136901855,51277,9063,42214,42214,0,12,7900000.0
7900,7900999,21.08928852056812,37.66942413648832,0.08470698008999,1483.011730670929,539.3931756019592,1313.0468559265137,51282,9065,42217,42217,0,12,7901000.0
7901,7901999,21.089373506343616,37.66868743373357,0.08468686238904266,1483.3885703086853,539.462197303772,1313.2127304077148,51286,9067,42219,42219,0,12,7902000.0
7902,7902999,21.089675884892333,37.66852185946766,0.08467022525137391,1483.642421722412,539.5299832820892,1313.3616409301758,51298,9068,42230,42230,0,12,7903000.0
7903,7903999,21.089931912767486,37.668320564727075,0.08466054093435316,1483.874446630478,539.5945746898651,1313.4930534362793,51300,9069,42231,42231,0,12,7904000.0
7904,7904999,21.0906668785626,37.669215456569475,0.0846424351635151,1484.1109702587128,539.6599795818329,1313.6219177246094,51313,9070,42243,42243,0,12,7905000.0
7905,7905999,21.091859096037382,37.67074254902158,0.08463850174410004,1484.4876427650452,539.7300207614899,1313.7322463989258,51321,9072,42249,42249,0,12,7906000.0
7906,7906999,21.09358198094716,37.67546784855527,0.08459785511816442,1484.7240917682648,539.7937867641449,1314.0147972106934,51336,9073,42263,42263,0,12,7907000.0
7907,7907999,21.09522701986811,37.67956491748961,0.08458668154233706,1485.1977045536041,539.8574941158295,1314.0539093017578,51352,9076,42276,42276,0,12,7908000.0
7908,7908999,21.09653278387415,37.681009414183784,0.0845729447203406,1485.4368166923523,539.9217092990875,1314.101245880127,51354,9077,42277,42277,0,12,7909000.0
7909,7909999,21.098026110216402,37.68341650146427,0.08457047545931484,1485.6679663658142,539.9852979183197,1314.2240447998047,51356,9078,42278,42278,0,12,7910000.0
7910,7910999,21.0995311568195,37.68524090613517,0.0845697952970873,1485.9008870124817,540.0498433113098,1314.344581604004,51358,9079,42279,42279,0,12,7911000.0
7911,7911999,21.1020389167049,37.69843149254686,0.08454556426693827,1486.0248565673828,540.1150846481323,1314.6440048217773,51360,9079,42281,42281,0,12,7912000.0
7912,7912999,21.104466464976255,37.70172503732556,0.08454264882824991,1486.1328618526459,540.1787989139557,1314.8507995605469,51361,9079,42282,42282,0,12,7913000.0
7913,7913999,21.10727637870665,37.705783735002214,0.084561931793254,1486.2639260292053,540.2430894374847,1315.0009498596191,51362,9079,42283,42283,0,12,7914000.0
7914,7914999,21.10923888376862,37.70823155922712,0.08459092274701852,1486.49795460701,540.3080861568451,1315.0614547729492,51364,9080,42284,42284,0,12,7915000.0
7915,7915999,21.109572342481474,37.70841572037281,0.08457222540997256,1486.7511162757874,540.3709406852722,1315.5087051391602,51371,9081,42290,42290,0,12,7916000.0
7916,7916999,21.109360936367768,37.70799391390423,0.0845554417708192,1487.1069600582123,540.4346716403961,1315.7167854309082,51382,9083,42299,42299,0,12,7917000.0
7917,7917999,21.109115820799015,37.70737508392729,0.0845440728848631,1487.2195188999176,540.4980912208557,1315.956615447998,51383,9083,42300,42300,0,12,7918000.0
7918,7918999,21.109356570734814,37.707857965708484,0.08453013812038235,1487.5947318077087,540.5662176609039,1316.1119079589844,51398,9085,42313,42313,0,12,7919000.0
7919,7919999,21.10957158957051,37.70790723344208,0.08452040661530069,1487.9628400802612,540.6320459842682,1316.3981132507324,51417,9087,42330,42330,0,12,7920000.0
7920,7920999,21.109895906630264,37.70786116543553,0.0845156681663326,1488.088187456131,540.696046590805,1316.5778923034668,51417,9087,42330,42330,0,12,7921000.0
7921,7921999,21.110392924882497,37.70789468002656,0.084513299025473,1488.2046494483948,540.7593388557434,1316.698616027832,51417,9087,42330,42330,0,12,7922000.0
7922,7922999,21.111385258794556,37.70920093669122,0.08450671381697727,1488.456874370575,540.8236110210419,1316.7614631652832,51419,9088,42331,42331,0,12,7923000.0
7923,7923999,21.112472003564505,37.71065495192871,0.08449460282402688,1488.6958413124084,540.8881878852844,1316.8410301208496,51431,9089,42342,42342,0,12,7924000.0
7924,7924999,21.11334031010422,37.71127055653545,0.08451239546948996,1488.949580192566,540.9611480236053,1317.025058746338,51433,9090,42343,42343,0,12,7925000.0
7925,7925999,21.11453144616168,37.71259767633159,0.08450510282849788,1489.1818964481354,541.0274937152863,1317.2210426330566,51435,9091,42344,42344,0,12,7926000.0
7926,7926999,21.115912919951768,37.71604076129583,0.08452117897835143,1489.4238386154175,541.093912601471,1317.2945251464844,51440,9092,42348,42348,0,12,7927000.0
7927,7927999,21.11736034711086,37.7174673013312,0.08452363121061435,1489.802829027176,541.1582906246185,1317.2804641723633,51454,9094,42360,42360,0,12,7928000.0
7928,7928999,21.118796612303736,37.719038005236634,0.08452882093817526,1489.9385583400726,541.2209458351135,1317.407428741455,51454,9094,42360,42360,0,12,7929000.0
7929,7929999,21.120321533574014,37.721850629359125,0.08451843279131543,1490.1662216186523,541.2835021018982,1317.4118270874023,51456,9095,42361,42361,0,12,7930000.0
7930,7930999,21.121934292870694,37.72329561827938,0.08451096040881578,1490.2833225727081,541.3480310440063,1317.6743087768555,51457,9095,42362,42362,0,12,7931000.0
7931,7931999,21.123536088387084,37.72629299967663,0.0845039895935169,1490.525241613388,541.4144730567932,1317.7783851623535,51459,9096,42363,42363,0,12,7932000.0
7932,7932999,21.124694973953794,37.72669181680341,0.08449956995174235,1490.6515185832977,541.4802489280701,1317.875316619873,51459,9096,42363,42363,0,12,7933000.0
7933,7933999,21.125207324261066,37.72770999363487,0.08447007413880925,1490.8943190574646,541.5461204051971,1318.3719291687012,51466,9097,42369,42369,0,12,7934000.0
7934,7934999,21.124681946333652,37.72709412042815,0.08446245826468401,1491.1447458267212,541.6133575439453,1318.584327697754,51469,9098,42371,42371,0,12,7935000.0
7935,7935999,21.124141067419682,37.72656169400222,0.0844539730143068,1491.3945927619934,541.6806032657623,1318.7678718566895,51481,9099,42382,42382,0,12,7936000.0
7936,7936999,21.12398588358961,37.72632356128488,0.08444594788983384,1491.7699568271637,541.7474930286407,1318.8068199157715,51505,9101,42404,42404,0,12,7937000.0
7937,7937999,21.12375130052336,37.72572169969346,0.08443986089850697,1492.252177476883,541.8152861595154,1318.9949417114258,51522,9104,42418,42418,0,12,7938000.0
7938,7938999,21.123719552722207,37.7256419066599,0.08442803913680652,1492.500517129898,541.8815138339996,1319.1459350585938,51534,9105,42429,42429,0,12,7939000.0
7939,7939999,21.12351343667721,37.72487084068853,0.08442094453289772,1492.6296231746674,541.9480030536652,1319.2873077392578,51534,9105,42429,42429,0,12,7940000.0
7940,7940999,21.12345166393687,37.72422786490208,0.08441557546720468,1492.8784201145172,542.0140473842621,1319.3945236206055,51536,9106,42430,42430,0,12,7941000.0
7941,7941999,21.12365314152569,37.72697747853807,0.0843967922019051,1493.1209251880646,542.0820236206055,1319.5864906311035,51543,9107,42436,42436,0,12,7942000.0
7942,7942999,21.12396116167535,37.72687739302676,0.08439451280381305,1493.4954340457916,542.150018453598,1319.7675704956055,51557,9109,42448,42448,0,12,7943000.0
7943,7943999,21.124577538153062,37.72880776184986,0.0843852242443417,1493.6228301525116,542.216340303421,1320.198097229004,51557,9109,42448,42448,0,12,7944000.0
7944,7944999,21.125476003848757,37.731381976387524,0.08437856651617048,1493.985559463501,542.2834897041321,1320.293270111084,51563,9111,42452,42452,0,12,7945000.0
7945,7945999,21.126747673496105,37.733049562213374,0.08438296618186747,1494.2274808883667,542.3505311012268,1320.4068489074707,51565,9112,42453,42453,0,12,7946000.0
7946,7946999,21.127934840941307,37.73449701530047,0.08439190481226377,1494.358404159546,542.4183151721954,1320.5845489501953,51565,9112,42453,42453,0,12,7947000.0
7947,7947999,21.129544424426996,37.7364142568657,0.08440677198614932,1494.6093780994415,542.4844861030579,1320.664695739746,51567,9113,42454,42454,0,12,7948000.0
7948,7948999,21.131089289292294,37.738048066607696,0.08441122038415094,1494.7338469028473,542.550998210907,1320.9092750549316,51567,9113,42454,42454,0,12,7949000.0
7949,7949999,21.13275266198294,37.74159424612817,0.08440603566792326,1494.9748268127441,542.6177926063538,1321.012294769287,51569,9114,42455,42455,0,12,7950000.0
7950,7950999,21.133794346481995,37.74229064694187,0.084407819456506,1495.0847651958466,542.6836171150208,1321.1275672912598,51569,9114,42455,42455,0,12,7951000.0
7951,7951999,21.13389712991343,37.74151943740661,0.08440655309993839,1495.3401041030884,542.7509043216705,1321.2875862121582,51583,9115,42468,42468,0,12,7952000.0
7952,7952999,21.13348546499372,37.741195653184526,0.08439676386621386,1495.7122888565063,542.8173127174377,1321.5831565856934,51599,9117,42482,42482,0,12,7953000.0
7953,7953999,21.13311967781528,37.74148666120899,0.08439235811836243,1496.0998513698578,542.8848567008972,1321.7617149353027,51607,9119,42488,42488,0,12,7954000.0
7954,7954999,21.132914309150866,37.74134291483821,0.08438848980907265,1496.234867811203,542.9515781402588,1321.9585762023926,51608,9119,42489,42489,0,12,7955000.0
7955,7955999,21.133074881840646,37.74202531286316,0.08437665509629189,1496.3704099655151,543.0186266899109,1322.3085556030273,51609,9119,42490,42490,0,12,7956000.0
7956,7956999,21.133553385361694,37.74356257491349,0.08436286316871777,1496.484883069992,543.0839521884918,1322.5598220825195,51609,9119,42490,42490,0,12,7957000.0
7957,7957999,21.134318309014386,37.74539214936485,0.08434602286402682,1496.6136858463287,543.1500108242035,1322.7134284973145,51609,9119,42490,42490,0,12,7958000.0
7958,7958999,21.13479044440386,37.746371983628244,0.08433797022253053,1496.852808713913,543.216055393219,1322.75687789917,51611,9120,42491,42491,0,12,7959000.0
7959,7959999,21.135058944718146,37.746712557722105,0.0843272418702169,1496.9844822883606,543.283123254776,1322.9233741760254,51612,9120,42492,42492,0,12,7960000.0
7960,7960999,21.13575732251215,37.748123102614194,0.08432815145451922,1497.2495353221893,543.3500163555145,1323.1699104309082,51615,9121,42494,42494,0,12,7961000.0
7961,7961999,21.13656710845523,37.75054504418938,0.08430935975233922,1497.625815153122,543.417070388794,1323.2629432678223,51629,9123,42506,42506,0,12,7962000.0
7962,7962999,21.13733497214871,37.752253221348205,0.08429896821101357,1497.7437508106232,543.4844479560852,1323.4116439819336,51629,9123,42506,42506,0,12,7963000.0
7963,7963999,21.137797627564986,37.753007940106706,0.08429058679492818,1498.1294286251068,543.552187204361,1323.4368133544922,51644,9125,42519,42519,0,12,7964000.0
7964,7964999,21.138993335333886,37.75706705298503,0.08428172438207437,1498.2555615901947,543.6200575828552,1323.573745727539,51644,9125,42519,42519,0,12,7965000.0
7965,7965999,21.13977129361565,37.758160288749615,0.08427266170138703,1498.3853650093079,543.6858274936676,1323.7681732177734,51644,9125,42519,42519,0,12,7966000.0
7966,7966999,21.140826110512496,37.759499825697326,0.08425922886191661,1498.5101566314697,543.7512562274933,1323.907527923584,51644,9125,42519,42519,0,12,7967000.0
7967,7967999,21.141998461448974,37.76236398073606,0.08425062321604948,1498.621077299118,543.8172266483307,1324.008731842041,51644,9125,42519,42519,0,12,7968000.0
7968,7968999,21.142875201769915,37.76328356745486,0.08424734750828167,1498.8738255500793,543.8854069709778,1323.9353828430176,51646,9126,42520,42520,0,12,7969000.0
7969,7969999,21.142900710414626,37.76380479028884,0.08423853867924314,1499.2485616207123,543.9529340267181,1324.3368301391602,51666,9128,42538,42538,0,12,7970000.0
7970,7970999,21.142388954858585,37.76316070085953,0.08423821484535421,1499.487981081009,544.02073097229,1324.6288375854492,51668,9129,42539,42539,0,12,7971000.0
7971,7971999,21.141814107406557,37.762676010016044,0.08423502654886517,1499.9770855903625,544.0888857841492,1324.7869300842285,51677,9132,42545,42545,0,12,7972000.0
7972,7972999,21.14120620813477,37.76134675442551,0.08423523713805314,1500.0993974208832,544.1571938991547,1325.0300025939941,51677,9132,42545,42545,0,12,7973000.0
7973,7973999,21.140666142197656,37.760124250509314,0.08423348861958668,1500.3428375720978,544.2252073287964,1325.30806350708,51689,9133,42556,42556,0,12,7974000.0
7974,7974999,21.140284780335488,37.7592042290993,0.08423127740639147,1500.46049451828,544.2922768592834,1325.5439567565918,51689,9133,42556,42556,0,12,7975000.0
7975,7975999,21.139964802734813,37.75833289591042,0.08422589509943157,1500.961898803711,544.3611772060394,1325.54487991333,51697,9136,42561,42561,0,12,7976000.0
7976,7976999,21.13957905989878,37.757243659911296,0.08422322779339164,1501.212457895279,544.428139925003,1325.681251525879,51700,9137,42563,42563,0,12,7977000.0
7977,7977999,21.139313402724632,37.758352742680735,0.08420964264236397,1501.345550775528,544.4947357177734,1325.9067344665527,51701,9137,42564,42564,0,12,7978000.0
7978,7978999,21.138953715796365,37.757495952965975,0.08420107604048388,1501.4615626335144,544.561117887497,1326.065788269043,51701,9137,42564,42564,0,12,7979000.0
7979,7979999,21.138662460410018,37.756327663975014,0.08419000328584614,1501.587871313095,544.6288187503815,1326.4897232055664,51702,9137,42565,42565,0,12,7980000.0
7980,7980999,21.138739429391332,37.75604153461881,0.08417735068823529,1501.9515948295593,544.6966006755829,1326.6686096191406,51711,9139,42572,42572,0,12,7981000.0
7981,7981999,21.138697299537434,37.75698270001836,0.08416664212800495,1502.3192434310913,544.7649269104004,1326.7752685546875,51717,9141,42576,42576,0,12,7982000.0
7982,7982999,21.138463909859002,37.7558270776872,0.08416106319637662,1502.563720703125,544.8335044384003,1326.904052734375,51719,9142,42577,42577,0,12,7983000.0
7983,7983999,21.13847013892329,37.75531763725465,0.08415254973697439,1502.6817214488983,544.9000425338745,1327.0314750671387,51719,9142,42577,42577,0,12,7984000.0
7984,7984999,21.138468460038606,37.75457304560597,0.08413986687817587,1502.8049488067627,544.9663808345795,1327.1784133911133,51719,9142,42577,42577,0,12,7985000.0
7985,7985999,21.138430755434587,37.75368632601494,0.08412792429646454,1502.9355204105377,545.0334935188293,1327.4472274780273,51719,9142,42577,42577,0,12,7986000.0
7986,7986999,21.13829132839661,37.75250279771177,0.0841160106278418,1503.057160615921,545.1008496284485,1327.6229667663574,51719,9142,42577,42577,0,12,7987000.0
7987,7987999,21.13816898449582,37.75152043146592,0.08411095951654146,1503.1847667694092,545.1665978431702,1327.7434921264648,51720,9142,42578,42578,0,12,7988000.0
7988,7988999,21.137837640521585,37.750322726369895,0.08410532510095847,1503.4342143535614,545.2332293987274,1327.8421440124512,51725,9143,42582,42582,0,12,7989000.0
7989,7989999,21.137609795416008,37.749172537016214,0.08408796986565692,1503.6845591068268,545.3000299930573,1328.317985534668,51730,9144,42586,42586,0,12,7990000.0
7990,7990999,21.137277548116653,37.74826480325253,0.08406798931557757,1503.9427797794342,545.3672678470612,1328.5089797973633,51737,9145,42592,42592,0,12,7991000.0
7991,7991999,21.13704438643296,37.747187931538576,0.08404793727437421,1504.5535514354706,545.4351930618286,1328.5228118896484,51754,9149,42605,42605,0,12,7992000.0
7992,7992999,21.13685599280635,37.74634963138126,0.0840323680447067,1504.6732902526855,545.501570224762,1328.7102546691895,51754,9149,42605,42605,0,12,7993000.0
7993,7993999,21.13674870971167,37.74576484747145,0.08401439665097599,1504.79461312294,545.568989276886,1328.9801979064941,51754,9149,42605,42605,0,12,7994000.0
7994,7994999,21.136953564630225,37.74534182800549,0.08399464936354573,1505.3063187599182,545.6399462223053,1329.0065383911133,51770,9152,42618,42618,0,12,7995000.0
7995,7995999,21.13719247356591,37.74501999297467,0.08398011213158496,1505.6726973056793,545.7073609828949,1329.08296585083,51784,9154,42630,42630,0,12,7996000.0
7996,7996999,21.137377521772123,37.74457442007963,0.08395611493100741,1505.799506187439,545.7745401859283,1329.2448425292969,51784,9154,42630,42630,0,12,7997000.0
7997,7997999,21.137981997484452,37.74487340503212,0.08392832999201294,1505.9208376407623,545.8412475585938,1329.4001274108887,51784,9154,42630,42630,0,12,7998000.0
7998,7998999,21.138367964071765,37.74460144270214,0.08390690829255587,1506.4158034324646,545.9094133377075,1329.3868408203125,51799,9157,42642,42642,0,12,7999000.0
7999,7999999,21.139346022688578,37.744841679980404,0.08385667999266078,1506.5336520671844,545.9766902923584,1329.7338218688965,51799,9157,42642,42642,0,12,8000000.0
8000,8000999,21.140606165262433,37.7451898699218,0.08381331707816475,1506.7779998779297,546.0435144901276,1329.9006233215332,51811,9158,42653,42653,0,12,8001000.0
8001,8001999,21.141524096671503,37.74546884442003,0.0837784192524027,1507.0385642051697,546.113972902298,1329.999309539795,51823,9159,42664,42664,0,12,8002000.0
8002,8002999,21.14267710853018,37.745814213479235,0.08374296418483806,1507.1666405200958,546.1809060573578,1330.1242370605469,51823,9159,42664,42664,0,12,8003000.0
8003,8003999,21.143370454975386,37.74549131666346,0.08371108730957355,1507.4127202033997,546.2482583522797,1330.2004470825195,51835,9160,42675,42675,0,12,8004000.0
8004,8004999,21.144521699409033,37.7457167227844,0.08366540025558888,1507.7790415287018,546.3151097297668,1330.233226776123,51839,9162,42677,42677,0,12,8005000.0
8005,8005999,21.146538512843787,37.74715563033532,0.08356069877616656,1507.9033670425415,546.3829712867737,1330.7765884399414,51839,9162,42677,42677,0,12,8006000.0
8006,8006999,21.148045967757824,37.747739486173764,0.08348582968392071,1508.0200023651123,546.4500398635864,1330.9724006652832,51839,9162,42677,42677,0,12,8007000.0
8007,8007999,21.149409425086404,37.74811330718131,0.08341978152971863,1508.1418294906616,546.5182938575745,1331.104320526123,51839,9162,42677,42677,0,12,8008000.0
8008,8008999,21.150392627019688,37.74798080842348,0.08336792936828785,1508.3947627544403,546.5855710506439,1331.1897735595703,51844,9163,42681,42681,0,12,8009000.0
8009,8009999,21.15010852137376,37.74683069928809,0.08335473748176381,1508.7744164466858,546.6539499759674,1331.7054862976074,51864,9165,42699,42699,0,12,8010000.0
8010,8010999,21.149500406189585,37.74563469258567,0.08335171823646548,1509.0214858055115,546.7220482826233,1331.9769668579102,51869,9166,42703,42703,0,12,8011000.0
8011,8011999,21.148875360444382,37.74454985953925,0.08335220774446894,1509.1458406448364,546.7898035049438,1332.2314949035645,51869,9166,42703,42703,0,12,8012000.0
8012,8012999,21.14826367438693,37.74316031305366,0.08335278056409112,1509.2647800445557,546.8576111793518,1332.4501304626465,51869,9166,42703,42703,0,12,8013000.0
8013,8013999,21.147645377022613,37.741938505234515,0.08335079426778236,1509.6454603672028,546.9271056652069,1332.5620651245117,51884,9168,42716,42716,0,12,8014000.0
8014,8014999,21.146953773775227,37.74054234553864,0.08335183705018934,1509.7775230407715,547.0023844242096,1332.7413482666016,51884,9168,42716,42716,0,12,8015000.0
8015,8015999,21.146369367860746,37.73938252492196,0.08335263749657718,1510.1442005634308,547.0702912807465,1332.8119812011719,51908,9170,42738,42738,0,12,8016000.0
8016,8016999,21.14602639451059,37.73866062816682,0.08335004194450435,1510.265498161316,547.1370892524719,1332.9955558776855,51908,9170,42738,42738,0,12,8017000.0
8017,8017999,21.14564256599214,37.73766301080185,0.08334751228742776,1510.524870634079,547.205540895462,1333.1242866516113,51910,9171,42739,42739,0,12,8018000.0
8018,8018999,21.145570899693677,37.7369204692317,0.08333652485897813,1510.7753114700317,547.2746357917786,1333.460536956787,51923,9172,42751,42751,0,12,8019000.0
8019,8019999,21.145434505180596,37.73600068763242,0.08332926582248756,1510.9026658535004,547.3414361476898,1333.6620750427246,51924,9172,42752,42752,0,12,8020000.0
8020,8020999,21.145576025326495,37.737210434876985,0.08331336357215291,1511.0343654155731,547.409060716629,1333.7650451660156,51924,9172,42752,42752,0,12,8021000.0
8021,8021999,21.14524940755635,37.7358905041096,0.08330971016806898,1511.1593976020813,547.4759440422058,1333.8935279846191,51924,9172,42752,42752,0,12,8022000.0
8022,8022999,21.145388801991157,37.73758960908461,0.08329896006544923,1511.5266044139862,547.5435900688171,1333.967098236084,51928,9174,42754,42754,0,12,8023000.0
8023,8023999,21.14537358209617,37.73700288009802,0.08328984287291807,1511.6468608379364,547.6106607913971,1334.0926055908203,51928,9174,42754,42754,0,12,8024000.0
8024,8024999,21.145168240672078,37.735735357157914,0.08328635849910271,1511.763860464096,547.6777586936951,1334.1803131103516,51928,9174,42754,42754,0,12,8025000.0
8025,8025999,21.14464675406405,37.735315075555484,0.08328122949524153,1511.8863308429718,547.7449386119843,1334.7449951171875,51930,9174,42756,42756,0,12,8026000.0
8026,8026999,21.143942496925245,37.73457793494528,0.083280852951363,1512.0105826854706,547.8135983943939,1335.0164031982422,51930,9174,42756,42756,0,12,8027000.0
8027,8027999,21.143257445224872,37.73379331935451,0.08327182298406066,1512.7398536205292,547.8814167976379,1335.0366859436035,51951,9179,42772,42772,0,12,8028000.0
8028,8028999,21.142447092989862,37.73252577878317,0.08327480847258839,1513.1105444431305,547.9496264457703,1335.4114036560059,51967,9181,42786,42786,0,12,8029000.0
8029,8029999,21.14191229767847,37.731647873189544,0.08327137269582541,1513.2395479679108,548.019166469574,1335.7149658203125,51967,9181,42786,42786,0,12,8030000.0
8030,8030999,21.14119469465886,37.73029760959771,0.08327151302373315,1513.609052181244,548.0866923332214,1335.8314514160156,52001,9183,42818,42818,0,12,8031000.0
8031,8031999,21.14075830662112,37.730223837933,0.08326231855104604,1513.7394268512726,548.1551191806793,1335.9680099487305,52001,9183,42818,42818,0,12,8032000.0
8032,8032999,21.140550458977284,37.730403538438715,0.08325121691492698,1514.2263884544373,548.2228586673737,1336.014793395996,52019,9186,42833,42833,0,12,8033000.0
8033,8033999,21.14043182697581,37.73062913526779,0.08324031919182517,1514.346429347992,548.2902555465698,1336.2844734191895,52019,9186,42833,42833,0,12,8034000.0
8034,8034999,21.140408218860212,37.7303412476976,0.08323249191065185,1514.4805207252502,548.3608679771423,1336.570629119873,52022,9186,42836,42836,0,12,8035000.0
8035,8035999,21.140628374811232,37.730783781971034,0.08322274729555423,1514.9700467586517,548.4295766353607,1336.6457252502441,52029,9189,42840,42840,0,12,8036000.0
8036,8036999,21.140991921727394,37.73103458800575,0.08321548785938526,1515.2181854248047,548.4977304935455,1336.8017845153809,52039,9190,42849,42849,0,12,8037000.0
8037,8037999,21.141495828031715,37.731766100390864,0.08320666776985375,1515.4651341438293,548.5645666122437,1336.902011871338,52041,9191,42850,42850,0,12,8038000.0
8038,8038999,21.14261909751462,37.73445163092007,0.08319851927268729,1515.5870201587677,548.633054971695,1337.0333213806152,52041,9191,42850,42850,0,12,8039000.0
8039,8039999,21.143325856204818,37.735334017136466,0.08318890949846036,1515.7166619300842,548.7021586894989,1337.2499046325684,52041,9191,42850,42850,0,12,8040000.0
8040,8040999,21.14446539355985,37.7367649346995,0.08318501442733761,1515.9598140716553,548.7703893184662,1337.3708953857422,52044,9192,42852,42852,0,12,8041000.0
8041,8041999,21.14523475619931,37.7372774239053,0.08319121862244916,1516.085713148117,548.8365767002106,1337.4942741394043,52044,9192,42852,42852,0,12,8042000.0
8042,8042999,21.14586747405933,37.73753374419474,0.08319701289105219,1516.355705499649,548.9065642356873,1337.532657623291,52046,9193,42853,42853,0,12,8043000.0
8043,8043999,21.145984209426338,37.73738632872687,0.08319189431560292,1516.6121513843536,548.9735407829285,1337.9846267700195,52057,9194,42863,42863,0,12,8044000.0
8044,8044999,21.14617472305973,37.739500317258624,0.08316821126340046,1516.7433359622955,549.046272277832,1338.3428802490234,52058,9194,42864,42864,0,12,8045000.0
8045,8045999,21.145846447357695,37.73993895852936,0.083152310862736,1516.987179517746,549.1141803264618,1338.4828338623047,52060,9195,42865,42865,0,12,8046000.0
8046,8046999,21.14574831815443,37.74084742559093,0.08314522407317004,1517.2433896064758,549.1821279525757,1338.6564865112305,52062,9196,42866,42866,0,12,8047000.0
8047,8047999,21.145342785239816,37.74030306732116,0.08313945912030274,1517.3687660694122,549.2492520809174,1338.9333457946777,52063,9196,42867,42867,0,12,8048000.0
8048,8048999,21.145107231986795,37.73945159550368,0.08312965244274162,1517.731573343277,549.3158371448517,1339.1342849731445,52082,9198,42884,42884,0,12,8049000.0
8049,8049999,21.14488182614022,37.73878993188016,0.08311806645625264,1517.8575251102448,549.3837900161743,1339.318286895752,52082,9198,42884,42884,0,12,8050000.0
8050,8050999,21.14462213118649,37.73810291357991,0.08311241475211628,1517.9850285053253,549.4496598243713,1339.4563522338867,52083,9198,42885,42885,0,12,8051000.0
8051,8051999,21.144479950330435,37.73766355122669,0.08310235115145437,1518.110455751419,549.5154407024384,1339.5954780578613,52084,9198,42886,42886,0,12,8052000.0
8052,8052999,21.14437250549988,37.73735880302403,0.08309372606089804,1518.2349207401276,549.5823886394501,1339.7009925842285,52084,9198,42886,42886,0,12,8053000.0
8053,8053999,21.14433469926092,37.736965763933505,0.08308614669688441,1518.6186804771423,549.6503682136536,1339.9679679870605,52091,9200,42891,42891,0,12,8054000.0
8054,8054999,21.14466915747325,37.737338076778876,0.08307591512576185,1518.7401280403137,549.716991186142,1340.1601486206055,52091,9200,42891,42891,0,12,8055000.0
8055,8055999,21.14513248765841,37.73783816476971,0.08306653677179099,1519.1065382957458,549.784008026123,1340.246696472168,52100,9202,42898,42898,0,12,8056000.0
8056,8056999,21.145571839994243,37.73785219913396,0.08305515691005805,1519.3679172992706,549.8502838611603,1340.3077545166016,52104,9203,42901,42901,0,12,8057000.0
8057,8057999,21.14608569531077,37.738149011280726,0.08304868517089592,1519.4880459308624,549.9165723323822,1340.4538269042969,52104,9203,42901,42901,0,12,8058000.0
8058,8058999,21.14687588771812,37.73968436813597,0.08304600655905625,1519.7298409938812,549.9834268093109,1340.4931182861328,52106,9204,42902,42902,0,12,8059000.0
8059,8059999,21.14808599278229,37.74283264217051,0.08302801916424929,1519.9978847503662,550.0555567741394,1340.7348403930664,52111,9205,42906,42906,0,12,8060000.0
8060,8060999,21.148974211967406,37.74338805760656,0.08301942263081119,1520.2415301799774,550.1224205493927,1340.8593482971191,52113,9206,42907,42907,0,12,8061000.0
8061,8061999,21.149837575790823,37.74375361762114,0.08300972649143612,1520.367563009262,550.1889064311981,1340.967056274414,52113,9206,42907,42907,0,12,8062000.0
8062,8062999,21.15025781719155,37.7433535602195,0.08299805195743915,1520.4959354400635,550.2548806667328,1341.0607414245605,52113,9206,42907,42907,0,12,8063000.0
8063,8063999,21.15022993159151,37.743484241848506,0.08299022527343536,1520.7455732822418,550.32204413414,1341.8413276672363,52118,9207,42911,42911,0,12,8064000.0
8064,8064999,21.150356691498377,37.74421962256866,0.08297275610383803,1520.8619754314423,550.3898158073425,1342.1313819885254,52118,9207,42911,42911,0,12,8065000.0
8065,8065999,21.15022183664844,37.74387746163938,0.08297165203337653,1520.9914124011993,550.4572851657867,1342.3614959716797,52118,9207,42911,42911,0,12,8066000.0
8066,8066999,21.15022249970089,37.743342206387425,0.08296698358157195,1521.1193883419037,550.525007724762,1342.549705505371,52118,9207,42911,42911,0,12,8067000.0
8067,8067999,21.150840078706285,37.743914582374835,0.0829561305687122,1521.2557880878448,550.5971674919128,1342.912727355957,52119,9207,42912,42912,0,12,8068000.0
8068,8068999,21.151677316705744,37.74575104649473,0.08294587272059273,1521.377355337143,550.6647520065308,1343.113941192627,52119,9207,42912,42912,0,12,8069000.0
8069,8069999,21.152952192953368,37.748381691114304,0.08295007616497996,1521.494767665863,550.7306478023529,1343.2415657043457,52119,9207,42912,42912,0,12,8070000.0
8070,8070999,21.15419417489315,37.75108984164792,0.0829542869005544,1521.7391681671143,550.7978081703186,1343.3964080810547,52121,9208,42913,42913,0,12,8071000.0
8071,8071999,21.15605364387239,37.7554449287049,0.08296888044689077,1521.866415977478,550.8654551506042,1343.5879936218262,52121,9208,42913,42913,0,12,8072000.0
8072,8072999,21.15845602352345,37.76044644083514,0.08297896805439609,1522.121633529663,550.9324581623077,1343.8827514648438,52123,9209,42914,42914,0,12,8073000.0
8073,8073999,21.161068627986296,37.76509897544851,0.08300659700931401,1522.4829256534576,550.9994282722473,1344.0167770385742,52132,9211,42921,42921,0,12,8074000.0
8074,8074999,21.163244461937417,37.76924725313522,0.08303077419247673,1522.6019127368927,551.0653088092804,1344.2302551269531,52132,9211,42921,42921,0,12,8075000.0
8075,8075999,21.165721223915444,37.77467051845072,0.0830614956323592,1522.851681470871,551.1321742534637,1344.348762512207,52135,9212,42923,42923,0,12,8076000.0
8076,8076999,21.168244727333608,37.78090138807537,0.08311709061307215,1523.1095764636993,551.2001156806946,1344.43989944458,52137,9213,42924,42924,0,12,8077000.0
8077,8077999,21.17110650562454,37.785907796809035,0.08319080333015128,1523.3747131824493,551.2733640670776,1344.670555114746,52139,9214,42925,42925,0,12,8078000.0
8078,8078999,21.174507967523674,37.79439278307319,0.0832530029752877,1523.7525594234467,551.3397164344788,1344.7600708007812,52145,9216,42929,42929,0,12,8079000.0
8079,8079999,21.177713713633775,37.8001803427057,0.08337331819791671,1523.8687806129456,551.4049787521362,1344.892505645752,52145,9216,42929,42929,0,12,8080000.0
8080,8080999,21.179093430814763,37.80135532565819,0.08338374528880443,1523.9944112300873,551.4711270332336,1345.2130012512207,52146,9216,42930,42930,0,12,8081000.0
8081,8081999,21.17972711238931,37.804273809830946,0.0833691502138505,1524.2313768863678,551.5368497371674,1345.540885925293,52153,9217,42936,42936,0,12,8082000.0
8082,8082999,21.18033324073374,37.806337593755444,0.0833480893551849,1524.4854154586792,551.6049056053162,1345.6822509765625,52158,9218,42940,42940,0,12,8083000.0
8083,8083999,21.181165703142238,37.80875116808651,0.08332581032535902,1524.6092698574066,551.6726393699646,1345.932559967041,52158,9218,42940,42940,0,12,8084000.0
8084,8084999,21.181868490817838,37.81013967415513,0.0833170099998034,1524.9740540981293,551.7393825054169,1346.206527709961,52163,9220,42943,42943,0,12,8085000.0
8085,8085999,21.182555733092887,37.81214155855495,0.08330071643784587,1525.1068348884583,551.8062884807587,1346.4541549682617,52163,9220,42943,42943,0,12,8086000.0
8086,8086999,21.18319087029017,37.813015166790485,0.08329268870519002,1525.3821895122528,551.8758263587952,1346.5712699890137,52175,9221,42954,42954,0,12,8087000.0
8087,8087999,21.183695923231685,37.81358613332487,0.0832888291043008,1525.7618117332458,551.9438099861145,1346.6048774719238,52189,9223,42966,42966,0,12,8088000.0
8088,8088999,21.1845282637514,37.81466799027753,0.0832850837835889,1526.01242852211,552.0108330249786,1346.7650527954102,52191,9224,42967,42967,0,12,8089000.0
8089,8089999,21.18557787600992,37.816524062073334,0.08327956428094407,1526.1328155994415,552.0774981975555,1346.907314300537,52192,9224,42968,42968,0,12,8090000.0
8090,8090999,21.187022033817573,37.81846705540579,0.0832742697058314,1526.250394821167,552.1433458328247,1347.2367477416992,52192,9224,42968,42968,0,12,8091000.0
8091,8091999,21.188707204173955,37.82318239195013,0.08326613456704246,1526.497454881668,552.2107112407684,1347.3603057861328,52198,9225,42973,42973,0,12,8092000.0
8092,8092999,21.1898577267386,37.824195729419095,0.08326425770570345,1526.877471446991,552.2779972553253,1347.4012336730957,52212,9227,42985,42985,0,12,8093000.0
8093,8093999,21.191295419779962,37.82698570397111,0.083261945368172,1527.258409500122,552.3457155227661,1347.449863433838,52216,9229,42987,42987,0,12,8094000.0
8094,8094999,21.19302153602049,37.830113818569444,0.08328068009925849,1527.3760540485382,552.4112937450409,1347.5951194763184,52216,9229,42987,42987,0,12,8095000.0
8095,8095999,21.194895628224664,37.83400416347209,0.08329330864405393,1527.6141667366028,552.4773354530334,1347.7983131408691,52221,9230,42991,42991,0,12,8096000.0
8096,8096999,21.19700174525902,37.837585896555744,0.08330572505449707,1527.7478456497192,552.5433728694916,1347.993595123291,52221,9230,42991,42991,0,12,8097000.0
8097,8097999,21.198760482891295,37.84010800731558,0.08331823991185472,1527.873287677765,552.6107404232025,1348.119915008545,52221,9230,42991,42991,0,12,8098000.0
8098,8098999,21.200541862487228,37.84253121627703,0.08334722389514393,1528.2451646327972,552.676836013794,1348.1373291015625,52225,9232,42993,42993,0,12,8099000.0
8099,8099999,21.20123918542248,37.843683341371865,0.08333866757417752,1528.3766634464264,552.7445368766785,1348.700050354004,52225,9232,42993,42993,0,12,8100000.0
8100,8100999,21.20078546675562,37.84274922848592,0.08332843685860536,1528.7562992572784,552.815456867218,1348.9886169433594,52230,9234,42996,42996,0,12,8101000.0
8101,8101999,21.20057392852412,37.84240881601838,0.08331852109324323,1528.9957191944122,552.8833150863647,1349.2833404541016,52235,9235,43000,43000,0,12,8102000.0
8102,8102999,21.200408038886312,37.84224473707897,0.0833027960788979,1529.129388809204,552.9520809650421,1349.5448379516602,52235,9235,43000,43000,0,12,8103000.0
8103,8103999,21.20042567107138,37.8416827933141,0.08328554299413937,1529.380399942398,553.0202622413635,1349.7553634643555,52240,9236,43004,43004,0,12,8104000.0
8104,8104999,21.200942614402386,37.84284283389602,0.08319356639658348,1529.745414018631,553.0895349979401,1349.9951934814453,52245,9238,43007,43007,0,12,8105000.0
8105,8105999,21.20104546568699,37.8427799325727,0.08316635798222627,1529.8581204414368,553.1568796634674,1350.2101211547852,52245,9238,43007,43007,0,12,8106000.0
8106,8106999,21.20124639806993,37.84206916679139,0.08314504600768724,1530.1005449295044,553.2246663570404,1350.3256530761719,52257,9239,43018,43018,0,12,8107000.0
8107,8107999,21.20153105848894,37.842089030369884,0.08312200304344419,1530.2330958843231,553.299408197403,1350.490364074707,52257,9239,43018,43018,0,12,8108000.0
8108,8108999,21.20156845390667,37.84129548617962,0.08310749802820794,1530.3631963729858,553.3662974834442,1350.676914215088,52257,9239,43018,43018,0,12,8109000.0
8109,8109999,21.20213751875553,37.84153413479543,0.08306092849274382,1530.6230065822601,553.4362535476685,1351.0055923461914,52265,9240,43025,43025,0,12,8110000.0
8110,8110999,21.202800791567405,37.84171398389298,0.08302224285950399,1530.74187874794,553.5031814575195,1351.3139686584473,52265,9240,43025,43025,0,12,8111000.0
8111,8111999,21.203311651710525,37.84157898966742,0.08299968820183368,1530.9934039115906,553.5714538097382,1351.4592628479004,52269,9241,43028,43028,0,12,8112000.0
8112,8112999,21.203855896349033,37.84170051614954,0.08298225235560341,1531.2397620677948,553.6390588283539,1351.5571937561035,52271,9242,43029,43029,0,12,8113000.0
8113,8113999,21.20418177307684,37.84127300019342,0.08297067057942487,1531.4898540973663,553.7074480056763,1351.6553840637207,52273,9243,43030,43030,0,12,8114000.0
8114,8114999,21.2047531238108,37.84107521899983,0.0829567200505964,1531.6166324615479,553.7746095657349,1351.7975425720215,52273,9243,43030,43030,0,12,8115000.0
8115,8115999,21.205633057821547,37.84126364874217,0.08292380226304508,1531.7504198551178,553.8423173427582,1352.0678482055664,52273,9243,43030,43030,0,12,8116000.0
8116,8116999,21.20645309102931,37.84251184766717,0.08290358302279377,1531.9911034107208,553.9110872745514,1352.2036018371582,52275,9244,43031,43031,0,12,8117000.0
8117,8117999,21.20691949459674,37.84201144053331,0.08288756974902822,1532.1203508377075,553.9780170917511,1352.3306999206543,52275,9244,43031,43031,0,12,8118000.0
8118,8118999,21.207511309857747,37.841728985647556,0.08287016143420445,1532.4990231990814,554.0466210842133,1352.2875938415527,52291,9246,43045,43045,0,12,8119000.0
8119,8119999,21.207785437318798,37.84326759126538,0.08285211049014352,1532.7529067993164,554.1141536235809,1352.6195335388184,52300,9247,43053,43053,0,12,8120000.0
8120,8120999,21.20724615969932,37.842218026677195,0.08284500865227296,1533.001745223999,554.1827473640442,1352.8702507019043,52302,9248,43054,43054,0,12,8121000.0
8121,8121999,21.20682448081735,37.84168243210828,0.08283058266562504,1533.1420958042145,554.2499873638153,1353.051082611084,52302,9248,43054,43054,0,12,8122000.0
8122,8122999,21.20650360809748,37.84070981033217,0.08282100169673423,1533.7308740615845,554.35080909729,1353.167381286621,52306,9250,43056,43056,0,12,8123000.0
8123,8123999,21.20617662823046,37.83971645584601,0.08281518640701568,1534.2139382362366,554.4179286956787,1353.1861381530762,52313,9253,43060,43060,0,12,8124000.0
8124,8124999,21.20664132845678,37.8412358916089,0.08269532789976464,1534.3419840335846,554.4917182922363,1353.5704956054688,52314,9253,43061,43061,0,12,8125000.0
8125,8125999,21.207473484998015,37.84416264918911,0.08258647197713809,1534.5872390270233,554.55921626091,1353.7216835021973,52316,9254,43062,43062,0,12,8126000.0
8126,8126999,21.207638844409022,37.84436858758811,0.082519812925267,1534.9497511386871,554.6271617412567,1353.8465423583984,52331,9256,43075,43075,0,12,8127000.0
8127,8127999,21.20796694529883,37.84504189176684,0.08245431477842302,1535.0759255886078,554.696263551712,1353.9908180236816,52332,9256,43076,43076,0,12,8128000.0
8128,8128999,21.208366094263273,37.845464086814395,0.08239700753498658,1535.44566822052,554.7639162540436,1354.062786102295,52347,9258,43089,43089,0,12,8129000.0
8129,8129999,21.208404745328785,37.84483705411738,0.082366831220682,1535.7016699314117,554.8315186500549,1354.210678100586,52359,9259,43100,43100,0,12,8130000.0
8130,8130999,21.209506463472895,37.847337445015114,0.08224774569336812,1535.8205103874207,554.8982853889465,1354.531723022461,52359,9259,43100,43100,0,12,8131000.0
8131,8131999,21.210483884352268,37.851347141134866,0.08214779758148838,1536.0636270046234,554.9648184776306,1354.6283683776855,52361,9260,43101,43101,0,12,8132000.0
8132,8132999,21.211059206282325,37.85164420019578,0.08210087376427222,1536.31543302536,555.0324175357819,1354.6933097839355,52363,9261,43102,43102,0,12,8133000.0
8133,8133999,21.21166425481415,37.8519176901771,0.08206204473494161,1536.5684263706207,555.0994119644165,1354.7736549377441,52365,9262,43103,43103,0,12,8134000.0
8134,8134999,21.21237155523858,37.85209496213116,0.08202317366320244,1536.6856610774994,555.165543794632,1354.8961791992188,52365,9262,43103,43103,0,12,8135000.0
8135,8135999,21.212963575008708,37.85230804999214,0.08199661058228136,1537.1765954494476,555.232613325119,1354.9971046447754,52371,9265,43106,43106,0,12,8136000.0
8136,8136999,21.21389673768053,37.853002374998084,0.08194721740497457,1537.421195268631,555.3003656864166,1355.3507080078125,52374,9266,43108,43108,0,12,8137000.0
8137,8137999,21.214458021362507,37.85283848544747,0.08192612293123047,1537.667279958725,555.3679649829865,1355.5264129638672,52394,9267,43127,43127,0,12,8138000.0
8138,8138999,21.2150290300445,37.85260116656139,0.08190931609086738,1537.7884418964386,555.4342226982117,1355.6747589111328,52394,9267,43127,43127,0,12,8139000.0
8139,8139999,21.21507918464234,37.851756070588614,0.08190066377085337,1538.04074716568,555.5013031959534,1355.7651176452637,52396,9268,43128,43128,0,12,8140000.0
8140,8140999,21.215154975935857,37.851294046068816,0.08188677716299131,1538.1700036525726,555.5689189434052,1356.3610000610352,52396,9268,43128,43128,0,12,8141000.0
8141,8141999,21.21501029615147,37.85091577654406,0.08187462191148798,1538.5441217422485,555.6382687091827,1356.6438598632812,52402,9270,43132,43132,0,12,8142000.0
8142,8142999,21.21502957145313,37.850544256906296,0.08185977233048758,1538.7961609363556,555.7070834636688,1356.806411743164,52404,9271,43133,43133,0,12,8143000.0
8143,8143999,21.214821053996676,37.849750457080354,0.08185155052655357,1538.9137802124023,555.7750554084778,1357.0440788269043,52405,9271,43134,43134,0,12,8144000.0
8144,8144999,21.215378811803415,37.85058911307991,0.08180188931024757,1539.2801146507263,555.843745470047,1357.3487243652344,52410,9273,43137,43137,0,12,8145000.0
8145,8145999,21.21559118789692,37.85036875529496,0.08177602211696822,1539.4033036231995,555.9119355678558,1357.5564041137695,52410,9273,43137,43137,0,12,8146000.0
8146,8146999,21.21593762407844,37.85028569580887,0.08175124938583489,1539.530201435089,555.9793672561646,1357.7236633300781,52411,9273,43138,43138,0,12,8147000.0
8147,8147999,21.216204898247806,37.84992845220107,0.08173392463642593,1539.6575405597687,556.0478930473328,1357.9125900268555,52412,9273,43139,43139,0,12,8148000.0
8148,8148999,21.216588733689886,37.849961538425454,0.08173541945619056,1539.7956504821777,556.1250355243683,1358.03267288208,52412,9273,43139,43139,0,12,8149000.0
8149,8149999,21.217677407442235,37.85123863542364,0.08169266102753592,1539.9196381568909,556.1935369968414,1358.5030708312988,52412,9273,43139,43139,0,12,8150000.0
8150,8150999,21.218831065235964,37.85276997383594,0.0816395031798216,1540.046169757843,556.262663602829,1358.7081871032715,52412,9273,43139,43139,0,12,8151000.0
8151,8151999,21.219962098347533,37.85413038042719,0.08161223530455608,1540.167578458786,556.3308646678925,1358.8595161437988,52412,9273,43139,43139,0,12,8152000.0
8152,8152999,21.22098911475023,37.85630177150099,0.08158167802623117,1540.4182350635529,556.399022102356,1358.9678039550781,52424,9274,43150,43150,0,12,8153000.0
8153,8153999,21.222161783251305,37.85868445136946,0.08155437855065173,1540.6660523414612,556.4674251079559,1359.1117630004883,52426,9275,43151,43151,0,12,8154000.0
8154,8154999,21.224199654684078,37.86193318879986,0.08149095839863874,1540.7857160568237,556.5342996120453,1359.2623176574707,52426,9275,43151,43151,0,12,8155000.0
8155,8155999,21.225471956958682,37.86294176142249,0.08146608657023913,1541.0289027690887,556.6014971733093,1359.359619140625,52428,9276,43152,43152,0,12,8156000.0
8156,8156999,21.2262847051811,37.86350823668347,0.08145357104185513,1541.3952550888062,556.6696336269379,1359.6376609802246,52442,9278,43164,43164,0,12,8157000.0
8157,8157999,21.22660851780927,37.864803767281906,0.08143892305106837,1541.6426284313202,556.7374610900879,1360.035301208496,52448,9279,43169,43169,0,12,8158000.0
8158,8158999,21.227212670562057,37.868945138706714,0.08142134288954239,1542.010871887207,556.8054358959198,1360.264720916748,52462,9281,43181,43181,0,12,8159000.0
8159,8159999,21.227573803887566,37.87024812430988,0.08141089032985682,1542.2545301914215,556.8733217716217,1360.4627799987793,52467,9282,43185,43185,0,12,8160000.0
8160,8160999,21.228248439445277,37.87115325489172,0.08138122859681574,1542.3759174346924,556.9410817623138,1360.9475479125977,52467,9282,43185,43185,0,12,8161000.0
8161,8161999,21.22870735639996,37.871532951520365,0.0813603100640855,1542.510531425476,557.0082902908325,1361.2035942077637,52467,9282,43185,43185,0,12,8162000.0
8162,8162999,21.22935960515614,37.87213012381263,0.08133630189671048,1542.633624792099,557.0758736133575,1361.362476348877,52467,9282,43185,43185,0,12,8163000.0
8163,8163999,21.230130871097284,37.87338771418149,0.0813068359320871,1542.7585003376007,557.1470310688019,1361.5313720703125,52468,9282,43186,43186,0,12,8164000.0
8164,8164999,21.230904714461172,37.87413027118856,0.08128521597884064,1542.8921830654144,557.2151000499725,1361.6526145935059,52468,9282,43186,43186,0,12,8165000.0
8165,8165999,21.231709121703297,37.87485341798228,0.08125659348504144,1543.1395325660706,557.2838990688324,1361.9466171264648,52470,9283,43187,43187,0,12,8166000.0
8166,8166999,21.233494658839643,37.880678459258625,0.08119965490520475,1543.3873136043549,557.3519852161407,1362.0607376098633,52472,9284,43188,43188,0,12,8167000.0
8167,8167999,21.235193703009422,37.88376551310491,0.0811777506661826,1543.6334774494171,557.4215362071991,1362.1774520874023,52474,9285,43189,43189,0,12,8168000.0
8168,8168999,21.23717985518179,37.88727507152942,0.08115577145165842,1544.1322004795074,557.4898710250854,1362.1901245117188,52490,9288,43202,43202,0,12,8169000.0
8169,8169999,21.23921407943939,37.89063001520353,0.08114461472281898,1544.379723072052,557.5576906204224,1362.298957824707,52495,9289,43206,43206,0,12,8170000.0
8170,8170999,21.241891692076816,37.89764480883735,0.08112871993030168,1544.6385107040405,557.6330964565277,1362.5239639282227,52497,9290,43207,43207,0,12,8171000.0
8171,8171999,21.24446190521223,37.90169673944541,0.08110364881266663,1545.0014235973358,557.700425863266,1362.5819664001465,52501,9292,43209,43209,0,12,8172000.0
8172,8172999,21.246434373488114,37.90510560669886,0.08110877612472711,1545.122746706009,557.7675597667694,1362.7633361816406,52501,9292,43209,43209,0,12,8173000.0
8173,8173999,21.2480568803449,37.90728325009041,0.08113765872269896,1545.2536158561707,557.8348183631897,1362.887565612793,52501,9292,43209,43209,0,12,8174000.0
8174,8174999,21.24887380395448,37.90833510362278,0.08115855924640891,1545.4976618289948,557.9013574123383,1363.2793197631836,52516,9293,43223,43223,0,12,8175000.0
8175,8175999,21.248397201667924,37.908387933325045,0.08114873638639164,1545.6140141487122,557.9666409492493,1363.554557800293,52516,9293,43223,43223,0,12,8176000.0
8176,8176999,21.24800109510069,37.90758108924836,0.08114341776374734,1545.73251247406,558.0323348045349,1363.7353439331055,52516,9293,43223,43223,0,12,8177000.0
8177,8177999,21.247866500150778,37.9075713966773,0.08113250215102363,1545.8661441802979,558.0994062423706,1363.9291534423828,52518,9293,43225,43225,0,12,8178000.0
8178,8178999,21.247737507238558,37.90718806368208,0.08112283506774676,1546.2421913146973,558.166556596756,1363.9889030456543,52548,9295,43253,43253,0,12,8179000.0
8179,8179999,21.247803962805666,37.9076351240601,0.08110605634872625,1546.6149978637695,558.2339935302734,1364.347183227539,52562,9297,43265,43265,0,12,8180000.0
8180,8180999,21.247882587006202,37.907392285663654,0.08109725475306884,1546.7313055992126,558.3016359806061,1364.5558166503906,52562,9297,43265,43265,0,12,8181000.0
8181,8181999,21.248083643617782,37.907230458198164,0.0810928801343258,1546.9844818115234,558.3685166835785,1364.5717086791992,52566,9298,43268,43268,0,12,8182000.0
8182,8182999,21.248633426818703,37.90757877874446,0.08109415218172544,1547.116708278656,558.4343237876892,1364.705738067627,52566,9298,43268,43268,0,12,8183000.0
8183,8183999,21.249406888749306,37.90878228984175,0.08109653569679531,1547.2414135932922,558.5015535354614,1364.8226280212402,52566,9298,43268,43268,0,12,8184000.0
8184,8184999,21.25043726677722,37.91015358638119,0.08109720364589978,1547.363937139511,558.5687923431396,1365.1118087768555,52566,9298,43268,43268,0,12,8185000.0
8185,8185999,21.251361926347386,37.91096249977412,0.08110312952086907,1547.7437767982483,558.6371285915375,1365.1934776306152,52589,9300,43289,43289,0,12,8186000.0
8186,8186999,21.252618074659207,37.912294951474074,0.08111382915668341,1547.993991136551,558.703351020813,1365.324478149414,52591,9301,43290,43290,0,12,8187000.0
8187,8187999,21.25405271014208,37.91402090343352,0.08112360658951612,1548.2409839630127,558.7704005241394,1365.4185600280762,52593,9302,43291,43291,0,12,8188000.0
8188,8188999,21.255477903701067,37.91584957121085,0.08114518478368549,1548.3831593990326,558.839658498764,1365.5535049438477,52593,9302,43291,43291,0,12,8189000.0
8189,8189999,21.25669916825049,37.9169604183788,0.08116840420232296,1548.5286304950714,558.9162516593933,1365.6621551513672,52593,9302,43291,43291,0,12,8190000.0
8190,8190999,21.258371851270038,37.91976750911857,0.08119238631201842,1548.9153454303741,558.983068227768,1365.7391662597656,52603,9304,43299,43299,0,12,8191000.0
8191,8191999,21.26042487947547,37.922291994488404,0.08122769481948777,1549.0301189422607,559.0505414009094,1365.8646965026855,52603,9304,43299,43299,0,12,8192000.0
8192,8192999,21.262237106366843,37.92587747462252,0.08127189681705105,1549.2907321453094,559.1168975830078,1365.965835571289,52608,9305,43303,43303,0,12,8193000.0
8193,8193999,21.263638262666934,37.92683872734005,0.08130112849955995,1549.5414531230927,559.183685541153,1366.0436477661133,52617,9306,43311,43311,0,12,8194000.0
8194,8194999,21.26423341975955,37.927630300773636,0.08130493381779658,1549.7927882671356,559.2519495487213,1366.663818359375,52634,9307,43327,43327,0,12,8195000.0
8195,8195999,21.26391328794938,37.928294588728875,0.08128979722663998,1550.041310787201,559.3198277950287,1367.0641784667969,52646,9308,43338,43338,0,12,8196000.0
8196,8196999,21.263440010909186,37.92824894283106,0.08127940906480591,1550.1755392551422,559.3956408500671,1367.3329277038574,52646,9308,43338,43338,0,12,8197000.0
8197,8197999,21.26299766208521,37.92741750625749,0.08126991539543671,1550.2977080345154,559.4622106552124,1367.5759925842285,52646,9308,43338,43338,0,12,8198000.0
8198,8198999,21.262527797487643,37.92660580977563,0.08126297199228427,1550.4243965148926,559.529422044754,1367.777759552002,52646,9308,43338,43338,0,12,8199000.0
8199,8199999,21.26254237239073,37.92601546221815,0.08124958907561852,1550.5407872200012,559.5979106426239,1368.249584197998,52648,9308,43340,43340,0,12,8200000.0
8200,8200999,21.262299190897014,37.92486158905301,0.08123957665334525,1550.903666973114,559.6659798622131,1368.411289215088,52657,9310,43347,43347,0,12,8201000.0
8201,8201999,21.262319414829566,37.926340643376896,0.08122643549666264,1551.160483598709,559.7335963249207,1368.5577850341797,52661,9311,43350,43350,0,12,8202000.0
8202,8202999,21.262150518904853,37.92540936676953,0.08121699414314176,1551.5266733169556,559.8011102676392,1368.6487464904785,52666,9313,43353,43353,0,12,8203000.0
8203,8203999,21.262270888274962,37.924914354434776,0.08120707070273858,1551.651743888855,559.8700206279755,1368.8577346801758,52666,9313,43353,43353,0,12,8204000.0
8204,8204999,21.26254505943786,37.924703523508576,0.08118883011743339,1551.8973181247711,559.9378395080566,1369.1110610961914,52668,9314,43354,43354,0,12,8205000.0
8205,8205999,21.26356077330637,37.925279983112794,0.08113426547167435,1552.0125932693481,560.0039286613464,1369.3886375427246,52668,9314,43354,43354,0,12,8206000.0
8206,8206999,21.26453297037694,37.9259059104161,0.08109648951920911,1552.2606177330017,560.0719227790833,1369.5464363098145,52670,9315,43355,43355,0,12,8207000.0
8207,8207999,21.265563851425224,37.92914126598162,0.08105629905583156,1552.5079016685486,560.1385860443115,1369.6622047424316,52673,9316,43357,43357,0,12,8208000.0
8208,8208999,21.266365320910104,37.92928430956093,0.08102915183691817,1552.7652595043182,560.2055728435516,1369.7711868286133,52675,9317,43358,43358,0,12,8209000.0
8209,8209999,21.267354365897337,37.92988229185029,0.08099642031832177,1553.0079622268677,560.2731533050537,1369.8703689575195,52677,9318,43359,43359,0,12,8210000.0
8210,8210999,21.268824360709356,37.93098562839922,0.08092444882308136,1553.1426417827606,560.3404591083527,1370.1074867248535,52677,9318,43359,43359,0,12,8211000.0
8211,8211999,21.270617663119786,37.93217576706444,0.08084882489209899,1553.4048924446106,560.4171636104584,1370.2182426452637,52679,9319,43360,43360,0,12,8212000.0
8212,8212999,21.271844311599974,37.932600184101936,0.08079385183350696,1553.5253031253815,560.4829132556915,1370.35648727417,52679,9319,43360,43360,0,12,8213000.0
8213,8213999,21.273054614216548,37.93279021699169,0.08074157128739157,1553.6416954994202,560.548478603363,1370.458896636963,52679,9319,43360,43360,0,12,8214000.0
8214,8214999,21.27363939637179,37.93310135803011,0.08070873608681195,1553.8993537425995,560.614531993866,1370.8064804077148,52697,9320,43377,43377,0,12,8215000.0
8215,8215999,21.273160653479053,37.93196359326137,0.08069702841935933,1554.1453866958618,560.680862903595,1371.1085662841797,52710,9321,43389,43389,0,12,8216000.0
8216,8216999,21.272674849959973,37.93168679864832,0.08069224368526906,1554.2618124485016,560.7471671104431,1371.2953414916992,52710,9321,43389,43389,0,12,8217000.0
8217,8217999,21.27231671392689,37.930808440142116,0.08068255586940687,1554.5104777812958,560.8145809173584,1371.4399604797363,52722,9322,43400,43400,0,12,8218000.0
8218,8218999,21.271795182759146,37.92945868392448,0.08067664688611142,1554.6440422534943,560.8804705142975,1371.5687446594238,52722,9322,43400,43400,0,12,8219000.0
8219,8219999,21.271413924839134,37.92830349232245,0.08067541792681665,1555.028504371643,560.9485366344452,1371.6941833496094,52735,9324,43411,43411,0,12,8220000.0
8220,8220999,21.27107186314518,37.92736662840454,0.08066858101759178,1555.4066615104675,561.0159873962402,1371.7508506774902,52749,9326,43423,43423,0,12,8221000.0
8221,8221999,21.270570167007644,37.92613515979287,0.08066450801025482,1555.5280990600586,561.0829367637634,1371.8707695007324,52749,9326,43423,43423,0,12,8222000.0
8222,8222999,21.270375258837326,37.925356450340324,0.08065981008054623,1555.6459021568298,561.1487085819244,1371.9440269470215,52749,9326,43423,43423,0,12,8223000.0
8223,8223999,21.270202560595997,37.92478315092948,0.08064984717891888,1555.7750663757324,561.2148661613464,1372.086784362793,52749,9326,43423,43423,0,12,8224000.0
8224,8224999,21.269873531830704,37.92385357722856,0.0806441350950553,1555.9076125621796,561.2804214954376,1372.1627464294434,52749,9326,43423,43423,0,12,8225000.0
8225,8225999,21.26977605493699,37.92289024235595,0.08063626512236133,1556.0270578861237,561.3469800949097,1372.4226036071777,52750,9326,43424,43424,0,12,8226000.0
8226,8226999,21.26980719309568,37.92218495072542,0.0806356037462348,1556.5317869186401,561.413473367691,1372.3601188659668,52767,9329,43438,43438,0,12,8227000.0
8227,8227999,21.26989762290299,37.92166924763762,0.08062916860304892,1556.784332036972,561.4808037281036,1372.4526176452637,52772,9330,43442,43442,0,12,8228000.0
8228,8228999,21.270150725804676,37.92135446146339,0.08062428457056725,1557.0297515392303,561.5475745201111,1372.530746459961,52774,9331,43443,43443,0,12,8229000.0
8229,8229999,21.270600914653507,37.92134755262305,0.08062072237536233,1557.2940924167633,561.6141724586487,1372.587001800537,52777,9332,43445,43445,0,12,8230000.0
8230,8230999,21.271156897649195,37.92144958208724,0.08061286325197237,1557.4169108867645,561.6799397468567,1372.775489807129,52779,9332,43447,43447,0,12,8231000.0
8231,8231999,21.272002399907468,37.92160321328471,0.0805965124873167,1557.5311415195465,561.7455976009369,1372.931137084961,52780,9332,43448,43448,0,12,8232000.0
8232,8232999,21.272588992040227,37.92147556740247,0.08058552370681582,1557.6580173969269,561.8128345012665,1373.0440254211426,52780,9332,43448,43448,0,12,8233000.0
8233,8233999,21.272986210119544,37.920955548474105,0.08057837879055663,1557.9027063846588,561.879230260849,1373.100788116455,52782,9333,43449,43449,0,12,8234000.0
8234,8234999,21.273236269536014,37.921650620992665,0.08056433424186527,1558.0443651676178,561.9446558952332,1373.1991882324219,52782,9333,43449,43449,0,12,8235000.0
8235,8235999,21.272911869935506,37.921911889958515,0.08055311160498002,1558.4162583351135,562.0113258361816,1373.698844909668,52811,9335,43476,43476,0,12,8236000.0
8236,8236999,21.272255600691224,37.920889334261844,0.08055338815534141,1558.5420577526093,562.0785562992096,1373.9306678771973,52811,9335,43476,43476,0,12,8237000.0
8237,8237999,21.271871170000242,37.92094677642143,0.08054750186800752,1558.9152982234955,562.1459863185883,1374.035816192627,52825,9337,43488,43488,0,12,8238000.0
8238,8238999,21.271579001701415,37.92106776038973,0.08053837411215037,1559.2843708992004,562.213830947876,1374.1049156188965,52832,9339,43493,43493,0,12,8239000.0
8239,8239999,21.271378953515658,37.92047253372816,0.08052994605668606,1559.5351519584656,562.2832152843475,1374.412940979004,52837,9340,43497,43497,0,12,8240000.0
8240,8240999,21.271280184028342,37.92043666227792,0.08051928364528893,1559.7762517929077,562.3502306938171,1374.6268310546875,52839,9341,43498,43498,0,12,8241000.0
8241,8241999,21.271321758211084,37.9200652822473,0.08051026450723442,1560.2842519283295,562.4199998378754,1374.7793350219727,52850,9344,43506,43506,0,12,8242000.0
8242,8242999,21.271296177291767,37.919542094923635,0.0805044833770564,1560.41423869133,562.4889252185822,1374.9594802856445,52850,9344,43506,43506,0,12,8243000.0
8243,8243999,21.271370669413376,37.919118760691504,0.08049684458770967,1560.6576731204987,562.5568044185638,1375.1057167053223,52854,9345,43509,43509,0,12,8244000.0
8244,8244999,21.271538973258867,37.91908428778774,0.08048741328171882,1560.904179096222,562.6235208511353,1375.2392578125,52856,9346,43510,43510,0,12,8245000.0
8245,8245999,21.27195688359174,37.91929334553205,0.0804757284845602,1561.0353016853333,562.6920351982117,1375.7819595336914,52859,9346,43513,43513,0,12,8246000.0
8246,8246999,21.27235467566615,37.91959848550693,0.08046911694151415,1561.1510314941406,562.760005235672,1376.0340118408203,52859,9346,43513,43513,0,12,8247000.0
8247,8247999,21.272529469604983,37.91939119167228,0.0804670034988888,1561.398519039154,562.8269057273865,1376.2103309631348,52861,9347,43514,43514,0,12,8248000.0
8248,8248999,21.27334440428802,37.92185117068998,0.08045768980841195,1561.5257930755615,562.8946914672852,1376.343162536621,52861,9347,43514,43514,0,12,8249000.0
8249,8249999,21.27393237472983,37.922188171283146,0.0804574625022818,1561.6525919437408,562.9619240760803,1376.492733001709,52861,9347,43514,43514,0,12,8250000.0
8250,8250999,21.274625744148505,37.9224391639216,0.08045613917980066,1561.8986077308655,563.0298361778259,1376.7286643981934,52863,9348,43515,43515,0,12,8251000.0
8251,8251999,21.276006442944684,37.924293044445825,0.0804402857823765,1562.023069858551,563.0967931747437,1376.9473190307617,52863,9348,43515,43515,0,12,8252000.0
8252,8252999,21.27701513859241,37.92568339079685,0.08043935194534357,1562.1436173915863,563.1634035110474,1377.1169815063477,52863,9348,43515,43515,0,12,8253000.0
8253,8253999,21.27821341375272,37.92666176589269,0.08043779465299994,1562.2665240764618,563.2299258708954,1377.240234375,52863,9348,43515,43515,0,12,8254000.0
8254,8254999,21.27904212781028,37.92675096974235,0.08043669473866388,1562.3942284584045,563.2953867912292,1377.39351272583,52864,9348,43516,43516,0,12,8255000.0
8255,8255999,21.279057794554106,37.92754803459545,0.08042789839052022,1562.9097955226898,563.3650810718536,1377.8222846984863,52883,9351,43532,43532,0,12,8256000.0
8256,8256999,21.279369397427978,37.9283385365278,0.08042523322351092,1563.1553950309753,563.4329655170441,1378.005859375,52886,9352,43534,43534,0,12,8257000.0
8257,8257999,21.280304666805982,37.93042954551846,0.08041206521924271,1563.2897350788116,563.5010533332825,1378.289894104004,52886,9352,43534,43534,0,12,8258000.0
8258,8258999,21.281107476984953,37.93473408850153,0.08039775393023485,1563.5361034870148,563.5690503120422,1378.3869285583496,52898,9353,43545,43545,0,12,8259000.0
8259,8259999,21.281973560892883,37.936391692135295,0.08039683776036377,1563.915028333664,563.6367971897125,1378.7146530151367,52913,9355,43558,43558,0,12,8260000.0
8260,8260999,21.282760276062465,37.93739436144677,0.08039038440617963,1564.282547235489,563.7060832977295,1378.8628730773926,52917,9357,43560,43560,0,12,8261000.0
8261,8261999,21.28398885233367,37.939188460412,0.0803873005505974,1564.4118814468384,563.7741692066193,1379.0450286865234,52917,9357,43560,43560,0,12,8262000.0
8262,8262999,21.284981084990466,37.94023011039348,0.08039133489741968,1564.658347606659,563.841933965683,1379.189453125,52929,9358,43571,43571,0,12,8263000.0
8263,8263999,21.286301888935604,37.94183296033573,0.08039381033613968,1564.902756690979,563.9097769260406,1379.2921829223633,52932,9359,43573,43573,0,12,8264000.0
8264,8264999,21.287471166176488,37.94433076595134,0.08039018155845168,1565.1619277000427,563.9840455055237,1379.6647415161133,52941,9360,43581,43581,0,12,8265000.0
8265,8265999,21.288701942384925,37.94603430735491,0.08039784287854623,1565.285700559616,564.050778388977,1379.8254737854004,52941,9360,43581,43581,0,12,8266000.0
8266,8266999,21.290193703303203,37.947772620587735,0.08040593973331145,1565.7915496826172,564.1184892654419,1379.8165283203125,52960,9363,43597,43597,0,12,8267000.0
8267,8267999,21.291469402168705,37.94917337229815,0.08041852367232227,1565.9275097846985,564.1863467693329,1379.94091796875,52960,9363,43597,43597,0,12,8268000.0
8268,8268999,21.29283587548433,37.9508399700786,0.0804458393960249,1566.1842284202576,564.2549982070923,1380.054328918457,52972,9364,43608,43608,0,12,8269000.0
8269,8269999,21.294788480618962,37.95489488816679,0.08046123769381386,1566.564087152481,564.3229987621307,1380.4006614685059,53007,9366,43641,43641,0,12,8270000.0
8270,8270999,21.296263653430458,37.95629400723119,0.08047607633203613,1566.6806514263153,564.3893790245056,1380.6121788024902,53007,9366,43641,43641,0,12,8271000.0
8271,8271999,21.297798625278908,37.9577743858835,0.08050171673224038,1567.05326628685,564.456316947937,1380.683879852295,53031,9368,43663,43663,0,12,8272000.0
8272,8272999,21.2992473387223,37.95898136005981,0.08052890974854376,1567.2993652820587,564.5233750343323,1380.7613830566406,53033,9369,43664,43664,0,12,8273000.0
8273,8273999,21.29965456086577,37.959589105926256,0.08053124897721198,1567.6695339679718,564.5904970169067,1381.2906341552734,53061,9371,43690,43690,0,12,8274000.0
8274,8274999,21.299394996787953,37.96072703163746,0.08051966774756458,1567.7995779514313,564.6596512794495,1381.6947135925293,53061,9371,43690,43690,0,12,8275000.0
8275,8275999,21.299088894242317,37.960862675215004,0.08051122581982195,1567.924216747284,564.7283518314362,1381.9333229064941,53061,9371,43690,43690,0,12,8276000.0
8276,8276999,21.2988238451846,37.961448589849994,0.0804983215431454,1568.169112443924,564.7957813739777,1382.0641708374023,53064,9372,43692,43692,0,12,8277000.0
8277,8277999,21.29875404061166,37.96136746233169,0.0804858046198158,1568.305831193924,564.8649973869324,1382.402545928955,53066,9372,43694,43694,0,12,8278000.0
8278,8278999,21.298556930237403,37.96105627938658,0.08047933172083133,1568.5712847709656,564.9332780838013,1382.5352210998535,53078,9373,43705,43705,0,12,8279000.0
8279,8279999,21.2986327823211,37.96081302148231,0.08047052781650788,1568.691959142685,565.001482963562,1382.680477142334,53078,9373,43705,43705,0,12,8280000.0
8280,8280999,21.298989597159345,37.96150169689809,0.08045805432555586,1568.9413437843323,565.0693361759186,1382.7880935668945,53080,9374,43706,43706,0,12,8281000.0
8281,8281999,21.299160967916396,37.961511781420796,0.08044781526420886,1569.2079603672028,565.1444160938263,1382.8579750061035,53082,9375,43707,43707,0,12,8282000.0
8282,8282999,21.299393942223382,37.9616130811656,0.08043699178035446,1569.3400297164917,565.2128913402557,1383.2414016723633,53083,9375,43708,43708,0,12,8283000.0
8283,8283999,21.299848701521274,37.96219599604616,0.08043106616728368,1569.4740929603577,565.2818446159363,1383.396484375,53083,9375,43708,43708,0,12,8284000.0
8284,8284999,21.300329227858903,37.96261256755883,0.08041904837197222,1569.8476376533508,565.3496849536896,1383.4775619506836,53101,9377,43724,43724,0,12,8285000.0
8285,8285999,21.300791229967455,37.96287932789931,0.08041123516044757,1569.9776465892792,565.4177927970886,1383.624713897705,53102,9377,43725,43725,0,12,8286000.0
8286,8286999,21.301105296470283,37.962924755350286,0.08040232112698709,1570.107078552246,565.4866406917572,1383.756061553955,53102,9377,43725,43725,0,12,8287000.0
8287,8287999,21.301536300906864,37.963013861316426,0.08039184638443642,1570.2337238788605,565.55437541008,1383.994441986084,53102,9377,43725,43725,0,12,8288000.0
8288,8288999,21.30183411313973,37.96305958121244,0.08038352652331837,1570.6226983070374,565.622716665268,1384.0638008117676,53116,9379,43737,43737,0,12,8289000.0
8289,8289999,21.301933152427026,37.96243533207062,0.08037716916144622,1570.7471370697021,565.690367937088,1384.186767578125,53116,9379,43737,43737,0,12,8290000.0
8290,8290999,21.301910431947523,37.96370072996565,0.08036492138614548,1571.2369503974915,565.7584645748138,1384.652515411377,53153,9382,43771,43771,0,12,8291000.0
8291,8291999,21.301458372805687,37.962806904923966,0.08035706085698968,1571.887489080429,565.8309767246246,1384.6775665283203,53194,9386,43808,43808,0,12,8292000.0
8292,8292999,21.301139255376487,37.96268918281993,0.08034977543679256,1572.2612192630768,565.8993890285492,1384.839698791504,53207,9388,43819,43819,0,12,8293000.0
8293,8293999,21.300901841179968,37.9620194130381,0.0803425437583436,1572.5136001110077,565.968186378479,1385.1682434082031,53211,9389,43822,43822,0,12,8294000.0
8294,8294999,21.30075731841665,37.96157182638284,0.08033565325018543,1572.8925516605377,566.0375308990479,1385.3761558532715,53215,9391,43824,43824,0,12,8295000.0
8295,8295999,21.300670307284005,37.96160940790946,0.08032803782823439,1573.1443846225739,566.1045117378235,1385.5539321899414,53219,9392,43827,43827,0,12,8296000.0
8296,8296999,21.30058203976652,37.961836753802594,0.08031959536648547,1573.5122394561768,566.1725940704346,1385.6153182983398,53225,9394,43831,43831,0,12,8297000.0
8297,8297999,21.300581271207495,37.9617548411572,0.08031264429673146,1573.6355211734772,566.2406208515167,1385.8034286499023,53225,9394,43831,43831,0,12,8298000.0
8298,8298999,21.30069330421057,37.96186742404332,0.08030455637430234,1573.8840034008026,566.3088052272797,1385.9266929626465,53237,9395,43842,43842,0,12,8299000.0
8299,8299999,21.300862165063798,37.96158091131958,0.08029405333723871,1574.010225534439,566.3772761821747,1386.2845268249512,53238,9395,43843,43843,0,12,8300000.0
8300,8300999,21.301271793323888,37.962437009712126,0.08028760079962605,1574.2514896392822,566.4437878131866,1386.4277153015137,53241,9396,43845,43845,0,12,8301000.0
8301,8301999,21.301483209189026,37.962298752869344,0.08027766083853882,1574.5023610591888,566.5107283592224,1386.5532722473145,53243,9397,43846,43846,0,12,8302000.0
8302,8302999,21.301963666273828,37.96275740923732,0.08026551562635875,1574.7457280158997,566.5777349472046,1386.65287399292,53255,9398,43857,43857,0,12,8303000.0
8303,8303999,21.30210309368312,37.96268169045004,0.08026124418364933,1574.8665480613708,566.6449520587921,1386.7971420288086,53255,9398,43857,43857,0,12,8304000.0
8304,8304999,21.30226941894897,37.96257257950835,0.08025240024755009,1574.9960687160492,566.7118215560913,1386.891399383545,53255,9398,43857,43857,0,12,8305000.0
8305,8305999,21.302693268383695,37.962598462959086,0.08024215898278597,1575.2423331737518,566.7792015075684,1387.1080055236816,53257,9399,43858,43858,0,12,8306000.0
8306,8306999,21.30294539153719,37.962466335761434,0.0802303085338264,1575.6068065166473,566.8466477394104,1387.1468811035156,53271,9401,43870,43870,0,12,8307000.0
8307,8307999,21.303246481503706,37.96299438865448,0.08021861380375139,1575.9881565570831,566.9136159420013,1387.1838912963867,53275,9403,43872,43872,0,12,8308000.0
8308,8308999,21.30308347932417,37.96205006672273,0.08021394547112182,1576.244950056076,566.9802138805389,1387.2305526733398,53287,9404,43883,43883,0,12,8309000.0
8309,8309999,21.3034935311657,37.962115277145266,0.08018515631733358,1576.370573759079,567.0476446151733,1387.742603302002,53291,9404,43887,43887,0,12,8310000.0
8310,8310999,21.303541208227248,37.9617101984415,0.08015747249897598,1576.7534289360046,567.1149175167084,1387.999080657959,53315,9406,43909,43909,0,12,8311000.0
8311,8311999,21.303820286385946,37.96234212118544,0.08012063092037158,1576.8843894004822,567.1818058490753,1388.2309799194336,53315,9406,43909,43909,0,12,8312000.0
8312,8312999,21.304168598213796,37.9627099225775,0.08008469831910825,1577.0140857696533,567.2484712600708,1388.3992958068848,53315,9406,43909,43909,0,12,8313000.0
8313,8313999,21.304389230500874,37.96295854774399,0.08006065093324022,1577.1347682476044,567.3150322437286,1388.578712463379,53315,9406,43909,43909,0,12,8314000.0
8314,8314999,21.3050538844475,37.9633160126022,0.0800320596336046,1577.5168387889862,567.3819417953491,1388.8179473876953,53320,9408,43912,43912,0,12,8315000.0
8315,8315999,21.305718761532933,37.96380765607427,0.08000473602116098,1577.7655205726624,567.4497358798981,1388.980297088623,53351,9409,43942,43942,0,12,8316000.0
8316,8316999,21.306171285835962,37.96410860883196,0.07998099217944599,1578.015785932541,567.5169103145599,1389.0571899414062,53356,9410,43946,43946,0,12,8317000.0
8317,8317999,21.306678380500497,37.96409762088318,0.07995694378299667,1578.1355483531952,567.5829560756683,1389.157917022705,53356,9410,43946,43946,0,12,8318000.0
8318,8318999,21.307284741830497,37.96431086990463,0.0799279876682103,1578.2662904262543,567.6500935554504,1389.3232154846191,53357,9410,43947,43947,0,12,8319000.0
8319,8319999,21.30843910609856,37.96515911268212,0.07990490403685457,1578.5246860980988,567.7167398929596,1389.5807609558105,53360,9411,43949,43949,0,12,8320000.0
8320,8320999,21.309890618721596,37.96630203850103,0.07986176704441039,1578.6402554512024,567.7822575569153,1389.7520179748535,53360,9411,43949,43949,0,12,8321000.0
8321,8321999,21.31093344441425,37.96676923910513,0.07983074554129899,1578.7710781097412,567.8482885360718,1389.912410736084,53360,9411,43949,43949,0,12,8322000.0
8322,8322999,21.31215781923819,37.96749597697162,0.07980161523961049,1579.1460525989532,567.9149439334869,1389.9429626464844,53364,9413,43951,43951,0,12,8323000.0
8323,8323999,21.313218817107668,37.968310859383706,0.07978038862133652,1579.390230178833,567.9811582565308,1390.0823287963867,53376,9414,43962,43962,0,12,8324000.0
8324,8324999,21.314299088969623,37.96883939337505,0.0797542900549727,1579.7663793563843,568.0485072135925,1390.1104850769043,53391,9416,43975,43975,0,12,8325000.0
8325,8325999,21.315913334841902,37.97010939898461,0.07968915761205742,1579.8888068199158,568.1146855354309,1390.3626976013184,53391,9416,43975,43975,0,12,8326000.0
8326,8326999,21.317628150121692,37.97168640966598,0.07964394695364085,1580.014032125473,568.1824266910553,1390.4912567138672,53391,9416,43975,43975,0,12,8327000.0
8327,8327999,21.31923761622642,37.973126963314165,0.07961299140854095,1580.1432747840881,568.2475869655609,1390.5771217346191,53391,9416,43975,43975,0,12,8328000.0
8328,8328999,21.320436380654183,37.973664622053,0.07958806946771657,1580.271394252777,568.3129281997681,1390.6352005004883,53391,9416,43975,43975,0,12,8329000.0
8329,8329999,21.32100427550103,37.974579277321276,0.07956158758335408,1580.5218572616577,568.3798804283142,1391.1695518493652,53399,9417,43982,43982,0,12,8330000.0
8330,8330999,21.320819428071,37.97385886272693,0.07955879830070245,1580.6375358104706,568.447291135788,1391.547966003418,53399,9417,43982,43982,0,12,8331000.0
8331,8331999,21.320794738541085,37.97406540352739,0.07955368281121811,1580.7603962421417,568.514814376831,1391.8108215332031,53399,9417,43982,43982,0,12,8332000.0
8332,8332999,21.320988460575265,37.97495094581799,0.07955010987976574,1580.8845398426056,568.5827646255493,1391.9971504211426,53399,9417,43982,43982,0,12,8333000.0
8333,8333999,21.321162360165857,37.97475883424529,0.07954962322232595,1581.1350445747375,568.6509912014008,1392.2955627441406,53401,9418,43983,43983,0,12,8334000.0
8334,8334999,21.32187604660591,37.975985208757606,0.07954730333336668,1581.6297352313995,568.717981338501,1392.4784240722656,53417,9421,43996,43996,0,12,8335000.0
8335,8335999,21.322411541264035,37.97628255967869,0.07954636770899637,1581.7571539878845,568.7854838371277,1392.702377319336,53417,9421,43996,43996,0,12,8336000.0
8336,8336999,21.323217903250566,37.97728773520723,0.07953835855494074,1581.8806283473969,568.8526041507721,1392.847713470459,53417,9421,43996,43996,0,12,8337000.0
8337,8337999,21.32397819415034,37.978460749080234,0.07953204300502847,1582.252768754959,568.9207689762115,1392.9531173706055,53424,9423,44001,44001,0,12,8338000.0
8338,8338999,21.32510859926596,37.98004659167312,0.07953035957810906,1582.493290424347,568.9871108531952,1393.089153289795,53426,9424,44002,44002,0,12,8339000.0
8339,8339999,21.326743252104944,37.98255905451581,0.07952647682333358,1582.742790222168,569.0553402900696,1393.5040016174316,53429,9425,44004,44004,0,12,8340000.0
8340,8340999,21.32850436628257,37.98499381397623,0.07951003282185132,1582.9795496463776,569.1221115589142,1393.676124572754,53431,9426,44005,44005,0,12,8341000.0
8341,8341999,21.3302187116289,37.98677390556265,0.07949404172372299,1583.4982771873474,569.1900432109833,1393.6726150512695,53442,9429,44013,44013,0,12,8342000.0
8342,8342999,21.33216836645322,37.9891846750166,0.07949681071734638,1583.7408564090729,569.2564733028412,1393.801830291748,53444,9430,44014,44014,0,12,8343000.0
8343,8343999,21.33439445090116,37.99211026923176,0.07950989983974399,1584.2367312908173,569.3241829872131,1393.92232131958,53470,9433,44037,44037,0,12,8344000.0
8344,8344999,21.336385346890264,37.994049011797614,0.07952029195435906,1584.604175567627,569.3908841609955,1394.1595573425293,53494,9435,44059,44059,0,12,8345000.0
8345,8345999,21.339122860153992,37.997516048492855,0.07951632269189524,1584.7200355529785,569.4575440883636,1394.3828086853027,53494,9435,44059,44059,0,12,8346000.0
8346,8346999,21.34119384033638,37.99951489958828,0.07952372331494573,1585.0859973430634,569.5237789154053,1394.4845085144043,53508,9437,44071,44071,0,12,8347000.0
8347,8347999,21.34325306677219,38.00126158969254,0.07953769219319595,1585.326595067978,569.5905594825745,1394.5699043273926,53512,9438,44074,44074,0,12,8348000.0
8348,8348999,21.34430858212237,38.00154317433188,0.07953605392397856,1585.6977565288544,569.6572647094727,1394.7532424926758,53528,9440,44088,44088,0,12,8349000.0
8349,8349999,21.344910473041224,38.00230982345132,0.07948989112789906,1586.0720572471619,569.7240188121796,1395.1957359313965,53544,9442,44102,44102,0,12,8350000.0
8350,8350999,21.344837624686047,38.00209831716942,0.07946323001970035,1586.4413239955902,569.7912089824677,1395.3709144592285,53568,9444,44124,44124,0,12,8351000.0
8351,8351999,21.34511933863417,38.00248557169609,0.07943690573849127,1586.5719833374023,569.8574075698853,1395.5946998596191,53568,9444,44124,44124,0,12,8352000.0
8352,8352999,21.345198740524328,38.0018768967491,0.07940594997525974,1586.8241474628448,569.9245095252991,1395.7378005981445,53570,9445,44125,44125,0,12,8353000.0
8353,8353999,21.345345194913662,38.00111109372023,0.07937264988338344,1587.191392660141,569.9922602176666,1395.9929695129395,53584,9447,44137,44137,0,12,8354000.0
8354,8354999,21.345595636897034,38.0004460692634,0.07933545248388219,1587.3103334903717,570.0582797527313,1396.214012145996,53584,9447,44137,44137,0,12,8355000.0
8355,8355999,21.345676559441596,37.9996878332855,0.07930673032415947,1587.4311957359314,570.1242599487305,1396.363567352295,53584,9447,44137,44137,0,12,8356000.0
8356,8356999,21.345994219066913,37.999216193237146,0.07927201095621528,1587.6858744621277,570.1905539035797,1396.4537658691406,53596,9448,44148,44148,0,12,8357000.0
8357,8357999,21.346458574652228,37.999132341403765,0.07922810272555736,1587.8062763214111,570.2562658786774,1396.5994186401367,53596,9448,44148,44148,0,12,8358000.0
8358,8358999,21.346632306821387,37.99850822684401,0.07919509321177887,1588.054339170456,570.3234918117523,1396.6556091308594,53600,9449,44151,44151,0,12,8359000.0
8359,8359999,21.347824091181398,37.99900139697863,0.07912131218162377,1588.1724410057068,570.3894944190979,1397.0554122924805,53600,9449,44151,44151,0,12,8360000.0
8360,8360999,21.34901007677171,37.99935442307369,0.07905274092924675,1588.412288427353,570.4552936553955,1397.19287109375,53604,9450,44154,44154,0,12,8361000.0
8361,8361999,21.349949998255177,37.99946066102624,0.0789965886950259,1588.6633229255676,570.522278547287,1397.2848052978516,53606,9451,44155,44155,0,12,8362000.0
8362,8362999,21.350742400918122,37.9994412218381,0.0789515463203615,1588.9213585853577,570.5889799594879,1397.3770027160645,53608,9452,44156,44156,0,12,8363000.0
8363,8363999,21.351441273285605,37.99911573652676,0.07890375651997028,1589.0403554439545,570.6560642719269,1397.4928436279297,53608,9452,44156,44156,0,12,8364000.0
8364,8364999,21.352771867704327,37.99988526912063,0.07881188001449924,1589.2923662662506,570.7225947380066,1397.6469268798828,53611,9453,44158,44158,0,12,8365000.0
8365,8365999,21.355419432831656,38.00243496977991,0.07863659469848538,1589.5255200862885,570.7880351543427,1397.8107299804688,53618,9454,44164,44164,0,12,8366000.0
8366,8366999,21.35730662134649,38.00346439824813,0.07853028566458597,1589.7782468795776,570.8546760082245,1397.9140167236328,53630,9455,44175,44175,0,12,8367000.0
8367,8367999,21.358929245430062,38.00427287417205,0.07843424682182587,1589.9115312099457,570.9209344387054,1398.0055122375488,53630,9455,44175,44175,0,12,8368000.0
8368,8368999,21.359743508173164,38.0042666820519,0.07838340846793823,1590.290079832077,570.9880270957947,1398.0553512573242,53654,9457,44197,44197,0,12,8369000.0
8369,8369999,21.359776108058323,38.00382248342101,0.07835925816813516,1590.4071128368378,571.0546839237213,1398.7251930236816,53660,9457,44203,44203,0,12,8370000.0
8370,8370999,21.35947213607567,38.00326668546342,0.07833592968758729,1590.6519482135773,571.1226081848145,1398.9371299743652,53662,9458,44204,44204,0,12,8371000.0
8371,8371999,21.35912922803124,38.002008832104416,0.07831995736752584,1590.902126789093,571.1903829574585,1399.1043510437012,53664,9459,44205,44205,0,12,8372000.0
8372,8372999,21.358666640244792,38.00065617536415,0.07831093091495211,1591.0222582817078,571.2581424713135,1399.2674026489258,53664,9459,44205,44205,0,12,8373000.0
8373,8373999,21.35869074491201,38.000909286752126,0.0782901708035828,1591.274337530136,571.3263909816742,1399.6229515075684,53668,9460,44208,44208,0,12,8374000.0
8374,8374999,21.358538104945357,37.99976363198453,0.07827373246361713,1591.5232067108154,571.3939068317413,1399.7849044799805,53670,9461,44209,44209,0,12,8375000.0
8375,8375999,21.358175711018127,37.998762611174755,0.07826508857172099,1591.7705426216125,571.4618237018585,1399.9352111816406,53672,9462,44210,44210,0,12,8376000.0
8376,8376999,21.358189587217318,38.00026405944101,0.07824222449162765,1592.0234262943268,571.5300002098083,1400.0477905273438,53684,9463,44221,44221,0,12,8377000.0
8377,8377999,21.35818358713393,38.00041985171523,0.07821679957298833,1592.1557631492615,571.5970342159271,1400.2147407531738,53684,9463,44221,44221,0,12,8378000.0
8378,8378999,21.358353309130646,38.00002949403963,0.07819056765081289,1592.5234127044678,571.6642682552338,1400.3246994018555,53698,9465,44233,44233,0,12,8379000.0
8379,8379999,21.35874263829707,37.99942434173659,0.07814422726973247,1592.6582660675049,571.7320101261139,1400.6831016540527,53698,9465,44233,44233,0,12,8380000.0
8380,8380999,21.35941501354089,37.999117936304756,0.07809495925920651,1593.0227918624878,571.7988810539246,1400.848201751709,53721,9467,44254,44254,0,12,8381000.0
8381,8381999,21.360071777585976,37.99998076022908,0.07805160779607456,1593.1567647457123,571.8668689727783,1401.0102310180664,53721,9467,44254,44254,0,12,8382000.0
8382,8382999,21.36047592577142,37.999526096142965,0.07802406183671584,1593.4106662273407,571.9343695640564,1401.0721817016602,53733,9468,44265,44265,0,12,8383000.0
8383,8383999,21.361062378939298,37.999499531180746,0.07799461305535471,1593.5305361747742,572.0020887851715,1401.1894149780273,53733,9468,44265,44265,0,12,8384000.0
8384,8384999,21.361751556335882,37.99935361754024,0.0779535690098202,1593.6615238189697,572.0693535804749,1401.3892631530762,53733,9468,44265,44265,0,12,8385000.0
8385,8385999,21.363404622617434,38.00047647708319,0.07787965073184389,1593.7790591716766,572.1354751586914,1401.5690231323242,53733,9468,44265,44265,0,12,8386000.0
8386,8386999,21.36467515472862,38.00101644677337,0.07780737554487871,1593.896847486496,572.2018413543701,1401.705093383789,53733,9468,44265,44265,0,12,8387000.0
8387,8387999,21.365677757058137,38.001098706028095,0.07774995392774708,1594.1612100601196,572.2685010433197,1401.7725563049316,53745,9469,44276,44276,0,12,8388000.0
8388,8388999,21.366750983640173,38.00277393059136,0.07771960148474466,1594.2919311523438,572.33447098732,1401.860107421875,53745,9469,44276,44276,0,12,8389000.0
8389,8389999,21.366453917287267,38.00176584734283,0.07770523332280987,1594.6646780967712,572.403461933136,1402.4777908325195,53783,9471,44312,44312,0,12,8390000.0
8390,8390999,21.365768062477787,38.00028899845866,0.0776964664804003,1594.9101388454437,572.4721887111664,1402.7126770019531,53787,9472,44315,44315,0,12,8391000.0
8391,8391999,21.365266717242683,37.999503378824905,0.07768873007767907,1595.2787215709686,572.5400013923645,1402.8419036865234,53805,9474,44331,44331,0,12,8392000.0
8392,8392999,21.364694005551776,37.99823385796819,0.07768357745812282,1595.6549055576324,572.6081099510193,1402.9984817504883,53820,9476,44344,44344,0,12,8393000.0
8393,8393999,21.36446727641782,37.99753658457822,0.07767294095446942,1596.026622056961,572.6767446994781,1403.2874603271484,53828,9478,44350,44350,0,12,8394000.0
8394,8394999,21.364528120921214,37.99692440638579,0.07766019705942895,1596.1402821540833,572.7455289363861,1403.5963973999023,53829,9478,44351,44351,0,12,8395000.0
8395,8395999,21.36450045902824,37.99631333943227,0.07765079539063058,1596.6416087150574,572.8133056163788,1403.700538635254,53835,9481,44354,44354,0,12,8396000.0
8396,8396999,21.36436036453985,37.99540159115902,0.07764325253757887,1596.7665770053864,572.8814101219177,1403.8889045715332,53835,9481,44354,44354,0,12,8397000.0
8397,8397999,21.36476200598276,37.99824005303931,0.0776235285293655,1596.8830995559692,572.9492795467377,1404.063663482666,53837,9481,44356,44356,0,12,8398000.0
8398,8398999,21.365114563591792,37.99865527891059,0.07761099515032543,1597.1343166828156,573.016970872879,1404.1835250854492,53840,9482,44358,44358,0,12,8399000.0
8399,8399999,21.365566976132502,37.998507716036784,0.07759819711138272,1597.2589793205261,573.085126876831,1404.4919624328613,53846,9482,44364,44364,0,12,8400000.0
8400,8400999,21.366186205619822,37.998820448984084,0.0775789904954074,1597.3759865760803,573.151787519455,1404.6421966552734,53846,9482,44364,44364,0,12,8401000.0
8401,8401999,21.36685311398275,37.99945248242764,0.07756324791051505,1597.6334660053253,573.2191548347473,1404.7434730529785,53849,9483,44366,44366,0,12,8402000.0
8402,8402999,21.367543378483138,37.99981830982118,0.07754788952780278,1597.8745384216309,573.2864174842834,1404.7929725646973,53851,9484,44367,44367,0,12,8403000.0
8403,8403999,21.36801902108551,37.99980947614454,0.07754089927311159,1598.1218688488007,573.3531954288483,1404.883716583252,53853,9485,44368,44368,0,12,8404000.0
8404,8404999,21.36860664565658,37.99968504723262,0.0775298550343515,1598.7450859546661,573.4216215610504,1404.8831634521484,53864,9489,44375,44375,0,12,8405000.0
8405,8405999,21.36987074399176,38.00059230557089,0.07750999914308121,1598.8696916103363,573.4888002872467,1405.3836402893066,53871,9489,44382,44382,0,12,8406000.0
8406,8406999,21.37091564386415,38.00092963350698,0.07749479547233618,1598.9926025867462,573.556800365448,1405.566707611084,53871,9489,44382,44382,0,12,8407000.0
8407,8407999,21.371927648388592,38.001362109223614,0.07748228904418408,1599.1166007518768,573.6243216991425,1405.6952743530273,53871,9489,44382,44382,0,12,8408000.0
8408,8408999,21.372490298180857,38.001148538189305,0.07747453516122305,1599.3677914142609,573.6918442249298,1405.7758522033691,53874,9490,44384,44384,0,12,8409000.0
8409,8409999,21.372226803949747,38.000666094823195,0.077463905366706,1599.621307849884,573.7584261894226,1406.4932479858398,53892,9491,44401,44401,0,12,8410000.0
8410,8410999,21.37186326530042,38.00046698309429,0.07745506293390925,1600.0045895576477,573.8259155750275,1406.7783584594727,53908,9493,44415,44415,0,12,8411000.0
8411,8411999,21.371195300235463,37.99915445147837,0.07745283257403246,1600.2588484287262,573.8954198360443,1407.0499992370605,53920,9494,44426,44426,0,12,8412000.0
8412,8412999,21.37079245917217,37.99813941509088,0.07744751787398796,1600.3881690502167,573.9631633758545,1407.284652709961,53923,9494,44429,44429,0,12,8413000.0
8413,8413999,21.370429031497164,37.99710314368817,0.07744001340677265,1600.63769865036,574.034993648529,1407.4932403564453,53935,9495,44440,44440,0,12,8414000.0
8414,8414999,21.369887249007178,37.995766394347605,0.07743488251908959,1600.8858160972595,574.1028361320496,1407.6325645446777,53938,9496,44442,44442,0,12,8415000.0
8415,8415999,21.369418421047257,37.99471527431769,0.07742755784252808,1601.024206161499,574.171548128128,1407.7424697875977,53938,9496,44442,44442,0,12,8416000.0
8416,8416999,21.36906611687367,37.99367807544885,0.07742313569548342,1601.2779214382172,574.240339756012,1407.8470840454102,53952,9497,44455,44455,0,12,8417000.0
8417,8417999,21.36862756288106,37.992813250368634,0.0774197039607959,1601.7850933074951,574.3091912269592,1407.800624847412,53959,9500,44459,44459,0,12,8418000.0
8418,8418999,21.368489378556923,37.99183720984599,0.07739816089708318,1601.916682958603,574.3784942626953,1408.142505645752,53961,9500,44461,44461,0,12,8419000.0
8419,8419999,21.36863115989808,37.99138169930154,0.07737698025245965,1602.1696729660034,574.4471220970154,1408.2684898376465,53963,9501,44462,44462,0,12,8420000.0
8420,8420999,21.36865231323597,37.99068359592744,0.07736344294556119,1602.8158237934113,574.5163924694061,1408.2542343139648,54018,9505,44513,44513,0,12,8421000.0
8421,8421999,21.36855193892684,37.98972249716492,0.07735374096274428,1602.9464182853699,574.5850808620453,1408.4168319702148,54018,9505,44513,44513,0,12,8422000.0
8422,8422999,21.36857449428254,37.98910535990702,0.07734503426631456,1603.342483997345,574.6546120643616,1408.497055053711,54025,9507,44518,44518,0,12,8423000.0
8423,8423999,21.368983326924365,37.989987906775596,0.07731179599512594,1603.8570561408997,574.7239234447479,1408.5713958740234,54041,9510,44531,44531,0,12,8424000.0
8424,8424999,21.369146072867114,37.99042313428621,0.07728753355210549,1603.9908418655396,574.7914569377899,1408.737606048584,54041,9510,44531,44531,0,12,8425000.0
8425,8425999,21.3689471357595,37.98941640261617,0.07727107368323882,1604.2365291118622,574.8598206043243,1408.8449974060059,54043,9511,44532,44532,0,12,8426000.0
8426,8426999,21.368445136609743,37.98828695535232,0.07727370814334988,1604.7415177822113,574.928231716156,1409.5197143554688,54058,9514,44544,44544,0,12,8427000.0
8427,8427999,21.368069674608243,37.98946666341353,0.0772628167125583,1604.984248161316,574.9973976612091,1409.787467956543,54062,9515,44547,44547,0,12,8428000.0
8428,8428999,21.36777048779878,37.9891282043646,0.07725919203863907,1605.1084113121033,575.0661985874176,1410.0458145141602,54062,9515,44547,44547,0,12,8429000.0
8429,8429999,21.36728538393168,37.98818432411119,0.07725440340810108,1605.489183664322,575.135550737381,1410.4095268249512,54071,9517,44554,44554,0,12,8430000.0
8430,8430999,21.36706889028156,37.98759348341248,0.07724287523437268,1605.7366652488708,575.2040596008301,1410.5626373291016,54073,9518,44555,44555,0,12,8431000.0
8431,8431999,21.367055521787872,37.98727906268683,0.0772416571769744,1605.9811775684357,575.2722089290619,1410.7335319519043,54075,9519,44556,44556,0,12,8432000.0
8432,8432999,21.36684817179053,37.986487860214716,0.07723792832326626,1606.2295615673065,575.3418569564819,1410.8844451904297,54078,9520,44558,44558,0,12,8433000.0
8433,8433999,21.366571995048712,37.98570591460741,0.07723409644440493,1606.491860628128,575.4100522994995,1411.0577583312988,54081,9521,44560,44560,0,12,8434000.0
8434,8434999,21.36655344720755,37.98598931555069,0.0772290168127111,1606.8634767532349,575.478847026825,1411.1381645202637,54086,9523,44563,44563,0,12,8435000.0
8435,8435999,21.36679581543231,37.98586678588383,0.07721451400653367,1607.2391340732574,575.5477845668793,1411.4659423828125,54094,9525,44569,44569,0,12,8436000.0
8436,8436999,21.36688708298113,37.98531779074053,0.07719646008027203,1607.488251209259,575.6168777942657,1411.6037673950195,54097,9526,44571,44571,0,12,8437000.0
8437,8437999,21.367020417394144,37.985185647027215,0.07719332044740823,1608.0041906833649,575.6860241889954,1411.6585121154785,54103,9529,44574,44574,0,12,8438000.0
8438,8438999,21.367053586616766,37.98449653543742,0.07718891048946597,1608.2513554096222,575.7541000843048,1411.7934913635254,54105,9530,44575,44575,0,12,8439000.0
8439,8439999,21.367518021002592,37.984715275282554,0.07717890834416719,1608.5006346702576,575.8231546878815,1411.9695091247559,54108,9531,44577,44577,0,12,8440000.0
8440,8440999,21.36762174153706,37.984133733706365,0.0771681179749244,1608.7594771385193,575.8921060562134,1412.2451705932617,54113,9532,44581,44581,0,12,8441000.0
8441,8441999,21.368100729143425,37.984112621258014,0.07714884580190229,1608.8742711544037,575.9610939025879,1412.489429473877,54114,9532,44582,44582,0,12,8442000.0
8442,8442999,21.36862715401961,37.98410614088227,0.07713341362405879,1609.3735761642456,576.0301098823547,1412.5350456237793,54121,9535,44586,44586,0,12,8443000.0
8443,8443999,21.368842603138322,37.98421308683539,0.07712174986865394,1609.4920165538788,576.0982782840729,1412.734043121338,54121,9535,44586,44586,0,12,8444000.0
8444,8444999,21.369104592230922,37.985874256979834,0.07710581418518259,1609.87193441391,576.1669163703918,1412.817855834961,54136,9537,44599,44599,0,12,8445000.0
8445,8445999,21.368810728828,37.98554051835793,0.07709624610798305,1610.1361675262451,576.2372233867645,1413.1841583251953,54149,9538,44611,44611,0,12,8446000.0
8446,8446999,21.36816697136535,37.98450131543379,0.0770983791357458,1610.38742685318,576.3044319152832,1413.3214492797852,54152,9539,44613,44613,0,12,8447000.0
8447,8447999,21.367831729240855,37.98463087807286,0.07709530117954733,1610.6370708942413,576.3717782497406,1413.399185180664,54157,9540,44617,44617,0,12,8448000.0
8448,8448999,21.367511306763937,37.98471957508192,0.0770915214129263,1611.147854566574,576.4400780200958,1413.4165344238281,54168,9543,44625,44625,0,12,8449000.0
8449,8449999,21.367562949592454,37.98463992210088,0.07708953939694752,1611.2779285907745,576.5090661048889,1413.7084007263184,54169,9543,44626,44626,0,12,8450000.0
8450,8450999,21.367824542545144,37.98505220286411,0.07708369900360135,1611.3998832702637,576.5761766433716,1413.9094467163086,54169,9543,44626,44626,0,12,8451000.0
8451,8451999,21.36807917346552,37.985139416807186,0.0770817001845896,1611.6670253276825,576.6449661254883,1414.0032081604004,54172,9544,44628,44628,0,12,8452000.0
8452,8452999,21.36823457084545,37.9850225199943,0.07708326635661045,1611.9164955615997,576.7131814956665,1414.0984573364258,54174,9545,44629,44629,0,12,8453000.0
8453,8453999,21.368711016259347,37.98572115014832,0.07708072891755369,1612.1641261577606,576.7801389694214,1414.1897201538086,54177,9546,44631,44631,0,12,8454000.0
8454,8454999,21.36910546658008,37.98603834420644,0.07708546115756365,1612.2970786094666,576.8491513729095,1414.3041954040527,54177,9546,44631,44631,0,12,8455000.0
8455,8455999,21.369357780550096,37.98643588220092,0.07708160106830031,1612.6791722774506,576.9169776439667,1414.5064659118652,54182,9548,44634,44634,0,12,8456000.0
8456,8456999,21.370096748413026,37.987669044627566,0.07708428329412198,1613.4879703521729,576.9979610443115,1414.4989738464355,54202,9552,44650,44650,0,12,8457000.0
8457,8457999,21.37024054250525,37.987578612673516,0.07707966347703177,1613.6168115139008,577.0654263496399,1414.6550674438477,54202,9552,44650,44650,0,12,8458000.0
8458,8458999,21.370856620310526,37.988716601400846,0.07707871580188386,1614.0019571781158,577.1340866088867,1414.6947860717773,54216,9554,44662,44662,0,12,8459000.0
8459,8459999,21.37134099948138,37.98912273287253,0.07707737803712134,1614.1257576942444,577.202066898346,1414.8100662231445,54216,9554,44662,44662,0,12,8460000.0
8460,8460999,21.371693990757468,37.98924186254541,0.07708054853845758,1614.3865830898285,577.2687928676605,1414.971035003662,54219,9555,44664,44664,0,12,8461000.0
8461,8461999,21.372317812680173,37.990065254371046,0.0770805648961228,1614.5112380981445,577.3363599777222,1415.1479682922363,54219,9555,44664,44664,0,12,8462000.0
8462,8462999,21.372838263131904,37.991156485093,0.0770854721515235,1614.7683274745941,577.4038572311401,1415.2096519470215,54221,9556,44665,44665,0,12,8463000.0
8463,8463999,21.37298975472507,37.99105023839501,0.07709921078907023,1614.8913493156433,577.4711725711823,1415.3299293518066,54221,9556,44665,44665,0,12,8464000.0
8464,8464999,21.37313083721527,37.99083927385421,0.0771083447728077,1615.0157446861267,577.5372323989868,1415.433193206787,54221,9556,44665,44665,0,12,8465000.0
8465,8465999,21.372552444834557,37.99092794319249,0.07710629218609044,1615.5135962963104,577.604954957962,1416.065341949463,54252,9559,44693,44693,0,12,8466000.0
8466,8466999,21.371728163091912,37.989938222359704,0.07710867092720253,1615.8869585990906,577.6717798709869,1416.2593574523926,54256,9561,44695,44695,0,12,8467000.0
8467,8467999,21.371103228764046,37.989151447901335,0.07710742862211584,1616.2653493881226,577.7401547431946,1416.3945617675781,54271,9563,44708,44708,0,12,8468000.0
8468,8468999,21.37044435563294,37.98793738038937,0.07710580643272391,1616.3816466331482,577.80655169487,1416.5718536376953,54271,9563,44708,44708,0,12,8469000.0
8469,8469999,21.37002005326867,37.987905711819714,0.07709621448200177,1616.6286928653717,577.8736901283264,1416.870719909668,54274,9564,44710,44710,0,12,8470000.0
8470,8470999,21.36954524249109,37.98741288400382,0.0770934236830495,1616.8843250274658,577.9416761398315,1417.0022811889648,54286,9565,44721,44721,0,12,8471000.0
8471,8471999,21.36903932462636,37.986480088793094,0.07709135218118846,1617.259376525879,578.0096139907837,1417.0933418273926,54291,9567,44724,44724,0,12,8472000.0
8472,8472999,21.368617309134212,37.985991699772185,0.07708575189945954,1617.5705215930939,578.1035268306732,1417.1921501159668,54293,9568,44725,44725,0,12,8473000.0
8473,8473999,21.368549068397957,37.98610039564482,0.07708652888349565,1617.9581406116486,578.1720106601715,1417.2863159179688,54307,9570,44737,44737,0,12,8474000.0
8474,8474999,21.36893848445817,37.98681570974749,0.07708620016025391,1618.0828931331635,578.2388298511505,1417.5942344665527,54307,9570,44737,44737,0,12,8475000.0
8475,8475999,21.369562345981812,37.987785003970586,0.07708894057797311,1618.3350653648376,578.3065845966339,1417.8267135620117,54309,9571,44738,44738,0,12,8476000.0
8476,8476999,21.370522957196812,37.989954135715784,0.07708941659215662,1618.5880722999573,578.3740541934967,1417.9734077453613,54312,9572,44740,44740,0,12,8477000.0
8477,8477999,21.371795986201807,37.992876262021746,0.0771208749626403,1619.0946142673492,578.4412970542908,1417.9812126159668,54324,9575,44749,44749,0,12,8478000.0
8478,8478999,21.373034016428836,37.99575842659164,0.07715064305648278,1619.347259759903,578.5082023143768,1418.121295928955,54326,9576,44750,44750,0,12,8479000.0
8479,8479999,21.374410554899942,37.999591706084644,0.07719770574408458,1619.4735479354858,578.57470870018,1418.2493057250977,54326,9576,44750,44750,0,12,8480000.0
8480,8480999,21.375396104550248,38.00069030611495,0.07721343499665956,1619.5908901691437,578.6410944461823,1418.550666809082,54329,9576,44753,44753,0,12,8481000.0
8481,8481999,21.376990284245238,38.00472965519614,0.07723018924658265,1620.0920634269714,578.7079744338989,1418.569263458252,54337,9579,44758,44758,0,12,8482000.0
8482,8482999,21.37820395844694,38.00603425918864,0.07725953474507119,1620.600312948227,578.7752315998077,1418.6299018859863,54348,9582,44766,44766,0,12,8483000.0
8483,8483999,21.379009050326882,38.00712290051971,0.07728563143798295,1620.9736762046814,578.8418090343475,1418.7019882202148,54353,9584,44769,44769,0,12,8484000.0
8484,8484999,21.378969887532183,38.00685052808744,0.07728776860641628,1621.2308268547058,578.9098935127258,1419.228946685791,54373,9585,44788,44788,0,12,8485000.0
8485,8485999,21.378489821878247,38.00610798941564,0.0772902313558873,1621.4843904972076,578.9779191017151,1419.4742469787598,54382,9586,44796,44796,0,12,8486000.0
8486,8486999,21.37825073077496,38.00608206539734,0.07729073163123723,1621.6013252735138,579.0449237823486,1419.6639251708984,54382,9586,44796,44796,0,12,8487000.0
8487,8487999,21.378052116011748,38.00627730888422,0.07728475786650857,1621.7290148735046,579.1123323440552,1419.816562652588,54383,9586,44797,44797,0,12,8488000.0
8488,8488999,21.377965497198623,38.00610399484996,0.07728440427562211,1621.859941482544,579.1798851490021,1420.045768737793,54385,9586,44799,44799,0,12,8489000.0
8489,8489999,21.377735957540988,38.00552644431927,0.07728217382490199,1622.1121747493744,579.247727394104,1420.1719665527344,54392,9587,44805,44805,0,12,8490000.0
8490,8490999,21.37754986563485,38.00497079652088,0.07728178911366612,1622.232267856598,579.3141705989838,1420.3089981079102,54392,9587,44805,44805,0,12,8491000.0
8491,8491999,21.377490984815044,38.00457471342405,0.07728028032881862,1622.3507299423218,579.3807528018951,1420.3965072631836,54392,9587,44805,44805,0,12,8492000.0
8492,8492999,21.37766086349784,38.00517674820293,0.0772726184045266,1622.7319555282593,579.4485149383545,1420.456687927246,54398,9589,44809,44809,0,12,8493000.0
8493,8493999,21.37770957726613,38.00491521879988,0.07726130453756086,1622.8525047302246,579.515762090683,1420.578369140625,54399,9589,44810,44810,0,12,8494000.0
8494,8494999,21.37783417361326,38.00490698932449,0.07725969087576501,1623.3703889846802,579.5847320556641,1420.7967376708984,54417,9592,44825,44825,0,12,8495000.0
8495,8495999,21.37798233312733,38.004531693611874,0.07725673499165531,1624.272144317627,579.6547811031342,1420.7825813293457,54430,9598,44832,44832,0,12,8496000.0
8496,8496999,21.377955574879582,38.0038556066946,0.07725827177055733,1624.650205373764,579.7231755256653,1420.9612884521484,54445,9600,44845,44845,0,12,8497000.0
8497,8497999,21.377872248147668,38.00317985862754,0.0772561519311461,1624.9071288108826,579.7911703586578,1421.0744018554688,54448,9601,44847,44847,0,12,8498000.0
8498,8498999,21.377947803392644,38.002810988197155,0.07725697381114016,1625.4275171756744,579.8594920635223,1421.099624633789,54455,9604,44851,44851,0,12,8499000.0
8499,8499999,21.37796664678209,38.00232942492206,0.07724881128498118,1625.542195558548,579.9263865947723,1421.2669258117676,54457,9604,44853,44853,0,12,8500000.0
8500,8500999,21.37820065234642,38.00204730453623,0.07723689285045154,1625.7977063655853,579.9970254898071,1421.5381507873535,54461,9605,44856,44856,0,12,8501000.0
8501,8501999,21.378315466654282,38.00254042601819,0.07722223342724632,1626.0548169612885,580.0651400089264,1421.6827507019043,54464,9606,44858,44858,0,12,8502000.0
8502,8502999,21.378179049594916,38.00159163884507,0.07721396636025923,1626.3056597709656,580.1322183609009,1421.7998352050781,54466,9607,44859,44859,0,12,8503000.0
8503,8503999,21.378085913713875,38.000822059954615,0.07720745083498848,1626.5637018680573,580.1988694667816,1421.8954582214355,54468,9608,44860,44860,0,12,8504000.0
8504,8504999,21.377267173625942,37.99922633979332,0.07721039644275807,1626.8240420818329,580.2650616168976,1422.1959838867188,54478,9609,44869,44869,0,12,8505000.0
8505,8505999,21.376178220363528,37.9976452926405,0.0772161016120636,1627.2106127738953,580.333411693573,1422.3344802856445,54513,9611,44902,44902,0,12,8506000.0
8506,8506999,21.37514794618662,37.99603044920956,0.07722124569682542,1627.3384993076324,580.4016392230988,1422.5690116882324,54513,9611,44902,44902,0,12,8507000.0
8507,8507999,21.374242303377784,37.99501625238783,0.07722657825324808,1627.4676024913788,580.4687173366547,1422.6823539733887,54513,9611,44902,44902,0,12,8508000.0
8508,8508999,21.373289240084823,37.993471381077335,0.0772299053786123,1627.7277677059174,580.5367305278778,1422.8385887145996,54517,9612,44905,44905,0,12,8509000.0
8509,8509999,21.37257241501717,37.99254990787074,0.07722852881610387,1627.9767224788666,580.6044731140137,1423.0227813720703,54524,9613,44911,44911,0,12,8510000.0
8510,8510999,21.37174168558895,37.991340615846426,0.07723351849567617,1628.097748041153,580.6718015670776,1423.1503143310547,54524,9613,44911,44911,0,12,8511000.0
8511,8511999,21.371093819507234,37.99085013515964,0.07723099767136354,1628.359227180481,580.7399711608887,1423.1946868896484,54531,9614,44917,44917,0,12,8512000.0
8512,8512999,21.370776440640668,37.991124577692,0.07725293821915913,1628.49253988266,580.808495759964,1423.3138236999512,54531,9614,44917,44917,0,12,8513000.0
8513,8513999,21.371083262344218,37.99361503938705,0.07727426962180128,1628.8799502849579,580.8769211769104,1423.36185836792,54535,9616,44919,44919,0,12,8514000.0
8514,8514999,21.37130556140101,37.99641695233172,0.07725924241824611,1629.1276743412018,580.9453287124634,1423.6491889953613,54538,9617,44921,44921,0,12,8515000.0
8515,8515999,21.37156980351076,37.996947593791106,0.07725782714085672,1629.2584125995636,581.0133929252625,1423.8557929992676,54539,9617,44922,44922,0,12,8516000.0
8516,8516999,21.371883175962324,37.997877124603406,0.07724430873988408,1629.6416997909546,581.0817003250122,1423.9342803955078,54553,9619,44934,44934,0,12,8517000.0
8517,8517999,21.372284997778706,37.998458277555834,0.07723323322188169,1629.8971564769745,581.1502594947815,1424.0710144042969,54555,9620,44935,44935,0,12,8518000.0
8518,8518999,21.372582529293666,37.99879918520404,0.07722409125511298,1630.5456709861755,581.2184784412384,1424.0476341247559,54565,9624,44941,44941,0,12,8519000.0
8519,8519999,21.373306891488028,38.00052536849746,0.07719918162563577,1630.6711888313293,581.2877352237701,1424.260829925537,54566,9624,44942,44942,0,12,8520000.0
8520,8520999,21.374460080002,38.002004403227126,0.07718460556754725,1630.9104142189026,581.3542380332947,1424.4007034301758,54569,9625,44944,44944,0,12,8521000.0
8521,8521999,21.375476718067027,38.003420288037375,0.07716242641543813,1631.1642200946808,581.4220349788666,1424.4253044128418,54572,9626,44946,44946,0,12,8522000.0
8522,8522999,21.37631978867069,38.004012346314546,0.07715057803675884,1631.2825713157654,581.4880888462067,1424.5248260498047,54572,9626,44946,44946,0,12,8523000.0
8523,8523999,21.37659115930137,38.00393989239829,0.07714280926122885,1631.803794145584,581.5554523468018,1424.5310249328613,54579,9629,44950,44950,0,12,8524000.0
8524,8524999,21.376134482889814,38.003325927195746,0.07713554847691062,1632.4477665424347,581.624685049057,1424.957836151123,54601,9633,44968,44968,0,12,8525000.0
8525,8525999,21.37564805982642,38.00245760385395,0.07712866639856375,1632.567767381668,581.6916177272797,1425.263771057129,54601,9633,44968,44968,0,12,8526000.0
8526,8526999,21.375369899344786,38.00189520524486,0.07712327331905244,1632.684452533722,581.7595007419586,1425.468116760254,54601,9633,44968,44968,0,12,8527000.0
8527,8527999,21.375032855822774,38.001005202504125,0.07711907035578014,1633.0720686912537,581.8288912773132,1425.6125450134277,54606,9635,44971,44971,0,12,8528000.0
8528,8528999,21.375198180094504,38.00080456004153,0.07710788613101027,1633.3270812034607,581.897180557251,1425.87601852417,54608,9636,44972,44972,0,12,8529000.0
8529,8529999,21.375512093225147,38.00108907678945,0.0770963305590403,1633.4497430324554,581.9650239944458,1426.0724792480469,54608,9636,44972,44972,0,12,8530000.0
8530,8530999,21.375867551146783,38.00140942919735,0.07708896899604867,1633.5802836418152,582.035525560379,1426.1883354187012,54608,9636,44972,44972,0,12,8531000.0
8531,8531999,21.376315067031925,38.00231177541351,0.07707591301596495,1633.7034106254578,582.1034436225891,1426.3222274780273,54608,9636,44972,44972,0,12,8532000.0
8532,8532999,21.376759993273737,38.002774596652934,0.07707214332314483,1633.9570903778076,582.1707513332367,1426.4558181762695,54612,9637,44975,44975,0,12,8533000.0
8533,8533999,21.377111398755325,38.00300340723071,0.07706272221147648,1634.0868618488312,582.2388994693756,1426.6427764892578,54613,9637,44976,44976,0,12,8534000.0
8534,8534999,21.378330518353366,38.00656421608913,0.07705145257492385,1634.4672107696533,582.3066034317017,1426.896141052246,54621,9639,44982,44982,0,12,8535000.0
8535,8535999,21.379565114794527,38.00814498011484,0.07706214501640074,1634.5955996513367,582.3752355575562,1427.0737800598145,54621,9639,44982,44982,0,12,8536000.0
8536,8536999,21.380756356297827,38.00972991414178,0.07706803524005335,1634.9881527423859,582.4438834190369,1427.1661186218262,54635,9641,44994,44994,0,12,8537000.0
8537,8537999,21.382163793841666,38.01199391645241,0.07707780498034156,1635.2375676631927,582.5120635032654,1427.2765083312988,54638,9642,44996,44996,0,12,8538000.0
8538,8538999,21.383545903373793,38.01384732524419,0.07709610596902128,1635.35889005661,582.5789513587952,1427.4142265319824,54639,9642,44997,44997,0,12,8539000.0
8539,8539999,21.385163509425837,38.01587541525036,0.07712664634524624,1635.4801037311554,582.6466784477234,1427.725975036621,54640,9642,44998,44998,0,12,8540000.0
8540,8540999,21.38730274975011,38.01965401637192,0.07715699133623355,1635.8650078773499,582.7140717506409,1427.8092308044434,54645,9644,45001,45001,0,12,8541000.0
8541,8541999,21.389038656126317,38.02179472986807,0.07721460120522772,1636.1275146007538,582.7846879959106,1427.9512977600098,54647,9645,45002,45002,0,12,8542000.0
8542,8542999,21.390621418554304,38.023476041107074,0.07727381095384211,1636.2501628398895,582.851972579956,1428.065673828125,54647,9645,45002,45002,0,12,8543000.0
8543,8543999,21.391027696473575,38.023508431430116,0.07727988465045144,1636.8057796955109,582.9200434684753,1428.3906860351562,54697,9648,45049,45049,0,12,8544000.0
8544,8544999,21.39127513866979,38.02503709242961,0.07726642131414352,1636.930807352066,582.9879078865051,1428.6716537475586,54697,9648,45049,45049,0,12,8545000.0
8545,8545999,21.391908956167356,38.02696235170611,0.07726038663885482,1637.056390285492,583.0547111034393,1428.8744850158691,54697,9648,45049,45049,0,12,8546000.0
8546,8546999,21.392917675956603,38.0304121502197,0.07723994621182328,1637.1738040447235,583.121940612793,1429.035976409912,54699,9648,45051,45051,0,12,8547000.0
8547,8547999,21.393919535981425,38.03207074932844,0.07724002841758648,1637.2924859523773,583.1892755031586,1429.2871932983398,54700,9648,45052,45052,0,12,8548000.0
8548,8548999,21.395249858719787,38.03480016887331,0.07723590059331897,1637.4183740615845,583.2568399906158,1429.4685974121094,54701,9648,45053,45053,0,12,8549000.0
8549,8549999,21.396649681562888,38.038278228896345,0.07722085519974464,1637.548764705658,583.3241033554077,1429.5887260437012,54701,9648,45053,45053,0,12,8550000.0
8550,8550999,21.398809071527342,38.04560869066692,0.0772087431203432,1637.7993562221527,583.3920023441315,1429.7247619628906,54706,9649,45057,45057,0,12,8551000.0
8551,8551999,21.40075172633554,38.050978246490274,0.07719386108865645,1638.065572977066,583.4603343009949,1429.8318977355957,54709,9650,45059,45059,0,12,8552000.0
8552,8552999,21.40315746442118,38.058423444581095,0.07719050006462724,1638.1875116825104,583.528660774231,1430.0704307556152,54709,9650,45059,45059,0,12,8553000.0
8553,8553999,21.405297229199082,38.06539823684199,0.07721118467541599,1638.4873354434967,583.6129038333893,1430.1809005737305,54711,9651,45060,45060,0,12,8554000.0
8554,8554999,21.407569429342583,38.07188676217238,0.07720484808590822,1638.6300280094147,583.680285692215,1430.280918121338,54712,9651,45061,45061,0,12,8555000.0
8555,8555999,21.41009913969074,38.07831052646893,0.07720990437759745,1639.012976884842,583.747679233551,1430.3072776794434,54726,9653,45073,45073,0,12,8556000.0
8556,8556999,21.41222804241902,38.083805487382,0.07719040384722464,1639.1419868469238,583.8150503635406,1430.4914169311523,54726,9653,45073,45073,0,12,8557000.0
8557,8557999,21.414270118972812,38.089339250041704,0.07717000613711111,1639.262173652649,583.8821310997009,1430.598388671875,54726,9653,45073,45073,0,12,8558000.0
8558,8558999,21.41594343467856,38.09300304598048,0.07715932489938016,1639.3899893760681,583.9486548900604,1430.6869087219238,54726,9653,45073,45073,0,12,8559000.0
8559,8559999,21.416549990077016,38.09538082417675,0.07714226671622748,1639.7695636749268,584.0166046619415,1431.0787887573242,54743,9655,45088,45088,0,12,8560000.0
8560,8560999,21.416260098345614,38.0956443140975,0.07712734855482661,1640.3765153884888,584.124694108963,1431.283145904541,54758,9657,45101,45101,0,12,8561000.0
8561,8561999,21.41619300554662,38.09590970016867,0.07711472198564107,1640.623615026474,584.193751335144,1431.4189910888672,54761,9658,45103,45103,0,12,8562000.0
8562,8562999,21.416015625985033,38.095883657840986,0.07710558288234637,1640.881365776062,584.2612035274506,1431.652545928955,54763,9659,45104,45104,0,12,8563000.0
8563,8563999,21.415646362836636,38.09501905264526,0.07709979011186163,1641.0073432922363,584.3285207748413,1431.8608894348145,54763,9659,45104,45104,0,12,8564000.0
8564,8564999,21.415527132003326,38.09456688006841,0.07709083765711644,1641.128581047058,584.3947145938873,1432.0067100524902,54763,9659,45104,45104,0,12,8565000.0
8565,8565999,21.415600691358662,38.09452656816179,0.07707820364904183,1641.2487542629242,584.4618701934814,1432.1398963928223,54763,9659,45104,45104,0,12,8566000.0
8566,8566999,21.41577672005767,38.094913578241446,0.07706518768942194,1641.5042996406555,584.5302863121033,1432.2580680847168,54775,9660,45115,45115,0,12,8567000.0
8567,8567999,21.415955829684982,38.09521201806135,0.07705080866754443,1641.6369442939758,584.597945690155,1432.389217376709,54776,9660,45116,45116,0,12,8568000.0
8568,8568999,21.41637848988095,38.0955349890279,0.07703744004258084,1641.7571425437927,584.6648252010345,1432.7252388000488,54777,9660,45117,45117,0,12,8569000.0
8569,8569999,21.416758696523928,38.09568327153367,0.07702418711996517,1641.8737676143646,584.7320880889893,1432.879295349121,54777,9660,45117,45117,0,12,8570000.0
8570,8570999,21.41709421447935,38.09563489565217,0.07701526362118694,1641.9961349964142,584.8006105422974,1433.033561706543,54777,9660,45117,45117,0,12,8571000.0
8571,8571999,21.417462758934747,38.095634650687956,0.07701170071656793,1642.2619473934174,584.8692262172699,1433.0984916687012,54779,9661,45118,45118,0,12,8572000.0
8572,8572999,21.417868675046158,38.095783722408825,0.07700745262733255,1642.6497497558594,584.9378411769867,1433.1523132324219,54783,9663,45120,45120,0,12,8573000.0
8573,8573999,21.41836182656458,38.09583693013774,0.07700158160012038,1643.040308713913,585.0076999664307,1433.2052268981934,54788,9665,45123,45123,0,12,8574000.0
8574,8574999,21.419336160313367,38.09685717677942,0.07699372380823333,1643.4355216026306,585.0758228302002,1433.2339706420898,54802,9667,45135,45135,0,12,8575000.0
8575,8575999,21.41970322318819,38.09661961144513,0.07699173960615824,1643.7027122974396,585.1444892883301,1433.2956008911133,54805,9668,45137,45137,0,12,8576000.0
8576,8576999,21.420160468834744,38.09663323480994,0.07699004955341093,1643.8289828300476,585.2117025852203,1433.3675003051758,54805,9668,45137,45137,0,12,8577000.0
8577,8577999,21.420413665193404,38.09616201221423,0.07699041944661245,1644.0817909240723,585.2784378528595,1433.3994674682617,54812,9669,45143,45143,0,12,8578000.0
8578,8578999,21.420150946744236,38.09554651083598,0.07698072549876833,1644.335128068924,585.3461654186249,1433.9538879394531,54827,9670,45157,45157,0,12,8579000.0
8579,8579999,21.419694244219443,38.09513562582401,0.07696819539463429,1644.45290017128,585.4132604598999,1434.2094192504883,54827,9670,45157,45157,0,12,8580000.0
8580,8580999,21.419229862311806,38.09403152602598,0.07695909151823954,1644.7187151908875,585.4814338684082,1434.3560371398926,54829,9671,45158,45158,0,12,8581000.0
8581,8581999,21.4189723674982,38.09370296011361,0.0769469243491584,1644.9749372005463,585.5484344959259,1434.438217163086,54833,9672,45161,45161,0,12,8582000.0
8582,8582999,21.41871849938143,38.092980058645,0.07693947513663468,1645.3596065044403,585.6156151294708,1434.6447944641113,54850,9674,45176,45176,0,12,8583000.0
8583,8583999,21.41854003073413,38.09225003518923,0.07692877382561858,1645.745857477188,585.6832485198975,1434.9126739501953,54860,9676,45184,45184,0,12,8584000.0
8584,8584999,21.41852224967552,38.0920693396681,0.0769184587984324,1646.0018899440765,585.7507948875427,1435.0677452087402,54863,9677,45186,45186,0,12,8585000.0
8585,8585999,21.418602577559177,38.09168844594809,0.07691026759580499,1646.3893430233002,585.8177568912506,1435.0748138427734,54869,9679,45190,45190,0,12,8586000.0
8586,8586999,21.418889232863037,38.09204772037859,0.07689529617310731,1646.7849173545837,585.8865723609924,1435.2079849243164,54881,9681,45200,45200,0,12,8587000.0
8587,8587999,21.419456813440565,38.09315967099195,0.07688179091881553,1646.9120891094208,585.9542028903961,1435.3715591430664,54881,9681,45200,45200,0,12,8588000.0
8588,8588999,21.419880739963364,38.09362322177758,0.07687168968055313,1647.3018231391907,586.0233545303345,1435.6505012512207,54898,9683,45215,45215,0,12,8589000.0
8589,8589999,21.42035932906603,38.09376791510138,0.07685802693988497,1647.4222934246063,586.091317653656,1435.8298149108887,54898,9683,45215,45215,0,12,8590000.0
8590,8590999,21.420916143336296,38.09401938863602,0.07684545711726287,1647.6809496879578,586.1586203575134,1435.9554023742676,54910,9684,45226,45226,0,12,8591000.0
8591,8591999,21.421353142121312,38.094043879791286,0.07683457502279056,1648.0732367038727,586.2259638309479,1435.9831581115723,54922,9686,45236,45236,0,12,8592000.0
8592,8592999,21.421787507751073,38.09419770839412,0.07682455680313516,1648.337450504303,586.2934954166412,1436.0948677062988,54926,9687,45239,45239,0,12,8593000.0
8593,8593999,21.422278181724057,38.0943585512139,0.07681822975796992,1648.4555833339691,586.360748052597,1436.203628540039,54926,9687,45239,45239,0,12,8594000.0
8594,8594999,21.422855087786772,38.094127788274434,0.07679978162962975,1648.7069964408875,586.4278044700623,1436.3644752502441,54929,9688,45241,45241,0,12,8595000.0
8595,8595999,21.423510419014566,38.09420617209185,0.07678096458000949,1648.8312895298004,586.4946119785309,1436.4719429016113,54929,9688,45241,45241,0,12,8596000.0
8596,8596999,21.423807477203574,38.093661140150594,0.0767642647736606,1648.969604730606,586.5619313716888,1436.546630859375,54929,9688,45241,45241,0,12,8597000.0
8597,8597999,21.42396283862474,38.093879078903605,0.07675681422192604,1649.230396270752,586.6290669441223,1436.5937385559082,54937,9689,45248,45248,0,12,8598000.0
8598,8598999,21.423425085655186,38.09280945462655,0.07675431654572196,1649.4835937023163,586.69611120224,1437.0353775024414,54951,9690,45261,45261,0,12,8599000.0
8599,8599999,21.422915388159534,38.09239585557461,0.0767594411752921,1649.602679491043,586.7633702754974,1437.2369079589844,54951,9690,45261,45261,0,12,8600000.0
8600,8600999,21.4223915432474,38.09172449700971,0.07675868023055266,1649.8499727249146,586.8297641277313,1437.366325378418,54953,9691,45262,45262,0,12,8601000.0
8601,8601999,21.42177858536034,38.090619813198465,0.0767638550846792,1650.3618874549866,586.8978772163391,1437.4260597229004,54959,9694,45265,45265,0,12,8602000.0
8602,8602999,21.421342655386603,38.08995691319924,0.07675969545602612,1650.6174182891846,586.9653193950653,1437.6568145751953,54963,9695,45268,45268,0,12,8603000.0
8603,8603999,21.421161765567003,38.089256781740175,0.07675855322749359,1650.748083114624,587.0331561565399,1437.848087310791,54965,9695,45270,45270,0,12,8604000.0
8604,8604999,21.42082207239646,38.08892327763009,0.07675420379278741,1650.8758716583252,587.100353717804,1437.9645729064941,54965,9695,45270,45270,0,12,8605000.0
8605,8605999,21.420335294161497,38.087810043438,0.07675361847906426,1651.014522075653,587.1671934127808,1438.0388488769531,54965,9695,45270,45270,0,12,8606000.0
8606,8606999,21.41998601198062,38.08681209421002,0.07675414979899753,1651.2694911956787,587.23504114151,1438.1145401000977,54978,9696,45282,45282,0,12,8607000.0
8607,8607999,21.419627981804098,38.08617957042371,0.07674981899443456,1651.6569344997406,587.3027546405792,1438.1043968200684,54982,9698,45284,45284,0,12,8608000.0
8608,8608999,21.41937530233065,38.08518153421491,0.07673787679096311,1652.0489768981934,587.3711297512054,1438.4251136779785,54990,9700,45290,45290,0,12,8609000.0
8609,8609999,21.4192616185022,38.08581257276679,0.07672092727568025,1652.3042278289795,587.438756942749,1438.565200805664,54992,9701,45291,45291,0,12,8610000.0
8610,8610999,21.419018880987846,38.08495362627202,0.07671618116789747,1652.5483932495117,587.5061712265015,1438.7009773254395,54994,9702,45292,45292,0,12,8611000.0
8611,8611999,21.41865484434737,38.08412685177161,0.07671387116685313,1653.0697016716003,587.5741548538208,1438.8064041137695,55000,9705,45295,45295,0,12,8612000.0
8612,8612999,21.418528712669353,38.08320743759432,0.07670662530929095,1653.3330080509186,587.642144203186,1438.895092010498,55003,9706,45297,45297,0,12,8613000.0
8613,8613999,21.418330769751904,38.0823219802215,0.07669957926112503,1653.4510929584503,587.7094812393188,1439.0062522888184,55003,9706,45297,45297,0,12,8614000.0
8614,8614999,21.418420030998945,38.081503939459445,0.07668693001883042,1653.5720653533936,587.7757835388184,1439.2734413146973,55005,9706,45299,45299,0,12,8615000.0
8615,8615999,21.41830061894901,38.08052616917949,0.07668123552666883,1654.2239167690277,587.8437697887421,1439.2207641601562,55017,9710,45307,45307,0,12,8616000.0
8616,8616999,21.418024124917263,38.079484471345104,0.07667990758270671,1654.5913617610931,587.9110412597656,1439.2943992614746,55023,9712,45311,45311,0,12,8617000.0
8617,8617999,21.41751802903018,38.07816729183029,0.07667583497370467,1654.9754729270935,587.9780931472778,1439.4192199707031,55027,9714,45313,45313,0,12,8618000.0
8618,8618999,21.416978714888142,38.07871421686687,0.07667245139243861,1655.228272676468,588.0461268424988,1439.886417388916,55041,9715,45326,45326,0,12,8619000.0
8619,8619999,21.41602256461681,38.07715200101129,0.0766769395776501,1655.4767682552338,588.1127595901489,1440.0693893432617,55052,9716,45336,45336,0,12,8620000.0
8620,8620999,21.415285629045567,38.076004751867565,0.07667553064825594,1655.7209267616272,588.1793465614319,1440.231861114502,55054,9717,45337,45337,0,12,8621000.0
8621,8621999,21.414615415254975,38.07492947928888,0.07667628053584874,1655.9894938468933,588.2523555755615,1440.3191184997559,55059,9718,45341,45341,0,12,8622000.0
8622,8622999,21.414075638295,38.07396018109425,0.07667191429598097,1656.1147012710571,588.320032119751,1440.5502700805664,55060,9718,45342,45342,0,12,8623000.0
8623,8623999,21.41351211237824,38.07293313771115,0.07667043212923352,1656.3699314594269,588.3876333236694,1440.6913299560547,55063,9719,45344,45344,0,12,8624000.0
8624,8624999,21.412912216571648,38.07166069938372,0.07666875004504725,1656.4878282546997,588.4540102481842,1440.835132598877,55064,9719,45345,45345,0,12,8625000.0
8625,8625999,21.412310246085326,38.07075210690285,0.07666677513496412,1656.618364572525,588.5211234092712,1440.9547882080078,55064,9719,45345,45345,0,12,8626000.0
8626,8626999,21.41187526076639,38.07075262689069,0.07666101647990531,1657.0088257789612,588.5881321430206,1440.9771156311035,55074,9721,45353,45353,0,12,8627000.0
8627,8627999,21.411470773963657,38.07188208622004,0.07664945318390237,1657.2694466114044,588.656909942627,1441.0863571166992,55076,9722,45354,45354,0,12,8628000.0
8628,8628999,21.411073402929105,38.07120460490383,0.07665104165694003,1657.3908274173737,588.7244439125061,1441.2906494140625,55076,9722,45354,45354,0,12,8629000.0
8629,8629999,21.410802216079226,38.072493782560336,0.07664130660986979,1657.5208690166473,588.7911152839661,1441.399398803711,55076,9722,45354,45354,0,12,8630000.0
8630,8630999,21.410535360464884,38.07176981347515,0.07663742047273203,1657.6480333805084,588.8581573963165,1441.5088806152344,55076,9722,45354,45354,0,12,8631000.0
8631,8631999,21.410401223463694,38.07123855897271,0.07663515080137173,1657.7858233451843,588.9257543087006,1441.6004676818848,55076,9722,45354,45354,0,12,8632000.0
8632,8632999,21.4102047857264,38.07057346036434,0.07663161781537864,1657.9203124046326,588.9919099807739,1441.672508239746,55076,9722,45354,45354,0,12,8633000.0
8633,8633999,21.410043140033604,38.06998056243963,0.07663309648345729,1658.03800034523,589.0579235553741,1441.7415657043457,55076,9722,45354,45354,0,12,8634000.0
8634,8634999,21.410075343522674,38.069621511022454,0.07662555360421597,1658.1696486473083,589.1254823207855,1441.914264678955,55076,9722,45354,45354,0,12,8635000.0
8635,8635999,21.410081940166503,38.06924298739135,0.0766188802553085,1658.4169964790344,589.1916666030884,1441.9489479064941,55078,9723,45355,45355,0,12,8636000.0
8636,8636999,21.409838635381398,38.0683580606932,0.07661527354976505,1658.815613746643,589.2587130069733,1441.975673675537,55082,9725,45357,45357,0,12,8637000.0
8637,8637999,21.40968516249754,38.06773899920609,0.07661130019938844,1658.9355466365814,589.3251328468323,1442.0660095214844,55082,9725,45357,45357,0,12,8638000.0
8638,8638999,21.409267470280156,38.06719423978062,0.07660821588984745,1659.1970221996307,589.3921377658844,1442.4031982421875,55097,9726,45371,45371,0,12,8639000.0
8639,8639999,21.408387517192295,38.06630567261776,0.07660615897675283,1659.4460406303406,589.4607927799225,1442.6048126220703,55100,9727,45373,45373,0,12,8640000.0
8640,8640999,21.407442778834987,38.06498919937707,0.07660645571456381,1659.573345899582,589.5270304679871,1442.7451477050781,55101,9727,45374,45374,0,12,8641000.0
8641,8641999,21.406837442812197,38.06415241552008,0.07660286912295777,1659.8319792747498,589.5952234268188,1442.8633041381836,55113,9728,45385,45385,0,12,8642000.0
8642,8642999,21.406052944863827,38.06300542310415,0.0766001491115964,1660.3412790298462,589.6633019447327,1442.8765029907227,55130,9731,45399,45399,0,12,8643000.0
8643,8643999,21.40552444656777,38.06198263095918,0.07659364207976727,1660.467469215393,589.7305912971497,1443.1710090637207,55130,9731,45399,45399,0,12,8644000.0
8644,8644999,21.404950502126095,38.06097417479435,0.07658999949595369,1660.5977711677551,589.7985835075378,1443.3061561584473,55130,9731,45399,45399,0,12,8645000.0
8645,8645999,21.404368837832553,38.05979082440827,0.07658391453910673,1660.7199335098267,589.8660123348236,1443.4110717773438,55130,9731,45399,45399,0,12,8646000.0
8646,8646999,21.40371975245332,38.05838969836096,0.07658184316407801,1660.8502023220062,589.9332673549652,1443.5158576965332,55130,9731,45399,45399,0,12,8647000.0
8647,8647999,21.40317882653591,38.057113675759034,0.07657734931010463,1661.2236580848694,590.0005707740784,1443.5544395446777,55137,9733,45404,45404,0,12,8648000.0
8648,8648999,21.402515157486036,38.05572652430791,0.07657584345509982,1661.6133408546448,590.0692663192749,1443.6961822509766,55141,9735,45406,45406,0,12,8649000.0
8649,8649999,21.40205648680722,38.05468801287239,0.07656940747825802,1661.8900890350342,590.137797832489,1443.8582305908203,55143,9736,45407,45407,0,12,8650000.0
8650,8650999,21.401667450336802,38.05376839527563,0.07656146325756219,1662.144157409668,590.2056574821472,1443.9375953674316,55146,9737,45409,45409,0,12,8651000.0
8651,8651999,21.40125776237319,38.0530456942679,0.07655347187811001,1662.2607626914978,590.2731065750122,1444.0837211608887,55146,9737,45409,45409,0,12,8652000.0
8652,8652999,21.400773027232404,38.051925384675286,0.07655038207811227,1662.5126316547394,590.3408668041229,1444.1754684448242,55158,9738,45420,45420,0,12,8653000.0
8653,8653999,21.40044016657132,38.05102241724661,0.07654326215235363,1662.7831478118896,590.4080338478088,1444.2573165893555,55160,9739,45421,45421,0,12,8654000.0
8654,8654999,21.40027585427752,38.050437534755496,0.07653304359214785,1662.9119482040405,590.4757177829742,1444.437644958496,55161,9739,45422,45422,0,12,8655000.0
8655,8655999,21.400006630965848,38.049491518737064,0.07652733830551728,1663.1630427837372,590.5422699451447,1444.4543685913086,55164,9740,45424,45424,0,12,8656000.0
8656,8656999,21.399847158369756,38.04886574461817,0.07651965377643255,1663.4314351081848,590.6106822490692,1444.4694290161133,55167,9741,45426,45426,0,12,8657000.0
8657,8657999,21.399713961066112,38.04823056177262,0.07651169835984928,1663.829752445221,590.6817915439606,1444.534954071045,55181,9743,45438,45438,0,12,8658000.0
8658,8658999,21.399302465780917,38.04711550319261,0.07650850072899451,1663.9589939117432,590.7478795051575,1444.619785308838,55181,9743,45438,45438,0,12,8659000.0
8659,8659999,21.3986632020546,38.046541219447676,0.07650514685456433,1664.214650630951,590.8150207996368,1445.0457649230957,55185,9744,45441,45441,0,12,8660000.0
8660,8660999,21.397908918703617,38.045904622871724,0.07649957005166363,1664.8580949306488,590.8828413486481,1445.067398071289,55223,9748,45475,45475,0,12,8661000.0
8661,8661999,21.397136356492986,38.044663813043144,0.07650011534578405,1665.1182944774628,590.9509856700897,1445.2539138793945,55225,9749,45476,45476,0,12,8662000.0
8662,8662999,21.396624249532554,38.04454304719085,0.07649609680226277,1665.2436213493347,591.0186042785645,1445.4369049072266,55225,9749,45476,45476,0,12,8663000.0
8663,8663999,21.396002301449585,38.04319791487336,0.07649254256285287,1665.3616590499878,591.0865390300751,1445.7350006103516,55226,9749,45477,45477,0,12,8664000.0
8664,8664999,21.395444385812652,38.04192631957463,0.07648846215289107,1665.4775085449219,591.1512675285339,1445.977180480957,55226,9749,45477,45477,0,12,8665000.0
8665,8665999,21.39501950619457,38.04091173648237,0.07648044202624893,1665.7226905822754,591.2174253463745,1446.1104736328125,55229,9750,45479,45479,0,12,8666000.0
8666,8666999,21.394515296562293,38.03970971764427,0.07647514003842404,1665.84339427948,591.2814357280731,1446.2414894104004,55229,9750,45479,45479,0,12,8667000.0
8667,8667999,21.394139793144703,38.039309526511786,0.07646592840895794,1666.0867593288422,591.3454401493073,1446.3519706726074,55232,9751,45481,45481,0,12,8668000.0
8668,8668999,21.393726918226694,38.03816122061612,0.07645819535111564,1666.4639649391174,591.4103407859802,1446.3699264526367,55236,9753,45483,45483,0,12,8669000.0
8669,8669999,21.39338803063861,38.03710818355775,0.07644903921798218,1666.5802199840546,591.4743070602417,1446.60005569458,55236,9753,45483,45483,0,12,8670000.0
8670,8670999,21.39324748006773,38.03618543008423,0.07643567960436559,1666.8204135894775,591.5402863025665,1446.7104721069336,55238,9754,45484,45484,0,12,8671000.0
8671,8671999,21.39320028246706,38.03546888830209,0.07642705681758011,1667.0661361217499,591.6056163311005,1446.799430847168,55241,9755,45486,45486,0,12,8672000.0
8672,8672999,21.393175302952642,38.0348331630559,0.07642303555538621,1667.4538249969482,591.6730599403381,1446.8187370300293,55255,9757,45498,45498,0,12,8673000.0
8673,8673999,21.393082851118592,38.03407508555325,0.07641884258963327,1667.7074010372162,591.738290309906,1446.8902587890625,55258,9758,45500,45500,0,12,8674000.0
8674,8674999,21.39308457472523,38.03338826357092,0.07641273257357162,1667.8264756202698,591.8029310703278,1446.9947204589844,55258,9758,45500,45500,0,12,8675000.0
8675,8675999,21.393452941274994,38.03306206603664,0.0764029059782575,1667.9443366527557,591.8686630725861,1447.3331451416016,55260,9758,45502,45502,0,12,8676000.0
8676,8676999,21.393574713059873,38.03259193477489,0.07640243085539633,1668.3240473270416,591.9328057765961,1447.3595962524414,55265,9760,45505,45505,0,12,8677000.0
8677,8677999,21.39368049385653,38.03207497959011,0.07639773728056032,1668.5723850727081,591.9974572658539,1447.4473876953125,55268,9761,45507,45507,0,12,8678000.0
8678,8678999,21.39360277659867,38.03119538595809,0.07639757129676561,1668.8192780017853,592.0636825561523,1447.5049591064453,55271,9762,45509,45509,0,12,8679000.0
8679,8679999,21.393562989966934,38.03055592224486,0.0763945029038603,1669.1894805431366,592.1286358833313,1447.838077545166,55301,9764,45537,45537,0,12,8680000.0
8680,8680999,21.393533984092926,38.030871934666415,0.07639152266556892,1669.3068113327026,592.1967782974243,1448.0227737426758,55301,9764,45537,45537,0,12,8681000.0
8681,8681999,21.393382779157104,38.030752459294426,0.07638756560421556,1669.7953233718872,592.2604324817657,1448.1442375183105,55318,9767,45551,45551,0,12,8682000.0
8682,8682999,21.393391817165273,38.03049034591018,0.07637846575201424,1669.9205574989319,592.3257238864899,1448.2773933410645,55319,9767,45552,45552,0,12,8683000.0
8683,8683999,21.39354092877738,38.03093440750458,0.07636807296861037,1670.0497317314148,592.3989024162292,1448.5137557983398,55319,9767,45552,45552,0,12,8684000.0
8684,8684999,21.393923292917716,38.03142392704021,0.07635641921657388,1670.4400517940521,592.4674046039581,1448.6149711608887,55339,9769,45570,45570,0,12,8685000.0
8685,8685999,21.394108614287457,38.03175535292858,0.07634490496390667,1670.9512491226196,592.5361204147339,1448.6334381103516,55354,9772,45582,45582,0,12,8686000.0
8686,8686999,21.39447187846315,38.032941771025854,0.07632747238279813,1671.2048106193542,592.6027686595917,1448.7471160888672,55366,9773,45593,45593,0,12,8687000.0
8687,8687999,21.394847643121974,38.03302907993831,0.07633088479351113,1671.316238641739,592.666779756546,1448.9562339782715,55369,9773,45596,45596,0,12,8688000.0
8688,8688999,21.395567965124524,38.03553085319988,0.0763147947507633,1671.5845885276794,592.7342662811279,1449.1154022216797,55372,9774,45598,45598,0,12,8689000.0
8689,8689999,21.396134141572734,38.03632218342797,0.07632659045344992,1671.825023174286,592.7996287345886,1449.269588470459,55375,9775,45600,45600,0,12,8690000.0
8690,8690999,21.3973886667999,38.03847247086715,0.07634135242951656,1672.7082259654999,592.8656640052795,1449.2530632019043,55421,9781,45640,45640,0,12,8691000.0
8691,8691999,21.398643934392975,38.04108005503865,0.07636475694115619,1672.8279118537903,592.9308071136475,1449.4537200927734,55421,9781,45640,45640,0,12,8692000.0
8692,8692999,21.399784999217776,38.04275793043113,0.07639816750980888,1673.3248257637024,592.9960219860077,1449.4808197021484,55428,9784,45644,45644,0,12,8693000.0
8693,8693999,21.401434465261733,38.04692976227266,0.07642288988856183,1673.4485294818878,593.0618507862091,1449.7337112426758,55430,9784,45646,45646,0,12,8694000.0
8694,8694999,21.403119563228966,38.050120216705714,0.07643014868788889,1673.6906974315643,593.125862121582,1449.8527030944824,55432,9785,45647,45647,0,12,8695000.0
8695,8695999,21.404265457302248,38.052204502007505,0.07642945200594542,1673.9366693496704,593.1894931793213,1449.9234428405762,55434,9786,45648,45648,0,12,8696000.0
8696,8696999,21.40507430608633,38.05371448563543,0.07644129303019187,1674.3307695388794,593.2571947574615,1450.2463073730469,55442,9788,45654,45654,0,12,8697000.0
8697,8697999,21.404693633608893,38.05324781599079,0.07643159048804771,1674.571563243866,593.3221569061279,1450.4846076965332,55447,9789,45658,45658,0,12,8698000.0
8698,8698999,21.404458941654127,38.05311828773961,0.07642260460267725,1674.9391360282898,593.3876435756683,1450.6330947875977,55454,9791,45663,45663,0,12,8699000.0
8699,8699999,21.403928231868186,38.05223621423681,0.07641324289167428,1675.1777772903442,593.4516844749451,1450.759864807129,55458,9792,45666,45666,0,12,8700000.0
8700,8700999,21.40361713733858,38.05174036008375,0.07640254555751358,1675.4280347824097,593.5173261165619,1451.0533981323242,55461,9793,45668,45668,0,12,8701000.0
8701,8701999,21.403158944814344,38.05066827599746,0.07639408230582256,1675.6701128482819,593.5812296867371,1451.2251663208008,55465,9794,45671,45671,0,12,8702000.0
8702,8702999,21.40262159306142,38.04942287511576,0.0763838808234879,1676.0381200313568,593.6461174488068,1451.274959564209,55480,9796,45684,45684,0,12,8703000.0
8703,8703999,21.402227044107722,38.0485630259518,0.0763755029194042,1676.419316291809,593.7133915424347,1451.3793106079102,55496,9798,45698,45698,0,12,8704000.0
8704,8704999,21.401973291436814,38.04778758328318,0.0763643433489174,1676.6627798080444,593.7796552181244,1451.600284576416,55502,9799,45703,45703,0,12,8705000.0
8705,8705999,21.401705342661586,38.04712831106524,0.07635528175977813,1676.791740655899,593.8489089012146,1451.7953834533691,55503,9799,45704,45704,0,12,8706000.0
8706,8706999,21.40193876398088,38.04738584584524,0.07632958625294917,1676.9127793312073,593.9166600704193,1452.2155799865723,55506,9799,45707,45707,0,12,8707000.0
8707,8707999,21.40193203926004,38.0467433594028,0.07631980700844931,1677.287658214569,593.9825975894928,1452.343059539795,55511,9801,45710,45710,0,12,8708000.0
8708,8708999,21.401964702106742,38.04608680518238,0.07630996251466671,1677.5344488620758,594.0509293079376,1452.4963150024414,55513,9802,45711,45711,0,12,8709000.0
8709,8709999,21.40227026087621,38.046125079582424,0.07630244199995573,1677.7776007652283,594.1166429519653,1452.6119194030762,55516,9803,45713,45713,0,12,8710000.0
8710,8710999,21.40242914281496,38.04578589472492,0.07629735670959692,1678.0274260044098,594.1851885318756,1452.7878761291504,55518,9804,45714,45714,0,12,8711000.0
8711,8711999,21.402646598143686,38.04563029967949,0.07629237944889167,1678.1574909687042,594.2494306564331,1453.0050201416016,55519,9804,45715,45715,0,12,8712000.0
8712,8712999,21.4030384157022,38.045333961721205,0.07629301632526175,1678.5326843261719,594.3137495517731,1453.139835357666,55525,9806,45719,45719,0,12,8713000.0
8713,8713999,21.403376601059414,38.045363060787324,0.0762895148395093,1678.8962063789368,594.3797435760498,1453.2290573120117,55530,9808,45722,45722,0,12,8714000.0
8714,8714999,21.403788586253206,38.045241960081505,0.07629196529979321,1679.008121728897,594.4442749023438,1453.3884162902832,55530,9808,45722,45722,0,12,8715000.0
8715,8715999,21.403950400391334,38.04477671562481,0.07628933733281895,1679.5126028060913,594.5096833705902,1453.4271812438965,55546,9811,45735,45735,0,12,8716000.0
8716,8716999,21.40363964868682,38.04447815761083,0.07627250335817526,1679.7603039741516,594.5746374130249,1454.0062217712402,55566,9812,45754,45754,0,12,8717000.0
8717,8717999,21.40312212306479,38.0437707440266,0.07626056066573572,1679.8727722167969,594.6387786865234,1454.2744102478027,55567,9812,45755,45755,0,12,8718000.0
8718,8718999,21.402518509036465,38.04258959273783,0.07625664011061961,1679.9843657016754,594.7017605304718,1454.506061553955,55567,9812,45755,45755,0,12,8719000.0
8719,8719999,21.402032243286172,38.04160484005067,0.07625034672845055,1680.102515220642,594.7650957107544,1454.6593551635742,55567,9812,45755,45755,0,12,8720000.0
8720,8720999,21.401493283319272,38.04058475923899,0.07624434277371817,1680.2328886985779,594.8296208381653,1454.9466743469238,55567,9812,45755,45755,0,12,8721000.0
8721,8721999,21.40109450532465,38.03938610667296,0.07623074370235494,1680.3451571464539,594.8936452865601,1455.1892929077148,55567,9812,45755,45755,0,12,8722000.0
8722,8722999,21.400710552512002,38.038526706884035,0.07621936754719616,1680.7320940494537,594.9607088565826,1455.25736618042,55572,9814,45758,45758,0,12,8723000.0
8723,8723999,21.400143530087615,38.03717056437786,0.07621321496461264,1681.1096799373627,595.026281118393,1455.3455390930176,55605,9816,45789,45789,0,12,8724000.0
8724,8724999,21.399849070801036,38.03658885363114,0.07620466226996525,1681.3564674854279,595.0907340049744,1455.5070533752441,55608,9817,45791,45791,0,12,8725000.0
8725,8725999,21.39937914920001,38.03541383388226,0.0761989962213695,1681.6005454063416,595.1569018363953,1455.6194152832031,55610,9818,45792,45792,0,12,8726000.0
8726,8726999,21.39903740563811,38.03439317674791,0.07618786387602783,1681.8479311466217,595.2208640575409,1455.9022102355957,55616,9819,45797,45797,0,12,8727000.0
8727,8727999,21.39876918057691,38.033558455933985,0.076175294941638,1682.1126792430878,595.2921240329742,1456.0466270446777,55618,9820,45798,45798,0,12,8728000.0
8728,8728999,21.398528205236044,38.03276287748682,0.07616504053050399,1682.235403060913,595.35520362854,1456.2160911560059,55618,9820,45798,45798,0,12,8729000.0
8729,8729999,21.39851030156818,38.032471959056686,0.07615591406644118,1682.5094339847565,595.4238884449005,1456.2585144042969,55621,9821,45800,45800,0,12,8730000.0
8730,8730999,21.398420808097406,38.03182711381441,0.07614829083525454,1683.0077464580536,595.489089012146,1456.2873229980469,55640,9824,45816,45816,0,12,8731000.0
8731,8731999,21.398380224334847,38.03126297068218,0.0761411783043403,1683.119919538498,595.5530133247375,1456.412353515625,55640,9824,45816,45816,0,12,8732000.0
8732,8732999,21.398567217784308,38.030990977534444,0.07613022615796394,1683.244060754776,595.6160359382629,1456.6182556152344,55641,9824,45817,45817,0,12,8733000.0
8733,8733999,21.398808439004142,38.03072549772485,0.07612183166352404,1683.49307847023,595.6798605918884,1456.6674461364746,55643,9825,45818,45818,0,12,8734000.0
8734,8734999,21.398822857050607,38.03005050704895,0.07611351607137784,1683.6161270141602,595.7434732913971,1456.761905670166,55643,9825,45818,45818,0,12,8735000.0
8735,8735999,21.398904012716738,38.02966245108182,0.07610608605132452,1683.7371277809143,595.8051631450653,1456.844165802002,55643,9825,45818,45818,0,12,8736000.0
8736,8736999,21.39863028666597,38.02973631671634,0.07609809860121086,1684.3530824184418,595.8686623573303,1457.0802612304688,55685,9829,45856,45856,0,12,8737000.0
8737,8737999,21.398683885739203,38.032386532631584,0.07608357492113205,1684.594643354416,595.9332211017609,1457.233486175537,55687,9830,45857,45857,0,12,8738000.0
8738,8738999,21.398566414942476,38.03334561181276,0.07607387455176085,1684.8465225696564,595.9970240592957,1457.3470153808594,55693,9831,45862,45862,0,12,8739000.0
8739,8739999,21.398811509263485,38.03651295050487,0.07607123976705776,1685.2169225215912,596.062563419342,1457.4424171447754,55699,9833,45866,45866,0,12,8740000.0
8740,8740999,21.399129830232326,38.03887624847496,0.0760532262907303,1685.5986287593842,596.1283705234528,1457.7256889343262,55716,9835,45881,45881,0,12,8741000.0
8741,8741999,21.39957074237104,38.04213063121022,0.076038118443025,1685.9767212867737,596.1928491592407,1457.921314239502,55723,9837,45886,45886,0,12,8742000.0
8742,8742999,21.400335468511017,38.045667983886645,0.0760386232816096,1686.094155073166,596.2581646442413,1458.0919914245605,55723,9837,45886,45886,0,12,8743000.0
8743,8743999,21.40078193116455,38.047428330416366,0.07604525949601726,1686.3470296859741,596.3225104808807,1458.1820831298828,55726,9838,45888,45888,0,12,8744000.0
8744,8744999,21.40138610972377,38.04925946981853,0.07606687049191174,1686.5984511375427,596.3874845504761,1458.338119506836,55739,9839,45900,45900,0,12,8745000.0
8745,8745999,21.40214232407315,38.05090447752472,0.07607918628014787,1686.8348350524902,596.4511003494263,1458.5742301940918,55744,9840,45904,45904,0,12,8746000.0
8746,8746999,21.403221442817827,38.053009776375795,0.07605613364752761,1686.9530770778656,596.5162422657013,1458.7840614318848,55744,9840,45904,45904,0,12,8747000.0
8747,8747999,21.4042898586077,38.05714566911044,0.0760336020175546,1687.3380930423737,596.5838449001312,1458.799087524414,55749,9842,45907,45907,0,12,8748000.0
8748,8748999,21.405579874131092,38.05930341457052,0.07604269159255694,1687.7295742034912,596.6506049633026,1458.9202575683594,55753,9844,45909,45909,0,12,8749000.0
8749,8749999,21.4066890577394,38.0612742204228,0.07603556958230073,1687.9746079444885,596.7154080867767,1459.0361366271973,55755,9845,45910,45910,0,12,8750000.0
8750,8750999,21.40815614962006,38.063838884217766,0.07603776261778605,1688.3441491127014,596.7807583808899,1459.2147750854492,55761,9847,45914,45914,0,12,8751000.0
8751,8751999,21.409823043664854,38.06663084770948,0.0760366400286987,1688.9601242542267,596.845794916153,1459.231372833252,55771,9851,45920,45920,0,12,8752000.0
8752,8752999,21.411212318856126,38.06861930337662,0.07604678040255852,1689.2031664848328,596.9103498458862,1459.3691749572754,55773,9852,45921,45921,0,12,8753000.0
8753,8753999,21.412449012733433,38.06973298052642,0.07606296409342861,1689.5836198329926,596.9747977256775,1459.409034729004,55788,9854,45934,45934,0,12,8754000.0
8754,8754999,21.41254852872172,38.069675187556456,0.07605785732347126,1689.8205499649048,597.0383081436157,1459.908706665039,55796,9855,45941,45941,0,12,8755000.0
8755,8755999,21.412025204032147,38.07032343289013,0.07605446238764457,1689.9478132724762,597.1050853729248,1460.215259552002,55796,9855,45941,45941,0,12,8756000.0
8756,8756999,21.411469329987916,38.069604417929895,0.07604835221276407,1690.0774865150452,597.1777067184448,1460.4368591308594,55797,9855,45942,45942,0,12,8757000.0
8757,8757999,21.411253984481355,38.07054397219097,0.07603624248329777,1690.3149452209473,597.2409992218018,1460.6261024475098,55809,9856,45953,45953,0,12,8758000.0
8758,8758999,21.41082297481351,38.07011690395077,0.0760313604097066,1690.5541887283325,597.3062510490417,1460.7596969604492,55821,9857,45964,45964,0,12,8759000.0
8759,8759999,21.41069371968454,38.06975774980906,0.07602392434829375,1690.7978084087372,597.3701872825623,1461.0948028564453,55823,9858,45965,45965,0,12,8760000.0
8760,8760999,21.410618254359758,38.069395978727606,0.07601700248273346,1691.0468475818634,597.4364087581635,1461.2098388671875,55825,9859,45966,45966,0,12,8761000.0
8761,8761999,21.41075995384222,38.06946828168136,0.07600855092250192,1691.1595447063446,597.5003974437714,1461.3641967773438,55826,9859,45967,45967,0,12,8762000.0
8762,8762999,21.41136269403273,38.070769687613414,0.07599562182266695,1691.5355353355408,597.565051317215,1461.4310417175293,55831,9861,45970,45970,0,12,8763000.0
8763,8763999,21.412353951945754,38.07292050350679,0.07598999479357937,1691.775550365448,597.6294219493866,1461.5814971923828,55834,9862,45972,45972,0,12,8764000.0
8764,8764999,21.413293972310292,38.07465181564628,0.07599401313264864,1692.1429979801178,597.6932525634766,1461.723201751709,55838,9864,45974,45974,0,12,8765000.0
8765,8765999,21.414638590920195,38.077067577602456,0.07599852645901728,1692.5101532936096,597.7572658061981,1461.852222442627,55843,9866,45977,45977,0,12,8766000.0
8766,8766999,21.415977954280187,38.079874277557764,0.07601060730852383,1692.746999502182,597.8207740783691,1462.0031509399414,55854,9867,45987,45987,0,12,8767000.0
8767,8767999,21.417452778333693,38.08262323655649,0.0760317460460681,1693.1388742923737,597.8861241340637,1462.0244140625,55860,9869,45991,45991,0,12,8768000.0
8768,8768999,21.41918525691182,38.08568088225806,0.07605527542580737,1693.64412856102,597.9510140419006,1462.0455474853516,55876,9872,46004,46004,0,12,8769000.0
8769,8769999,21.42104205017299,38.08895635606766,0.07609341062715846,1693.7597434520721,598.0152764320374,1462.2063026428223,55877,9872,46005,46005,0,12,8770000.0
8770,8770999,21.423513577121206,38.094962565891464,0.0760944704644615,1694.1340680122375,598.0790679454803,1462.3683967590332,55892,9874,46018,46018,0,12,8771000.0
8771,8771999,21.42542074336457,38.097758393716454,0.07612407658060394,1694.4998610019684,598.1429994106293,1462.4298667907715,55898,9876,46022,46022,0,12,8772000.0
8772,8772999,21.427369208982906,38.10080670798534,0.07616721419721695,1694.7474834918976,598.2084002494812,1462.5188789367676,55900,9877,46023,46023,0,12,8773000.0
8773,8773999,21.429145980922446,38.10328887731017,0.07621169054269927,1695.117502450943,598.2735209465027,1462.5815238952637,55919,9879,46040,46040,0,12,8774000.0
8774,8774999,21.42934572091955,38.103080138321246,0.0762234139018978,1695.5051460266113,598.3377249240875,1463.1098670959473,55936,9881,46055,46055,0,12,8775000.0
8775,8775999,21.42893675760044,38.10334048474601,0.07621895058132888,1695.742731332779,598.4033398628235,1463.4082832336426,55940,9882,46058,46058,0,12,8776000.0
8776,8776999,21.428429876079193,38.10227266066062,0.0762167419906643,1695.8557028770447,598.4693520069122,1463.6089706420898,55941,9882,46059,46059,0,12,8777000.0
8777,8777999,21.428019304028698,38.10144358401306,0.07621209561488984,1696.1100285053253,598.5373017787933,1463.750820159912,55953,9883,46070,46070,0,12,8778000.0
8778,8778999,21.42756615941887,38.1004158681646,0.07620721719673818,1696.3546707630157,598.6016449928284,1463.8869132995605,55956,9884,46072,46072,0,12,8779000.0
8779,8779999,21.427267761119793,38.099598432463594,0.07620154145797864,1696.5941581726074,598.6679027080536,1464.0772552490234,55959,9885,46074,46074,0,12,8780000.0
8780,8780999,21.42711969076287,38.09906975172818,0.07619664020078509,1696.85853433609,598.7353551387787,1464.1743278503418,55961,9886,46075,46075,0,12,8781000.0
8781,8781999,21.427001623266765,38.09859447874419,0.07619284570517071,1697.1123270988464,598.8011631965637,1464.2582550048828,55973,9887,46086,46086,0,12,8782000.0
8782,8782999,21.42686838595011,38.098218979695595,0.07618858779252913,1697.7505762577057,598.8669233322144,1464.2719497680664,56002,9891,46111,46111,0,12,8783000.0
8783,8783999,21.426885096234436,38.09777768526373,0.07618727959510174,1698.1287331581116,598.9319076538086,1464.391803741455,56017,9893,46124,46124,0,12,8784000.0
8784,8784999,21.427040622900215,38.09764016325238,0.07618586080670287,1698.252153635025,599.0004048347473,1464.6260147094727,56017,9893,46124,46124,0,12,8785000.0
8785,8785999,21.427362669823836,38.097969382456704,0.07618315230404515,1698.6262640953064,599.0660660266876,1464.7663192749023,56031,9895,46136,46136,0,12,8786000.0
8786,8786999,21.427762437583798,38.098235570738176,0.07617916283604886,1698.7420105934143,599.1314966678619,1464.905445098877,56031,9895,46136,46136,0,12,8787000.0
8787,8787999,21.42810237584531,38.098558000846225,0.07617561233867653,1699.2460067272186,599.1974544525146,1464.9491386413574,56050,9898,46152,46152,0,12,8788000.0
8788,8788999,21.428362567735867,38.098489329057394,0.07617297860408001,1699.632462978363,599.263076543808,1464.9246444702148,56056,9900,46156,46156,0,12,8789000.0
8789,8789999,21.428921162672687,38.09905544779114,0.0761769639066795,1700.2720382213593,599.330258846283,1465.006736755371,56075,9904,46171,46171,0,12,8790000.0
8790,8790999,21.429667956720756,38.09972899594995,0.07618035671832768,1700.648158788681,599.396644115448,1465.2946968078613,56088,9906,46182,46182,0,12,8791000.0
8791,8791999,21.430496503130037,38.100476662033536,0.07616817708091783,1700.7621483802795,599.4618303775787,1465.5601692199707,56088,9906,46182,46182,0,12,8792000.0
8792,8792999,21.431117251857465,38.10067863351838,0.07616941377391528,1701.0154294967651,599.5276181697845,1465.7319030761719,56090,9907,46183,46183,0,12,8793000.0
8793,8793999,21.431528450264175,38.10064040889484,0.0761748188056166,1701.1319720745087,599.5925223827362,1465.864845275879,56091,9907,46184,46184,0,12,8794000.0
8794,8794999,21.431817970035663,38.100156855477046,0.07617859514585235,1701.3818821907043,599.6569423675537,1466.0619812011719,56104,9908,46196,46196,0,12,8795000.0
8795,8795999,21.431533968021164,38.10400248999145,0.07615645461741205,1702.0064871311188,599.7223708629608,1466.3537330627441,56114,9912,46202,46202,0,12,8796000.0
8796,8796999,21.430958975443904,38.102967332565576,0.07615003511530516,1702.505372285843,599.7868053913116,1466.4623184204102,56131,9915,46216,46216,0,12,8797000.0
8797,8797999,21.43075394546835,38.10347667152062,0.07613810307262692,1702.8885419368744,599.8515822887421,1466.5586128234863,56136,9917,46219,46219,0,12,8798000.0
8798,8798999,21.43052252031213,38.10319875749558,0.07613180200310588,1703.1323220729828,599.9164640903473,1466.7168769836426,56148,9918,46230,46230,0,12,8799000.0
8799,8799999,21.430381930393757,38.10260956833011,0.07612998657232073,1703.3820521831512,599.9828808307648,1467.0485229492188,56158,9919,46239,46239,0,12,8800000.0
8800,8800999,21.430076301318294,38.10166443869265,0.07613125388706521,1703.6305203437805,600.0492262840271,1467.2102088928223,56170,9920,46250,46250,0,12,8801000.0
8801,8801999,21.430222253978442,38.10347041444758,0.07612152345519896,1703.873761177063,600.1132590770721,1467.33984375,56172,9921,46251,46251,0,12,8802000.0
8802,8802999,21.43020626881917,38.10286303087568,0.07612219138041532,1704.120626449585,600.1790714263916,1467.4330863952637,56175,9922,46253,46253,0,12,8803000.0
8803,8803999,21.430588425460822,38.1036213797829,0.07612807163919766,1704.2428524494171,600.2436213493347,1467.607578277588,56176,9922,46254,46254,0,12,8804000.0
8804,8804999,21.431404299120434,38.105016973842496,0.0761397402608599,1704.359164237976,600.3075053691864,1467.9811973571777,56180,9922,46258,46258,0,12,8805000.0
8805,8805999,21.432311812628768,38.10619115789796,0.07614838912007815,1704.609318971634,600.3735258579254,1468.16068649292,56183,9923,46260,46260,0,12,8806000.0
8806,8806999,21.433331759070377,38.10734861983448,0.07614614015227061,1705.1129567623138,600.4395275115967,1468.205768585205,56191,9926,46265,46265,0,12,8807000.0
8807,8807999,21.43426487477028,38.10963480313738,0.07616811036725946,1705.3587007522583,600.5047698020935,1468.348918914795,56193,9927,46266,46266,0,12,8808000.0
8808,8808999,21.435153003587754,38.11038605351157,0.07617916157229787,1705.6071684360504,600.5714104175568,1468.4680557250977,56196,9928,46268,46268,0,12,8809000.0
8809,8809999,21.43634047442422,38.11230490318919,0.07619835397930275,1705.7239389419556,600.6369562149048,1468.5951881408691,56196,9928,46268,46268,0,12,8810000.0
8810,8810999,21.438056097288516,38.11658523134411,0.07621177393847456,1705.8429729938507,600.7025978565216,1468.8750114440918,56196,9928,46268,46268,0,12,8811000.0
8811,8811999,21.439716181827205,38.12065846539006,0.07623636506606868,1706.109168291092,600.7713479995728,1468.930763244629,56198,9929,46269,46269,0,12,8812000.0
8812,8812999,21.44086345772865,38.123028311216835,0.07627234087611412,1706.4815084934235,600.8377227783203,1468.9741439819336,56202,9931,46271,46271,0,12,8813000.0
8813,8813999,21.441836172002557,38.12380333026873,0.07629785484481955,1706.728318452835,600.9026799201965,1469.05033493042,56205,9932,46273,46273,0,12,8814000.0
8814,8814999,21.442030840652247,38.12436503487835,0.07629193574242865,1706.9763720035553,600.9683122634888,1469.4297256469727,56210,9933,46277,46277,0,12,8815000.0
8815,8815999,21.441973451807105,38.124766457881314,0.07628313223615213,1707.0956089496613,601.0332119464874,1469.705436706543,56210,9933,46277,46277,0,12,8816000.0
8816,8816999,21.44218846236911,38.125720737945535,0.07626815795659325,1707.2139327526093,601.099219083786,1469.9159965515137,56211,9933,46278,46278,0,12,8817000.0
8817,8817999,21.442373061104217,38.12724114774586,0.07625230046590348,1707.5914888381958,601.1666836738586,1470.0796012878418,56239,9935,46304,46304,0,12,8818000.0
8818,8818999,21.44280533583178,38.12800284835196,0.07623198019667976,1708.1045935153961,601.2332377433777,1470.2219772338867,56248,9938,46310,46310,0,12,8819000.0
8819,8819999,21.443031797652623,38.128066419116834,0.07621861074283076,1708.487298488617,601.2997541427612,1470.3455924987793,56258,9940,46318,46318,0,12,8820000.0
8820,8820999,21.443217225439895,38.12803675106639,0.07620624393321307,1708.6061458587646,601.3652219772339,1470.4917259216309,56258,9940,46318,46318,0,12,8821000.0
8821,8821999,21.443229012565684,38.12740753404877,0.07619639853032256,1708.9983966350555,601.4337975978851,1470.6053886413574,56264,9942,46322,46322,0,12,8822000.0
8822,8822999,21.443625888281428,38.129494365830645,0.07617422950363306,1709.6453824043274,601.5002856254578,1470.590976715088,56275,9946,46329,46329,0,12,8823000.0
8823,8823999,21.443776943459554,38.12886959933823,0.07616260907369321,1710.1687874794006,601.5693860054016,1470.864803314209,56284,9949,46335,46335,0,12,8824000.0
8824,8824999,21.443946348183427,38.12847259702453,0.07614506346671046,1710.6665420532227,601.6374328136444,1471.0442543029785,56290,9952,46338,46338,0,12,8825000.0
8825,8825999,21.444071125610687,38.12808000409829,0.07612913977257629,1710.779096364975,601.7029130458832,1471.2988510131836,56290,9952,46338,46338,0,12,8826000.0
8826,8826999,21.444392904732354,38.12781591900631,0.07611351169485892,1711.0350131988525,601.7700202465057,1471.4362030029297,56293,9953,46340,46340,0,12,8827000.0
8827,8827999,21.44461604515901,38.12737533709163,0.07609823153070538,1711.4064025878906,601.8376371860504,1471.532054901123,56317,9955,46362,46362,0,12,8828000.0
8828,8828999,21.444932509707503,38.12696759670682,0.0760819042698615,1712.0279982089996,601.9036560058594,1471.7252922058105,56348,9959,46389,46389,0,12,8829000.0
8829,8829999,21.44490000817472,38.12601190586605,0.07606959332123775,1712.141977071762,601.9685802459717,1471.917423248291,56348,9959,46389,46389,0,12,8830000.0
8830,8830999,21.444964274495863,38.12513288686538,0.07605863643984523,1712.2646827697754,602.0360796451569,1472.0204544067383,56348,9959,46389,46389,0,12,8831000.0
8831,8831999,21.444632747380144,38.12441827968548,0.07604976920409634,1712.5241265296936,602.1028010845184,1472.6206550598145,56360,9960,46400,46400,0,12,8832000.0
8832,8832999,21.444128829911055,38.124588888617474,0.07603807127816009,1712.9050970077515,602.1700234413147,1472.7936782836914,56382,9962,46420,46420,0,12,8833000.0
8833,8833999,21.443679238771026,38.12417670584728,0.07603717495978779,1713.2792210578918,602.2361884117126,1472.9943962097168,56397,9964,46433,46433,0,12,8834000.0
8834,8834999,21.44306507146503,38.122941427917276,0.07603409690917162,1713.5246667861938,602.3041350841522,1473.1442337036133,56409,9965,46444,46444,0,12,8835000.0
8835,8835999,21.44257970628765,38.12181841620996,0.07603027392562822,1714.023208141327,602.3696658611298,1473.4150848388672,56418,9968,46450,46450,0,12,8836000.0
8836,8836999,21.442183815532733,38.12084094004099,0.0760251378176452,1714.1428036689758,602.4351005554199,1473.60986328125,56418,9968,46450,46450,0,12,8837000.0
8837,8837999,21.44174536019372,38.12054346308735,0.07601706406604858,1714.3907234668732,602.5028958320618,1473.7069091796875,56420,9969,46451,46451,0,12,8838000.0
8838,8838999,21.4414170217659,38.12048381572699,0.07600491126355646,1714.7644906044006,602.5699779987335,1473.779884338379,56436,9971,46465,46465,0,12,8839000.0
8839,8839999,21.441122885917967,38.11969443818689,0.07599443152074814,1714.883502483368,602.6348392963409,1473.9759521484375,56438,9971,46467,46467,0,12,8840000.0
8840,8840999,21.441205984151235,38.119395326713075,0.07597235212744957,1715.253854751587,602.6994190216064,1474.1735649108887,56454,9973,46481,46481,0,12,8841000.0
8841,8841999,21.44152831747512,38.119033340414674,0.07593974705789042,1716.0347492694855,602.7661893367767,1474.1643257141113,56465,9978,46487,46487,0,12,8842000.0
8842,8842999,21.441717357481796,38.118634988749925,0.0759196551957092,1716.1610107421875,602.831503868103,1474.383201599121,56465,9978,46487,46487,0,12,8843000.0
8843,8843999,21.441827607370122,38.11805898648634,0.07590533151104484,1716.4001624584198,602.8958332538605,1474.5023231506348,56468,9979,46489,46489,0,12,8844000.0
8844,8844999,21.442025095361767,38.11783974905307,0.07589202130238781,1716.7752678394318,602.9610624313354,1474.6009216308594,56474,9981,46493,46493,0,12,8845000.0
8845,8845999,21.4424547292341,38.11773456923738,0.07587153097166233,1717.1777737140656,603.0292127132416,1474.6846885681152,56478,9983,46495,46495,0,12,8846000.0
8846,8846999,21.44294295694417,38.11856096645881,0.07584838219888401,1717.5436789989471,603.0948424339294,1474.9680671691895,56484,9985,46499,46499,0,12,8847000.0
8847,8847999,21.443233895221617,38.118110789111114,0.07583532488589406,1717.7881338596344,603.1618945598602,1475.1376876831055,56486,9986,46500,46500,0,12,8848000.0
8848,8848999,21.4432992650509,38.11746090447155,0.07582454953581719,1718.154887676239,603.2275896072388,1475.2228507995605,56491,9988,46503,46503,0,12,8849000.0
8849,8849999,21.443275463975784,38.11670052521698,0.07581679012822751,1718.5249989032745,603.2931482791901,1475.2996292114258,56496,9990,46506,46506,0,12,8850000.0
8850,8850999,21.44281864620337,38.11559588617641,0.07581342038426053,1718.9048595428467,603.3585999011993,1475.761489868164,56506,9992,46514,46514,0,12,8851000.0
8851,8851999,21.441980417788766,38.11455458203195,0.07581539221021871,1719.0131459236145,603.4228496551514,1476.0675659179688,56506,9992,46514,46514,0,12,8852000.0
8852,8852999,21.441252185756984,38.11409806554312,0.07581327695344864,1719.1341063976288,603.4869179725647,1476.2643356323242,56506,9992,46514,46514,0,12,8853000.0
8853,8853999,21.44039148865846,38.112602030782725,0.07581535822166663,1719.3863072395325,603.5539927482605,1476.380027770996,56510,9993,46517,46517,0,12,8854000.0
8854,8854999,21.439675131932507,38.11135969268037,0.07581684503903063,1719.5059592723846,603.6219446659088,1476.5237274169922,56510,9993,46517,46517,0,12,8855000.0
8855,8855999,21.4389961231896,38.11000185332258,0.07581699229232164,1719.7563042640686,603.6864595413208,1476.6636085510254,56513,9994,46519,46519,0,12,8856000.0
8856,8856999,21.43837892670898,38.10880291339553,0.07581546133442874,1719.9992973804474,603.7517638206482,1476.822582244873,56515,9995,46520,46520,0,12,8857000.0
8857,8857999,21.437707355576485,38.10767524541094,0.07581423949069754,1720.261952638626,603.8181421756744,1476.9477844238281,56518,9996,46522,46522,0,12,8858000.0
8858,8858999,21.436963785851734,38.106494995509394,0.07581368449425285,1720.4955983161926,603.8810744285583,1477.0224990844727,56521,9997,46524,46524,0,12,8859000.0
8859,8859999,21.436323925432053,38.1052898511108,0.07581257805650632,1720.6195003986359,603.9459102153778,1477.1846618652344,56521,9997,46524,46524,0,12,8860000.0
8860,8860999,21.435667950552794,38.10424049513563,0.07581106831509832,1721.0149416923523,604.0139811038971,1477.2289543151855,56525,9999,46526,46526,0,12,8861000.0
8861,8861999,21.435159182255223,38.103010346191944,0.07580628354205654,1721.1321759223938,604.0782177448273,1477.4925079345703,56525,9999,46526,46526,0,12,8862000.0
8862,8862999,21.434732933104666,38.1018374789144,0.07580039951417428,1721.5359992980957,604.1507580280304,1477.535930633545,56530,10001,46529,46529,0,12,8863000.0
8863,8863999,21.434239433543063,38.10066905483537,0.07579594090772412,1721.6557865142822,604.2151911258698,1477.6708869934082,56530,10001,46529,46529,0,12,8864000.0
8864,8864999,21.433858004039177,38.10085147884985,0.07578907202668927,1721.771877527237,604.2785654067993,1477.7718696594238,56530,10001,46529,46529,0,12,8865000.0
8865,8865999,21.433399236590674,38.09972503432419,0.07578508770477543,1721.901897907257,604.3443737030029,1477.8786697387695,56530,10001,46529,46529,0,12,8866000.0
8866,8866999,21.43291153954465,38.098561072629835,0.07578454176516214,1722.156568288803,604.4076819419861,1477.9856224060059,56533,10002,46531,46531,0,12,8867000.0
8867,8867999,21.43244441641883,38.0973368075642,0.07578333174246032,1722.3989887237549,604.4719049930573,1478.1058349609375,56535,10003,46532,46532,0,12,8868000.0
8868,8868999,21.43204867306048,38.09694309670339,0.07577764692654498,1722.639145374298,604.5355324745178,1478.1662483215332,56537,10004,46533,46533,0,12,8869000.0
8869,8869999,21.431429036231293,38.09573165933135,0.07577631796132689,1722.773936033249,604.599939584732,1478.2484855651855,56537,10004,46533,46533,0,12,8870000.0
8870,8870999,21.430735622306052,38.09442347590543,0.07577438978781414,1722.8988358974457,604.6661586761475,1478.3123779296875,56537,10004,46533,46533,0,12,8871000.0
8871,8871999,21.43009832763504,38.09402018309136,0.07577296678725243,1723.1475567817688,604.7340474128723,1478.6938743591309,56550,10005,46545,46545,0,12,8872000.0
8872,8872999,21.429409969456056,38.09355499264937,0.07576862813894258,1723.2608761787415,604.8001289367676,1478.8736152648926,56550,10005,46545,46545,0,12,8873000.0
8873,8873999,21.42854886219478,38.09233230756619,0.07576904731648759,1723.6360743045807,604.8645474910736,1478.9551391601562,56555,10007,46548,46548,0,12,8874000.0
8874,8874999,21.428283457692558,38.092201449291316,0.07576623712079111,1723.8828501701355,604.9309606552124,1479.0865287780762,56557,10008,46549,46549,0,12,8875000.0
8875,8875999,21.42799842641924,38.09191694105515,0.07575858069938168,1724.00221991539,604.9958276748657,1479.3769836425781,56557,10008,46549,46549,0,12,8876000.0
8876,8876999,21.427859312017084,38.09157872612854,0.07575005946689728,1724.3816087245941,605.0594966411591,1479.4761924743652,56567,10010,46557,46557,0,12,8877000.0
8877,8877999,21.42797492759846,38.09178798581567,0.07572075632316799,1724.6279079914093,605.1241753101349,1479.6284713745117,56569,10011,46558,46558,0,12,8878000.0
8878,8878999,21.42780956993608,38.09141895330313,0.07570679537780722,1724.8793070316315,605.1892776489258,1479.7476959228516,56571,10012,46559,46559,0,12,8879000.0
8879,8879999,21.4279198328072,38.09128905655981,0.07569234082603538,1725.2522876262665,605.2541170120239,1479.8425064086914,56586,10014,46572,46572,0,12,8880000.0
8880,8880999,21.42794796895609,38.09096527318617,0.07568491898706564,1725.3943693637848,605.321807384491,1480.007900238037,56587,10014,46573,46573,0,12,8881000.0
8881,8881999,21.428091308982285,38.09075986710627,0.0756804341111239,1725.6462891101837,605.3859069347382,1480.2273406982422,56591,10015,46576,46576,0,12,8882000.0
8882,8882999,21.428089352215576,38.090160535980495,0.07567966894631062,1725.7923538684845,605.4609544277191,1480.3612365722656,56592,10015,46577,46577,0,12,8883000.0
8883,8883999,21.428051468273647,38.08955926985412,0.07568008162795414,1725.9111518859863,605.5235431194305,1480.4921035766602,56592,10015,46577,46577,0,12,8884000.0
8884,8884999,21.428098704929287,38.0891139954301,0.07568122991998405,1726.0326766967773,605.5867204666138,1480.575870513916,56592,10015,46577,46577,0,12,8885000.0
8885,8885999,21.42829841155836,38.088938822205655,0.07567512989855119,1726.2788345813751,605.6501784324646,1480.6067848205566,56603,10016,46587,46587,0,12,8886000.0
8886,8886999,21.42827317138739,38.088270158039194,0.07567708234292658,1726.3911504745483,605.7134194374084,1480.780258178711,56603,10016,46587,46587,0,12,8887000.0
8887,8887999,21.42861357293688,38.087978092933476,0.07567752417758955,1726.5136659145355,605.7763814926147,1480.9393310546875,56603,10016,46587,46587,0,12,8888000.0
8888,8888999,21.42877691440287,38.087455941168166,0.07567161852146143,1727.0336427688599,605.8428032398224,1480.944953918457,56609,10019,46590,46590,0,12,8889000.0
8889,8889999,21.428775795849567,38.086666497221245,0.07567556735621239,1727.1574952602386,605.90527510643,1481.068214416504,56609,10019,46590,46590,0,12,8890000.0
8890,8890999,21.428707866148454,38.08582110878235,0.07566888411802108,1727.4013738632202,605.9681651592255,1481.1165504455566,56611,10020,46591,46591,0,12,8891000.0
8891,8891999,21.427970290055704,38.084300677855005,0.07566855141439943,1727.5279772281647,606.0421528816223,1481.5725326538086,56615,10020,46595,46595,0,12,8892000.0
8892,8892999,21.427024965945566,38.08312652545888,0.07566944443447043,1727.6397531032562,606.1063241958618,1481.7678260803223,56615,10020,46595,46595,0,12,8893000.0
8893,8893999,21.426081620119376,38.08165813826536,0.0756715025462722,1727.8927335739136,606.1700382232666,1481.8430099487305,56618,10021,46597,46597,0,12,8894000.0
8894,8894999,21.42535545206479,38.08058785180105,0.07567080953469574,1728.1438040733337,606.2336568832397,1481.9296875,56620,10022,46598,46598,0,12,8895000.0
8895,8895999,21.424732908826417,38.07964595246983,0.07566678872534383,1728.386180639267,606.2974181175232,1482.1563148498535,56633,10023,46610,46610,0,12,8896000.0
8896,8896999,21.424181822829034,38.078934406462785,0.0756637134765954,1728.63534283638,606.3628463745117,1482.2467994689941,56635,10024,46611,46611,0,12,8897000.0
8897,8897999,21.42365236027075,38.078154173149564,0.07566104208917102,1729.0112063884735,606.4265177249908,1482.3831596374512,56648,10026,46622,46622,0,12,8898000.0
8898,8898999,21.42287720588464,38.0766621472029,0.07565951653003589,1729.2614398002625,606.4901385307312,1482.4901390075684,56651,10027,46624,46624,0,12,8899000.0
8899,8899999,21.422283821247674,38.07532819002603,0.07565548034316283,1729.510145187378,606.5561928749084,1482.6587867736816,56654,10028,46626,46626,0,12,8900000.0
8900,8900999,21.421801926446957,38.0743218394407,0.07565314286854397,1729.7601327896118,606.6198468208313,1482.774600982666,56666,10029,46637,46637,0,12,8901000.0
8901,8901999,21.42150100666562,38.075107514578434,0.07564059755450436,1730.1355543136597,606.6840662956238,1483.0481605529785,56682,10031,46651,46651,0,12,8902000.0
8902,8902999,21.420991709740925,38.07381757575285,0.07563898569476823,1730.2534317970276,606.747777223587,1483.215835571289,56682,10031,46651,46651,0,12,8903000.0
8903,8903999,21.42063797350692,38.07286067994414,0.07563633034139283,1730.6339783668518,606.8136503696442,1483.2881813049316,56687,10033,46654,46654,0,12,8904000.0
8904,8904999,21.42025095814571,38.07188307615272,0.07563373774194082,1730.8837881088257,606.8778660297394,1483.4106712341309,56689,10034,46655,46655,0,12,8905000.0
8905,8905999,21.42001444910065,38.071245538245826,0.07562885576782141,1731.1205995082855,606.9415187835693,1483.5393829345703,56693,10035,46658,46658,0,12,8906000.0
8906,8906999,21.419894395748283,38.070519843561684,0.0756245376474497,1731.4975364208221,607.0058436393738,1483.6558074951172,56700,10037,46663,46663,0,12,8907000.0
8907,8907999,21.419895018036648,38.069713106835586,0.07561867099630981,1731.7483642101288,607.0715844631195,1483.879207611084,56703,10038,46665,46665,0,12,8908000.0
8908,8908999,21.419888953939317,38.06897954912814,0.0756115452985755,1731.994270324707,607.1354806423187,1483.9789352416992,56705,10039,46666,46666,0,12,8909000.0
8909,8909999,21.419658939014223,38.06804599208851,0.07560896525507177,1732.4980249404907,607.2001919746399,1483.9825477600098,56713,10042,46671,46671,0,12,8910000.0
8910,8910999,21.4192953174703,38.0669165348606,0.07560538550708795,1732.6184146404266,607.2641241550446,1484.1135215759277,56713,10042,46671,46671,0,12,8911000.0
8911,8911999,21.41867073142654,38.065575644928195,0.07560149224111645,1732.999430656433,607.3290481567383,1484.578125,56729,10044,46685,46685,0,12,8912000.0
8912,8912999,21.41785762679982,38.06419919483887,0.07559449757544334,1733.241665840149,607.393406867981,1484.832145690918,56734,10045,46689,46689,0,12,8913000.0
8913,8913999,21.417165901246143,38.06301130837649,0.07559153991373768,1733.3589644432068,607.457044839859,1485.0459899902344,56734,10045,46689,46689,0,12,8914000.0
8914,8914999,21.416610105991982,38.06189784725265,0.07558824513056839,1733.6034488677979,607.521148443222,1485.1706085205078,56737,10046,46691,46691,0,12,8915000.0
8915,8915999,21.416224992374993,38.06160548313932,0.07557451581092811,1733.9849317073822,607.5871636867523,1485.3749885559082,56752,10048,46704,46704,0,12,8916000.0
8916,8916999,21.41579558401651,38.06047371108725,0.07556574348377432,1734.1045594215393,607.6548490524292,1485.559226989746,56752,10048,46704,46704,0,12,8917000.0
8917,8917999,21.41545515006829,38.059486643723446,0.07555583392090548,1734.2180833816528,607.7176268100739,1485.7103157043457,56752,10048,46704,46704,0,12,8918000.0
8918,8918999,21.415108546351664,38.05879996760562,0.07554866751033684,1734.3387682437897,607.7832367420197,1485.8272132873535,56752,10048,46704,46704,0,12,8919000.0
8919,8919999,21.414811677713924,38.05797164523341,0.07554414600708093,1734.7150263786316,607.8487021923065,1485.8608207702637,56757,10050,46707,46707,0,12,8920000.0
8920,8920999,21.414854203713226,38.0579270976767,0.07553638981932731,1735.0923864841461,607.9135925769806,1485.909740447998,56761,10052,46709,46709,0,12,8921000.0
8921,8921999,21.415149840792516,38.05791339595248,0.07552179435580564,1735.3334379196167,607.9790534973145,1486.1771926879883,56765,10053,46712,46712,0,12,8922000.0
8922,8922999,21.4157817575786,38.05874046498141,0.07551296660713691,1735.7129447460175,608.0447316169739,1486.2668571472168,56779,10055,46724,46724,0,12,8923000.0
8923,8923999,21.41621131736828,38.059272754036364,0.07550709545893175,1735.8349602222443,608.1131014823914,1486.4091835021973,56779,10055,46724,46724,0,12,8924000.0
8924,8924999,21.41679554116963,38.06004516527137,0.07551817913881587,1735.963906288147,608.1768753528595,1486.515037536621,56780,10055,46725,46725,0,12,8925000.0
8925,8925999,21.417745009301854,38.0616519844657,0.07552376871710631,1736.7462575435638,608.244978427887,1486.4005432128906,56803,10060,46743,46743,0,12,8926000.0
8926,8926999,21.41866841641489,38.06302985086851,0.075538603925551,1737.017735004425,608.3103115558624,1486.5937728881836,56805,10061,46744,46744,0,12,8927000.0
8927,8927999,21.419945333540625,38.06475225287077,0.07554403794938369,1737.2680673599243,608.3751010894775,1486.7091064453125,56807,10062,46745,46745,0,12,8928000.0
8928,8928999,21.421380392044686,38.06742211466705,0.07554712788071638,1737.5342381000519,608.4419620037079,1486.829029083252,56809,10063,46746,46746,0,12,8929000.0
8929,8929999,21.42249716089499,38.068555439171895,0.0755649717448229,1738.0362565517426,608.5068724155426,1486.7920570373535,56818,10066,46752,46752,0,12,8930000.0
8930,8930999,21.423542612527648,38.07003383075476,0.07557014186776123,1738.1611695289612,608.571038722992,1486.9064559936523,56818,10066,46752,46752,0,12,8931000.0
8931,8931999,21.423304916691066,38.06967172844639,0.07555414510039093,1738.4043743610382,608.6359639167786,1487.494873046875,56824,10067,46757,46757,0,12,8932000.0
8932,8932999,21.422948705389334,38.06980976686136,0.07553968447420711,1739.1714787483215,608.7025017738342,1487.6074142456055,56844,10072,46772,46772,0,12,8933000.0
8933,8933999,21.422549107000687,38.06913060523212,0.07553164060966733,1739.4178824424744,608.7687895298004,1487.7897682189941,56849,10073,46776,46776,0,12,8934000.0
8934,8934999,21.42216993970126,38.069475218733984,0.07552145491011664,1739.8011224269867,608.8347952365875,1487.9642868041992,56864,10075,46789,46789,0,12,8935000.0
8935,8935999,21.421890156812886,38.068734247029006,0.07551383488603813,1740.0444855690002,608.9000716209412,1488.2254371643066,56868,10076,46792,46792,0,12,8936000.0
8936,8936999,21.42164338825731,38.06795171416321,0.07550269675391186,1740.5448081493378,608.9673252105713,1488.3540573120117,56886,10079,46807,46807,0,12,8937000.0
8937,8937999,21.421410785382907,38.06768127925891,0.0754927854358578,1740.7969920635223,609.0328392982483,1488.4801902770996,56898,10080,46818,46818,0,12,8938000.0
8938,8938999,21.421243358390207,38.06894447180331,0.07548146836472802,1741.1909034252167,609.1017377376556,1488.520076751709,56904,10082,46822,46822,0,12,8939000.0
8939,8939999,21.42110027526326,38.068377968106255,0.07547452803436039,1741.5726387500763,609.1680536270142,1488.5999794006348,56909,10084,46825,46825,0,12,8940000.0
8940,8940999,21.420940764315162,38.06765820040706,0.07547103356079343,1741.69180893898,609.2336375713348,1488.7832946777344,56909,10084,46825,46825,0,12,8941000.0
8941,8941999,21.421166151808617,38.06732744174107,0.07544662521225054,1741.943249464035,609.3037025928497,1489.1028671264648,56923,10085,46838,46838,0,12,8942000.0
8942,8942999,21.421446620058045,38.06730366236818,0.07542342444174499,1742.445230960846,609.3703944683075,1489.1682815551758,56941,10088,46853,46853,0,12,8943000.0
8943,8943999,21.421770789456524,38.06729938551407,0.07540634998413542,1742.690776348114,609.4363765716553,1489.2849311828613,56943,10089,46854,46854,0,12,8944000.0
8944,8944999,21.42226772927758,38.06751422251101,0.07538489051551811,1743.210913658142,609.502849817276,1489.3778343200684,56950,10092,46858,46858,0,12,8945000.0
8945,8945999,21.422759443785935,38.06760990326561,0.07537440962283437,1743.327478647232,609.5686395168304,1489.524070739746,56950,10092,46858,46858,0,12,8946000.0
8946,8946999,21.423124062167645,38.067210212396375,0.07536977869525563,1743.445621728897,609.6349384784698,1489.660026550293,56951,10092,46859,46859,0,12,8947000.0
8947,8947999,21.423784244702002,38.067302001392605,0.07535740475909813,1743.7038705348969,609.7005834579468,1489.9843864440918,56954,10093,46861,46861,0,12,8948000.0
8948,8948999,21.42465130422711,38.067654572354215,0.07535225604221685,1743.9577581882477,609.7682948112488,1490.0735549926758,56956,10094,46862,46862,0,12,8949000.0
8949,8949999,21.42534644694469,38.067694286582125,0.07534783315425686,1744.3354578018188,609.8336126804352,1490.1276321411133,56960,10096,46864,46864,0,12,8950000.0
8950,8950999,21.425980052667818,38.06809561607229,0.07534559701582733,1744.715338230133,609.898764371872,1490.1725540161133,56966,10098,46868,46868,0,12,8951000.0
8951,8951999,21.425928851797842,38.06733047102061,0.07534331967408647,1744.8320755958557,609.963873386383,1490.6814880371094,56974,10098,46876,46876,0,12,8952000.0
8952,8952999,21.425117390433726,38.06624177926562,0.0753449842406988,1744.9472053050995,610.0297679901123,1491.0088386535645,56974,10098,46876,46876,0,12,8953000.0
8953,8953999,21.424349022444176,38.066087313215405,0.07534282696030925,1745.0666346549988,610.0983197689056,1491.238296508789,56975,10098,46877,46877,0,12,8954000.0
8954,8954999,21.423602060126875,38.06499474678898,0.07534346466503772,1745.1863667964935,610.1643972396851,1491.4159812927246,56976,10098,46878,46878,0,12,8955000.0
8955,8955999,21.422932130293272,38.064483842070615,0.07534004341855172,1745.3074777126312,610.2305881977081,1491.6961631774902,56980,10098,46882,46882,0,12,8956000.0
8956,8956999,21.42249151640203,38.064348915441855,0.07533195110197188,1745.9597935676575,610.2992300987244,1491.782070159912,56994,10102,46892,46892,0,12,8957000.0
8957,8957999,21.4219550286995,38.063165077701804,0.07532942018317113,1746.0803921222687,610.3657367229462,1492.025650024414,56994,10102,46892,46892,0,12,8958000.0
8958,8958999,21.421326325166813,38.06198304776073,0.07532695102514175,1746.199838399887,610.4314694404602,1492.197177886963,56994,10102,46892,46892,0,12,8959000.0
8959,8959999,21.420833608298675,38.061037825320966,0.07532172990333641,1746.5836408138275,610.4967110157013,1492.3177185058594,57002,10104,46898,46898,0,12,8960000.0
8960,8960999,21.420439863796183,38.06218209171559,0.07531164596389262,1746.7084107398987,610.5627226829529,1492.4906425476074,57002,10104,46898,46898,0,12,8961000.0
8961,8961999,21.420218374866042,38.06139600051472,0.0753021666753183,1746.826993227005,610.6285681724548,1492.7640495300293,57002,10104,46898,46898,0,12,8962000.0
8962,8962999,21.42019085122302,38.060884895648954,0.07528848893258144,1747.5915124416351,610.6944003105164,1492.8320388793945,57043,10109,46934,46934,0,12,8963000.0
8963,8963999,21.420226159869827,38.06079833140791,0.0752808168033533,1748.1059396266937,610.7596836090088,1492.8640251159668,57053,10112,46941,46941,0,12,8964000.0
8964,8964999,21.42011086257358,38.06008334748457,0.07527236936500414,1748.3599927425385,610.8258483409882,1492.9492263793945,57055,10113,46942,46942,0,12,8965000.0
8965,8965999,21.420185634979003,38.0596389720871,0.0752632498452247,1748.7346394062042,610.890707731247,1493.195888519287,57067,10115,46952,46952,0,12,8966000.0
8966,8966999,21.420153310466766,38.05883933736652,0.07525747188843956,1749.1107382774353,610.9563994407654,1493.3490104675293,57072,10117,46955,46955,0,12,8967000.0
8967,8967999,21.420025982504505,38.0580076578115,0.07525348728648207,1749.4830930233002,611.0206344127655,1493.3748626708984,57080,10119,46961,46961,0,12,8968000.0
8968,8968999,21.41988838003911,38.05836056074982,0.07524689722135958,1749.7469866275787,611.089129447937,1493.7239227294922,57094,10120,46974,46974,0,12,8969000.0
8969,8969999,21.419457413091493,38.05797655629603,0.07524356184689052,1750.0051925182343,611.155415058136,1494.160228729248,57109,10121,46988,46988,0,12,8970000.0
8970,8970999,21.418861580418806,38.0573465810908,0.07524138579314876,1750.1203701496124,611.2197413444519,1494.3679389953613,57110,10121,46989,46989,0,12,8971000.0
8971,8971999,21.41833487891075,38.05645251880183,0.07524135287348754,1750.6629285812378,611.291029214859,1494.4689140319824,57145,10124,47021,47021,0,12,8972000.0
8972,8972999,21.4179624407571,38.05594112316312,0.07524687845234146,1751.0459477901459,611.3564374446869,1494.7809524536133,57159,10126,47033,47033,0,12,8973000.0
8973,8973999,21.417840567113224,38.056048916791404,0.07524346931908754,1751.1783983707428,611.42502617836,1494.996868133545,57159,10126,47033,47033,0,12,8974000.0
8974,8974999,21.41750042558541,38.055297095624134,0.07523942590002752,1751.4302198886871,611.4933233261108,1495.1104469299316,57161,10127,47034,47034,0,12,8975000.0
8975,8975999,21.417596642220687,38.057574547763906,0.07522630413687381,1751.8132784366608,611.5594112873077,1495.1348037719727,57174,10129,47045,47045,0,12,8976000.0
8976,8976999,21.41747316438166,38.05714194923614,0.0752232303278626,1752.2117562294006,611.6265156269073,1495.1945037841797,57181,10131,47050,47050,0,12,8977000.0
8977,8977999,21.4178502664441,38.057491910097085,0.07521399594977674,1752.739639043808,611.6945354938507,1495.2787551879883,57192,10134,47058,47058,0,12,8978000.0
8978,8978999,21.41825403786824,38.05796380921707,0.07520814931089082,1753.2628872394562,611.761376619339,1495.474681854248,57209,10137,47072,47072,0,12,8979000.0
8979,8979999,21.419035329981035,38.058806363630175,0.0751995626884554,1753.5236139297485,611.8294131755829,1495.6287002563477,57211,10138,47073,47073,0,12,8980000.0
8980,8980999,21.419455559552002,38.06024205079673,0.07519083349810984,1753.9031429290771,611.8956706523895,1495.695713043213,57216,10140,47076,47076,0,12,8981000.0
8981,8981999,21.420135517096394,38.06100600248933,0.07518689788268684,1754.1876907348633,611.9662311077118,1495.7654724121094,57220,10141,47079,47079,0,12,8982000.0
8982,8982999,21.42114114653231,38.06300307823638,0.07518415682828927,1754.4422056674957,612.0316476821899,1495.8811340332031,57223,10142,47081,47081,0,12,8983000.0
8983,8983999,21.422099828506482,38.064258043175954,0.07518663227831257,1754.6872825622559,612.096785068512,1496.079891204834,57225,10143,47082,47082,0,12,8984000.0
8984,8984999,21.42338537515185,38.06535042244641,0.07519215503864918,1754.9364013671875,612.1619741916656,1496.1735038757324,57228,10144,47084,47084,0,12,8985000.0
8985,8985999,21.424326999354957,38.065845246622445,0.07519954809964768,1755.1893255710602,612.2265207767487,1496.2581405639648,57231,10145,47086,47086,0,12,8986000.0
8986,8986999,21.42524364272887,38.06716183017032,0.07520529566728706,1755.3291473388672,612.2984869480133,1496.344654083252,57231,10145,47086,47086,0,12,8987000.0
8987,8987999,21.425611812450853,38.06672361330317,0.07521143819769727,1760.4125814437866,612.363263130188,1496.4688262939453,57231,10145,47086,47086,0,12,8988000.0
8988,8988999,21.425496645901628,38.06602229566494,0.07519960655580393,1760.6705458164215,612.4262957572937,1496.787582397461,57237,10146,47091,47091,0,12,8989000.0
8989,8989999,21.424937570695636,38.06487598694419,0.07519498306014272,1760.9429183006287,612.4926462173462,1496.9451942443848,57242,10147,47095,47095,0,12,8990000.0
8990,8990999,21.424833167532995,38.06457704341898,0.07518843539490505,1761.3574192523956,612.557687997818,1497.0329360961914,57247,10149,47098,47098,0,12,8991000.0
8991,8991999,21.424723424844156,38.064082217942904,0.07518268927079574,1761.4793453216553,612.6208620071411,1497.1154174804688,57247,10149,47098,47098,0,12,8992000.0
8992,8992999,21.424502516032884,38.06336243338935,0.07518028319239922,1761.7492978572845,612.6849844455719,1497.2697715759277,57250,10150,47100,47100,0,12,8993000.0
8993,8993999,21.424957902532984,38.06429305876921,0.07518062247991353,1761.8855221271515,612.7492084503174,1497.3716125488281,57250,10150,47100,47100,0,12,8994000.0
8994,8994999,21.425626547031978,38.06582911886492,0.07517718206243895,1762.0107262134552,612.8117287158966,1497.44429397583,57250,10150,47100,47100,0,12,8995000.0
8995,8995999,21.426226639310183,38.066804654503294,0.07518063896538474,1762.1475825309753,612.8748183250427,1497.5226097106934,57250,10150,47100,47100,0,12,8996000.0
8996,8996999,21.42732312195558,38.06939602808708,0.07518355319709413,1762.267944574356,612.9383625984192,1497.6010971069336,57250,10150,47100,47100,0,12,8997000.0
8997,8997999,21.42829300953909,38.071365171290175,0.07518785386075055,1762.6738696098328,613.0013475418091,1497.5187644958496,57262,10152,47110,47110,0,12,8998000.0
8998,8998999,21.42971804282912,38.07511433829954,0.0751887336643321,1762.7983784675598,613.0656204223633,1497.7064819335938,57262,10152,47110,47110,0,12,8999000.0
8999,8999999,21.431646633914678,38.07942519923716,0.07519313289196017,1763.0655875205994,613.1283268928528,1497.721981048584,57268,10153,47115,47115,0,12,9000000.0
9000,9000999,21.4332582429798,38.08377494138744,0.07520878625786576,1763.6059498786926,613.191965341568,1497.7113990783691,57281,10156,47125,47125,0,12,9001000.0
9001,9001999,21.435096414272827,38.08709873784208,0.07523064725910444,1764.1796226501465,613.2560198307037,1497.6241836547852,57296,10159,47137,47137,0,12,9002000.0
9002,9002999,21.437106544853528,38.090581715671455,0.0752800378481201,1764.2991392612457,613.3197617530823,1497.759189605713,57296,10159,47137,47137,0,12,9003000.0
9003,9003999,21.439019279113076,38.093631434082624,0.07531803649441293,1764.831779718399,613.3837296962738,1497.7898902893066,57302,10162,47140,47140,0,12,9004000.0
9004,9004999,21.441039895859785,38.09680085331229,0.07534715703621231,1765.1227078437805,613.4504692554474,1497.9476585388184,57304,10163,47141,47141,0,12,9005000.0
9005,9005999,21.44262815266172,38.0987050943708,0.07538370841708908,1765.2413713932037,613.5143413543701,1498.0688972473145,57304,10163,47141,47141,0,12,9006000.0
9006,9006999,21.44427308625368,38.100963736259686,0.07542357844999559,1765.509572505951,613.5772180557251,1498.135871887207,57306,10164,47142,47142,0,12,9007000.0
9007,9007999,21.445103365623787,38.1024641984389,0.07543967069656887,1765.9134526252747,613.6405143737793,1498.435188293457,57318,10166,47152,47152,0,12,9008000.0
9008,9008999,21.444368888215738,38.10118796282919,0.07543759209944279,1766.0352456569672,613.70454621315,1498.986759185791,57321,10166,47155,47155,0,12,9009000.0
9009,9009999,21.443793007307512,38.10024813888977,0.0754340700552103,1766.2923560142517,613.7686216831207,1499.2091789245605,57326,10167,47159,47159,0,12,9010000.0
9010,9010999,21.443466377238476,38.099789686611615,0.07542763712113143,1766.5658435821533,613.8339219093323,1499.4732208251953,57330,10168,47162,47162,0,12,9011000.0
9011,9011999,21.443264067076793,38.10022735992965,0.07541927809185922,1766.8206272125244,613.8981747627258,1499.629768371582,57340,10169,47171,47171,0,12,9012000.0
9012,9012999,21.442965426166282,38.09961202739024,0.07540910267370304,1767.0789704322815,613.9627714157104,1499.840560913086,57352,10170,47182,47182,0,12,9013000.0
9013,9013999,21.442583633814184,38.098631618830176,0.07540478206356893,1767.6238896846771,614.0292673110962,1499.7501907348633,57361,10173,47188,47188,0,12,9014000.0
9014,9014999,21.442421856322884,38.098171400472516,0.07539379383372413,1767.9094169139862,614.0999147891998,1499.9194450378418,57365,10174,47191,47191,0,12,9015000.0
9015,9015999,21.442598508811717,38.100140415850056,0.07537514719229255,1768.1670570373535,614.1659774780273,1500.0389556884766,57368,10175,47193,47193,0,12,9016000.0
9016,9016999,21.442872322106588,38.100771637956115,0.07536547992752995,1768.569305896759,614.2319812774658,1500.181541442871,57383,10177,47206,47206,0,12,9017000.0
9017,9017999,21.443339633756487,38.10158631401821,0.0753594079955,1768.833764076233,614.2967898845673,1500.4264945983887,57387,10178,47209,47209,0,12,9018000.0
9018,9018999,21.44394672422279,38.10222978832619,0.07535644500196792,1768.965722322464,614.3607103824615,1500.6599731445312,57387,10178,47209,47209,0,12,9019000.0
9019,9019999,21.444664944331414,38.103657704532374,0.07535456812576558,1769.5078601837158,614.426516532898,1500.6176109313965,57405,10181,47224,47224,0,12,9020000.0
9020,9020999,21.445414453739673,38.104510152339735,0.0753532056277767,1769.774343252182,614.4932327270508,1500.663730621338,57408,10182,47226,47226,0,12,9021000.0
9021,9021999,21.446109976979248,38.10555450751959,0.07535763370920556,1770.1772077083588,614.5578200817108,1500.70458984375,57423,10184,47239,47239,0,12,9022000.0
9022,9022999,21.446999031691025,38.10676943371441,0.07537217354463088,1770.7239780426025,614.6228868961334,1500.6396141052246,57436,10187,47249,47249,0,12,9023000.0
9023,9023999,21.448198376390458,38.10938104773881,0.07537022656608872,1770.9918785095215,614.6874761581421,1500.8920936584473,57439,10188,47251,47251,0,12,9024000.0
9024,9024999,21.449444292812476,38.11080611631679,0.07538119352120742,1771.3770821094513,614.7501275539398,1500.9402770996094,57444,10190,47254,47254,0,12,9025000.0
9025,9025999,21.450590825132583,38.11240689413019,0.07540157828278549,1771.793529033661,614.815450668335,1501.0123672485352,57448,10192,47256,47256,0,12,9026000.0
9026,9026999,21.45141099081687,38.11293329714751,0.07540949862507473,1772.049326658249,614.8793182373047,1501.1201286315918,57450,10193,47257,47257,0,12,9027000.0
9027,9027999,21.451573322005896,38.11276445919174,0.07540205652469056,1772.460268497467,614.9431943893433,1501.434097290039,57459,10195,47264,47264,0,12,9028000.0
9028,9028999,21.45109502916503,38.11173846930093,0.07539692903968065,1772.5765829086304,615.0086324214935,1501.6452331542969,57459,10195,47264,47264,0,12,9029000.0
9029,9029999,21.450613821896454,38.11056493421039,0.07539322318913566,1772.701623916626,615.0755884647369,1501.8177528381348,57460,10195,47265,47265,0,12,9030000.0
9030,9030999,21.450167616626796,38.10980366681366,0.0753899515446198,1773.2418367862701,615.1396749019623,1501.828800201416,57484,10198,47286,47286,0,12,9031000.0
9031,9031999,21.44969399544782,38.10871306141185,0.07538559178749671,1773.5179183483124,615.2053809165955,1501.9826393127441,57496,10199,47297,47297,0,12,9032000.0
9032,9032999,21.4491901247707,38.10744972079035,0.07538169066064393,1773.7888054847717,615.2693672180176,1502.134853363037,57505,10200,47305,47305,0,12,9033000.0
9033,9033999,21.448928163600442,38.10647111762529,0.07537599120709548,1773.910787820816,615.3328094482422,1502.2556838989258,57505,10200,47305,47305,0,12,9034000.0
9034,9034999,21.44842380364306,38.10514971480654,0.07537141426917737,1774.1784536838531,615.3983449935913,1502.2599563598633,57517,10201,47316,47316,0,12,9035000.0
9035,9035999,21.448061689967073,38.10576351142645,0.07536208395086941,1774.4391429424286,615.4629230499268,1502.2689208984375,57526,10202,47324,47324,0,12,9036000.0
9036,9036999,21.44773831168047,38.105028592807685,0.07535763489491276,1774.5782461166382,615.529748916626,1502.404842376709,57526,10202,47324,47324,0,12,9037000.0
9037,9037999,21.44744275562133,38.10401786107347,0.07535544645659398,1774.7049338817596,615.5949902534485,1502.6288261413574,57526,10202,47324,47324,0,12,9038000.0
9038,9038999,21.447264653641565,38.10314281387804,0.07534719062215256,1775.1055443286896,615.6610374450684,1502.7059783935547,57537,10204,47333,47333,0,12,9039000.0
9039,9039999,21.447090216421422,38.10238598477456,0.07534151618247464,1775.2192242145538,615.7265119552612,1502.8437767028809,57537,10204,47333,47333,0,12,9040000.0
9040,9040999,21.446783438574812,38.101300998775,0.07533605286489209,1775.499847650528,615.7951519489288,1502.9038429260254,57540,10205,47335,47335,0,12,9041000.0
9041,9041999,21.44652018280246,38.10036835138634,0.07533341637806334,1775.7636544704437,615.8603022098541,1502.991298675537,57547,10206,47341,47341,0,12,9042000.0
9042,9042999,21.44647171907768,38.09975177298299,0.07532732865129332,1775.8880786895752,615.9249210357666,1503.0837783813477,57547,10206,47341,47341,0,12,9043000.0
9043,9043999,21.44653378665398,38.09903009526632,0.07531011301400259,1776.3134710788727,615.9949285984039,1503.1807250976562,57562,10208,47354,47354,0,12,9044000.0
9044,9044999,21.446689811711273,38.098266552720084,0.07529357878372145,1776.4418234825134,616.0582637786865,1503.2973289489746,57562,10208,47354,47354,0,12,9045000.0
9045,9045999,21.44669856412561,38.09726302282328,0.07528118403333484,1776.7097432613373,616.1217408180237,1503.3204612731934,57573,10209,47364,47364,0,12,9046000.0
9046,9046999,21.446617239653477,38.09645206055821,0.07527033399983507,1776.9824404716492,616.1950736045837,1503.3506660461426,57576,10210,47366,47366,0,12,9047000.0
9047,9047999,21.446274370953716,38.095305886581954,0.07526505325089317,1777.2447628974915,616.259850025177,1503.6012573242188,57585,10211,47374,47374,0,12,9048000.0
9048,9048999,21.445520104821906,38.09444187504805,0.07526476645164315,1777.5085458755493,616.3257508277893,1503.7907600402832,57588,10212,47376,47376,0,12,9049000.0
9049,9049999,21.444739710055018,38.09332418707973,0.07526283952002089,1777.9122273921967,616.3915729522705,1503.8932151794434,57611,10214,47397,47397,0,12,9050000.0
9050,9050999,21.444050103385827,38.0925880885926,0.07526129982254426,1778.0347681045532,616.4591865539551,1504.0491828918457,57611,10214,47397,47397,0,12,9051000.0
9051,9051999,21.443529274956195,38.09192269188109,0.07525720129182523,1778.439855337143,616.5253608226776,1504.1154327392578,57625,10216,47409,47409,0,12,9052000.0
9052,9052999,21.443057570400658,38.091301699981926,0.07524939353977467,1778.701355934143,616.5910048484802,1504.4075508117676,57637,10217,47420,47420,0,12,9053000.0
9053,9053999,21.44262687098153,38.09023897157159,0.07524576752805268,1778.8240411281586,616.6536998748779,1504.550666809082,57637,10217,47420,47420,0,12,9054000.0
9054,9054999,21.442163522229365,38.089004509086074,0.07524081717844955,1778.9529628753662,616.7188768386841,1504.6596374511719,57637,10217,47420,47420,0,12,9055000.0
9055,9055999,21.441831253928484,38.088274142773905,0.0752368021951988,1779.0806713104248,616.7873048782349,1504.7433547973633,57637,10217,47420,47420,0,12,9056000.0
9056,9056999,21.441415515044902,38.08720225514073,0.07523569857554635,1779.3431298732758,616.8519377708435,1504.775707244873,57640,10218,47422,47422,0,12,9057000.0
9057,9057999,21.441077953222276,38.086266030976894,0.0752315362659246,1779.468296289444,616.9169085025787,1504.8694381713867,57640,10218,47422,47422,0,12,9058000.0
9058,9058999,21.440954970685933,38.08553119602284,0.07522057523922865,1779.756008863449,616.9829280376434,1505.2342262268066,57644,10219,47425,47425,0,12,9059000.0
9059,9059999,21.4410476271535,38.085096212520526,0.07521032858194032,1779.8817229270935,617.0504615306854,1505.3874320983887,57644,10219,47425,47425,0,12,9060000.0
9060,9060999,21.440929351652695,38.08436321064452,0.0752044652924595,1780.0039529800415,617.1157963275909,1505.4836730957031,57644,10219,47425,47425,0,12,9061000.0
9061,9061999,21.44097235682524,38.08419900183825,0.07519453791879915,1780.1365962028503,617.1804459095001,1505.587501525879,57644,10219,47425,47425,0,12,9062000.0
9062,9062999,21.441088459511956,38.083880487605704,0.0751898216604705,1780.2508263587952,617.2442820072174,1505.6820602416992,57644,10219,47425,47425,0,12,9063000.0
9063,9063999,21.441353027363657,38.08370991277553,0.07518494643414353,1780.3801898956299,617.3120725154877,1505.811378479004,57644,10219,47425,47425,0,12,9064000.0
9064,9064999,21.4417051957161,38.0834902561801,0.07517563279937844,1780.6457214355469,617.3763630390167,1505.8261795043945,57656,10220,47436,47436,0,12,9065000.0
9065,9065999,21.442110873590803,38.083285987402995,0.07516724128322683,1780.7746014595032,617.4404859542847,1505.8837776184082,57656,10220,47436,47436,0,12,9066000.0
9066,9066999,21.442401162698168,38.08287430472377,0.07516321325839137,1780.9001169204712,617.5059862136841,1505.9254837036133,57656,10220,47436,47436,0,12,9067000.0
9067,9067999,21.442815706737726,38.082672473068286,0.07515807569928123,1781.027338027954,617.5692374706268,1505.9719543457031,57656,10220,47436,47436,0,12,9068000.0
9068,9068999,21.442303234940205,38.081563656267484,0.07515423158295154,1781.4472358226776,617.6352910995483,1506.4393157958984,57663,10222,47441,47441,0,12,9069000.0
9069,9069999,21.44195714925339,38.08239709483839,0.07513903105212827,1781.6997375488281,617.6996238231659,1506.7088584899902,57666,10223,47443,47443,0,12,9070000.0
9070,9070999,21.442033037263435,38.085115087251424,0.07512395770703983,1781.9670345783234,617.7655394077301,1506.841106414795,57678,10224,47454,47454,0,12,9071000.0
9071,9071999,21.441740816226172,38.0843484751684,0.07511659098224566,1782.2160682678223,617.8300087451935,1506.9406356811523,57680,10225,47455,47455,0,12,9072000.0
9072,9072999,21.441866905095306,38.084166112890436,0.07510929404107536,1782.4788596630096,617.8959732055664,1507.1949157714844,57692,10226,47466,47466,0,12,9073000.0
9073,9073999,21.442261130406706,38.084846898190634,0.07510228359221593,1782.7502400875092,617.964836359024,1507.3406829833984,57694,10227,47467,47467,0,12,9074000.0
9074,9074999,21.442935545846172,38.08574213159907,0.07509554912683802,1783.016501903534,618.0302560329437,1507.4378204345703,57696,10228,47468,47468,0,12,9075000.0
9075,9075999,21.443792083587642,38.087031536591695,0.07510479459505626,1783.1435170173645,618.0945899486542,1507.588623046875,57696,10228,47468,47468,0,12,9076000.0
9076,9076999,21.444835464238825,38.08888922451823,0.07511747735510288,1783.294706106186,618.1710546016693,1507.7129287719727,57696,10228,47468,47468,0,12,9077000.0
9077,9077999,21.446400911892702,38.0922516902993,0.0751403190687947,1783.8143274784088,618.236025094986,1507.7556037902832,57712,10231,47481,47481,0,12,9078000.0
9078,9078999,21.447750992181117,38.094462431525656,0.07515216440799843,1784.0692110061646,618.3006861209869,1508.0881805419922,57717,10232,47485,47485,0,12,9079000.0
9079,9079999,21.449970520547957,38.100046944482635,0.07517196438349782,1784.3252205848694,618.364629983902,1508.2044868469238,57721,10233,47488,47488,0,12,9080000.0
9080,9080999,21.451835723144537,38.103615008622455,0.07519745015668855,1784.4505333900452,618.428462266922,1508.3246040344238,57721,10233,47488,47488,0,12,9081000.0
9081,9081999,21.454105211470644,38.10843220044779,0.07523829101449886,1784.5734667778015,618.4954915046692,1508.419532775879,57721,10233,47488,47488,0,12,9082000.0
9082,9082999,21.45684432165409,38.11759330727223,0.07526642582017506,1784.7101211547852,618.5607059001923,1508.5226402282715,57721,10233,47488,47488,0,12,9083000.0
9083,9083999,21.45923765803292,38.12242631728439,0.07532338114849257,1784.830182313919,618.6245296001434,1508.691062927246,57721,10233,47488,47488,0,12,9084000.0
9084,9084999,21.461527137797148,38.12651808198955,0.07535709092581722,1785.0906081199646,618.6892826557159,1508.9250831604004,57733,10234,47499,47499,0,12,9085000.0
9085,9085999,21.464084979803886,38.13176605143142,0.07539262933959123,1785.2250447273254,618.7562181949615,1509.0509490966797,57733,10234,47499,47499,0,12,9086000.0
9086,9086999,21.466197601847895,38.13519915785188,0.07543915159981474,1785.6084699630737,618.821028470993,1509.1321983337402,57737,10236,47501,47501,0,12,9087000.0
9087,9087999,21.468206129661052,38.13922852700429,0.07545901746366346,1786.124193906784,618.8858363628387,1509.137523651123,57760,10239,47521,47521,0,12,9088000.0
9088,9088999,21.468258110789286,38.14002658725195,0.07545213126265204,1786.3813245296478,618.9499297142029,1509.550926208496,57766,10240,47526,47526,0,12,9089000.0
9089,9089999,21.46770845408076,38.13932122253821,0.0754506086781962,1786.6267561912537,619.017037153244,1509.7875900268555,57768,10241,47527,47527,0,12,9090000.0
9090,9090999,21.46743461439582,38.13942475123309,0.07544368942095003,1786.88822889328,619.0837695598602,1509.9492988586426,57770,10242,47528,47528,0,12,9091000.0
9091,9091999,21.467036752424004,38.13883264984998,0.07543786889511361,1787.1527862548828,619.150463104248,1510.017375946045,57777,10243,47534,47534,0,12,9092000.0
9092,9092999,21.46674332478356,38.13819253665118,0.07543221786693488,1787.5376198291779,619.216470003128,1510.2199249267578,57791,10245,47546,47546,0,12,9093000.0
9093,9093999,21.466528536076165,38.1379351055305,0.07542537432438112,1787.6686515808105,619.2808525562286,1510.3959770202637,57791,10245,47546,47546,0,12,9094000.0
9094,9094999,21.466354427779198,38.13744915828928,0.07541774480564079,1788.1848587989807,619.3456568717957,1510.4929275512695,57801,10248,47553,47553,0,12,9095000.0
9095,9095999,21.46629356726098,38.139087584452575,0.07540446812706203,1788.5855243206024,619.4130263328552,1510.5959587097168,57815,10250,47565,47565,0,12,9096000.0
9096,9096999,21.465914733175076,38.13809213634,0.07540107871123869,1788.9875435829163,619.4787254333496,1510.6698989868164,57831,10252,47579,47579,0,12,9097000.0
9097,9097999,21.46600934645622,38.13754668139389,0.07539225955270179,1789.395491361618,619.5484652519226,1511.04443359375,57843,10254,47589,47589,0,12,9098000.0
9098,9098999,21.466210472485418,38.13736506837763,0.0753782709013473,1789.5103449821472,619.6127882003784,1511.2940254211426,57843,10254,47589,47589,0,12,9099000.0
9099,9099999,21.466483145655744,38.13738364750642,0.0753719110170542,1789.6294696331024,619.677627325058,1511.4387130737305,57843,10254,47589,47589,0,12,9100000.0
9100,9100999,21.466753264799006,38.13733181934658,0.07536370202739895,1789.7668511867523,619.7450454235077,1511.5697059631348,57843,10254,47589,47589,0,12,9101000.0
9101,9101999,21.467157190415968,38.13734924961122,0.07535786101081887,1790.023401260376,619.8112778663635,1511.6614952087402,57856,10255,47601,47601,0,12,9102000.0
9102,9102999,21.46784539438387,38.137598057572475,0.07534154817110383,1790.1444337368011,619.8770935535431,1511.9046363830566,57856,10255,47601,47601,0,12,9103000.0
9103,9103999,21.468191856295682,38.137304711160795,0.07533296657191291,1790.257934331894,619.9412441253662,1512.0471458435059,57856,10255,47601,47601,0,12,9104000.0
9104,9104999,21.4684252003104,38.13684585970789,0.0753220431858973,1790.3743329048157,620.0044133663177,1512.141487121582,57856,10255,47601,47601,0,12,9105000.0
9105,9105999,21.467870882662872,38.13600871401495,0.07532017964404925,1790.501767873764,620.0694491863251,1512.6382369995117,57857,10255,47602,47602,0,12,9106000.0
9106,9106999,21.46734900941684,38.13535086755609,0.07531604335932995,1790.7549302577972,620.135547876358,1512.8514289855957,57863,10256,47607,47607,0,12,9107000.0
9107,9107999,21.46674212442277,38.134384131151734,0.07531541446351442,1790.8779735565186,620.1998655796051,1513.0891494750977,57864,10256,47608,47608,0,12,9108000.0
9108,9108999,21.466297872019357,38.133992364535764,0.0753085222906823,1791.2612771987915,620.2646193504333,1513.3502006530762,57873,10258,47615,47615,0,12,9109000.0
9109,9109999,21.465993708978733,38.13328360730226,0.07530173045182653,1791.3856728076935,620.3337693214417,1513.537124633789,57873,10258,47615,47615,0,12,9110000.0
9110,9110999,21.465812976520304,38.13254678716156,0.07529493413837307,1791.5084788799286,620.3974931240082,1513.688591003418,57873,10258,47615,47615,0,12,9111000.0
9111,9111999,21.46564586132551,38.131757324376345,0.07528873750128229,1791.6337230205536,620.461220741272,1513.7896423339844,57873,10258,47615,47615,0,12,9112000.0
9112,9112999,21.465623134613434,38.13135351226176,0.07528134452790258,1791.7503733634949,620.5246138572693,1513.8914413452148,57873,10258,47615,47615,0,12,9113000.0
9113,9113999,21.46568075700623,38.13100953319592,0.07527511752698701,1792.0280892848969,620.5957503318787,1514.0060005187988,57879,10259,47620,47620,0,12,9114000.0
9114,9114999,21.465769515047192,38.13068852477422,0.07526673214905377,1792.1543736457825,620.6631336212158,1514.2435684204102,57879,10259,47620,47620,0,12,9115000.0
9115,9115999,21.466105261185533,38.130446691709615,0.07525249065862483,1792.4086363315582,620.7270519733429,1514.3454475402832,57881,10260,47621,47621,0,12,9116000.0
9116,9116999,21.466644203651146,38.130750398349015,0.07524342119070782,1792.5383644104004,620.793294429779,1514.4735260009766,57881,10260,47621,47621,0,12,9117000.0
9117,9117999,21.46717431521599,38.130791047717516,0.07523685119133072,1792.7941892147064,620.8579142093658,1514.5421981811523,57883,10261,47622,47622,0,12,9118000.0
9118,9118999,21.467790108106385,38.13127998449386,0.07523328236766913,1793.049064397812,620.9220671653748,1514.6128196716309,57895,10262,47633,47633,0,12,9119000.0
9119,9119999,21.468209131064555,38.13122753245072,0.0752324068941298,1793.18945646286,620.989364862442,1514.6864013671875,57895,10262,47633,47633,0,12,9120000.0
9120,9120999,21.46906938730082,38.13182986468613,0.07522699354475604,1793.3093523979187,621.0528876781464,1514.8523406982422,57895,10262,47633,47633,0,12,9121000.0
9121,9121999,21.469986684849296,38.13233994753151,0.07522069495202766,1793.438215970993,621.1178729534149,1514.9450874328613,57895,10262,47633,47633,0,12,9122000.0
9122,9122999,21.470742356161164,38.13275210555322,0.07522205878953092,1793.695328950882,621.1828036308289,1514.9805908203125,57897,10263,47634,47634,0,12,9123000.0
9123,9123999,21.47118732841813,38.132607253046366,0.0752262458205264,1793.9516003131866,621.2467880249023,1515.0003929138184,57909,10264,47645,47645,0,12,9124000.0
9124,9124999,21.471055643068393,38.13206167323606,0.07522220900136045,1794.2188262939453,621.3115837574005,1515.483139038086,57913,10265,47648,47648,0,12,9125000.0
9125,9125999,21.470178165281823,38.13064109092985,0.07522421984584071,1794.469164133072,621.3759765625,1515.7873001098633,57916,10266,47650,47650,0,12,9126000.0
9126,9126999,21.469351420455865,38.129282633277676,0.0752263245592425,1794.5864417552948,621.4421129226685,1516.0489807128906,57917,10266,47651,47651,0,12,9127000.0
9127,9127999,21.468715607721887,38.12843309489221,0.07522243999608869,1794.837035894394,621.5090568065643,1516.2376976013184,57929,10267,47662,47662,0,12,9128000.0
9128,9128999,21.468078390337766,38.127495277391475,0.07521825128345838,1794.9584052562714,621.5716316699982,1516.3919486999512,57929,10267,47662,47662,0,12,9129000.0
9129,9129999,21.46744647128974,38.12624161740039,0.07521401880614487,1795.0796239376068,621.6352326869965,1516.645450592041,57930,10267,47663,47663,0,12,9130000.0
9130,9130999,21.466832809426297,38.125049832930884,0.07521142141960158,1795.1974070072174,621.6973011493683,1516.7680015563965,57930,10267,47663,47663,0,12,9131000.0
9131,9131999,21.466174645989202,38.12382518349207,0.07520752891139892,1795.3194677829742,621.7595415115356,1516.8677940368652,57930,10267,47663,47663,0,12,9132000.0
9132,9132999,21.465585697806926,38.12280262673962,0.07520366332848705,1795.5999386310577,621.8272812366486,1516.9473915100098,57964,10268,47696,47696,0,12,9133000.0
9133,9133999,21.465202742288238,38.121988103458726,0.0751979636882455,1795.9898419380188,621.8916392326355,1517.1438789367676,57979,10270,47709,47709,0,12,9134000.0
9134,9134999,21.464860016418474,38.12108175834858,0.07518835090500864,1796.1146712303162,621.9555063247681,1517.437385559082,57979,10270,47709,47709,0,12,9135000.0
9135,9135999,21.464344477989368,38.119819905377405,0.07518285203274722,1796.3779180049896,622.0212461948395,1517.5349235534668,57984,10271,47713,47713,0,12,9136000.0
9136,9136999,21.46386723678697,38.11900474356436,0.07517652182731305,1796.4978914260864,622.086674451828,1517.644931793213,57984,10271,47713,47713,0,12,9137000.0
9137,9137999,21.46366804375028,38.118473483826904,0.07516925580013234,1796.9069063663483,622.1537177562714,1517.6706237792969,57995,10273,47722,47722,0,12,9138000.0
9138,9138999,21.46340297629533,38.11769520312421,0.07516354168939077,1797.3090462684631,622.2196474075317,1517.7590980529785,58010,10275,47735,47735,0,12,9139000.0
9139,9139999,21.463163367820904,38.116895833696596,0.07515579430062824,1797.4276161193848,622.2831823825836,1517.9074974060059,58010,10275,47735,47735,0,12,9140000.0
9140,9140999,21.463066232565925,38.116208302941985,0.07514198022069607,1797.6877100467682,622.3471593856812,1518.0505752563477,58012,10276,47736,47736,0,12,9141000.0
9141,9141999,21.46303707292351,38.11546040361076,0.07512491538056632,1797.7978374958038,622.4114472866058,1518.1781768798828,58012,10276,47736,47736,0,12,9142000.0
9142,9142999,21.462751744691378,38.11439065756077,0.075118383516807,1798.0408823490143,622.4728059768677,1518.234001159668,58014,10277,47737,47737,0,12,9143000.0
9143,9143999,21.46242308113719,38.1136469781899,0.07510876944571576,1798.300038099289,622.5366427898407,1518.3205299377441,58016,10278,47738,47738,0,12,9144000.0
9144,9144999,21.461964951053496,38.11248849825378,0.07510654559466379,1798.4469423294067,622.6019630432129,1518.5959968566895,58018,10278,47740,47740,0,12,9145000.0
9145,9145999,21.46088326285533,38.111218674714756,0.07511064007298063,1798.5630962848663,622.6668276786804,1518.9409446716309,58018,10278,47740,47740,0,12,9146000.0
9146,9146999,21.459852884409255,38.10984166259036,0.07511392413349716,1798.810494184494,622.7310712337494,1519.1239318847656,58021,10279,47742,47742,0,12,9147000.0
9147,9147999,21.45895366864891,38.108771457342286,0.07511333202114634,1798.9353821277618,622.7961437702179,1519.3444480895996,58022,10279,47743,47743,0,12,9148000.0
9148,9148999,21.458119937505764,38.10791992502306,0.07511182053307863,1799.0563004016876,622.8604092597961,1519.4493217468262,58022,10279,47743,47743,0,12,9149000.0
9149,9149999,21.457325023147895,38.10654218048744,0.07511190106040444,1799.313243150711,622.9271655082703,1519.578010559082,58024,10280,47744,47744,0,12,9150000.0
9150,9150999,21.45658048941914,38.10520827530531,0.07511156709835254,1799.7232401371002,622.992723941803,1519.707878112793,58040,10282,47758,47758,0,12,9151000.0
9151,9151999,21.455830237608073,38.10418953759129,0.07511103307035372,1799.9775898456573,623.0569000244141,1519.8072509765625,58044,10283,47761,47761,0,12,9152000.0
9152,9152999,21.45514294579607,38.10314074697992,0.07510794067775173,1800.2318062782288,623.1207883358002,1519.8608169555664,58049,10284,47765,47765,0,12,9153000.0
9153,9153999,21.454468020386756,38.10193646641619,0.07510744235845679,1800.3531374931335,623.1848249435425,1520.0155334472656,58049,10284,47765,47765,0,12,9154000.0
9154,9154999,21.45380813894903,38.100589651723055,0.0751080507404085,1800.6254467964172,623.253536939621,1520.162223815918,58061,10285,47776,47776,0,12,9155000.0
9155,9155999,21.453202888309495,38.09933692232598,0.07510482252843276,1801.2757999897003,623.3185381889343,1520.1700744628906,58092,10289,47803,47803,0,12,9156000.0
9156,9156999,21.45268169720147,38.098220683298976,0.07510343014077014,1801.3900537490845,623.3826789855957,1520.3892555236816,58092,10289,47803,47803,0,12,9157000.0
9157,9157999,21.452377658655468,38.09762586399602,0.07510240419992331,1801.6567401885986,623.4497938156128,1520.4977264404297,58094,10290,47804,47804,0,12,9158000.0
9158,9158999,21.45210126448241,38.0969474469303,0.07509979027740543,1801.7763621807098,623.5147089958191,1520.65376663208,58094,10290,47804,47804,0,12,9159000.0
9159,9159999,21.451888275422647,38.09649322083485,0.07510033253099091,1801.9023447036743,623.5814578533173,1520.7814407348633,58094,10290,47804,47804,0,12,9160000.0
9160,9160999,21.451895149153113,38.09667047450973,0.07510066123381764,1802.0299575328827,623.6455633640289,1521.0126647949219,58094,10290,47804,47804,0,12,9161000.0
9161,9161999,21.45204597096536,38.09734053986572,0.07511322333323622,1802.5330662727356,623.7100419998169,1521.023639678955,58100,10293,47807,47807,0,12,9162000.0
9162,9162999,21.452243338593718,38.09826509264772,0.07512093609656545,1802.647554397583,623.7742190361023,1521.165225982666,58100,10293,47807,47807,0,12,9163000.0
9163,9163999,21.45231722172366,38.098455634665775,0.07512179965868426,1802.778615474701,623.8379657268524,1521.242416381836,58100,10293,47807,47807,0,12,9164000.0
9164,9164999,21.451420031882332,38.09699501664572,0.07512797191699605,1802.9034886360168,623.9016220569611,1521.5587348937988,58100,10293,47807,47807,0,12,9165000.0
9165,9165999,21.45060593447567,38.096861541421916,0.07512530105847981,1803.1665389537811,623.966805934906,1521.6142463684082,58104,10294,47810,47810,0,12,9166000.0
9166,9166999,21.449808165437705,38.095930192045074,0.07512761969459891,1803.2878501415253,624.0310246944427,1521.7710990905762,58104,10294,47810,47810,0,12,9167000.0
9167,9167999,21.44897682266848,38.09477363566108,0.07512740216372782,1803.694652080536,624.0952527523041,1521.8333320617676,58114,10296,47818,47818,0,12,9168000.0
9168,9168999,21.44825309435137,38.093897146386865,0.07512552250667726,1804.1027143001556,624.1606631278992,1521.963737487793,58126,10298,47828,47828,0,12,9169000.0
9169,9169999,21.447456268726967,38.09276542443335,0.07512602243096178,1804.2185862064362,624.2246098518372,1522.169288635254,58126,10298,47828,47828,0,12,9170000.0
9170,9170999,21.446665467130778,38.091446703736274,0.0751271406744739,1804.4705166816711,624.2890210151672,1522.2934112548828,58133,10299,47834,47834,0,12,9171000.0
9171,9171999,21.44589682786595,38.09015128075442,0.0751277195811596,1804.6029181480408,624.3533532619476,1522.4101867675781,58133,10299,47834,47834,0,12,9172000.0
9172,9172999,21.445318595674102,38.08930733450213,0.0751252519325667,1804.7302985191345,624.4169812202454,1522.565860748291,58133,10299,47834,47834,0,12,9173000.0
9173,9173999,21.44468973322514,38.08809570954006,0.07512516010441161,1804.8514704704285,624.481582403183,1522.751621246338,58133,10299,47834,47834,0,12,9174000.0
9174,9174999,21.444178367398166,38.08741299504525,0.07512371125531936,1804.9660155773163,624.5454001426697,1522.9011611938477,58133,10299,47834,47834,0,12,9175000.0
9175,9175999,21.443634712010176,38.086341929568235,0.07512264897220366,1805.0998849868774,624.6091969013214,1523.0064506530762,58133,10299,47834,47834,0,12,9176000.0
9176,9176999,21.443336802563152,38.08583117063691,0.0751179723319424,1805.2309267520905,624.6732976436615,1523.1008033752441,58133,10299,47834,47834,0,12,9177000.0
9177,9177999,21.442973558773684,38.0850369277919,0.07511495234306942,1805.3593175411224,624.7384407520294,1523.1892585754395,58133,10299,47834,47834,0,12,9178000.0
9178,9178999,21.442948854333554,38.085108189382,0.07510972810314587,1805.4850430488586,624.8022992610931,1523.2504959106445,58133,10299,47834,47834,0,12,9179000.0
9179,9179999,21.44291684038026,38.08490285287397,0.07510385975986644,1805.6118831634521,624.8662066459656,1523.3709411621094,58133,10299,47834,47834,0,12,9180000.0
9180,9180999,21.443216720627834,38.08658254511679,0.07509376088167063,1805.7309119701385,624.9299201965332,1523.4312362670898,58133,10299,47834,47834,0,12,9181000.0
9181,9181999,21.443165908690588,38.086358511032586,0.07508981015002847,1805.998006105423,624.9934747219086,1523.4483833312988,58135,10300,47835,47835,0,12,9182000.0
9182,9182999,21.443104696155924,38.08627044032124,0.07508507326990554,1806.2564487457275,625.0570421218872,1523.4828491210938,58137,10301,47836,47836,0,12,9183000.0
9183,9183999,21.44266723485429,38.085491563779975,0.07508744313664528,1806.5230350494385,625.1241631507874,1523.9060363769531,58140,10302,47838,47838,0,12,9184000.0
9184,9184999,21.442190162281808,38.085012923715205,0.07508834558764421,1806.908759355545,625.1901004314423,1524.0759468078613,58149,10304,47845,47845,0,12,9185000.0
9185,9185999,21.44203025819038,38.085591771098336,0.07508259759931368,1807.3092594146729,625.2583904266357,1524.1825942993164,58156,10306,47850,47850,0,12,9186000.0
9186,9186999,21.441872121168043,38.08571222736189,0.07507613543278069,1807.4278728961945,625.3239350318909,1524.3876647949219,58156,10306,47850,47850,0,12,9187000.0
9187,9187999,21.441641332647357,38.085081340014156,0.0750686631569013,1807.5497558116913,625.3897721767426,1524.6824264526367,58157,10306,47851,47851,0,12,9188000.0
9188,9188999,21.44143784234481,38.08460377857443,0.07506217541280058,1807.6777608394623,625.4563467502594,1524.8958015441895,58157,10306,47851,47851,0,12,9189000.0
9189,9189999,21.441636729391227,38.084839176691986,0.07505093305005872,1807.7931594848633,625.523031949997,1525.0500526428223,58157,10306,47851,47851,0,12,9190000.0
9190,9190999,21.44163585599041,38.08482617303225,0.07504662638058157,1807.9102778434753,625.5872738361359,1525.1562042236328,58157,10306,47851,47851,0,12,9191000.0
9191,9191999,21.442076722869825,38.08604838712894,0.07504520579127472,1808.02223610878,625.6521708965302,1525.2786827087402,58157,10306,47851,47851,0,12,9192000.0
9192,9192999,21.44247710645778,38.087153359365125,0.07503519987406992,1808.4111413955688,625.717705488205,1525.2899017333984,58171,10308,47863,47863,0,12,9193000.0
9193,9193999,21.443285502062334,38.08891723209469,0.07503413588883634,1808.7937111854553,625.7816917896271,1525.5600662231445,58186,10310,47876,47876,0,12,9194000.0
9194,9194999,21.444612753570297,38.10001619450844,0.07500764083858191,1809.0493307113647,625.8476831912994,1525.641731262207,58195,10311,47884,47884,0,12,9195000.0
9195,9195999,21.445302222383123,38.101207725556606,0.07500985816393502,1809.2981810569763,625.9125106334686,1525.7457313537598,58198,10312,47886,47886,0,12,9196000.0
9196,9196999,21.44646874179317,38.10362796071688,0.07502416739186457,1809.6780614852905,625.9779675006866,1525.786823272705,58205,10314,47891,47891,0,12,9197000.0
9197,9197999,21.447491054696442,38.10660208109341,0.07504408635300264,1809.7934374809265,626.0425796508789,1525.8942070007324,58205,10314,47891,47891,0,12,9198000.0
9198,9198999,21.44861490136066,38.10834267415188,0.07506471174030405,1810.0437514781952,626.1071457862854,1526.005214691162,58207,10315,47892,47892,0,12,9199000.0
9199,9199999,21.45074917494976,38.1144390824195,0.0750772108389477,1810.1679725646973,626.1712584495544,1526.0792503356934,58207,10315,47892,47892,0,12,9200000.0
9200,9200999,21.452260079179695,38.117409027074686,0.07509754151848447,1810.4248683452606,626.2353587150574,1526.1386947631836,58212,10316,47896,47896,0,12,9201000.0
9201,9201999,21.453646411408766,38.1196641545716,0.07511568534057922,1810.690911769867,626.298898935318,1526.222183227539,58220,10317,47903,47903,0,12,9202000.0
9202,9202999,21.45384488981521,38.11948548250104,0.07511857636550756,1810.8112931251526,626.3646910190582,1526.7129554748535,58224,10317,47907,47907,0,12,9203000.0
9203,9203999,21.453420098835583,38.11972804443388,0.07511106868674278,1810.924164533615,626.429370880127,1527.0205764770508,58224,10317,47907,47907,0,12,9204000.0
9204,9204999,21.45284924297053,38.119175376986654,0.0751080285526019,1811.0475370883942,626.4946701526642,1527.2168922424316,58224,10317,47907,47907,0,12,9205000.0
9205,9205999,21.45234120426524,38.11861409154862,0.07510513713089106,1811.4301135540009,626.561558008194,1527.3568992614746,58231,10319,47912,47912,0,12,9206000.0
9206,9206999,21.45204317115531,38.11811428133248,0.07509998227491899,1811.8123717308044,626.627283334732,1527.4995956420898,58236,10321,47915,47915,0,12,9207000.0
9207,9207999,21.45203487229647,38.11787944559991,0.07508522829238573,1812.070688009262,626.7028439044952,1527.7622756958008,58243,10322,47921,47921,0,12,9208000.0
9208,9208999,21.45197807880006,38.11737507047249,0.07507161507701299,1812.1891198158264,626.7670328617096,1527.9792747497559,58243,10322,47921,47921,0,12,9209000.0
9209,9209999,21.451891589046717,38.116950437380076,0.07506243548770919,1812.3097186088562,626.8314001560211,1528.1118087768555,58243,10322,47921,47921,0,12,9210000.0
9210,9210999,21.451879906395693,38.11696403001482,0.07505149959053681,1812.4354305267334,626.8975627422333,1528.248867034912,58245,10322,47923,47923,0,12,9211000.0
9211,9211999,21.45236093773267,38.1178725937122,0.07504130015443478,1812.5637483596802,626.9616158008575,1528.3689804077148,58245,10322,47923,47923,0,12,9212000.0
9212,9212999,21.45286384246694,38.11944204626477,0.07503160242609297,1812.8314073085785,627.039071559906,1528.619255065918,58257,10323,47934,47934,0,12,9213000.0
9213,9213999,21.453258009962134,38.11963412039883,0.07503119084770349,1813.21710562706,627.1059546470642,1528.741985321045,58261,10325,47936,47936,0,12,9214000.0
9214,9214999,21.453824267023908,38.120193808235456,0.0750226562127485,1813.3375685214996,627.1703791618347,1528.878704071045,58261,10325,47936,47936,0,12,9215000.0
9215,9215999,21.454317689371223,38.12044841506446,0.07502557764589024,1813.596428155899,627.2351112365723,1528.9420013427734,58263,10326,47937,47937,0,12,9216000.0
9216,9216999,21.455162704299376,38.121652961624804,0.07502872650279369,1813.7133979797363,627.2995352745056,1529.0887603759766,58263,10326,47937,47937,0,12,9217000.0
9217,9217999,21.456136436478438,38.12292635699759,0.07504442712380421,1813.8343262672424,627.3639209270477,1529.184684753418,58263,10326,47937,47937,0,12,9218000.0
9218,9218999,21.457641371547886,38.126911067399334,0.07503715636765151,1813.9563477039337,627.4303507804871,1529.4959526062012,58263,10326,47937,47937,0,12,9219000.0
9219,9219999,21.459022356576632,38.12934401625488,0.07505199406258933,1814.2080960273743,627.4938068389893,1529.6145248413086,58265,10327,47938,47938,0,12,9220000.0
9220,9220999,21.46068664215435,38.134016765236254,0.07506480677938387,1814.3242213726044,627.5570631027222,1529.7344398498535,58265,10327,47938,47938,0,12,9221000.0
9221,9221999,21.462083547575162,38.13566383315605,0.07508800672599347,1814.8473508358002,627.6224896907806,1529.7329559326172,58278,10330,47948,47948,0,12,9222000.0
9222,9222999,21.462315631989714,38.13659025393756,0.07508650936747308,1815.1031017303467,627.6859843730927,1530.1523094177246,58281,10331,47950,47950,0,12,9223000.0
9223,9223999,21.461695844451043,38.13545622896836,0.07507923064500432,1815.2219319343567,627.750086069107,1530.4195022583008,58281,10331,47950,47950,0,12,9224000.0
9224,9224999,21.461065217129367,38.13434877580615,0.07507630014566158,1815.340672492981,627.8148510456085,1530.6051750183105,58281,10331,47950,47950,0,12,9225000.0
9225,9225999,21.46053266365486,38.133726601314564,0.0750737755808446,1815.4560956954956,627.8799903392792,1530.729507446289,58281,10331,47950,47950,0,12,9226000.0
9226,9226999,21.460248389337206,38.13302353352781,0.07506074803435914,1815.8479144573212,627.9448499679565,1530.924633026123,58296,10333,47963,47963,0,12,9227000.0
9227,9227999,21.45989631269598,38.13198233661362,0.07505394590966985,1816.2320387363434,628.009610414505,1530.9623680114746,58310,10335,47975,47975,0,12,9228000.0
9228,9228999,21.459445482038003,38.130979038243865,0.07504487323870501,1816.4845643043518,628.0757756233215,1531.0278930664062,58312,10336,47976,47976,0,12,9229000.0
9229,9229999,21.459045846875924,38.13018217981871,0.07503962409918064,1816.7544448375702,628.1415767669678,1531.1369247436523,58318,10337,47981,47981,0,12,9230000.0
9230,9230999,21.458803693036366,38.12960143821452,0.07503248641117732,1817.0112526416779,628.2067430019379,1531.251693725586,58328,10338,47990,47990,0,12,9231000.0
9231,9231999,21.458734515358163,38.13034921876868,0.07501923967909574,1817.2753293514252,628.2752974033356,1531.4846267700195,58331,10339,47992,47992,0,12,9232000.0
9232,9232999,21.45888577580287,38.13037754094068,0.07500747332371804,1817.3916754722595,628.3402390480042,1531.671775817871,58331,10339,47992,47992,0,12,9233000.0
9233,9233999,21.45895668223369,38.13049959909775,0.07499469869190001,1817.5202639102936,628.404844045639,1531.7767944335938,58331,10339,47992,47992,0,12,9234000.0
9234,9234999,21.459073196278954,38.13026701266131,0.07498544573736254,1817.64648103714,628.4700043201447,1531.911849975586,58332,10339,47993,47993,0,12,9235000.0
9235,9235999,21.459108777728563,38.129885294126005,0.07497941994218438,1817.9030258655548,628.5345413684845,1531.964542388916,58344,10340,48004,48004,0,12,9236000.0
9236,9236999,21.45911675866359,38.12935099827963,0.07496357646646212,1818.0292258262634,628.6004917621613,1532.113338470459,58344,10340,48004,48004,0,12,9237000.0
9237,9237999,21.459010707788813,38.128779616246774,0.0749512215280691,1818.1523365974426,628.6655111312866,1532.179946899414,58344,10340,48004,48004,0,12,9238000.0
9238,9238999,21.458977982122615,38.12811534690445,0.07493570514270731,1818.276002407074,628.7317900657654,1532.2376899719238,58344,10340,48004,48004,0,12,9239000.0
9239,9239999,21.458258002061037,38.12779438128249,0.07493481558184467,1818.3953824043274,628.7995114326477,1532.809627532959,58344,10340,48004,48004,0,12,9240000.0
9240,9240999,21.457428407896558,38.12672008016384,0.07493641909180082,1818.5176241397858,628.8647201061249,1533.059726715088,58344,10340,48004,48004,0,12,9241000.0
9241,9241999,21.456817397552292,38.12687296647975,0.07493533109887784,1818.7701435089111,628.9307191371918,1533.229175567627,58347,10341,48006,48006,0,12,9242000.0
9242,9242999,21.455988740198205,38.125835836673886,0.07493634490556045,1818.8963296413422,628.9961080551147,1533.5663414001465,58348,10341,48007,48007,0,12,9243000.0
9243,9243999,21.45521409397629,38.124464981191316,0.07493876978562097,1819.0165240764618,629.061665058136,1533.783290863037,58348,10341,48007,48007,0,12,9244000.0
9244,9244999,21.454371416362743,38.12300077353345,0.07493942306448886,1819.1343593597412,629.1250381469727,1533.9501838684082,58348,10341,48007,48007,0,12,9245000.0
9245,9245999,21.453653609275044,38.12178646649374,0.07493838060223879,1819.3919970989227,629.1904747486115,1534.0438194274902,58350,10342,48008,48008,0,12,9246000.0
9246,9246999,21.45310744331486,38.12089818952068,0.07493621568269504,1819.655731678009,629.2565383911133,1534.1493911743164,58357,10343,48014,48014,0,12,9247000.0
9247,9247999,21.452565053202026,38.1200002478818,0.07493457227749856,1819.9045968055725,629.323028087616,1534.2577095031738,58370,10344,48026,48026,0,12,9248000.0
9248,9248999,21.452093020610533,38.11911223457759,0.07492900501126976,1820.0323655605316,629.3884747028351,1534.459846496582,58370,10344,48026,48026,0,12,9249000.0
9249,9249999,21.45181684686657,38.118310130637965,0.07492326979228359,1820.155152797699,629.4526400566101,1534.5643157958984,58370,10344,48026,48026,0,12,9250000.0
9250,9250999,21.4514989148258,38.117391015580374,0.07491852899568974,1820.2779421806335,629.5169789791107,1534.6910018920898,58370,10344,48026,48026,0,12,9251000.0
9251,9251999,21.451270384602324,38.11678805132549,0.07491342274490886,1820.4049379825592,629.5820343494415,1534.7644004821777,58370,10344,48026,48026,0,12,9252000.0
9252,9252999,21.451135458015845,38.117022639119455,0.07490537127643815,1820.792049407959,629.6467094421387,1534.8005104064941,58383,10346,48037,48037,0,12,9253000.0
9253,9253999,21.450924234753558,38.11624868114678,0.07489985120508469,1820.9184458255768,629.7113869190216,1534.8647575378418,58383,10346,48037,48037,0,12,9254000.0
9254,9254999,21.450848545435246,38.115524476413896,0.07488978629518506,1821.0468740463257,629.7771244049072,1534.9919357299805,58383,10346,48037,48037,0,12,9255000.0
9255,9255999,21.450856695215297,38.115559906796804,0.074879665429471,1821.2957384586334,629.8422617912292,1535.0404434204102,58385,10347,48038,48038,0,12,9256000.0
9256,9256999,21.45063442548755,38.11523378113538,0.07487169330835608,1821.4237351417542,629.907110452652,1535.1059799194336,58385,10347,48038,48038,0,12,9257000.0
9257,9257999,21.450419238431948,38.11437774419696,0.074867469086916,1821.5608382225037,629.9708416461945,1535.160026550293,58385,10347,48038,48038,0,12,9258000.0
9258,9258999,21.44977214468689,38.11356576641582,0.07486432461598758,1821.9667484760284,630.0421299934387,1535.3626861572266,58395,10349,48046,48046,0,12,9259000.0
9259,9259999,21.448832807098274,38.11205360918914,0.07486890482803366,1822.2173652648926,630.105299949646,1535.5855331420898,58397,10350,48047,48047,0,12,9260000.0
9260,9260999,21.447865722823177,38.11044501406658,0.07487377876790291,1822.3376643657684,630.1695685386658,1535.7284126281738,58397,10350,48047,48047,0,12,9261000.0
9261,9261999,21.44708167677831,38.10912653066761,0.07487617764907017,1822.7366423606873,630.2341182231903,1535.7223472595215,58408,10352,48056,48056,0,12,9262000.0
9262,9262999,21.446406814349814,38.107999589342846,0.07487790541491623,1822.8581602573395,630.2973620891571,1535.8689918518066,58408,10352,48056,48056,0,12,9263000.0
9263,9263999,21.44571687598989,38.106705557660334,0.07488147235172815,1822.978973865509,630.3626201152802,1536.109188079834,58408,10352,48056,48056,0,12,9264000.0
9264,9264999,21.445099282451555,38.10549125572853,0.07488324532917057,1823.1000392436981,630.4295620918274,1536.2657775878906,58408,10352,48056,48056,0,12,9265000.0
9265,9265999,21.444299766034714,38.10396441629327,0.07488661569165411,1823.6361861228943,630.4949672222137,1536.2659072875977,58416,10355,48061,48061,0,12,9266000.0
9266,9266999,21.44366893235594,38.103736607044674,0.07488382917455016,1823.743971824646,630.557932138443,1536.4192504882812,58416,10355,48061,48061,0,12,9267000.0
9267,9267999,21.443119431579902,38.10295327895964,0.07488259220536586,1823.8690490722656,630.6224682331085,1536.5712966918945,58417,10355,48062,48062,0,12,9268000.0
9268,9268999,21.442526419092086,38.102063062200784,0.0748815445920279,1823.9958839416504,630.6873936653137,1536.691993713379,58417,10355,48062,48062,0,12,9269000.0
9269,9269999,21.441911086773885,38.100721694201795,0.07488302089435606,1824.1119906902313,630.7506747245789,1536.8737678527832,58417,10355,48062,48062,0,12,9270000.0
9270,9270999,21.44148751343105,38.09999845868634,0.07488101851743323,1824.361205816269,630.8138513565063,1536.947395324707,58419,10356,48063,48063,0,12,9271000.0
9271,9271999,21.440938148856027,38.098965731277424,0.07487961918870545,1824.6365621089935,630.8776223659515,1537.0244102478027,58422,10357,48065,48065,0,12,9272000.0
9272,9272999,21.44048892294414,38.097889669542006,0.07487804131599118,1824.8997762203217,630.9433941841125,1537.1010704040527,58424,10358,48066,48066,0,12,9273000.0
9273,9273999,21.439993798467118,38.09670555804247,0.07487737921692605,1825.0057384967804,631.0061378479004,1537.198616027832,58424,10358,48066,48066,0,12,9274000.0
9274,9274999,21.43975644232058,38.09577353561993,0.07487362619802285,1825.258216381073,631.0707142353058,1537.2929382324219,58426,10359,48067,48067,0,12,9275000.0
9275,9275999,21.43967663567832,38.095935824545386,0.07486086788418322,1825.3884472846985,631.1444756984711,1537.406162261963,58426,10359,48067,48067,0,12,9276000.0
9276,9276999,21.43935205595586,38.09487915764759,0.07485626060193262,1825.5115065574646,631.2081415653229,1537.4674263000488,58426,10359,48067,48067,0,12,9277000.0
9277,9277999,21.438893518581022,38.09375942506024,0.07485302503296776,1825.7785987854004,631.2725803852081,1537.542781829834,58431,10360,48071,48071,0,12,9278000.0
9278,9278999,21.43837724582251,38.09311460124141,0.07484980666010033,1825.8988180160522,631.3353796005249,1537.674949645996,58431,10360,48071,48071,0,12,9279000.0
9279,9279999,21.437564252364155,38.09166415922196,0.07485502819186463,1826.0249161720276,631.4000339508057,1538.0512046813965,58432,10360,48072,48072,0,12,9280000.0
9280,9280999,21.43669449720559,38.09050249978523,0.074857755426608,1826.2750399112701,631.4645283222198,1538.1520538330078,58434,10361,48073,48073,0,12,9281000.0
9281,9281999,21.43582125016798,38.08901363112127,0.07485878857013206,1826.392390012741,631.5300023555756,1538.3067359924316,58434,10361,48073,48073,0,12,9282000.0
9282,9282999,21.434960741932414,38.08755769610371,0.07486273027424373,1826.6581211090088,631.5979797840118,1538.3887672424316,58438,10362,48076,48076,0,12,9283000.0
9283,9283999,21.43429487084781,38.086175239149476,0.07486226832561416,1827.0534660816193,631.6646325588226,1538.5209655761719,58442,10364,48078,48078,0,12,9284000.0
9284,9284999,21.43374830130649,38.08509766019654,0.074852563996199,1827.317787885666,631.7330310344696,1538.6702880859375,58445,10365,48080,48080,0,12,9285000.0
9285,9285999,21.433222522806812,38.08389732002189,0.07484476048311683,1827.5796344280243,631.7977757453918,1538.7708625793457,58447,10366,48081,48081,0,12,9286000.0
9286,9286999,21.432670616288693,38.08284454885172,0.07483946226682792,1827.7062287330627,631.8622679710388,1538.9023475646973,58447,10366,48081,48081,0,12,9287000.0
9287,9287999,21.43221464451758,38.081823336219834,0.07483079863537456,1827.8307814598083,631.9270112514496,1539.027416229248,58447,10366,48081,48081,0,12,9288000.0
9288,9288999,21.431969005933283,38.08236635821833,0.07481611579138936,1827.9502561092377,631.9934277534485,1539.100643157959,58447,10366,48081,48081,0,12,9289000.0
9289,9289999,21.43196844993137,38.08185839451375,0.0747942845981312,1828.0695374011993,632.0578470230103,1539.2841148376465,58447,10366,48081,48081,0,12,9290000.0
9290,9290999,21.43178809788986,38.08091708380732,0.07477875976561876,1828.2008774280548,632.1216015815735,1539.3691215515137,58447,10366,48081,48081,0,12,9291000.0
9291,9291999,21.431571617635253,38.08001350174668,0.07476418017502429,1828.3240442276,632.1858870983124,1539.4636116027832,58447,10366,48081,48081,0,12,9292000.0
9292,9292999,21.43140017706467,38.07902833409917,0.074753423588518,1828.4497842788696,632.2524547576904,1539.5383262634277,58447,10366,48081,48081,0,12,9293000.0
9293,9293999,21.431189103472526,38.07803335515418,0.07474559028825678,1828.714730501175,632.3168733119965,1539.5626678466797,58449,10367,48082,48082,0,12,9294000.0
9294,9294999,21.431038448537173,38.07706466883738,0.07473157216511017,1828.8446352481842,632.3810679912567,1539.6860847473145,58449,10367,48082,48082,0,12,9295000.0
9295,9295999,21.431322255488553,38.07667611329864,0.07469725387191817,1828.9588387012482,632.443826675415,1539.7793998718262,58450,10367,48083,48083,0,12,9296000.0
9296,9296999,21.43124417595383,38.0757108258254,0.07467749119573652,1829.090250492096,632.5101780891418,1539.8300552368164,58450,10367,48083,48083,0,12,9297000.0
9297,9297999,21.430998478856782,38.07457420836287,0.0746626784511607,1829.2046339511871,632.5737843513489,1539.865306854248,58450,10367,48083,48083,0,12,9298000.0
9298,9298999,21.430615471638344,38.07330040581329,0.074655451674572,1829.461436033249,632.6375632286072,1539.9290351867676,58462,10368,48094,48094,0,12,9299000.0
9299,9299999,21.429807786194548,38.07178184039848,0.07466201824362706,1829.8577501773834,632.7020881175995,1540.1627082824707,58476,10370,48106,48106,0,12,9300000.0
9300,9300999,21.42903452171902,38.070547896442925,0.07465961011374023,1830.1172316074371,632.7667739391327,1540.3014526367188,58488,10371,48117,48117,0,12,9301000.0
9301,9301999,21.428336736258284,38.06950552175276,0.0746568469013853,1830.3696954250336,632.8306102752686,1540.4321479797363,58490,10372,48118,48118,0,12,9302000.0
9302,9302999,21.427617315900513,38.068276799542176,0.07465919677481059,1830.6215076446533,632.8944251537323,1540.4404106140137,58493,10373,48120,48120,0,12,9303000.0
9303,9303999,21.427053867541236,38.06714423139831,0.0746529720327056,1830.8896343708038,632.9620456695557,1540.6503601074219,58496,10374,48122,48122,0,12,9304000.0
9304,9304999,21.426442865366873,38.066328946570955,0.0746480599356576,1831.2913041114807,633.0293397903442,1540.714641571045,58500,10376,48124,48124,0,12,9305000.0
9305,9305999,21.425782081666394,38.06501513050698,0.07464190601453513,1831.4124598503113,633.0928199291229,1540.8836555480957,58500,10376,48124,48124,0,12,9306000.0
9306,9306999,21.425017783618287,38.063588265804015,0.07463929130964186,1831.6841609477997,633.1591320037842,1540.870704650879,58503,10377,48126,48126,0,12,9307000.0
9307,9307999,21.42454497264063,38.06578865457708,0.0746238348104118,1831.8166961669922,633.2336225509644,1541.0003547668457,58503,10377,48126,48126,0,12,9308000.0
9308,9308999,21.42391873035646,38.06461531391574,0.07462185628391438,1831.9501962661743,633.2968332767487,1541.0873260498047,58503,10377,48126,48126,0,12,9309000.0
9309,9309999,21.423573336673144,38.06365677828937,0.07460599210597363,1832.214405298233,633.3638546466827,1541.2533531188965,58514,10378,48136,48136,0,12,9310000.0
9310,9310999,21.42346154043334,38.06292881533955,0.0745840747637746,1832.3384449481964,633.4279937744141,1541.3482627868652,58514,10378,48136,48136,0,12,9311000.0
9311,9311999,21.42317356825221,38.06209220742678,0.07457239065242105,1832.4594769477844,633.4928233623505,1541.4281463623047,58514,10378,48136,48136,0,12,9312000.0
9312,9312999,21.423102981146126,38.0614511735922,0.07456017071566945,1832.8592524528503,633.5567004680634,1541.4098014831543,58518,10380,48138,48138,0,12,9313000.0
9313,9313999,21.42306286362247,38.06082068580119,0.07454556613935459,1832.9808433055878,633.6209909915924,1541.4927520751953,58518,10380,48138,48138,0,12,9314000.0
9314,9314999,21.42317000441968,38.060535424246666,0.07453642743104849,1833.24769282341,633.6866865158081,1541.6090278625488,58527,10381,48146,48146,0,12,9315000.0
9315,9315999,21.42363824560546,38.060493006445746,0.07451330085433938,1833.3655230998993,633.7493960857391,1541.784797668457,58527,10381,48146,48146,0,12,9316000.0
9316,9316999,21.42392863717,38.060034961694214,0.07450086886305707,1833.6111524105072,633.8121039867401,1541.829517364502,58529,10382,48147,48147,0,12,9317000.0
9317,9317999,21.424152406876914,38.05950921887089,0.07448819091240222,1833.865306854248,633.8760232925415,1541.8368911743164,58533,10383,48150,48150,0,12,9318000.0
9318,9318999,21.423945358050155,38.058417992512645,0.0744804748183,1833.9986369609833,633.943874835968,1541.929355621338,58533,10383,48150,48150,0,12,9319000.0
9319,9319999,21.42353174532544,38.057240283765985,0.07447037584672134,1834.111955165863,634.0069415569305,1542.3985061645508,58533,10383,48150,48150,0,12,9320000.0
9320,9320999,21.42261923012042,38.05576146809058,0.07447215587058842,1834.3643097877502,634.0720453262329,1542.5043334960938,58537,10384,48153,48153,0,12,9321000.0
9321,9321999,21.421983795335635,38.054763523717796,0.07447070306078996,1834.4846968650818,634.1362879276276,1542.6743354797363,58537,10384,48153,48153,0,12,9322000.0
9322,9322999,21.421248745897707,38.05364409215703,0.07447258958877023,1834.8670706748962,634.2017936706543,1542.7168006896973,58541,10386,48155,48155,0,12,9323000.0
9323,9323999,21.420541488168617,38.052227471235845,0.07447259410296703,1835.1245415210724,634.2689001560211,1542.929027557373,58553,10387,48166,48166,0,12,9324000.0
9324,9324999,21.42003281737414,38.05111138678339,0.07447015158181813,1835.2441999912262,634.3339641094208,1543.1656379699707,58553,10387,48166,48166,0,12,9325000.0
9325,9325999,21.419409434884606,38.049744416670606,0.07446865112143086,1835.366842508316,634.4023668766022,1543.320686340332,58553,10387,48166,48166,0,12,9326000.0
9326,9326999,21.41880235470099,38.04845748524743,0.07446457221301561,1835.6318542957306,634.4686925411224,1543.3902397155762,58565,10388,48177,48177,0,12,9327000.0
9327,9327999,21.418224436055393,38.04717507174317,0.07446079857267252,1835.7507450580597,634.5333299636841,1543.501636505127,58565,10388,48177,48177,0,12,9328000.0
9328,9328999,21.417707256838362,38.04606086134567,0.07445974503491692,1836.018529176712,634.6005954742432,1543.6414527893066,58567,10389,48178,48178,0,12,9329000.0
9329,9329999,21.417271216191637,38.04485259942647,0.07445386717838631,1836.1404829025269,634.6679928302765,1543.906005859375,58567,10389,48178,48178,0,12,9330000.0
9330,9330999,21.417218479220686,38.04414461810008,0.07443856684476347,1836.2769832611084,634.7354347705841,1544.0702896118164,58567,10389,48178,48178,0,12,9331000.0
9331,9331999,21.416965930692133,38.04303764028811,0.07442996001424862,1836.4060306549072,634.8029034137726,1544.2153205871582,58567,10389,48178,48178,0,12,9332000.0
9332,9332999,21.416772290225488,38.04219693957182,0.07442118317618596,1836.5335884094238,634.8678121566772,1544.2945365905762,58567,10389,48178,48178,0,12,9333000.0
9333,9333999,21.416544180719917,38.04126761301437,0.07441008988644482,1836.9166657924652,634.933840751648,1544.3186492919922,58581,10391,48190,48190,0,12,9334000.0
9334,9334999,21.416468659847034,38.040469214183574,0.07440215160258412,1837.0406897068024,634.999125957489,1544.4075050354004,58582,10391,48191,48191,0,12,9335000.0
9335,9335999,21.416805676921406,38.04021158185595,0.07438285427855962,1837.3218789100647,635.0764768123627,1544.5289688110352,58584,10392,48192,48192,0,12,9336000.0
9336,9336999,21.41727430067321,38.04047589383634,0.07436894713390207,1837.5793771743774,635.1406087875366,1544.6193008422852,58587,10393,48194,48194,0,12,9337000.0
9337,9337999,21.417753274483847,38.04093483507967,0.07435861558103907,1837.7045876979828,635.2050848007202,1544.6930618286133,58587,10393,48194,48194,0,12,9338000.0
9338,9338999,21.41859479210566,38.0420693556164,0.0743491227217371,1837.8350615501404,635.2700910568237,1544.7615776062012,58587,10393,48194,48194,0,12,9339000.0
9339,9339999,21.41872763103126,38.042132021658624,0.07434728948122926,1837.9553513526917,635.3332104682922,1545.1771240234375,58591,10393,48198,48198,0,12,9340000.0
9340,9340999,21.41790396640809,38.04094189439981,0.07435048750031659,1838.3340003490448,635.3983709812164,1545.449607849121,58601,10395,48206,48206,0,12,9341000.0
9341,9341999,21.417249974974887,38.04065485878409,0.07434762962334251,1838.7411816120148,635.4667017459869,1545.5947265625,58615,10397,48218,48218,0,12,9342000.0
9342,9342999,21.416466805522212,38.03922982262386,0.07435000466775399,1838.986765384674,635.530743598938,1545.7597312927246,58627,10398,48229,48229,0,12,9343000.0
9343,9343999,21.415906864257263,38.04037839884189,0.07434156219031718,1839.109435558319,635.595401763916,1545.9214897155762,58627,10398,48229,48229,0,12,9344000.0
9344,9344999,21.415422104531086,38.04007337461923,0.07433813777461007,1839.236947774887,635.6605613231659,1546.1802787780762,58627,10398,48229,48229,0,12,9345000.0
9345,9345999,21.41495921102455,38.03940013151711,0.07433361054150878,1839.6250622272491,635.7250759601593,1546.2892265319824,58643,10400,48243,48243,0,12,9346000.0
9346,9346999,21.41442606138494,38.03823986964723,0.07433125221703474,1839.7368876934052,635.78870844841,1546.4089622497559,58643,10400,48243,48243,0,12,9347000.0
9347,9347999,21.413803256952768,38.03708177525553,0.07432941024929351,1840.124478340149,635.8534212112427,1546.4734725952148,58647,10402,48245,48245,0,12,9348000.0
9348,9348999,21.413174981380426,38.03577656599425,0.07432876435423552,1840.513426065445,635.9177069664001,1546.5446472167969,58663,10404,48259,48259,0,12,9349000.0
9349,9349999,21.41280104874741,38.03529252893522,0.0743221050724513,1840.6301474571228,635.9830009937286,1546.6551628112793,58663,10404,48259,48259,0,12,9350000.0
9350,9350999,21.41252334146662,38.03459022435085,0.0743122432534381,1840.8847107887268,636.0480828285217,1546.8799667358398,58665,10405,48260,48260,0,12,9351000.0
9351,9351999,21.4122767729451,38.033717094799776,0.07430558438387869,1841.1379771232605,636.1129915714264,1546.9707489013672,58667,10406,48261,48261,0,12,9352000.0
9352,9352999,21.41188863168318,38.03257304366708,0.07430016888703528,1841.4230942726135,636.187132358551,1547.0589027404785,58669,10407,48262,48262,0,12,9353000.0
9353,9353999,21.411626884866866,38.03156024879155,0.07429517022222265,1841.5474774837494,636.2523446083069,1547.1511840820312,58669,10407,48262,48262,0,12,9354000.0
9354,9354999,21.41140881372969,38.030687181384174,0.07428663626461729,1841.8074944019318,636.3175001144409,1547.2262420654297,58683,10408,48275,48275,0,12,9355000.0
9355,9355999,21.411130410398385,38.02966387936287,0.07427947034227411,1842.0794134140015,636.3833730220795,1547.3517761230469,58686,10409,48277,48277,0,12,9356000.0
9356,9356999,21.41114419109581,38.02891338230303,0.07426894218097713,1842.333892583847,636.4486601352692,1547.5514526367188,58693,10410,48283,48283,0,12,9357000.0
9357,9357999,21.410982755736587,38.02794948179071,0.07426083643011094,1842.5815751552582,636.5137214660645,1547.6480407714844,58695,10411,48284,48284,0,12,9358000.0
9358,9358999,21.410773550342096,38.02692520506328,0.07425334833911268,1842.705374956131,636.5786345005035,1547.730297088623,58695,10411,48284,48284,0,12,9359000.0
9359,9359999,21.410513516259375,38.026350848443954,0.07424493229738638,1842.971476316452,636.6466753482819,1547.789638519287,58697,10412,48285,48285,0,12,9360000.0
9360,9360999,21.40999902491728,38.02614401913699,0.0742430964181352,1843.0955727100372,636.7113451957703,1548.3761596679688,58699,10412,48287,48287,0,12,9361000.0
9361,9361999,21.409075530887314,38.02457550054584,0.07425161060155727,1843.2101488113403,636.776620388031,1548.6686325073242,58699,10412,48287,48287,0,12,9362000.0
9362,9362999,21.408292485859995,38.023839548812234,0.07425616231419063,1843.322121143341,636.841997385025,1548.8731155395508,58699,10412,48287,48287,0,12,9363000.0
9363,9363999,21.407673734123406,38.0232538990765,0.07425589183919223,1843.573758840561,636.907957315445,1549.022289276123,58711,10413,48298,48298,0,12,9364000.0
9364,9364999,21.407119683031986,38.022259908095904,0.07425441453662185,1843.8355066776276,636.9738578796387,1549.3174896240234,58713,10414,48299,48299,0,12,9365000.0
9365,9365999,21.406600029550756,38.02133288169584,0.07425347163909257,1844.2189133167267,637.0402765274048,1549.4197273254395,58720,10416,48304,48304,0,12,9366000.0
9366,9366999,21.406144833994947,38.02102340722093,0.07424633575932704,1844.475210905075,637.106787443161,1549.5688591003418,58732,10417,48315,48315,0,12,9367000.0
9367,9367999,21.405605004120083,38.02003366907282,0.07424604898544973,1844.7373707294464,637.1721472740173,1549.6914825439453,58764,10418,48346,48346,0,12,9368000.0
9368,9368999,21.40518941881558,38.0196159887745,0.07424254608793479,1844.9888455867767,637.2373480796814,1549.786506652832,58771,10419,48352,48352,0,12,9369000.0
9369,9369999,21.404786686800076,38.01893773769905,0.07424053000049469,1845.115347623825,637.3037075996399,1550.051097869873,58771,10419,48352,48352,0,12,9370000.0
9370,9370999,21.404410050927936,38.01791088656874,0.07423776626006617,1845.3698675632477,637.3688111305237,1550.200397491455,58773,10420,48353,48353,0,12,9371000.0
9371,9371999,21.404018469817213,38.01707761527631,0.07423658490027207,1845.4950881004333,637.4347507953644,1550.3375282287598,58773,10420,48353,48353,0,12,9372000.0
9372,9372999,21.403715969658084,38.016226128321655,0.07423626551367601,1845.6212298870087,637.4994783401489,1550.4640007019043,58773,10420,48353,48353,0,12,9373000.0
9373,9373999,21.40332574325494,38.01511892597815,0.07423739209570601,1845.739648103714,637.564062833786,1550.5531539916992,58773,10420,48353,48353,0,12,9374000.0
9374,9374999,21.403071385682793,38.01427908926786,0.07423632675316871,1845.87562084198,637.6314723491669,1550.676670074463,58773,10420,48353,48353,0,12,9375000.0
9375,9375999,21.402721256517772,38.0133405766621,0.07423614414886348,1846.1412889957428,637.6968524456024,1550.7237930297852,58785,10421,48364,48364,0,12,9376000.0
9376,9376999,21.402129299129268,38.012042624065565,0.07423869660714844,1846.266879081726,637.7641038894653,1550.783790588379,58785,10421,48364,48364,0,12,9377000.0
9377,9377999,21.401546169521023,38.01132619487406,0.07424346774795931,1846.5221638679504,637.8295214176178,1551.3493118286133,58788,10422,48366,48366,0,12,9378000.0
9378,9378999,21.40061357954538,38.01021843646879,0.07425007337144929,1846.773814201355,637.895165681839,1551.6157302856445,58791,10423,48368,48368,0,12,9379000.0
9379,9379999,21.399741792258396,38.008856862557316,0.07425529952736398,1846.8861501216888,637.9598665237427,1551.8005142211914,58791,10423,48368,48368,0,12,9380000.0
9380,9380999,21.398837917523874,38.00753479492629,0.07426101385273531,1847.0133972167969,638.0264716148376,1551.9498710632324,58791,10423,48368,48368,0,12,9381000.0
9381,9381999,21.398110522334147,38.00625820400514,0.07426513578935401,1847.2736973762512,638.0940172672272,1552.2408142089844,58794,10424,48370,48370,0,12,9382000.0
9382,9382999,21.39744590840674,38.00555049118553,0.07426319267979176,1847.5276503562927,638.1589756011963,1552.343376159668,58806,10425,48381,48381,0,12,9383000.0
9383,9383999,21.39683564561646,38.00471779355377,0.07426136799093586,1847.6507856845856,638.2235054969788,1552.4616584777832,58806,10425,48381,48381,0,12,9384000.0
9384,9384999,21.396189740693906,38.004195768261205,0.07426005871867136,1847.9201200008392,638.2892739772797,1552.5498657226562,58818,10426,48392,48392,0,12,9385000.0
9385,9385999,21.39558729917423,38.003187393313766,0.07425964148618502,1848.0381655693054,638.3532576560974,1552.6621131896973,58818,10426,48392,48392,0,12,9386000.0
9386,9386999,21.39508638507975,38.002394445449276,0.0742594437859393,1848.1621203422546,638.4174318313599,1552.902759552002,58818,10426,48392,48392,0,12,9387000.0
9387,9387999,21.39501052668674,38.002364658933686,0.07425437376482058,1848.4236071109772,638.4858419895172,1553.038173675537,58831,10427,48404,48404,0,12,9388000.0
9388,9388999,21.39485995027681,38.00210784405095,0.07425070405994016,1848.5489258766174,638.549468755722,1553.1635971069336,58831,10427,48404,48404,0,12,9389000.0
9389,9389999,21.39496921109684,38.00235122626679,0.0742429499863766,1848.683308839798,638.6139574050903,1553.2650604248047,58832,10427,48405,48405,0,12,9390000.0
9390,9390999,21.395014302629015,38.002488185746344,0.0742380719171265,1849.2104096412659,638.6798467636108,1553.2644844055176,58848,10430,48418,48418,0,12,9391000.0
9391,9391999,21.395297785073414,38.003154471294266,0.07422950563345865,1849.331715106964,638.7448868751526,1553.3637046813965,58848,10430,48418,48418,0,12,9392000.0
9392,9392999,21.395645065528722,38.003653988278394,0.07422546393057783,1849.5848262310028,638.8112244606018,1553.6107749938965,58853,10431,48422,48422,0,12,9393000.0
9393,9393999,21.395858606560974,38.00387419199211,0.07422021413811775,1849.719962835312,638.8760340213776,1553.7220573425293,58854,10431,48423,48423,0,12,9394000.0
9394,9394999,21.396071495334557,38.00439643164463,0.0742132526309649,1849.8391366004944,638.9403395652771,1553.7961311340332,58854,10431,48423,48423,0,12,9395000.0
9395,9395999,21.396214667337105,38.00435628739151,0.07420681036822463,1849.964805841446,639.0076088905334,1553.8533935546875,58854,10431,48423,48423,0,12,9396000.0
9396,9396999,21.396036387572945,38.003817684896234,0.07420329961762184,1850.228030204773,639.0722894668579,1554.1730155944824,58857,10432,48425,48425,0,12,9397000.0
9397,9397999,21.39536274031358,38.002828100976004,0.07420132468973017,1850.3485367298126,639.1368463039398,1554.5176887512207,58857,10432,48425,48425,0,12,9398000.0
9398,9398999,21.394634127012807,38.00185204984976,0.07420104086056656,1850.6010217666626,639.2013640403748,1554.6428108215332,58859,10433,48426,48426,0,12,9399000.0
9399,9399999,21.39395506477662,38.000585281249506,0.07420139214411314,1850.7272744178772,639.26806807518,1554.7770538330078,58860,10433,48427,48427,0,12,9400000.0
9400,9400999,21.393454075561454,37.99985467575104,0.07419523621443991,1851.1291320323944,639.3314702510834,1554.7924499511719,58876,10435,48441,48441,0,12,9401000.0
9401,9401999,21.392890269950872,37.9992915357546,0.07418973194931422,1851.2500293254852,639.3954136371613,1555.0851554870605,58876,10435,48441,48441,0,12,9402000.0
9402,9402999,21.392294964211302,37.99804581385396,0.07418679688113239,1851.3843402862549,639.4605445861816,1555.2332305908203,58876,10435,48441,48441,0,12,9403000.0
9403,9403999,21.391745076336587,37.996889944330796,0.07418394021699315,1851.5074849128723,639.5254712104797,1555.3505973815918,58876,10435,48441,48441,0,12,9404000.0
9404,9404999,21.391128391913377,37.99570693964406,0.07418080371185642,1851.6318814754486,639.5899322032928,1555.4205207824707,58876,10435,48441,48441,0,12,9405000.0
9405,9405999,21.3906252432702,37.9945681434665,0.07417700912365155,1851.9017825126648,639.6545906066895,1555.4786834716797,58878,10436,48442,48442,0,12,9406000.0
9406,9406999,21.390113100697793,37.993435130047786,0.07417486048937638,1852.3019242286682,639.7200078964233,1555.4650230407715,58893,10438,48455,48455,0,12,9407000.0
9407,9407999,21.38983722797544,37.99254705677452,0.0741682229027204,1852.7183272838593,639.7845900058746,1555.689609527588,58917,10440,48477,48477,0,12,9408000.0
9408,9408999,21.38942050384043,37.991460974053595,0.07416455277323386,1852.8421046733856,639.8483743667603,1555.79252243042,58917,10440,48477,48477,0,12,9409000.0
9409,9409999,21.389063883395263,37.990688948714606,0.07415878910820628,1853.2269468307495,639.9126145839691,1555.8683700561523,58931,10442,48489,48489,0,12,9410000.0
9410,9410999,21.3887609782814,37.98985424789423,0.07415722447422135,1853.3582615852356,639.9769020080566,1555.942138671875,58931,10442,48489,48489,0,12,9411000.0
9411,9411999,21.3885404392519,37.98901057429385,0.07415305493598712,1853.476986169815,640.0381355285645,1556.0167999267578,58931,10442,48489,48489,0,12,9412000.0
9412,9412999,21.388342937083642,37.98818972631736,0.07414986481303543,1853.5991320610046,640.1019184589386,1556.1410446166992,58931,10442,48489,48489,0,12,9413000.0
9413,9413999,21.388387013755885,37.98754524266188,0.07414255058038022,1853.7295768260956,640.1659195423126,1556.226650238037,58931,10442,48489,48489,0,12,9414000.0
9414,9414999,21.388378548317515,37.98771391444304,0.07413121300445913,1853.8389782905579,640.2279877662659,1556.283302307129,58931,10442,48489,48489,0,12,9415000.0
9415,9415999,21.38814754956977,37.98659867614468,0.07412411093320992,1853.9745433330536,640.2931780815125,1556.3253707885742,58931,10442,48489,48489,0,12,9416000.0
9416,9416999,21.387773007939558,37.98541987096515,0.0741211122443235,1854.097333431244,640.355667591095,1556.367332458496,58931,10442,48489,48489,0,12,9417000.0
9417,9417999,21.38724550370323,37.984070539189716,0.07411989045057332,1854.212253332138,640.4200115203857,1556.803882598877,58932,10442,48490,48490,0,12,9418000.0
9418,9418999,21.386495880603622,37.9828107266414,0.07412048658077597,1854.3533849716187,640.4980707168579,1557.0973815917969,58932,10442,48490,48490,0,12,9419000.0
9419,9419999,21.38570477018535,37.98129716791579,0.07412271714257124,1854.4807851314545,640.5631873607635,1557.3815307617188,58932,10442,48490,48490,0,12,9420000.0
9420,9420999,21.38492757367989,37.97989425609439,0.0741237848542492,1854.6008188724518,640.6276850700378,1557.5723838806152,58932,10442,48490,48490,0,12,9421000.0
9421,9421999,21.38443651011763,37.978793908031136,0.07411704355980242,1854.728388786316,640.6925089359283,1557.8007698059082,58933,10442,48491,48491,0,12,9422000.0
9422,9422999,21.38387734963963,37.97755635591773,0.07411176149903498,1854.987467765808,640.7583522796631,1557.9293098449707,58945,10443,48502,48502,0,12,9423000.0
9423,9423999,21.3833954351536,37.97634567396854,0.07410753999869957,1855.2493019104004,640.8223373889923,1558.0673065185547,58958,10444,48514,48514,0,12,9424000.0
9424,9424999,21.382788947783265,37.97507189316497,0.07410299589011715,1855.3819296360016,640.887631893158,1558.1922149658203,58958,10444,48514,48514,0,12,9425000.0
9425,9425999,21.382279754112492,37.97388953887156,0.0740990572740764,1855.7666137218475,640.9527854919434,1558.2339172363281,58962,10446,48516,48516,0,12,9426000.0
9426,9426999,21.381927328243236,37.97305348660967,0.07409177439805947,1855.8983316421509,641.017834186554,1558.344799041748,58962,10446,48516,48516,0,12,9427000.0
9427,9427999,21.381561154345654,37.971951426829534,0.07407853103177686,1856.152736902237,641.0832586288452,1558.6783294677734,58975,10447,48528,48528,0,12,9428000.0
9428,9428999,21.381564647802108,37.97124731558197,0.07405344920405188,1856.5386242866516,641.1484322547913,1558.7564315795898,58979,10449,48530,48530,0,12,9429000.0
9429,9429999,21.38135214396402,37.970439599562816,0.07403903735650708,1856.6562094688416,641.2129027843475,1558.9573440551758,58979,10449,48530,48530,0,12,9430000.0
9430,9430999,21.3810653142102,37.96941437292109,0.07402963865636691,1856.786123752594,641.2774202823639,1559.0792846679688,58979,10449,48530,48530,0,12,9431000.0
9431,9431999,21.380903951192497,37.968721757296535,0.07402057729576683,1856.909492969513,641.3407571315765,1559.1989669799805,58979,10449,48530,48530,0,12,9432000.0
9432,9432999,21.380755926034137,37.96778080682177,0.07400809650390627,1857.0406551361084,641.4044711589813,1559.3540725708008,58979,10449,48530,48530,0,12,9433000.0
9433,9433999,21.38071627787773,37.966832631158205,0.07399352089929168,1857.1636009216309,641.4691691398621,1559.5167427062988,58979,10449,48530,48530,0,12,9434000.0
9434,9434999,21.380629451970684,37.96583441513609,0.07398082963637231,1857.424075603485,641.5327553749084,1559.5993614196777,58981,10450,48531,48531,0,12,9435000.0
9435,9435999,21.3803192469307,37.96464439245835,0.07397603380755147,1857.6742839813232,641.5971901416779,1559.7063941955566,58986,10451,48535,48535,0,12,9436000.0
9436,9436999,21.3798906961204,37.96334269496507,0.07397364718941812,1857.9386637210846,641.6638698577881,1559.7460632324219,58988,10452,48536,48536,0,12,9437000.0
9437,9437999,21.379201285057633,37.96217026546937,0.0739738436847186,1858.1994605064392,641.7310497760773,1560.2443008422852,58997,10453,48544,48544,0,12,9438000.0
9438,9438999,21.37838378184957,37.9614498294011,0.07397664395524717,1858.4516153335571,641.7947316169739,1560.4284858703613,58999,10454,48545,48545,0,12,9439000.0
9439,9439999,21.377749606111465,37.960439319070545,0.07398061141874923,1858.7233192920685,641.8616962432861,1560.5708198547363,59011,10455,48556,48556,0,12,9440000.0
9440,9440999,21.377001843615126,37.95913271128321,0.07398448962687199,1858.849365234375,641.9280097484589,1560.6800270080566,59011,10455,48556,48556,0,12,9441000.0
9441,9441999,21.37617186716951,37.95787869404216,0.0739874950494519,1858.9658184051514,641.9942348003387,1560.9476928710938,59011,10455,48556,48556,0,12,9442000.0
9442,9442999,21.375585766512575,37.95687353043905,0.07398617293159038,1859.074069738388,642.0573217868805,1561.1261711120605,59012,10455,48557,48557,0,12,9443000.0
9443,9443999,21.37503307235697,37.95597804404824,0.07398378342656109,1859.2123045921326,642.1214516162872,1561.264015197754,59012,10455,48557,48557,0,12,9444000.0
9444,9444999,21.374452303313657,37.95529370028296,0.07398415176891493,1859.3408195972443,642.1845562458038,1561.3621520996094,59012,10455,48557,48557,0,12,9445000.0
9445,9445999,21.373888221001096,37.95423784641787,0.07398497567525875,1859.604407787323,642.2496304512024,1561.4355239868164,59025,10456,48569,48569,0,12,9446000.0
9446,9446999,21.37331662275248,37.95323216871828,0.07398075089375233,1859.9800899028778,642.313380241394,1561.4965629577637,59039,10458,48581,48581,0,12,9447000.0
9447,9447999,21.373009626900267,37.95242687653594,0.07397141845794974,1860.093855381012,642.376720905304,1561.7153663635254,59039,10458,48581,48581,0,12,9448000.0
9448,9448999,21.37275777147462,37.95191947371792,0.07396244540220942,1860.36607503891,642.4402894973755,1561.7908935546875,59041,10459,48582,48582,0,12,9449000.0
9449,9449999,21.372371929032063,37.95087788854792,0.0739572750497326,1860.4951131343842,642.506914138794,1561.9106369018555,59041,10459,48582,48582,0,12,9450000.0
9450,9450999,21.371976530298088,37.9497787991407,0.07395153643080965,1860.7509953975677,642.5715095996857,1561.9380378723145,59044,10460,48584,48584,0,12,9451000.0
9451,9451999,21.371665890533272,37.948963483095845,0.07394563290665157,1860.8715314865112,642.6345887184143,1562.0304794311523,59044,10460,48584,48584,0,12,9452000.0
9452,9452999,21.37152682871218,37.94825467121135,0.07394017996054458,1861.1319329738617,642.6979928016663,1562.0597190856934,59048,10461,48587,48587,0,12,9453000.0
9453,9453999,21.371522639861237,37.947751604460365,0.0739321711271459,1861.2451610565186,642.7620413303375,1562.3337783813477,59048,10461,48587,48587,0,12,9454000.0
9454,9454999,21.37153138502024,37.947069363791144,0.07392726362919255,1861.3691837787628,642.8243708610535,1562.445255279541,59048,10461,48587,48587,0,12,9455000.0
9455,9455999,21.371618546204196,37.94722683782186,0.07392067933281199,1861.7712290287018,642.8915450572968,1562.4673500061035,59052,10463,48589,48589,0,12,9456000.0
9456,9456999,21.371701431091182,37.94726008936201,0.07393724903765908,1862.0246798992157,642.9557511806488,1562.5133514404297,59054,10464,48590,48590,0,12,9457000.0
9457,9457999,21.3714716603241,37.94690040864763,0.07393998661673373,1862.4325358867645,643.0281145572662,1562.978286743164,59065,10466,48599,48599,0,12,9458000.0
9458,9458999,21.37065241611305,37.9462424866567,0.07394189735847678,1862.5463881492615,643.0930418968201,1563.2801551818848,59065,10466,48599,48599,0,12,9459000.0
9459,9459999,21.36980758795774,37.94494887570871,0.07394491267690351,1862.8023102283478,643.1614615917206,1563.4485244750977,59077,10467,48610,48610,0,12,9460000.0
9460,9460999,21.369014049725227,37.943762724776434,0.07394713103301909,1863.0633072853088,643.2265553474426,1563.579189300537,59089,10468,48621,48621,0,12,9461000.0
9461,9461999,21.368253818938406,37.94248556741356,0.07394796998611608,1863.462280511856,643.2926054000854,1563.6358489990234,59093,10470,48623,48623,0,12,9462000.0
9462,9462999,21.367672626290847,37.94376222770243,0.07393960596408022,1863.5736496448517,643.357358455658,1563.940517425537,59093,10470,48623,48623,0,12,9463000.0
9463,9463999,21.366908248174735,37.942327148308934,0.07394184347654154,1863.6939361095428,643.4220728874207,1564.0671577453613,59093,10470,48623,48623,0,12,9464000.0
9464,9464999,21.366221790230334,37.94095869929852,0.07394023163539543,1863.9566128253937,643.486156463623,1564.1598587036133,59105,10471,48634,48634,0,12,9465000.0
9465,9465999,21.365629988110314,37.94040225094198,0.07393620312166249,1864.0812039375305,643.5535287857056,1564.2322387695312,59105,10471,48634,48634,0,12,9466000.0
9466,9466999,21.36513069992029,37.939408567556725,0.07393305050315158,1864.2012391090393,643.6190445423126,1564.3320999145508,59105,10471,48634,48634,0,12,9467000.0
9467,9467999,21.364729257577764,37.938290804184746,0.07392734646420573,1864.3407304286957,643.6867828369141,1564.5522537231445,59105,10471,48634,48634,0,12,9468000.0
9468,9468999,21.364708250893816,37.93780628282901,0.0739113448845119,1864.8816533088684,643.7606501579285,1564.5336074829102,59126,10474,48652,48652,0,12,9469000.0
9469,9469999,21.364429984882456,37.9366907574029,0.07390270693090006,1865.1269142627716,643.824615240097,1564.677173614502,59138,10475,48663,48663,0,12,9470000.0
9470,9470999,21.364313586488016,37.93590333578679,0.07389284876509894,1865.3857564926147,643.8896672725677,1564.7335929870605,59140,10476,48664,48664,0,12,9471000.0
9471,9471999,21.364202692119843,37.93517107680081,0.07388227713452244,1865.652916431427,643.9548487663269,1564.8115921020508,59143,10477,48666,48666,0,12,9472000.0
9472,9472999,21.364023536677895,37.934482154787034,0.07387421156764729,1865.9011192321777,644.0186815261841,1564.868995666504,59155,10478,48677,48677,0,12,9473000.0
9473,9473999,21.364156660959466,37.93405167005521,0.07386378152249684,1866.0293626785278,644.0844411849976,1565.0373725891113,59155,10478,48677,48677,0,12,9474000.0
9474,9474999,21.364376218237666,37.93342101257232,0.07385049792752285,1866.2852623462677,644.1477813720703,1565.0927543640137,59158,10479,48679,48679,0,12,9475000.0
9475,9475999,21.36456301932962,37.932852601041986,0.07383854942816348,1866.4019763469696,644.2117726802826,1565.1700057983398,59158,10479,48679,48679,0,12,9476000.0
9476,9476999,21.364672643700313,37.9321270747877,0.07382708443885067,1866.5222005844116,644.2742924690247,1565.230339050293,59158,10479,48679,48679,0,12,9477000.0
9477,9477999,21.364473639615095,37.93115452302588,0.07382116550555884,1866.644971370697,644.3384940624237,1565.3597793579102,59158,10479,48679,48679,0,12,9478000.0
9478,9478999,21.36375228352173,37.92976807689917,0.07381936177766679,1867.0395805835724,644.4035098552704,1565.6973724365234,59164,10481,48683,48683,0,12,9479000.0
9479,9479999,21.36295376302969,37.928355126289,0.07381603939935921,1867.423159122467,644.4693355560303,1565.8130111694336,59168,10483,48685,48685,0,12,9480000.0
9480,9480999,21.36216857104632,37.92722954991208,0.07381718144532246,1867.552970647812,644.53431224823,1565.9834327697754,59168,10483,48685,48685,0,12,9481000.0
9481,9481999,21.361424477062464,37.925885824036094,0.07381631501238506,1867.6736760139465,644.5986657142639,1566.138786315918,59168,10483,48685,48685,0,12,9482000.0
9482,9482999,21.36091571218636,37.92505712425844,0.07381269541316926,1868.0761103630066,644.664154291153,1566.3006134033203,59182,10485,48697,48697,0,12,9483000.0
9483,9483999,21.360508443530605,37.9239969710407,0.07381160116403584,1868.1905980110168,644.7296757698059,1566.4309463500977,59182,10485,48697,48697,0,12,9484000.0
9484,9484999,21.360282295349474,37.92318353914088,0.07380899151150855,1868.586080789566,644.7947580814362,1566.492576599121,59193,10487,48706,48706,0,12,9485000.0
9485,9485999,21.359948370326542,37.92244326596229,0.07380533761291297,1868.7146124839783,644.8618853092194,1566.5694122314453,59193,10487,48706,48706,0,12,9486000.0
9486,9486999,21.359828232225937,37.921911616713224,0.07380362059649315,1868.8230907917023,644.9254915714264,1566.6658096313477,59193,10487,48706,48706,0,12,9487000.0
9487,9487999,21.35973671093049,37.92139332107047,0.07380820045390013,1869.380939245224,644.9915182590485,1566.5771141052246,59199,10490,48709,48709,0,12,9488000.0
9488,9488999,21.3604529399796,37.922638997148646,0.07381215011986997,1869.5052168369293,645.0584049224854,1566.8185005187988,59199,10490,48709,48709,0,12,9489000.0
9489,9489999,21.361204255247674,37.924400973052,0.07382815686532684,1869.7555170059204,645.1232120990753,1566.9279975891113,59211,10491,48720,48720,0,12,9490000.0
9490,9490999,21.36178343106251,37.92536240328539,0.07384438809772809,1869.878294467926,645.1877851486206,1567.0339317321777,59211,10491,48720,48720,0,12,9491000.0
9491,9491999,21.362715120535334,37.927392117452044,0.07385607645471959,1870.2741763591766,645.254435300827,1567.0585556030273,59215,10493,48722,48722,0,12,9492000.0
9492,9492999,21.363937374648874,37.93078283514097,0.07388244361120355,1870.5405542850494,645.3182039260864,1567.129898071289,59218,10494,48724,48724,0,12,9493000.0
9493,9493999,21.365638422385686,37.93700276144001,0.07390300549606865,1870.7925374507904,645.3824825286865,1567.2829208374023,59230,10495,48735,48735,0,12,9494000.0
9494,9494999,21.3672506945525,37.94146535710626,0.07391701852208221,1870.9233133792877,645.4483799934387,1567.4233322143555,59230,10495,48735,48735,0,12,9495000.0
9495,9495999,21.368876497009737,37.94459480966778,0.07393851281056696,1871.3094532489777,645.5128717422485,1567.444564819336,59244,10497,48747,48747,0,12,9496000.0
9496,9496999,21.370410320065307,37.94765963781881,0.0739651278406136,1871.5702781677246,645.5804934501648,1567.4848976135254,59248,10498,48750,48750,0,12,9497000.0
9497,9497999,21.371295443974883,37.94949382135205,0.07396766021399914,1872.2487561702728,645.6460242271423,1567.5929718017578,59269,10502,48767,48767,0,12,9498000.0
9498,9498999,21.370866562607624,37.94890894025416,0.07396497163669236,1872.6453597545624,645.7117114067078,1567.9000701904297,59276,10504,48772,48772,0,12,9499000.0
9499,9499999,21.370344866109452,37.94875333127433,0.07396773262231027,1872.765822172165,645.7770898342133,1568.084846496582,59276,10504,48772,48772,0,12,9500000.0
9500,9500999,21.369825356692278,37.94814430554077,0.07397018073161077,1872.8847296237946,645.8422727584839,1568.229320526123,59276,10504,48772,48772,0,12,9501000.0
9501,9501999,21.369420212707897,37.94753394305255,0.07396903980361602,1873.0136306285858,645.9077107906342,1568.427188873291,59276,10504,48772,48772,0,12,9502000.0
9502,9502999,21.368899785773,37.9466656924304,0.07396890039556425,1873.1347210407257,645.9721119403839,1568.564510345459,59276,10504,48772,48772,0,12,9503000.0
9503,9503999,21.36836527737704,37.945806870237185,0.0739680209547624,1873.272839307785,646.0397601127625,1568.6800994873047,59276,10504,48772,48772,0,12,9504000.0
9504,9504999,21.367810281609536,37.94485423347547,0.07397048149981567,1873.532065153122,646.1044721603394,1568.7479400634766,59280,10505,48775,48775,0,12,9505000.0
9505,9505999,21.367257585331554,37.94387159956759,0.07397506487760996,1873.8042306900024,646.1764822006226,1568.8351364135742,59282,10506,48776,48776,0,12,9506000.0
9506,9506999,21.36688367391518,37.943186016709255,0.07397643364892614,1873.9308619499207,646.2427489757538,1568.9409523010254,59282,10506,48776,48776,0,12,9507000.0
9507,9507999,21.366825072642477,37.94309545508914,0.07397285936666309,1874.0613527297974,646.3095760345459,1569.1753845214844,59282,10506,48776,48776,0,12,9508000.0
9508,9508999,21.366762091952275,37.94280942117421,0.07397245766740046,1874.3218042850494,646.3747270107269,1569.2547416687012,59284,10507,48777,48777,0,12,9509000.0
9509,9509999,21.366619430703704,37.94224216856458,0.07397680462092016,1874.43443608284,646.4392926692963,1569.3541564941406,59284,10507,48777,48777,0,12,9510000.0
9510,9510999,21.366736257412462,37.94228488346444,0.07397828893503822,1874.5656242370605,646.5038886070251,1569.4643821716309,59284,10507,48777,48777,0,12,9511000.0
9511,9511999,21.36681225281775,37.94189039393118,0.07398392057446401,1875.0873727798462,646.5686166286469,1569.5653915405273,59301,10510,48791,48791,0,12,9512000.0
9512,9512999,21.366720696257797,37.94129560316496,0.07398534648200472,1875.347148656845,646.6327426433563,1569.6517753601074,59306,10511,48795,48795,0,12,9513000.0
9513,9513999,21.366858250969546,37.94166051912778,0.07398310581164291,1875.7251048088074,646.6967952251434,1569.678394317627,59310,10513,48797,48797,0,12,9514000.0
9514,9514999,21.36651973236358,37.94089993204239,0.07398127080148764,1876.2459154129028,646.7623202800751,1569.980827331543,59321,10516,48805,48805,0,12,9515000.0
9515,9515999,21.366051334908875,37.940609943928074,0.07397323878977957,1876.3672573566437,646.8270802497864,1570.3030090332031,59321,10516,48805,48805,0,12,9516000.0
9516,9516999,21.365566546324885,37.93982845932311,0.07397205110505733,1876.6290888786316,646.8936545848846,1570.4523124694824,59323,10517,48806,48806,0,12,9517000.0
9517,9517999,21.36499045934545,37.938856418251135,0.07397202562131633,1876.7490174770355,646.9582600593567,1570.6317977905273,59323,10517,48806,48806,0,12,9518000.0
9518,9518999,21.364728267576748,37.938852705847715,0.07395615439066039,1876.866771697998,647.0235693454742,1570.8864288330078,59323,10517,48806,48806,0,12,9519000.0
9519,9519999,21.364460664801282,37.93850804070545,0.07394131730128461,1877.2729580402374,647.088739156723,1571.006046295166,59339,10519,48820,48820,0,12,9520000.0
9520,9520999,21.36397819751989,37.937396885531186,0.07392916247728165,1877.4041466712952,647.1538650989532,1571.1745071411133,59339,10519,48820,48820,0,12,9521000.0
9521,9521999,21.363633965711365,37.93727168549017,0.0739193314936808,1877.517086982727,647.2180144786835,1571.2971725463867,59339,10519,48820,48820,0,12,9522000.0
9522,9522999,21.36333000081969,37.9367052147017,0.07391065384844653,1877.6371159553528,647.284916639328,1571.4245109558105,59339,10519,48820,48820,0,12,9523000.0
9523,9523999,21.362966041215,37.93595098281177,0.0739049457039721,1877.8899447917938,647.3499569892883,1571.4584846496582,59341,10520,48821,48821,0,12,9524000.0
9524,9524999,21.363026013625568,37.93606084479992,0.0738776715902012,1878.1456489562988,647.4168465137482,1571.6801414489746,59343,10521,48822,48822,0,12,9525000.0
9525,9525999,21.363031482335156,37.9355812669307,0.07386071793166982,1878.4069383144379,647.4836013317108,1571.7506523132324,59354,10522,48832,48832,0,12,9526000.0
9526,9526999,21.36279695645718,37.93455458441912,0.07384943192598792,1878.523253440857,647.5471169948578,1571.8744583129883,59354,10522,48832,48832,0,12,9527000.0
9527,9527999,21.363085847988156,37.93760313403469,0.07382444890860584,1878.6480317115784,647.6157550811768,1571.9591789245605,59354,10522,48832,48832,0,12,9528000.0
9528,9528999,21.363090874080104,37.937099857551075,0.07381453287667528,1878.9106347560883,647.6808564662933,1572.0083198547363,59357,10523,48834,48834,0,12,9529000.0
9529,9529999,21.363291903182265,37.93677502312533,0.07379289707192171,1879.0226380825043,647.7442309856415,1572.1681098937988,59357,10523,48834,48834,0,12,9530000.0
9530,9530999,21.36365400806397,37.93651721087372,0.0737619847633042,1879.2741224765778,647.8091156482697,1572.2239265441895,59361,10524,48837,48837,0,12,9531000.0
9531,9531999,21.364004546145594,37.936371640288804,0.07373636076202206,1879.404218196869,647.875360250473,1572.320701599121,59361,10524,48837,48837,0,12,9532000.0
9532,9532999,21.364192669477895,37.93571262505312,0.07371281837722365,1879.5304868221283,647.9385068416595,1572.3798713684082,59361,10524,48837,48837,0,12,9533000.0
9533,9533999,21.364209198958072,37.93534825439286,0.07369753024013703,1879.7860078811646,648.0032458305359,1572.4519271850586,59363,10525,48838,48838,0,12,9534000.0
9534,9534999,21.363401691803322,37.93426170464547,0.073697444535331,1879.904911518097,648.0663483142853,1573.077018737793,59363,10525,48838,48838,0,12,9535000.0
9535,9535999,21.362530186626426,37.932907673439026,0.0736998125684798,1880.0268630981445,648.129637002945,1573.3471031188965,59363,10525,48838,48838,0,12,9536000.0
9536,9536999,21.36188514400154,37.93179724168843,0.07369810237626961,1880.28555226326,648.1938076019287,1573.5286827087402,59365,10526,48839,48839,0,12,9537000.0
9537,9537999,21.361303591385543,37.93081931093391,0.07369435856666573,1880.7986097335815,648.2578277587891,1573.5840148925781,59382,10529,48853,48853,0,12,9538000.0
9538,9538999,21.36081679783905,37.93023248104898,0.07368707385636653,1881.0471136569977,648.32173371315,1573.856601715088,59386,10530,48856,48856,0,12,9539000.0
9539,9539999,21.360507515522297,37.930307953704315,0.07368431807630793,1881.170551776886,648.3864035606384,1574.0900192260742,59386,10530,48856,48856,0,12,9540000.0
9540,9540999,21.36029958409878,37.93068320304861,0.07367282051980784,1881.2875883579254,648.450448513031,1574.2111701965332,59386,10530,48856,48856,0,12,9541000.0
9541,9541999,21.360156570254635,37.930775000243464,0.07366605774910495,1881.5581035614014,648.5156559944153,1574.289264678955,59398,10531,48867,48867,0,12,9542000.0
9542,9542999,21.360093697570896,37.93103870793149,0.0736598163606329,1881.9482793807983,648.5803549289703,1574.3250770568848,59412,10533,48879,48879,0,12,9543000.0
9543,9543999,21.360518810471252,37.932325151113226,0.0736541870514601,1882.0751559734344,648.6448712348938,1574.474063873291,59413,10533,48880,48880,0,12,9544000.0
9544,9544999,21.36096017763396,37.933334494238615,0.07366004531589465,1882.1928987503052,648.7089109420776,1574.7438697814941,59413,10533,48880,48880,0,12,9545000.0
9545,9545999,21.3617210372569,37.934999181141066,0.07366149624273255,1882.3123166561127,648.7736406326294,1574.9218215942383,59413,10533,48880,48880,0,12,9546000.0
9546,9546999,21.36267810745073,37.937317010273816,0.07366031016429142,1882.5625467300415,648.8394513130188,1575.0548210144043,59416,10534,48882,48882,0,12,9547000.0
9547,9547999,21.363731914035625,37.939425313965764,0.07366756812576769,1882.8334782123566,648.9035425186157,1575.1467514038086,59428,10535,48893,48893,0,12,9548000.0
9548,9548999,21.364966086366486,37.94181840916127,0.0736755251523914,1882.9579679965973,648.9682793617249,1575.2389678955078,59428,10535,48893,48893,0,12,9549000.0
9549,9549999,21.36606749342495,37.94362115327466,0.07368201733757662,1883.0742585659027,649.0310499668121,1575.3614616394043,59428,10535,48893,48893,0,12,9550000.0
9550,9550999,21.36731149827526,37.94659444585056,0.07367021498583604,1883.3257715702057,649.0946278572083,1575.5321083068848,59430,10536,48894,48894,0,12,9551000.0
9551,9551999,21.368602007736612,37.948872012514464,0.07366724136710268,1883.454024553299,649.1583633422852,1575.6757164001465,59430,10536,48894,48894,0,12,9552000.0
9552,9552999,21.369529313443582,37.95025769694422,0.07367231087269277,1883.7020373344421,649.2224595546722,1575.754623413086,59442,10537,48905,48905,0,12,9553000.0
9553,9553999,21.369905750720303,37.95052655411275,0.07367040432640226,1883.808147907257,649.2850046157837,1575.838291168213,59442,10537,48905,48905,0,12,9554000.0
9554,9554999,21.36911455408251,37.949385240164666,0.07367401655039496,1883.9333028793335,649.3491368293762,1576.4029426574707,59444,10537,48907,48907,0,12,9555000.0
9555,9555999,21.36805645048603,37.94785428196696,0.07368091444643443,1884.1767041683197,649.4127275943756,1576.563850402832,59456,10538,48918,48918,0,12,9556000.0
9556,9556999,21.36722828672606,37.94763147708354,0.07368087053024486,1884.291488647461,649.4761135578156,1576.7626571655273,59456,10538,48918,48918,0,12,9557000.0
9557,9557999,21.36627801937929,37.94631666817908,0.0736849524283687,1884.5497908592224,649.5412650108337,1576.8995208740234,59468,10539,48929,48929,0,12,9558000.0
9558,9558999,21.365475813726505,37.9452077058395,0.073687082255812,1884.6691291332245,649.6045873165131,1577.1235580444336,59468,10539,48929,48929,0,12,9559000.0
9559,9559999,21.364771461416584,37.94402255763389,0.07368650988863712,1885.0711033344269,649.6700723171234,1577.156665802002,59473,10541,48932,48932,0,12,9560000.0
9560,9560999,21.36409494510638,37.94268952642663,0.07368629316323494,1885.1901981830597,649.7332973480225,1577.3215599060059,59473,10541,48932,48932,0,12,9561000.0
9561,9561999,21.36336485573071,37.94136558942949,0.0736871974318658,1885.3067035675049,649.7967100143433,1577.458667755127,59473,10541,48932,48932,0,12,9562000.0
9562,9562999,21.362758458518726,37.940092405653104,0.07368803940389013,1885.4263865947723,649.8634567260742,1577.589729309082,59473,10541,48932,48932,0,12,9563000.0
9563,9563999,21.362339598519032,37.93917604682575,0.07368600515413692,1885.5525214672089,649.9307389259338,1577.6977424621582,59473,10541,48932,48932,0,12,9564000.0
9564,9564999,21.361989510394586,37.93817702736588,0.07368208413501953,1885.8077991008759,649.9971127510071,1577.9924621582031,59485,10542,48943,48943,0,12,9565000.0
9565,9565999,21.361726412405716,37.93726735333514,0.07367648602464505,1886.0577561855316,650.0612633228302,1578.1187324523926,59487,10543,48944,48944,0,12,9566000.0
9566,9566999,21.361483259933838,37.9364452921886,0.07367275218295866,1886.1695523262024,650.1243093013763,1578.2602272033691,59487,10543,48944,48944,0,12,9567000.0
9567,9567999,21.361160857121963,37.935567850071926,0.07367255005609197,1886.3152136802673,650.1951351165771,1578.3612594604492,59487,10543,48944,48944,0,12,9568000.0
9568,9568999,21.360931151877654,37.934829896941594,0.07367265728010397,1886.4479718208313,650.2621150016785,1578.4612731933594,59487,10543,48944,48944,0,12,9569000.0
9569,9569999,21.360750690765236,37.9341195022362,0.07366827164099299,1886.7109785079956,650.3280711174011,1578.5645599365234,59489,10544,48945,48945,0,12,9570000.0
9570,9570999,21.360777297998336,37.93355761363591,0.07365995968514771,1886.8466997146606,650.3947818279266,1578.733757019043,59489,10544,48945,48945,0,12,9571000.0
9571,9571999,21.36074549604208,37.93295504873409,0.07365355643240246,1887.101170539856,650.4590439796448,1578.7945022583008,59491,10545,48946,48946,0,12,9572000.0
9572,9572999,21.360527223524596,37.931952219895884,0.07364927048344783,1887.3542914390564,650.5220756530762,1578.8575477600098,59494,10546,48948,48948,0,12,9573000.0
9573,9573999,21.360105817319365,37.930798524286075,0.0736481199757838,1887.4772968292236,650.5870146751404,1578.942367553711,59494,10546,48948,48948,0,12,9574000.0
9574,9574999,21.359471378315746,37.92981348655475,0.07365092895761216,1887.7215819358826,650.6495480537415,1579.4538269042969,59507,10547,48960,48960,0,12,9575000.0
9575,9575999,21.358961569171086,37.93064052443829,0.07364642936507015,1887.8385796546936,650.7131583690643,1579.669418334961,59507,10547,48960,48960,0,12,9576000.0
9576,9576999,21.35820587198647,37.92956858940944,0.07365067198754682,1888.1145195960999,650.7800002098083,1579.803424835205,59510,10548,48962,48962,0,12,9577000.0
9577,9577999,21.357412764356965,37.92859973817839,0.0736526360055485,1888.2341113090515,650.842794418335,1579.9431533813477,59510,10548,48962,48962,0,12,9578000.0
9578,9578999,21.35668475701356,37.92745729797934,0.07365464107789077,1888.7724478244781,650.9082541465759,1580.0134239196777,59532,10551,48981,48981,0,12,9579000.0
9579,9579999,21.355982583877527,37.92628852983086,0.07365959887771634,1888.8907897472382,650.9734585285187,1580.239543914795,59532,10551,48981,48981,0,12,9580000.0
9580,9580999,21.35515524271286,37.924864864823896,0.07366315119802624,1889.0174961090088,651.0368883609772,1580.388843536377,59532,10551,48981,48981,0,12,9581000.0
9581,9581999,21.354452663610378,37.92370081558231,0.07366348654885768,1889.1493730545044,651.0993368625641,1580.478874206543,59532,10551,48981,48981,0,12,9582000.0
9582,9582999,21.353740283856443,37.92237836662019,0.0736627481209794,1889.2717552185059,651.1624627113342,1580.5895652770996,59532,10551,48981,48981,0,12,9583000.0
9583,9583999,21.353056230472472,37.921086066153634,0.07366125052176276,1889.5316932201385,651.226024389267,1580.6999320983887,59543,10552,48991,48991,0,12,9584000.0
9584,9584999,21.35249863143188,37.91992092795646,0.07365283463287409,1889.6527247428894,651.2906637191772,1580.970947265625,59543,10552,48991,48991,0,12,9585000.0
9585,9585999,21.351962505652107,37.91870959347023,0.07364578338269001,1889.7974336147308,651.3655252456665,1581.1219367980957,59543,10552,48991,48991,0,12,9586000.0
9586,9586999,21.351294452527732,37.91744911630268,0.07364367032879082,1889.9122469425201,651.4301452636719,1581.2457427978516,59543,10552,48991,48991,0,12,9587000.0
9587,9587999,21.350933166061857,37.91743790081087,0.07363956607166455,1890.1868467330933,651.4953315258026,1581.290096282959,59545,10553,48992,48992,0,12,9588000.0
9588,9588999,21.350344449409324,37.91618705762197,0.07363474698603112,1890.4398047924042,651.5603501796722,1581.296646118164,59548,10554,48994,48994,0,12,9589000.0
9589,9589999,21.349733308904664,37.9149159456187,0.07363387933925591,1890.5759317874908,651.6252090930939,1581.3746299743652,59548,10554,48994,48994,0,12,9590000.0
9590,9590999,21.349279896532096,37.91378735271148,0.07362786916859954,1890.697033405304,651.6887400150299,1581.5913276672363,59548,10554,48994,48994,0,12,9591000.0
9591,9591999,21.3488624132032,37.912567469577425,0.07362174219038464,1890.8248164653778,651.7545442581177,1581.6843795776367,59548,10554,48994,48994,0,12,9592000.0
9592,9592999,21.34827659553911,37.91125426568843,0.07361949264394296,1890.9497838020325,651.8188190460205,1581.7550201416016,59548,10554,48994,48994,0,12,9593000.0
9593,9593999,21.347550137642653,37.909942946875475,0.07361817067966936,1891.0800414085388,651.8909029960632,1581.811149597168,59548,10554,48994,48994,0,12,9594000.0
9594,9594999,21.346691657533448,37.908438861750824,0.07362466609332319,1891.236484527588,651.9657728672028,1582.5033264160156,59554,10554,49000,49000,0,12,9595000.0
9595,9595999,21.34581135100472,37.907949567084124,0.07362257179735732,1891.4957478046417,652.0324196815491,1582.9426803588867,59560,10555,49005,49005,0,12,9596000.0
9596,9596999,21.344844290284612,37.90642814979769,0.07362553133907335,1891.6128633022308,652.1003968715668,1583.2749099731445,59562,10555,49007,49007,0,12,9597000.0
9597,9597999,21.343936844316353,37.90524478338911,0.07362679273936446,1891.8841047286987,652.169037103653,1583.5263862609863,59564,10556,49008,49008,0,12,9598000.0
9598,9598999,21.34306025398474,37.903834277138564,0.07362870393558396,1892.2730159759521,652.2349770069122,1583.687629699707,59573,10558,49015,49015,0,12,9599000.0
9599,9599999,21.34226631809941,37.90262001551438,0.0736215874827254,1892.5267670154572,652.3007192611694,1583.9002227783203,59576,10559,49017,49017,0,12,9600000.0
9600,9600999,21.341568100873857,37.90150272552967,0.07361937799187956,1892.912679195404,652.3652722835541,1583.9891891479492,59580,10561,49019,49019,0,12,9601000.0
9601,9601999,21.340918328844694,37.900485735577014,0.07361954235345547,1893.573350429535,652.431943655014,1584.0923805236816,59610,10565,49045,49045,0,12,9602000.0
9602,9602999,21.340299458949257,37.89952247130324,0.07361543475702337,1893.6940751075745,652.4988968372345,1584.2879486083984,59612,10565,49047,49047,0,12,9603000.0
9603,9603999,21.33973161234372,37.8985633672644,0.0736160514822588,1893.9598321914673,652.5683703422546,1584.4205780029297,59614,10566,49048,49048,0,12,9604000.0
9604,9604999,21.339226944066162,37.897547131965695,0.07361277972340252,1894.366455078125,652.634299993515,1584.8096466064453,59629,10568,49061,49061,0,12,9605000.0
9605,9605999,21.339071842415876,37.89722510988815,0.07360746502471338,1894.4900767803192,652.7027571201324,1585.1339569091797,59630,10568,49062,49062,0,12,9606000.0
9606,9606999,21.338900293864867,37.89663380232675,0.07360228391026846,1894.7501201629639,652.7682275772095,1585.3082695007324,59642,10569,49073,49073,0,12,9607000.0
9607,9607999,21.338685173599174,37.89593833312962,0.07360536871978529,1895.293467760086,652.8363528251648,1585.329475402832,59653,10572,49081,49081,0,12,9608000.0
9608,9608999,21.338727851233152,37.89573551031689,0.07360002535983856,1895.7061264514923,652.9019734859467,1585.4058418273926,59677,10574,49103,49103,0,12,9609000.0
9609,9609999,21.338516792056797,37.894948637040955,0.07359699960011967,1896.2325642108917,652.9678175449371,1585.4522094726562,59686,10577,49109,49109,0,12,9610000.0
9610,9610999,21.338383975740776,37.89414563415055,0.07359383146748566,1896.485778093338,653.0320942401886,1585.7225799560547,59692,10578,49114,49114,0,12,9611000.0
9611,9611999,21.338530349670084,37.89423653138265,0.07358878949957093,1896.7450206279755,653.0986216068268,1585.8596878051758,59694,10579,49115,49115,0,12,9612000.0
9612,9612999,21.338385334976376,37.893428421257425,0.07358230423306189,1896.9939148426056,653.1620416641235,1585.9583625793457,59696,10580,49116,49116,0,12,9613000.0
9613,9613999,21.338238494055595,37.892685684520316,0.07358137890579897,1897.279170036316,653.2289323806763,1586.0079040527344,59698,10581,49117,49117,0,12,9614000.0
9614,9614999,21.337875895596355,37.89168487066507,0.0735760670383454,1897.5404455661774,653.2941522598267,1586.461280822754,59717,10582,49135,49135,0,12,9615000.0
9615,9615999,21.337081280655063,37.89042301606789,0.07357393823404912,1897.9262425899506,653.3580987453461,1586.8160133361816,59734,10584,49150,49150,0,12,9616000.0
9616,9616999,21.336462135606215,37.889653022663474,0.0735716928339274,1898.322209596634,653.424681186676,1587.005687713623,59742,10586,49156,49156,0,12,9617000.0
9617,9617999,21.336027559452706,37.888971199124086,0.07357176978494351,1898.5825583934784,653.4890565872192,1587.1907043457031,59747,10587,49160,49160,0,12,9618000.0
9618,9618999,21.336135675402048,37.88980411098317,0.0735668941309282,1898.9819645881653,653.5541331768036,1587.222770690918,59753,10589,49164,49164,0,12,9619000.0
9619,9619999,21.336501115394697,37.8903669823204,0.07356982513934007,1899.2388050556183,653.6200466156006,1587.6264266967773,59756,10590,49166,49166,0,12,9620000.0
9620,9620999,21.337300384762003,37.89198519113321,0.07357610153366023,1899.359043121338,653.6840727329254,1587.8430786132812,59757,10590,49167,49167,0,12,9621000.0
9621,9621999,21.33823340829807,37.89543663798548,0.07357782533425639,1899.4666774272919,653.7482681274414,1587.9756660461426,59757,10590,49167,49167,0,12,9622000.0
9622,9622999,21.33940868638025,37.898338446175465,0.07359121418736825,1899.8665063381195,653.8123607635498,1588.0302200317383,59762,10592,49170,49170,0,12,9623000.0
9623,9623999,21.340703746879488,37.90079187058722,0.07361769275050867,1900.126019001007,653.8789849281311,1588.1594543457031,59769,10593,49176,49176,0,12,9624000.0
9624,9624999,21.342030149863472,37.9042492369397,0.07363350207256791,1900.372004032135,653.9433290958405,1588.4745254516602,59777,10594,49183,49183,0,12,9625000.0
9625,9625999,21.343559872478203,37.907318879076314,0.07365493799351985,1900.7583594322205,654.0075986385345,1588.6562232971191,59783,10596,49187,49187,0,12,9626000.0
9626,9626999,21.344885585259583,37.910864926892245,0.07367092164101074,1901.1435430049896,654.0741732120514,1588.828872680664,59798,10598,49200,49200,0,12,9627000.0
9627,9627999,21.346256503823057,37.913273763858065,0.07370367344233197,1901.4009068012238,654.1408264636993,1588.963966369629,59800,10599,49201,49201,0,12,9628000.0
9628,9628999,21.34745769324522,37.9153029592285,0.07373989975864137,1901.5222079753876,654.2054653167725,1589.1022109985352,59800,10599,49201,49201,0,12,9629000.0
9629,9629999,21.349246934236312,37.91816492516066,0.07379023575039279,1902.1794545650482,654.2711989879608,1589.0382957458496,59819,10603,49216,49216,0,12,9630000.0
9630,9630999,21.350994217017302,37.92160695289495,0.07382130861303271,1902.4344732761383,654.3371467590332,1589.4651107788086,59834,10604,49230,49230,0,12,9631000.0
9631,9631999,21.35280413849334,37.9251314900912,0.07388257970734691,1902.7055852413177,654.4045741558075,1589.653232574463,59838,10605,49233,49233,0,12,9632000.0
9632,9632999,21.354525056372797,37.92821103770484,0.07391891295600428,1903.104008436203,654.4755990505219,1589.7617149353027,59852,10607,49245,49245,0,12,9633000.0
9633,9633999,21.35551943310999,37.92900765461609,0.07394572618356554,1903.3562641143799,654.5395367145538,1589.910717010498,59854,10608,49246,49246,0,12,9634000.0
9634,9634999,21.355734237718927,37.92913419319194,0.07394396269878334,1903.4883019924164,654.6047830581665,1590.468593597412,59861,10608,49253,49253,0,12,9635000.0
9635,9635999,21.355327329589446,37.92915774564788,0.07394253915314064,1903.613079547882,654.6685748100281,1590.7842903137207,59861,10608,49253,49253,0,12,9636000.0
9636,9636999,21.35491064439429,37.9292267045962,0.07393955833115562,1904.0119183063507,654.7340881824493,1590.9538040161133,59880,10610,49270,49270,0,12,9637000.0
9637,9637999,21.354517854752217,37.92906846721741,0.07393992977860153,1904.1303226947784,654.8021607398987,1591.1321296691895,59880,10610,49270,49270,0,12,9638000.0
9638,9638999,21.353980293358347,37.928115675506554,0.07394083454834799,1904.2519295215607,654.8694524765015,1591.4258117675781,59880,10610,49270,49270,0,12,9639000.0
9639,9639999,21.353534260717915,37.92710560953664,0.07394105000337003,1904.3714604377747,654.9329926967621,1591.616054534912,59880,10610,49270,49270,0,12,9640000.0
9640,9640999,21.353105015077066,37.926227341351826,0.07394228760684796,1904.6253352165222,654.9980480670929,1591.713607788086,59884,10611,49273,49273,0,12,9641000.0
9641,9641999,21.35271904804211,37.92743142515693,0.07393461337809248,1904.8908536434174,655.0641548633575,1591.790542602539,59896,10612,49284,49284,0,12,9642000.0
9642,9642999,21.352354758585385,37.926657648907,0.07393367635612902,1905.0118443965912,655.1287267208099,1591.946388244629,59896,10612,49284,49284,0,12,9643000.0
9643,9643999,21.35207845968792,37.92609849556227,0.07392947284113238,1905.2683582305908,655.1955745220184,1592.2816886901855,59899,10613,49286,49286,0,12,9644000.0
9644,9644999,21.351880184109163,37.927042048077865,0.07392251857308352,1905.522929430008,655.2593359947205,1592.4725227355957,59911,10614,49297,49297,0,12,9645000.0
9645,9645999,21.35153037441272,37.9262021224888,0.0739195056689963,1905.6349513530731,655.3235790729523,1592.622085571289,59911,10614,49297,49297,0,12,9646000.0
9646,9646999,21.351158963086277,37.925141347930904,0.0739190243162523,1905.762897014618,655.389004945755,1592.7270202636719,59911,10614,49297,49297,0,12,9647000.0
9647,9647999,21.350916930247188,37.924366257280674,0.07391977386151916,1906.1745653152466,655.4545910358429,1592.7626304626465,59924,10616,49308,49308,0,12,9648000.0
9648,9648999,21.35047555874812,37.923143096726534,0.07392080104615284,1906.5735652446747,655.5198295116425,1592.9045295715332,59940,10618,49322,49322,0,12,9649000.0
9649,9649999,21.349964103120087,37.92191308402585,0.07392363774839528,1906.6914670467377,655.5830113887787,1593.0153732299805,59940,10618,49322,49322,0,12,9650000.0
9650,9650999,21.349359412516108,37.920658411804816,0.07392574432957955,1906.810051202774,655.6472492218018,1593.13862991333,59940,10618,49322,49322,0,12,9651000.0
9651,9651999,21.34869699972151,37.91959192555978,0.07393144931833906,1906.9311909675598,655.7122309207916,1593.8679161071777,59946,10618,49328,49328,0,12,9652000.0
9652,9652999,21.347867121364935,37.918296846762544,0.07393823927664367,1907.0430850982666,655.7789058685303,1594.1697616577148,59946,10618,49328,49328,0,12,9653000.0
9653,9653999,21.34692801880734,37.91674201778782,0.07394699831585261,1907.299283504486,655.8436453342438,1594.329231262207,59949,10619,49330,49330,0,12,9654000.0
9654,9654999,21.346115055028132,37.9154767886131,0.0739517271122806,1907.4217855930328,655.9076907634735,1594.6742515563965,59949,10619,49330,49330,0,12,9655000.0
9655,9655999,21.34539856739902,37.914365164866936,0.07395514906913991,1907.6729834079742,655.9713623523712,1594.888584136963,59961,10620,49341,49341,0,12,9656000.0
9656,9656999,21.3446865021875,37.913166912613725,0.07396101652692855,1907.9356527328491,656.0376377105713,1595.042350769043,59964,10621,49343,49343,0,12,9657000.0
9657,9657999,21.343932805572283,37.91210580428398,0.07396541162017722,1908.0535905361176,656.1026568412781,1595.1661911010742,59964,10621,49343,49343,0,12,9658000.0
9658,9658999,21.34330745715222,37.91104769934418,0.07396778784556723,1908.1765747070312,656.167592048645,1595.281581878662,59965,10621,49344,49344,0,12,9659000.0
9659,9659999,21.342731475931313,37.90996446230378,0.07396950746377451,1908.4388558864594,656.2334575653076,1595.3772621154785,59967,10622,49345,49345,0,12,9660000.0
9660,9660999,21.342354578306175,37.90918609082684,0.07396849946599182,1908.7007927894592,656.2993953227997,1595.6254501342773,59974,10623,49351,49351,0,12,9661000.0
9661,9661999,21.341875952731584,37.908267924248825,0.07396898286740139,1908.8209648132324,656.3635289669037,1595.7811737060547,59974,10623,49351,49351,0,12,9662000.0
9662,9662999,21.341467207379175,37.90746208660816,0.07396638493617469,1909.0682587623596,656.4284842014313,1595.8468132019043,59976,10624,49352,49352,0,12,9663000.0
9663,9663999,21.341183194598987,37.90688931989851,0.07396531126525796,1909.3272483348846,656.4940235614777,1595.974681854248,59984,10625,49359,49359,0,12,9664000.0
9664,9664999,21.340875299174378,37.90625530755326,0.07396266705466947,1909.5831801891327,656.5607631206512,1596.1025276184082,59996,10626,49370,49370,0,12,9665000.0
9665,9665999,21.340576985990563,37.90575635836683,0.07395852359024746,1909.8540380001068,656.6278777122498,1596.149745941162,59998,10627,49371,49371,0,12,9666000.0
9666,9666999,21.340446483243493,37.905943449203264,0.07395114290205196,1909.9749417304993,656.6930756568909,1596.3631477355957,59998,10627,49371,49371,0,12,9667000.0
9667,9667999,21.340242772140922,37.905213887231824,0.07394944015761984,1910.098896741867,656.7571833133698,1596.485008239746,59998,10627,49371,49371,0,12,9668000.0
9668,9668999,21.33979700474362,37.90414584989681,0.07394747280390024,1910.4941022396088,656.821647644043,1596.4768753051758,60005,10629,49376,49376,0,12,9669000.0
9669,9669999,21.339275282089258,37.902988739198896,0.07394496834567865,1910.6177823543549,656.8847088813782,1596.5615158081055,60005,10629,49376,49376,0,12,9670000.0
9670,9670999,21.33861409674185,37.90168112429164,0.07394973665923732,1910.7413966655731,656.9477453231812,1597.1666374206543,60015,10629,49386,49386,0,12,9671000.0
9671,9671999,21.337727233488298,37.9004165205791,0.07395365847595947,1910.8551399707794,657.013112783432,1597.5652618408203,60018,10629,49389,49389,0,12,9672000.0
9672,9672999,21.337091008727924,37.89993726141902,0.07395209939817782,1911.1097888946533,657.0786521434784,1597.7736282348633,60022,10630,49392,49392,0,12,9673000.0
9673,9673999,21.33633439094774,37.898800205048246,0.07395575494539985,1911.2359955310822,657.143392086029,1597.939193725586,60022,10630,49392,49392,0,12,9674000.0
9674,9674999,21.335658886728986,37.89803044142218,0.07395542209519812,1911.4990618228912,657.2079496383667,1598.037612915039,60024,10631,49393,49393,0,12,9675000.0
9675,9675999,21.33502914142268,37.89689145118396,0.07395864625381865,1912.2962787151337,657.273494720459,1598.1527061462402,60046,10636,49410,49410,0,12,9676000.0
9676,9676999,21.334586817239302,37.89596462684748,0.07395419655864977,1912.8325774669647,657.3373665809631,1598.2913970947266,60052,10639,49413,49413,0,12,9677000.0
9677,9677999,21.334107759522364,37.89513815621359,0.07395039601064579,1912.9501550197601,657.4008204936981,1598.5060844421387,60053,10639,49414,49414,0,12,9678000.0
9678,9678999,21.333689458434698,37.89433502264437,0.07394907054401623,1913.214143037796,657.4675433635712,1598.5425109863281,60058,10640,49418,49418,0,12,9679000.0
9679,9679999,21.33324663468719,37.89362393747323,0.07394696617919427,1913.4709513187408,657.5315973758698,1598.6574516296387,60060,10641,49419,49419,0,12,9680000.0
9680,9680999,21.332828782342563,37.892664755032634,0.07394590849766891,1913.726157426834,657.5949296951294,1598.8854179382324,60062,10642,49420,49420,0,12,9681000.0
9681,9681999,21.332483526205714,37.891745388564544,0.07394306219990898,1914.106386423111,657.6568257808685,1598.996883392334,60068,10644,49424,49424,0,12,9682000.0
9682,9682999,21.332490275065812,37.892466986877785,0.07393171482215743,1914.2156505584717,657.7182049751282,1599.1444053649902,60068,10644,49424,49424,0,12,9683000.0
9683,9683999,21.33228760773746,37.8917469181827,0.07392712145047287,1914.3382716178894,657.7817666530609,1599.267822265625,60068,10644,49424,49424,0,12,9684000.0
9684,9684999,21.3319804757063,37.89084951310124,0.0739250062498793,1914.6032433509827,657.8488149642944,1599.324062347412,60080,10645,49435,49435,0,12,9685000.0
9685,9685999,21.331726123063333,37.88997978275446,0.07392367577300174,1914.7386181354523,657.9119081497192,1599.4129333496094,60080,10645,49435,49435,0,12,9686000.0
9686,9686999,21.331496247187822,37.88918432826352,0.07392088364660998,1914.995397567749,657.9770128726959,1599.6263885498047,60086,10646,49440,49440,0,12,9687000.0
9687,9687999,21.331422419798304,37.88863688919357,0.07391603186789042,1915.3910853862762,658.0405721664429,1599.6550788879395,60097,10648,49449,49449,0,12,9688000.0
9688,9688999,21.331269087784,37.887934134041544,0.07391282502468344,1915.6435179710388,658.1040518283844,1599.8103942871094,60099,10649,49450,49450,0,12,9689000.0
9689,9689999,21.330787738872388,37.88683520170117,0.07391046986271121,1915.9047493934631,658.1674571037292,1599.875576019287,60106,10650,49456,49456,0,12,9690000.0
9690,9690999,21.33026134289716,37.88556672221922,0.07391137971334516,1916.3006777763367,658.2307097911835,1600.059772491455,60114,10652,49462,49462,0,12,9691000.0
9691,9691999,21.329464563500526,37.88431888451971,0.07391454832940314,1916.419830083847,658.2938303947449,1600.3566055297852,60115,10652,49463,49463,0,12,9692000.0
9692,9692999,21.328713955703716,37.88307670508845,0.07391607151768953,1916.5417232513428,658.3570864200592,1600.5740852355957,60116,10652,49464,49464,0,12,9693000.0
9693,9693999,21.328236731414457,37.882578656423306,0.07391446152151893,1916.9275584220886,658.420506477356,1600.6807441711426,60134,10654,49480,49480,0,12,9694000.0
9694,9694999,21.327594090282197,37.881427216833806,0.07391538441602186,1917.19282746315,658.4844357967377,1600.887638092041,60139,10655,49484,49484,0,12,9695000.0
9695,9695999,21.327320401961853,37.880775540504025,0.07391019675468136,1917.4694759845734,658.5524492263794,1601.1559219360352,60142,10656,49486,49486,0,12,9696000.0
9696,9696999,21.326961969476585,37.87986387316955,0.07390758114123774,1917.5920424461365,658.6236820220947,1601.3429489135742,60142,10656,49486,49486,0,12,9697000.0
9697,9697999,21.326653891866442,37.879096361718666,0.07390332629792062,1917.7216753959656,658.687488079071,1601.4461822509766,60142,10656,49486,49486,0,12,9698000.0
9698,9698999,21.326291041410464,37.87837763971583,0.07390230382578378,1917.8387854099274,658.7507860660553,1601.5274238586426,60142,10656,49486,49486,0,12,9699000.0
9699,9699999,21.3258374654272,37.87724075764903,0.07390078703878766,1917.985910654068,658.8164856433868,1601.6795043945312,60142,10656,49486,49486,0,12,9700000.0
9700,9700999,21.32541336806266,37.87612873463171,0.07389635880860435,1918.2442390918732,658.8792576789856,1601.8521003723145,60146,10657,49489,49489,0,12,9701000.0
9701,9701999,21.325031651161908,37.875016749425974,0.07389352433971708,1918.3641896247864,658.9442522525787,1602.0471382141113,60146,10657,49489,49489,0,12,9702000.0
9702,9702999,21.324699195534503,37.87425519681803,0.0738889342318374,1918.6209721565247,659.0067846775055,1602.1691780090332,60158,10658,49500,49500,0,12,9703000.0
9703,9703999,21.324517934116926,37.87840223520991,0.07386537257796033,1918.8908784389496,659.0727701187134,1602.2682991027832,60170,10659,49511,49511,0,12,9704000.0
9704,9704999,21.324242883906074,37.87853645066978,0.07385806794909489,1919.1650428771973,659.1374206542969,1602.3245391845703,60182,10660,49522,49522,0,12,9705000.0
9705,9705999,21.323876129253144,37.8774307933552,0.07385377773871726,1919.559140920639,659.2008395195007,1602.417766571045,60191,10662,49529,49529,0,12,9706000.0
9706,9706999,21.323459943403073,37.876317254986056,0.07385070536231486,1919.8082234859467,659.2656688690186,1602.6467361450195,60199,10663,49536,49536,0,12,9707000.0
9707,9707999,21.323027618585932,37.875085510826246,0.0738475933778393,1920.0676262378693,659.3285717964172,1602.7454986572266,60201,10664,49537,49537,0,12,9708000.0
9708,9708999,21.32255447560515,37.87391117701826,0.07384698047651861,1920.1788439750671,659.3909223079681,1602.8763465881348,60201,10664,49537,49537,0,12,9709000.0
9709,9709999,21.322004966131757,37.872682911841366,0.07384710485805812,1920.3074913024902,659.4527516365051,1602.9416122436523,60201,10664,49537,49537,0,12,9710000.0
9710,9710999,21.321316507134622,37.87156195063516,0.07385009579556379,1920.422010421753,659.5149717330933,1603.5211601257324,60210,10664,49546,49546,0,12,9711000.0
9711,9711999,21.320368548682477,37.870233773544435,0.07385455752885972,1920.6779823303223,659.5786423683167,1603.7807350158691,60213,10665,49548,49548,0,12,9712000.0
9712,9712999,21.319455544123123,37.86904235446413,0.0738588419276508,1920.80073428154,659.6453263759613,1604.017578125,60214,10665,49549,49549,0,12,9713000.0
9713,9713999,21.318700595002646,37.868124982601884,0.07386029507910619,1920.9163568019867,659.7089612483978,1604.1626091003418,60214,10665,49549,49549,0,12,9714000.0
9714,9714999,21.318048566185404,37.86710364459744,0.07386125646255348,1921.0338053703308,659.7721784114838,1604.432357788086,60216,10665,49551,49551,0,12,9715000.0
9715,9715999,21.317486205292383,37.86602685797597,0.07386341561171028,1921.2854793071747,659.8357846736908,1604.662021636963,60228,10666,49562,49562,0,12,9716000.0
9716,9716999,21.316856954280627,37.864738963824216,0.07386650170718345,1921.536371231079,659.8994076251984,1604.853157043457,60230,10667,49563,49563,0,12,9717000.0
9717,9717999,21.316210889736105,37.86349995342561,0.07386737511836339,1922.0754635334015,659.96351313591,1604.8625106811523,60237,10670,49567,49567,0,12,9718000.0
9718,9718999,21.31566299748974,37.86253675140165,0.0738672505329887,1922.4529039859772,660.0276799201965,1604.9739456176758,60241,10672,49569,49569,0,12,9719000.0
9719,9719999,21.315128792194876,37.86148676306532,0.07386928917242197,1922.5862076282501,660.0993273258209,1605.1622886657715,60242,10672,49570,49570,0,12,9720000.0
9720,9720999,21.314816295138783,37.86079739897888,0.07386827627554504,1922.8404731750488,660.163859128952,1605.4053649902344,60244,10673,49571,49571,0,12,9721000.0
9721,9721999,21.314357293437755,37.85991702172092,0.0738729406057238,1923.2260580062866,660.228533744812,1605.4823570251465,60250,10675,49575,49575,0,12,9722000.0
9722,9722999,21.313885346840042,37.85901860825338,0.0738742509240583,1923.6291153430939,660.2940654754639,1605.555118560791,60256,10677,49579,49579,0,12,9723000.0
9723,9723999,21.3137718093905,37.85855453163168,0.07387512555502063,1924.0292620658875,660.3588800430298,1605.5715522766113,60260,10679,49581,49581,0,12,9724000.0
9724,9724999,21.31354241344949,37.8580492537359,0.07387481339523638,1924.1474046707153,660.4242792129517,1605.7692184448242,60260,10679,49581,49581,0,12,9725000.0
9725,9725999,21.31362686640436,37.85807643446465,0.07387802787376696,1924.2779054641724,660.4892106056213,1605.8712997436523,60260,10679,49581,49581,0,12,9726000.0
9726,9726999,21.31394135632543,37.85810155331188,0.07388311701739292,1924.5225939750671,660.5524663925171,1605.966064453125,60263,10680,49583,49583,0,12,9727000.0
9727,9727999,21.314403822283932,37.858542868703566,0.07388040077116198,1924.8030543327332,660.6185953617096,1605.9892578125,60266,10681,49585,49585,0,12,9728000.0
9728,9728999,21.314638077292116,37.85838821841734,0.07388160362380713,1925.0700726509094,660.6857419013977,1606.0387268066406,60275,10682,49593,49593,0,12,9729000.0
9729,9729999,21.31451011194924,37.85816512074711,0.07388025772611106,1925.4654672145844,660.7497074604034,1606.161418914795,60283,10684,49599,49599,0,12,9730000.0
9730,9730999,21.3139156971168,37.85722098619954,0.07388142611292647,1925.7245080471039,660.813568353653,1606.5789833068848,60289,10685,49604,49604,0,12,9731000.0
9731,9731999,21.31282921140826,37.85582234307946,0.07388668565362044,1925.8467211723328,660.8791935443878,1606.7879676818848,60290,10685,49605,49605,0,12,9732000.0
9732,9732999,21.311876423937928,37.85444170380298,0.07388983559916829,1926.2652606964111,660.9489054679871,1606.9191055297852,60301,10687,49614,49614,0,12,9733000.0
9733,9733999,21.310936742551238,37.85303033125165,0.07389488767061592,1926.3856406211853,661.0133457183838,1607.053237915039,60301,10687,49614,49614,0,12,9734000.0
9734,9734999,21.310064539138054,37.851805753720406,0.07389660178961677,1926.5148763656616,661.0790922641754,1607.264747619629,60301,10687,49614,49614,0,12,9735000.0
9735,9735999,21.309188313610573,37.85038934059958,0.07390052187984253,1926.9133183956146,661.1443569660187,1607.4110641479492,60317,10689,49628,49628,0,12,9736000.0
9736,9736999,21.308285878672915,37.84896768588239,0.07390417607905486,1927.1683280467987,661.2076845169067,1607.5544242858887,60329,10690,49639,49639,0,12,9737000.0
9737,9737999,21.30743056233755,37.847518911054244,0.07390658234376113,1927.291673898697,661.2749030590057,1607.6681594848633,60329,10690,49639,49639,0,12,9738000.0
9738,9738999,21.306658296447402,37.846272309241776,0.07390830873471865,1927.5626912117004,661.3390491008759,1607.7480125427246,60337,10691,49646,49646,0,12,9739000.0
9739,9739999,21.305965058373108,37.84529874653227,0.07390941106791282,1927.8177995681763,661.4039831161499,1607.8709907531738,60341,10692,49649,49649,0,12,9740000.0
9740,9740999,21.30540103780877,37.8443063264717,0.0739110004035951,1927.948322057724,661.46955037117,1608.1438903808594,60342,10692,49650,49650,0,12,9741000.0
9741,9741999,21.30493505023885,37.84335510059454,0.07391004111473765,1928.2008955478668,661.5340719223022,1608.2680625915527,60345,10693,49652,49652,0,12,9742000.0
9742,9742999,21.304384955159836,37.84230323927309,0.07390757962569339,1928.4668610095978,661.5997939109802,1608.405632019043,60347,10694,49653,49653,0,12,9743000.0
9743,9743999,21.30387332400655,37.841284491753704,0.07390493760736572,1928.6026546955109,661.6647067070007,1608.5065727233887,60347,10694,49653,49653,0,12,9744000.0
9744,9744999,21.303459034222463,37.84046055363749,0.07390064176810152,1929.0226604938507,661.7312495708466,1608.5241241455078,60356,10696,49660,49660,0,12,9745000.0
9745,9745999,21.30310804106117,37.839850955730036,0.07389860921988545,1929.412315607071,661.795627117157,1608.5618896484375,60370,10698,49672,49672,0,12,9746000.0
9746,9746999,21.30274144265765,37.83911257303338,0.07389485596050749,1929.5534279346466,661.8631615638733,1608.761074066162,60370,10698,49672,49672,0,12,9747000.0
9747,9747999,21.302448083749308,37.838172693801724,0.07389402934151568,1929.6807351112366,661.9259729385376,1608.8590240478516,60370,10698,49672,49672,0,12,9748000.0
9748,9748999,21.302070949079837,37.83735402452682,0.07389044449476223,1929.927466392517,661.9885754585266,1608.9357872009277,60372,10699,49673,49673,0,12,9749000.0
9749,9749999,21.301663784486536,37.83634746157195,0.07388918993234861,1930.1964712142944,662.0526769161224,1608.9555702209473,60377,10700,49677,49677,0,12,9750000.0
9750,9750999,21.301223123179156,37.83526445531471,0.07389003797661975,1930.451791524887,662.1159060001373,1609.3160667419434,60395,10701,49694,49694,0,12,9751000.0
9751,9751999,21.30019999715432,37.833877029422254,0.07389362013877199,1930.7098660469055,662.1806457042694,1609.513584136963,60398,10702,49696,49696,0,12,9752000.0
9752,9752999,21.299343745361128,37.83272807628744,0.07389493294460314,1930.9687826633453,662.2451465129852,1609.6544570922852,60410,10703,49707,49707,0,12,9753000.0
9753,9753999,21.29860555384286,37.83167189799208,0.07389709292004043,1931.08788728714,662.3087332248688,1609.8155975341797,60410,10703,49707,49707,0,12,9754000.0
9754,9754999,21.297846259831474,37.831271275057325,0.07389488798983368,1931.3652710914612,662.3760509490967,1609.876163482666,60412,10704,49708,49708,0,12,9755000.0
9755,9755999,21.297241668809356,37.830560799230426,0.07389068084648609,1931.7623958587646,662.4407510757446,1610.0688285827637,60417,10706,49711,49711,0,12,9756000.0
9756,9756999,21.29663250974076,37.82958881352601,0.07389068568422075,1931.884288072586,662.5046987533569,1610.2384719848633,60417,10706,49711,49711,0,12,9757000.0
9757,9757999,21.29609765388306,37.82865972409381,0.07389016280094485,1932.1484410762787,662.5691337585449,1610.3256225585938,60419,10707,49712,49712,0,12,9758000.0
9758,9758999,21.295731039895987,37.82832885847219,0.0738920001260277,1932.26389503479,662.6340003013611,1610.4261856079102,60419,10707,49712,49712,0,12,9759000.0
9759,9759999,21.29539107877793,37.82792278813586,0.07389098867640653,1932.3812246322632,662.6978597640991,1610.5441780090332,60419,10707,49712,49712,0,12,9760000.0
9760,9760999,21.29522515053042,37.827833179744694,0.07389380837066528,1932.635311126709,662.7613923549652,1610.5988960266113,60421,10708,49713,49713,0,12,9761000.0
9761,9761999,21.295274887284435,37.828418501727214,0.07389156101671923,1933.038649559021,662.8292779922485,1610.7711067199707,60427,10710,49717,49717,0,12,9762000.0
9762,9762999,21.295348361005125,37.82858279656803,0.07388815052401831,1933.1623771190643,662.8940014839172,1610.9168014526367,60427,10710,49717,49717,0,12,9763000.0
9763,9763999,21.29564252513149,37.82929346047761,0.07388085499600405,1933.2811934947968,662.9568562507629,1611.0186920166016,60427,10710,49717,49717,0,12,9764000.0
9764,9764999,21.295572018817932,37.82903513377431,0.07387913213708952,1933.398015499115,663.0217099189758,1611.1220664978027,60427,10710,49717,49717,0,12,9765000.0
9765,9765999,21.295930725617467,37.82991429906984,0.07387833663825416,1933.5170905590057,663.0846951007843,1611.2044219970703,60427,10710,49717,49717,0,12,9766000.0
9766,9766999,21.296331771404386,37.83049001416353,0.07387722822747211,1934.0514540672302,663.1516988277435,1611.3042526245117,60447,10713,49734,49734,0,12,9767000.0
9767,9767999,21.296628256959803,37.8315403006524,0.07387777515195171,1934.175800561905,663.215434551239,1611.454875946045,60448,10713,49735,49735,0,12,9768000.0
9768,9768999,21.2972501442815,37.83277855800149,0.07387996752714465,1934.2973005771637,663.2795743942261,1611.5440292358398,60448,10713,49735,49735,0,12,9769000.0
9769,9769999,21.297482486851706,37.83272593452451,0.07387941005423082,1934.4137115478516,663.3426339626312,1611.619873046875,60448,10713,49735,49735,0,12,9770000.0
9770,9770999,21.297452358572546,37.83248925204562,0.07387602966544926,1934.5270235538483,663.4037194252014,1611.7583770751953,60448,10713,49735,49735,0,12,9771000.0
9771,9771999,21.296761774599577,37.83158084492486,0.07387612196261695,1934.639948129654,663.4674832820892,1612.2687721252441,60453,10713,49740,49740,0,12,9772000.0
9772,9772999,21.29603291784695,37.83074299304044,0.0738781988118572,1934.7607197761536,663.5338988304138,1612.5013618469238,60453,10713,49740,49740,0,12,9773000.0
9773,9773999,21.29536483427177,37.82974070366832,0.07387903742288482,1934.8816986083984,663.5978357791901,1612.6663780212402,60453,10713,49740,49740,0,12,9774000.0
9774,9774999,21.29464380640204,37.82849357231026,0.07388126687920715,1935.2717761993408,663.6623759269714,1612.8896789550781,60471,10715,49756,49756,0,12,9775000.0
9775,9775999,21.29403410660724,37.827413196783226,0.07388160878856775,1935.5265424251556,663.7269015312195,1613.0816764831543,60483,10716,49767,49767,0,12,9776000.0
9776,9776999,21.2933312723128,37.826291580380754,0.07388231833785852,1935.6430265903473,663.7899391651154,1613.2366371154785,60483,10716,49767,49767,0,12,9777000.0
9777,9777999,21.29258494103811,37.82493346007796,0.07388353345217735,1935.763356924057,663.8541324138641,1613.3288230895996,60483,10716,49767,49767,0,12,9778000.0
9778,9778999,21.291925930461268,37.823753799801814,0.07388373046491459,1936.0206611156464,663.9185914993286,1613.4419746398926,60485,10717,49768,49768,0,12,9779000.0
9779,9779999,21.291273909020237,37.82272222927433,0.07388391353904267,1936.2805199623108,663.98521733284,1613.5382652282715,60487,10718,49769,49769,0,12,9780000.0
9780,9780999,21.29077001121305,37.8216555193166,0.07387803308454943,1936.3963496685028,664.0493676662445,1613.8619270324707,60488,10718,49770,49770,0,12,9781000.0
9781,9781999,21.290307777688408,37.82052953069435,0.0738697534774585,1936.5250988006592,664.1168241500854,1614.007339477539,60488,10718,49770,49770,0,12,9782000.0
9782,9782999,21.28985262097681,37.81943643970518,0.07386703930559413,1936.6561965942383,664.18137550354,1614.1106986999512,60488,10718,49770,49770,0,12,9783000.0
9783,9783999,21.289486124534342,37.8198045846317,0.07386125143310329,1936.7824499607086,664.2488467693329,1614.2230758666992,60488,10718,49770,49770,0,12,9784000.0
9784,9784999,21.289046616020457,37.81866768914751,0.07386023159922728,1936.9178483486176,664.3222692012787,1614.3405265808105,60489,10718,49771,49771,0,12,9785000.0
9785,9785999,21.28880100383703,37.81872609353701,0.07384527992093715,1937.3041064739227,664.387668132782,1614.3519592285156,60495,10720,49775,49775,0,12,9786000.0
9786,9786999,21.288486379248088,37.81781075714793,0.0738411519495914,1937.4324600696564,664.4525814056396,1614.4411888122559,60495,10720,49775,49775,0,12,9787000.0
9787,9787999,21.288184461896446,37.817703066518554,0.0738308088008971,1937.5676319599152,664.5188939571381,1614.841381072998,60499,10720,49779,49779,0,12,9788000.0
9788,9788999,21.287484407142767,37.81714366646942,0.07382874523275551,1937.6842007637024,664.5844688415527,1615.1101875305176,60500,10720,49780,49780,0,12,9789000.0
9789,9789999,21.286892090538164,37.81681644801345,0.07382985474892778,1937.942459344864,664.6525347232819,1615.2908973693848,60503,10721,49782,49782,0,12,9790000.0
9790,9790999,21.286184836571334,37.81569167891801,0.07383112838395356,1938.1926021575928,664.7173089981079,1615.4262428283691,60505,10722,49783,49783,0,12,9791000.0
9791,9791999,21.28577699650263,37.81486372134454,0.07382737349808433,1938.4528422355652,664.7813580036163,1615.6567420959473,60507,10723,49784,49784,0,12,9792000.0
9792,9792999,21.285604847180455,37.81808119918338,0.07380892593851884,1938.7251210212708,664.8476090431213,1615.8093643188477,60510,10724,49786,49786,0,12,9793000.0
9793,9793999,21.28530583290823,37.817679385643395,0.073801539749484,1939.0002880096436,664.9211237430573,1615.9122009277344,60514,10725,49789,49789,0,12,9794000.0
9794,9794999,21.28514876900344,37.81738516847205,0.073794490052839,1939.1284446716309,664.9857342243195,1616.0055694580078,60514,10725,49789,49789,0,12,9795000.0
9795,9795999,21.285028363276282,37.81783060312886,0.07379375971328128,1939.380039215088,665.050637960434,1616.0961723327637,60519,10726,49793,49793,0,12,9796000.0
9796,9796999,21.284942822969413,37.817507913086715,0.07379245057983419,1939.6275498867035,665.1144273281097,1616.1887588500977,60521,10727,49794,49794,0,12,9797000.0
9797,9797999,21.2851916871624,37.817917259338216,0.07378455428076525,1939.8835792541504,665.1782836914062,1616.4293479919434,60524,10728,49796,49796,0,12,9798000.0
9798,9798999,21.285329709494924,37.817919032604216,0.0737765362175582,1940.0084302425385,665.2431206703186,1616.5715866088867,60524,10728,49796,49796,0,12,9799000.0
9799,9799999,21.285398861577495,37.81778570750708,0.07377102836693739,1940.2713391780853,665.3086047172546,1616.6455192565918,60526,10729,49797,49797,0,12,9800000.0
9800,9800999,21.285396512081046,37.817633112465145,0.07376696930396509,1940.521348953247,665.3710188865662,1616.7375030517578,60538,10730,49808,49808,0,12,9801000.0
9801,9801999,21.285452479641716,37.81749750465981,0.07376328776277008,1940.6518642902374,665.4367773532867,1616.8280410766602,60538,10730,49808,49808,0,12,9802000.0
9802,9802999,21.28562227016673,37.81748054375232,0.07375735490154955,1940.7677698135376,665.5009026527405,1616.9919776916504,60538,10730,49808,49808,0,12,9803000.0
9803,9803999,21.285776150083592,37.8173588586935,0.07375095589347924,1940.8872137069702,665.5656373500824,1617.0971450805664,60538,10730,49808,49808,0,12,9804000.0
9804,9804999,21.285867135720085,37.817029511432935,0.07374465664415186,1941.021033525467,665.6292021274567,1617.1904487609863,60539,10730,49809,49809,0,12,9805000.0
9805,9805999,21.285743645538194,37.816289607567256,0.07373693077050525,1941.1393821239471,665.692854642868,1617.245204925537,60539,10730,49809,49809,0,12,9806000.0
9806,9806999,21.285482563693066,37.8154078593178,0.07373521927749294,1941.6774997711182,665.7574248313904,1617.4181594848633,60572,10733,49839,49839,0,12,9807000.0
9807,9807999,21.284583722407056,37.814296716244094,0.07373824178108945,1941.7916691303253,665.8213851451874,1617.862720489502,60575,10733,49842,49842,0,12,9808000.0
9808,9808999,21.283841034055545,37.8133359927151,0.07373657889045349,1942.1781339645386,665.8869659900665,1618.0233421325684,60595,10735,49860,49860,0,12,9809000.0
9809,9809999,21.283456933811365,37.813422973318204,0.07372607004168674,1942.2976517677307,665.9521055221558,1618.2173690795898,60595,10735,49860,49860,0,12,9810000.0
9810,9810999,21.282960135772672,37.81317785816394,0.07372096870862366,1942.5611989498138,666.0168099403381,1618.2809028625488,60599,10736,49863,49863,0,12,9811000.0
9811,9811999,21.282709116005606,37.81271731971781,0.07371435387889436,1942.9706768989563,666.0818936824799,1618.5398635864258,60609,10738,49871,49871,0,12,9812000.0
9812,9812999,21.282356436611604,37.81201645473711,0.07371031108216364,1943.2232015132904,666.1471445560455,1618.6994972229004,60612,10739,49873,49873,0,12,9813000.0
9813,9813999,21.282242660359294,37.81229670249977,0.07370152896831306,1943.6250629425049,666.2132635116577,1618.7855262756348,60626,10741,49885,49885,0,12,9814000.0
9814,9814999,21.282267399144153,37.81249032180443,0.07369896649151164,1943.738416671753,666.2750895023346,1618.944076538086,60627,10741,49886,49886,0,12,9815000.0
9815,9815999,21.282408473722203,37.813063295868695,0.07369564629331471,1943.8762862682343,666.3485202789307,1619.0610885620117,60627,10741,49886,49886,0,12,9816000.0
9816,9816999,21.282624677158775,37.81361409087881,0.07368791601051305,1943.9914333820343,666.4118132591248,1619.1474571228027,60627,10741,49886,49886,0,12,9817000.0
9817,9817999,21.282898612511264,37.81438149885613,0.07368425291136704,1944.5325360298157,666.4763116836548,1619.255771636963,60636,10744,49892,49892,0,12,9818000.0
9818,9818999,21.283019706744817,37.814643436713844,0.07367765018047023,1944.7988061904907,666.5430018901825,1619.379051208496,60638,10745,49893,49893,0,12,9819000.0
9819,9819999,21.283100322019802,37.81463594737118,0.07368049051693704,1944.9260382652283,666.606202840805,1619.4743003845215,60638,10745,49893,49893,0,12,9820000.0
9820,9820999,21.283195489921457,37.81472332208131,0.07367572737859396,1945.0366895198822,666.669406414032,1619.5752639770508,60638,10745,49893,49893,0,12,9821000.0
9821,9821999,21.28326874530787,37.81467438272571,0.0736722131841715,1945.4356198310852,666.7331955432892,1619.6159896850586,60642,10747,49895,49895,0,12,9822000.0
9822,9822999,21.283414103108,37.81476279242078,0.07366368291365832,1945.5580248832703,666.7975668907166,1619.7522506713867,60642,10747,49895,49895,0,12,9823000.0
9823,9823999,21.283624308105914,37.8148869575475,0.07365400893300711,1945.8164432048798,666.8626129627228,1619.7780113220215,60644,10748,49896,49896,0,12,9824000.0
9824,9824999,21.283714540784292,37.814789227137844,0.07364384375039235,1945.9392669200897,666.9257891178131,1619.887191772461,60644,10748,49896,49896,0,12,9825000.0
9825,9825999,21.28375337145681,37.814534615419745,0.07363166500967289,1946.2031190395355,666.9890403747559,1619.9102058410645,60646,10749,49897,49897,0,12,9826000.0
9826,9826999,21.283686776804384,37.8141596493141,0.07362378741226139,1946.3249471187592,667.0526485443115,1620.1261291503906,60646,10749,49897,49897,0,12,9827000.0
9827,9827999,21.28277199723369,37.81283239614216,0.07362794097575331,1946.5784339904785,667.1160998344421,1620.3999214172363,60650,10750,49900,49900,0,12,9828000.0
9828,9828999,21.28190330735222,37.81179166542593,0.07363268460036265,1946.8318452835083,667.1800754070282,1620.5834197998047,60653,10751,49902,49902,0,12,9829000.0
9829,9829999,21.281035359008783,37.81068826832266,0.0736354492959056,1947.2250046730042,667.246012210846,1620.7445945739746,60660,10753,49907,49907,0,12,9830000.0
9830,9830999,21.280217850085283,37.80929919890521,0.07363851811747613,1947.3502736091614,667.3102519512177,1620.9181938171387,60660,10753,49907,49907,0,12,9831000.0
9831,9831999,21.27944889984,37.808050430351244,0.0736407637620996,1947.6012279987335,667.3741528987885,1621.1320571899414,60665,10754,49911,49911,0,12,9832000.0
9832,9832999,21.278672910881397,37.80665158065538,0.07364346239147757,1947.7248795032501,667.4390549659729,1621.308006286621,60665,10754,49911,49911,0,12,9833000.0
9833,9833999,21.277889546708927,37.805414498601664,0.07364413729712027,1947.840413570404,667.5020534992218,1621.4246978759766,60665,10754,49911,49911,0,12,9834000.0
9834,9834999,21.277172256137106,37.80407512616944,0.07364450970945102,1947.9693894386292,667.566014289856,1621.5421524047852,60667,10754,49913,49913,0,12,9835000.0
9835,9835999,21.276431002104278,37.80274752655473,0.07364649375569476,1948.2362406253815,667.6294887065887,1621.6364974975586,60680,10755,49925,49925,0,12,9836000.0
9836,9836999,21.275855325667443,37.801737611600196,0.07364549359236894,1948.3480203151703,667.6923534870148,1621.8584480285645,60682,10755,49927,49927,0,12,9837000.0
9837,9837999,21.275386251441176,37.80082837072323,0.07364261648869974,1948.4712908267975,667.7553279399872,1621.9777488708496,60682,10755,49927,49927,0,12,9838000.0
9838,9838999,21.275011681678922,37.79998471030509,0.07364391942607695,1948.59836602211,667.8180420398712,1622.079189300537,60682,10755,49927,49927,0,12,9839000.0
9839,9839999,21.27455948056731,37.79899842732813,0.0736426404830599,1948.8597567081451,667.8806471824646,1622.115737915039,60684,10756,49928,49928,0,12,9840000.0
9840,9840999,21.274068924749,37.79797769307345,0.07364237974369592,1949.2597420215607,667.9451270103455,1622.111499786377,60692,10758,49934,49934,0,12,9841000.0
9841,9841999,21.273706278710495,37.79707503764003,0.0736431273357202,1949.5330908298492,668.0113759040833,1622.193172454834,60696,10759,49937,49937,0,12,9842000.0
9842,9842999,21.2737167480607,37.79687895262911,0.07364013436228001,1949.6520352363586,668.0739593505859,1622.3534469604492,60697,10759,49938,49938,0,12,9843000.0
9843,9843999,21.273791063934038,37.79651208341195,0.07364814774855988,1950.194296836853,668.1422669887543,1622.3657112121582,60704,10762,49942,49942,0,12,9844000.0
9844,9844999,21.27387539966547,37.79618721153915,0.07366226615332427,1950.3174903392792,668.206728219986,1622.4980506896973,60704,10762,49942,49942,0,12,9845000.0
9845,9845999,21.27384124070274,37.795703573237226,0.07367204585722875,1950.4351029396057,668.268317937851,1622.5835266113281,60704,10762,49942,49942,0,12,9846000.0
9846,9846999,21.27331423721093,37.79471110330966,0.07367325170148897,1950.8301994800568,668.3331818580627,1622.9155044555664,60727,10764,49963,49963,0,12,9847000.0
9847,9847999,21.272560829256943,37.79377636905658,0.07367929492381597,1950.9451446533203,668.3972344398499,1623.1491813659668,60727,10764,49963,49963,0,12,9848000.0
9848,9848999,21.271922897647404,37.79262256410921,0.07368001897635634,1951.0625784397125,668.4611704349518,1623.3523139953613,60728,10764,49964,49964,0,12,9849000.0
9849,9849999,21.271656858035584,37.79223358913992,0.07367553921769698,1951.458069562912,668.5253014564514,1623.383228302002,60732,10766,49966,49966,0,12,9850000.0
9850,9850999,21.271182946041094,37.791211823585826,0.07367772027467523,1951.5813481807709,668.5903263092041,1623.595718383789,60732,10766,49966,49966,0,12,9851000.0
9851,9851999,21.271082618205714,37.7907219669461,0.07367162963387486,1951.8365952968597,668.6547827720642,1623.7580757141113,60734,10767,49967,49967,0,12,9852000.0
9852,9852999,21.27092855261313,37.79015472790593,0.07366844623826019,1952.1016092300415,668.7192986011505,1623.8891716003418,60738,10768,49970,49970,0,12,9853000.0
9853,9853999,21.270718554165867,37.78953518286463,0.07366854256887245,1952.5015950202942,668.7831709384918,1623.978256225586,60744,10770,49974,49974,0,12,9854000.0
9854,9854999,21.27057908048884,37.78893065284876,0.07366533516545393,1952.6170637607574,668.8473379611969,1624.1157035827637,60744,10770,49974,49974,0,12,9855000.0
9855,9855999,21.270312639759727,37.788147751003265,0.07366696440159759,1952.7306861877441,668.910231590271,1624.2496223449707,60744,10770,49974,49974,0,12,9856000.0
9856,9856999,21.270082547666842,37.787339467542324,0.07366373374087687,1953.1308906078339,668.9750406742096,1624.3432159423828,60748,10772,49976,49976,0,12,9857000.0
9857,9857999,21.269860240584787,37.78644593898256,0.07366279950241661,1953.5252487659454,669.0391137599945,1624.3928413391113,60753,10774,49979,49979,0,12,9858000.0
9858,9858999,21.269717652053142,37.7856092069308,0.07365903952428154,1954.0767459869385,669.1037590503693,1624.4345054626465,60779,10777,50002,50002,0,12,9859000.0
9859,9859999,21.26956341293642,37.78486481253755,0.07365751453388902,1954.606389760971,669.1685101985931,1624.4716186523438,60795,10780,50015,50015,0,12,9860000.0
9860,9860999,21.26955163091211,37.78686260223045,0.07364611200100879,1955.0008263587952,669.2328820228577,1624.6125297546387,60802,10782,50020,50020,0,12,9861000.0
9861,9861999,21.26937507381037,37.78596768998064,0.07364333775617338,1955.2563591003418,669.2993543148041,1624.7313499450684,60807,10783,50024,50024,0,12,9862000.0
9862,9862999,21.269425175657723,37.78520463205484,0.07363040376284335,1955.6585822105408,669.3642673492432,1624.9002876281738,60814,10785,50029,50029,0,12,9863000.0
9863,9863999,21.269665533018703,37.784843005720035,0.07361736516529727,1956.1878008842468,669.4280912876129,1624.9245491027832,60825,10788,50037,50037,0,12,9864000.0
9864,9864999,21.269613116649605,37.784027041989084,0.07360889062485942,1956.3006546497345,669.4918537139893,1625.1120681762695,60825,10788,50037,50037,0,12,9865000.0
9865,9865999,21.26935746374794,37.78311998594707,0.07360586259997792,1956.7025516033173,669.5564987659454,1625.167781829834,60831,10790,50041,50041,0,12,9866000.0
9866,9866999,21.269005745613754,37.783027274993316,0.0736023747657586,1956.8183236122131,669.619957447052,1625.6735534667969,60841,10790,50051,50051,0,12,9867000.0
9867,9867999,21.26840156933815,37.78185594229791,0.07359977556179587,1956.9324502944946,669.6835145950317,1625.9514694213867,60842,10790,50052,50052,0,12,9868000.0
9868,9868999,21.267784905332565,37.78059299807069,0.07359660928366196,1957.0578045845032,669.7475926876068,1626.1630554199219,60844,10790,50054,50054,0,12,9869000.0
9869,9869999,21.267164813339605,37.779417359857746,0.0735942299886514,1957.319417476654,669.8112640380859,1626.249668121338,60848,10791,50057,50057,0,12,9870000.0
9870,9870999,21.266524272353855,37.77897146052852,0.07359075348216404,1957.4320662021637,669.8757736682892,1626.5036964416504,60850,10791,50059,50059,0,12,9871000.0
9871,9871999,21.265980786926516,37.777890422951096,0.07358794674318259,1957.699597120285,669.9420976638794,1626.655933380127,60852,10792,50060,50060,0,12,9872000.0
9872,9872999,21.265462627739705,37.7768058603768,0.07358275470765974,1957.9651572704315,670.0092010498047,1626.7414245605469,60854,10793,50061,50061,0,12,9873000.0
9873,9873999,21.264968518265277,37.776058046980616,0.07357689861920291,1958.0847194194794,670.0749821662903,1626.8778991699219,60854,10793,50061,50061,0,12,9874000.0
9874,9874999,21.264482027609176,37.774912236565235,0.07357104067749509,1958.3464472293854,670.1397361755371,1626.9303855895996,60856,10794,50062,50062,0,12,9875000.0
9875,9875999,21.26408646671054,37.77433277968266,0.07356210430434418,1958.6094524860382,670.2050206661224,1626.9901657104492,60860,10795,50065,50065,0,12,9876000.0
9876,9876999,21.26390568249706,37.77362067726915,0.07354412037689795,1958.8639931678772,670.2696585655212,1627.2268753051758,60864,10796,50068,50068,0,12,9877000.0
9877,9877999,21.264027953247634,37.77342962356986,0.07351732168188274,1959.2772588729858,670.3406915664673,1627.3045196533203,60868,10798,50070,50070,0,12,9878000.0
9878,9878999,21.26395105982529,37.77292067467361,0.07350302640002271,1959.4022977352142,670.4061522483826,1627.4750480651855,60868,10798,50070,50070,0,12,9879000.0
9879,9879999,21.263941736608814,37.77222100923655,0.07348749837736968,1959.7989447116852,670.4718656539917,1627.5112800598145,60872,10800,50072,50072,0,12,9880000.0
9880,9880999,21.264014511361864,37.772582190930734,0.0734688660859486,1960.0587587356567,670.536474943161,1627.6497688293457,60874,10801,50073,50073,0,12,9881000.0
9881,9881999,21.264213320489112,37.77214739116989,0.07344506394497896,1960.7282741069794,670.6014685630798,1627.6410751342773,60882,10805,50077,50077,0,12,9882000.0
9882,9882999,21.264367582103624,37.7715268074887,0.073428364421948,1960.8398699760437,670.6666569709778,1627.9415893554688,60884,10805,50079,50079,0,12,9883000.0
9883,9883999,21.26457159032891,37.771063621805254,0.07341097540847152,1960.9518282413483,670.7343084812164,1628.083782196045,60884,10805,50079,50079,0,12,9884000.0
9884,9884999,21.26458020790231,37.77025879629486,0.07339857930801474,1961.3460931777954,670.7981321811676,1628.1584167480469,60889,10807,50082,50082,0,12,9885000.0
9885,9885999,21.264601678382704,37.76953141862543,0.07339049768570827,1961.7422044277191,670.8618357181549,1628.1425552368164,60893,10809,50084,50084,0,12,9886000.0
9886,9886999,21.264241444137543,37.769054864581165,0.07338260693435206,1962.1401727199554,670.9253671169281,1628.4684600830078,60901,10811,50090,50090,0,12,9887000.0
9887,9887999,21.263579008709083,37.76925691502458,0.07337161247200019,1962.536810874939,670.9932146072388,1628.6661338806152,60915,10813,50102,50102,0,12,9888000.0
9888,9888999,21.262926247284998,37.76805972170253,0.07336588566669267,1962.6600549221039,671.0584218502045,1628.9008750915527,60915,10813,50102,50102,0,12,9889000.0
9889,9889999,21.26227814118371,37.766953471657686,0.07336541666768048,1962.7815718650818,671.1219758987427,1629.0725173950195,60915,10813,50102,50102,0,12,9890000.0
9890,9890999,21.261599864600786,37.76578195907109,0.07336398653788545,1962.914383172989,671.1888954639435,1629.222110748291,60916,10813,50103,50103,0,12,9891000.0
9891,9891999,21.261127834054804,37.764774038147024,0.07336279498282561,1963.1757144927979,671.255115032196,1629.4604530334473,60919,10814,50105,50105,0,12,9892000.0
9892,9892999,21.2606618335535,37.76365285301271,0.07336100045084082,1963.4457409381866,671.3228640556335,1629.5995254516602,60926,10815,50111,50111,0,12,9893000.0
9893,9893999,21.260488976576244,37.764174894211486,0.07335183369591214,1963.5681648254395,671.3910813331604,1629.7188911437988,60926,10815,50111,50111,0,12,9894000.0
9894,9894999,21.260236050842554,37.76358830872219,0.07335397878958072,1963.6829941272736,671.4574728012085,1629.8269729614258,60927,10815,50112,50112,0,12,9895000.0
9895,9895999,21.260008509341844,37.76298633968838,0.07335853670693027,1964.2530851364136,671.5267901420593,1629.7976036071777,60935,10818,50117,50117,0,12,9896000.0
9896,9896999,21.260128134074368,37.76309686119677,0.07336227379311877,1964.791365146637,671.5936698913574,1629.8154792785645,60963,10821,50142,50142,0,12,9897000.0
9897,9897999,21.260641840897577,37.763761342839466,0.07336775867901091,1964.9092545509338,671.6588695049286,1630.071460723877,60963,10821,50142,50142,0,12,9898000.0
9898,9898999,21.261241611131418,37.76531458145151,0.07336327950371191,1965.1732814311981,671.7245197296143,1630.1480102539062,60965,10822,50143,50143,0,12,9899000.0
9899,9899999,21.261844818263853,37.76632929060233,0.07337163402201174,1965.4262988567352,671.7896795272827,1630.2310600280762,60968,10823,50145,50145,0,12,9900000.0
9900,9900999,21.262505035009678,37.76849285713559,0.07337093192762623,1965.6985611915588,671.855021238327,1630.2962074279785,60972,10824,50148,50148,0,12,9901000.0
9901,9901999,21.26319678236151,37.76918697884367,0.07339442132591689,1965.9657480716705,671.9210424423218,1630.3322639465332,60974,10825,50149,50149,0,12,9902000.0
9902,9902999,21.263916783245776,37.76985514247675,0.07340664885769888,1966.0895841121674,671.9856362342834,1630.4987678527832,60974,10825,50149,50149,0,12,9903000.0
9903,9903999,21.264763161351954,37.77058027616046,0.07340581719398864,1966.4969623088837,672.0503599643707,1630.625202178955,60984,10827,50157,50157,0,12,9904000.0
9904,9904999,21.265698298378567,37.772024122246314,0.07340716391078284,1966.6249127388,672.1157550811768,1630.7414627075195,60984,10827,50157,50157,0,12,9905000.0
9905,9905999,21.266495006805282,37.772525202944855,0.07341310827113134,1966.74311709404,672.1791753768921,1630.8295822143555,60984,10827,50157,50157,0,12,9906000.0
9906,9906999,21.26690499880204,37.772613846981734,0.07340736020752481,1966.8565797805786,672.2432384490967,1630.9322052001953,60984,10827,50157,50157,0,12,9907000.0
9907,9907999,21.266244446722716,37.77178648524325,0.07340767849843699,1967.116736650467,672.3087575435638,1631.4822235107422,60993,10828,50165,50165,0,12,9908000.0
9908,9908999,21.265499976250712,37.77069474504319,0.07340972961577596,1967.240555524826,672.3742682933807,1631.6950492858887,60993,10828,50165,50165,0,12,9909000.0
9909,9909999,21.264933618441948,37.7700220724755,0.07341162637244047,1967.505927324295,672.4398748874664,1631.7748413085938,60996,10829,50167,50167,0,12,9910000.0
9910,9910999,21.264295532644518,37.76901740062105,0.07341419475053934,1967.6261959075928,672.5051295757294,1631.9526824951172,60996,10829,50167,50167,0,12,9911000.0
9911,9911999,21.263662843928284,37.767742040062316,0.07341731221677217,1967.884771823883,672.5710866451263,1632.2735557556152,60999,10830,50169,50169,0,12,9912000.0
9912,9912999,21.262994025176052,37.76648487776672,0.07341787410147216,1968.0048563480377,672.6364696025848,1632.4560585021973,60999,10830,50169,50169,0,12,9913000.0
9913,9913999,21.262447087316673,37.76610758550052,0.07341551637701815,1968.2655210494995,672.7013928890228,1632.4979820251465,61003,10831,50172,50172,0,12,9914000.0
9914,9914999,21.261813464926245,37.765080420582464,0.07341640555061557,1968.3833031654358,672.7670776844025,1632.6349601745605,61003,10831,50172,50172,0,12,9915000.0
9915,9915999,21.261130075712263,37.7638747754251,0.07341873629433338,1968.7833397388458,672.8320891857147,1632.7118911743164,61012,10833,50179,50179,0,12,9916000.0
9916,9916999,21.260636152328342,37.762813036245994,0.07341931480969299,1969.0442595481873,672.898898601532,1632.9367561340332,61015,10834,50181,50181,0,12,9917000.0
9917,9917999,21.26011665353746,37.76189070169009,0.07341818143890189,1969.58540391922,672.964625120163,1632.9893417358398,61027,10837,50190,50190,0,12,9918000.0
9918,9918999,21.25975442486616,37.76114923503958,0.07341738635634432,1969.7081935405731,673.0295512676239,1633.1305847167969,61027,10837,50190,50190,0,12,9919000.0
9919,9919999,21.259373093166943,37.76003438071004,0.07341981119152952,1969.9751279354095,673.094211101532,1633.1925582885742,61029,10838,50191,50191,0,12,9920000.0
9920,9920999,21.259065489753056,37.75915819120269,0.0734178127135392,1970.382404088974,673.1598582267761,1633.2513847351074,61033,10840,50193,50193,0,12,9921000.0
9921,9921999,21.258697288377405,37.758008184361046,0.07341740873560731,1970.503352880478,673.2252266407013,1633.4965171813965,61034,10840,50194,50194,0,12,9922000.0
9922,9922999,21.25822676478147,37.75678818309545,0.07342131272080576,1970.7732782363892,673.2908325195312,1633.5745964050293,61036,10841,50195,50195,0,12,9923000.0
9923,9923999,21.257636656412142,37.75557985743139,0.07342574643072919,1971.02689743042,673.3549838066101,1633.7053337097168,61039,10842,50197,50197,0,12,9924000.0
9924,9924999,21.256844435067205,37.754261619170386,0.07342631257303456,1971.2913086414337,673.420786857605,1634.2038612365723,61044,10843,50201,50201,0,12,9925000.0
9925,9925999,21.25619493779654,37.753226171680275,0.07342765811832608,1971.4118440151215,673.4879653453827,1634.42679977417,61045,10843,50202,50202,0,12,9926000.0
9926,9926999,21.255511278611674,37.752309117693024,0.07343024147568078,1971.665165424347,673.552182674408,1634.5903968811035,61048,10844,50204,50204,0,12,9927000.0
9927,9927999,21.254809365586997,37.75098087788085,0.07343301324939577,1971.938396692276,673.6195816993713,1634.8019409179688,61053,10845,50208,50208,0,12,9928000.0
9928,9928999,21.25419537260012,37.74976737599665,0.07343398640526033,1972.061782836914,673.685604095459,1635.0256271362305,61053,10845,50208,50208,0,12,9929000.0
9929,9929999,21.253502477815292,37.74852248241655,0.07343536374362136,1972.4620213508606,673.752507686615,1635.0521430969238,61069,10847,50222,50222,0,12,9930000.0
9930,9930999,21.25284016076357,37.74728501489509,0.07343848691402632,1972.587988615036,673.8193306922913,1635.194004058838,61069,10847,50222,50222,0,12,9931000.0
9931,9931999,21.25226906703902,37.746200731776796,0.07343655651771375,1972.9916718006134,673.8864538669586,1635.2533836364746,61074,10849,50225,50225,0,12,9932000.0
9932,9932999,21.251716302167402,37.745230313650204,0.07343514528180639,1973.406397819519,673.9551825523376,1635.3316688537598,61088,10851,50237,50237,0,12,9933000.0
9933,9933999,21.251439372833527,37.744466663700564,0.073432079066577,1973.677994966507,674.0214784145355,1635.5342826843262,61091,10852,50239,50239,0,12,9934000.0
9934,9934999,21.25135203067884,37.743936333603706,0.07342740103511725,1974.0832288265228,674.0878400802612,1635.6087799072266,61105,10854,50251,50251,0,12,9935000.0
9935,9935999,21.25118191979495,37.74365075661487,0.0734252861689586,1974.3616054058075,674.1571068763733,1635.7088737487793,61109,10855,50254,50254,0,12,9936000.0
9936,9936999,21.251093166874245,37.74319514282122,0.07342162849829392,1974.622317790985,674.2231471538544,1635.7743835449219,61113,10856,50257,50257,0,12,9937000.0
9937,9937999,21.251103336767518,37.742975383862465,0.07341902417522794,1974.8935461044312,674.2907814979553,1635.817527770996,61124,10857,50267,50267,0,12,9938000.0
9938,9938999,21.25136161322266,37.74299570610306,0.07341552543265462,1975.3048841953278,674.3574404716492,1635.8817596435547,61130,10859,50271,50271,0,12,9939000.0
9939,9939999,21.251632088181253,37.74320659131434,0.07340959084012022,1975.4415481090546,674.4223251342773,1636.0579872131348,61131,10859,50272,50272,0,12,9940000.0
9940,9940999,21.251753720272536,37.742986994019006,0.0734047603735114,1975.5714983940125,674.4887595176697,1636.1656494140625,61131,10859,50272,50272,0,12,9941000.0
9941,9941999,21.251942582021268,37.743286337382045,0.07339881877229648,1975.7009665966034,674.5556831359863,1636.249740600586,61131,10859,50272,50272,0,12,9942000.0
9942,9942999,21.25180711644452,37.74258549923065,0.07339436829396906,1975.9613490104675,674.6211912631989,1636.2909469604492,61135,10860,50275,50275,0,12,9943000.0
9943,9943999,21.251183888182606,37.74164445607096,0.07339238999455333,1976.2185790538788,674.686500787735,1636.8716163635254,61142,10861,50281,50281,0,12,9944000.0
9944,9944999,21.250309553705176,37.74052461722629,0.07339367455299672,1976.3332421779633,674.7513103485107,1637.20170211792,61142,10861,50281,50281,0,12,9945000.0
9945,9945999,21.24956129878892,37.73963425874291,0.07339386212092891,1976.4501583576202,674.8163802623749,1637.4429740905762,61144,10861,50283,50283,0,12,9946000.0
9946,9946999,21.248733857898277,37.73828882204658,0.07339587932331659,1976.866371870041,674.8839066028595,1637.4598808288574,61152,10863,50289,50289,0,12,9947000.0
9947,9947999,21.24805162442145,37.737144649631816,0.07339507780782983,1977.1298406124115,674.951452255249,1637.773307800293,61155,10864,50291,50291,0,12,9948000.0
9948,9948999,21.247393664549143,37.73600007891074,0.07339252959063236,1977.6949591636658,675.0205211639404,1637.8903465270996,61166,10867,50299,50299,0,12,9949000.0
9949,9949999,21.24678822848825,37.734945235304174,0.07339028664515002,1978.2451491355896,675.0865087509155,1638.0177154541016,61184,10870,50314,50314,0,12,9950000.0
9950,9950999,21.246202765292956,37.734016177645664,0.0733885662053202,1978.3721730709076,675.1522762775421,1638.2061042785645,61186,10870,50316,50316,0,12,9951000.0
9951,9951999,21.24574897626504,37.733575988923434,0.07338445606686828,1978.7946434020996,675.2186596393585,1638.2820320129395,61201,10872,50329,50329,0,12,9952000.0
9952,9952999,21.245208409548937,37.73276020405128,0.07338367873929275,1979.0574107170105,675.2831194400787,1638.3915557861328,61204,10873,50331,50331,0,12,9953000.0
9953,9953999,21.244761316110196,37.731808778989105,0.07338350341010602,1979.3245713710785,675.3485763072968,1638.671817779541,61209,10874,50335,50335,0,12,9954000.0
9954,9954999,21.244579955195476,37.73130833041725,0.07338107401933724,1979.585254907608,675.4150958061218,1638.8266410827637,61211,10875,50336,50336,0,12,9955000.0
9955,9955999,21.24430652322071,37.730518945451635,0.07337959335590793,1979.7036201953888,675.480541229248,1638.9775581359863,61211,10875,50336,50336,0,12,9956000.0
9956,9956999,21.24404366623995,37.730105094900644,0.07337532781990874,1980.4024662971497,675.5455009937286,1638.9619979858398,61221,10879,50342,50342,0,12,9957000.0
9957,9957999,21.24377764176327,37.72941017781233,0.07337325655634563,1981.0842673778534,675.6101222038269,1638.97900390625,61249,10883,50366,50366,0,12,9958000.0
9958,9958999,21.24358279708897,37.728947296464526,0.07337191169693402,1981.2029626369476,675.6747014522552,1639.1366081237793,61249,10883,50366,50366,0,12,9959000.0
9959,9959999,21.243526350610225,37.72831211780586,0.0733676507606611,1981.4630448818207,675.7413129806519,1639.3830337524414,61252,10884,50368,50368,0,12,9960000.0
9960,9960999,21.243297614373397,37.727385108279016,0.07336353574601595,1981.7308642864227,675.8053157329559,1639.485008239746,61254,10885,50369,50369,0,12,9961000.0
9961,9961999,21.24308793856151,37.72664432495277,0.07336133797067512,1982.135717868805,675.8697471618652,1639.5563621520996,61258,10887,50371,50371,0,12,9962000.0
9962,9962999,21.242748382969403,37.725697524860834,0.0733591182118356,1982.399603843689,675.9323787689209,1639.6511573791504,61270,10888,50382,50382,0,12,9963000.0
9963,9963999,21.24210509559236,37.724594033947064,0.07336090225561664,1982.6592411994934,675.9975616931915,1640.1934204101562,61285,10889,50396,50396,0,12,9964000.0
9964,9964999,21.241091621893016,37.72311497229188,0.07336533894087238,1982.9128947257996,676.0612752437592,1640.4467658996582,61288,10890,50398,50398,0,12,9965000.0
9965,9965999,21.2401634012759,37.72184347172079,0.0733682193888916,1983.027284860611,676.1262023448944,1640.6649856567383,61288,10890,50398,50398,0,12,9966000.0
9966,9966999,21.239292700484814,37.72061467789112,0.07337077035700579,1983.1600790023804,676.1899626255035,1640.816421508789,61288,10890,50398,50398,0,12,9967000.0
9967,9967999,21.238588915150995,37.719891658983414,0.07336856614211074,1983.4118628501892,676.2538530826569,1641.0191841125488,61301,10891,50410,50410,0,12,9968000.0
9968,9968999,21.237824194841945,37.71859026630661,0.07337018325058509,1983.6728019714355,676.317334651947,1641.233715057373,61303,10892,50411,50411,0,12,9969000.0
9969,9969999,21.237051398721412,37.717233894710645,0.07337226943666597,1984.0630867481232,676.3817563056946,1641.317123413086,61317,10894,50423,50423,0,12,9970000.0
9970,9970999,21.236422659236755,37.71643533868067,0.07337185999351536,1984.3436012268066,676.4470729827881,1641.414981842041,61321,10895,50426,50426,0,12,9971000.0
9971,9971999,21.235852166267854,37.715409193181834,0.07337229118808941,1984.4570410251617,676.5104541778564,1641.5358352661133,61321,10895,50426,50426,0,12,9972000.0
9972,9972999,21.23541097690697,37.71480279344297,0.0733694213287398,1984.5819759368896,676.5781705379486,1641.6895217895508,61321,10895,50426,50426,0,12,9973000.0
9973,9973999,21.235173880582146,37.71466421713848,0.07336983047862189,1984.7045958042145,676.6424806118011,1641.9596710205078,61322,10895,50427,50427,0,12,9974000.0
9974,9974999,21.23485732133193,37.713967208882764,0.07337261016906249,1984.9598367214203,676.7074699401855,1642.0980796813965,61325,10896,50429,50429,0,12,9975000.0
9975,9975999,21.23470454181814,37.71356502918642,0.07337284036157588,1985.3806941509247,676.7725443840027,1642.117115020752,61330,10898,50432,50432,0,12,9976000.0
9976,9976999,21.235052527694908,37.71426821675873,0.07336823879406829,1985.497915506363,676.8378033638,1642.2529067993164,61330,10898,50432,50432,0,12,9977000.0
9977,9977999,21.235463151333406,37.715268607279675,0.07337210776126257,1985.6246085166931,676.9013702869415,1642.391357421875,61330,10898,50432,50432,0,12,9978000.0
9978,9978999,21.23617159589092,37.71660872671905,0.07337443151048728,1985.8898782730103,676.9662036895752,1642.4448471069336,61334,10899,50435,50435,0,12,9979000.0
9979,9979999,21.237015814466154,37.71758339784599,0.07337908199800292,1986.0096995830536,677.0306186676025,1642.8046951293945,61337,10899,50438,50438,0,12,9980000.0
9980,9980999,21.237729909199448,37.71831349100797,0.07338639139953185,1986.2636206150055,677.0936734676361,1642.8906478881836,61339,10900,50439,50439,0,12,9981000.0
9981,9981999,21.238811857384487,37.71962058452753,0.0733978382615279,1986.6592190265656,677.1586775779724,1642.996784210205,61353,10902,50451,50451,0,12,9982000.0
9982,9982999,21.23931761165607,37.719927043365665,0.07340393646542509,1987.0576758384705,677.2235000133514,1643.0265998840332,61358,10904,50454,50454,0,12,9983000.0
9983,9983999,21.238782708948662,37.71904038424232,0.07340823114601469,1987.3189947605133,677.2908489704132,1643.5537109375,61368,10905,50463,50463,0,12,9984000.0
9984,9984999,21.238024903467007,37.718137084138526,0.07340874206236714,1987.6009848117828,677.3577926158905,1643.7195434570312,61374,10906,50468,50468,0,12,9985000.0
9985,9985999,21.237191690894107,37.71687561612514,0.07341030642806778,1987.712777853012,677.4202661514282,1643.9501037597656,61374,10906,50468,50468,0,12,9986000.0
9986,9986999,21.236382430902193,37.71551804366202,0.07341350823496129,1988.239037513733,677.4839463233948,1644.0034408569336,61392,10909,50483,50483,0,12,9987000.0
9987,9987999,21.235616014138312,37.714169880050875,0.07341464310667323,1988.4971199035645,677.5489459037781,1644.344295501709,61404,10910,50494,50494,0,12,9988000.0
9988,9988999,21.235050780410152,37.7133418532101,0.07340536871724967,1988.6088507175446,677.6133189201355,1644.5625534057617,61404,10910,50494,50494,0,12,9989000.0
9989,9989999,21.23434192805788,37.71204852378883,0.07340132237546892,1989.3024656772614,677.678058385849,1644.6230964660645,61418,10914,50504,50504,0,12,9990000.0
9990,9990999,21.23368566387015,37.71101005100701,0.07339841336590436,1989.7097454071045,677.7433989048004,1644.7263145446777,61429,10916,50513,50513,0,12,9991000.0
9991,9991999,21.23321034841683,37.710156314947405,0.07339153632168827,1989.8300476074219,677.8090362548828,1644.9001808166504,61429,10916,50513,50513,0,12,9992000.0
9992,9992999,21.23273267317049,37.71083175525607,0.0733813946802675,1989.9572949409485,677.8765664100647,1645.057502746582,61430,10916,50514,50514,0,12,9993000.0
9993,9993999,21.232505702100077,37.71004982966156,0.07337008741157258,1990.0774507522583,677.9409749507904,1645.423454284668,61431,10916,50515,50515,0,12,9994000.0
9994,9994999,21.23229253670443,37.709126381232274,0.07336381160764316,1990.336856842041,678.0046577453613,1645.5539817810059,61433,10917,50516,50516,0,12,9995000.0
9995,9995999,21.23191511456516,37.70805732430371,0.07335938157792676,1990.6150543689728,678.0757391452789,1645.7088165283203,61445,10918,50527,50527,0,12,9996000.0
9996,9996999,21.231686226872732,37.70821231627913,0.07334969956868465,1990.874683856964,678.1399273872375,1645.8225746154785,61458,10919,50539,50539,0,12,9997000.0
9997,9997999,21.231407398868605,37.707489720490045,0.07334415314656761,1991.0054750442505,678.2046895027161,1645.9503173828125,61459,10919,50540,50540,0,12,9998000.0
9998,9998999,21.23106104745831,37.70650152278408,0.07334104791864149,1991.1327657699585,678.2718665599823,1646.0666236877441,61460,10919,50541,50541,0,12,9999000.0
9999,9999999,21.2310145928961,37.7058198399479,0.07333189226244574,1991.5322470664978,678.3374311923981,1646.3430786132812,61467,10921,50546,50546,0,12,10000000.0
10000,10000999,21.230953384399342,37.70503426541042,0.07332291374102762,1991.7929861545563,678.4027166366577,1646.4452362060547,61469,10922,50547,50547,0,12,10001000.0
10001,10001999,21.230758954272027,37.70427951603449,0.07331734887041741,1992.183836221695,678.467570066452,1646.4990997314453,61483,10924,50559,50559,0,12,10002000.0
10002,10002999,21.230319762073222,37.70315597373969,0.07331684948246553,1992.4513466358185,678.5329985618591,1646.6728286743164,61485,10925,50560,50560,0,12,10003000.0
10003,10003999,21.22971735572488,37.70194070677351,0.07331395858622791,1992.7055306434631,678.5978510379791,1647.0161590576172,61498,10926,50572,50572,0,12,10004000.0
10004,10004999,21.229161442720883,37.701130081903585,0.07330438193863242,1992.9731276035309,678.66357588768,1647.195945739746,61501,10927,50574,50574,0,12,10005000.0
10005,10005999,21.228538397460163,37.70018907863654,0.07329853269459141,1993.2347276210785,678.7289369106293,1647.3800354003906,61509,10928,50581,50581,0,12,10006000.0
10006,10006999,21.228100879506357,37.69988354157074,0.0732899351784132,1993.635882616043,678.7946517467499,1647.460548400879,61514,10930,50584,50584,0,12,10007000.0
10007,10007999,21.227665186324668,37.698987564800625,0.07328286103699155,1994.0332555770874,678.8608090877533,1647.700309753418,61529,10932,50597,50597,0,12,10008000.0
10008,10008999,21.22719319523612,37.6980761903014,0.07327389831222342,1994.2994043827057,678.9268560409546,1647.855339050293,61531,10933,50598,50598,0,12,10009000.0
10009,10009999,21.22705391188829,37.697831116506585,0.07325895824408724,1994.8514511585236,678.9920868873596,1647.8794326782227,61551,10936,50615,50615,0,12,10010000.0
10010,10010999,21.226727083352632,37.697393168203874,0.07325171948331444,1995.1346883773804,679.0704746246338,1647.9774932861328,61553,10937,50616,50616,0,12,10011000.0
10011,10011999,21.226697708529308,37.697876443935456,0.07324108468340162,1995.4039053916931,679.1364667415619,1648.109519958496,61556,10938,50618,50618,0,12,10012000.0
10012,10012999,21.226434104244994,37.697026575866346,0.07323401950518194,1995.805297613144,679.2018747329712,1648.1863327026367,61561,10940,50621,50621,0,12,10013000.0
10013,10013999,21.226721727396946,37.69772891425123,0.07322338703390308,1996.0544505119324,679.2673237323761,1648.5154647827148,61575,10941,50634,50634,0,12,10014000.0
10014,10014999,21.226740731834244,37.69734069848747,0.07322456339577343,1996.1692898273468,679.3325610160828,1648.773323059082,61575,10941,50634,50634,0,12,10015000.0
10015,10015999,21.226844684617866,37.69701342764762,0.07322399487915665,1996.5710973739624,679.3975920677185,1648.8865013122559,61591,10943,50648,50648,0,12,10016000.0
10016,10016999,21.227223590664032,37.69720178622228,0.0732288462198536,1996.8520820140839,679.4659156799316,1649.0301704406738,61595,10944,50651,50651,0,12,10017000.0
10017,10017999,21.227474721676476,37.697059068287714,0.07323618713798252,1997.5383636951447,679.5329792499542,1648.9934883117676,61608,10948,50660,50660,0,12,10018000.0
10018,10018999,21.227899229785546,37.69736890134292,0.07324369217628579,1997.8009843826294,679.5993704795837,1649.0878829956055,61612,10949,50663,50663,0,12,10019000.0
