,n_samples,MAE,RMSE,R2,time_learning,time_predicting,memory,n_nodes,n_branches,n_leaves,n_active_leaves,n_inactive_leaves,height,total_observed_weight
0,999,20.42384130879432,37.93610961097188,-0.014165771224336376,0.140883207321167,0.06732702255249023,0.23662567138671875,3,1,2,2,0,2,1000.0
1,1999,21.39349941302081,42.9058567644078,-0.00588598290925213,0.2954695224761963,0.13378071784973145,0.29546356201171875,3,1,2,2,0,2,2000.0
2,2999,20.593286258525932,39.69219170642934,-0.005247901565484492,0.4403419494628906,0.1896975040435791,0.3261146545410156,3,1,2,2,0,2,3000.0
3,3999,20.808685233314854,44.722541461991845,-0.0027722378376207057,0.5805833339691162,0.24324989318847656,0.3194389343261719,11,2,9,9,0,3,4000.0
4,4999,20.294315484144075,42.220596672999285,-0.003115913092449407,0.6870870590209961,0.29860520362854004,0.6665458679199219,11,2,9,9,0,3,5000.0
5,5999,19.912373339618508,40.75664414403351,-0.0026231989155591773,0.7936618328094482,0.35393786430358887,0.8367691040039062,11,2,9,9,0,3,6000.0
6,6999,19.7947904293849,39.65609103467483,-0.0012301685065367884,0.9194960594177246,0.4099414348602295,0.9439239501953125,11,2,9,9,0,3,7000.0
7,7999,19.92945008685668,39.13957717605673,-0.0012203030739013077,1.0431926250457764,0.4647221565246582,1.0248947143554688,11,2,9,9,0,3,8000.0
8,8999,20.23640057882791,39.376944698228705,-0.0014940671153704788,1.1663007736206055,0.5201413631439209,1.0825157165527344,11,2,9,9,0,3,9000.0
9,9999,20.767494250724248,40.101570424731676,-0.0015118028188101373,1.284675121307373,0.5748062133789062,1.1288909912109375,11,2,9,9,0,3,10000.0
10,10999,20.930317629412148,39.8714821396352,-0.0013105980727798894,1.4045288562774658,0.6297485828399658,1.1671142578125,11,2,9,9,0,3,11000.0
11,11999,21.076579649775532,39.60337494317125,0.0005546252455745915,1.5556516647338867,0.6916470527648926,1.1065254211425781,13,3,10,10,0,4,12000.0
12,12999,21.593305696898383,40.89814534796907,0.005286150974616932,1.6993770599365234,0.7558252811431885,1.1218833923339844,15,4,11,11,0,4,13000.0
13,13999,22.119311618437905,41.3525077039836,0.014819730622452787,1.8200385570526123,0.8110909461975098,1.3349761962890625,28,5,23,23,0,4,14000.0
14,14999,22.611129084345563,41.84098869115245,0.016920512917362296,1.9548261165618896,0.8675203323364258,1.4525985717773438,47,7,40,40,0,5,15000.0
15,15999,22.79588115365784,41.700689829822984,0.022074989408768397,2.0743906497955322,0.9239866733551025,1.8553047180175781,47,7,40,40,0,5,16000.0
16,16999,23.098608788256342,42.11377559627776,0.02706480427782665,2.182943344116211,0.9792611598968506,2.0353012084960938,47,7,40,40,0,5,17000.0
17,17999,23.353127612074516,42.01904042625167,0.029744841092443686,2.294344663619995,1.0365378856658936,2.110076904296875,50,8,42,42,0,5,18000.0
18,18999,23.32641328104359,41.62061891439071,0.0325739685134262,2.4205856323242188,1.0936388969421387,2.227031707763672,54,9,45,45,0,5,19000.0
19,19999,23.205472668406955,41.28534967699049,0.03001213174340278,2.5255398750305176,1.154339075088501,2.7824935913085938,64,9,55,55,0,5,20000.0
20,20999,22.955986755321373,41.00831175843444,0.026059479435409205,2.649487257003784,1.2116878032684326,3.0502052307128906,68,10,58,58,0,5,21000.0
21,21999,22.658653449952748,40.48807531946997,0.026353321890617565,2.772933006286621,1.2697856426239014,3.3965225219726562,78,11,67,67,0,5,22000.0
22,22999,22.431253184222243,40.21118441336442,0.026256579013526404,2.9147305488586426,1.393296480178833,3.6558914184570312,84,12,72,72,0,5,23000.0
23,23999,22.25260551369336,39.73270423211696,0.02551136162320966,3.0306243896484375,1.4505934715270996,3.859771728515625,87,13,74,74,0,5,24000.0
24,24999,22.065873587599395,39.316770127045956,0.024748305555575834,3.1478357315063477,1.510408878326416,3.9741897583007812,87,13,74,74,0,5,25000.0
25,25999,21.934158113612337,39.01362742581863,0.022985214959097888,3.276185989379883,1.5693063735961914,4.188976287841797,91,14,77,77,0,5,26000.0
26,26999,21.823652504754232,38.67577237195536,0.02188112113475127,3.4072999954223633,1.6279082298278809,4.2332305908203125,99,16,83,83,0,5,27000.0
27,27999,21.727213907590087,38.41023749746287,0.020026615981965423,3.523315668106079,1.6850025653839111,4.370273590087891,99,16,83,83,0,5,28000.0
28,28999,21.637148520954273,38.27521708766084,0.01950341286188928,3.6469268798828125,1.741952896118164,4.4095001220703125,105,18,87,87,0,5,29000.0
29,29999,21.5208718220555,37.96449765589042,0.020793672141976804,3.7656667232513428,1.7986652851104736,4.5972137451171875,105,18,87,87,0,5,30000.0
30,30999,21.46085775176417,38.095307779470005,0.0204868832621794,3.8861308097839355,1.8559365272521973,4.680637359619141,107,19,88,88,0,5,31000.0
31,31999,21.38586468387866,37.83964059036978,0.02022579848535977,4.006601810455322,1.9134676456451416,4.910221099853516,109,19,90,90,0,5,32000.0
32,32999,21.358969358768693,37.72262745501462,0.019618903267313303,4.123622417449951,1.9705443382263184,5.030235290527344,113,21,92,92,0,5,33000.0
33,33999,21.31832669960924,37.54011727893282,0.01990138207144332,4.240887403488159,2.027323007583618,5.124164581298828,113,21,92,92,0,5,34000.0
34,34999,21.270445829720618,37.40395257196083,0.02002358673260196,4.373432397842407,2.0871047973632812,5.3483123779296875,113,21,92,92,0,5,35000.0
35,35999,21.297529862809263,37.29303009669448,0.018912617251432118,4.4918882846832275,2.1435546875,5.418209075927734,113,21,92,92,0,5,36000.0
36,36999,21.266981526902107,37.123791067982985,0.01912918744297243,4.607240200042725,2.200751304626465,5.698162078857422,126,22,104,104,0,5,37000.0
37,37999,21.246894677184596,36.93775583395717,0.018623040953309133,4.732399940490723,2.2574219703674316,5.777912139892578,134,23,111,111,0,5,38000.0
38,38999,21.243103816270605,36.784193610901085,0.017466063373765772,4.839189052581787,2.314532995223999,5.839687347412109,134,23,111,111,0,5,39000.0
39,39999,21.215467482721767,36.60748095954787,0.016748656564763764,4.953409671783447,2.3714895248413086,5.884693145751953,134,23,111,111,0,5,40000.0
40,40999,21.12375098031925,36.461630443493874,0.016816888153934673,5.0715227127075195,2.428572177886963,5.979549407958984,139,25,114,114,0,5,41000.0
41,41999,20.969499005126465,36.20366842261151,0.01698007952963798,5.192829370498657,2.486382007598877,6.106761932373047,141,26,115,115,0,6,42000.0
42,42999,20.808901801468092,35.957495958352794,0.018371358035508822,5.3119282722473145,2.5434410572052,6.200435638427734,141,26,115,115,0,6,43000.0
43,43999,20.655241338512326,35.697008989739686,0.019158121569946118,5.443315505981445,2.6018378734588623,6.334140777587891,141,26,115,115,0,6,44000.0
44,44999,20.544405802680366,35.49106276515086,0.01972200887130804,5.555166006088257,2.659166097640991,6.385440826416016,141,26,115,115,0,6,45000.0
45,45999,20.410501334057837,35.23572322494429,0.020332000246913506,5.677809476852417,2.717102289199829,6.428474426269531,141,26,115,115,0,6,46000.0
46,46999,20.303602598567117,35.01692620774633,0.020479989422820144,5.808094263076782,2.7765514850616455,6.508220672607422,141,26,115,115,0,6,47000.0
47,47999,20.223875276152093,34.89780153271636,0.020264464375434166,5.939416885375977,2.8339967727661133,6.341217041015625,155,28,127,127,0,6,48000.0
48,48999,20.17321437362061,34.88421982328061,0.01970593098718798,6.060169219970703,2.892057180404663,6.42254638671875,169,30,139,139,0,7,49000.0
49,49999,20.102701854195562,34.839410939612186,0.01986591834469198,6.187008857727051,2.9502196311950684,6.659336090087891,169,30,139,139,0,7,50000.0
50,50999,20.059840825888777,34.7614297427008,0.02158448498276444,6.295318841934204,3.0070972442626953,6.832366943359375,169,30,139,139,0,7,51000.0
51,51999,20.03429759096319,34.65798181974255,0.022416770119300544,6.431095361709595,3.0650088787078857,6.864513397216797,175,31,144,144,0,7,52000.0
52,52999,19.996352066784326,34.540316687225605,0.02237748547923335,6.558915853500366,3.1224586963653564,7.021923065185547,183,32,151,151,0,7,53000.0
53,53999,19.99459318569277,34.50674319976432,0.02181377448068933,6.6775383949279785,3.179802179336548,7.1255340576171875,194,33,161,161,0,7,54000.0
54,54999,19.996191922047686,34.452128690698515,0.02213983784286966,6.798644065856934,3.2377352714538574,7.269893646240234,194,33,161,161,0,7,55000.0
55,55999,20.011575754380374,34.4235901042618,0.022220624342633832,6.914555072784424,3.295734167098999,7.399990081787109,194,33,161,161,0,7,56000.0
56,56999,20.020103529460233,34.37341112970429,0.02244018784618229,7.02983832359314,3.3531103134155273,7.635154724121094,194,33,161,161,0,7,57000.0
57,57999,20.033617395573614,34.32448253714742,0.02277927572686933,7.144376516342163,3.411611557006836,7.7249298095703125,194,33,161,161,0,7,58000.0
58,58999,20.035013533180624,34.25757327729045,0.02275128680295868,7.2646684646606445,3.469388961791992,7.771354675292969,194,33,161,161,0,7,59000.0
59,59999,20.0742655107443,34.215277264528076,0.02216582485652485,7.379537343978882,3.5273356437683105,7.923168182373047,194,33,161,161,0,7,60000.0
60,60999,20.124770564106896,34.33599894396582,0.02185055434781802,7.507761001586914,3.590618848800659,8.13907241821289,205,34,171,171,0,7,61000.0
61,61999,20.05789416116955,34.22084168790989,0.021922556215194122,7.627436876296997,3.650503635406494,8.380157470703125,211,35,176,176,0,7,62000.0
62,62999,19.978152053210078,34.13546547132371,0.021695263188921787,7.764284610748291,3.7205417156219482,8.520191192626953,213,36,177,177,0,7,63000.0
63,63999,19.902835598500292,34.069653166323505,0.021852498734547088,7.889617204666138,3.7812397480010986,8.922515869140625,227,37,190,190,0,7,64000.0
64,64999,19.81388842805409,33.92111509735662,0.022034021425286543,8.024980545043945,3.842799663543701,9.19766616821289,240,38,202,202,0,7,65000.0
65,65999,19.776739714781392,33.90216174764808,0.021828192180678663,8.153023481369019,3.903228282928467,9.320785522460938,240,38,202,202,0,7,66000.0
66,66999,19.757956370353906,33.93831235812276,0.021864550318838716,8.282306909561157,3.9609367847442627,9.334774017333984,248,39,209,209,0,7,67000.0
67,67999,19.73372976035695,33.8864200114226,0.021743643611898844,8.40624451637268,4.01903510093689,9.5133056640625,260,40,220,220,0,7,68000.0
68,68999,19.760753170696628,33.91474899586599,0.024798473733330995,8.532329082489014,4.081588268280029,9.752128601074219,267,41,226,226,0,7,69000.0
69,69999,19.803121969618747,34.22956943367748,0.025994111797648878,8.654621124267578,4.142212867736816,9.927421569824219,274,42,232,232,0,7,70000.0
70,70999,19.884486961143967,34.45307303626616,0.02785870402112578,8.76578164100647,4.202117681503296,10.119335174560547,274,42,232,232,0,7,71000.0
71,71999,19.98135598715402,34.64165751500648,0.03152122589335704,8.878607749938965,4.2611095905303955,10.192817687988281,274,42,232,232,0,7,72000.0
72,72999,20.0609634161029,35.00103839670304,0.03282522842509683,8.998698949813843,4.319213390350342,10.269844055175781,275,42,233,233,0,7,73000.0
73,73999,20.156782580417097,35.30457682701491,0.03407609402148293,9.151651382446289,4.381091356277466,10.235538482666016,288,44,244,244,0,7,74000.0
74,74999,20.249244886855493,35.462782043392664,0.034457214152377014,9.28896713256836,4.439096927642822,10.264450073242188,294,45,249,249,0,7,75000.0
75,75999,20.347065180072516,35.612965902272244,0.035114852155705645,9.408297061920166,4.5677571296691895,10.478801727294922,294,45,249,249,0,7,76000.0
76,76999,20.48449460000848,36.06572342948488,0.035686116202667484,9.530762434005737,4.6302313804626465,10.608482360839844,295,45,250,250,0,7,77000.0
77,77999,20.62418067692899,36.279669282574616,0.03584682470992917,9.652678966522217,4.6892290115356445,10.765987396240234,296,45,251,251,0,7,78000.0
78,78999,20.738322893557463,36.440046548480026,0.03600583625917919,9.773199081420898,4.747583389282227,10.814594268798828,296,45,251,251,0,7,79000.0
79,79999,20.861207215375217,36.57015448884697,0.03622608917348924,9.904422044754028,4.809421062469482,11.130386352539062,308,46,262,262,0,7,80000.0
80,80999,20.953910153814626,36.636957081385646,0.036675377794488484,10.014466047286987,4.867973327636719,11.253490447998047,308,46,262,262,0,7,81000.0
81,81999,20.95640941946958,36.623647206228924,0.036049481780587755,10.120068311691284,4.925469398498535,11.445499420166016,309,46,263,263,0,7,82000.0
82,82999,20.922362614681866,36.601695381831775,0.03601266559990246,10.261659622192383,4.988922834396362,11.613140106201172,328,49,279,279,0,7,83000.0
83,83999,20.86794273897272,36.487641641529095,0.03622056505234683,10.375141382217407,5.0479207038879395,11.77902603149414,337,50,287,287,0,7,84000.0
84,84999,20.83031858198142,36.409701308108644,0.03597586289985011,10.490915060043335,5.106674909591675,11.858192443847656,340,51,289,289,0,7,85000.0
85,85999,20.83934523599572,36.444492387391584,0.03631357441397498,10.620153188705444,5.166992425918579,12.109752655029297,349,52,297,297,0,7,86000.0
86,86999,20.828254505046896,36.39990527487934,0.035560928128148483,10.735947370529175,5.225613355636597,12.24527359008789,349,52,297,297,0,7,87000.0
87,87999,20.878584303375064,36.47150330196324,0.03502934129558233,10.85432767868042,5.284273386001587,12.374629974365234,349,52,297,297,0,7,88000.0
88,88999,20.932502397962146,36.55469898266663,0.03382633319687933,11.005198955535889,5.343397378921509,12.569210052490234,349,52,297,297,0,7,89000.0
89,89999,20.997598081219085,36.62745446423362,0.03308478547125815,11.124620199203491,5.403690814971924,12.624408721923828,349,52,297,297,0,7,90000.0
90,90999,21.075255124227013,36.72029400365297,0.03234275111415663,11.246360301971436,5.46186637878418,12.696941375732422,349,52,297,297,0,7,91000.0
91,91999,21.177467612289814,36.88060284281546,0.03123329622995419,11.366406202316284,5.520358324050903,12.800361633300781,349,52,297,297,0,7,92000.0
92,92999,21.298197944205665,37.11279019501025,0.03227175721303688,11.48008418083191,5.578512668609619,12.838424682617188,349,52,297,297,0,7,93000.0
93,93999,21.39735625728249,37.25381339320475,0.03233026404760775,11.601062536239624,5.637492656707764,12.876991271972656,349,52,297,297,0,7,94000.0
94,94999,21.479538544311406,37.344890150852336,0.03240938389508319,11.726121425628662,5.697407245635986,13.027542114257812,349,52,297,297,0,7,95000.0
95,95999,21.589897982653273,37.5173095685843,0.032973552843686305,11.844913959503174,5.755954265594482,13.063003540039062,349,52,297,297,0,7,96000.0
96,96999,21.71162933803012,37.680018783228,0.03350105012874438,11.974563837051392,5.814906358718872,13.100601196289062,349,52,297,297,0,7,97000.0
97,97999,21.854145569522945,38.00179036231329,0.033565721191693654,12.093868255615234,5.874111175537109,13.322093963623047,355,53,302,302,0,7,98000.0
98,98999,21.977565778625724,38.16419995957235,0.03416458702948555,12.212769031524658,5.932886838912964,13.378559112548828,362,54,308,308,0,7,99000.0
99,99999,22.103473747169915,38.33110147886614,0.03584395907608673,12.325054168701172,5.991413831710815,13.50302505493164,362,54,308,308,0,7,100000.0
100,100999,22.204520683957185,38.42746633846405,0.036289111102343674,12.43524694442749,6.051023483276367,13.69500732421875,363,54,309,309,0,7,101000.0
101,101999,22.24286207803248,38.440417456991455,0.0366076821205219,12.56100583076477,6.112859725952148,13.870185852050781,364,54,310,310,0,7,102000.0
102,102999,22.202882467698007,38.366995333459,0.03675027494347327,12.676599264144897,6.171997308731079,14.060726165771484,364,54,310,310,0,7,103000.0
103,103999,22.176122093920387,38.35288517986108,0.036895253190259436,12.805656671524048,6.231574535369873,14.18178939819336,369,55,314,314,0,7,104000.0
104,104999,22.137984224184727,38.31355999227746,0.03669341094634382,12.92326807975769,6.291456937789917,14.277992248535156,369,55,314,314,0,7,105000.0
105,105999,22.102028383143853,38.246654089270606,0.0367735159101118,13.040552854537964,6.350190162658691,14.3621826171875,369,55,314,314,0,7,106000.0
106,106999,22.06189893749904,38.1661628433256,0.03674898549592165,13.156789541244507,6.408418416976929,14.410381317138672,369,55,314,314,0,7,107000.0
107,107999,22.016031569042337,38.059857563462906,0.03685346456284189,13.29119348526001,6.46543025970459,14.451290130615234,369,55,314,314,0,7,108000.0
108,108999,21.997070194728405,38.137938275444945,0.03636891503091211,13.409393548965454,6.523410081863403,14.501678466796875,369,55,314,314,0,7,109000.0
109,109999,21.968725499233358,38.067554854485074,0.036343848502488174,13.530672788619995,6.582106351852417,14.53763198852539,369,55,314,314,0,7,110000.0
110,110999,21.955323116277995,37.996691030896166,0.036102190334659334,13.655805110931396,6.640623569488525,14.441967010498047,371,56,315,315,0,7,111000.0
111,111999,21.94994422029826,38.064495929680035,0.035540470129489354,13.801219940185547,6.701878786087036,14.489856719970703,376,57,319,319,0,7,112000.0
112,112999,21.93393363020502,37.995508988649185,0.03526141463197596,13.92696237564087,6.760961532592773,14.542736053466797,381,58,323,323,0,7,113000.0
113,113999,21.930068254772095,37.94441904749425,0.03504709696165853,14.038350105285645,6.819618463516235,14.775871276855469,392,59,333,333,0,7,114000.0
114,114999,21.938692368267073,37.90599130651199,0.034852488622667765,14.168696880340576,6.877434730529785,14.90835952758789,392,59,333,333,0,7,115000.0
115,115999,21.938631175715823,37.84372544653216,0.03470523713540796,14.286041259765625,6.937506914138794,14.98983383178711,392,59,333,333,0,7,116000.0
116,116999,21.947655313973076,37.78277982483894,0.034218887075995075,14.420856475830078,6.998861312866211,15.085090637207031,392,59,333,333,0,7,117000.0
117,117999,21.952557506050137,37.77207252395587,0.033794858905364156,14.528414726257324,7.058407306671143,15.123531341552734,392,59,333,333,0,7,118000.0
118,118999,21.95051607631618,37.717805876245826,0.033080828524258976,14.65023684501648,7.117336750030518,15.189464569091797,392,59,333,333,0,7,119000.0
119,119999,21.908881143533613,37.64859124011262,0.0331181098971155,14.77042531967163,7.1764092445373535,15.314922332763672,393,59,334,334,0,7,120000.0
120,120999,21.85969241421481,37.558532780967845,0.03356167950498379,14.892077684402466,7.23611307144165,15.44406509399414,394,59,335,335,0,7,121000.0
121,121999,21.801453610163335,37.45776059993012,0.03384446446045708,15.004434823989868,7.295698404312134,15.493110656738281,394,59,335,335,0,7,122000.0
122,122999,21.75016670497711,37.376178798070114,0.03443845687463143,15.114305973052979,7.354738712310791,15.567066192626953,395,59,336,336,0,7,123000.0
123,123999,21.70980962341776,37.29401836988285,0.03448452037610539,15.247564792633057,7.413129806518555,15.593948364257812,395,59,336,336,0,7,124000.0
124,124999,21.670869067489047,37.26992815642119,0.034859238370115175,15.37267541885376,7.4767162799835205,15.612445831298828,395,59,336,336,0,7,125000.0
125,125999,21.63754091909503,37.20312415531915,0.034944254928110485,15.503720760345459,7.5356714725494385,15.599075317382812,397,60,337,337,0,7,126000.0
126,126999,21.610115970294018,37.138376359687484,0.03475635335234584,15.6321702003479,7.595459699630737,15.655647277832031,397,60,337,337,0,7,127000.0
127,127999,21.580525339391396,37.07050926126037,0.034590563180251666,15.750792264938354,7.655937194824219,15.632820129394531,405,61,344,344,0,7,128000.0
128,128999,21.561542233681056,37.00768812989797,0.034439211263494585,15.869726419448853,7.7162041664123535,15.785072326660156,408,62,346,346,0,7,129000.0
129,129999,21.546960067680544,36.96143300156355,0.034021322210251226,16.006372451782227,7.77696418762207,15.8802490234375,408,62,346,346,0,7,130000.0
130,130999,21.527279850138545,36.91622705667665,0.033880420538867306,16.129682064056396,7.836629629135132,15.931522369384766,408,62,346,346,0,7,131000.0
131,131999,21.532352161792762,36.96910798709637,0.0341479462765818,16.254045724868774,7.896951198577881,16.008056640625,408,62,346,346,0,7,132000.0
132,132999,21.53665317870243,36.94670803742561,0.033875846125128395,16.38181734085083,7.956970453262329,15.982044219970703,419,63,356,356,0,7,133000.0
133,133999,21.558922701297018,36.967830000969116,0.03359627536820442,16.51362156867981,8.018018960952759,16.02535629272461,419,63,356,356,0,7,134000.0
134,134999,21.59445763087534,36.99817074627327,0.0335529187539263,16.631234407424927,8.076920986175537,16.144969940185547,419,63,356,356,0,7,135000.0
135,135999,21.62324850650902,37.002007698951886,0.033611496122205375,16.737462282180786,8.135879278182983,16.18470001220703,419,63,356,356,0,7,136000.0
136,136999,21.650198554660143,37.017544611499936,0.033676487991780135,16.86621642112732,8.194982528686523,16.20590591430664,419,63,356,356,0,7,137000.0
137,137999,21.689853384374533,37.10126705633163,0.033504368803490614,16.98923420906067,8.256336450576782,16.298324584960938,419,63,356,356,0,7,138000.0
138,138999,21.698301139832967,37.08731625911718,0.03347732307142226,17.128002882003784,8.318536043167114,16.60910415649414,462,64,398,398,0,7,139000.0
139,139999,21.661656861421626,37.06489445872193,0.033618333854672056,17.249653577804565,8.378053903579712,16.847755432128906,468,65,403,403,0,7,140000.0
140,140999,21.621362082111407,36.99214882356639,0.03365728805277424,17.393813610076904,8.438860416412354,16.96030044555664,476,67,409,409,0,7,141000.0
141,141999,21.590917815132528,36.930062051718984,0.033623280961778024,17.508827209472656,8.500564336776733,17.15459442138672,478,68,410,410,0,7,142000.0
142,142999,21.554896217305892,36.85413564025946,0.03360820474444903,17.634419441223145,8.56187891960144,17.265296936035156,481,69,412,412,0,7,143000.0
143,143999,21.526136689313528,36.81260649841656,0.03343034288902391,17.77517056465149,8.622145652770996,17.28976058959961,489,70,419,419,0,7,144000.0
144,144999,21.4975313703633,36.741466443331355,0.03328714151437373,17.920984745025635,8.694048881530762,17.31161880493164,496,71,425,425,0,7,145000.0
145,145999,21.469774363262953,36.676975468708186,0.033313079417683356,18.053913593292236,8.754151821136475,17.29724884033203,505,73,432,432,0,7,146000.0
146,146999,21.4479184991102,36.621386851232145,0.033251258020290164,18.183465480804443,8.814173221588135,17.3582763671875,505,73,432,432,0,7,147000.0
147,147999,21.423877786802063,36.55400435482335,0.03315513505360945,18.313405990600586,8.874382972717285,17.454273223876953,505,73,432,432,0,7,148000.0
148,148999,21.411576136641482,36.51708888055968,0.03301593297870464,18.434160232543945,8.934892654418945,17.58965301513672,506,73,433,433,0,7,149000.0
149,149999,21.389935683120076,36.4574885655635,0.03304742296683427,18.594224452972412,9.095311403274536,17.66120147705078,515,75,440,440,0,7,150000.0
150,150999,21.378566142442374,36.43115741301132,0.032870552698185174,18.718180179595947,9.155476331710815,17.752483367919922,515,75,440,440,0,7,151000.0
151,151999,21.365324225489463,36.388497071073445,0.03272658799889305,18.849329233169556,9.215296268463135,17.846763610839844,515,75,440,440,0,7,152000.0
152,152999,21.362977546028493,36.349312858794256,0.03243969789970658,18.976153135299683,9.275040864944458,17.898155212402344,515,75,440,440,0,7,153000.0
153,153999,21.368277958701707,36.30941231507352,0.0321899120859811,19.12581467628479,9.338551759719849,17.868118286132812,523,76,447,447,0,7,154000.0
154,154999,21.367336327580084,36.25756500579346,0.03191411852874415,19.266525983810425,9.399811029434204,17.902667999267578,528,77,451,451,0,7,155000.0
155,155999,21.373045957416164,36.20592354630539,0.031407806531424276,19.382912158966064,9.460146188735962,17.877826690673828,536,78,458,458,0,7,156000.0
156,156999,21.37731293491759,36.16607418392511,0.03085249827546177,19.500467538833618,9.518977642059326,17.946155548095703,536,78,458,458,0,7,157000.0
157,157999,21.38078661970236,36.133033202739625,0.03052358989643189,19.640095710754395,9.579614162445068,17.998111724853516,536,78,458,458,0,7,158000.0
158,158999,21.377706435451884,36.07999623991001,0.02998604321614129,19.761027336120605,9.639044523239136,17.983623504638672,544,79,465,465,0,7,159000.0
159,159999,21.342888934833404,36.01512438274072,0.03007166136829509,19.874909162521362,9.69759726524353,18.15353012084961,553,80,473,473,0,7,160000.0
160,160999,21.291886523371552,35.93661452658039,0.030446552572146568,20.000617027282715,9.757777690887451,18.443710327148438,564,81,483,483,0,7,161000.0
161,161999,21.237497614415243,35.85680425113689,0.030791440818113136,20.1315279006958,9.818812847137451,18.517227172851562,566,82,484,484,0,7,162000.0
162,162999,21.18640777696642,35.78201826402312,0.031093711112454403,20.251445531845093,9.881900072097778,18.578678131103516,566,82,484,484,0,7,163000.0
163,163999,21.14591131665387,35.733416578131695,0.031144080277444086,20.369804859161377,9.942504167556763,18.782115936279297,567,82,485,485,0,7,164000.0
164,164999,21.095755855970488,35.65203974218621,0.03144110893587504,20.48288655281067,10.002778053283691,18.82501220703125,569,83,486,486,0,7,165000.0
165,165999,21.06222229139744,35.59143746740158,0.03170418524688945,20.61259913444519,10.06294846534729,18.88607406616211,569,83,486,486,0,7,166000.0
166,166999,21.036704607526488,35.52451728697318,0.031875989450138364,20.756745100021362,10.122660636901855,18.894317626953125,573,84,489,489,0,7,167000.0
167,167999,21.008817685122374,35.47477906160708,0.03195890528988121,20.884907007217407,10.18375015258789,18.85256576538086,579,85,494,494,0,7,168000.0
168,168999,20.986435944888175,35.421445763526656,0.03216885858722973,21.01635193824768,10.244549751281738,18.97559356689453,585,86,499,499,0,7,169000.0
169,169999,20.98146616761614,35.455853250812055,0.03197621152729102,21.127954244613647,10.303635835647583,19.18917465209961,585,86,499,499,0,7,170000.0
170,170999,20.975687174758082,35.4423200450038,0.0324067147005781,21.244000911712646,10.36292815208435,19.286304473876953,585,86,499,499,0,7,171000.0
171,171999,20.97074132968378,35.428840029732235,0.03254609365889927,21.370784282684326,10.421552658081055,19.347061157226562,585,86,499,499,0,7,172000.0
172,172999,20.975974223703,35.42652920799987,0.032690860799058585,21.48502540588379,10.479637861251831,19.516910552978516,587,86,501,501,0,7,173000.0
173,173999,20.98314637550692,35.417131909683874,0.03259984938963467,21.606398820877075,10.541969776153564,19.59881591796875,591,87,504,504,0,8,174000.0
174,174999,20.99390361503857,35.41055157265119,0.03286244550493034,21.72667360305786,10.605554103851318,19.67401123046875,591,87,504,504,0,8,175000.0
175,175999,21.01808529213919,35.41690037481977,0.03276341720638587,21.849135398864746,10.666202068328857,19.746173858642578,592,87,505,505,0,8,176000.0
176,176999,21.037530127967088,35.4215910280005,0.03274379644704284,21.975749254226685,10.725735187530518,19.783214569091797,592,87,505,505,0,8,177000.0
177,177999,21.051373360960508,35.407096305148656,0.032620083326006744,22.093207836151123,10.785629034042358,19.87529754638672,593,87,506,506,0,8,178000.0
178,178999,21.051793300863682,35.37150480131741,0.032240187520430674,22.21435570716858,10.847517728805542,19.9212646484375,593,87,506,506,0,8,179000.0
179,179999,21.01912381515052,35.33755761940336,0.03243481033779139,22.34340262413025,10.908247232437134,20.14748764038086,602,88,514,514,0,8,180000.0
180,180999,20.978887170412474,35.272102468125766,0.03271508499038667,22.46310305595398,10.970524072647095,20.296756744384766,606,89,517,517,0,8,181000.0
181,181999,20.929619010555378,35.1973243392956,0.03311077403025631,22.579962968826294,11.031319379806519,20.42412567138672,606,89,517,517,0,8,182000.0
182,182999,20.885665825717858,35.133359121069766,0.03337598271945574,22.711766481399536,11.091979265213013,20.49063491821289,606,89,517,517,0,8,183000.0
183,183999,20.850764438109305,35.083378589993096,0.03343549519454292,22.833317518234253,11.151819705963135,20.724205017089844,608,89,519,519,0,8,184000.0
184,184999,20.809493827809224,35.01536300543562,0.033729210391465925,22.94716191291809,11.212742567062378,20.800830841064453,610,90,520,520,0,8,185000.0
185,185999,20.775497639113805,34.950320997573506,0.03392352764686679,23.07757329940796,11.273717641830444,20.929306030273438,619,91,528,528,0,8,186000.0
186,186999,20.73872279753628,34.88339086960785,0.0341508336271531,23.201926469802856,11.334540843963623,21.016883850097656,627,92,535,535,0,8,187000.0
187,187999,20.704248767145085,34.82137009884134,0.03430264839524222,23.321889400482178,11.395271062850952,21.097789764404297,629,93,536,536,0,8,188000.0
188,188999,20.675354219354723,34.76885604704209,0.03452329077900573,23.453160285949707,11.457266569137573,21.121227264404297,631,94,537,537,0,8,189000.0
189,189999,20.650591498730726,34.73457178352898,0.034500408522104786,23.561584949493408,11.519043207168579,21.366966247558594,631,94,537,537,0,8,190000.0
190,190999,20.620362313031904,34.674646557991586,0.034447037633474564,23.682648181915283,11.579193353652954,21.48125457763672,631,94,537,537,0,8,191000.0
191,191999,20.59460865215457,34.6378090877896,0.034559173427075596,23.80744743347168,11.639777421951294,21.532543182373047,631,94,537,537,0,8,192000.0
192,192999,20.577322664162814,34.59866411984193,0.034389841938536114,23.92853546142578,11.699780702590942,21.667896270751953,634,95,539,539,0,8,193000.0
193,193999,20.56514461702984,34.56329548036672,0.03427540186629152,24.056482553482056,11.759589195251465,21.746414184570312,636,96,540,540,0,8,194000.0
194,194999,20.55280086165614,34.52499296349959,0.034212221903098916,24.184698343276978,11.819118022918701,21.80097198486328,636,96,540,540,0,8,195000.0
195,195999,20.555330869777322,34.506996390620984,0.03417350371462746,24.308218479156494,11.878526449203491,21.900737762451172,644,97,547,547,0,8,196000.0
196,196999,20.553767478389815,34.479490915376154,0.0340144326441717,24.438113927841187,11.940470457077026,21.913997650146484,646,98,548,548,0,8,197000.0
197,197999,20.551100943778827,34.45368816081029,0.0341393769892393,24.56818199157715,12.000877141952515,22.040931701660156,647,98,549,549,0,8,198000.0
198,198999,20.54890385470654,34.4231654252605,0.033974154599978656,24.700138807296753,12.064131736755371,22.083282470703125,657,99,558,558,0,8,199000.0
199,199999,20.533583792505922,34.38413506393133,0.03407505470494099,24.814232349395752,12.126898765563965,22.339977264404297,660,99,561,561,0,8,200000.0
200,200999,20.50802504628398,34.354000932831006,0.03413551444318641,24.92885684967041,12.187066793441772,22.432689666748047,662,100,562,562,0,8,201000.0
201,201999,20.476131155941935,34.30611681474078,0.03430880468513031,25.049330949783325,12.247810363769531,22.519756317138672,662,100,562,562,0,8,202000.0
202,202999,20.451797462920116,34.28053254944026,0.0344454301762126,25.175963163375854,12.3113112449646,22.528182983398438,669,101,568,568,0,8,203000.0
203,203999,20.42138548108186,34.22817316066925,0.03475761070638095,25.309611082077026,12.371084451675415,22.682445526123047,673,102,571,571,0,8,204000.0
204,204999,20.39606857759743,34.18762508168867,0.03502413913225455,25.428716897964478,12.434194564819336,22.81647491455078,675,103,572,572,0,8,205000.0
205,205999,20.372931390534323,34.14774363201759,0.035168375618739756,25.562877893447876,12.494065284729004,22.87826156616211,683,104,579,579,0,8,206000.0
206,206999,20.348841349915993,34.109469957108935,0.03551256044029438,25.684380292892456,12.555237293243408,22.960159301757812,695,105,590,590,0,8,207000.0
207,207999,20.33327602636118,34.09586155742201,0.035862603840354,25.804232835769653,12.615947484970093,23.042247772216797,697,106,591,591,0,8,208000.0
208,208999,20.313625951128483,34.05535100290407,0.0359922691504837,25.929901838302612,12.677051067352295,23.114898681640625,697,106,591,591,0,8,209000.0
209,209999,20.30996025148662,34.03700134160399,0.036488084136641175,26.06141448020935,12.736944913864136,23.342254638671875,697,106,591,591,0,8,210000.0
210,210999,20.306689038524965,34.054261914034825,0.036663521175016145,26.18159556388855,12.79726529121399,23.42575454711914,697,106,591,591,0,8,211000.0
211,211999,20.298931003407894,34.030981811245084,0.03702624947249855,26.312591552734375,12.856932640075684,23.479209899902344,697,106,591,591,0,8,212000.0
212,212999,20.29934552268474,34.03891233155642,0.03714605901209489,26.44630265235901,12.917684555053711,23.617725372314453,697,106,591,591,0,8,213000.0
213,213999,20.30656215326432,34.050600760648976,0.03737635042183829,26.574025869369507,12.978616714477539,23.692790985107422,697,106,591,591,0,8,214000.0
214,214999,20.32537846629316,34.08952424358839,0.03770548601926471,26.696556091308594,13.039719820022583,23.74073028564453,697,106,591,591,0,8,215000.0
215,215999,20.345180204950033,34.118981538781874,0.0380754262557399,26.81408190727234,13.10001277923584,23.887409210205078,698,106,592,592,0,8,216000.0
216,216999,20.367741143208754,34.147658186653054,0.03844676828740867,26.942663431167603,13.160735607147217,23.871871948242188,703,108,595,595,0,8,217000.0
217,217999,20.38586006940151,34.16854554060626,0.03885435930083958,27.071221351623535,13.220537185668945,23.914134979248047,713,109,604,604,0,8,218000.0
218,218999,20.414021147643606,34.20816911210873,0.03893323424448447,27.203198194503784,13.281277179718018,24.066234588623047,717,110,607,607,0,8,219000.0
219,219999,20.41450632705572,34.18835266390106,0.0387839818828013,27.324909925460815,13.341153621673584,24.26239013671875,724,111,613,613,0,8,220000.0
220,220999,20.389060106294675,34.16499646492282,0.0388224875947899,27.441323041915894,13.40070915222168,24.368698120117188,732,112,620,620,0,8,221000.0
221,221999,20.35882286921733,34.129407610484606,0.0389518810567927,27.55794858932495,13.461661100387573,24.542236328125,732,112,620,620,0,8,222000.0
222,222999,20.32948088160803,34.08440280078388,0.03912788454396787,27.674694776535034,13.522501945495605,24.620925903320312,732,112,620,620,0,8,223000.0
223,223999,20.31080400953036,34.06970975600912,0.03916473825793709,27.796162843704224,13.58389163017273,24.679279327392578,734,113,621,621,0,8,224000.0
224,224999,20.2969096178587,34.041517825532424,0.03939484785536751,28.037915468215942,13.64960765838623,24.95526885986328,735,113,622,622,0,8,225000.0
225,225999,20.287470672887956,34.01157822297888,0.039515397289564214,28.159568786621094,13.713295698165894,25.040721893310547,735,113,622,622,0,8,226000.0
226,226999,20.280289694000192,34.002237949177164,0.039509774543488474,28.300564289093018,13.771972179412842,24.964717864990234,763,117,646,646,0,8,227000.0
227,227999,20.27694512713509,33.99645294863388,0.0394401939811706,28.4200599193573,13.831394672393799,25.091659545898438,774,118,656,656,0,8,228000.0
228,228999,20.279327989255805,34.012519906584735,0.03959077088857743,28.554670095443726,13.89549970626831,25.178325653076172,786,120,666,666,0,8,229000.0
229,229999,20.28472375137271,34.02918454713485,0.03974947756742808,28.68812394142151,13.956613779067993,25.245044708251953,804,122,682,682,0,8,230000.0
230,230999,20.315008737540413,34.07263837917758,0.03976518531853879,28.801562786102295,14.0166757106781,25.435165405273438,804,122,682,682,0,8,231000.0
231,231999,20.34038239307276,34.10018887243825,0.04001284385635251,28.92189121246338,14.078354835510254,25.52435302734375,805,122,683,683,0,8,232000.0
232,232999,20.37089503063781,34.16485199412724,0.0401878835172953,29.0637366771698,14.137917280197144,25.540138244628906,824,125,699,699,0,8,233000.0
233,233999,20.413707268070105,34.25450616422665,0.04058951150700374,29.21810793876648,14.20682406425476,25.718944549560547,841,127,714,714,0,8,234000.0
234,234999,20.46222505855722,34.396761349849236,0.040720491575441,29.333900451660156,14.268204689025879,25.793025970458984,841,127,714,714,0,8,235000.0
235,235999,20.513307468289113,34.54134277712876,0.041124974422091065,29.472623348236084,14.331896305084229,25.87627410888672,853,128,725,725,0,8,236000.0
236,236999,20.57485286103142,34.7067819016586,0.04183688508189365,29.584661722183228,14.390899896621704,25.953693389892578,853,128,725,725,0,8,237000.0
237,237999,20.61663859046284,34.77474959823503,0.04253328155923952,29.706997632980347,14.453907012939453,25.9554443359375,862,129,733,733,0,8,238000.0
238,238999,20.65050007292652,34.83100654471921,0.04312643070467492,29.848081827163696,14.516479969024658,25.940242767333984,888,133,755,755,0,8,239000.0
239,239999,20.656862829977484,34.857309493116446,0.04305263246228663,29.963162422180176,14.580975532531738,26.18572235107422,892,133,759,759,0,8,240000.0
240,240999,20.637628451904764,34.845452155938354,0.04315242098093941,30.098184823989868,14.64218544960022,26.39318084716797,901,135,766,766,0,8,241000.0
241,241999,20.620396049563073,34.81553094213937,0.04326097804651241,30.23004674911499,14.701657056808472,26.507652282714844,901,135,766,766,0,8,242000.0
242,242999,20.604933168336487,34.808095083479,0.04318421186084598,30.356931686401367,14.761947870254517,26.542652130126953,903,136,767,767,0,8,243000.0
243,243999,20.590747884799903,34.7853426184091,0.04327425001657714,30.465018272399902,14.824772357940674,26.87106704711914,905,136,769,769,0,8,244000.0
244,244999,20.577933755740812,34.75844505345731,0.04323101874708657,30.590823650360107,14.886054992675781,27.035930633544922,908,137,771,771,0,8,245000.0
245,245999,20.568844554876346,34.735068384244556,0.043083945578641036,30.71392011642456,14.946919918060303,27.285282135009766,922,138,784,784,0,8,246000.0
246,246999,20.559984168044476,34.725505051761466,0.04300599503240543,30.84768295288086,15.01045036315918,27.380874633789062,931,140,791,791,0,8,247000.0
247,247999,20.553969709794845,34.709457350956825,0.04285804002108229,30.970558404922485,15.070847034454346,27.46782684326172,933,141,792,792,0,8,248000.0
248,248999,20.55158109046388,34.69561241470654,0.04282090832734964,31.103373289108276,15.129895210266113,27.507686614990234,948,143,805,805,0,8,249000.0
249,249999,20.54682464435252,34.67874514853226,0.042736964427024904,31.228747367858887,15.189248323440552,27.551528930664062,948,143,805,805,0,8,250000.0
250,250999,20.546245135012963,34.667468687070794,0.042684107615846845,31.359138011932373,15.24907660484314,27.661895751953125,951,144,807,807,0,8,251000.0
251,251999,20.54987882531326,34.654854908177896,0.04250149632101474,31.484715223312378,15.308153867721558,27.761249542236328,951,144,807,807,0,8,252000.0
252,252999,20.557038314889702,34.645133800826684,0.042279204937275994,31.602118968963623,15.367161750793457,27.85767364501953,952,144,808,808,0,8,253000.0
253,253999,20.562050007291944,34.63181725085501,0.04198233781591065,31.741847276687622,15.426693439483643,27.843807220458984,1000,148,852,852,0,8,254000.0
254,254999,20.566651899634724,34.62314670219996,0.041756681954547625,31.855849504470825,15.491132736206055,28.079448699951172,1002,148,854,854,0,8,255000.0
255,255999,20.56066490864759,34.598461290322305,0.04155013672092012,31.989933729171753,15.550363540649414,28.382549285888672,1031,150,881,881,0,8,256000.0
256,256999,20.548814712924695,34.59522621475036,0.04158458126697706,32.103492975234985,15.61113452911377,28.553253173828125,1034,151,883,883,0,8,257000.0
257,257999,20.542902932285926,34.59106174976749,0.04163285062116562,32.23333668708801,15.674498081207275,28.753459930419922,1042,152,890,890,0,8,258000.0
258,258999,20.538632846313646,34.582653917715554,0.04154888409910906,32.35807180404663,15.73603892326355,28.98519515991211,1048,153,895,895,0,8,259000.0
259,259999,20.535498952080914,34.57066787812594,0.04151095346934741,32.47338151931763,15.797722101211548,29.177875518798828,1048,153,895,895,0,8,260000.0
260,260999,20.543980644833574,34.608789914330245,0.04156407667596196,32.595157861709595,15.86055874824524,29.24112319946289,1054,154,900,900,0,8,261000.0
261,261999,20.55028778196378,34.630615176491844,0.0415048715248697,32.74205541610718,15.92697548866272,29.542404174804688,1060,155,905,905,0,8,262000.0
262,262999,20.559997481508336,34.64191354350138,0.04160274587365509,32.87359571456909,15.98832392692566,29.606121063232422,1073,157,916,916,0,8,263000.0
263,263999,20.57456050995269,34.66105395177204,0.04171051932808045,32.99119520187378,16.050151586532593,29.777843475341797,1073,157,916,916,0,8,264000.0
264,264999,20.596462252507028,34.69263560684862,0.04184544069631135,33.13029623031616,16.11070227622986,29.878707885742188,1073,157,916,916,0,8,265000.0
265,265999,20.622322889059443,34.76109720369466,0.04195105891163031,33.256481409072876,16.173639059066772,29.88003158569336,1075,158,917,917,0,8,266000.0
266,266999,20.64331808504629,34.78533892867256,0.04211729938091513,33.390416383743286,16.23497176170349,29.990249633789062,1096,160,936,936,0,8,267000.0
267,267999,20.66403205623411,34.80425384504094,0.042359816737498,33.517049074172974,16.295448541641235,30.09774398803711,1098,161,937,937,0,8,268000.0
268,268999,20.686550113893396,34.82889259996843,0.042741109966733304,33.63701391220093,16.356868982315063,30.20459747314453,1098,161,937,937,0,8,269000.0
269,269999,20.7087873752329,34.850549016503905,0.04312893481159785,33.757248401641846,16.4205424785614,30.541080474853516,1107,162,945,945,0,8,270000.0
270,270999,20.74833712069594,34.92677201208879,0.04389616987643796,33.88720655441284,16.483774185180664,30.67342758178711,1120,163,957,957,0,8,271000.0
271,271999,20.76578120825041,34.937457611252526,0.04451769157438923,34.02210712432861,16.54535150527954,30.728439331054688,1162,167,995,995,0,8,272000.0
272,272999,20.785287475348333,34.945891137875456,0.04487187200001064,34.14891839027405,16.60631775856018,30.80527114868164,1175,168,1007,1007,0,8,273000.0
273,273999,20.79730395101318,35.005760020636046,0.04433007729950644,34.42970156669617,16.667368173599243,31.137142181396484,1206,170,1036,1036,0,8,274000.0
274,274999,20.807073385261067,35.06096442922169,0.044447594979729055,34.55065202713013,16.728995084762573,31.416156768798828,1208,170,1038,1038,0,8,275000.0
275,275999,20.816048781525158,35.14102488911346,0.04397221953340458,34.68023943901062,16.793848514556885,31.592994689941406,1222,171,1051,1051,0,8,276000.0
276,276999,20.823192278748472,35.1659946432753,0.04393633847822864,34.80458641052246,16.85553741455078,31.693435668945312,1238,173,1065,1065,0,8,277000.0
277,277999,20.837748025761293,35.19758104442581,0.0436895212484395,34.920841217041016,16.91884207725525,31.982318878173828,1240,173,1067,1067,0,8,278000.0
278,278999,20.86043521540248,35.24205164554567,0.043993285090849765,35.05628991127014,16.981307983398438,32.090721130371094,1255,175,1080,1080,0,8,279000.0
279,279999,20.880477955863064,35.26895389856005,0.044420001828595845,35.18898844718933,17.044610261917114,32.338619232177734,1265,176,1089,1089,0,8,280000.0
280,280999,20.90711967064556,35.3048428627002,0.04488695907681939,35.32350134849548,17.113422870635986,32.641658782958984,1281,178,1103,1103,0,8,281000.0
281,281999,20.940233384125175,35.376305142221405,0.04566467706402444,35.440868616104126,17.172611236572266,32.738990783691406,1283,179,1104,1104,0,8,282000.0
282,282999,20.9752204168752,35.452277715347485,0.04643982186489959,35.58581471443176,17.23434352874756,32.74574661254883,1307,183,1124,1124,0,8,283000.0
283,283999,21.014051494197908,35.526394876007565,0.04754293656716768,35.72766995429993,17.29639506340027,32.6609992980957,1325,186,1139,1139,0,8,284000.0
284,284999,21.05501144656483,35.59715845746331,0.0489211588960734,35.84984230995178,17.358073949813843,32.772586822509766,1332,188,1144,1144,0,8,285000.0
285,285999,21.092513579787216,35.64176539284983,0.05025834436741139,35.973674058914185,17.419716835021973,32.891178131103516,1332,188,1144,1144,0,8,286000.0
286,286999,21.13925005069223,35.734319978977084,0.05188799461758331,36.122801065444946,17.481470346450806,32.8986930847168,1366,193,1173,1173,0,8,287000.0
287,287999,21.183019515344363,35.79678666909766,0.05339413116148117,36.2489914894104,17.544132947921753,33.0120849609375,1368,194,1174,1174,0,8,288000.0
288,288999,21.23724685885782,35.90418939527332,0.055261754302487254,36.376150608062744,17.606160640716553,33.34074783325195,1391,195,1196,1196,0,8,289000.0
289,289999,21.294231478769902,36.00333243691008,0.05786422922698775,36.496002197265625,17.66683268547058,33.5048828125,1416,197,1219,1219,0,8,290000.0
290,290999,21.348601561776388,36.096506596313915,0.06016253916479242,36.615302324295044,17.728713512420654,33.59193801879883,1435,199,1236,1236,0,8,291000.0
291,291999,21.4003494048649,36.183691625872854,0.061659041282276394,36.7302360534668,17.789148569107056,33.83110809326172,1446,200,1246,1246,0,8,292000.0
292,292999,21.428011422908405,36.24312668187738,0.061729791341487594,36.866355895996094,17.850152015686035,33.97955322265625,1477,203,1274,1274,0,8,293000.0
293,293999,21.429441990542987,36.272315301666474,0.06125941116415001,36.98920464515686,17.91222643852234,34.31675338745117,1484,203,1281,1281,0,8,294000.0
294,294999,21.419987584659747,36.27200482769075,0.06113483622624616,37.114328145980835,17.972991228103638,34.526912689208984,1499,204,1295,1295,0,8,295000.0
295,295999,21.412689340924565,36.26764311398508,0.0609551154071577,37.241705656051636,18.033945560455322,34.6362419128418,1499,204,1295,1295,0,8,296000.0
296,296999,21.409862783180248,36.263011966450776,0.060698884785940765,37.3647403717041,18.094863176345825,34.74116134643555,1512,205,1307,1307,0,8,297000.0
297,297999,21.409431945013505,36.25178262336784,0.060625200935004675,37.4948205947876,18.156543016433716,34.8587760925293,1532,207,1325,1325,0,8,298000.0
298,298999,21.408787253807272,36.24361544389626,0.06064685584445506,37.62849164009094,18.217881679534912,34.91032409667969,1557,209,1348,1348,0,8,299000.0
299,299999,21.407354041038367,36.2309976024517,0.06051756426430854,37.760581970214844,18.2862868309021,35.27564239501953,1565,210,1355,1355,0,8,300000.0
300,300999,21.40448230495308,36.213647236060226,0.06029638375353841,37.881399631500244,18.348792791366577,35.44877624511719,1567,211,1356,1356,0,8,301000.0
301,301999,21.404127516624065,36.2034869669749,0.06017618226503274,38.00728225708008,18.410910606384277,35.58125686645508,1582,213,1369,1369,0,8,302000.0
302,302999,21.40169020426563,36.186836617737974,0.06011621923265453,38.11994481086731,18.47264266014099,35.762454986572266,1584,213,1371,1371,0,8,303000.0
303,303999,21.396616015179646,36.168071279152635,0.060033465231200234,38.25183320045471,18.533127546310425,35.81951904296875,1584,213,1371,1371,0,8,304000.0
304,304999,21.397484656255607,36.160593196605106,0.05998881892801666,38.37452840805054,18.593200206756592,35.867332458496094,1584,213,1371,1371,0,8,305000.0
305,305999,21.397874910673075,36.15198402117572,0.059875551427458706,38.50038504600525,18.654298543930054,36.07093811035156,1595,214,1381,1381,0,8,306000.0
306,306999,21.39912768137096,36.13811919092557,0.05994984165520678,38.62592577934265,18.71654725074768,36.185184478759766,1595,214,1381,1381,0,8,307000.0
307,307999,21.405643391921792,36.13447312676923,0.060067922381225713,38.75598883628845,18.778708457946777,36.19969940185547,1599,216,1383,1383,0,9,308000.0
308,308999,21.41964112727865,36.16255298129328,0.060579134973119286,38.88347148895264,18.844508171081543,36.745967864990234,1617,217,1400,1400,0,9,309000.0
309,309999,21.438464323377342,36.2129762755231,0.061113985408573934,38.99720740318298,18.908244609832764,36.947227478027344,1617,217,1400,1400,0,9,310000.0
310,310999,21.443822277414455,36.22286222242518,0.06157033136794654,39.12013125419617,18.972103357315063,37.1868896484375,1635,218,1417,1417,0,9,311000.0
311,311999,21.45032099856041,36.24512837681931,0.0618365138272613,39.26156449317932,19.03765892982483,37.20145034790039,1653,221,1432,1432,0,9,312000.0
312,312999,21.44310958363212,36.28174453008401,0.06168163166665308,39.394492387771606,19.1074800491333,37.684043884277344,1684,222,1462,1462,0,9,313000.0
313,313999,21.432964722742163,36.285969093310456,0.06163248360865303,39.52088212966919,19.167574644088745,37.953125,1710,224,1486,1486,0,9,314000.0
314,314999,21.437835331829138,36.31809599212201,0.061929210899203446,39.64208173751831,19.229430198669434,38.18108367919922,1713,225,1488,1488,0,9,315000.0
315,315999,21.43771719395365,36.342837847773076,0.06196279864368459,39.77749752998352,19.293813943862915,38.299354553222656,1742,227,1515,1515,0,9,316000.0
316,316999,21.44401792602179,36.36983069144674,0.06172694671156009,39.898940324783325,19.355238437652588,38.64002990722656,1756,228,1528,1528,0,9,317000.0
317,317999,21.443450093571492,36.373374436690064,0.06229175260512165,40.02746915817261,19.41737699508667,38.804527282714844,1761,230,1531,1531,0,9,318000.0
318,318999,21.45015343902853,36.39773806386095,0.062217747623747544,40.159968852996826,19.48262882232666,39.31893539428711,1778,231,1547,1547,0,9,319000.0
319,319999,21.461845278183542,36.41856137989341,0.06218430150566778,40.28013849258423,19.545297145843506,39.46614074707031,1794,233,1561,1561,0,9,320000.0
320,320999,21.469651896479586,36.42742750903535,0.06207651538943093,40.4077308177948,19.61007285118103,39.64004135131836,1796,234,1562,1562,0,9,321000.0
321,321999,21.471329819298518,36.41977144339098,0.06201557451645978,40.5356707572937,19.670827627182007,39.77091598510742,1800,235,1565,1565,0,9,322000.0
322,322999,21.47862607832771,36.423608330566495,0.06179946830458105,40.670658588409424,19.731004238128662,39.74525451660156,1816,237,1579,1579,0,9,323000.0
323,323999,21.487725190959925,36.464758398917574,0.06153123087235135,40.80382227897644,19.79147481918335,39.7328987121582,1831,239,1592,1592,0,9,324000.0
324,324999,21.4899758859847,36.45881765791065,0.06144519093184164,40.92219018936157,19.857835054397583,40.05069351196289,1835,239,1596,1596,0,9,325000.0
325,325999,21.488466241651913,36.445621807791035,0.06154285529746739,41.05613923072815,19.922974824905396,40.15633010864258,1847,240,1607,1607,0,9,326000.0
326,326999,21.496958264787843,36.449215008909015,0.061583135081202944,41.19066023826599,19.983872175216675,40.333892822265625,1877,243,1634,1634,0,9,327000.0
327,327999,21.504897342020623,36.44983544839703,0.061413174476174004,41.333580493927,20.047543048858643,40.858585357666016,1918,245,1673,1673,0,9,328000.0
328,328999,21.507705080057367,36.44130600096974,0.06157871051744124,41.476457834243774,20.11354422569275,40.964698791503906,1961,248,1713,1713,0,9,329000.0
329,329999,21.50188935210295,36.421614557676236,0.06174960364047899,41.60997486114502,20.180329084396362,41.2224235534668,1995,250,1745,1745,0,9,330000.0
330,330999,21.49577733206642,36.39958641599681,0.06174272193218877,41.74292969703674,20.24028706550598,41.30859375,2035,254,1781,1781,0,9,331000.0
331,331999,21.490669191302214,36.41058343627053,0.06147956842835767,41.85890197753906,20.301644325256348,41.959651947021484,2058,255,1803,1803,0,9,332000.0
332,332999,21.473049585875142,36.385981743076904,0.06150556855239464,41.97446870803833,20.36565089225769,42.369850158691406,2064,255,1809,1809,0,9,333000.0
333,333999,21.458995829017738,36.365960647516275,0.061490876627744884,42.09056234359741,20.427281379699707,42.56544494628906,2067,256,1811,1811,0,9,334000.0
334,334999,21.4457787417566,36.35553329499284,0.06156939935443162,42.2005660533905,20.489027500152588,42.740970611572266,2068,256,1812,1812,0,9,335000.0
335,335999,21.437120237029472,36.34195702060338,0.061561945639789006,42.32120943069458,20.550874948501587,43.01567840576172,2077,257,1820,1820,0,9,336000.0
336,336999,21.433948707167986,36.34752696555921,0.06160688183366769,42.4701361656189,20.61622190475464,43.08240509033203,2086,260,1826,1826,0,9,337000.0
337,337999,21.430266534281394,36.332423105284306,0.06165364215970126,42.58802247047424,20.677100896835327,43.20893096923828,2086,260,1826,1826,0,9,338000.0
338,338999,21.430936452984163,36.327987153071014,0.0616955565961983,42.69501280784607,20.73882746696472,43.71459197998047,2094,260,1834,1834,0,9,339000.0
339,339999,21.43010804921873,36.315113950021136,0.06189479472637471,42.858673095703125,20.800386428833008,43.7925910949707,2159,266,1893,1893,0,9,340000.0
340,340999,21.435860686063943,36.315557482319264,0.06205957933490558,42.98349642753601,20.865392446517944,43.984779357910156,2163,267,1896,1896,0,9,341000.0
341,341999,21.444843993347188,36.32001439698365,0.06243410708708497,43.1015145778656,20.927313089370728,44.225223541259766,2167,267,1900,1900,0,9,342000.0
342,342999,21.467317688752043,36.35417230659206,0.06298389213984712,43.22141122817993,20.986895084381104,44.3376579284668,2168,267,1901,1901,0,9,343000.0
343,343999,21.485126363017983,36.37347896372595,0.06362719550876927,43.3599648475647,21.048722982406616,44.28839111328125,2176,270,1906,1906,0,9,344000.0
344,344999,21.51406293644068,36.410059317100405,0.0643827926999676,43.48505902290344,21.108303785324097,44.62628173828125,2189,271,1918,1918,0,9,345000.0
345,345999,21.543957623240257,36.4506926225412,0.06509056734575003,43.609299421310425,21.168954610824585,44.68027877807617,2210,273,1937,1937,0,9,346000.0
346,346999,21.574591333003934,36.48592300726728,0.06590334945865806,43.729889154434204,21.230774879455566,44.85995101928711,2211,273,1938,1938,0,9,347000.0
347,347999,21.616130263245942,36.54815963106223,0.06747123513190756,43.85613679885864,21.29578399658203,45.62491226196289,2230,273,1957,1957,0,9,348000.0
348,348999,21.64557928487177,36.57973187940194,0.06832747297256814,43.97276711463928,21.35688328742981,45.79103469848633,2238,274,1964,1964,0,9,349000.0
349,349999,21.67873966267719,36.61523231553827,0.06950549200030987,44.08389854431152,21.417809009552002,46.144107818603516,2245,274,1971,1971,0,9,350000.0
350,350999,21.698849583870206,36.64009256609168,0.06997930561299981,44.21820592880249,21.478473901748657,46.235801696777344,2281,277,2004,2004,0,9,351000.0
351,351999,21.691484857172497,36.63050074539551,0.06979472864181246,44.32944655418396,21.53978204727173,46.8541145324707,2301,277,2024,2024,0,9,352000.0
352,352999,21.679116174894045,36.61320761355966,0.06967307145417312,44.47406840324402,21.604703903198242,47.23954772949219,2310,278,2032,2032,0,9,353000.0
353,353999,21.66474365896016,36.59268861770568,0.06956794189929305,44.61026382446289,21.668335676193237,47.42147445678711,2340,281,2059,2059,0,9,354000.0
354,354999,21.64956434295134,36.56747422846718,0.06951461482167431,44.73038911819458,21.72986102104187,47.60839080810547,2340,281,2059,2059,0,9,355000.0
355,355999,21.64539731967825,36.55962385493227,0.06934571981013105,44.85736298561096,21.79450511932373,47.89152908325195,2353,282,2071,2071,0,9,356000.0
356,356999,21.648055911443105,36.55250184538427,0.06920588835071428,44.98180031776428,21.858080625534058,48.05269241333008,2355,283,2072,2072,0,9,357000.0
357,357999,21.64676340113113,36.540352830781906,0.06914445305440886,45.108872175216675,21.921818733215332,48.17826461791992,2355,283,2072,2072,0,9,358000.0
358,358999,21.643010260091728,36.52562974403345,0.06908353750293839,45.23250436782837,21.987542390823364,48.743534088134766,2367,284,2083,2083,0,9,359000.0
359,359999,21.642165594565782,36.514445773426615,0.06901402789430844,45.360933780670166,22.049745082855225,48.906959533691406,2384,286,2098,2098,0,9,360000.0
360,360999,21.64225142939097,36.506528796459605,0.06908389052300168,45.49133610725403,22.112805604934692,49.03404998779297,2388,288,2100,2100,0,9,361000.0
361,361999,21.64612263804745,36.497947707052184,0.0692575581514212,45.60767674446106,22.177055835723877,49.30390930175781,2392,288,2104,2104,0,9,362000.0
362,362999,21.648618253992666,36.48735182708608,0.06925611750490657,45.748507499694824,22.24023723602295,49.376564025878906,2407,289,2118,2118,0,9,363000.0
363,363999,21.65285906360979,36.4789911128272,0.06923589962987953,45.880549907684326,22.300747394561768,49.34857177734375,2411,291,2120,2120,0,9,364000.0
364,364999,21.65620028719545,36.4713851153853,0.06905714320497269,46.03566837310791,22.36300778388977,49.59760284423828,2445,294,2151,2151,0,9,365000.0
365,365999,21.66289268248086,36.46564405058269,0.06896622763842508,46.151501178741455,22.42423701286316,49.81352615356445,2446,294,2152,2152,0,9,366000.0
366,366999,21.67105507485825,36.463870794974824,0.0689844959352397,46.487032651901245,22.487483739852905,49.96957778930664,2453,296,2157,2157,0,9,367000.0
367,367999,21.68143806061528,36.46632174417968,0.06874776374514213,46.61789417266846,22.552507400512695,50.69230651855469,2472,296,2176,2176,0,9,368000.0
368,368999,21.687038748802834,36.46095234262635,0.0686837595682358,46.741337060928345,22.617199897766113,50.95033645629883,2472,296,2176,2176,0,9,369000.0
369,369999,21.689546016497705,36.45108667562083,0.0686805094912859,46.855369329452515,22.679216146469116,51.12748718261719,2472,296,2176,2176,0,9,370000.0
370,370999,21.69619247049427,36.444079160376106,0.06862911626501589,46.971829891204834,22.73926305770874,51.58108901977539,2480,296,2184,2184,0,9,371000.0
371,371999,21.689007412444113,36.43090677976676,0.06858174326976907,47.11159372329712,22.802587270736694,52.016563415527344,2534,298,2236,2236,0,9,372000.0
372,372999,21.67792729029869,36.43300634167352,0.0684447084299653,47.24779748916626,22.86651635169983,52.37557601928711,2545,299,2246,2246,0,9,373000.0
373,373999,21.660195143621866,36.40724618374922,0.06855556982012301,47.373196840286255,22.93126678466797,52.616119384765625,2547,300,2247,2247,0,9,374000.0
374,374999,21.64095052699356,36.375616970228386,0.06863564774783149,47.513895750045776,22.993227243423462,52.7353401184082,2578,302,2276,2276,0,9,375000.0
375,375999,21.62413877915309,36.349876661731294,0.06866114777824361,47.62498712539673,23.056182861328125,53.063716888427734,2583,302,2281,2281,0,9,376000.0
376,376999,21.60987316778431,36.33660861571458,0.06860603439043511,47.754554986953735,23.11720895767212,53.19812774658203,2585,303,2282,2282,0,9,377000.0
377,377999,21.596288300753507,36.32189390120789,0.06855814446426778,47.871373414993286,23.179667711257935,53.66842269897461,2596,303,2293,2293,0,9,378000.0
378,378999,21.580174846263066,36.29196930755081,0.06856898561341873,47.992364168167114,23.241438150405884,53.868255615234375,2614,304,2310,2310,0,9,379000.0
379,379999,21.565005485304177,36.26559369476361,0.06859461395303712,48.10859513282776,23.30288290977478,54.02592849731445,2616,305,2311,2311,0,9,380000.0
380,380999,21.55568556884193,36.253014563897324,0.06867653231377113,48.25720453262329,23.363669395446777,54.36254119873047,2656,309,2347,2347,0,9,381000.0
381,381999,21.541651805792206,36.22794584165819,0.06880339923993228,48.37026524543762,23.423880577087402,54.6287956237793,2657,309,2348,2348,0,9,382000.0
382,382999,21.532531782113196,36.23088959250372,0.06878834586773075,48.504135608673096,23.487569332122803,54.74996566772461,2663,310,2353,2353,0,9,383000.0
383,383999,21.52185505754054,36.208764574342496,0.06884450212773774,48.6413938999176,23.549902200698853,55.187294006347656,2676,312,2364,2364,0,9,384000.0
384,384999,21.510113739356804,36.18519986274567,0.06890995367014785,48.77551889419556,23.611366271972656,55.31227493286133,2698,314,2384,2384,0,9,385000.0
385,385999,21.4994260952266,36.16107772967691,0.06885139253385508,48.89986252784729,23.67655611038208,55.9532470703125,2721,315,2406,2406,0,9,386000.0
386,386999,21.484275523882655,36.13614283817827,0.0689713214158667,49.008795499801636,23.735655307769775,56.18571472167969,2723,316,2407,2407,0,9,387000.0
387,387999,21.47105035713676,36.110365436856746,0.06898913887812941,49.12829899787903,23.79547119140625,56.62873458862305,2753,317,2436,2436,0,9,388000.0
388,388999,21.467957063900744,36.143608636169176,0.06887148617540839,49.255690813064575,23.85634183883667,57.23057556152344,2779,318,2461,2461,0,9,389000.0
389,389999,21.462398854438586,36.13983560725689,0.06932860838798749,49.3899028301239,23.917855739593506,57.71194839477539,2818,320,2498,2498,0,9,390000.0
390,390999,21.45635102778666,36.12853360880455,0.0695568750057678,49.51796746253967,23.978386163711548,58.08949279785156,2822,321,2501,2501,0,9,391000.0
391,391999,21.46230394013285,36.140476727533255,0.06967280552857003,49.64449334144592,24.040201663970947,58.620643615722656,2840,322,2518,2518,0,9,392000.0
392,392999,21.479020536761375,36.176181416213375,0.06965399037663755,49.77649688720703,24.10670518875122,58.791053771972656,2843,323,2520,2520,0,9,393000.0
393,393999,21.500552742105757,36.22230407088131,0.07043582472963095,49.91541385650635,24.167980194091797,59.038719177246094,2871,325,2546,2546,0,9,394000.0
394,394999,21.53318219012474,36.28690079741168,0.07073422712696742,50.02959942817688,24.231019735336304,59.59339904785156,2883,325,2558,2558,0,9,395000.0
395,395999,21.56245143885339,36.3401755276698,0.0713347117622175,50.158713817596436,24.298539638519287,59.77467727661133,2885,326,2559,2559,0,9,396000.0
396,396999,21.594694019284898,36.394409806670666,0.07233496530271888,50.27256774902344,24.35898733139038,59.88490676879883,2887,327,2560,2560,0,9,397000.0
397,397999,21.63611913557121,36.48118122805411,0.0733218882770621,50.40442657470703,24.423426866531372,60.28909683227539,2894,327,2567,2567,0,9,398000.0
398,398999,21.671064303652745,36.5377204785962,0.07445136176641853,50.53925156593323,24.48978066444397,60.444068908691406,2897,328,2569,2569,0,9,399000.0
399,399999,21.71130831884866,36.636083572572595,0.07514533153424185,50.68085026741028,24.553728103637695,60.4791145324707,2899,329,2570,2570,0,9,400000.0
400,400999,21.753634425933896,36.71444102641096,0.07540374607211908,50.80312490463257,24.61898636817932,61.01744079589844,2908,329,2579,2579,0,9,401000.0
401,401999,21.79811642184234,36.793173022192796,0.07590520268958445,50.92589831352234,24.682782411575317,61.170284271240234,2908,329,2579,2579,0,9,402000.0
402,402999,21.84482619442619,36.892129038823605,0.0764473201635073,51.064226150512695,24.745712518692017,61.6751594543457,2931,331,2600,2600,0,9,403000.0
403,403999,21.89110225413408,36.96824987969539,0.07741703040513592,51.20399618148804,24.809502124786377,61.90714645385742,2935,333,2602,2602,0,9,404000.0
404,404999,21.934395693671075,37.040605621855775,0.07892272756343766,51.31005501747131,24.871432781219482,62.11494445800781,2935,333,2602,2602,0,9,405000.0
405,405999,21.969958132206347,37.08705516676497,0.07950493257256097,51.418702363967896,24.933082342147827,62.5504264831543,2945,333,2612,2612,0,9,406000.0
406,406999,21.984405689896445,37.10243528140402,0.07993730120030995,51.56030631065369,24.997076749801636,62.9388427734375,2965,336,2629,2629,0,9,407000.0
407,407999,21.980483972289544,37.11638853309698,0.07959921734308506,51.684449434280396,25.05834412574768,63.39401626586914,2982,337,2645,2645,0,9,408000.0
408,408999,21.979116807203557,37.14599687787779,0.07933561305813164,52.04093837738037,25.120776891708374,63.95750427246094,2996,338,2658,2658,0,9,409000.0
409,409999,21.97798325302856,37.15385736614002,0.07910152308757201,52.16025424003601,25.18330216407776,64.24750518798828,2997,338,2659,2659,0,9,410000.0
410,410999,21.97670411836367,37.159055508814276,0.07897058531754031,52.292372703552246,25.245317697525024,64.31389617919922,3002,340,2662,2662,0,9,411000.0
411,411999,21.976347912620103,37.158183236923705,0.07877952689534384,52.43060898780823,25.31040620803833,64.65248107910156,3035,342,2693,2693,0,9,412000.0
412,412999,21.974398772228064,37.15031204726269,0.07875174364052717,52.55653619766235,25.374151706695557,64.86030960083008,3038,343,2695,2695,0,9,413000.0
413,413999,21.972646094849473,37.14030375714925,0.07860901092052319,52.684128761291504,25.436647653579712,65.34555435180664,3049,343,2706,2706,0,9,414000.0
414,414999,21.972671193628152,37.129761001970046,0.07846287044338418,52.79316997528076,25.498533248901367,65.6724967956543,3050,343,2707,2707,0,9,415000.0
415,415999,21.972497469039205,37.12078758439521,0.0784491308834705,52.917274475097656,25.56043767929077,65.85652542114258,3052,344,2708,2708,0,9,416000.0
416,416999,21.970034609417965,37.11414670508806,0.07838991351641,53.05615711212158,25.62265157699585,66.14990234375,3065,346,2719,2719,0,9,417000.0
417,417999,21.96966233798392,37.10372406134988,0.0782151901875715,53.17414832115173,25.683147430419922,66.46681213378906,3068,347,2721,2721,0,9,418000.0
418,418999,21.965919950143366,37.08745179148035,0.07819291503325154,53.30616307258606,25.74441409111023,66.60561752319336,3101,350,2751,2751,0,9,419000.0
419,419999,21.965436483697566,37.07810881666204,0.07820445506965501,53.45527362823486,25.808887243270874,66.66262817382812,3123,353,2770,2770,0,9,420000.0
420,420999,21.970144403827682,37.11064045243845,0.07786426709252592,53.57890439033508,25.87117099761963,67.25236511230469,3134,354,2780,2780,0,9,421000.0
421,421999,21.973444061152797,37.12680971800051,0.07777264594238475,53.70800566673279,25.938044548034668,67.46980285644531,3136,355,2781,2781,0,9,422000.0
422,422999,21.97554470131616,37.11926722546699,0.07772269161487311,53.82808756828308,25.99971294403076,67.9959831237793,3157,356,2801,2801,0,9,423000.0
423,423999,21.973819127168134,37.10239978025912,0.07765237392605118,53.9619996547699,26.064880847930908,68.29640197753906,3166,358,2808,2808,0,9,424000.0
424,424999,21.971241016587037,37.087321337906005,0.07769061507539354,54.07637929916382,26.129034996032715,68.54543685913086,3166,358,2808,2808,0,9,425000.0
425,425999,21.97198249716422,37.074142138924785,0.0775908150254433,54.212801933288574,26.190497636795044,68.94328308105469,3201,360,2841,2841,0,9,426000.0
426,426999,21.96365653524129,37.04945806024592,0.07755074676972684,54.359681606292725,26.25197434425354,69.14296340942383,3242,364,2878,2878,0,9,427000.0
427,427999,21.946701316492735,37.026299426287245,0.07755082124895607,54.47535538673401,26.31395649909973,69.77059936523438,3263,364,2899,2899,0,9,428000.0
428,428999,21.92597758181391,36.997109138411474,0.07768249382481196,54.59807324409485,26.376322031021118,70.22402954101562,3274,365,2909,2909,0,9,429000.0
429,429999,21.908188451799496,36.974752118755745,0.0777414798390863,54.71413016319275,26.438068866729736,70.48688507080078,3275,365,2910,2910,0,9,430000.0
430,430999,21.88802515432359,36.94663008482669,0.07782395477319737,54.84423279762268,26.500004291534424,70.60255813598633,3303,367,2936,2936,0,9,431000.0
431,431999,21.870084728133516,36.91774257463949,0.07791084707539409,54.968125104904175,26.560620307922363,70.92591094970703,3310,368,2942,2942,0,9,432000.0
432,432999,21.85360764783315,36.89806420382509,0.07796162262681083,55.098174810409546,26.62133026123047,71.07876968383789,3313,369,2944,2944,0,9,433000.0
433,433999,21.83503101979106,36.86873874226238,0.0780268319884233,55.22996258735657,26.68240785598755,71.32041931152344,3323,370,2953,2953,0,9,434000.0
434,434999,21.819427027838177,36.84239585573637,0.07804070452499912,55.343990325927734,26.744142532348633,71.65459060668945,3327,370,2957,2957,0,9,435000.0
435,435999,21.80114907465148,36.81356270317498,0.07816244586740273,55.489036083221436,26.80787467956543,71.77104568481445,3351,373,2978,2978,0,9,436000.0
436,436999,21.783826876501305,36.786534105152924,0.07825522301465215,55.625051736831665,26.872534036636353,71.9484977722168,3356,374,2982,2982,0,9,437000.0
437,437999,21.769311413382294,36.76246994711664,0.07825083869596483,55.75575017929077,26.93714427947998,72.30659866333008,3375,375,3000,3000,0,9,438000.0
438,438999,21.754766643737195,36.739525943641866,0.07830795106164934,55.888121128082275,27.000829458236694,72.57976150512695,3377,376,3001,3001,0,9,439000.0
439,439999,21.738231273196952,36.71283310033882,0.07839116897475906,56.02018618583679,27.062652111053467,72.63040161132812,3381,378,3003,3003,0,9,440000.0
440,440999,21.72596091689346,36.688123739145745,0.0783115658949115,56.139108657836914,27.12321400642395,73.16648483276367,3408,379,3029,3029,0,9,441000.0
441,441999,21.71158159431336,36.66027853489642,0.07830586651437377,56.263800621032715,27.18451166152954,73.32999801635742,3410,380,3030,3030,0,10,442000.0
442,442999,21.701204784929743,36.63863743068343,0.07824831042858882,56.398391008377075,27.24752640724182,73.87319564819336,3432,381,3051,3051,0,10,443000.0
443,443999,21.687070542394864,36.612299053708455,0.07824088537657536,56.531984090805054,27.30842614173889,74.12319564819336,3471,383,3088,3088,0,10,444000.0
444,444999,21.67064622047219,36.5848384598439,0.07832268069443626,56.648152589797974,27.36928963661194,74.34281921386719,3471,383,3088,3088,0,10,445000.0
445,445999,21.658144841453286,36.5617902931567,0.07835540882907832,56.76840138435364,27.434338092803955,74.82418441772461,3482,383,3099,3099,0,10,446000.0
446,446999,21.64229194553512,36.53446170499631,0.07845403386301941,56.91386127471924,27.498700618743896,75.2342529296875,3522,386,3136,3136,0,10,447000.0
447,447999,21.626700527033815,36.524852417813,0.07825319631010563,57.053446531295776,27.56010913848877,75.66539764404297,3560,389,3171,3171,0,10,448000.0
448,448999,21.60643850976799,36.49504525713188,0.07837922765324412,57.16545605659485,27.622008085250854,76.24502563476562,3571,389,3182,3182,0,10,449000.0
449,449999,21.58863751273563,36.47656647491774,0.07841322755276248,57.27454471588135,27.681714057922363,76.47953414916992,3571,389,3182,3182,0,10,450000.0
450,450999,21.571668681403132,36.45330257041235,0.07846824854179024,57.38412618637085,27.741970777511597,76.67351150512695,3573,389,3184,3184,0,10,451000.0
451,451999,21.556130790846755,36.427036911583414,0.07853925067883549,57.49592304229736,27.803059339523315,77.05619812011719,3578,389,3189,3189,0,10,452000.0
452,452999,21.53983869574777,36.405122226109185,0.07857195072793832,57.65606713294983,27.866620540618896,77.06671524047852,3607,393,3214,3214,0,10,453000.0
453,453999,21.521701598680565,36.379180779892245,0.07865800759760422,57.782960653305054,27.92829418182373,77.4910659790039,3621,394,3227,3227,0,10,454000.0
454,454999,21.506384675894555,36.35494324828035,0.07872219708883743,57.8880729675293,27.98920464515686,77.84808349609375,3624,394,3230,3230,0,10,455000.0
455,455999,21.48755050671442,36.32971263607803,0.07884833437240701,58.024129152297974,28.0503089427948,78.00681686401367,3650,397,3253,3253,0,10,456000.0
456,456999,21.467414432599806,36.30269759655355,0.07899626068332932,58.154845237731934,28.112566709518433,78.15773391723633,3652,398,3254,3254,0,10,457000.0
457,457999,21.453962302683745,36.289272546776175,0.07891143570245585,58.29293417930603,28.173267126083374,78.54282760620117,3677,400,3277,3277,0,10,458000.0
458,458999,21.436742410032007,36.260699229595815,0.07896161559154813,58.41468572616577,28.238743543624878,78.95292663574219,3682,401,3281,3281,0,10,459000.0
459,459999,21.421547546432656,36.23979044554616,0.07895675981492756,58.55868983268738,28.299973487854004,79.03539276123047,3690,404,3286,3286,0,10,460000.0
460,460999,21.41036720194018,36.21783382858935,0.07887522272272829,58.96202349662781,28.36261534690857,79.64971160888672,3719,405,3314,3314,0,10,461000.0
461,461999,21.398000877965696,36.19331235281764,0.07885069986780113,59.074374198913574,28.423527479171753,79.90982818603516,3719,405,3314,3314,0,10,462000.0
462,462999,21.387514557994376,36.170553469660625,0.07877674233611431,59.20363664627075,28.487213373184204,80.41150283813477,3743,406,3337,3337,0,10,463000.0
463,463999,21.378764518508152,36.15082113704991,0.07871095606448153,59.338919162750244,28.54995822906494,80.80337905883789,3797,409,3388,3388,0,10,464000.0
464,464999,21.366748133096255,36.12766859157828,0.07873149921767497,59.45574235916138,28.610111713409424,81.06566619873047,3797,409,3388,3388,0,10,465000.0
465,465999,21.35937845803503,36.1100104935371,0.07864822623005152,59.57311987876892,28.670566082000732,81.48738861083984,3816,410,3406,3406,0,10,466000.0
466,466999,21.34421503544359,36.083063141079485,0.07868391253403229,59.70077204704285,28.730355978012085,81.78737258911133,3839,411,3428,3428,0,10,467000.0
467,467999,21.327280026421136,36.0579747937888,0.07867301858467768,59.82214426994324,28.790693283081055,82.5571517944336,3868,412,3456,3456,0,10,468000.0
468,468999,21.312145284875825,36.047664754740374,0.07862281374784741,59.956857204437256,28.851656675338745,83.0283203125,3880,413,3467,3467,0,10,469000.0
469,469999,21.29800656478231,36.026200538907275,0.07861749293531173,60.10914921760559,28.912612676620483,83.20571899414062,3939,416,3523,3523,0,10,470000.0
470,470999,21.28462278700436,36.00367045664108,0.07862847440846621,60.231914043426514,28.973397970199585,83.41347122192383,3944,417,3527,3527,0,10,471000.0
471,471999,21.275825860076175,35.99846871979893,0.07850835884045049,60.35321831703186,29.034215450286865,83.73594284057617,3958,418,3540,3540,0,10,472000.0
472,472999,21.265645255394123,35.97863606832969,0.0784796626550095,60.510780811309814,29.097317934036255,83.80374526977539,3987,422,3565,3565,0,10,473000.0
473,473999,21.252221368741843,35.96141494277875,0.07851936295404516,60.6246120929718,29.15780472755432,84.02733993530273,3987,422,3565,3565,0,10,474000.0
474,474999,21.244570062006062,35.96622773074411,0.07835574667439005,60.73943042755127,29.22107696533203,84.5738410949707,4000,422,3578,3578,0,10,475000.0
475,475999,21.237005096080917,35.956528805493534,0.07826514177367139,60.85825753211975,29.282992839813232,84.78108215332031,4002,423,3579,3579,0,10,476000.0
476,476999,21.229092051273902,35.94769159148843,0.07820893950317509,60.992926836013794,29.34519624710083,84.89481735229492,4006,425,3581,3581,0,10,477000.0
477,477999,21.21799651216766,35.92578719819516,0.07822285276058083,61.13006567955017,29.408518314361572,85.25692367553711,4021,427,3594,3594,0,10,478000.0
478,478999,21.208024121879813,35.90818106145426,0.07819068962109876,61.27809715270996,29.47066020965576,85.30085754394531,4030,430,3600,3600,0,10,479000.0
479,479999,21.19800386039669,35.88811256217234,0.07823225954623636,61.40992975234985,29.53546905517578,85.46921157836914,4033,431,3602,3602,0,10,480000.0
480,480999,21.189753465530107,35.86805386362064,0.07814920131946235,61.54070830345154,29.598785638809204,85.90743637084961,4044,432,3612,3612,0,10,481000.0
481,481999,21.188490722706728,35.85690847023674,0.0779960096325355,61.67670798301697,29.660587310791016,86.03638458251953,4050,434,3616,3616,0,10,482000.0
482,482999,21.186811691030552,35.84332305216543,0.07788377412741843,61.80016207695007,29.721336603164673,86.19780349731445,4052,435,3617,3617,0,10,483000.0
483,483999,21.185717658466203,35.83323893113244,0.07771335880524388,61.93508338928223,29.787695169448853,86.98463439941406,4078,436,3642,3642,0,10,484000.0
484,484999,21.18261477155517,35.82057780321474,0.07764110589651041,62.045889139175415,29.847896575927734,87.25685501098633,4078,436,3642,3642,0,10,485000.0
485,485999,21.17902673180645,35.80821177522146,0.07758091125394684,62.15704584121704,29.90934109687805,87.47028350830078,4079,436,3643,3643,0,10,486000.0
486,486999,21.17892530342957,35.79805786976338,0.07734356805922149,62.28967046737671,29.9717435836792,87.98550796508789,4096,438,3658,3658,0,10,487000.0
487,487999,21.16844823667534,35.779959014084575,0.07729162700867231,62.417728662490845,30.034443140029907,88.69657135009766,4120,439,3681,3681,0,10,488000.0
488,488999,21.15772192915354,35.77608800033989,0.07724191325418528,62.53986597061157,30.095866918563843,89.15052032470703,4141,440,3701,3701,0,10,489000.0
489,489999,21.14295723601511,35.758146121436994,0.07762049839069951,62.67119026184082,30.157273054122925,89.45148468017578,4144,441,3703,3703,0,10,490000.0
490,490999,21.127182317324475,35.73385101193445,0.07773448248068149,62.781880617141724,30.217471599578857,89.70675277709961,4145,441,3704,3704,0,10,491000.0
491,491999,21.118347965537144,35.73255553678329,0.07764392851976376,62.90243077278137,30.277065753936768,89.85528182983398,4149,442,3707,3707,0,10,492000.0
492,492999,21.110894574406267,35.71824309597304,0.07762262786419116,63.01307940483093,30.338985443115234,90.25045776367188,4156,442,3714,3714,0,10,493000.0
493,493999,21.102625026779766,35.70307486714837,0.07762552786131194,63.14134097099304,30.4005126953125,90.41973114013672,4159,443,3716,3716,0,10,494000.0
494,494999,21.094878545943057,35.69016011213551,0.07759997800192231,63.27177453041077,30.462927103042603,90.80672454833984,4173,444,3729,3729,0,10,495000.0
495,495999,21.085528214661146,35.670309490775914,0.07756775543517369,63.38098669052124,30.52414298057556,91.07472229003906,4174,444,3730,3730,0,10,496000.0
496,496999,21.078768351833183,35.65810489662773,0.0775180442096729,63.5072238445282,30.585592031478882,91.23852157592773,4176,445,3731,3731,0,10,497000.0
497,497999,21.073952134770618,35.64642414562526,0.077556912630809,63.6453857421875,30.648274421691895,91.49176025390625,4190,447,3743,3743,0,10,498000.0
498,498999,21.07650043520591,35.638014265130735,0.07749976731666663,63.77681374549866,30.708738088607788,91.60945510864258,4194,448,3746,3746,0,10,499000.0
499,499999,21.080779412521554,35.64217920445407,0.07757230572340823,63.925047397613525,30.770244121551514,91.92929458618164,4213,450,3763,3763,0,10,500000.0
500,500999,21.081403834036117,35.635476552190234,0.0775590932459761,64.05850100517273,30.83170509338379,92.09156799316406,4216,451,3765,3765,0,10,501000.0
501,501999,21.089447727515324,35.64173075995224,0.07761747200792846,64.18883275985718,30.896730422973633,92.72556686401367,4238,452,3786,3786,0,10,502000.0
502,502999,21.102890209444713,35.658272972088014,0.07785513556115187,64.318350315094,30.960148572921753,93.02076721191406,4261,453,3808,3808,0,10,503000.0
503,503999,21.112411675112455,35.69355788954232,0.07782917102842757,64.46650886535645,31.024937391281128,93.60712432861328,4327,456,3871,3871,0,10,504000.0
504,504999,21.120911275032427,35.700120141358646,0.07780825939576663,64.57014155387878,31.0852313041687,94.00432968139648,4329,456,3873,3873,0,10,505000.0
505,505999,21.129728967115238,35.70874799897139,0.07796697488544713,64.68664026260376,31.147459745407104,94.22942733764648,4330,456,3874,3874,0,10,506000.0
506,506999,21.13671208453366,35.743390146611354,0.07782040354476782,64.81959295272827,31.21236824989319,94.70931243896484,4345,457,3888,3888,0,10,507000.0
507,507999,21.137509511026085,35.74052954005735,0.07787730361049283,64.93788504600525,31.27318286895752,95.0072021484375,4348,458,3890,3890,0,10,508000.0
508,508999,21.132394524406653,35.75338681210569,0.07758833121575448,65.0594916343689,31.335007429122925,95.73109436035156,4372,458,3914,3914,0,10,509000.0
509,509999,21.122506451966995,35.741032575637504,0.07784348894542181,65.17618298530579,31.397454261779785,96.39852905273438,4388,458,3930,3930,0,10,510000.0
510,510999,21.111488950359256,35.730299317353854,0.07804665838881075,65.29675912857056,31.4596049785614,96.64885711669922,4397,459,3938,3938,0,10,511000.0
511,511999,21.101193768898373,35.71315911372156,0.07830687158856786,65.43001437187195,31.522793769836426,96.98573684692383,4416,461,3955,3955,0,10,512000.0
512,512999,21.09364616538458,35.708369868363995,0.0784535280258476,65.5611674785614,31.5836181640625,97.21721267700195,4441,462,3979,3979,0,10,513000.0
513,513999,21.08462216457529,35.69414657447664,0.07858670734711481,65.69635915756226,31.644853115081787,97.35488510131836,4457,463,3994,3994,0,10,514000.0
514,514999,21.078294732006256,35.68094391716878,0.0785844872474879,65.81594181060791,31.707106351852417,97.86971664428711,4469,463,4006,4006,0,10,515000.0
515,515999,21.067574775324754,35.66338929680357,0.07861019491586552,65.94125771522522,31.771522521972656,98.07715225219727,4495,464,4031,4031,0,10,516000.0
516,516999,21.058810357001605,35.64841168938043,0.07884400570427907,66.06486368179321,31.83256483078003,98.20732498168945,4497,465,4032,4032,0,10,517000.0
517,517999,21.052383753195123,35.63517362375248,0.07882637463825437,66.19817185401917,31.89524483680725,98.47196960449219,4531,467,4064,4064,0,10,518000.0
518,518999,21.044037279955035,35.62137171707962,0.078952040426714,66.32464051246643,31.956923723220825,98.75620651245117,4542,468,4074,4074,0,10,519000.0
519,519999,21.034100757510867,35.60236441194266,0.07906533127472648,66.47260737419128,32.01972818374634,98.99712753295898,4558,471,4087,4087,0,10,520000.0
520,520999,21.033528994240374,35.64878380766302,0.07863349953016119,66.589772939682,32.081637382507324,99.44529342651367,4562,471,4091,4091,0,10,521000.0
521,521999,21.031316972779905,35.64060517995576,0.07853597481281682,66.70924496650696,32.14333915710449,99.62336349487305,4562,471,4091,4091,0,10,522000.0
522,522999,21.02766795833021,35.64416997993671,0.07831702276106933,67.16584992408752,32.20575785636902,100.44516372680664,4585,471,4114,4114,0,10,523000.0
523,523999,21.017410872927734,35.625645208828715,0.07839189537355973,67.30568718910217,32.268810749053955,100.64658737182617,4613,473,4140,4140,0,10,524000.0
524,524999,21.009458141295067,35.60851335683029,0.07834022937638963,67.43678855895996,32.332056760787964,101.28661727905273,4629,474,4155,4155,0,10,525000.0
525,525999,21.00495831042717,35.626985560047025,0.07828037634158413,67.58645868301392,32.39854693412781,102.23713302612305,4696,476,4220,4220,0,10,526000.0
526,526999,20.994983474289945,35.610047648165235,0.07828654753701669,67.71999788284302,32.464433908462524,102.77462768554688,4727,477,4250,4250,0,10,527000.0
527,527999,20.986785948106764,35.59686452724395,0.07831404902258832,67.849276304245,32.52924346923828,103.03373718261719,4732,478,4254,4254,0,10,528000.0
528,528999,20.978899789348663,35.583785646555015,0.07828304637435735,67.98126101493835,32.59454941749573,103.48527145385742,4745,479,4266,4266,0,10,529000.0
529,529999,20.974165853598624,35.5721836379411,0.07831904561242764,68.10538387298584,32.65507912635803,103.75139617919922,4747,480,4267,4267,0,10,530000.0
530,530999,20.971136572895603,35.57266762241622,0.07821762109240993,68.21916794776917,32.71880769729614,103.94277954101562,4747,480,4267,4267,0,10,531000.0
531,531999,20.965960122339897,35.56584330714031,0.0780101414119182,68.34497165679932,32.78200125694275,104.48996353149414,4761,480,4281,4281,0,10,532000.0
532,532999,20.96182407522343,35.58995497557018,0.07769683261937566,68.49074339866638,32.84293556213379,104.65495300292969,4784,483,4301,4301,0,10,533000.0
533,533999,20.957658742099433,35.58704906161649,0.07757441207724369,68.61521577835083,32.905508279800415,104.91204452514648,4786,484,4302,4302,0,10,534000.0
534,534999,20.95565980235755,35.57446869823468,0.0774244751010299,68.74241876602173,32.96807026863098,105.3029556274414,4798,485,4313,4313,0,10,535000.0
535,535999,20.954090481292432,35.57292417345245,0.07726496858764165,68.90309476852417,33.02889800071716,105.48067855834961,4813,488,4325,4325,0,10,536000.0
536,536999,20.95406177307476,35.57329813709986,0.07727178030880466,69.06390714645386,33.09075140953064,105.58636474609375,4824,492,4332,4332,0,10,537000.0
537,537999,20.96327949994122,35.58670043205167,0.07685389878314408,69.19449496269226,33.15712571144104,106.20866394042969,4840,493,4347,4347,0,10,538000.0
538,538999,20.97076190893355,35.59208077812643,0.0767729132610957,69.33518648147583,33.21892976760864,106.40494155883789,4869,496,4373,4373,0,10,539000.0
539,539999,20.97370513425543,35.592289432903364,0.07670851106872689,69.44578409194946,33.28058481216431,106.58872604370117,4869,496,4373,4373,0,10,540000.0
540,540999,20.980735841025165,35.61554155038867,0.07660596379293638,69.58154702186584,33.34283638000488,107.42824935913086,4896,497,4399,4399,0,10,541000.0
541,541999,20.984734438283297,35.61239015575053,0.07644489843939795,69.6864230632782,33.404261350631714,107.67781066894531,4896,497,4399,4399,0,10,542000.0
542,542999,20.987417552149253,35.609640010656626,0.07636289395128792,69.81628489494324,33.46808075904846,108.11691665649414,4911,498,4413,4413,0,10,543000.0
543,543999,20.985413084989982,35.59848362029488,0.07624415393678308,69.96506929397583,33.530081272125244,108.44041061401367,4963,501,4462,4462,0,10,544000.0
544,544999,20.979905327155635,35.589996203670275,0.07615338596364685,70.10413956642151,33.59261870384216,109.25018310546875,5004,503,4501,4501,0,10,545000.0
545,545999,20.970476253984913,35.588819773079194,0.07596486954508774,70.24035930633545,33.65577483177185,110.04637145996094,5024,504,4520,4520,0,10,546000.0
546,546999,20.958347165480472,35.56950800770926,0.07599985692658673,70.36917495727539,33.71743321418762,110.42700958251953,5050,505,4545,4545,0,10,547000.0
547,547999,20.949427296805005,35.566401310730264,0.07585239515657405,70.49915266036987,33.778051137924194,110.63518905639648,5056,506,4550,4550,0,10,548000.0
548,548999,20.939145380500733,35.54977889772471,0.07583691038974638,70.63967800140381,33.84751796722412,110.89088439941406,5061,507,4554,4554,0,10,549000.0
549,549999,20.933258954973713,35.53610188617959,0.07575537567347368,70.7809567451477,33.90707015991211,111.09540176391602,5073,509,4564,4564,0,10,550000.0
550,550999,20.92677157232706,35.52005591985438,0.07577604471104604,70.90228581428528,33.9698121547699,111.3669662475586,5077,510,4567,4567,0,10,551000.0
551,551999,20.926146308539135,35.51433506171647,0.07566469267073472,71.05975914001465,34.03345274925232,111.80787658691406,5121,513,4608,4608,0,10,552000.0
552,552999,20.92124313165929,35.50090460342475,0.07563540550957515,71.18453288078308,34.09674906730652,112.12059783935547,5124,514,4610,4610,0,10,553000.0
553,553999,20.91925117409844,35.48978955590375,0.07564167000262112,71.30461239814758,34.158732414245605,112.37934875488281,5126,515,4611,4611,0,10,554000.0
554,554999,20.917420699416954,35.48352143017354,0.07561857199118971,71.45079755783081,34.221890926361084,112.74716567993164,5152,517,4635,4635,0,10,555000.0
555,555999,20.91517903246006,35.47468036084178,0.07558841427004537,71.60304951667786,34.284645795822144,112.99380493164062,5161,520,4641,4641,0,10,556000.0
556,556999,20.911545728619803,35.46396728530093,0.07560756303864724,71.7526535987854,34.34909796714783,113.13422012329102,5188,522,4666,4666,0,10,557000.0
557,557999,20.90724500304763,35.452127586208476,0.07562770173870315,71.90738129615784,34.41506338119507,113.43203735351562,5203,524,4679,4679,0,10,558000.0
558,558999,20.908223960329103,35.4478084344428,0.07549504192864809,72.02145504951477,34.47991871833801,113.89063262939453,5207,524,4683,4683,0,10,559000.0
559,559999,20.90475977077864,35.43771351122996,0.07558542080506936,72.17431497573853,34.54428267478943,114.00323867797852,5240,527,4713,4713,0,10,560000.0
560,560999,20.9034304142837,35.42946477142674,0.07558580007644322,72.31242990493774,34.6102409362793,114.80265045166016,5268,528,4740,4740,0,10,561000.0
561,561999,20.90519934067313,35.42691234982236,0.07562864182048878,72.42738842964172,34.67449641227722,115.18550109863281,5268,528,4740,4740,0,10,562000.0
562,562999,20.90594570993053,35.41992468325451,0.07569289444534066,72.53730535507202,34.73886775970459,115.39712524414062,5268,528,4740,4740,0,10,563000.0
563,563999,20.907263431560292,35.41398023418528,0.07571605784264923,72.65806555747986,34.804182052612305,116.02405166625977,5284,528,4756,4756,0,10,564000.0
564,564999,20.899972668371834,35.40117604969663,0.07574309353660691,72.77568459510803,34.86942672729492,116.67488098144531,5302,528,4774,4774,0,10,565000.0
565,565999,20.888432240130868,35.38866560239598,0.0756504355915738,72.89918613433838,34.93322229385376,117.03424835205078,5321,529,4792,4792,0,10,566000.0
566,566999,20.87515514793678,35.37107135767858,0.07573018626413297,73.04989624023438,34.99882531166077,117.64368057250977,5350,531,4819,4819,0,10,567000.0
567,567999,20.863617370872966,35.359216246696825,0.07577142217522825,73.19579148292542,35.06504583358765,117.87606811523438,5360,533,4827,4827,0,10,568000.0
568,568999,20.850431605378052,35.33977498108081,0.075779308977446,73.3140070438385,35.129650592803955,118.15062713623047,5362,533,4829,4829,0,10,569000.0
569,569999,20.841555759136167,35.32443818893147,0.07577022578450021,73.4403281211853,35.19421076774597,118.51240921020508,5374,534,4840,4840,0,10,570000.0
570,570999,20.829130341006266,35.30422760438674,0.07580429842998004,73.62331628799438,35.25891399383545,118.54141616821289,5405,538,4867,4867,0,10,571000.0
571,571999,20.81911644097823,35.28656419758465,0.07584420182361862,73.75483059883118,35.32458305358887,119.03279495239258,5418,538,4880,4880,0,10,572000.0
572,572999,20.80739193556991,35.267763144635104,0.07584664368026384,73.87276864051819,35.391350507736206,119.32816696166992,5419,538,4881,4881,0,10,573000.0
573,573999,20.79861457957117,35.25154432408631,0.0758399692134375,74.00220918655396,35.45621299743652,119.55228424072266,5421,539,4882,4882,0,10,574000.0
574,574999,20.787916768614622,35.2321901075151,0.07584803831789277,74.17359852790833,35.52214479446411,119.8448257446289,5465,542,4923,4923,0,10,575000.0
575,575999,20.780644598302512,35.250195567483146,0.0756878364172866,74.29476547241211,35.58590769767761,120.10360717773438,5466,542,4924,4924,0,10,576000.0
576,576999,20.76902280920699,35.22978616280422,0.075705250428163,74.44422364234924,35.64945387840271,120.23723983764648,5476,544,4932,4932,0,10,577000.0
577,577999,20.761155633978667,35.2139741577898,0.07568066644246874,74.58941078186035,35.71470546722412,120.62395477294922,5494,546,4948,4948,0,10,578000.0
578,578999,20.752679147530635,35.19756652725054,0.0756166698480154,74.71395611763,35.784446716308594,121.07301330566406,5496,546,4950,4950,0,10,579000.0
579,579999,20.745805791712836,35.18400816702519,0.07558770426860162,74.84955549240112,35.847485065460205,121.2573471069336,5500,548,4952,4952,0,10,580000.0
580,580999,20.742230838554573,35.191494921419675,0.07539466100782866,74.99495697021484,35.91023373603821,121.99457168579102,5530,550,4980,4980,0,10,581000.0
581,581999,20.73405256641445,35.17450939832318,0.075390003365857,75.11869311332703,35.97193646430969,122.35517883300781,5558,551,5007,5007,0,10,582000.0
582,582999,20.727228317157703,35.159506620728415,0.07536685820891875,75.23915147781372,36.0323543548584,122.54439163208008,5562,552,5010,5010,0,10,583000.0
583,583999,20.719664672740304,35.144693129457366,0.07527240475252905,75.37617325782776,36.09473252296448,123.12308883666992,5581,554,5027,5027,0,10,584000.0
584,584999,20.711085723826795,35.144405112279145,0.07532805373573837,75.5208797454834,36.16656827926636,123.8258171081543,5614,555,5059,5059,0,10,585000.0
585,585999,20.697287296534505,35.12326616003362,0.07536048811521734,76.05116724967957,36.2284038066864,124.44525909423828,5656,556,5100,5100,0,10,586000.0
586,586999,20.68671269972313,35.11829362315486,0.07537589642396902,76.16725635528564,36.29278826713562,124.97661972045898,5660,556,5104,5104,0,10,587000.0
587,587999,20.675916853225843,35.1024523063822,0.07542265772442158,76.27968263626099,36.35579776763916,125.28710556030273,5662,556,5106,5106,0,10,588000.0
588,588999,20.667258900630433,35.09012297598639,0.07538782837875013,76.39753675460815,36.418678283691406,125.51556396484375,5663,556,5107,5107,0,10,589000.0
589,589999,20.65913152714204,35.077072614599984,0.07540033474501429,76.52460646629333,36.48173499107361,125.99331665039062,5675,557,5118,5118,0,10,590000.0
590,590999,20.65142688747748,35.069362537905825,0.07539352056291782,76.67311096191406,36.54663419723511,126.20462036132812,5685,559,5126,5126,0,10,591000.0
591,591999,20.643882773351717,35.05438703754234,0.07536698754011795,76.82652688026428,36.61312198638916,126.64831161499023,5702,561,5141,5141,0,10,592000.0
592,592999,20.63617407475917,35.040561157956205,0.07538765212021348,76.95071244239807,36.67729711532593,126.93048858642578,5706,562,5144,5144,0,10,593000.0
593,593999,20.62833673515832,35.02759766622818,0.07540034098398052,77.09020209312439,36.742915391922,127.2157211303711,5713,564,5149,5149,0,10,594000.0
594,594999,20.625338649412996,35.026891635669124,0.07531246176872097,77.22268629074097,36.80554223060608,127.64854431152344,5725,565,5160,5160,0,10,595000.0
595,595999,20.62083791286226,35.02232654611124,0.07524735848879571,77.34390068054199,36.867255449295044,127.86143493652344,5728,566,5162,5162,0,10,596000.0
596,596999,20.61672959944894,35.0113069482686,0.07527001432215863,77.4595959186554,36.92881226539612,128.01952362060547,5728,566,5162,5162,0,10,597000.0
597,597999,20.612353110054645,35.00209775495257,0.07523073005163361,77.61624526977539,36.99227285385132,128.38930130004883,5753,569,5184,5184,0,10,598000.0
598,598999,20.607677853003047,34.990416849642294,0.07523935282539496,77.72919631004333,37.05485773086548,128.7248077392578,5754,569,5185,5185,0,10,599000.0
599,599999,20.605828189108458,34.98322034242152,0.07523323201120224,77.84937191009521,37.116002321243286,128.8855857849121,5756,570,5186,5186,0,10,600000.0
600,600999,20.604152693434063,34.97457764613088,0.07518554467564864,77.96784663200378,37.178715229034424,129.71653747558594,5782,570,5212,5212,0,10,601000.0
601,601999,20.602798348320654,34.964889582534774,0.07515342846075512,78.08913326263428,37.24073028564453,129.9785270690918,5784,571,5213,5213,0,10,602000.0
602,602999,20.59781017230839,34.9518629595442,0.07516349432281921,78.1962890625,37.301220655441284,130.20776748657227,5784,571,5213,5213,0,10,603000.0
603,603999,20.595318009152056,34.94992320672693,0.0749502823786301,78.33859872817993,37.362491607666016,130.70339584350586,5804,573,5231,5231,0,10,604000.0
604,604999,20.58843643234542,34.93706859909032,0.07489076707762965,78.4642288684845,37.42334294319153,131.52328872680664,5838,574,5264,5264,0,10,605000.0
605,605999,20.581131056589875,34.92544593568871,0.0747064435925262,78.59135627746582,37.48660612106323,132.21506881713867,5858,575,5283,5283,0,10,606000.0
606,606999,20.572327899293263,34.91216738059091,0.07465508123776787,78.70528721809387,37.55142951011658,132.68751525878906,5860,575,5285,5285,0,10,607000.0
607,607999,20.564119100131105,34.90037419342421,0.0745725070240818,78.81661438941956,37.613770723342896,132.9793472290039,5862,575,5287,5287,0,10,608000.0
608,608999,20.55780514973776,34.889564003557346,0.07449850537852432,78.92696046829224,37.67501163482666,133.40847778320312,5870,575,5295,5295,0,10,609000.0
609,609999,20.554205726353352,34.87921053806172,0.07439725065980729,79.07412767410278,37.73512625694275,133.66339874267578,5883,578,5305,5305,0,10,610000.0
610,610999,20.55084772004912,34.87618747481472,0.07430120901290249,79.2095696926117,37.79625129699707,133.92417907714844,5912,579,5333,5333,0,10,611000.0
611,611999,20.545258981697064,34.863886818719585,0.07422471521621399,79.32533621788025,37.859750270843506,134.48632049560547,5925,579,5346,5346,0,10,612000.0
612,612999,20.542130260204633,34.85728485845574,0.07411525781563777,79.45378947257996,37.92660331726074,134.75878524780273,5928,580,5348,5348,0,10,613000.0
613,613999,20.537012867715898,34.84598635485954,0.0740638997401123,79.57673001289368,37.98797678947449,134.98239517211914,5930,581,5349,5349,0,10,614000.0
614,614999,20.53697655490265,34.84248111492981,0.0739724488245288,79.71048784255981,38.04877185821533,135.44646453857422,5946,583,5363,5363,0,10,615000.0
615,615999,20.53816353886494,34.83949594367986,0.07399182439466512,79.85329580307007,38.11284351348877,135.6049346923828,5949,584,5365,5365,0,10,616000.0
616,616999,20.541738750239432,34.83946878794259,0.07433236358927908,80.00485944747925,38.1740837097168,135.65276718139648,5957,587,5370,5370,0,10,617000.0
617,617999,20.554220613424775,34.879192552482436,0.07458841914072734,80.13900423049927,38.23764181137085,136.27252197265625,5975,588,5387,5387,0,10,618000.0
618,618999,20.565721596975994,34.89161428348276,0.07490504944586307,80.2582459449768,38.30290102958679,136.5347785949707,5975,588,5387,5387,0,10,619000.0
619,619999,20.58081501312691,34.91091871020163,0.07522384022314732,80.40094661712646,38.363834381103516,136.64704513549805,5983,590,5393,5393,0,10,620000.0
620,620999,20.593754227847032,34.92448135619059,0.07547291528923405,80.51442837715149,38.42728877067566,137.6137809753418,6009,590,5419,5419,0,10,621000.0
621,621999,20.602065542262043,34.92983183710332,0.07565315778238779,80.62613654136658,38.48854112625122,137.89046478271484,6009,590,5419,5419,0,10,622000.0
622,622999,20.61354190520095,34.940922241966035,0.0758969281584706,80.76715111732483,38.55068111419678,138.34056091308594,6047,592,5455,5455,0,10,623000.0
623,623999,20.62256400160193,34.94224873621368,0.07589396154355499,80.87606978416443,38.6106481552124,138.68998336791992,6047,592,5455,5455,0,10,624000.0
624,624999,20.620052399027834,34.93436215114196,0.07576100415382858,80.9966893196106,38.673216104507446,139.56596755981445,6068,592,5476,5476,0,10,625000.0
625,625999,20.615056894043427,34.92508734902862,0.07566792866694771,81.11140823364258,38.73614192008972,140.27085876464844,6085,592,5493,5493,0,10,626000.0
626,626999,20.609406643053532,34.919945977883465,0.07564841988298521,81.22139525413513,38.79652547836304,140.62400817871094,6086,592,5494,5494,0,10,627000.0
627,627999,20.603836630174513,34.911556244384975,0.07557140593163625,81.33648800849915,38.85786294937134,140.9039306640625,6089,592,5497,5497,0,10,628000.0
628,628999,20.6010383931076,34.9109410694323,0.0754610781592302,81.46360540390015,38.92235255241394,141.29607009887695,6100,593,5507,5507,0,10,629000.0
629,629999,20.598092413049894,34.90093445300446,0.07538131374802204,81.58513045310974,38.98706817626953,141.51941680908203,6101,593,5508,5508,0,10,630000.0
630,630999,20.594004721877226,34.891190910636894,0.07537002992596364,81.70909404754639,39.04761600494385,141.69195175170898,6102,593,5509,5509,0,10,631000.0
631,631999,20.593998309646253,34.91395352460864,0.0751971949343454,81.83963370323181,39.11025381088257,142.18119430541992,6120,594,5526,5526,0,10,632000.0
632,632999,20.592769828371477,34.9068304101152,0.07518887751970016,81.95153093338013,39.17384433746338,142.41917037963867,6120,594,5526,5526,0,10,633000.0
633,633999,20.591224841117246,34.90402937300072,0.0751699423182901,82.10185360908508,39.23393535614014,142.49123001098633,6124,596,5528,5528,0,10,634000.0
634,634999,20.591111480693833,34.89688503429271,0.07515949008698264,82.2302758693695,39.29633021354675,142.88874053955078,6134,597,5537,5537,0,10,635000.0
635,635999,20.593026913704907,34.894546340415665,0.07508524217252632,82.34797644615173,39.35730338096619,143.0728302001953,6134,597,5537,5537,0,10,636000.0
636,636999,20.59638544008517,34.916295503596615,0.07509458557778248,82.4832272529602,39.421202421188354,143.09767150878906,6138,598,5540,5540,0,10,637000.0
637,637999,20.597878018831064,34.91200293001811,0.07508661177408349,82.6255271434784,39.48688721656799,143.68156051635742,6153,599,5554,5554,0,10,638000.0
638,638999,20.60364512479586,34.91252953057904,0.07514366572268494,82.75384306907654,39.55092144012451,143.8786735534668,6159,600,5559,5559,0,10,639000.0
639,639999,20.61083883902129,34.91760743070361,0.07532587475530483,82.8668966293335,39.612844467163086,144.07462692260742,6159,600,5559,5559,0,10,640000.0
640,640999,20.61807490598899,34.9212201843401,0.07535117034322902,82.97407746315002,39.67317509651184,144.96567153930664,6176,600,5576,5576,0,10,641000.0
641,641999,20.623415493497202,34.92119938578536,0.07537673902527409,83.08829975128174,39.73676776885986,145.23286819458008,6176,600,5576,5576,0,10,642000.0
642,642999,20.63115960679727,34.92509550377729,0.0755221437498228,83.22657752037048,39.79771828651428,145.37292861938477,6186,602,5584,5584,0,10,643000.0
643,643999,20.636058616294914,34.921993618921285,0.0755176701551834,83.34403562545776,39.85939908027649,145.9546012878418,6192,602,5590,5590,0,10,644000.0
644,644999,20.63505138680948,34.9153237632681,0.07545542147840123,83.46238827705383,39.923508644104004,146.69990921020508,6203,602,5601,5601,0,10,645000.0
645,645999,20.63199538338881,34.924531823618565,0.0752848281762758,83.57709097862244,39.98531484603882,147.37864303588867,6218,602,5616,5616,0,10,646000.0
646,646999,20.6270876695929,34.91706927292915,0.07529385679422429,83.69846844673157,40.04741072654724,147.71506118774414,6218,602,5616,5616,0,10,647000.0
647,647999,20.621667084107383,34.91128428024746,0.075396034413299,83.81143069267273,40.10978412628174,147.97919464111328,6219,602,5617,5617,0,10,648000.0
648,648999,20.61728516412424,34.900147178146604,0.07534671431945483,83.92688488960266,40.17142295837402,148.42908096313477,6228,602,5626,5626,0,10,649000.0
649,649999,20.614572237837013,34.89215750232342,0.07530622399821774,84.04329943656921,40.23229742050171,148.60819244384766,6228,602,5626,5626,0,10,650000.0
650,650999,20.612419193466756,34.88414095435604,0.07528929409254226,84.16028642654419,40.29498791694641,149.06536483764648,6236,602,5634,5634,0,10,651000.0
651,651999,20.610774238764982,34.881056769938205,0.07520092554967861,84.27143836021423,40.356905698776245,149.34567642211914,6237,602,5635,5635,0,10,652000.0
652,652999,20.610310524164852,34.885922245025284,0.07512494918674928,84.39869356155396,40.418710708618164,149.5432357788086,6237,602,5635,5635,0,10,653000.0
653,653999,20.613767576290652,34.88834300962599,0.07499099762002659,84.52480864524841,40.480069160461426,149.8469581604004,6245,603,5642,5642,0,10,654000.0
654,654999,20.6162236187268,34.89043729037952,0.0749293118478449,84.64491319656372,40.541539430618286,150.03779983520508,6246,603,5643,5643,0,10,655000.0
655,655999,20.616598216107697,34.88598136083442,0.07488005665446429,84.75988960266113,40.6025013923645,150.1342658996582,6246,603,5643,5643,0,10,656000.0
656,656999,20.622343772031545,34.89326177457414,0.07466961064946576,84.89648461341858,40.66518807411194,150.67388534545898,6260,604,5656,5656,0,10,657000.0
657,657999,20.62937675730529,34.90632872507204,0.07458377409347061,85.02873373031616,40.73020076751709,151.08661651611328,6273,605,5668,5668,0,10,658000.0
658,658999,20.641143107513976,34.9382274713663,0.0743228191473212,85.14371228218079,40.79330039024353,151.93804550170898,6288,605,5683,5683,0,10,659000.0
659,659999,20.64658951856342,34.95795173691781,0.07417042485313463,85.25704717636108,40.85581731796265,152.25112915039062,6288,605,5683,5683,0,10,660000.0
660,660999,20.649376451475746,34.95679745230171,0.0740452660916685,85.37613844871521,40.920185565948486,152.7935447692871,6292,605,5687,5687,0,10,661000.0
661,661999,20.6471310203994,34.959468977295984,0.0738848242185044,85.48683714866638,40.979522705078125,153.61468124389648,6302,605,5697,5697,0,10,662000.0
662,662999,20.64550423716043,34.966809410361435,0.07373756354119176,85.60587000846863,41.04130506515503,154.35425186157227,6309,605,5704,5704,0,10,663000.0
663,663999,20.643419762730225,34.970468097896564,0.07351941378685856,85.74019718170166,41.102534532547,154.6369857788086,6312,606,5706,5706,0,10,664000.0
664,664999,20.64084811371075,34.96673874352336,0.07338586527036284,85.86529731750488,41.16349959373474,154.9818000793457,6319,607,5712,5712,0,10,665000.0
665,665999,20.638907529443568,34.95906988853859,0.07324805634671183,85.98648071289062,41.22710704803467,155.28748321533203,6321,607,5714,5714,0,10,666000.0
666,666999,20.63683464182066,34.95404422339757,0.07311779203467572,86.09428405761719,41.28630042076111,155.4523811340332,6321,607,5714,5714,0,10,667000.0
667,667999,20.63832310725904,34.955422072034764,0.07289952898022545,86.22322964668274,41.35127234458923,155.94459915161133,6327,608,5719,5719,0,10,668000.0
668,668999,20.638541396256826,34.95065369179972,0.07275308349217713,86.33817052841187,41.41605854034424,156.2240104675293,6327,608,5719,5719,0,10,669000.0
669,669999,20.639400071092012,34.95601779750939,0.07257816508825377,86.45267224311829,41.48063397407532,156.39944458007812,6327,608,5719,5719,0,10,670000.0
670,670999,20.642267701259474,34.973671915144585,0.07235954722834703,87.05489444732666,41.546276807785034,156.88750839233398,6334,608,5726,5726,0,10,671000.0
671,671999,20.64298535094747,34.96910447875331,0.07223106792432521,87.20901489257812,41.61153745651245,157.04745864868164,6338,610,5728,5728,0,10,672000.0
672,672999,20.644852037015873,34.965700533721495,0.07208069370241743,87.33777475357056,41.67677330970764,157.1866111755371,6338,610,5728,5728,0,10,673000.0
673,673999,20.64536492314469,34.96038107670119,0.07191766753734807,87.4619369506836,41.7432017326355,157.80223846435547,6348,610,5738,5738,0,10,674000.0
674,674999,20.649842241072633,34.98410821190057,0.07169435450367068,87.59242367744446,41.807939291000366,158.0633888244629,6350,611,5739,5739,0,10,675000.0
675,675999,20.654103650482416,34.98503013197967,0.07149787116717188,87.7311806678772,41.872710943222046,158.21478652954102,6353,612,5741,5741,0,10,676000.0
676,676999,20.659983838826392,34.98217220856899,0.07131666792563696,87.86433219909668,41.93824863433838,159.1527976989746,6390,613,5777,5777,0,10,677000.0
677,677999,20.66700672114689,34.99375770309193,0.07115148793983883,87.97863125801086,42.003212213516235,159.4328498840332,6390,613,5777,5777,0,10,678000.0
678,678999,20.669409228148062,34.98820928762526,0.07108737743817461,88.09673357009888,42.067941665649414,159.87666702270508,6392,613,5779,5779,0,10,679000.0
679,679999,20.67204408639374,34.98243269115024,0.07099660169212707,88.21921944618225,42.133171796798706,160.26947021484375,6393,613,5780,5780,0,10,680000.0
680,680999,20.670614986959055,34.981070064034654,0.07082202640263602,88.3584852218628,42.198941469192505,161.0566291809082,6405,614,5791,5791,0,10,681000.0
681,681999,20.66547345528202,34.98071054624967,0.07069967047873615,88.49014067649841,42.264729738235474,161.6434211730957,6408,614,5794,5794,0,10,682000.0
682,682999,20.661224280556667,34.97625684781058,0.07058323066349359,88.6188371181488,42.32973074913025,161.95366287231445,6414,615,5799,5799,0,10,683000.0
683,683999,20.658672447376926,34.97287795468973,0.0704638009267351,88.73963403701782,42.39514422416687,162.23841094970703,6415,615,5800,5800,0,10,684000.0
684,684999,20.657336519652866,34.97127582935687,0.0703211522530981,88.89231753349304,42.460986375808716,162.5053939819336,6448,617,5831,5831,0,10,685000.0
685,685999,20.659949716319698,34.96889368420671,0.07021569115955639,89.02362442016602,42.52491617202759,162.83971405029297,6450,618,5832,5832,0,10,686000.0
686,686999,20.658687056614124,34.959491223454926,0.07017696490757752,89.14204144477844,42.58934783935547,163.08855056762695,6450,618,5832,5832,0,10,687000.0
687,687999,20.662229210047485,34.96606121831261,0.07005307624735535,89.26408767700195,42.65484356880188,163.60012435913086,6450,618,5832,5832,0,10,688000.0
688,688999,20.66773719369223,34.97145770307512,0.06996605380738008,89.38067269325256,42.71884536743164,163.86194229125977,6450,618,5832,5832,0,10,689000.0
689,689999,20.669602053473014,34.96570282109823,0.06991549812845355,89.50234174728394,42.78392052650452,164.05436325073242,6450,618,5832,5832,0,10,690000.0
690,690999,20.675131819593755,34.96712052042959,0.06992384453066036,89.6363205909729,42.84892559051514,164.50310897827148,6453,618,5835,5835,0,10,691000.0
691,691999,20.680841686314015,34.968313996376125,0.06978825469035221,89.7865378856659,42.91396450996399,164.73209381103516,6457,620,5837,5837,0,10,692000.0
692,692999,20.686108919608557,34.967871741859504,0.0697263032430071,89.91136360168457,42.97996187210083,164.91181564331055,6457,620,5837,5837,0,10,693000.0
693,693999,20.691436565918842,34.96883646977829,0.06968091821725875,90.04108262062073,43.045665979385376,165.39858627319336,6466,620,5846,5846,0,10,694000.0
694,694999,20.699346336496937,34.97308083479118,0.06962823965568676,90.16271305084229,43.112170696258545,165.74007034301758,6466,620,5846,5846,0,10,695000.0
695,695999,20.70825916311521,34.97735923686172,0.0696836053890234,90.28951859474182,43.176470041275024,165.92295455932617,6466,620,5846,5846,0,10,696000.0
696,696999,20.719938755389855,34.98382103473643,0.06956021966083181,90.44278144836426,43.24179482460022,166.7732048034668,6478,622,5856,5856,0,10,697000.0
697,697999,20.728610497062714,34.984509627148405,0.06938457514225438,90.55375003814697,43.30540442466736,167.0827980041504,6478,622,5856,5856,0,10,698000.0
698,698999,20.73706832074694,34.9850613452011,0.06926413533436337,90.66233515739441,43.369773387908936,167.28160858154297,6478,622,5856,5856,0,10,699000.0
699,699999,20.744305411927975,34.98348859309932,0.06908253250182339,90.77730107307434,43.43353605270386,167.9007911682129,6480,622,5858,5858,0,10,700000.0
700,700999,20.7439883121462,34.9792741377904,0.06897861311967934,90.89993262290955,43.498401403427124,168.72327423095703,6492,622,5870,5870,0,10,701000.0
701,701999,20.735852527645456,34.97046405922073,0.0689613878579699,91.0195894241333,43.56315803527832,169.3664321899414,6496,622,5874,5874,0,10,702000.0
702,702999,20.727893686361902,34.9617923192144,0.06899744238593308,91.15977668762207,43.62839388847351,169.79040145874023,6500,623,5877,5877,0,10,703000.0
703,703999,20.71977885209276,34.95608014368671,0.06910944304137001,91.27427673339844,43.6930570602417,170.0977783203125,6501,623,5878,5878,0,10,704000.0
704,704999,20.71995542748796,34.99727846566091,0.06900075068102818,91.40988087654114,43.75733399391174,170.45809173583984,6509,624,5885,5885,0,10,705000.0
705,705999,20.72214952269192,35.006594649544596,0.06916359116073023,91.54750776290894,43.821470975875854,170.83294677734375,6511,625,5886,5886,0,10,706000.0
706,706999,20.730137213936224,35.03313700114521,0.06926115306275527,91.67158079147339,43.88541054725647,171.0647850036621,6512,625,5887,5887,0,10,707000.0
707,707999,20.74178527414919,35.07130284221638,0.06928816388664416,91.78833723068237,43.95038652420044,171.5868682861328,6513,625,5888,5888,0,10,708000.0
708,708999,20.75306634915203,35.10423907010803,0.06941848610418111,91.90368676185608,44.01496338844299,171.8537826538086,6513,625,5888,5888,0,10,709000.0
709,709999,20.764426661734408,35.143815504526344,0.06949810032459947,92.01868343353271,44.078857421875,172.03210830688477,6513,625,5888,5888,0,10,710000.0
710,710999,20.77777297240735,35.18786101128355,0.06965304436513198,92.1614556312561,44.14389228820801,172.33506393432617,6515,626,5889,5889,0,10,711000.0
711,711999,20.788126663064507,35.22286231799924,0.06968731818137852,92.34469270706177,44.2084846496582,172.4876365661621,6531,629,5902,5902,0,10,712000.0
712,712999,20.79887296005103,35.24882145884079,0.06968654387184015,92.46457743644714,44.27352166175842,172.7102165222168,6532,629,5903,5903,0,10,713000.0
713,713999,20.810652121775163,35.27571381552698,0.06970513416637447,92.5830283164978,44.338059186935425,173.3702163696289,6533,629,5904,5904,0,10,714000.0
714,714999,20.82194244900037,35.29378329112785,0.06984748258639306,92.72989296913147,44.40340232849121,173.58024978637695,6538,631,5907,5907,0,10,715000.0
715,715999,20.835652035963413,35.3182757422409,0.06983531241785546,92.86132025718689,44.46910643577576,174.36418533325195,6540,631,5909,5909,0,10,716000.0
716,716999,20.84943933627946,35.34100115508326,0.06977797639315753,92.96916151046753,44.532620668411255,174.76531982421875,6540,631,5909,5909,0,10,717000.0
717,717999,20.86189258067038,35.35779131695749,0.06986511039150667,93.0814049243927,44.596269607543945,174.99978637695312,6540,631,5909,5909,0,10,718000.0
718,718999,20.87400580996802,35.37109561971013,0.06988440209696645,93.19986748695374,44.66076993942261,175.5620994567871,6541,631,5910,5910,0,10,719000.0
719,719999,20.873463694656323,35.36827520620086,0.06981905763973673,93.31680727005005,44.72547197341919,176.36909866333008,6551,631,5920,5920,0,10,720000.0
720,720999,20.870430815374828,35.377146075760045,0.06973017604389842,93.44036293029785,44.790239572525024,176.98692321777344,6554,631,5923,5923,0,10,721000.0
721,721999,20.867048728827637,35.3736614885807,0.0696203038815062,93.56317090988159,44.855754137039185,177.40523529052734,6556,631,5925,5925,0,10,722000.0
722,722999,20.86551169088367,35.37576798919482,0.06948497486523764,93.6904706954956,44.92137169837952,177.67905044555664,6556,631,5925,5925,0,10,723000.0
723,723999,20.86473658005798,35.3753395485243,0.0693671994552214,93.80729651451111,44.98604607582092,178.05368041992188,6557,631,5926,5926,0,10,724000.0
724,724999,20.862736258733925,35.3717857741446,0.06925886300167172,93.94292283058167,45.05017852783203,178.2817497253418,6560,632,5928,5928,0,10,725000.0
725,725999,20.861579795765614,35.36815441982165,0.0691427048182115,94.06114506721497,45.113670110702515,178.44507598876953,6560,632,5928,5928,0,10,726000.0
726,726999,20.85938931906077,35.3613162555396,0.06909167231114333,94.17853236198425,45.17835259437561,179.00142288208008,6561,632,5929,5929,0,10,727000.0
727,727999,20.85645113134011,35.35389547473126,0.06901742134950317,94.29530167579651,45.24377727508545,179.2664031982422,6561,632,5929,5929,0,10,728000.0
728,728999,20.854539395168636,35.3496401583232,0.06894450876217073,94.42880463600159,45.308502435684204,179.4163475036621,6563,633,5930,5930,0,10,729000.0
729,729999,20.85219594105434,35.34472969420145,0.06884083998050516,94.55865836143494,45.37331032752991,179.88800430297852,6564,633,5931,5931,0,10,730000.0
730,730999,20.84915729280811,35.337180098421506,0.06869790299557288,94.70614171028137,45.43794894218445,180.0695571899414,6566,634,5932,5932,0,10,731000.0
731,731999,20.848950748630397,35.358114477641884,0.0685249770345262,94.84197783470154,45.502872705459595,180.22489166259766,6567,634,5933,5933,0,10,732000.0
732,732999,20.846515376638134,35.35175475190635,0.06843623566815771,94.96766710281372,45.56905913352966,180.77046966552734,6567,634,5933,5933,0,10,733000.0
733,733999,20.84566865772061,35.34399986136367,0.068379763633443,95.08688616752625,45.634143352508545,180.9943618774414,6567,634,5933,5933,0,10,734000.0
734,734999,20.843370243778676,35.33418226980752,0.06833558809171458,95.20464634895325,45.698700189590454,181.15999603271484,6567,634,5933,5933,0,10,735000.0
735,735999,20.84865578651954,35.33394913132495,0.06812181155484709,95.32387685775757,45.763792753219604,182.09550094604492,6568,634,5934,5934,0,10,736000.0
736,736999,20.85078459836547,35.32954873902828,0.06798691778712129,95.44313645362854,45.82806849479675,182.3477439880371,6568,634,5934,5934,0,10,737000.0
737,737999,20.851380671554708,35.32238161151473,0.06789741141075845,95.57236576080322,45.89200568199158,182.82575607299805,6577,635,5942,5942,0,10,738000.0
738,738999,20.85212545190664,35.31589562584564,0.0677104034959708,95.7111554145813,45.95741105079651,183.17837142944336,6586,636,5950,5950,0,10,739000.0
739,739999,20.84998256100345,35.33742648033081,0.06764348143852106,95.82924890518188,46.02210307121277,184.01544952392578,6596,636,5960,5960,0,10,740000.0
740,740999,20.843208864317866,35.367228209495394,0.06754058771284777,95.9449532032013,46.08704495429993,184.65490341186523,6597,636,5961,5961,0,10,741000.0
741,741999,20.83553748071898,35.37233687767522,0.06749425815764576,96.07918787002563,46.15268111228943,184.99974060058594,6601,637,5964,5964,0,10,742000.0
742,742999,20.829746339516056,35.381085859177986,0.06750362615752614,96.19937825202942,46.2178213596344,185.2557258605957,6601,637,5964,5964,0,10,743000.0
743,743999,20.822418212323957,35.37382957374553,0.06758449379289388,96.31411051750183,46.28246831893921,185.65571975708008,6603,637,5966,5966,0,10,744000.0
744,744999,20.814041157249257,35.36145781825562,0.06757188629740973,96.449547290802,46.346333265304565,185.88394165039062,6605,638,5967,5967,0,10,745000.0
745,745999,20.810563404210573,35.36629777793098,0.06755605434690948,96.57094717025757,46.411041498184204,186.04539108276367,6605,638,5967,5967,0,10,746000.0
746,746999,20.803550496767727,35.35615342876482,0.06755645632331098,96.69374942779541,46.47611355781555,186.5495948791504,6605,638,5967,5967,0,10,747000.0
747,747999,20.79917561652166,35.353690469622684,0.06759593303202494,96.82702112197876,46.54122734069824,186.74379348754883,6607,639,5968,5968,0,10,748000.0
748,748999,20.792751969748714,35.347170305353984,0.06757198549161925,96.95177388191223,46.60513687133789,186.93914794921875,6607,639,5968,5968,0,10,749000.0
749,749999,20.790105733773995,35.34574601753134,0.06758838743088103,97.09626913070679,46.67012310028076,187.4122314453125,6635,640,5995,5995,0,10,750000.0
750,750999,20.787579086375594,35.34660968765377,0.06761072987021866,97.25315833091736,46.73427367210388,187.5421600341797,6639,642,5997,5997,0,10,751000.0
751,751999,20.781814078252467,35.335512325019565,0.0676707378255138,97.36943054199219,46.79829788208008,187.75287628173828,6639,642,5997,5997,0,10,752000.0
752,752999,20.77677534080183,35.326554245748795,0.06772280673757047,97.50068235397339,46.86334705352783,188.23973083496094,6639,642,5997,5997,0,10,753000.0
753,753999,20.777838703377146,35.32697039773966,0.0676571808255676,97.63853931427002,46.92751145362854,188.4132843017578,6641,643,5998,5998,0,10,754000.0
754,754999,20.77739263711288,35.32282927883991,0.06771521553049231,97.75776028633118,46.992544412612915,188.5982437133789,6641,643,5998,5998,0,10,755000.0
755,755999,20.778085682914522,35.3212803683724,0.06770118856322249,97.87790513038635,47.05786395072937,189.5155143737793,6642,643,5999,5999,0,10,756000.0
756,756999,20.778776057044208,35.319995225320234,0.06763085577824368,97.99393200874329,47.12201142311096,189.8246612548828,6642,643,5999,5999,0,10,757000.0
757,757999,20.77794581999817,35.31674421718278,0.06766425389678732,98.12145233154297,47.193641662597656,190.03126907348633,6642,643,5999,5999,0,10,758000.0
758,758999,20.77596157174077,35.31039012033179,0.06767444582224369,98.26325178146362,47.25747513771057,190.54627990722656,6646,644,6002,6002,0,10,759000.0
759,759999,20.771653715664726,35.30629311798773,0.06764260770483732,98.39264464378357,47.322508335113525,191.23251342773438,6651,644,6007,6007,0,10,760000.0
760,760999,20.762619986176478,35.29996976710179,0.06760300198928915,98.54890823364258,47.38690638542175,191.82820892333984,6667,646,6021,6021,0,10,761000.0
761,761999,20.751874892974353,35.28596928258196,0.06765470740221446,98.67055654525757,47.45208954811096,192.25005340576172,6667,646,6021,6021,0,10,762000.0
762,762999,20.74386151285996,35.290422153541726,0.06760381896974843,98.80514669418335,47.51782560348511,192.50482940673828,6670,647,6023,6023,0,10,763000.0
763,763999,20.736347542786554,35.28551861496067,0.06756096924969779,98.92884826660156,47.582876443862915,192.72844696044922,6670,647,6023,6023,0,10,764000.0
764,764999,20.729275575931823,35.27805332418272,0.06750875223471708,99.05531358718872,47.64675951004028,193.10126495361328,6672,647,6025,6025,0,10,765000.0
765,765999,20.724570245590797,35.274524191399706,0.06747797244059417,99.18158864974976,47.70990037918091,193.26201248168945,6672,647,6025,6025,0,10,766000.0
766,766999,20.719209630393426,35.270916700129156,0.06744357504249021,99.30447196960449,47.77431344985962,193.6653594970703,6672,647,6025,6025,0,10,767000.0
767,767999,20.714421364053162,35.266760884951225,0.0673831396382476,99.4667136669159,47.83886694908142,193.84603118896484,6679,649,6030,6030,0,10,768000.0
768,768999,20.709334565309444,35.25975276776973,0.06733786906378048,99.59198641777039,47.90338492393494,194.06925201416016,6679,649,6030,6030,0,10,769000.0
769,769999,20.70815978075735,35.25890716900782,0.06724457794307193,99.71188354492188,47.96879863739014,194.3520965576172,6679,649,6030,6030,0,10,770000.0
770,770999,20.7083670729714,35.255384843913674,0.06724119453881294,99.83186483383179,48.03281545639038,194.59821319580078,6679,649,6030,6030,0,10,771000.0
771,771999,20.707379545948303,35.256829677306236,0.06721429091620212,99.99273085594177,48.09684896469116,194.72188568115234,6695,651,6044,6044,0,10,772000.0
772,772999,20.70667181059562,35.252952966681356,0.0672042837803446,100.11621451377869,48.161110401153564,195.01345825195312,6695,651,6044,6044,0,10,773000.0
773,773999,20.708277334250162,35.25083470119449,0.06715786626135234,100.23539423942566,48.226025342941284,195.61300659179688,6695,651,6044,6044,0,10,774000.0
774,774999,20.710854065149565,35.253825679101496,0.06710492781351318,100.35420989990234,48.2912871837616,195.79883193969727,6695,651,6044,6044,0,10,775000.0
775,775999,20.71272820291932,35.25195556109291,0.06711451887662045,100.48109984397888,48.356475591659546,196.48219299316406,6696,651,6045,6045,0,10,776000.0
776,776999,20.716983775261202,35.281410523663,0.06692029640808561,100.5966260433197,48.420403242111206,196.92683029174805,6696,651,6045,6045,0,10,777000.0
777,777999,20.72044371064209,35.281380956767165,0.06683801418099322,100.74446773529053,48.485121965408325,197.0893783569336,6710,653,6057,6057,0,10,778000.0
778,778999,20.723446353969628,35.28285035642845,0.06683096585107495,101.43947792053223,48.550617694854736,197.60045623779297,6741,654,6087,6087,0,10,779000.0
779,779999,20.722434284966592,35.284785255653034,0.06678149333102512,101.55723524093628,48.61600184440613,197.8965072631836,6741,654,6087,6087,0,10,780000.0
780,780999,20.715197077245097,35.29263934955779,0.06674269799705501,101.69949626922607,48.684967041015625,198.62688446044922,6775,655,6120,6120,0,10,781000.0
781,781999,20.70592330522203,35.28002159593918,0.06679326385809303,101.8607771396637,48.75060820579529,199.17704010009766,6787,657,6130,6130,0,10,782000.0
782,782999,20.696196829131296,35.27178944386731,0.06683194566523865,102.00063347816467,48.81650495529175,199.4543113708496,6819,658,6161,6161,0,10,783000.0
783,783999,20.687522916016874,35.263006153543564,0.06684581200302975,102.13364791870117,48.88087201118469,199.79396057128906,6829,659,6170,6170,0,10,784000.0
784,784999,20.681744798868678,35.26941323938224,0.06677058903282851,102.27777886390686,48.946166038513184,200.2675437927246,6844,660,6184,6184,0,10,785000.0
785,785999,20.675280803714802,35.25978125708324,0.06677736209373941,102.40325951576233,49.01114296913147,200.52569198608398,6844,660,6184,6184,0,10,786000.0
786,786999,20.66938626824093,35.2509571082678,0.06676797699682013,102.54014444351196,49.07709813117981,200.94647979736328,6846,661,6185,6185,0,10,787000.0
787,787999,20.664328346282666,35.260345149483,0.06666441461733719,102.66110634803772,49.14216136932373,201.22503280639648,6846,661,6185,6185,0,10,788000.0
788,788999,20.658585562053197,35.271864040872764,0.06657280638323282,102.79783415794373,49.207223892211914,201.37826919555664,6850,662,6188,6188,0,10,789000.0
789,789999,20.65231972499795,35.26286139468878,0.06656444655942828,102.94279718399048,49.27234387397766,201.6724395751953,6854,663,6191,6191,0,10,790000.0
790,790999,20.647173164023435,35.25502232647744,0.06653300145532892,103.0565230846405,49.33659839630127,201.83621978759766,6854,663,6191,6191,0,10,791000.0
791,791999,20.643484966999917,35.25154694770234,0.06650479995147429,103.22213530540466,49.40224289894104,201.90258026123047,6862,665,6197,6197,0,10,792000.0
792,792999,20.638508414290005,35.245756777221985,0.06649871306584632,103.34168648719788,49.46807527542114,202.5876235961914,6862,665,6197,6197,0,10,793000.0
793,793999,20.635044864070522,35.239189749997095,0.06649511668976338,103.45377445220947,49.532732248306274,202.7878646850586,6862,665,6197,6197,0,10,794000.0
794,794999,20.63101196116647,35.227787448890204,0.06645522487506561,103.59734392166138,49.59811091423035,203.67693710327148,6866,666,6200,6200,0,10,795000.0
795,795999,20.62673329194239,35.21878307438756,0.06646496827431825,103.71218633651733,49.663474321365356,203.95932388305664,6866,666,6200,6200,0,10,796000.0
796,796999,20.622025614537176,35.20771602475787,0.06638244315130326,103.83878183364868,49.73263907432556,204.56194686889648,6866,666,6200,6200,0,10,797000.0
797,797999,20.614577050589983,35.196431181357305,0.06635223619662012,104.00666332244873,49.7981812953949,205.61059951782227,6895,668,6227,6227,0,10,798000.0
798,798999,20.603730767258103,35.18013485172069,0.06642140512793338,104.13289761543274,49.86409139633179,206.2457504272461,6895,668,6227,6227,0,10,799000.0
799,799999,20.59682302104005,35.18393418529635,0.06632325992508059,104.25351190567017,49.93031692504883,206.6422996520996,6895,668,6227,6227,0,10,800000.0
800,800999,20.589830757479852,35.1761657281593,0.06636571760100551,104.37362885475159,49.99505925178528,207.01714706420898,6896,668,6228,6228,0,10,801000.0
801,801999,20.585198359381415,35.17512588814363,0.06627637058484648,104.50632166862488,50.05860185623169,207.17939376831055,6898,669,6229,6229,0,10,802000.0
802,802999,20.57822496843089,35.163059215817036,0.06626667426280786,104.63534832000732,50.12320947647095,207.31583786010742,6898,669,6229,6229,0,10,803000.0
803,803999,20.572384832245465,35.15215771380255,0.06614736954355127,104.7563009262085,50.18806719779968,207.8169708251953,6898,669,6229,6229,0,10,804000.0
804,804999,20.56730454922394,35.14590663844169,0.06602996892785629,104.89772987365723,50.253464698791504,207.93923950195312,6903,670,6233,6233,0,10,805000.0
805,805999,20.56326763870567,35.13833255532939,0.065934023518329,105.03590106964111,50.31800937652588,208.09317016601562,6907,671,6236,6236,0,10,806000.0
806,806999,20.560337623453155,35.133349798954704,0.065832769449507,105.15567827224731,50.38254141807556,208.57884979248047,6910,671,6239,6239,0,10,807000.0
807,807999,20.558632758891324,35.14246987951803,0.06572673035638155,105.32578039169312,50.44746232032776,208.65265274047852,6922,674,6248,6248,0,10,808000.0
808,808999,20.5553620333193,35.13638880657812,0.06562546727549423,105.45433187484741,50.51214671134949,208.8206329345703,6922,674,6248,6248,0,10,809000.0
809,809999,20.553382683358716,35.13070849994787,0.06553543116088967,105.59186291694641,50.57705855369568,209.41202926635742,6929,675,6254,6254,0,10,810000.0
810,810999,20.550962449671708,35.12668050920342,0.065450558164314,105.72841048240662,50.643245458602905,209.67484664916992,6931,676,6255,6255,0,10,811000.0
811,811999,20.54911391673946,35.122052779874636,0.06539710713804159,105.84740972518921,50.70769906044006,209.8877296447754,6931,676,6255,6255,0,10,812000.0
812,812999,20.54929077351454,35.11626857053574,0.06523793064153804,105.97309017181396,50.773682832717896,210.91872787475586,6933,676,6257,6257,0,10,813000.0
813,813999,20.550349955719234,35.11256266588704,0.06513304319544777,106.08407616615295,50.837945222854614,211.20718383789062,6933,676,6257,6257,0,10,814000.0
814,814999,20.548666775633528,35.10487781829822,0.06506175714060447,106.19631719589233,50.90248727798462,211.7016143798828,6935,676,6259,6259,0,10,815000.0
815,815999,20.54586730480516,35.094453645850805,0.06499208855901284,106.32140111923218,50.96689319610596,212.04085159301758,6935,676,6259,6259,0,10,816000.0
816,816999,20.544915877597127,35.10670939349328,0.06488170165892826,106.44101119041443,51.03143000602722,212.81122589111328,6940,676,6264,6264,0,10,817000.0
817,817999,20.53678315747316,35.09382713777014,0.06488311645055644,106.57598519325256,51.09604072570801,213.48474884033203,6944,677,6267,6267,0,10,818000.0
818,818999,20.528938550992038,35.08228700982319,0.06496779333251945,106.69846296310425,51.16112184524536,213.83594131469727,6945,677,6268,6268,0,10,819000.0
819,819999,20.52295056641792,35.07083473817033,0.06499022146410971,106.8126277923584,51.225663900375366,214.07979202270508,6945,677,6268,6268,0,10,820000.0
820,820999,20.519671007993423,35.06705759657735,0.0649826915147812,106.97430491447449,51.29208779335022,214.29230499267578,6953,679,6274,6274,0,10,821000.0
821,821999,20.518460569113824,35.061809407894806,0.06496091528614834,107.10739398002625,51.356194496154785,214.58189010620117,6955,680,6275,6275,0,10,822000.0
822,822999,20.51820021861817,35.05726184578829,0.06497985111045412,107.23226261138916,51.42063546180725,214.7971305847168,6955,680,6275,6275,0,10,823000.0
823,823999,20.520125552181142,35.05561509370093,0.06508246724689315,107.35051774978638,51.48528456687927,215.12493896484375,6955,680,6275,6275,0,10,824000.0
824,824999,20.522406364028637,35.06566942732668,0.06510159837551133,107.50502133369446,51.55035471916199,215.29416275024414,6960,681,6279,6279,0,10,825000.0
825,825999,20.526017922670466,35.06769281179737,0.06523554357856054,107.63801980018616,51.61545205116272,215.4638328552246,6964,682,6282,6282,0,10,826000.0
826,826999,20.531892399402874,35.076071569327176,0.06543426067077218,107.782555103302,51.68061017990112,215.90651321411133,6968,683,6285,6285,0,10,827000.0
827,827999,20.536771600731587,35.079126197070934,0.0654638134120391,107.91533732414246,51.74518847465515,216.1240119934082,6970,684,6286,6286,0,10,828000.0
828,828999,20.542576784867716,35.08085914587167,0.0655512937826992,108.04003953933716,51.80966114997864,216.28484344482422,6970,684,6286,6286,0,10,829000.0
829,829999,20.548669032552038,35.08767404124686,0.0656297254546665,108.21786165237427,51.8817503452301,216.62345123291016,7004,686,6318,6318,0,10,830000.0
830,830999,20.556676185993897,35.096048827962484,0.06572073673181733,108.37256002426147,51.946534633636475,216.85494232177734,7011,688,6323,6323,0,10,831000.0
831,831999,20.562901177849255,35.09972225180315,0.06584710624008583,108.50758218765259,52.01244807243347,217.09091567993164,7020,689,6331,6331,0,10,832000.0
832,832999,20.57545615201557,35.11183528172176,0.06577904143876412,108.63815450668335,52.08270263671875,217.9519500732422,7022,689,6333,6333,0,10,833000.0
833,833999,20.58601420893022,35.120552248753434,0.06585794150686808,108.76893997192383,52.14755177497864,218.23266220092773,7027,690,6337,6337,0,10,834000.0
834,834999,20.592091421405165,35.12159966991266,0.06591215990152244,108.87861394882202,52.211313247680664,218.4384536743164,7027,690,6337,6337,0,10,835000.0
835,835999,20.595543112611868,35.11936467181737,0.0658306721572608,108.99606442451477,52.27620577812195,219.02606582641602,7029,690,6339,6339,0,10,836000.0
836,836999,20.592669899717535,35.11415306620199,0.06582465635210111,109.12325692176819,52.340211629867554,219.7589111328125,7036,690,6346,6346,0,10,837000.0
837,837999,20.589078768929923,35.117712821286226,0.06583561456569709,109.28298425674438,52.40615105628967,220.3461036682129,7047,692,6355,6355,0,10,838000.0
838,838999,20.585647912112677,35.119394603908056,0.06581098359272497,109.40754079818726,52.472009897232056,220.7504425048828,7049,692,6357,6357,0,10,839000.0
839,839999,20.583653499547957,35.118368380098424,0.06587488376195794,109.53105854988098,52.536569595336914,221.02264022827148,7049,692,6357,6357,0,10,840000.0
840,840999,20.585130690586517,35.11801392474474,0.06582079501770455,109.72553300857544,52.6141893863678,221.4240379333496,7071,694,6377,6377,0,10,841000.0
841,841999,20.58767519286646,35.126631096501285,0.06573926252036488,109.88320827484131,52.67957329750061,221.58971405029297,7076,696,6380,6380,0,10,842000.0
842,842999,20.589960097989373,35.13641933398993,0.06565149289501926,110.01153254508972,52.74578070640564,222.02145767211914,7076,696,6380,6380,0,10,843000.0
843,843999,20.597232559671266,35.17126684529158,0.06546165026852846,110.12252449989319,52.81024742126465,222.2832908630371,7076,696,6380,6380,0,10,844000.0
844,844999,20.60451399443346,35.20369767490924,0.0654108675863816,110.26886296272278,52.876160621643066,222.47725677490234,7078,697,6381,6381,0,10,845000.0
845,845999,20.617762439122078,35.26044678649358,0.06533627415958476,110.38748097419739,52.94079089164734,222.89580917358398,7078,697,6381,6381,0,10,846000.0
846,846999,20.629788515582213,35.31425861025693,0.06523046084489403,110.50404095649719,53.005200147628784,223.02681350708008,7078,697,6381,6381,0,10,847000.0
847,847999,20.646459528945194,35.37312809477817,0.06508199463007269,110.6331799030304,53.06999754905701,223.55651473999023,7079,697,6382,6382,0,10,848000.0
848,848999,20.66292084051789,35.41793111610033,0.06498482476446199,110.76846122741699,53.135594844818115,223.96119689941406,7090,698,6392,6392,0,10,849000.0
849,849999,20.683641530173098,35.47777972026194,0.06482977211245555,110.90436267852783,53.20080089569092,224.62437438964844,7093,699,6394,6394,0,10,850000.0
850,850999,20.702756779485924,35.53898930895879,0.0647139440441803,111.01607608795166,53.26573133468628,224.94572830200195,7094,699,6395,6395,0,10,851000.0
851,851999,20.723685805095364,35.59276622220513,0.06481447603008361,111.14131546020508,53.32988500595093,225.46651077270508,7094,699,6395,6395,0,10,852000.0
852,852999,20.731946469792696,35.61141327228208,0.06479324534471254,111.2750358581543,53.4020733833313,226.04200744628906,7097,699,6398,6398,0,10,853000.0
853,853999,20.745689609579777,35.70060540348986,0.0645787334820428,111.39608931541443,53.46738076210022,226.76887130737305,7100,699,6401,6401,0,10,854000.0
854,854999,20.767704903219677,35.81020640017433,0.06449002763736922,111.53813934326172,53.53344440460205,227.18009567260742,7105,700,6405,6405,0,10,855000.0
855,855999,20.784138339267713,35.88645513873284,0.06454274498297341,111.68583822250366,53.60088586807251,227.55030059814453,7113,701,6412,6412,0,10,856000.0
856,856999,20.803641454936102,35.96814921793652,0.06422185793819768,111.83070540428162,53.66633176803589,227.91857147216797,7115,702,6413,6413,0,10,857000.0
857,857999,20.818770656948193,36.02189577628094,0.06411543034141087,111.96696448326111,53.73115110397339,228.06444549560547,7119,703,6416,6416,0,10,858000.0
858,858999,20.83523869638429,36.075101880947194,0.06399401979561048,112.10681080818176,53.79635000228882,228.45449829101562,7122,704,6418,6418,0,10,859000.0
859,859999,20.852376017610766,36.120652393375316,0.06399477337552872,112.23404955863953,53.86156463623047,228.64577102661133,7122,704,6418,6418,0,10,860000.0
860,860999,20.869974055902784,36.16233240489928,0.06398520831895349,112.37226176261902,53.927422761917114,229.07256698608398,7150,705,6445,6445,0,10,861000.0
861,861999,20.8799511647394,36.17865526991879,0.06409515371164098,112.50263285636902,53.99238395690918,229.2152099609375,7152,706,6446,6446,0,10,862000.0
862,862999,20.89549258910688,36.21240257942551,0.06423504768295929,112.63939595222473,54.057090759277344,229.34738159179688,7156,707,6449,6449,0,10,863000.0
863,863999,20.91249120039778,36.27204418502666,0.06395817208748622,112.79235672950745,54.12389540672302,229.83976364135742,7166,709,6457,6457,0,10,864000.0
864,864999,20.933017861334797,36.339627898023394,0.06407800191761703,112.9103832244873,54.18892741203308,230.06241607666016,7166,709,6457,6457,0,10,865000.0
865,865999,20.951419465301523,36.366554854732506,0.06417792442907255,113.03580331802368,54.254443407058716,230.75509643554688,7166,709,6457,6457,0,10,866000.0
866,866999,20.96945084176397,36.411898891921794,0.06441556471903931,113.15211772918701,54.3190655708313,230.97951889038086,7166,709,6457,6457,0,10,867000.0
867,867999,20.9881273791978,36.43972430680243,0.0644893190597361,113.29276251792908,54.38718223571777,231.4053497314453,7168,710,6458,6458,0,10,868000.0
868,868999,20.99966432115646,36.46430104979651,0.06447236760848485,113.44372296333313,54.453120470047,232.02314376831055,7212,712,6500,6500,0,10,869000.0
869,869999,21.01165449285052,36.521799340882204,0.06431826595465051,113.565025806427,54.51785397529602,232.62657165527344,7219,712,6507,6507,0,10,870000.0
870,870999,21.021430805111073,36.56611509052023,0.0642643887737323,113.68510580062866,54.58340811729431,233.14044570922852,7219,712,6507,6507,0,10,871000.0
871,871999,21.032008058971385,36.592374997365695,0.06446437181207065,113.82258868217468,54.64919114112854,233.4357681274414,7223,713,6510,6510,0,10,872000.0
872,872999,21.04568945330697,36.6294538855439,0.06460075407141785,113.94606757164001,54.714945554733276,233.74359130859375,7223,713,6510,6510,0,10,873000.0
873,873999,21.064728428654966,36.68545362503206,0.06495701451619906,114.08811807632446,54.780269622802734,234.24807357788086,7236,714,6522,6522,0,10,874000.0
874,874999,21.077069069882047,36.70846112131399,0.0654284905979966,114.21047806739807,54.84677815437317,234.69585800170898,7239,714,6525,6525,0,10,875000.0
875,875999,21.09533391185742,36.76614637832181,0.06573625705373476,114.3624279499054,54.912630558013916,235.05572891235352,7252,716,6536,6536,0,10,876000.0
876,876999,21.11378720832158,36.8079194573354,0.06596871250296388,114.48450994491577,54.97908306121826,235.35951232910156,7254,716,6538,6538,0,10,877000.0
877,877999,21.135549838352677,36.88250351192733,0.06625193588337308,114.62055516242981,55.04505777359009,235.53498077392578,7260,717,6543,6543,0,10,878000.0
878,878999,21.157709560260493,36.9282904050658,0.06683572695498263,114.79400491714478,55.11069202423096,235.85040664672852,7275,720,6555,6555,0,10,879000.0
879,879999,21.17719100649744,36.96221485472834,0.06740126905240673,114.98218846321106,55.17570424079895,236.01815795898438,7285,724,6561,6561,0,10,880000.0
880,880999,21.196061150025752,36.99611235772026,0.06884666997790345,115.10788631439209,55.24139881134033,236.23099899291992,7285,724,6561,6561,0,10,881000.0
881,881999,21.2148390731358,37.03248584509325,0.06930872579126812,115.23963212966919,55.307990074157715,236.63994979858398,7285,724,6561,6561,0,10,882000.0
882,882999,21.239069051240644,37.0905985259979,0.07009920395326219,115.39264750480652,55.373541593551636,236.80317306518555,7296,726,6570,6570,0,10,883000.0
883,883999,21.259385958355477,37.125763054182826,0.0707764261955427,115.53525805473328,55.43842124938965,237.00848770141602,7306,727,6579,6579,0,10,884000.0
884,884999,21.27820352997141,37.14936316965411,0.07138362473573856,115.65345692634583,55.504504442214966,237.58382034301758,7306,727,6579,6579,0,10,885000.0
885,885999,21.29603411658604,37.17451362639386,0.07215207107036936,115.80022621154785,55.56885743141174,237.69555282592773,7315,729,6586,6586,0,10,886000.0
886,886999,21.316893282041505,37.21979502738807,0.07291737835637824,115.92344188690186,55.63392448425293,237.83202743530273,7315,729,6586,6586,0,10,887000.0
887,887999,21.330267524493078,37.2344027497703,0.07339191910684029,116.04188799858093,55.698134899139404,238.34943771362305,7315,729,6586,6586,0,10,888000.0
888,888999,21.339378573141754,37.25632794516508,0.07346900786879451,116.16963315010071,55.762701988220215,238.9966049194336,7322,729,6593,6593,0,10,889000.0
889,889999,21.336746402242103,37.25885147805216,0.07337942990953528,116.30832481384277,55.82817029953003,239.57219696044922,7331,730,6601,6601,0,10,890000.0
890,890999,21.339143089274238,37.28018223418784,0.07332956414037761,116.46330833435059,55.8946533203125,239.9922103881836,7346,732,6614,6614,0,10,891000.0
891,891999,21.34172404797126,37.29081234158281,0.07328754516784941,116.60605239868164,55.96067571640015,240.21316528320312,7349,733,6616,6616,0,10,892000.0
892,892999,21.343157460934215,37.296930618064714,0.073245077160909,116.73994660377502,56.026219844818115,240.44935607910156,7352,734,6618,6618,0,10,893000.0
893,893999,21.345702608449187,37.303698360440116,0.07324171782858624,116.88215613365173,56.09040379524231,240.66160583496094,7358,735,6623,6623,0,10,894000.0
894,894999,21.348830059723824,37.307408978814976,0.07317355607314102,117.01151466369629,56.15447807312012,240.83940887451172,7358,735,6623,6623,0,10,895000.0
895,895999,21.353548369297744,37.31597068747414,0.07313883721185477,117.17518639564514,56.21906042098999,241.04596710205078,7363,737,6626,6626,0,10,896000.0
896,896999,21.357492017777208,37.32373063979542,0.07310366806379465,117.2863028049469,56.28358721733093,241.2611083984375,7363,737,6626,6626,0,10,897000.0
897,897999,21.364603352711562,37.34184784062198,0.07312470202717358,117.42156410217285,56.34846210479736,241.41448593139648,7363,737,6626,6626,0,10,898000.0
898,898999,21.37367256025268,37.35916253057334,0.0732386638875181,117.55534982681274,56.413203954696655,241.66615676879883,7366,738,6628,6628,0,10,899000.0
899,899999,21.37873122364518,37.367614597312,0.07331635642982515,117.69141507148743,56.477845430374146,241.94749069213867,7374,739,6635,6635,0,10,900000.0
900,900999,21.38673729445546,37.37923212529247,0.07352047493752945,117.82593965530396,56.54291844367981,242.12093353271484,7376,740,6636,6636,0,10,901000.0
901,901999,21.395129415550034,37.39358045250248,0.0736400507033641,118.00949454307556,56.6081428527832,242.2371597290039,7384,743,6641,6641,0,10,902000.0
902,902999,21.407099754455793,37.41527621616821,0.07383597199326497,118.13285565376282,56.67330765724182,242.64694595336914,7384,743,6641,6641,0,10,903000.0
903,903999,21.42007288544619,37.44115131333473,0.07419295904044032,118.25762391090393,56.73787713050842,242.81901931762695,7384,743,6641,6641,0,10,904000.0
904,904999,21.43419469515667,37.461911275539265,0.0744202314901482,118.41773319244385,56.80356025695801,243.39940643310547,7425,745,6680,6680,0,10,905000.0
905,905999,21.446925142660664,37.4792382777264,0.0746924065511303,118.55018639564514,56.86756920814514,243.60071563720703,7427,746,6681,6681,0,10,906000.0
906,906999,21.46058545714519,37.50362242931067,0.07510387526246665,118.67218708992004,56.93155574798584,243.75874710083008,7427,746,6681,6681,0,10,907000.0
907,907999,21.477310319659402,37.530681490213034,0.07552574315279714,118.79668951034546,56.99593758583069,244.1819305419922,7427,746,6681,6681,0,10,908000.0
908,908999,21.484165981097057,37.538045428512234,0.07573535860046055,118.91240334510803,57.05989408493042,244.44915390014648,7428,746,6682,6682,0,10,909000.0
909,909999,21.485837221201383,37.557588819756916,0.0755936531961332,119.05176615715027,57.7956006526947,244.84264755249023,7434,747,6687,6687,0,10,910000.0
910,910999,21.484626995840948,37.558973876623206,0.07548757139166318,119.21422028541565,57.861448526382446,245.38007736206055,7467,749,6718,6718,0,10,911000.0
911,911999,21.486450700411638,37.56382255685178,0.07538552559748846,119.33712100982666,57.92679572105408,245.6322135925293,7467,749,6718,6718,0,10,912000.0
912,912999,21.489631635860263,37.575773638264934,0.07523739753036474,119.48395538330078,57.993053674697876,245.93932342529297,7469,750,6719,6719,0,10,913000.0
913,913999,21.493323295009905,37.580937461228245,0.07492516609114475,119.64493942260742,58.05843949317932,246.22050094604492,7489,752,6737,6737,0,10,914000.0
914,914999,21.495535026308303,37.583370380465446,0.07483552324604048,119.80660915374756,58.1235716342926,246.4415054321289,7526,754,6772,6772,0,10,915000.0
915,915999,21.49843948311435,37.585189137785,0.07476395030526184,119.97076988220215,58.189645290374756,246.83767700195312,7540,756,6784,6784,0,10,916000.0
916,916999,21.502502718977247,37.59464118773878,0.07463442440665558,120.13494992256165,58.25541162490845,247.02327728271484,7544,758,6786,6786,0,10,917000.0
917,917999,21.5062569702974,37.59858601771086,0.0745516446669372,120.29226541519165,58.32105302810669,247.1683006286621,7577,760,6817,6817,0,10,918000.0
918,918999,21.51450416125893,37.63872252689457,0.07442016147618513,120.42129278182983,58.388304471969604,247.46465682983398,7577,760,6817,6817,0,10,919000.0
919,919999,21.51656846868534,37.639320210537996,0.07444280698518257,120.5805938243866,58.45379948616028,247.53075790405273,7612,762,6850,6850,0,10,920000.0
920,920999,21.520908560803143,37.64390806058794,0.07440814985791311,120.72471761703491,58.51862072944641,247.60492706298828,7618,763,6855,6855,0,10,921000.0
921,921999,21.526821453808108,37.64919237960902,0.07430283022716455,120.85079169273376,58.58405947685242,248.04747772216797,7618,763,6855,6855,0,10,922000.0
922,922999,21.533384896573306,37.66256277605964,0.07436723408556567,121.00797533988953,58.64940690994263,248.16627502441406,7625,765,6860,6860,0,10,923000.0
923,923999,21.539097260269244,37.6673794594994,0.07428676189611916,121.12682938575745,58.71453356742859,248.61419296264648,7625,765,6860,6860,0,10,924000.0
924,924999,21.544171822034915,37.67250387921312,0.0742807293632547,121.26585984230042,58.77934503555298,248.83257293701172,7662,766,6896,6896,0,10,925000.0
925,925999,21.549458955503017,37.678009355293995,0.0743061640691347,121.38570356369019,58.843899726867676,249.4158935546875,7662,766,6896,6896,0,10,926000.0
926,926999,21.546180369071063,37.67030117177714,0.07429378111279739,121.54257869720459,58.90880060195923,249.9324607849121,7731,768,6963,6963,0,10,927000.0
927,927999,21.54151009100144,37.66656378099683,0.07426886026495882,121.67787909507751,58.97376251220703,250.47027969360352,7741,769,6972,6972,0,10,928000.0
928,928999,21.537232918279354,37.661161020608354,0.07426597402809121,121.80506563186646,59.03964805603027,250.76589965820312,7742,769,6973,6973,0,10,929000.0
929,929999,21.531859292025242,37.651144604451815,0.07426924421598569,121.96433210372925,59.10524916648865,250.94992446899414,7775,771,7004,7004,0,10,930000.0
930,930999,21.53132982033883,37.64570292021903,0.07417767130830466,122.12909150123596,59.171717405319214,251.29031372070312,7781,773,7008,7008,0,10,931000.0
931,931999,21.5295114902342,37.639708322638064,0.07406470868660431,122.24926996231079,59.2368643283844,251.50429916381836,7781,773,7008,7008,0,10,932000.0
932,932999,21.527775303873845,37.63261235254645,0.07394237962256633,122.401034116745,59.302746534347534,251.76870727539062,7785,774,7011,7011,0,10,933000.0
933,933999,21.529134588764734,37.648292343038364,0.07376169997433302,122.5403003692627,59.368120431900024,252.00043106079102,7790,775,7015,7015,0,10,934000.0
934,934999,21.528426614022802,37.63960979976532,0.07367540359910907,122.66287136077881,59.43293285369873,252.19630813598633,7790,775,7015,7015,0,10,935000.0
935,935999,21.528726754352803,37.63862000292657,0.07352365854947485,122.79000902175903,59.49906277656555,252.56666946411133,7792,775,7017,7017,0,10,936000.0
936,936999,21.528828197204394,37.63303132665141,0.07338206548431914,122.95135545730591,59.564340114593506,252.78500366210938,7825,777,7048,7048,0,10,937000.0
937,937999,21.53150445417826,37.633477813589785,0.0732971421423173,123.09503936767578,59.629899740219116,252.92033004760742,7827,778,7049,7049,0,10,938000.0
938,938999,21.534687532309793,37.63952255774668,0.07315635791703068,123.23780274391174,59.69497346878052,253.19031524658203,7834,779,7055,7055,0,10,939000.0
939,939999,21.54283446588917,37.64413155607644,0.07295664228195575,123.41223096847534,59.76069450378418,253.43086624145508,7845,782,7063,7063,0,10,940000.0
940,940999,21.549932561763434,37.65016420876599,0.07282651097387383,123.5885534286499,59.82642078399658,253.5868377685547,7854,785,7069,7069,0,10,941000.0
941,941999,21.557662596661494,37.651793620570494,0.07256813927401717,123.72360968589783,59.8915593624115,254.0243034362793,7861,786,7075,7075,0,10,942000.0
942,942999,21.566293254190523,37.65494178310292,0.07238513011946213,123.85715913772583,59.9564151763916,254.19880294799805,7863,787,7076,7076,0,10,943000.0
943,943999,21.570871224685316,37.65434286579323,0.07220676338220533,123.98749780654907,60.020346879959106,254.3012924194336,7873,788,7085,7085,0,10,944000.0
944,944999,21.575230607222306,37.659420808468106,0.07204069221703435,124.12711024284363,60.08651375770569,254.7474021911621,7877,789,7088,7088,0,10,945000.0
945,945999,21.57620156984688,37.65599518269211,0.07201180999936929,124.28418207168579,60.15063142776489,255.05737686157227,7884,791,7093,7093,0,10,946000.0
946,946999,21.574163041255794,37.666700159287544,0.0717141381592844,124.462961435318,60.21536111831665,255.40638732910156,7922,794,7128,7128,0,10,947000.0
947,947999,21.56827745664447,37.65788153167352,0.07169132958740576,124.62355422973633,60.28084754943848,255.8548583984375,7955,796,7159,7159,0,10,948000.0
948,948999,21.561537650640815,37.646910506640026,0.07170178619544665,124.74418616294861,60.34604048728943,256.07068634033203,7955,796,7159,7159,0,10,949000.0
949,949999,21.557626957836032,37.6447441919118,0.0716790735305699,124.88356924057007,60.411027669906616,256.2532768249512,7960,797,7163,7163,0,10,950000.0
950,950999,21.554061655888287,37.63686375969143,0.07163512651678561,125.03472542762756,60.4812912940979,256.6461524963379,7963,798,7165,7165,0,10,951000.0
951,951999,21.550976145389146,37.627951683567254,0.07157684410482934,125.18300294876099,60.5465190410614,257.02203369140625,7975,799,7176,7176,0,10,952000.0
952,952999,21.547782245042225,37.6198068122249,0.07153408150830831,125.30066895484924,60.61132264137268,257.2637748718262,7976,799,7177,7177,0,10,953000.0
953,953999,21.545578033523626,37.61162806050534,0.0714667556563513,125.48472929000854,60.67783331871033,257.4207763671875,8017,802,7215,7215,0,10,954000.0
954,954999,21.544250035701083,37.60784381883722,0.07139439056204633,125.60753273963928,60.74374485015869,257.61791229248047,8017,802,7215,7215,0,10,955000.0
955,955999,21.54244249880297,37.60068729209622,0.0713935535968594,125.75899052619934,60.80912804603577,257.7412528991699,8019,803,7216,7216,0,10,956000.0
956,956999,21.541418755877466,37.59576279877532,0.0713251130878233,125.87488913536072,60.87381911277771,258.15514373779297,8021,803,7218,7218,0,10,957000.0
957,957999,21.540434410383988,37.59107433202976,0.07134388436794836,126.02703428268433,60.93957996368408,258.29662322998047,8025,805,7220,7220,0,10,958000.0
958,958999,21.54009681658853,37.585197128300386,0.07130597258901172,126.18179154396057,61.00499415397644,258.3909225463867,8030,806,7224,7224,0,10,959000.0
959,959999,21.543193104524153,37.585585866223035,0.07124776589931925,126.30776643753052,61.06996250152588,258.8748588562012,8031,806,7225,7225,0,10,960000.0
960,960999,21.548157482325372,37.59050455418248,0.0711964847118084,126.46742820739746,61.13602900505066,259.01244735717773,8035,808,7227,7227,0,10,961000.0
961,961999,21.551271073431817,37.59079269551954,0.07116043768611646,126.60994911193848,61.20143461227417,259.2729263305664,8045,809,7236,7236,0,10,962000.0
962,962999,21.554577353942435,37.58963915203551,0.0711129808805987,126.7434573173523,61.26721739768982,259.73414611816406,8048,809,7239,7239,0,10,963000.0
963,963999,21.55860431715063,37.589350576131125,0.07110461220404996,126.88331079483032,61.33181571960449,259.83955001831055,8050,810,7240,7240,0,10,964000.0
964,964999,21.56261976428059,37.58781471228829,0.07109731996878488,127.07520985603333,61.396625995635986,259.8300437927246,8069,814,7255,7255,0,10,965000.0
965,965999,21.563643347375667,37.58222678213644,0.07105254266252004,127.23077440261841,61.46110272407532,260.1771240234375,8108,816,7292,7292,0,10,966000.0
966,966999,21.562998153309856,37.58375383600313,0.07095658872975008,127.37214970588684,61.52651357650757,260.703857421875,8115,817,7298,7298,0,10,967000.0
967,967999,21.555092240242804,37.57334004640164,0.07096537857359009,127.52652168273926,61.59180521965027,261.0700263977051,8119,819,7300,7300,0,10,968000.0
968,968999,21.54645148823149,37.56058849590482,0.07101264965061505,127.65164709091187,61.65711545944214,261.3588066101074,8119,819,7300,7300,0,10,969000.0
969,969999,21.53859656719071,37.550792750727574,0.07103247473010732,127.76721811294556,61.72174525260925,261.54580307006836,8119,819,7300,7300,0,10,970000.0
970,970999,21.530642334269523,37.53877854630761,0.07105388955245862,127.95049285888672,61.78787350654602,261.6226692199707,8125,822,7303,7303,0,10,971000.0
971,971999,21.522591322197126,37.524895267531235,0.07109156274339745,128.11347937583923,61.8528106212616,261.92599868774414,8130,824,7306,7306,0,10,972000.0
972,972999,21.514856792752205,37.512383939916475,0.0711019031970872,128.23756456375122,61.91824650764465,262.1015167236328,8130,824,7306,7306,0,10,973000.0
973,973999,21.507569120687265,37.50053969143105,0.07112252583136325,128.40082669258118,61.98345899581909,262.2544631958008,8134,826,7308,7308,0,10,974000.0
974,974999,21.50057092889063,37.48816949558152,0.07111506859102568,128.540611743927,62.04885125160217,262.5366630554199,8165,827,7338,7338,0,10,975000.0
975,975999,21.493762493221478,37.475810945010195,0.07113033705570915,128.70634770393372,62.11377787590027,262.6336898803711,8169,829,7340,7340,0,10,976000.0
976,976999,21.487921024768163,37.46883424099048,0.07113960444668066,128.85217022895813,62.17883253097534,262.79163360595703,8171,830,7341,7341,0,10,977000.0
977,977999,21.48335613584022,37.457639827004904,0.07108633862789471,128.99440121650696,62.24362754821777,263.08543395996094,8173,831,7342,7342,0,10,978000.0
978,978999,21.4807729963477,37.472675447501636,0.07095550856861399,129.17848825454712,62.308915853500366,263.18921279907227,8188,834,7354,7354,0,10,979000.0
979,979999,21.476239370704977,37.463045232493855,0.07093452143311074,129.3231430053711,62.3734290599823,263.31950759887695,8193,835,7358,7358,0,10,980000.0
980,980999,21.47128298050516,37.4524186316684,0.07089510573183666,129.4927978515625,62.43994498252869,263.6226921081543,8199,837,7362,7362,0,10,981000.0
981,981999,21.46892840990692,37.44709576401671,0.07084288365775238,129.6927514076233,62.50595283508301,263.68731689453125,8216,841,7375,7375,0,10,982000.0
982,982999,21.465452982301212,37.43911515407499,0.07081738796633719,129.81180715560913,62.57093906402588,263.8995780944824,8216,841,7375,7375,0,10,983000.0
983,983999,21.46049745046693,37.429299171430756,0.07079103379096208,129.97258186340332,62.63930130004883,264.21703338623047,8229,843,7386,7386,0,10,984000.0
984,984999,21.45642347967603,37.42041890089386,0.07077665969980695,130.11406755447388,62.70417618751526,264.36822509765625,8239,844,7395,7395,0,10,985000.0
985,985999,21.450908349102072,37.409870035520775,0.07077357393726313,130.24821281433105,62.76856994628906,264.6253471374512,8243,845,7398,7398,0,10,986000.0
986,986999,21.44550637387143,37.39927178949121,0.07073911814467004,130.37847232818604,62.83352255821228,264.8489303588867,8248,846,7402,7402,0,10,987000.0
987,987999,21.446725459542016,37.415983055885725,0.07061308869615446,130.51926589012146,62.89783692359924,265.5834846496582,8261,847,7414,7414,0,10,988000.0
988,988999,21.45033515772888,37.446921757377844,0.07050830875760872,130.63634586334229,62.963111877441406,266.1206817626953,8262,847,7415,7415,0,10,989000.0
989,989999,21.457634997543202,37.502710499398084,0.07046685071731462,130.82079458236694,63.02910804748535,266.2395935058594,8302,850,7452,7452,0,10,990000.0
990,990999,21.45821889132763,37.50654556672604,0.07049881416164905,130.9453763961792,63.09390664100647,266.45925521850586,8302,850,7452,7452,0,10,991000.0
991,991999,21.461263613577042,37.50866641715694,0.07044956479201259,131.10083174705505,63.1591317653656,266.70557022094727,8307,852,7455,7455,0,10,992000.0
992,992999,21.469053321595528,37.520295168538134,0.0703066849790348,131.24825191497803,63.22554421424866,266.8812828063965,8309,853,7456,7456,0,10,993000.0
993,993999,21.473725479866367,37.522957749715744,0.07026634764792528,131.39009141921997,63.2899386882782,267.0031051635742,8311,854,7457,7457,0,10,994000.0
994,994999,21.481513742596885,37.534632604652266,0.06989333344324722,131.5482201576233,63.3555006980896,267.2796821594238,8316,856,7460,7460,0,10,995000.0
995,995999,21.489709599174486,37.54190070902593,0.06958019109148739,131.68988847732544,63.42110896110535,267.4264450073242,8318,857,7461,7461,0,10,996000.0
996,996999,21.49517154505528,37.54545813534127,0.06942304196789628,131.87358832359314,63.48806834220886,267.5348320007324,8333,860,7473,7473,0,10,997000.0
997,997999,21.501422343115262,37.54860147162363,0.06909350346211773,132.0183265209198,63.55303740501404,267.9127540588379,8340,861,7479,7479,0,10,998000.0
998,998999,21.505695403736652,37.55261012597322,0.06889875638833054,132.19424414634705,63.61940884590149,268.0095443725586,8349,864,7485,7485,0,10,999000.0
999,999999,21.509052368971194,37.55600684231476,0.06884901137658961,132.357519865036,63.6844367980957,268.11791229248047,8359,866,7493,7493,0,10,1000000.0
1000,1000999,21.51267511716922,37.554474385388325,0.0686894489590244,132.51394414901733,63.74988889694214,268.42619705200195,8367,867,7500,7500,0,10,1001000.0
1001,1001999,21.518517791244236,37.56573751569526,0.06851123483786214,132.65198850631714,63.815269231796265,268.5752639770508,8369,868,7501,7501,0,10,1002000.0
1002,1002999,21.52445855354966,37.567611740730726,0.06833358904070608,132.83436727523804,63.87986183166504,268.650390625,8379,871,7508,7508,0,10,1003000.0
1003,1003999,21.534690655570756,37.572793495541525,0.06787660099311599,132.9919376373291,63.94473695755005,268.9876251220703,8417,873,7544,7544,0,10,1004000.0
1004,1004999,21.544123565418314,37.576096231544135,0.06748981732910508,133.10508704185486,64.00890445709229,269.18899154663086,8417,873,7544,7544,0,10,1005000.0
1005,1005999,21.55071738449782,37.576297630616374,0.06722490527901592,133.25922751426697,64.07308292388916,269.3080940246582,8422,875,7547,7547,0,10,1006000.0
1006,1006999,21.557789273092393,37.583841157609804,0.06694876601819755,133.37052845954895,64.13714361190796,269.6489715576172,8422,875,7547,7547,0,10,1007000.0
1007,1007999,21.557804849617323,37.57906538526724,0.06682535877217644,133.5520281791687,64.20216751098633,270.1736259460449,8468,878,7590,7590,0,10,1008000.0
1008,1008999,21.553396938135087,37.57590310781731,0.06676642491154416,133.66854858398438,64.2667589187622,270.63477325439453,8469,878,7591,7591,0,10,1009000.0
1009,1009999,21.54833208272504,37.569040750478486,0.06674863712739232,133.80801153182983,64.33259725570679,270.877498626709,8471,879,7592,7592,0,10,1010000.0
1010,1010999,21.543854483882345,37.56343708426894,0.0667363890008803,133.96558451652527,64.39770936965942,270.9771537780762,8495,881,7614,7614,0,10,1011000.0
1011,1011999,21.540280100807212,37.55762976106105,0.06669830599527049,134.1122076511383,64.46413683891296,271.2733345031738,8498,882,7616,7616,0,10,1012000.0
1012,1012999,21.53716973895968,37.549878660533,0.06668073948278852,134.25305199623108,64.52906012535095,271.53085708618164,8500,883,7617,7617,0,10,1013000.0
1013,1013999,21.534983196447634,37.54268385534201,0.0666521624141091,134.41449880599976,64.59379076957703,271.69515228271484,8533,885,7648,7648,0,10,1014000.0
1014,1014999,21.532414445637276,37.53793032841004,0.06661743284895638,134.5595211982727,64.65895009040833,272.0421371459961,8541,886,7655,7655,0,10,1015000.0
1015,1015999,21.5298669117528,37.531415159466725,0.06657481019158273,134.6820068359375,64.72368502616882,272.2538414001465,8541,886,7655,7655,0,10,1016000.0
1016,1016999,21.52930464937166,37.52708290398917,0.06654665240082736,134.86853337287903,64.7904486656189,272.2825164794922,8560,889,7671,7671,0,10,1017000.0
1017,1017999,21.532187606971622,37.52781042664671,0.06659044339640618,135.05807065963745,64.85659289360046,272.51236724853516,8568,892,7676,7676,0,10,1018000.0
1018,1018999,21.535947370003477,37.532194308881316,0.0666559891354177,135.197598695755,64.92240023612976,272.7636833190918,8570,893,7677,7677,0,10,1019000.0
1019,1019999,21.538684958586295,37.53296835327319,0.06673428982733809,135.33499360084534,64.98732018470764,272.9420394897461,8572,894,7678,7678,0,10,1020000.0
1020,1020999,21.540868096857064,37.5324961576697,0.0668310831647222,135.4866590499878,65.05244398117065,273.0363311767578,8574,895,7679,7679,0,10,1021000.0
1021,1021999,21.546527094646322,37.53733035660617,0.06683894766589671,135.6429169178009,65.11754059791565,273.4065475463867,8580,897,7683,7683,0,10,1022000.0
1022,1022999,21.551763688274658,37.540590141975905,0.06689889240986158,135.8035764694214,65.18285727500916,273.5754814147949,8584,899,7685,7685,0,10,1023000.0
1023,1023999,21.556519473062004,37.54098568330273,0.06693154649419486,135.94380831718445,65.2481255531311,273.932804107666,8587,900,7687,7687,0,10,1024000.0
1024,1024999,21.560555820127863,37.54069478534261,0.0669463377419881,136.0872097015381,65.31961464881897,274.13486099243164,8589,901,7688,7688,0,10,1025000.0
1025,1025999,21.56541296935997,37.54361594120009,0.06701361321666965,136.2066617012024,65.38368034362793,274.2953872680664,8589,901,7688,7688,0,10,1026000.0
1026,1026999,21.568528859782187,37.54258894571661,0.06702178633768263,136.35224676132202,65.44802117347717,274.5560646057129,8594,902,7692,7692,0,10,1027000.0
1027,1027999,21.569274332634247,37.53816946738783,0.06700076863614612,136.5093982219696,65.51225972175598,274.73730850219727,8605,904,7701,7701,0,10,1028000.0
1028,1028999,21.562852447802133,37.52947030481834,0.06699992971964419,136.67101430892944,65.57726979255676,275.1502151489258,8615,906,7709,7709,0,10,1029000.0
1029,1029999,21.556816410531297,37.52230802757079,0.06701249600968762,136.8100962638855,65.64300751686096,275.6422538757324,8618,907,7711,7711,0,10,1030000.0
1030,1030999,21.550528903022474,37.513550954244806,0.06702998380647152,136.92902064323425,65.70802426338196,275.94279861450195,8618,907,7711,7711,0,10,1031000.0
1031,1031999,21.543599375351242,37.502920037472585,0.06706638677270449,137.13630151748657,65.77369475364685,276.03607177734375,8655,911,7744,7744,0,10,1032000.0
1032,1032999,21.537003428857705,37.49326475561664,0.06708692001476368,137.26340246200562,65.83888268470764,276.43170166015625,8656,911,7745,7745,0,10,1033000.0
1033,1033999,21.53209554141832,37.48557921607961,0.06707465414498803,137.40793204307556,65.90328359603882,276.6442222595215,8658,912,7746,7746,0,10,1034000.0
1034,1034999,21.527214429397066,37.47832328459513,0.06705145453556227,137.53069829940796,65.96779680252075,276.7952880859375,8658,912,7746,7746,0,10,1035000.0
1035,1035999,21.52290668100362,37.473583055107284,0.06699111107791933,137.666268825531,66.03315854072571,277.0866584777832,8664,913,7751,7751,0,10,1036000.0
1036,1036999,21.51931816342453,37.47018622936592,0.06691744873137928,137.8231384754181,66.0987069606781,277.22050857543945,8666,914,7752,7752,0,10,1037000.0
1037,1037999,21.516096969741614,37.46399362268352,0.06688494486883612,137.95249319076538,66.16297912597656,277.31476974487305,8666,914,7752,7752,0,10,1038000.0
1038,1038999,21.51422136056308,37.45798793180588,0.0668328102353839,138.11182951927185,66.22844457626343,277.5310287475586,8670,915,7755,7755,0,10,1039000.0
1039,1039999,21.513139890361817,37.45336171529633,0.0667686547384696,138.23308157920837,66.29247856140137,277.69134521484375,8670,915,7755,7755,0,10,1040000.0
1040,1040999,21.51329253737214,37.451569650386624,0.06674168052719753,138.36932253837585,66.3575792312622,277.7404670715332,8673,916,7757,7757,0,10,1041000.0
1041,1041999,21.512931329673652,37.4470884667685,0.06668207027557183,138.52127528190613,66.42217588424683,277.9182815551758,8675,917,7758,7758,0,10,1042000.0
1042,1042999,21.514835916850977,37.44587412016053,0.06662178553826636,138.64358139038086,66.48654198646545,278.063907623291,8675,917,7758,7758,0,10,1043000.0
1043,1043999,21.517173291565058,37.44691117162069,0.06662167319993706,138.78861832618713,66.55200433731079,278.13563537597656,8677,918,7759,7759,0,10,1044000.0
1044,1044999,21.518043394741603,37.44687878825977,0.06656193240934116,138.92841744422913,66.61624193191528,278.3426399230957,8679,919,7760,7760,0,10,1045000.0
1045,1045999,21.519680085738564,37.44706958042864,0.06647291272316203,139.0708930492401,66.6800708770752,278.4242820739746,8681,920,7761,7761,0,10,1046000.0
1046,1046999,21.522688649267316,37.44933327516667,0.06643261845185766,139.18790745735168,66.74372553825378,278.53863525390625,8681,920,7761,7761,0,10,1047000.0
1047,1047999,21.525787276095027,37.44950093993187,0.0663628936930909,139.3136694431305,66.80773067474365,278.80458068847656,8681,920,7761,7761,0,10,1048000.0
1048,1048999,21.52408678702939,37.442318033601154,0.06633292453651074,139.43225264549255,66.87130427360535,278.9869384765625,8681,920,7761,7761,0,10,1049000.0
1049,1049999,21.520961257574378,37.44021527587007,0.0662257078467845,139.61080741882324,66.93601775169373,279.51336669921875,8699,923,7776,7776,0,10,1050000.0
1050,1050999,21.515766472706883,37.43253147468587,0.06625411242314494,139.7568531036377,67.00152730941772,279.907958984375,8701,924,7777,7777,0,10,1051000.0
1051,1051999,21.508204608698716,37.42139466825496,0.06628807704590856,139.95667266845703,67.06706476211548,280.00887298583984,8738,928,7810,7810,0,10,1052000.0
1052,1052999,21.50425710078827,37.41393185940944,0.0662749863198101,140.10344338417053,67.13270211219788,280.26660919189453,8765,929,7836,7836,0,10,1053000.0
1053,1053999,21.499395164842714,37.40486339256221,0.06626159401736409,140.2281403541565,67.19749546051025,280.510555267334,8765,929,7836,7836,0,10,1054000.0
1054,1054999,21.497948887874898,37.407130405856336,0.06619612534997299,140.34658479690552,67.26317310333252,280.6454658508301,8765,929,7836,7836,0,10,1055000.0
1055,1055999,21.49853620197139,37.417823707146106,0.06604577677140899,140.49162983894348,67.32873487472534,280.99615478515625,8770,930,7840,7840,0,10,1056000.0
1056,1056999,21.499455273752513,37.430755540784354,0.06596741359129599,140.63331770896912,67.39396500587463,281.14477920532227,8773,931,7842,7842,0,10,1057000.0
1057,1057999,21.507607386686605,37.48893680118908,0.06570456858647578,140.7885959148407,67.46122860908508,281.31591033935547,8776,932,7844,7844,0,10,1058000.0
1058,1058999,21.51237921475868,37.502966616551035,0.0656666160504511,140.9556746482849,67.52570104598999,281.42155838012695,8786,934,7852,7852,0,10,1059000.0
1059,1059999,21.51685024901024,37.53086368007978,0.06561431807251916,141.14040088653564,67.59097027778625,281.74789810180664,8850,937,7913,7913,0,10,1060000.0
1060,1060999,21.522536575883894,37.55779074099589,0.06548418324569627,141.28715634346008,67.65688443183899,282.1531639099121,8853,938,7915,7915,0,10,1061000.0
1061,1061999,21.532889338623058,37.60168192409839,0.06532052059377269,141.43536067008972,67.72188138961792,282.30781173706055,8855,939,7916,7916,0,10,1062000.0
1062,1062999,21.541822098268618,37.63227016400583,0.06525138062947322,141.60921359062195,67.78842663764954,282.8002471923828,8863,941,7922,7922,0,10,1063000.0
1063,1063999,21.550869765108,37.6640378650596,0.06519807260131372,141.72684025764465,67.85280990600586,283.1175842285156,8863,941,7922,7922,0,10,1064000.0
1064,1064999,21.553545933845673,37.67482596708435,0.06509801697384943,141.84135484695435,67.91699361801147,283.6195640563965,8867,941,7926,7926,0,10,1065000.0
1065,1065999,21.554172807300933,37.68799865093528,0.06506796754911692,142.02008032798767,67.98247814178467,284.0819091796875,8905,944,7961,7961,0,10,1066000.0
1066,1066999,21.555960405656165,37.703197981241935,0.06500626751532357,142.16694283485413,68.04800271987915,284.35676193237305,8907,945,7962,7962,0,10,1067000.0
1067,1067999,21.558227775449136,37.7227521146973,0.0648945813245616,142.31168246269226,68.11360478401184,284.5749092102051,8910,946,7964,7964,0,10,1068000.0
1068,1068999,21.55992621872006,37.728245786242695,0.06478580171353565,142.48259854316711,68.17838859558105,284.72351837158203,8918,948,7970,7970,0,10,1069000.0
1069,1069999,21.566862235546097,37.753803056024005,0.06464514612747152,142.6224536895752,68.24306392669678,284.865291595459,8949,949,8000,8000,0,10,1070000.0
1070,1070999,21.572161977625168,37.77178590085311,0.06447934044593384,142.78337454795837,68.3097665309906,285.1898193359375,8983,951,8032,8032,0,10,1071000.0
1071,1071999,21.576769205153827,37.78446816886618,0.0643874328715297,142.93053936958313,68.37517738342285,285.33448791503906,8985,952,8033,8033,0,10,1072000.0
1072,1072999,21.582376033587664,37.79478112262777,0.06434519369808389,143.08766293525696,68.44133949279785,285.5218963623047,8996,953,8043,8043,0,10,1073000.0
1073,1073999,21.59158261632203,37.823035895872465,0.06427216630818966,143.23344349861145,68.50615692138672,285.76496505737305,8998,954,8044,8044,0,10,1074000.0
1074,1074999,21.60369349303815,37.86646985807006,0.06426080900853226,143.39740705490112,68.5716621875763,285.8297576904297,9006,956,8050,8050,0,10,1075000.0
1075,1075999,21.615078187854046,37.88496045494962,0.0642587900477154,143.52517223358154,68.63764786720276,286.1433753967285,9009,956,8053,8053,0,10,1076000.0
1076,1076999,21.630534970353157,37.91374319181426,0.06428359693225527,143.68843030929565,68.70437097549438,286.35247802734375,9018,958,8060,8060,0,10,1077000.0
1077,1077999,21.645151618647763,37.94316723303414,0.06452570074124953,143.8115050792694,68.76972103118896,286.5220642089844,9018,958,8060,8060,0,10,1078000.0
1078,1078999,21.662047398157885,37.98917005141743,0.06454107523020214,143.92661666870117,68.8337652683258,286.92822265625,9020,958,8062,8062,0,10,1079000.0
1079,1079999,21.679477142199985,38.029707052907014,0.06475004981672661,144.03914141654968,68.89847350120544,287.0629119873047,9020,958,8062,8062,0,10,1080000.0
1080,1080999,21.700095197324533,38.07903202486992,0.0649717730302718,144.17968893051147,68.96365785598755,287.31175231933594,9032,959,8073,8073,0,10,1081000.0
1081,1081999,21.720024313827263,38.14137434029594,0.06517523090917898,144.32066679000854,69.02812051773071,287.5652961730957,9037,960,8077,8077,0,10,1082000.0
1082,1082999,21.72356129183866,38.1520136159179,0.06516083889874613,144.46005153656006,69.09248733520508,288.1789741516113,9044,961,8083,8083,0,10,1083000.0
1083,1083999,21.721233901450255,38.15339505462957,0.06512364779715396,144.57494044303894,69.15717220306396,288.5636215209961,9045,961,8084,8084,0,10,1084000.0
1084,1084999,21.72092219935327,38.16731027491059,0.06504830953401952,144.7010099887848,69.22248125076294,288.7837905883789,9045,961,8084,8084,0,10,1085000.0
1085,1085999,21.720357166365016,38.172299839670536,0.06501901690012613,144.82979607582092,69.28763580322266,288.91280364990234,9045,961,8084,8084,0,10,1086000.0
1086,1086999,21.72042150647836,38.173519969087735,0.0650065837827778,144.9739420413971,69.35266351699829,289.16799545288086,9048,962,8086,8086,0,10,1087000.0
1087,1087999,21.722602013230972,38.19481985991395,0.06488817318434481,145.12244844436646,69.41832947731018,289.54501724243164,9060,963,8097,8097,0,10,1088000.0
1088,1088999,21.725624817902162,38.199796321883646,0.06490885297011462,145.2448902130127,69.48261213302612,289.7716827392578,9061,963,8098,8098,0,10,1089000.0
1089,1089999,21.728143269001436,38.20385874282626,0.06488332081350112,145.3619887828827,69.54722476005554,290.06490325927734,9061,963,8098,8098,0,10,1090000.0
1090,1090999,21.732743431526817,38.21362311818097,0.06489949412441509,145.47716641426086,69.61181235313416,290.2150535583496,9061,963,8098,8098,0,10,1091000.0
1091,1091999,21.73899239742289,38.225377868905895,0.06499769612993911,145.62770104408264,69.67710661888123,290.3103141784668,9067,964,8103,8103,0,10,1092000.0
1092,1092999,21.747830174595776,38.23536140689516,0.06510140153834132,145.75081038475037,69.74178695678711,290.70329666137695,9070,964,8106,8106,0,10,1093000.0
1093,1093999,21.75535903955167,38.24652082063689,0.06529343680088118,145.8920862674713,69.80673217773438,290.85497665405273,9072,965,8107,8107,0,10,1094000.0
1094,1094999,21.76295430035535,38.25414509202074,0.0654720020977756,146.0729444026947,69.87237358093262,290.9422416687012,9078,967,8111,8111,0,10,1095000.0
1095,1095999,21.772539658247627,38.27951830500854,0.06568483620580967,146.1865255832672,69.93812394142151,291.2306900024414,9079,967,8112,8112,0,10,1096000.0
1096,1096999,21.78325937728406,38.295806099998686,0.06590953562081303,146.34526228904724,70.00278067588806,291.3443794250488,9083,969,8114,8114,0,10,1097000.0
1097,1097999,21.792316815605332,38.30671718303085,0.06610079334892804,146.48838877677917,70.06744241714478,291.45777893066406,9089,970,8119,8119,0,10,1098000.0
1098,1098999,21.80130080303803,38.31701209388447,0.0661778912385218,146.64793181419373,70.13258266448975,291.77874755859375,9125,972,8153,8153,0,10,1099000.0
1099,1099999,21.810460582529533,38.32629208877309,0.0663299345447691,146.7626051902771,70.1970272064209,291.9183654785156,9125,972,8153,8153,0,10,1100000.0
1100,1100999,21.816785220194568,38.330984311319185,0.06644686093530727,146.92485427856445,70.26150631904602,292.0707817077637,9159,974,8185,8185,0,10,1101000.0
1101,1101999,21.82231937040683,38.33462975737439,0.0664494816283192,147.08522987365723,70.32536458969116,292.0824661254883,9164,976,8188,8188,0,10,1102000.0
1102,1102999,21.81992296793718,38.33140071388101,0.06642418486047963,147.20535135269165,70.39038825035095,292.6854553222656,9171,976,8195,8195,0,10,1103000.0
1103,1103999,21.814930055066394,38.3286648604871,0.06643703462309081,147.32622957229614,70.45467567443848,293.08739471435547,9172,976,8196,8196,0,10,1104000.0
1104,1104999,21.809712552845625,38.321506250039455,0.06643095643164088,147.48736786842346,70.5211091041565,293.27050399780273,9178,978,8200,8200,0,10,1105000.0
1105,1105999,21.805614086457,38.31638311026068,0.06652981294584792,147.6540880203247,70.58645534515381,293.383975982666,9185,980,8205,8205,0,10,1106000.0
1106,1106999,21.80379189143514,38.314463821946205,0.0665836234032755,147.8352644443512,70.65175724029541,293.61016845703125,9204,983,8221,8221,0,10,1107000.0
1107,1107999,21.800871446834844,38.30871104592784,0.0666536270323076,148.04657363891602,70.71767044067383,293.6684036254883,9217,987,8230,8230,0,10,1108000.0
1108,1108999,21.798969169244955,38.30535295626127,0.06665710661594881,148.19135403633118,70.78209972381592,293.82752990722656,9220,988,8232,8232,0,10,1109000.0
1109,1109999,21.796114666897527,38.29892653574713,0.06668984740523887,148.31575870513916,70.84666180610657,294.14109802246094,9220,988,8232,8232,0,10,1110000.0
1110,1110999,21.792216457137705,38.290733335492305,0.0667008966422945,148.5000445842743,70.91148734092712,294.184326171875,9235,991,8244,8244,0,10,1111000.0
1111,1111999,21.790274721867306,38.285416569882806,0.06674030368704587,148.62731623649597,70.97647261619568,294.4207420349121,9235,991,8244,8244,0,10,1112000.0
1112,1112999,21.790521001399867,38.28413778265553,0.0667655655608963,148.81179308891296,71.04184460639954,294.6178092956543,9251,994,8257,8257,0,10,1113000.0
1113,1113999,21.787696318298703,38.27738975480651,0.06676618587326832,148.92861461639404,71.10668540000916,294.8465881347656,9251,994,8257,8257,0,10,1114000.0
1114,1114999,21.787645183494185,38.277013985978684,0.0667657590387053,149.08907103538513,71.17167925834656,294.9282341003418,9261,996,8265,8265,0,10,1115000.0
1115,1115999,21.78591223175767,38.27015680731052,0.06673130539082839,150.09253692626953,71.23808288574219,295.151611328125,9269,997,8272,8272,0,10,1116000.0
1116,1116999,21.78485376641314,38.266693784065374,0.06670115416283873,150.26015830039978,71.30393958091736,295.2916145324707,9277,999,8278,8278,0,10,1117000.0
1117,1117999,21.782940583068445,38.25935476901706,0.066695118013122,150.42149448394775,71.37032055854797,295.41121673583984,9289,1001,8288,8288,0,10,1118000.0
1118,1118999,21.78094615142256,38.25235586007278,0.06667375612650406,150.56861114501953,71.43596291542053,295.8998603820801,9309,1002,8307,8307,0,10,1119000.0
1119,1119999,21.777321037286804,38.24480264251756,0.06664671055071436,150.6907742023468,71.50273156166077,296.1918487548828,9309,1002,8307,8307,0,10,1120000.0
1120,1120999,21.77449181077478,38.23770733641358,0.06664846527265544,150.82168793678284,71.5671615600586,296.3717460632324,9309,1002,8307,8307,0,10,1121000.0
1121,1121999,21.770207904296548,38.22807471949112,0.06662887212814395,150.9653401374817,71.6320219039917,296.69690704345703,9316,1003,8313,8313,0,10,1122000.0
1122,1122999,21.766617622438392,38.219150916154256,0.06664085113355189,151.11296606063843,71.69663500785828,297.1056213378906,9325,1004,8321,8321,0,10,1123000.0
1123,1123999,21.761134679276147,38.21556330747838,0.06667994594332483,151.26135420799255,71.76150727272034,297.39490127563477,9327,1005,8322,8322,0,10,1124000.0
1124,1124999,21.753668614861656,38.20825340309094,0.06671358120508863,151.38414883613586,71.82772946357727,297.8243179321289,9328,1005,8323,8323,0,10,1125000.0
1125,1125999,21.7476442231008,38.2010796426596,0.06674094092008875,151.59607529640198,71.89374136924744,297.9217872619629,9339,1009,8330,8330,0,10,1126000.0
1126,1126999,21.742079377007023,38.19558699423548,0.06673472467369979,151.81069707870483,71.95975971221924,298.07212829589844,9347,1013,8334,8334,0,10,1127000.0
1127,1127999,21.73594546992757,38.18560307057237,0.06674318631778786,151.95765733718872,72.0280876159668,298.3795471191406,9350,1014,8336,8336,0,10,1128000.0
1128,1128999,21.73092791226498,38.17545391489406,0.06674092758328787,152.08917665481567,72.09293508529663,298.51606369018555,9350,1014,8336,8336,0,10,1129000.0
1129,1129999,21.726026962322194,38.167475051677954,0.06673979711628775,152.237690448761,72.15810108184814,298.58134841918945,9353,1015,8338,8338,0,10,1130000.0
1130,1130999,21.7219125886725,38.16417430310497,0.06671143698895343,152.36896133422852,72.22393584251404,298.8876152038574,9353,1015,8338,8338,0,10,1131000.0
1131,1131999,21.716492181163055,38.15439779066782,0.06670855380038532,152.51030206680298,72.29114723205566,298.97339248657227,9355,1016,8339,8339,0,10,1132000.0
1132,1132999,21.711750536750152,38.1450251856619,0.0667047248095205,152.6649580001831,72.35804629325867,299.11368560791016,9357,1017,8340,8340,0,10,1133000.0
1133,1133999,21.70850831584559,38.137104814257235,0.06667372342355515,152.83226227760315,72.42412495613098,299.45155334472656,9375,1019,8356,8356,0,10,1134000.0
1134,1134999,21.70533644294621,38.12938990736607,0.06662918892933867,152.9867434501648,72.48985147476196,299.6361541748047,9377,1020,8357,8357,0,10,1135000.0
1135,1135999,21.702467532070294,38.123869057033495,0.06662315411329489,153.10936641693115,72.55508756637573,299.76219940185547,9377,1020,8357,8357,0,10,1136000.0
1136,1136999,21.699892450075147,38.11945853648099,0.06659433831113393,153.29485440254211,72.62041521072388,299.979549407959,9397,1023,8374,8374,0,10,1137000.0
1137,1137999,21.69642045173062,38.10982327533756,0.06655573955029748,153.47814655303955,72.68622875213623,300.002685546875,9412,1026,8386,8386,0,10,1138000.0
1138,1138999,21.695172719264722,38.106144800219234,0.06654605738509489,153.66189980506897,72.75174260139465,300.259033203125,9443,1029,8414,8414,0,10,1139000.0
1139,1139999,21.69395656299724,38.099377889837704,0.066506774019371,153.7982976436615,72.81650519371033,300.62109375,9446,1030,8416,8416,0,10,1140000.0
1140,1140999,21.69394422506491,38.0950011439635,0.06646957583517199,153.9342703819275,72.8810248374939,300.7445526123047,9450,1031,8419,8419,0,10,1141000.0
1141,1141999,21.692278141011727,38.08781489639112,0.0664775965908262,154.1025927066803,72.94584608078003,300.8960380554199,9455,1033,8422,8422,0,10,1142000.0
1142,1142999,21.690503188348575,38.081068807121575,0.06647489958922426,154.22128009796143,73.01040959358215,301.0868682861328,9455,1033,8422,8422,0,10,1143000.0
1143,1143999,21.69017087901643,38.083681318752625,0.06644524054557255,154.34846425056458,73.07589530944824,301.4964141845703,9456,1033,8423,8423,0,10,1144000.0
1144,1144999,21.688484562712233,38.08504376732829,0.06649175857083012,154.5060076713562,73.14164757728577,301.7812728881836,9489,1035,8454,8454,0,10,1145000.0
1145,1145999,21.68662622631688,38.083500105357246,0.06657663031301342,154.6971206665039,73.20806455612183,301.9642333984375,9498,1038,8460,8460,0,10,1146000.0
1146,1146999,21.688185155322795,38.09184059924074,0.06660657237967571,154.86498403549194,73.27367281913757,302.0111961364746,9502,1040,8462,8462,0,10,1147000.0
1147,1147999,21.68817747608344,38.09600139984559,0.06662940691210217,154.9887011051178,73.33920812606812,302.2138671875,9502,1040,8462,8462,0,10,1148000.0
1148,1148999,21.692674209611255,38.105423925152195,0.06661905333566476,155.18877863883972,73.40605235099792,302.48687744140625,9541,1043,8498,8498,0,10,1149000.0
1149,1149999,21.700122423267633,38.11870381867402,0.06670718751731419,155.33875632286072,73.47274231910706,302.85666275024414,9550,1044,8506,8506,0,10,1150000.0
1150,1150999,21.708923041974966,38.141810519253575,0.06675048883074475,155.46112895011902,73.53888988494873,303.3972625732422,9550,1044,8506,8506,0,10,1151000.0
1151,1151999,21.71581681059695,38.15208254113318,0.06677367424497505,155.578843832016,73.60461688041687,303.6347007751465,9551,1044,8507,8507,0,10,1152000.0
1152,1152999,21.72569970576017,38.1754359752503,0.06688973452819846,155.78588581085205,73.67124938964844,303.5726623535156,9561,1048,8513,8513,0,10,1153000.0
1153,1153999,21.738499224112946,38.20046057585269,0.06708627179145421,155.91830825805664,73.73771476745605,303.84339904785156,9561,1048,8513,8513,0,10,1154000.0
1154,1154999,21.748706622504734,38.218933169348155,0.06726081880165835,156.065842628479,73.8031063079834,303.91852951049805,9563,1049,8514,8514,0,10,1155000.0
1155,1155999,21.75755845219277,38.23280339535531,0.0674164858208065,156.2018551826477,73.86831092834473,304.00580978393555,9563,1049,8514,8514,0,10,1156000.0
1156,1156999,21.76918216373453,38.250918044873536,0.06756764384121827,156.37455224990845,73.93368768692017,304.2040023803711,9574,1051,8523,8523,0,10,1157000.0
1157,1157999,21.783122824648927,38.28060785688761,0.06794022805327382,156.52066040039062,73.99960255622864,304.4236145019531,9576,1052,8524,8524,0,10,1158000.0
1158,1158999,21.797538064957042,38.31090115882036,0.06825773031621152,156.66544008255005,74.06520318984985,304.7573432922363,9587,1053,8534,8534,0,10,1159000.0
1159,1159999,21.813381022827777,38.34119088939604,0.06860271223093362,156.7799587249756,74.1296603679657,305.0321617126465,9587,1053,8534,8534,0,10,1160000.0
1160,1160999,21.826616397135105,38.35971290844563,0.06897487134749625,156.91517424583435,74.19421601295471,305.10400009155273,9590,1054,8536,8536,0,10,1161000.0
1161,1161999,21.840259639213645,38.37797174303349,0.06946205884057977,157.08548188209534,74.25937175750732,305.2628059387207,9623,1056,8567,8567,0,10,1162000.0
1162,1162999,21.8518724216066,38.39642739601724,0.0698123538919323,157.22272753715515,74.32341742515564,305.3791694641113,9625,1057,8568,8568,0,10,1163000.0
1163,1163999,21.85192496032424,38.40274080263687,0.06980729483274106,157.3392732143402,74.38723683357239,305.7534713745117,9625,1057,8568,8568,0,10,1164000.0
1164,1164999,21.851524973484576,38.4097390176191,0.06974735166384483,157.50183606147766,74.45233821868896,305.9362983703613,9630,1059,8571,8571,0,10,1165000.0
1165,1165999,21.852229920617532,38.41338435255637,0.06975165875255529,157.62796711921692,74.51821851730347,306.23088455200195,9630,1059,8571,8571,0,10,1166000.0
1166,1166999,21.85402190489881,38.419599431706295,0.0697670586190865,157.7917401790619,74.58455181121826,306.3344955444336,9635,1061,8574,8574,0,10,1167000.0
1167,1167999,21.856321772147645,38.438788339851996,0.0696808293971325,157.90949726104736,74.64933109283447,306.6615982055664,9636,1061,8575,8575,0,10,1168000.0
1168,1168999,21.858711636624317,38.44130271614561,0.06968959130284946,158.06471180915833,74.71329522132874,306.75299072265625,9640,1062,8578,8578,0,10,1169000.0
1169,1169999,21.86399117823978,38.45141464115001,0.06970177311666925,158.20844984054565,74.77772164344788,306.8918266296387,9671,1063,8608,8608,0,10,1170000.0
1170,1170999,21.869498222759642,38.46171867604968,0.06971227510690692,158.3681583404541,74.84283685684204,307.0984687805176,9678,1065,8613,8613,0,10,1171000.0
1171,1171999,21.873483060571953,38.468460793368706,0.06975737810496185,158.51520895957947,74.90793704986572,307.2431983947754,9681,1066,8615,8615,0,10,1172000.0
1172,1172999,21.881790331037404,38.48749001480088,0.06987653855527565,158.66141939163208,74.9732460975647,307.37403869628906,9683,1067,8616,8616,0,10,1173000.0
1173,1173999,21.893754581323662,38.5121028825402,0.0700520161255751,158.81088042259216,75.03839635848999,307.63543701171875,9691,1068,8623,8623,0,10,1174000.0
1174,1174999,21.901689069065927,38.525368210080906,0.07019969794909708,158.92627096176147,75.10390448570251,307.78173446655273,9691,1068,8623,8623,0,10,1175000.0
1175,1175999,21.911653469070018,38.54469161824942,0.07041585121187832,159.1014015674591,75.16938352584839,307.8133087158203,9701,1070,8631,8631,0,10,1176000.0
1176,1176999,21.921990676421732,38.564467752806486,0.07059428315278582,159.29435849189758,75.23518013954163,307.9000473022461,9713,1073,8640,8640,0,10,1177000.0
1177,1177999,21.935790915833696,38.5952588519333,0.07085152922723703,159.45277953147888,75.3001139163971,308.21639251708984,9749,1075,8674,8674,0,10,1178000.0
1178,1178999,21.945433320845897,38.6082188426771,0.07094460681452686,159.62029600143433,75.36695837974548,308.6150932312012,9762,1077,8685,8685,0,10,1179000.0
1179,1179999,21.955789299573702,38.62932180748069,0.07114574951174413,159.78706097602844,75.43105792999268,308.66584396362305,9768,1079,8689,8689,0,10,1180000.0
1180,1180999,21.969189161859404,38.65171990773356,0.07143231988213927,159.90233731269836,75.495361328125,308.783260345459,9768,1079,8689,8689,0,10,1181000.0
1181,1181999,21.97873416810099,38.66222544986943,0.07163307890894532,160.06374216079712,75.56076145172119,308.8811798095703,9772,1081,8691,8691,0,10,1182000.0
1182,1182999,21.984836076757897,38.670671966149364,0.07171278060365915,160.17757749557495,75.62446212768555,308.97546768188477,9772,1081,8691,8691,0,10,1183000.0
1183,1183999,21.98393428083073,38.674319627179514,0.07165513397182732,160.34413695335388,75.6889808177948,309.5538787841797,9785,1083,8702,8702,0,10,1184000.0
1184,1184999,21.98222894709866,38.67207474605106,0.07166788128819945,160.49138569831848,75.75502419471741,309.9567527770996,9793,1084,8709,8709,0,10,1185000.0
1185,1185999,21.980287746014046,38.67121140945859,0.07167648965867846,160.61267828941345,75.82057738304138,310.1305465698242,9794,1084,8710,8710,0,10,1186000.0
1186,1186999,21.978841066117205,38.66899901814944,0.07167054713115661,160.81562614440918,75.88694071769714,310.21643447875977,9802,1087,8715,8715,0,10,1187000.0
1187,1187999,21.976949943085007,38.66446728317161,0.07167975182706277,160.96290636062622,75.95238137245178,310.4118194580078,9808,1088,8720,8720,0,10,1188000.0
1188,1188999,21.974926192362723,38.658624985301586,0.07167286983941135,161.07676529884338,76.01663398742676,310.6046257019043,9809,1088,8721,8721,0,10,1189000.0
1189,1189999,21.97351767642288,38.65530925131577,0.07164899975662242,161.2245478630066,76.08177328109741,310.8353500366211,9811,1089,8722,8722,0,10,1190000.0
1190,1190999,21.97300583201449,38.653492049761965,0.07162965504899366,161.37638878822327,76.14690852165222,311.1037406921387,9822,1090,8732,8732,0,10,1191000.0
1191,1191999,21.972860276206823,38.65903697466855,0.07160448544146236,161.5228066444397,76.21192359924316,311.2889976501465,9829,1091,8738,8738,0,10,1192000.0
1192,1192999,21.972348602396373,38.654175799048836,0.07159896746442695,161.6461946964264,76.27673864364624,311.6722183227539,9829,1091,8738,8738,0,10,1193000.0
1193,1193999,21.971849070059847,38.6497540410252,0.07160495486475604,161.79015731811523,76.34157395362854,311.9617805480957,9834,1092,8742,8742,0,10,1194000.0
1194,1194999,21.971568465002193,38.64556794664079,0.07160468593764246,161.9345531463623,76.40643787384033,312.0608215332031,9840,1093,8747,8747,0,10,1195000.0
1195,1195999,21.97073656914382,38.63963746761601,0.07162765310419872,162.07964825630188,76.47138500213623,312.1721534729004,9846,1094,8752,8752,0,10,1196000.0
1196,1196999,21.971724429922034,38.63612357083299,0.07162408401567466,162.24697017669678,76.53638052940369,312.2132568359375,9853,1096,8757,8757,0,10,1197000.0
1197,1197999,21.971330403884863,38.629748100951396,0.07160930927524234,162.43464994430542,76.60243797302246,312.3730049133301,9888,1099,8789,8789,0,10,1198000.0
1198,1198999,21.970425012557783,38.62375219138645,0.07162882789477787,162.63673210144043,76.66709113121033,312.4362030029297,9909,1103,8806,8806,0,10,1199000.0
1199,1199999,21.970532453243884,38.61978620837927,0.07160877399290688,162.77332997322083,76.73122429847717,312.67759704589844,9916,1104,8812,8812,0,10,1200000.0
1200,1200999,21.9666648294315,38.619196455668856,0.07158677064433172,162.89646744728088,76.79511833190918,313.0488586425781,9916,1104,8812,8812,0,10,1201000.0
1201,1201999,21.962855888768225,38.62484468367969,0.07158597761672059,163.01733994483948,76.85984110832214,313.36915588378906,9916,1104,8812,8812,0,10,1202000.0
1202,1202999,21.959197519699742,38.62088163935941,0.07157754440020381,163.16030740737915,76.92520380020142,313.5796127319336,9948,1105,8843,8843,0,10,1203000.0
1203,1203999,21.954109290452863,38.61222477995182,0.07160882020744552,163.31005549430847,76.99046468734741,313.6524963378906,9950,1106,8844,8844,0,10,1204000.0
1204,1204999,21.949536452455668,38.60708833495963,0.07163526876413895,163.48200511932373,77.05622005462646,313.76441192626953,9961,1108,8853,8853,0,10,1205000.0
1205,1205999,21.94601552195131,38.60078694219065,0.07161607291784133,163.6136839389801,77.12058901786804,313.86401748657227,9961,1108,8853,8853,0,10,1206000.0
1206,1206999,21.941152029833376,38.591931619287244,0.0716258161198301,163.74039220809937,77.18492722511292,314.0654525756836,9961,1108,8853,8853,0,10,1207000.0
1207,1207999,21.936727647461677,38.581878608910465,0.07162062431987837,163.8781316280365,77.24957489967346,314.17163848876953,9964,1109,8855,8855,0,10,1208000.0
1208,1208999,21.932934383880777,38.572806868692,0.0716154093870528,164.01023054122925,77.31380105018616,314.2475891113281,9964,1109,8855,8855,0,10,1209000.0
1209,1209999,21.928760258571803,38.56325114865205,0.07159767536752049,164.13850164413452,77.37836027145386,314.3184623718262,9964,1109,8855,8855,0,10,1210000.0
1210,1210999,21.925460359186594,38.55506690690332,0.07157052879825121,164.28768062591553,77.4436457157135,314.4244384765625,9966,1110,8856,8856,0,10,1211000.0
1211,1211999,21.922111651572393,38.547401550571564,0.0715737957526773,164.4550495147705,77.50873875617981,314.4166374206543,9976,1112,8864,8864,0,10,1212000.0
1212,1212999,21.91981724641769,38.54194188039241,0.0715495559325704,164.60991311073303,77.57470393180847,314.4679641723633,9980,1113,8867,8867,0,10,1213000.0
1213,1213999,21.91830337166202,38.537778389321105,0.07151944557897583,164.74048900604248,77.63984251022339,314.7391014099121,9980,1113,8867,8867,0,10,1214000.0
1214,1214999,21.9174963816612,38.53313867911095,0.07149863915872667,164.86474204063416,77.70459055900574,314.8284912109375,9980,1113,8867,8867,0,10,1215000.0
1215,1215999,21.91623696347979,38.52728264180013,0.07148806219884196,164.99492383003235,77.76945042610168,314.9341049194336,9980,1113,8867,8867,0,10,1216000.0
1216,1216999,21.916616669079204,38.52375300810134,0.071461249840168,165.13981938362122,77.83425068855286,315.06177520751953,9983,1114,8869,8869,0,10,1217000.0
1217,1217999,21.915633523972563,38.517952558571295,0.07144678285449046,165.27512049674988,77.89840245246887,315.1071662902832,9993,1115,8878,8878,0,10,1218000.0
1218,1218999,21.91474700429625,38.511962248560835,0.07145214870556138,165.39933919906616,77.9630196094513,315.29608154296875,9994,1115,8879,8879,0,10,1219000.0
1219,1219999,21.914341290988745,38.506786032736834,0.071428637818584,165.54915404319763,78.0269296169281,315.4330291748047,9996,1116,8880,8880,0,10,1220000.0
1220,1220999,21.911208346685655,38.50390926205777,0.07140395162417057,165.6928927898407,78.09130549430847,315.7262382507324,9998,1117,8881,8881,0,10,1221000.0
1221,1221999,21.90538358100571,38.4956672936463,0.07141870393050764,165.81231141090393,78.1568615436554,316.0218391418457,9998,1117,8881,8881,0,10,1222000.0
1222,1222999,21.90035265140793,38.48899225410535,0.07141983561756748,165.93812775611877,78.22229957580566,316.2324409484863,9998,1117,8881,8881,0,10,1223000.0
1223,1223999,21.895124618373668,38.47920590676915,0.07142734637243786,166.08878469467163,78.28794813156128,316.36312103271484,10004,1118,8886,8886,0,10,1224000.0
1224,1224999,21.88988753248611,38.47000719487657,0.07143355614701952,166.2408151626587,78.3537106513977,316.46218490600586,10007,1119,8888,8888,0,10,1225000.0
1225,1225999,21.88685836362805,38.46101522071522,0.0713944412398615,166.39202618598938,78.41815972328186,316.57990646362305,10013,1120,8893,8893,0,10,1226000.0
1226,1226999,21.885131011925754,38.454372157454166,0.07134989872174191,166.54097867012024,78.48271799087524,316.63742446899414,10020,1121,8899,8899,0,10,1227000.0
1227,1227999,21.882802356044156,38.44567792888288,0.0713022554934879,166.69310688972473,78.54835033416748,316.8497200012207,10024,1122,8902,8902,0,10,1228000.0
1228,1228999,21.881631090881896,38.44148016089641,0.07124501580580278,166.86926078796387,78.61387205123901,317.1895980834961,10064,1124,8940,8940,0,10,1229000.0
1229,1229999,21.880488051533792,38.4334044650691,0.07119361764045518,167.02480840682983,78.67898178100586,317.4180107116699,10071,1125,8946,8946,0,10,1230000.0
1230,1230999,21.881437165693583,38.43052666263151,0.0711702818684572,167.15757870674133,78.74363422393799,317.5810012817383,10071,1125,8946,8946,0,10,1231000.0
1231,1231999,21.88290625381644,38.42834845399,0.07115169550459821,167.27343153953552,78.80828642845154,317.7420425415039,10071,1125,8946,8946,0,10,1232000.0
1232,1232999,21.882281559347522,38.422352745354985,0.07118454373973848,167.4037685394287,78.87319588661194,317.81438064575195,10071,1125,8946,8946,0,10,1233000.0
1233,1233999,21.882277246092226,38.41873560621139,0.07116211406502226,167.55567955970764,78.93822121620178,317.8071823120117,10074,1126,8948,8948,0,10,1234000.0
1234,1234999,21.883347313667993,38.41716626024238,0.07115356518816651,167.6757287979126,79.00346851348877,318.02220916748047,10074,1126,8948,8948,0,10,1235000.0
1235,1235999,21.8859732054669,38.417634702465215,0.07118092734432824,167.8401460647583,79.06996989250183,318.07386779785156,10106,1128,8978,8978,0,10,1236000.0
1236,1236999,21.887414577350583,38.415362351807666,0.07119005907061271,167.9720902442932,79.13585329055786,318.23714447021484,10106,1128,8978,8978,0,10,1237000.0
1237,1237999,21.89030868338497,38.41242701675907,0.07119233444314399,168.11568212509155,79.20078992843628,318.3792266845703,10108,1129,8979,8979,0,10,1238000.0
1238,1238999,21.89243904345063,38.40995125945773,0.07126215104947475,168.26067924499512,79.26528549194336,318.4307556152344,10112,1130,8982,8982,0,10,1239000.0
1239,1239999,21.893517208786143,38.40601181584873,0.07131485584628583,168.42994475364685,79.32956743240356,318.55280685424805,10121,1132,8989,8989,0,10,1240000.0
1240,1240999,21.894901143826424,38.408187691466054,0.07134047179634762,168.5738868713379,79.39487862586975,318.65110778808594,10128,1133,8995,8995,0,10,1241000.0
1241,1241999,21.890618795874094,38.40005268173405,0.07134829920601282,168.70614790916443,79.45895195007324,319.08453369140625,10130,1133,8997,8997,0,10,1242000.0
1242,1242999,21.884506645423475,38.39122071148223,0.07139071901313232,168.83129358291626,79.52336287498474,319.38747787475586,10130,1133,8997,8997,0,10,1243000.0
1243,1243999,21.878997132569978,38.38170486713518,0.07140825630227143,168.95006895065308,79.58818817138672,319.58836364746094,10131,1133,8998,8998,0,10,1244000.0
1244,1244999,21.87424706880094,38.3733976593977,0.07141382762607351,169.09706854820251,79.65325593948364,319.6950340270996,10134,1134,9000,9000,0,10,1245000.0
1245,1245999,21.869588725035744,38.363769089965544,0.07142142833033349,169.22161602973938,79.71918106079102,319.8224067687988,10134,1134,9000,9000,0,10,1246000.0
1246,1246999,21.86569338338428,38.35545940075007,0.07140303494531697,169.36039304733276,79.78389596939087,319.9700584411621,10134,1134,9000,9000,0,10,1247000.0
1247,1247999,21.86247118658328,38.347539325990056,0.07138944813342607,169.4815320968628,79.84794688224792,320.07194900512695,10134,1134,9000,9000,0,10,1248000.0
1248,1248999,21.8598595358343,38.34011631391711,0.0713582349594466,169.62431001663208,79.91283226013184,320.3356170654297,10138,1135,9003,9003,0,10,1249000.0
1249,1249999,21.856816096563758,38.33183229718862,0.0713563909684084,169.7506079673767,79.97764205932617,320.54018783569336,10138,1135,9003,9003,0,10,1250000.0
1250,1250999,21.855029653749057,38.32745415647588,0.07132660699017324,169.87339425086975,80.04210066795349,320.6546821594238,10138,1135,9003,9003,0,10,1251000.0
1251,1251999,21.853747437906264,38.320964921058206,0.07130253045221457,170.06143426895142,80.10724902153015,320.78369140625,10142,1137,9005,9005,0,10,1252000.0
1252,1252999,21.854167513607074,38.3197983390919,0.0710686333151187,170.2433784008026,80.17241787910461,320.86889266967773,10150,1140,9010,9010,0,10,1253000.0
1253,1253999,21.852682035951158,38.31549246952919,0.07101415278125678,170.35479187965393,80.23695111274719,321.0229034423828,10150,1140,9010,9010,0,10,1254000.0
1254,1254999,21.85160226202551,38.31009815504586,0.07097635776426514,170.49137616157532,80.30294966697693,321.1923713684082,10150,1140,9010,9010,0,10,1255000.0
1255,1255999,21.85334290851085,38.30811126357481,0.07087423926676273,170.6351022720337,80.36821937561035,321.3308334350586,10154,1141,9013,9013,0,10,1256000.0
1256,1256999,21.854440691613405,38.317468045150385,0.07078367848250566,170.78645300865173,80.43385004997253,321.41596603393555,10156,1142,9014,9014,0,10,1257000.0
1257,1257999,21.855433195879847,38.31365051552082,0.07074459421342882,170.9298803806305,80.49915289878845,321.6658630371094,10168,1143,9025,9025,0,11,1258000.0
1258,1258999,21.855885457409936,38.30953512809892,0.07072897130215883,171.0434877872467,80.56302523612976,321.79773712158203,10168,1143,9025,9025,0,11,1259000.0
1259,1259999,21.855691559958487,38.30464605636978,0.0707278655219935,171.15604901313782,80.6268093585968,321.90938568115234,10168,1143,9025,9025,0,11,1260000.0
1260,1260999,21.855601734448655,38.29940345500788,0.07070677500875477,171.29947233200073,80.6913251876831,322.13410568237305,10170,1144,9026,9026,0,11,1261000.0
1261,1261999,21.85367266251712,38.29257761678575,0.07070825196114516,171.41104698181152,80.75537633895874,322.4238090515137,10170,1144,9026,9026,0,11,1262000.0
1262,1262999,21.849139495451816,38.284958135370644,0.0707338174469444,171.57726740837097,80.82049465179443,322.6554870605469,10206,1146,9060,9060,0,11,1263000.0
1263,1263999,21.845302892839225,38.277407649191424,0.07077482334311669,171.73048067092896,80.88645601272583,322.9204864501953,10209,1147,9062,9062,0,11,1264000.0
1264,1264999,21.842562292483603,38.270722081427884,0.07080934883231549,171.88879561424255,80.95300555229187,323.07975006103516,10211,1148,9063,9063,0,11,1265000.0
1265,1265999,21.84220933811197,38.26914819720243,0.07086056353561798,172.01797127723694,81.01937818527222,323.2300491333008,10211,1148,9063,9063,0,11,1266000.0
1266,1266999,21.844583729522988,38.27132428150275,0.07084389044501882,172.16770267486572,81.08493614196777,323.4253578186035,10215,1149,9066,9066,0,11,1267000.0
1267,1267999,21.847324038939202,38.27389759974124,0.07078593841364655,172.31896495819092,81.15084314346313,323.5308074951172,10222,1150,9072,9072,0,11,1268000.0
1268,1268999,21.85060793532086,38.276824155095156,0.07072288729788623,172.46318697929382,81.21602010726929,323.6521339416504,10224,1151,9073,9073,0,11,1269000.0
1269,1269999,21.853373846386173,38.280401654644564,0.07065132747089609,172.59188532829285,81.2811291217804,323.89810943603516,10225,1151,9074,9074,0,11,1270000.0
1270,1270999,21.85597163234808,38.283440945866374,0.07061210066969381,172.73955702781677,81.34593319892883,323.95452880859375,10227,1152,9075,9075,0,11,1271000.0
1271,1271999,21.86041075947157,38.28809029916799,0.07056858629370033,172.92046904563904,81.41153335571289,324.05456161499023,10238,1154,9084,9084,0,11,1272000.0
1272,1272999,21.864635682067334,38.29364490177166,0.0705160040883892,173.0700957775116,81.47676110267639,324.36621475219727,10240,1155,9085,9085,0,11,1273000.0
1273,1273999,21.867940253862432,38.295775754243,0.07048041773649694,173.25930285453796,81.54229140281677,324.4304313659668,10250,1158,9092,9092,0,11,1274000.0
1274,1274999,21.87171516825984,38.29741691586873,0.07049080957821996,173.38570141792297,81.60702967643738,324.56210708618164,10250,1158,9092,9092,0,11,1275000.0
1275,1275999,21.87545002690035,38.30062862663381,0.07048300840269095,173.53510689735413,81.67301034927368,324.85648345947266,10258,1159,9099,9099,0,11,1276000.0
1276,1276999,21.879117300551396,38.303667640891,0.07049402551276118,173.65033793449402,81.73800420761108,325.0345878601074,10258,1159,9099,9099,0,11,1277000.0
1277,1277999,21.883186465504828,38.31172477789517,0.0704832776503378,173.77003169059753,81.80285263061523,325.16217041015625,10258,1159,9099,9099,0,11,1278000.0
1278,1278999,21.88790692013022,38.31980100138803,0.0704541410245556,173.91370058059692,81.8677020072937,325.3733139038086,10289,1160,9129,9129,0,11,1279000.0
1279,1279999,21.891063744804875,38.32115124229761,0.07048290714265049,174.04993748664856,81.93196320533752,325.4314422607422,10291,1161,9130,9130,0,11,1280000.0
1280,1280999,21.89438238132572,38.3217598823403,0.07054830435525006,174.17161512374878,81.99637413024902,325.5329246520996,10291,1161,9130,9130,0,11,1281000.0
1281,1281999,21.896010870145158,38.31989489636977,0.07052872863132431,174.30908370018005,82.06136965751648,325.7805824279785,10295,1162,9133,9133,0,11,1282000.0
1282,1282999,21.89410762277435,38.31331987291125,0.07052243563779192,174.43186140060425,82.12524580955505,326.1102066040039,10295,1162,9133,9133,0,11,1283000.0
1283,1283999,21.888777671268517,38.30647570590189,0.0704918444603988,174.57848000526428,82.19044947624207,326.36064529418945,10299,1163,9136,9136,0,11,1284000.0
1284,1284999,21.882939135881674,38.29850516546143,0.07048849844582739,174.712815284729,82.25618839263916,326.5588912963867,10299,1163,9136,9136,0,11,1285000.0
1285,1285999,21.878915824317573,38.29528936152268,0.0704779016760182,174.83954620361328,82.32256245613098,326.70275115966797,10299,1163,9136,9136,0,11,1286000.0
1286,1286999,21.87357824586767,38.28510945642278,0.07049466819732708,174.9931616783142,82.38833427429199,326.9618797302246,10343,1164,9179,9179,0,11,1287000.0
1287,1287999,21.868065116045138,38.274467444744765,0.07052996595336525,175.11868929862976,82.4533338546753,327.26751708984375,10343,1164,9179,9179,0,11,1288000.0
1288,1288999,21.863649330525796,38.26542487770344,0.07053102505442654,175.26933073997498,82.5185194015503,327.29186248779297,10352,1165,9187,9187,0,11,1289000.0
1289,1289999,21.859116646735888,38.26274035728215,0.07052638688068913,175.40740728378296,82.5841076374054,327.554443359375,10352,1165,9187,9187,0,11,1290000.0
1290,1290999,21.854837652634053,38.25411838607808,0.07052833393782199,175.55406713485718,82.6492178440094,327.6411666870117,10354,1166,9188,9188,0,11,1291000.0
1291,1291999,21.851084532362258,38.24824445239947,0.07051634491330105,175.6790177822113,82.71362948417664,327.7316360473633,10354,1166,9188,9188,0,11,1292000.0
1292,1292999,21.84827109695788,38.246933879219256,0.07049462301945197,175.8561897277832,82.77852964401245,327.7428092956543,10362,1168,9194,9194,0,11,1293000.0
1293,1293999,21.844773370566337,38.239201140796695,0.07049846306355911,176.02884554862976,82.84412741661072,327.7954216003418,10375,1170,9205,9205,0,11,1294000.0
1294,1294999,21.84114970459031,38.23191204237385,0.07052197948160721,176.15088391304016,82.90873456001282,327.9040832519531,10375,1170,9205,9205,0,11,1295000.0
1295,1295999,21.83838810116563,38.22761133197093,0.0705134860692358,176.2893795967102,82.97346448898315,327.9932632446289,10375,1170,9205,9205,0,11,1296000.0
1296,1296999,21.835958748875957,38.2215545162029,0.07049571987296177,176.4060502052307,83.03832244873047,328.2673110961914,10376,1170,9206,9206,0,11,1297000.0
1297,1297999,21.834299432073546,38.2166684592004,0.07050750626174096,176.5288565158844,83.1031608581543,328.40971755981445,10376,1170,9206,9206,0,11,1298000.0
1298,1298999,21.83291581735125,38.2108107828404,0.07049710784195184,176.6594762802124,83.16754817962646,328.51619720458984,10376,1170,9206,9206,0,11,1299000.0
1299,1299999,21.831917494134807,38.20665646368043,0.07047139597581231,176.80245566368103,83.23186254501343,328.70531463623047,10378,1171,9207,9207,0,11,1300000.0
1300,1300999,21.829404275335023,38.20072213743002,0.07046836345546681,176.92278361320496,83.29724717140198,328.83845138549805,10378,1171,9207,9207,0,11,1301000.0
1301,1301999,21.828435131906286,38.1970634092518,0.07047611786878516,177.03774642944336,83.36102771759033,328.9375991821289,10378,1171,9207,9207,0,11,1302000.0
1302,1302999,21.82653430722313,38.19141496550986,0.07047746827725376,177.15065598487854,83.42524480819702,329.24576568603516,10378,1171,9207,9207,0,11,1303000.0
1303,1303999,21.82224737804519,38.18297107458567,0.07048434197205433,177.29503774642944,83.48962640762329,329.57531356811523,10409,1172,9237,9237,0,11,1304000.0
1304,1304999,21.81597120498454,38.17463787419008,0.07052611557488575,177.41683387756348,83.55541062355042,329.8262367248535,10409,1172,9237,9237,0,11,1305000.0
1305,1305999,21.810180477491308,38.16900092715637,0.07056317725214367,177.54590010643005,83.62144112586975,330.1001434326172,10409,1172,9237,9237,0,11,1306000.0
1306,1306999,21.804186381600896,38.16179559523273,0.0706013031668904,177.71804904937744,83.68698930740356,330.2341423034668,10442,1174,9268,9268,0,11,1307000.0
1307,1307999,21.79795537500163,38.15224806792458,0.07063945982302144,177.86570167541504,83.75285601615906,330.3477668762207,10475,1175,9300,9300,0,11,1308000.0
1308,1308999,21.792851427423212,38.14306780638825,0.0706572286676197,178.0244014263153,83.81883835792542,330.48669815063477,10477,1176,9301,9301,0,11,1309000.0
1309,1309999,21.788274355545642,38.13336767056382,0.0706756928763328,178.1441831588745,83.88271617889404,330.6050834655762,10477,1176,9301,9301,0,11,1310000.0
1310,1310999,21.78263509367372,38.12298322841023,0.07069218438541514,178.30241346359253,83.94714140892029,330.721492767334,10484,1177,9307,9307,0,11,1311000.0
1311,1311999,21.779184209287862,38.11675759240449,0.07066555470237534,178.43282222747803,84.01119613647461,330.84704208374023,10484,1177,9307,9307,0,11,1312000.0
1312,1312999,21.774901776707527,38.11021549503791,0.07065326293568186,178.58824229240417,84.07555341720581,330.8596611022949,10490,1178,9312,9312,0,11,1313000.0
1313,1313999,21.770877223962295,38.102834227195956,0.07064785732845535,178.7185821533203,84.139723777771,330.9711608886719,10490,1178,9312,9312,0,11,1314000.0
1314,1314999,21.76824391143278,38.094985817243426,0.07060417642269812,178.85900831222534,84.20429182052612,331.1461410522461,10492,1179,9313,9313,0,11,1315000.0
1315,1315999,21.76649350797345,38.08836030002506,0.07053753541258012,178.9754285812378,84.26839399337769,331.2690773010254,10492,1179,9313,9313,0,11,1316000.0
1316,1316999,21.763677975196714,38.08049679595876,0.07050219558448634,179.10567593574524,84.3322982788086,331.3323669433594,10492,1179,9313,9313,0,11,1317000.0
1317,1317999,21.76312782299438,38.07517641319506,0.07040446012515966,179.24874448776245,84.39755415916443,331.4815559387207,10494,1180,9314,9314,0,11,1318000.0
1318,1318999,21.764735755682757,38.07812751546875,0.07019972085946036,179.37562155723572,84.4625997543335,331.6490173339844,10495,1180,9315,9315,0,11,1319000.0
1319,1319999,21.76515111822137,38.0745817427293,0.07010865962704638,179.541659116745,84.52758121490479,331.64180755615234,10502,1182,9320,9320,0,11,1320000.0
1320,1320999,21.76651239703983,38.074415716626966,0.07003352568210353,179.67490887641907,84.5916793346405,331.8059310913086,10502,1182,9320,9320,0,11,1321000.0
1321,1321999,21.76742134396897,38.07179566993153,0.06997682667443794,179.81555843353271,84.65645861625671,331.83102798461914,10505,1183,9322,9322,0,11,1322000.0
1322,1322999,21.7689040379104,38.069955067178455,0.06993944689326592,179.9376916885376,84.7206859588623,331.94964599609375,10505,1183,9322,9322,0,11,1323000.0
1323,1323999,21.769038255517824,38.067281651774046,0.06989266345172829,180.10611867904663,84.78481912612915,332.0518226623535,10511,1185,9326,9326,0,11,1324000.0
1324,1324999,21.76530228566543,38.05917346154417,0.06989020139528412,180.22494268417358,84.84898471832275,332.36341857910156,10511,1185,9326,9326,0,11,1325000.0
1325,1325999,21.76049409816521,38.06002536643681,0.06988298637622692,180.35572242736816,84.91537547111511,332.7613296508789,10511,1185,9326,9326,0,11,1326000.0
1326,1326999,21.755239446799443,38.060987766969866,0.0698757541260806,180.47302961349487,84.98076391220093,332.99926376342773,10511,1185,9326,9326,0,11,1327000.0
1327,1327999,21.748924310976456,38.053460138618966,0.06990979885104709,180.59915590286255,85.0460262298584,333.13361740112305,10511,1185,9326,9326,0,11,1328000.0
1328,1328999,21.743393631030237,38.04839755387065,0.06991629351606954,180.73051834106445,85.11064672470093,333.2799949645996,10511,1185,9326,9326,0,11,1329000.0
1329,1329999,21.737371036046063,38.038987786782535,0.06993614056006447,180.85158562660217,85.175790309906,333.39477157592773,10511,1185,9326,9326,0,11,1330000.0
1330,1330999,21.731623973605984,38.02981557721063,0.06995809571300848,180.9808065891266,85.2399230003357,333.5200004577637,10511,1185,9326,9326,0,11,1331000.0
1331,1331999,21.725455089845834,38.02099416457261,0.06996460642149016,181.1031506061554,85.30469417572021,333.7380065917969,10511,1185,9326,9326,0,11,1332000.0
1332,1332999,21.719425357442695,38.01100503598942,0.0699858208068016,181.26596212387085,85.37023496627808,333.79920196533203,10515,1186,9329,9329,0,11,1333000.0
1333,1333999,21.713789617302492,38.002322353351175,0.07000063034525572,181.38137340545654,85.43472409248352,333.8923530578613,10515,1186,9329,9329,0,11,1334000.0
1334,1334999,21.710189460572252,37.997055515055244,0.06999187242054195,181.53864526748657,85.49999022483826,334.3450469970703,10526,1187,9339,9339,0,11,1335000.0
1335,1335999,21.70735551607945,37.99531617159564,0.06997901124876948,181.66555786132812,85.56478500366211,334.51259994506836,10526,1187,9339,9339,0,11,1336000.0
1336,1336999,21.7046897011973,37.99070724885132,0.069982873494569,181.83522605895996,85.6303927898407,334.6279411315918,10583,1189,9394,9394,0,11,1337000.0
1337,1337999,21.701657578462452,37.98528874800224,0.06998204271872643,181.95307564735413,85.6950535774231,334.85900497436523,10583,1189,9394,9394,0,11,1338000.0
1338,1338999,21.701016491203607,37.98470752162603,0.06996285089727294,182.12873935699463,85.76012516021729,334.8680419921875,10601,1191,9410,9410,0,11,1339000.0
1339,1339999,21.700200164461997,37.985959045938806,0.06993026194895091,182.25036573410034,85.82503056526184,335.09637451171875,10602,1191,9411,9411,0,11,1340000.0
1340,1340999,21.69822319611311,37.982897336815256,0.06991742787397881,182.37027192115784,85.88930821418762,335.2450752258301,10602,1191,9411,9411,0,11,1341000.0
1341,1341999,21.695450874670033,37.976392786715614,0.06991446196789308,182.53636193275452,85.95384740829468,335.41453552246094,10612,1193,9419,9419,0,11,1342000.0
1342,1342999,21.691774624456237,37.969489969290336,0.06989542443864505,182.65203022956848,86.01931190490723,335.89320373535156,10616,1193,9423,9423,0,11,1343000.0
1343,1343999,21.686713840171947,37.96316462242114,0.06989339545672046,182.7879831790924,86.08466744422913,336.33720779418945,10618,1193,9425,9425,0,11,1344000.0
1344,1344999,21.681404536571986,37.95552360544934,0.06990923401893345,182.93514966964722,86.15092253684998,336.6069564819336,10651,1194,9457,9457,0,11,1345000.0
1345,1345999,21.67721374934532,37.95529064326919,0.0698850801253793,183.05539727210999,86.21590518951416,336.7741470336914,10653,1194,9459,9459,0,11,1346000.0
1346,1346999,21.673559705982843,37.948306849938625,0.0698908651574297,183.18625855445862,86.28170990943909,337.0426902770996,10654,1194,9460,9460,0,11,1347000.0
1347,1347999,21.670649419716323,37.941683928604554,0.06987621242769415,183.33349013328552,86.34639072418213,337.1456642150879,10656,1195,9461,9461,0,11,1348000.0
1348,1348999,21.666885341799354,37.93457108676329,0.06987088405039044,183.5032103061676,86.41144728660583,337.3120536804199,10674,1197,9477,9477,0,11,1349000.0
1349,1349999,21.664652167304325,37.93258268128972,0.06983585569532136,183.65719485282898,86.47632670402527,337.56429290771484,10677,1198,9479,9479,0,11,1350000.0
1350,1350999,21.663067305606795,37.93328833272634,0.06977142606219511,183.8046293258667,86.54086756706238,337.6332244873047,10679,1199,9480,9480,0,11,1351000.0
1351,1351999,21.66101477980076,37.92815466491707,0.0697211595354511,183.93636751174927,86.60616040229797,337.7709846496582,10679,1199,9480,9480,0,11,1352000.0
1352,1352999,21.658049451005496,37.92107090587971,0.06969889548583208,184.12034463882446,86.67145299911499,337.9607849121094,10693,1201,9492,9492,0,11,1353000.0
1353,1353999,21.65657487939142,37.91794477108228,0.06965034987724228,184.24501585960388,86.73665976524353,338.1203079223633,10693,1201,9492,9492,0,11,1354000.0
1354,1354999,21.65626035848083,37.92558579811767,0.06955399185683186,184.40909385681152,86.80228853225708,338.1450614929199,10701,1202,9499,9499,0,11,1355000.0
1355,1355999,21.655754982232445,37.921652173959366,0.06950608318377938,184.5639033317566,86.86832427978516,338.27380752563477,10703,1203,9500,9500,0,11,1356000.0
1356,1356999,21.654786820078897,37.91731971861699,0.06948499266174801,184.70833230018616,86.93411421775818,338.3882293701172,10708,1204,9504,9504,0,11,1357000.0
1357,1357999,21.656316564210627,37.9248656606472,0.06940301726169318,184.83280658721924,86.99880170822144,338.4844207763672,10708,1204,9504,9504,0,11,1358000.0
1358,1358999,21.657040824820886,37.922476293304314,0.0693459175504414,184.9582495689392,87.06486511230469,338.6528663635254,10708,1204,9504,9504,0,11,1359000.0
1359,1359999,21.658129164307663,37.919740237183774,0.0693072311886157,185.09721064567566,87.128657579422,338.6676254272461,10715,1205,9510,9510,0,11,1360000.0
1360,1360999,21.65842962304838,37.91585245758215,0.06927310590943203,185.22139596939087,87.19295144081116,338.76216888427734,10715,1205,9510,9510,0,11,1361000.0
1361,1361999,21.657889597440246,37.91052591464252,0.06922953843169743,185.337975025177,87.25668144226074,338.97994232177734,10715,1205,9510,9510,0,11,1362000.0
1362,1362999,21.65879774418219,37.9090078084849,0.06915962914697571,185.50702095031738,87.32088541984558,339.24470138549805,10721,1207,9514,9514,0,11,1363000.0
1363,1363999,21.656169835191516,37.90497372479326,0.06910479113853163,185.67308950424194,87.38541078567505,339.5503692626953,10736,1209,9527,9527,0,11,1364000.0
1364,1364999,21.65499810180637,37.904087600713154,0.06907458914338704,185.83286309242249,87.45153856277466,339.8910598754883,10738,1210,9528,9528,0,11,1365000.0
1365,1365999,21.65381086242603,37.900895415616,0.06907494526046176,185.97944235801697,87.51694941520691,340.06446838378906,10741,1211,9530,9530,0,11,1366000.0
1366,1366999,21.652314232961505,37.89716369372462,0.0690867134944183,186.15704464912415,87.58298301696777,340.1556816101074,10745,1213,9532,9532,0,11,1367000.0
1367,1367999,21.65433180463968,37.89969992357272,0.0690217440407862,186.2810354232788,87.6478328704834,340.35143661499023,10745,1213,9532,9532,0,11,1368000.0
1368,1368999,21.65474887478244,37.89831045202231,0.06896414231882331,186.41606211662292,87.71228051185608,340.47707748413086,10745,1213,9532,9532,0,11,1369000.0
1369,1369999,21.65590993252842,37.89824482031862,0.06892829148760993,186.53352165222168,87.77759504318237,340.6452865600586,10745,1213,9532,9532,0,11,1370000.0
1370,1370999,21.657694650676355,37.89709953651261,0.06883000715124066,186.68149876594543,87.84318137168884,341.1872215270996,10760,1214,9546,9546,0,11,1371000.0
1371,1371999,21.659121014393804,37.894593366462544,0.06872454506595338,186.80387663841248,87.90899085998535,341.4546241760254,10764,1214,9550,9550,0,11,1372000.0
1372,1372999,21.661179667897432,37.89427496613432,0.06866054716574199,186.95686101913452,87.97435069084167,341.59485626220703,10769,1215,9554,9554,0,11,1373000.0
1373,1373999,21.662698923386717,37.892418663177494,0.06855307238246511,187.09301137924194,88.03940415382385,341.8757209777832,10769,1215,9554,9554,0,11,1374000.0
1374,1374999,21.66530353298525,37.89305562357573,0.06844525112526079,187.22080779075623,88.10414552688599,342.00783920288086,10769,1215,9554,9554,0,11,1375000.0
1375,1375999,21.665933700637613,37.88805777706849,0.06836092143017114,187.35678696632385,88.1688334941864,342.0905532836914,10769,1215,9554,9554,0,11,1376000.0
1376,1376999,21.66795767007209,37.88580248340645,0.06824668859079297,187.4841194152832,88.23419523239136,342.2511177062988,10769,1215,9554,9554,0,11,1377000.0
1377,1377999,21.671184100492933,37.88399868590966,0.06814759985651941,187.62832474708557,88.29900336265564,342.31360244750977,10776,1216,9560,9560,0,11,1378000.0
1378,1378999,21.673802019359258,37.88386330870003,0.06806533593394137,187.77911758422852,88.36429238319397,342.49497985839844,10788,1217,9571,9571,0,11,1379000.0
1379,1379999,21.677861005670866,37.88258270895782,0.06785826013919427,187.90547609329224,88.42926383018494,342.7464828491211,10788,1217,9571,9571,0,11,1380000.0
1380,1380999,21.68117774034516,37.88001375089053,0.06773128687984997,188.07222437858582,88.49373579025269,342.78314208984375,10792,1219,9573,9573,0,11,1381000.0
1381,1381999,21.681894951564285,37.87457050938079,0.06763320188997846,188.19196319580078,88.55944752693176,342.8813934326172,10792,1219,9573,9573,0,11,1382000.0
1382,1382999,21.68138436627549,37.86835732477387,0.06755356808091229,188.3122935295105,88.62376189231873,343.09970474243164,10792,1219,9573,9573,0,11,1383000.0
1383,1383999,21.679608882556746,37.86374588246133,0.06750409437980653,188.45264410972595,88.68790364265442,343.4079399108887,10799,1220,9579,9579,0,11,1384000.0
1384,1384999,21.6753128487259,37.85513032856914,0.06753147524520586,188.64526438713074,88.75274133682251,343.5619583129883,10806,1223,9583,9583,0,11,1385000.0
1385,1385999,21.67129509689727,37.84800345252355,0.06754787994724021,188.77060317993164,88.81935501098633,343.8895797729492,10806,1223,9583,9583,0,11,1386000.0
1386,1386999,21.66850910394319,37.84323724565726,0.06751704242835155,188.8923840522766,88.88431429862976,344.0954132080078,10806,1223,9583,9583,0,11,1387000.0
1387,1387999,21.664116397139548,37.83397874693786,0.06754872932802469,189.05009865760803,88.94972705841064,344.1872100830078,10808,1224,9584,9584,0,11,1388000.0
1388,1388999,21.66257382642512,37.828006748509054,0.0674996996226932,189.1740710735321,89.01523876190186,344.3877754211426,10808,1224,9584,9584,0,11,1389000.0
1389,1389999,21.659030265134426,37.8197030187178,0.0674922111512456,189.3486876487732,89.08046841621399,344.4536895751953,10813,1226,9587,9587,0,11,1390000.0
1390,1390999,21.655928713196705,37.811599169891814,0.06748347436019464,189.4758825302124,89.14537692070007,344.69755935668945,10813,1226,9587,9587,0,11,1391000.0
1391,1391999,21.654074921251556,37.805646208811154,0.06742592522211288,189.6249544620514,89.21069312095642,344.8819885253906,10815,1227,9588,9588,0,11,1392000.0
1392,1392999,21.65193140262667,37.79855588678378,0.06738860622203902,189.81916642189026,89.27591466903687,344.859375,10827,1230,9597,9597,0,11,1393000.0
1393,1393999,21.64946366446571,37.79204427475775,0.06736559146291321,189.9729769229889,89.34224796295166,344.8942222595215,10834,1231,9603,9603,0,11,1394000.0
1394,1394999,21.650548739565433,37.790412772631,0.0672574731656076,190.155921459198,89.407785654068,345.1531181335449,10841,1233,9608,9608,0,11,1395000.0
1395,1395999,21.652917468582583,37.79316695192299,0.06721242719079301,190.2751429080963,89.47247457504272,345.35000228881836,10841,1233,9608,9608,0,11,1396000.0
1396,1396999,21.65734365608246,37.80172245945763,0.06713080766865409,190.4190640449524,89.53754734992981,345.466121673584,10844,1234,9610,9610,0,11,1397000.0
1397,1397999,21.663898814049446,37.81263666749452,0.06701727927816248,190.53920698165894,89.60372376441956,345.7550964355469,10844,1234,9610,9610,0,11,1398000.0
1398,1398999,21.671097952510394,37.82232259007008,0.06697974339211177,190.6602487564087,89.66898036003113,345.9610366821289,10844,1234,9610,9610,0,11,1399000.0
1399,1399999,21.675832884245068,37.82514884902848,0.06697542922415922,190.8468976020813,89.73454880714417,345.99282455444336,10850,1237,9613,9613,0,11,1400000.0
1400,1400999,21.684473222839614,37.83592901763545,0.06688939400680805,190.9596450328827,89.79848122596741,346.2862358093262,10850,1237,9613,9613,0,11,1401000.0
1401,1401999,21.68970456622754,37.83897504176885,0.06681035856987194,191.10167932510376,89.86346673965454,346.3848457336426,10852,1238,9614,9614,0,11,1402000.0
1402,1402999,21.694903636901298,37.8418707002066,0.06678709168718011,191.27528285980225,89.9280002117157,346.519100189209,10856,1240,9616,9616,0,11,1403000.0
1403,1403999,21.69872633410223,37.844894157487246,0.06676843529460097,191.38988971710205,89.99196124076843,346.7937202453613,10856,1240,9616,9616,0,11,1404000.0
1404,1404999,21.69840727791393,37.840246092054656,0.06662100759667622,191.5551507472992,90.0563576221466,347.17469787597656,10862,1242,9620,9620,0,11,1405000.0
1405,1405999,21.69646527294713,37.833692011061316,0.06653538841782569,191.72229099273682,90.12176489830017,347.4413070678711,10870,1244,9626,9626,0,11,1406000.0
1406,1406999,21.696515804656133,37.828392227861194,0.06637021672397214,191.84072017669678,90.18784236907959,347.69635009765625,10870,1244,9626,9626,0,11,1407000.0
1407,1407999,21.695790576769824,37.82344573750935,0.06625012320433687,191.9919469356537,90.2532799243927,347.8686637878418,10876,1245,9631,9631,0,11,1408000.0
1408,1408999,21.69382112808929,37.81646643369069,0.06618860998899379,192.22486805915833,90.32010889053345,347.80517959594727,10891,1249,9642,9642,0,11,1409000.0
1409,1409999,21.695114727745704,37.81259621238338,0.06601082308258788,192.4014790058136,90.38554430007935,347.9956588745117,10896,1251,9645,9645,0,11,1410000.0
1410,1410999,21.695031290033835,37.80679968990397,0.06587695224677426,192.544997215271,90.4505352973938,348.20780181884766,10898,1252,9646,9646,0,11,1411000.0
1411,1411999,21.69584092947636,37.802608868323944,0.06574115943668324,192.74980807304382,90.51656079292297,348.30054473876953,10911,1255,9656,9656,0,11,1412000.0
1412,1412999,21.696492609186244,37.80008178822235,0.06560103051995247,192.9259433746338,90.58229231834412,348.4577178955078,10925,1257,9668,9668,0,11,1413000.0
1413,1413999,21.69711028803576,37.79819509304774,0.06546700361143254,193.1100208759308,90.64778470993042,348.62546157836914,10930,1259,9671,9671,0,11,1414000.0
1414,1414999,21.700643779546528,37.80752724522275,0.06542550968845073,193.31229281425476,90.71383762359619,348.7832679748535,10944,1262,9682,9682,0,11,1415000.0
1415,1415999,21.709422032886316,37.827971463772606,0.06506424366399888,193.49351954460144,90.77953457832336,349.0550765991211,10948,1264,9684,9684,0,11,1416000.0
1416,1416999,21.715478439388082,37.83446093814616,0.06490180935030287,193.6131784915924,90.84518766403198,349.25560760498047,10950,1264,9686,9686,0,11,1417000.0
1417,1417999,21.722075695770247,37.847057801415005,0.0647989906412536,193.73120856285095,90.91027998924255,349.37138748168945,10950,1264,9686,9686,0,11,1418000.0
1418,1418999,21.730128538675416,37.8607135585001,0.06459702436573689,193.85500860214233,90.97599649429321,349.7189598083496,10950,1264,9686,9686,0,11,1419000.0
1419,1419999,21.735255201489434,37.86588109629926,0.06452268675064599,193.9934115409851,91.04096508026123,349.83552169799805,10958,1265,9693,9693,0,11,1420000.0
1420,1420999,21.744475266294476,37.88470006934281,0.06444819811966795,194.13991594314575,91.10653948783875,350.1510200500488,10960,1266,9694,9694,0,11,1421000.0
1421,1421999,21.75361920280983,37.895400894861844,0.0644048765189732,194.26717710494995,91.17114734649658,350.3470039367676,10960,1266,9694,9694,0,11,1422000.0
1422,1422999,21.761215359216905,37.903129505695205,0.06441253995026719,194.41434240341187,91.23540210723877,350.4048728942871,10963,1267,9696,9696,0,11,1423000.0
1423,1423999,21.769351843265415,37.91267745506071,0.06439036633952755,194.52870750427246,91.2993426322937,350.6156005859375,10963,1267,9696,9696,0,11,1424000.0
1424,1424999,21.772335192334005,37.911660763229825,0.06436938142761317,194.64198637008667,91.36408019065857,350.82347106933594,10963,1267,9696,9696,0,11,1425000.0
1425,1425999,21.774998023625482,37.91686659444182,0.06413616941903344,194.7840178012848,91.42842698097229,351.19933700561523,10966,1268,9698,9698,0,11,1426000.0
1426,1426999,21.775632409416165,37.91745331204191,0.0639861108275741,194.90249872207642,91.49372744560242,351.62554931640625,10969,1268,9701,9701,0,11,1427000.0
1427,1427999,21.776736176383444,37.9154166292231,0.0638163198797228,195.0756733417511,91.55954837799072,351.8787651062012,10975,1270,9705,9705,0,11,1428000.0
1428,1428999,21.77852858112639,37.9156550300927,0.06363580271073754,195.20378422737122,91.62455129623413,352.0667610168457,10976,1270,9706,9706,0,11,1429000.0
1429,1429999,21.78015374308799,37.91633997264782,0.0633872393471987,195.37814259529114,91.6901433467865,352.19815826416016,10983,1272,9711,9711,0,11,1430000.0
1430,1430999,21.784436855635033,37.9194934553516,0.06293424049477914,195.5545370578766,91.75724983215332,352.398624420166,10993,1274,9719,9719,0,11,1431000.0
1431,1431999,21.786689630971505,37.919041694445575,0.06271181534261372,195.78084325790405,91.82311964035034,352.44561767578125,11006,1278,9728,9728,0,11,1432000.0
1432,1432999,21.791236971432937,37.92171196327212,0.06232492801022693,195.93017077445984,91.88888359069824,352.8125228881836,11010,1279,9731,9731,0,11,1433000.0
1433,1433999,21.79745369489615,37.92795578974614,0.06174975635367008,196.04573965072632,91.95461463928223,353.09429931640625,11010,1279,9731,9731,0,11,1434000.0
1434,1434999,21.802681185691572,37.93233380296084,0.061294966931355166,196.20254230499268,92.02032041549683,353.2178077697754,11012,1280,9732,9732,0,11,1435000.0
1435,1435999,21.80819778041366,37.93601343108055,0.06087129809376535,196.3431544303894,92.08615589141846,353.3790626525879,11012,1280,9732,9732,0,11,1436000.0
1436,1436999,21.81528501390946,37.94176970150916,0.06043768846690101,196.51448369026184,92.15136575698853,353.43141174316406,11021,1282,9739,9739,0,11,1437000.0
1437,1437999,21.81899635823029,37.94401726091217,0.06012860325007896,196.66853380203247,92.2177300453186,353.47420501708984,11023,1283,9740,9740,0,11,1438000.0
1438,1438999,21.822305624264224,37.94554667621398,0.05998712025543129,196.82884073257446,92.28358149528503,353.5738220214844,11026,1284,9742,9742,0,11,1439000.0
1439,1439999,21.83033036936805,37.94932750844138,0.05972851763449727,196.98221135139465,92.34872341156006,353.71666717529297,11029,1285,9744,9744,0,11,1440000.0
1440,1440999,21.83604503825188,37.952255194071945,0.05965849883487784,197.12670493125916,92.41381216049194,353.8381690979004,11031,1286,9745,9745,0,11,1441000.0
1441,1441999,21.842397569049364,37.95590308166569,0.05958931049518079,197.2753710746765,92.47939920425415,353.98719024658203,11033,1287,9746,9746,0,11,1442000.0
1442,1442999,21.85037383459458,37.960838279328776,0.05930103951127219,197.45072102546692,92.54426860809326,354.0186538696289,11037,1289,9748,9748,0,11,1443000.0
1443,1443999,21.857100002796944,37.96535207834159,0.05916498603394027,197.62158703804016,92.60907363891602,354.05764389038086,11042,1291,9751,9751,0,11,1444000.0
1444,1444999,21.86455956442632,37.97402883328406,0.05907722871608034,197.78757643699646,92.67358684539795,354.19448471069336,11046,1293,9753,9753,0,11,1445000.0
1445,1445999,21.868228137187394,37.97294873598437,0.05901625936253363,197.95424795150757,92.73797416687012,354.2966499328613,11051,1295,9756,9756,0,11,1446000.0
1446,1446999,21.865824847093233,37.96999495319745,0.058951056243568556,199.14811897277832,92.80400514602661,354.7599563598633,11060,1296,9764,9764,0,11,1447000.0
1447,1447999,21.86425009508902,37.973574834333974,0.05890081467084762,199.27608609199524,92.86993312835693,355.1324653625488,11061,1296,9765,9765,0,11,1448000.0
1448,1448999,21.862056288944196,37.96822788028334,0.05884255312691622,199.4306378364563,92.93676447868347,355.3141288757324,11063,1297,9766,9766,0,11,1449000.0
1449,1449999,21.860676247356913,37.9675605696045,0.05881011495950572,199.55693912506104,93.0030448436737,355.47887420654297,11064,1297,9767,9767,0,11,1450000.0
1450,1450999,21.860355229135408,37.96666451490348,0.05876651651334697,199.700181722641,93.068776845932,355.63439559936523,11064,1297,9767,9767,0,11,1451000.0
1451,1451999,21.860031461407306,37.966517464825195,0.0587012815541591,199.85497784614563,93.13329100608826,355.6824722290039,11066,1298,9768,9768,0,11,1452000.0
1452,1452999,21.860261762143168,37.96412819010344,0.05865365611742812,199.98138332366943,93.1980652809143,355.87674713134766,11066,1298,9768,9768,0,11,1453000.0
1453,1453999,21.860547502698164,37.981671519241516,0.05855082517672827,200.18963265419006,93.26376366615295,355.87762451171875,11080,1301,9779,9779,0,11,1454000.0
1454,1454999,21.861452069015836,37.98243511973117,0.05850448444224898,200.40259671211243,93.3299355506897,355.81980895996094,11092,1304,9788,9788,0,11,1455000.0
1455,1455999,21.862419427850217,37.98199714205491,0.05846116023371328,200.53173184394836,93.39537930488586,356.01551818847656,11092,1304,9788,9788,0,11,1456000.0
1456,1456999,21.864846742798136,37.995383738851615,0.058413837298834315,200.70159482955933,93.46036219596863,356.0585250854492,11097,1306,9791,9791,0,11,1457000.0
1457,1457999,21.866460492524944,37.997038199446465,0.058367061148066,200.87674021720886,93.5258252620697,356.1348533630371,11106,1308,9798,9798,0,11,1458000.0
1458,1458999,21.870269765624755,38.012715670896604,0.05831115954795263,201.0291645526886,93.59176325798035,356.3945999145508,11115,1309,9806,9806,0,11,1459000.0
1459,1459999,21.876070343712126,38.03489786680987,0.05826221586565583,201.17597937583923,93.65764164924622,356.611759185791,11120,1310,9810,9810,0,11,1460000.0
1460,1460999,21.88107852670552,38.055670292165544,0.0581304628822682,201.3049111366272,93.7224531173706,356.7679214477539,11120,1310,9810,9810,0,11,1461000.0
1461,1461999,21.88502398079021,38.06099211361285,0.05804524817091161,201.53242254257202,93.78795337677002,356.66033935546875,11137,1314,9823,9823,0,11,1462000.0
1462,1462999,21.889812180107388,38.072534637386646,0.05796870663583975,201.68818402290344,93.8546040058136,356.77656173706055,11141,1315,9826,9826,0,11,1463000.0
1463,1463999,21.890898047341725,38.07290454814051,0.0579363532871241,201.80648612976074,93.91891074180603,357.13233184814453,11141,1315,9826,9826,0,11,1464000.0
1464,1464999,21.892520925853805,38.080639976066145,0.05786473077048193,201.95988297462463,93.98678851127625,357.6459617614746,11150,1316,9834,9834,0,11,1465000.0
1465,1465999,21.895960302054178,38.09332990368287,0.0578468222338705,202.110848903656,94.05255317687988,357.8166618347168,11158,1317,9841,9841,0,11,1466000.0
1466,1466999,21.899010769150486,38.10354917721656,0.057817454897859055,202.24089694023132,94.1180853843689,357.9856376647949,11159,1317,9842,9842,0,11,1467000.0
1467,1467999,21.905834105245116,38.123649085886,0.05766244140145771,202.37376523017883,94.18430757522583,358.14888763427734,11160,1317,9843,9843,0,11,1468000.0
1468,1468999,21.909848300069065,38.132090585763585,0.057548395135395225,202.54280042648315,94.24938201904297,358.1497688293457,11164,1319,9845,9845,0,11,1469000.0
1469,1469999,21.914465814740492,38.1416578377629,0.0574553667453892,202.72713422775269,94.3153018951416,358.2502250671387,11169,1321,9848,9848,0,11,1470000.0
1470,1470999,21.920855418467927,38.153511465952406,0.057375839679600915,202.8549358844757,94.3812026977539,358.4787483215332,11169,1321,9848,9848,0,11,1471000.0
1471,1471999,21.92905643191864,38.16922756218566,0.05732087987928269,203.05935907363892,94.44723629951477,358.40732192993164,11182,1324,9858,9858,0,11,1472000.0
1472,1472999,21.93668446610989,38.19296598635577,0.05730022492428166,203.18643403053284,94.51313185691833,358.94361114501953,11187,1324,9863,9863,0,11,1473000.0
1473,1473999,21.94200158475544,38.2013897959412,0.0572722595062235,203.3398084640503,94.58017826080322,359.314884185791,11195,1325,9870,9870,0,11,1474000.0
1474,1474999,21.94946311918835,38.21690642456483,0.05731419089395118,203.58465361595154,94.64959478378296,359.43152618408203,11213,1329,9884,9884,0,11,1475000.0
1475,1475999,21.958159670354235,38.23581404688308,0.05727208775744086,203.735356092453,94.71473741531372,359.62458419799805,11217,1330,9887,9887,0,11,1476000.0
1476,1476999,21.966414944646676,38.25083204332321,0.05728267326304426,203.87130570411682,94.78832936286926,359.7630157470703,11217,1330,9887,9887,0,11,1477000.0
1477,1477999,21.97444308330294,38.262947210066535,0.057235881806784294,203.99804186820984,94.85389733314514,360.1011619567871,11225,1330,9895,9895,0,11,1478000.0
1478,1478999,21.98137224082224,38.28285766181288,0.05720391480771647,204.14904952049255,94.9189805984497,360.3184394836426,11234,1331,9903,9903,0,11,1479000.0
1479,1479999,21.990756678589946,38.30102440030711,0.05718241057819384,204.29668712615967,94.98387026786804,360.52015686035156,11239,1332,9907,9907,0,11,1480000.0
1480,1480999,21.991277217446633,38.3029946290141,0.05716718179216351,204.410564661026,95.04776453971863,360.857120513916,11239,1332,9907,9907,0,11,1481000.0
1481,1481999,21.98864717230583,38.30428408737083,0.0571443388883508,204.57732939720154,95.11401867866516,361.2186851501465,11243,1334,9909,9909,0,11,1482000.0
1482,1482999,21.985156646243237,38.302487594788005,0.05712615707550639,204.76798796653748,95.18007946014404,361.4430160522461,11257,1337,9920,9920,0,11,1483000.0
1483,1483999,21.981135155929465,38.29970364305518,0.05710530802893543,204.88794660568237,95.24663543701172,361.63318634033203,11257,1337,9920,9920,0,11,1484000.0
1484,1484999,21.97867014703443,38.29708402397301,0.057095902552544375,205.01165914535522,95.31177687644958,361.9234275817871,11257,1337,9920,9920,0,11,1485000.0
1485,1485999,21.976669491866392,38.29489844339186,0.05706804590060699,205.19049549102783,95.3774847984314,362.0712471008301,11290,1339,9951,9951,0,11,1486000.0
1486,1486999,21.97373291980833,38.28870125088717,0.05705611053813897,205.33900451660156,95.44306874275208,362.2603569030762,11292,1340,9952,9952,0,11,1487000.0
1487,1487999,21.972622093516634,38.285655338424924,0.05701496791451155,205.48974990844727,95.50925898551941,362.4766960144043,11303,1341,9962,9962,0,11,1488000.0
1488,1488999,21.973262305615936,38.286954219214174,0.05701058272902604,205.66628670692444,95.57821893692017,362.5673828125,11308,1343,9965,9965,0,11,1489000.0
1489,1489999,21.974195133800713,38.29292643556311,0.057012502081404404,205.79563689231873,95.6437656879425,362.6717185974121,11308,1343,9965,9965,0,11,1490000.0
1490,1490999,21.97462714772052,38.29414570560941,0.057021457921582086,205.9712574481964,95.70937752723694,363.00108337402344,11321,1345,9976,9976,0,11,1491000.0
1491,1491999,21.974400570735334,38.2929203656154,0.05703654349800613,206.09827280044556,95.77534317970276,363.1264114379883,11321,1345,9976,9976,0,11,1492000.0
1492,1492999,21.975783510365517,38.294998691304876,0.05701340761374174,206.24233508110046,95.84429454803467,363.2170639038086,11321,1345,9976,9976,0,11,1493000.0
1493,1493999,21.97786565167699,38.29662796963375,0.0570539252986616,206.41730046272278,95.9102132320404,363.3330535888672,11326,1347,9979,9979,0,11,1494000.0
1494,1494999,21.982004084314383,38.30023604522218,0.05707986499977247,206.53914403915405,95.97571134567261,363.4883232116699,11326,1347,9979,9979,0,11,1495000.0
1495,1495999,21.986359885268733,38.305161035810535,0.057134768415516235,206.6579098701477,96.04073333740234,363.5854721069336,11326,1347,9979,9979,0,11,1496000.0
1496,1496999,21.989972840207788,38.30596166802533,0.057116582268627814,206.84016060829163,96.1061339378357,363.6799964904785,11330,1349,9981,9981,0,11,1497000.0
1497,1497999,21.995920863361,38.3160382543062,0.05711229256687289,206.9860188961029,96.17067623138428,363.7877197265625,11332,1350,9982,9982,0,11,1498000.0
1498,1498999,22.000850446332983,38.32044106282406,0.057244980338869156,207.12792015075684,96.2348997592926,363.8565330505371,11335,1351,9984,9984,0,11,1499000.0
1499,1499999,22.003782253398484,38.32105286289577,0.057296286229545634,207.29576420783997,96.30003619194031,364.06861877441406,11341,1353,9988,9988,0,11,1500000.0
1500,1500999,22.004690137587453,38.32928312614632,0.05727036444047051,207.41291689872742,96.36389923095703,364.4160804748535,11345,1353,9992,9992,0,11,1501000.0
1501,1501999,22.00124337262337,38.33381939489209,0.05723642506363036,207.5310878753662,96.42805695533752,364.64404678344727,11346,1353,9993,9993,0,11,1502000.0
1502,1502999,21.996492746323355,38.328206249255416,0.05724574954459072,207.6846969127655,96.4939455986023,365.0314025878906,11377,1354,10023,10023,0,11,1503000.0
1503,1503999,21.991768598132747,38.320803872397356,0.05725833077934428,207.86345863342285,96.55990242958069,365.13840103149414,11381,1356,10025,10025,0,11,1504000.0
1504,1504999,21.98754936547214,38.31433953672924,0.05726852668399274,207.98469519615173,96.62505865097046,365.27875900268555,11381,1356,10025,10025,0,11,1505000.0
1505,1505999,21.985131231734115,38.31416145715128,0.05724730926458621,208.13343572616577,96.69009447097778,365.4710388183594,11389,1357,10032,10032,0,11,1506000.0
1506,1506999,21.982760301977343,38.30933650538533,0.057219299300875215,208.25424146652222,96.75439620018005,365.6248245239258,11389,1357,10032,10032,0,11,1507000.0
1507,1507999,21.979906966385478,38.30489832445859,0.057206937508432754,208.45288801193237,96.81963586807251,365.6827507019043,11424,1360,10064,10064,0,11,1508000.0
1508,1508999,21.97823780378745,38.29988660658263,0.057167763749409795,208.60051465034485,96.88570976257324,365.87158966064453,11426,1361,10065,10065,0,11,1509000.0
1509,1509999,21.97625561721043,38.294775605604464,0.05713693446487389,208.78412532806396,96.95126390457153,365.9666404724121,11437,1363,10074,10074,0,11,1510000.0
1510,1510999,21.97428234742565,38.28901492030622,0.05712653966889647,208.90609741210938,97.01588582992554,366.0802230834961,11437,1363,10074,10074,0,11,1511000.0
1511,1511999,21.973708043495467,38.286878322861035,0.05711775730415536,209.03253960609436,97.08086466789246,366.20999908447266,11437,1363,10074,10074,0,11,1512000.0
1512,1512999,21.973029308655537,38.28413788155763,0.05710825698628108,209.19046878814697,97.14638304710388,366.2743797302246,11439,1364,10075,10075,0,11,1513000.0
1513,1513999,21.972768761923497,38.281263965060134,0.057082496058147414,209.3250970840454,97.21130323410034,366.3507843017578,11439,1364,10075,10075,0,11,1514000.0
1514,1514999,21.97317223621825,38.281697936729636,0.057079627825963763,209.44517827033997,97.27621150016785,366.5469665527344,11439,1364,10075,10075,0,11,1515000.0
1515,1515999,21.97444869568645,38.27941565394518,0.05706580047543419,209.60156679153442,97.34137535095215,366.66010665893555,11442,1365,10077,10077,0,11,1516000.0
1516,1516999,21.97543126516499,38.27676202338031,0.05709404514420424,209.76812148094177,97.4064588546753,366.78875732421875,11451,1367,10084,10084,0,11,1517000.0
1517,1517999,21.977841870036656,38.27643200565246,0.0571028204970393,210.00722765922546,97.47182059288025,366.9221611022949,11467,1371,10096,10096,0,11,1518000.0
1518,1518999,21.98077130258625,38.27602338335431,0.05715584838323473,210.19888162612915,97.53778219223022,366.9866523742676,11474,1374,10100,10100,0,11,1519000.0
1519,1519999,21.98315416175634,38.27576508809343,0.05724021508521948,210.34646677970886,97.60223746299744,367.1282424926758,11476,1375,10101,10101,0,11,1520000.0
1520,1520999,21.984994873730223,38.27527206592209,0.057235405853032106,210.5200867652893,97.66688013076782,367.24633407592773,11482,1377,10105,10105,0,11,1521000.0
1521,1521999,21.98322430885038,38.270529289713,0.057273275666482104,210.63303995132446,97.73080945014954,367.51927947998047,11482,1377,10105,10105,0,11,1522000.0
1522,1522999,21.97799417796589,38.27270983536613,0.05727897907622492,210.7610776424408,97.79618835449219,367.68502044677734,11482,1377,10105,10105,0,11,1523000.0
1523,1523999,21.972235516523096,38.268862231070244,0.05729365836067657,210.94449019432068,97.86215424537659,368.0062255859375,11487,1379,10108,10108,0,11,1524000.0
1524,1524999,21.96583756904513,38.26025786190668,0.057329843134183545,211.12431502342224,97.92790818214417,368.1838035583496,11491,1381,10110,10110,0,11,1525000.0
1525,1525999,21.96018150832165,38.25175302856947,0.05735959022367931,211.247878074646,97.99395847320557,368.3416442871094,11491,1381,10110,10110,0,11,1526000.0
1526,1526999,21.95523602813666,38.24481638499098,0.057385155396348364,211.42233657836914,98.05918002128601,368.468448638916,11498,1383,10115,10115,0,11,1527000.0
1527,1527999,21.950526877891576,38.23742323973874,0.05740217924492519,211.54620671272278,98.12417006492615,368.59550857543945,11498,1383,10115,10115,0,11,1528000.0
1528,1528999,21.945466467979248,38.22926478412075,0.05743396653269783,211.72599458694458,98.1946816444397,368.66360092163086,11500,1384,10116,10116,0,11,1529000.0
1529,1529999,21.941274460077043,38.22208190087372,0.057450249563148925,211.8711256980896,98.2601900100708,368.7721633911133,11502,1385,10117,10117,0,11,1530000.0
1530,1530999,21.937121727170563,38.21669793609493,0.05745820889525488,211.99958419799805,98.3249671459198,368.8583450317383,11502,1385,10117,10117,0,11,1531000.0
1531,1531999,21.933543542696512,38.21035160823514,0.0574866426774423,212.15554523468018,98.39017462730408,368.91965103149414,11510,1386,10124,10124,0,11,1532000.0
1532,1532999,21.929336789400303,38.20263059369542,0.05752037433917856,212.31113839149475,98.45685839653015,369.03231048583984,11517,1387,10130,10130,0,11,1533000.0
1533,1533999,21.926003928007706,38.19505141397722,0.057542779537033684,212.4670054912567,98.52200961112976,369.10252380371094,11519,1388,10131,10131,0,11,1534000.0
1534,1534999,21.922508403887964,38.18946919084785,0.05754428057891725,212.5968701839447,98.58683943748474,369.1988182067871,11519,1388,10131,10131,0,11,1535000.0
1535,1535999,21.920400468000878,38.18487228748451,0.05754637071933921,212.75473189353943,98.65195918083191,369.3275680541992,11522,1389,10133,10133,0,11,1536000.0
1536,1536999,21.919399622482377,38.18209446588688,0.057562806044844206,212.87729382514954,98.71692752838135,369.4698028564453,11522,1389,10133,10133,0,11,1537000.0
1537,1537999,21.917936226015385,38.17772059093955,0.05756949145559198,213.10797023773193,98.78282880783081,369.40029525756836,11536,1393,10143,10143,0,11,1538000.0
1538,1538999,21.91654816884187,38.17294735471675,0.05757444346348295,213.32117891311646,98.84893107414246,369.4603958129883,11556,1396,10160,10160,0,11,1539000.0
1539,1539999,21.915001086600366,38.16857586854428,0.05758531768383657,213.49179673194885,98.91333031654358,369.5702476501465,11562,1398,10164,10164,0,11,1540000.0
1540,1540999,21.91336925826958,38.16451318713869,0.05761529395367104,213.6749129295349,98.97810173034668,369.65445709228516,11568,1400,10168,10168,0,11,1541000.0
1541,1541999,21.911199811736505,38.158959777581344,0.057611268581193587,213.80059432983398,99.04268622398376,369.93295669555664,11568,1400,10168,10168,0,11,1542000.0
1542,1542999,21.907798480388248,38.151488199492235,0.05758247651268522,213.9393150806427,99.10693669319153,370.2120018005371,11599,1401,10198,10198,0,11,1543000.0
1543,1543999,21.9045445617842,38.14923736868972,0.057510753744343446,214.08168148994446,99.17265272140503,370.3432083129883,11603,1402,10201,10201,0,11,1544000.0
1544,1544999,21.90107694376248,38.141965477752265,0.05750962740558885,214.23512196540833,99.23812627792358,370.6629753112793,11605,1403,10202,10202,0,11,1545000.0
1545,1545999,21.897251346362033,38.134992236338014,0.057512045405717305,214.41825246810913,99.30419373512268,370.8285255432129,11611,1405,10206,10206,0,11,1546000.0
1546,1546999,21.895077904722292,38.13017980176436,0.057497216125769746,214.62762594223022,99.37068557739258,370.9318199157715,11628,1408,10220,10220,0,11,1547000.0
1547,1547999,21.89620206921415,38.12918821538063,0.05743884469822513,214.79947352409363,99.43689227104187,371.1484031677246,11630,1409,10221,10221,0,11,1548000.0
1548,1548999,21.898211662351954,38.128925688070346,0.05741270450904523,214.939932346344,99.50191569328308,371.2758026123047,11632,1410,10222,10222,0,11,1549000.0
1549,1549999,21.901048732547068,38.134287074733855,0.057357490446471426,215.07330417633057,99.56815719604492,371.49374771118164,11632,1410,10222,10222,0,11,1550000.0
1550,1550999,21.903419852043918,38.13765766868229,0.0572883184317583,215.21570086479187,99.63467216491699,371.7085266113281,11634,1411,10223,10223,0,11,1551000.0
1551,1551999,21.908359158211802,38.1482701764758,0.05728498818400918,215.3716380596161,99.70042252540588,371.8651695251465,11636,1412,10224,10224,0,11,1552000.0
1552,1552999,21.91084282536743,38.15287426053851,0.05729447666104481,215.50026726722717,99.76580429077148,371.98268127441406,11636,1412,10224,10224,0,11,1553000.0
1553,1553999,21.917072476994136,38.170041563616564,0.05736996059195443,215.6945071220398,99.8338770866394,372.0129508972168,11640,1414,10226,10226,0,11,1554000.0
1554,1554999,21.92246167733142,38.18645129412673,0.05744447646341966,215.85273575782776,99.89940881729126,372.1482048034668,11644,1415,10229,10229,0,11,1555000.0
1555,1555999,21.92693501004594,38.198099903519356,0.057516770424646535,215.98141717910767,99.96577548980713,372.2674751281738,11645,1415,10230,10230,0,11,1556000.0
1556,1556999,21.93192731337975,38.20830874837592,0.05748315368765733,216.10002255439758,100.03093075752258,372.5005874633789,11645,1415,10230,10230,0,11,1557000.0
1557,1557999,21.937543785822236,38.21908446463252,0.057465344710515676,216.27747225761414,100.09712028503418,372.56327056884766,11656,1417,10239,10239,0,11,1558000.0
1558,1558999,21.941866610895392,38.22281703136123,0.05744032341259386,216.4249198436737,100.16282320022583,372.6821594238281,11658,1418,10240,10240,0,11,1559000.0
1559,1559999,21.9475180809013,38.22853445053784,0.05743524306940884,216.57984352111816,100.22768425941467,372.75556564331055,11660,1419,10241,10241,0,11,1560000.0
1560,1560999,21.95260679354952,38.236073439713266,0.05742050399244247,216.76015639305115,100.2926185131073,372.7979316711426,11667,1421,10246,10246,0,11,1561000.0
1561,1561999,21.95718356487917,38.239509372159944,0.057443779418794194,216.9063425064087,100.35697984695435,372.87778091430664,11669,1422,10247,10247,0,11,1562000.0
1562,1562999,21.957836800154396,38.23666371746599,0.057399305345840035,217.0344831943512,100.42152333259583,373.0407028198242,11669,1422,10247,10247,0,11,1563000.0
1563,1563999,21.95585534141147,38.23498382223311,0.057400858538465105,217.1565980911255,100.48619556427002,373.3044242858887,11669,1422,10247,10247,0,11,1564000.0
1564,1564999,21.954158619697917,38.234928108835135,0.057416416355796196,217.30585527420044,100.55150985717773,373.5814743041992,11676,1423,10253,10253,0,11,1565000.0
1565,1565999,21.95328835047068,38.23375596507189,0.05745322126506314,217.51453280448914,100.61867141723633,373.76868438720703,11682,1426,10256,10256,0,11,1566000.0
1566,1566999,21.954393139574798,38.23571834094665,0.05746034670623812,217.63674926757812,100.68435549736023,374.0118522644043,11683,1426,10257,10257,0,11,1567000.0
1567,1567999,21.956235901285428,38.236480016708974,0.057436683161572466,217.79396796226501,100.75006699562073,374.14641189575195,11694,1427,10267,10267,0,11,1568000.0
1568,1568999,21.957838755470714,38.23778584429479,0.05743000209192406,217.96484184265137,100.82356023788452,374.27853775024414,11697,1428,10269,10269,0,11,1569000.0
1569,1569999,21.96066366862089,38.24102423556931,0.05740123676148157,218.1013741493225,100.88887453079224,374.3868217468262,11697,1428,10269,10269,0,11,1570000.0
1570,1570999,21.96291421160223,38.24356864221581,0.05736545133152049,218.25226259231567,100.9541585445404,374.5360870361328,11700,1429,10271,10271,0,11,1571000.0
1571,1571999,21.965596175507844,38.245751111502216,0.05736122725049775,218.40413212776184,101.02007675170898,374.6170463562012,11703,1430,10273,10273,0,11,1572000.0
1572,1572999,21.969951045784192,38.2510391138968,0.05739762732845477,218.55734729766846,101.08590459823608,374.6934242248535,11705,1431,10274,10274,0,11,1573000.0
1573,1573999,21.976351239305604,38.26934750451138,0.05744571924200925,218.7138810157776,101.15150666236877,374.780574798584,11707,1432,10275,10275,0,11,1574000.0
1574,1574999,21.981613313851184,38.27673349846858,0.05758361049725402,218.9245364665985,101.21823930740356,374.7547073364258,11721,1435,10286,10286,0,11,1575000.0
1575,1575999,21.989240062167237,38.29442900541484,0.05762954214251825,219.11338257789612,101.28372383117676,374.6648139953613,11725,1437,10288,10288,0,11,1576000.0
1576,1576999,21.99874097189437,38.31626973397307,0.05771714481398915,219.23124504089355,101.34953260421753,374.9245491027832,11725,1437,10288,10288,0,11,1577000.0
1577,1577999,22.006002530384784,38.325370636279146,0.05776627026033465,219.35452032089233,101.41434359550476,375.0501022338867,11726,1437,10289,10289,0,11,1578000.0
1578,1578999,22.01196207330069,38.33197576835148,0.05787732998063799,219.61700248718262,101.48036813735962,375.06214904785156,11759,1442,10317,10317,0,11,1579000.0
1579,1579999,22.021197489127704,38.34488213497035,0.05793469947148999,219.80043578147888,101.54787707328796,375.24419021606445,11765,1444,10321,10321,0,11,1580000.0
1580,1580999,22.02875514484493,38.35380476223115,0.05803873959170325,220.00738072395325,101.61289954185486,375.29184341430664,11773,1447,10326,10326,0,11,1581000.0
1581,1581999,22.03747065489647,38.3628975283056,0.05822975317160273,220.27710056304932,101.67886447906494,375.2498321533203,11785,1453,10332,10332,0,11,1582000.0
1582,1582999,22.04629076456847,38.37373940847837,0.0583521685599685,220.42409420013428,101.74423408508301,375.4405517578125,11788,1454,10334,10334,0,11,1583000.0
1583,1583999,22.047859108905968,38.374639768355664,0.058407072574072294,220.54139971733093,101.80848407745361,375.72364044189453,11788,1454,10334,10334,0,11,1584000.0
1584,1584999,22.041944538561964,38.36586084164069,0.05844736258040184,220.6802487373352,101.87269806861877,375.91543197631836,11819,1455,10364,10364,0,11,1585000.0
1585,1585999,22.03573351254511,38.35686504189277,0.058481237334831904,220.88897967338562,101.93848991394043,376.0878601074219,11854,1458,10396,10396,0,11,1586000.0
1586,1586999,22.03122914674796,38.35089611003555,0.05849839982662397,221.01823592185974,102.0042097568512,376.2823257446289,11854,1458,10396,10396,0,11,1587000.0
1587,1587999,22.027095951004952,38.34752074393448,0.05850082275520174,221.1382884979248,102.0697808265686,376.37549591064453,11854,1458,10396,10396,0,11,1588000.0
1588,1588999,22.023976368776612,38.34334456821833,0.05850053056200055,221.2616605758667,102.13626766204834,376.54528045654297,11854,1458,10396,10396,0,11,1589000.0
1589,1589999,22.020573935796147,38.33724275587126,0.05850002927845055,221.41753840446472,102.20078301429749,376.6019058227539,11857,1459,10398,10398,0,11,1590000.0
1590,1590999,22.016224613139638,38.32966183277875,0.05850893155251935,221.58195328712463,102.2654321193695,376.63634872436523,11860,1460,10400,10400,0,11,1591000.0
1591,1591999,22.013267358556966,38.324159166157486,0.05850919745218275,221.70121908187866,102.33029794692993,376.86075592041016,11860,1460,10400,10400,0,11,1592000.0
1592,1592999,22.01081586738028,38.320799753044774,0.05849794874064762,221.8412218093872,102.39540362358093,376.9545478820801,11860,1460,10400,10400,0,11,1593000.0
1593,1593999,22.008925959701017,38.31748651240608,0.05849702081764285,221.99786901474,102.46047043800354,377.01093673706055,11864,1461,10403,10403,0,11,1594000.0
1594,1594999,22.008661618920154,38.3155740584448,0.05848172423303555,222.16377186775208,102.52539587020874,377.1780090332031,11866,1462,10404,10404,0,11,1595000.0
1595,1595999,22.009518120618992,38.31479846097103,0.05849004278631509,222.34444904327393,102.59061741828918,377.20256423950195,11872,1464,10408,10408,0,11,1596000.0
1596,1596999,22.011393775603054,38.32195965821195,0.05846311331174869,222.5040159225464,102.65589904785156,377.2642288208008,11877,1465,10412,10412,0,11,1597000.0
1597,1597999,22.013533466782754,38.323677137314384,0.05847992432635407,222.62379384040833,102.72089147567749,377.4623794555664,11877,1465,10412,10412,0,11,1598000.0
1598,1598999,22.01826434351116,38.32957365484334,0.05854190601196152,222.80577993392944,102.78658771514893,377.55106353759766,11887,1467,10420,10420,0,11,1599000.0
1599,1599999,22.02318441181962,38.336157882925306,0.05861568159618846,222.95367527008057,102.8517382144928,377.6406555175781,11898,1468,10430,10430,0,11,1600000.0
1600,1600999,22.02903066494478,38.34390748810002,0.05861773841881934,223.12815809249878,102.91648530960083,377.7466506958008,11905,1470,10435,10435,0,11,1601000.0
1601,1601999,22.03494380645191,38.352794908048324,0.05873478370698926,223.2749388217926,102.98078894615173,377.8227424621582,11907,1471,10436,10436,0,11,1602000.0
1602,1602999,22.04434260682028,38.384895909301086,0.058790330736051666,223.48761081695557,103.04639673233032,377.81581115722656,11916,1474,10442,10442,0,11,1603000.0
1603,1603999,22.04871479250828,38.39061299157226,0.058795256172147536,223.6392982006073,103.11059498786926,377.93822479248047,11918,1475,10443,10443,0,11,1604000.0
1604,1604999,22.0494808514943,38.39081024746831,0.05879001992837263,223.78803396224976,103.17459201812744,378.20304107666016,11928,1476,10452,10452,0,11,1605000.0
1605,1605999,22.04830556238856,38.40169792487786,0.05875165077389655,223.94317841529846,103.24072241783142,378.4851264953613,11930,1477,10453,10453,0,11,1606000.0
1606,1606999,22.046545316442028,38.40790057785011,0.05873098703834245,224.0911476612091,103.30622911453247,378.6485595703125,11932,1478,10454,10454,0,11,1607000.0
1607,1607999,22.044709711817777,38.410819689943025,0.05870519511412031,224.26771306991577,103.37155652046204,378.7896308898926,11994,1480,10514,10514,0,11,1608000.0
1608,1608999,22.04299915337536,38.407722792387,0.05869335298523004,224.39682149887085,103.43709230422974,378.94992446899414,11994,1480,10514,10514,0,11,1609000.0
1609,1609999,22.04210711816494,38.40773213056631,0.058669919999509434,224.55208325386047,103.5027916431427,379.0134506225586,11998,1481,10517,10517,0,11,1610000.0
1610,1610999,22.04242122194849,38.41065618784871,0.05866032127185561,224.70336031913757,103.56766986846924,379.1279830932617,12002,1482,10520,10520,0,11,1611000.0
1611,1611999,22.042652672605858,38.411139069274256,0.05865809018142554,224.86201357841492,103.63378524780273,379.2257766723633,12005,1483,10522,10522,0,11,1612000.0
1612,1612999,22.042236921422134,38.40879335076525,0.05865438547036861,225.0648205280304,103.69956707954407,379.14338302612305,12012,1486,10526,10526,0,11,1613000.0
1613,1613999,22.042955010749935,38.410116300693026,0.05864094577764345,225.22460627555847,103.76498365402222,379.2303886413574,12016,1487,10529,10529,0,11,1614000.0
1614,1614999,22.045530870707378,38.412334351802244,0.05857551926997584,225.38215112686157,103.83190369606018,379.5026664733887,12018,1488,10530,10530,0,11,1615000.0
1615,1615999,22.047895236591398,38.42179677483419,0.05855703364839171,225.64443707466125,103.8977906703949,379.4503707885742,12037,1493,10544,10544,0,11,1616000.0
1616,1616999,22.048791191198042,38.42050735363202,0.0585186740913769,225.7921485900879,103.96394300460815,379.5553512573242,12040,1494,10546,10546,0,11,1617000.0
1617,1617999,22.05137448348629,38.422296035423514,0.05844668968519806,225.91421914100647,104.02929091453552,379.79162216186523,12040,1494,10546,10546,0,11,1618000.0
1618,1618999,22.05281176242172,38.420868761130286,0.058376584331957915,226.1114101409912,104.0957863330841,379.81442642211914,12048,1497,10551,10551,0,11,1619000.0
1619,1619999,22.05390196639745,38.4195958694729,0.05833683133807199,226.26390171051025,104.16034007072449,379.8872528076172,12050,1498,10552,10552,0,11,1620000.0
1620,1620999,22.05612072506172,38.42665318637577,0.05827144777181803,226.4727005958557,104.22570300102234,379.92959213256836,12056,1501,10555,10555,0,11,1621000.0
1621,1621999,22.055683179833395,38.423257524879965,0.05826388517617909,226.62358903884888,104.29043650627136,380.0680732727051,12058,1502,10556,10556,0,11,1622000.0
1622,1622999,22.05312445800298,38.416805041772854,0.05825875935613045,226.74335741996765,104.35824751853943,380.42015838623047,12059,1502,10557,10557,0,11,1623000.0
1623,1623999,22.050543257694727,38.414927357072386,0.05824960678645441,226.8807020187378,104.43195247650146,380.8415107727051,12060,1502,10558,10558,0,11,1624000.0
1624,1624999,22.047174526108897,38.407790518339596,0.05825773042343407,227.05973172187805,104.4981279373169,381.02921295166016,12064,1504,10560,10560,0,11,1625000.0
1625,1625999,22.043778213376637,38.4035336955074,0.058265398835978255,227.2066206932068,104.56348252296448,381.15284729003906,12066,1505,10561,10561,0,11,1626000.0
1626,1626999,22.042224542192187,38.40014446242291,0.05824083392232737,227.38866186141968,104.6304292678833,381.2270278930664,12071,1507,10564,10564,0,11,1627000.0
1627,1627999,22.04022124671586,38.394530429779486,0.05820941885654074,227.569730758667,104.6957573890686,381.3366050720215,12076,1509,10567,10567,0,11,1628000.0
1628,1628999,22.037667628867652,38.38823857094205,0.05819163531847238,227.69813132286072,104.76088094711304,381.5014419555664,12076,1509,10567,10567,0,11,1629000.0
1629,1629999,22.036868016960135,38.382394400308264,0.05814332565259084,227.87540483474731,104.82733345031738,381.77924728393555,12080,1511,10569,10569,0,11,1630000.0
1630,1630999,22.0361477461514,38.38009649652727,0.05808784483312179,228.0531210899353,104.89404606819153,381.8853759765625,12084,1513,10571,10571,0,11,1631000.0
1631,1631999,22.03459769238412,38.37434898635184,0.05803324724164782,228.2124011516571,104.96195888519287,381.9876708984375,12087,1514,10573,10573,0,11,1632000.0
1632,1632999,22.035704290779588,38.37290061717358,0.05788846110051393,228.4420943260193,105.028151512146,382.05001068115234,12096,1518,10578,10578,0,11,1633000.0
1633,1633999,22.035221740086453,38.369328659968566,0.057824247466376155,228.59069561958313,105.09379410743713,382.18346786499023,12098,1519,10579,10579,0,11,1634000.0
1634,1634999,22.03416334016874,38.3643721071697,0.057778888214805146,228.77641606330872,105.15957355499268,382.18689727783203,12104,1521,10583,10583,0,11,1635000.0
1635,1635999,22.03593114525091,38.36265418491731,0.05759284709473167,228.98602104187012,105.22577404975891,382.2164764404297,12111,1524,10587,10587,0,11,1636000.0
1636,1636999,22.037825988712864,38.363485112603726,0.05744073338169475,229.17182230949402,105.29193615913391,382.31672286987305,12116,1526,10590,10590,0,11,1637000.0
1637,1637999,22.03994460450831,38.37353664653622,0.057341869726420414,229.37419605255127,105.35752964019775,382.3626365661621,12123,1529,10594,10594,0,11,1638000.0
1638,1638999,22.04275246245206,38.37180255645041,0.05718184212863231,229.559876203537,105.42285513877869,382.4282112121582,12127,1531,10596,10596,0,11,1639000.0
1639,1639999,22.04452734661517,38.36974189224615,0.057092037872155665,229.75693655014038,105.48808312416077,382.45100021362305,12133,1534,10599,10599,0,11,1640000.0
1640,1640999,22.04496750408748,38.36520102896103,0.05702243767366599,229.97765970230103,105.55273199081421,382.3990936279297,12142,1538,10604,10604,0,11,1641000.0
1641,1641999,22.04730405482182,38.3676872110213,0.05685208590555879,230.15205883979797,105.61750626564026,382.50318908691406,12147,1540,10607,10607,0,11,1642000.0
1642,1642999,22.04676135320895,38.36461430101596,0.05679249946675624,230.30130553245544,105.6824140548706,382.59869384765625,12149,1541,10608,10608,0,11,1643000.0
1643,1643999,22.043268578392965,38.35941961128451,0.05677358634398377,230.4149787425995,105.74646615982056,382.7974395751953,12149,1541,10608,10608,0,11,1644000.0
1644,1644999,22.039939214235805,38.35621125463018,0.056765517082217,230.61770462989807,105.82183194160461,383.00157928466797,12153,1543,10610,10610,0,11,1645000.0
1645,1645999,22.036281720986047,38.352272584397475,0.0567452297190808,230.9018795490265,105.88872575759888,382.9938278198242,12166,1549,10617,10617,0,11,1646000.0
1646,1646999,22.03380198943665,38.363928470032455,0.056701017858276526,231.02775526046753,105.95510005950928,383.1730766296387,12166,1549,10617,10617,0,11,1647000.0
1647,1647999,22.031907798747767,38.35875461621342,0.05666905426874336,231.14786505699158,106.01969003677368,383.43875885009766,12167,1549,10618,10618,0,11,1648000.0
1648,1648999,22.02977799292213,38.352005609860996,0.05662456499075896,231.34677743911743,106.08615446090698,383.44744873046875,12176,1552,10624,10624,0,11,1649000.0
1649,1649999,22.027169514032682,38.34546892584342,0.05658894085164534,231.6144506931305,106.15257167816162,383.3954658508301,12201,1557,10644,10644,0,11,1650000.0
1650,1650999,22.026278454415934,38.34037550063337,0.056487027867300754,231.72834253311157,106.21717309951782,383.5566596984863,12201,1557,10644,10644,0,11,1651000.0
1651,1651999,22.024270477062764,38.33470298620433,0.056427702769504706,231.90924525260925,106.28300619125366,383.5717010498047,12207,1559,10648,10648,0,11,1652000.0
1652,1652999,22.022763667201417,38.329228336609624,0.05635973248517978,232.05953907966614,106.34968900680542,383.6485710144043,12210,1560,10650,10650,0,11,1653000.0
1653,1653999,22.023307992275733,38.32566199841848,0.05623289459383474,232.30097246170044,106.41587471961975,383.62784576416016,12220,1564,10656,10656,0,11,1654000.0
1654,1654999,22.024239305832733,38.32180520075859,0.056083351929683944,232.50378036499023,106.48190402984619,383.6091766357422,12226,1567,10659,10659,0,11,1655000.0
1655,1655999,22.02398681033266,38.31795734646144,0.05600517958613216,232.6286473274231,106.54747796058655,383.7486572265625,12226,1567,10659,10659,0,11,1656000.0
1656,1656999,22.02585194854937,38.31695327806037,0.055870423686827375,232.79501390457153,106.61386108398438,383.92980194091797,12232,1568,10664,10664,0,11,1657000.0
1657,1657999,22.02978052642662,38.31795538682286,0.0556743962042372,232.92111325263977,106.67896270751953,384.07168197631836,12232,1568,10664,10664,0,11,1658000.0
1658,1658999,22.03264585387566,38.317628115875515,0.0555843943668225,233.09846091270447,106.74587202072144,384.13029861450195,12236,1570,10666,10666,0,11,1659000.0
1659,1659999,22.036746488790552,38.32006703785301,0.055486100118831594,233.22962760925293,106.81035304069519,384.34679794311523,12236,1570,10666,10666,0,11,1660000.0
1660,1660999,22.039443947534764,38.319109228142416,0.055386516138914654,233.37650299072266,106.87504577636719,384.4087829589844,12239,1571,10668,10668,0,11,1661000.0
1661,1661999,22.04168715164618,38.31782579683696,0.055302363878610095,233.54702234268188,106.9391827583313,384.4220275878906,12244,1573,10671,10671,0,11,1662000.0
1662,1662999,22.042765365197248,38.31538308108201,0.055262873415480085,233.79884147644043,107.00382113456726,384.40721130371094,12264,1578,10686,10686,0,11,1663000.0
1663,1663999,22.040898592482762,38.310323586217905,0.05522124978528231,233.91689729690552,107.06955289840698,384.66168212890625,12264,1578,10686,10686,0,11,1664000.0
1664,1664999,22.037110985723682,38.30593175633017,0.055201772511940805,234.0643436908722,107.13432121276855,384.8488235473633,12267,1579,10688,10688,0,11,1665000.0
1665,1665999,22.032563318453754,38.299518554315775,0.05518826225327078,234.2467064857483,107.20030951499939,385.1129570007324,12301,1581,10720,10720,0,11,1666000.0
1666,1666999,22.028345052862385,38.296810148061525,0.05515843425475808,234.4245307445526,107.26758408546448,385.3089904785156,12309,1583,10726,10726,0,11,1667000.0
1667,1667999,22.02440358551104,38.2910961633026,0.05510640026846059,234.60553669929504,107.33358001708984,385.3101577758789,12313,1585,10728,10728,0,11,1668000.0
1668,1668999,22.020760917686495,38.28495628797885,0.05509352731144335,234.75884532928467,107.39901828765869,385.4106750488281,12315,1586,10729,10729,0,11,1669000.0
1669,1669999,22.01749528189482,38.27956096306436,0.055040437667578046,234.91582536697388,107.46417951583862,385.509033203125,12317,1587,10730,10730,0,11,1670000.0
1670,1670999,22.013293448204283,38.27281182628752,0.055047624060598266,235.034166097641,107.52890419960022,385.622257232666,12317,1587,10730,10730,0,11,1671000.0
1671,1671999,22.00971349291214,38.2660620793268,0.05503225076339302,235.15911102294922,107.59641981124878,385.7561454772949,12317,1587,10730,10730,0,11,1672000.0
1672,1672999,22.00585684240656,38.25882763643006,0.05503906940837733,235.34772276878357,107.66201210021973,385.7923774719238,12321,1589,10732,10732,0,11,1673000.0
1673,1673999,22.002124242109815,38.25273859344303,0.05503274360800259,235.50734162330627,107.72764372825623,385.857479095459,12323,1590,10733,10733,0,11,1674000.0
1674,1674999,21.998629709168917,38.24576244749813,0.05503311111667275,235.69036388397217,107.79348492622375,385.89924240112305,12337,1592,10745,10745,0,11,1675000.0
1675,1675999,21.99578167150304,38.23964453852782,0.0550215366419915,235.86548805236816,107.85932302474976,385.9324760437012,12341,1594,10747,10747,0,11,1676000.0
1676,1676999,21.99242406082482,38.23293813963491,0.05501374386919167,236.02339005470276,107.92479300498962,386.0241012573242,12345,1595,10750,10750,0,11,1677000.0
1677,1677999,21.990140201993455,38.22795521203952,0.0549977369535124,236.17683386802673,107.99051213264465,386.1523780822754,12348,1596,10752,10752,0,11,1678000.0
1678,1678999,21.989958289076053,38.225815133625396,0.05497377657031344,236.2990002632141,108.05766439437866,386.31018829345703,12348,1596,10752,10752,0,11,1679000.0
1679,1679999,21.990214970350653,38.228497462074536,0.05495552853119268,236.49546217918396,108.12409329414368,386.50241470336914,12362,1598,10764,10764,0,11,1680000.0
1680,1680999,21.990094261500907,38.23078190946906,0.054935977236672096,236.63359546661377,108.1892900466919,386.6684150695801,12362,1598,10764,10764,0,11,1681000.0
1681,1681999,21.990253619580717,38.23232728657394,0.05492739832285398,236.82000732421875,108.25472378730774,386.69844818115234,12367,1600,10767,10767,0,11,1682000.0
1682,1682999,21.988906135962985,38.227667292489905,0.05495314746603075,236.98290467262268,108.31977272033691,386.76438903808594,12369,1601,10768,10768,0,11,1683000.0
1683,1683999,21.987320231047587,38.22264589650608,0.0549391577126519,237.14598393440247,108.38602709770203,386.88180923461914,12371,1602,10769,10769,0,11,1684000.0
1684,1684999,21.983268608190862,38.215715670294436,0.05495122433915778,237.271057844162,108.45442128181458,387.1116027832031,12371,1602,10769,10769,0,11,1685000.0
1685,1685999,21.977743237914616,38.208092060563956,0.0549841540945768,237.42629671096802,108.51972675323486,387.3091735839844,12373,1603,10770,10770,0,11,1686000.0
1686,1686999,21.973268109488984,38.20132984483248,0.05502125830616844,237.612854719162,108.58625650405884,387.490779876709,12377,1605,10772,10772,0,11,1687000.0
1687,1687999,21.969196745466583,38.19466449600012,0.05505867310599322,237.73640608787537,108.65195369720459,387.66960525512695,12377,1605,10772,10772,0,11,1688000.0
1688,1688999,21.96564516711196,38.18898422911084,0.055083175331482326,237.92072224617004,108.71849608421326,387.7618827819824,12387,1607,10780,10780,0,11,1689000.0
1689,1689999,21.963597191183705,38.18702487115506,0.055091956692004396,238.0464768409729,108.78408694267273,388.0025215148926,12387,1607,10780,10780,0,11,1690000.0
1690,1690999,21.962453449765086,38.18517798335873,0.05509548915509699,238.20158624649048,108.85008025169373,388.1144485473633,12389,1608,10781,10781,0,11,1691000.0
1691,1691999,21.96147939613608,38.18423287157638,0.055122424235646617,238.36868691444397,108.91686129570007,388.2815971374512,12393,1609,10784,10784,0,11,1692000.0
1692,1692999,21.96075283802929,38.187768006020406,0.05512255995962567,238.54901838302612,108.98243522644043,388.2832450866699,12397,1611,10786,10786,0,11,1693000.0
1693,1693999,21.96204211232657,38.202763692811246,0.055117805632158956,238.71185874938965,109.04860091209412,388.3505401611328,12399,1612,10787,10787,0,11,1694000.0
1694,1694999,21.962918822436336,38.20811644185534,0.0551286232765309,238.84116315841675,109.11382102966309,388.4398612976074,12399,1612,10787,10787,0,11,1695000.0
1695,1695999,21.965759752391147,38.22057826262406,0.05524925714145579,238.9701006412506,109.17981171607971,388.5861358642578,12399,1612,10787,10787,0,11,1696000.0
1696,1696999,21.967544861350497,38.228470527872204,0.05534061909111243,239.12781381607056,109.24495887756348,388.6282768249512,12405,1613,10792,10792,0,11,1697000.0
1697,1697999,21.96811014667614,38.23282948592085,0.055434191527368504,239.2850625514984,109.31057286262512,388.6721611022949,12407,1614,10793,10793,0,11,1698000.0
1698,1698999,21.97097003301733,38.24071842720097,0.055469695616992554,239.4357545375824,109.37766313552856,388.8441848754883,12414,1615,10799,10799,0,11,1699000.0
1699,1699999,21.974089396717428,38.25232386811747,0.05549641009523221,239.67248606681824,109.44399404525757,388.8564643859863,12430,1619,10811,10811,0,11,1700000.0
1700,1700999,21.97656809625146,38.25762192686473,0.055560158033334806,239.8015558719635,109.50983166694641,389.09381103515625,12430,1619,10811,10811,0,11,1701000.0
1701,1701999,21.97964258273646,38.26332743461162,0.05564214434197612,240.04570174217224,109.57937693595886,389.16369247436523,12440,1623,10817,10817,0,11,1702000.0
1702,1702999,21.983225195837576,38.26833696182685,0.05574223492166752,240.25697803497314,109.64726042747498,389.2937316894531,12446,1626,10820,10820,0,11,1703000.0
1703,1703999,21.985276398418225,38.26924555049159,0.05581995067436252,240.46231770515442,109.71246695518494,389.4351119995117,12452,1629,10823,10823,0,11,1704000.0
1704,1704999,21.98680533585566,38.281152433259905,0.055826715991583065,240.6325922012329,109.77731037139893,389.5990409851074,12484,1631,10853,10853,0,11,1705000.0
1705,1705999,21.984495079347997,38.28239857725436,0.05579202913667847,240.78325057029724,109.84208226203918,390.29434967041016,12496,1632,10864,10864,0,11,1706000.0
1706,1706999,21.97982505951917,38.275134274407556,0.055811731109397855,240.96388483047485,109.90774941444397,390.7622947692871,12501,1634,10867,10867,0,11,1707000.0
1707,1707999,21.97532863909803,38.267899562535845,0.055831853702240974,241.12065196037292,109.9734148979187,390.99853897094727,12510,1635,10875,10875,0,11,1708000.0
1708,1708999,21.971891922518115,38.26673853843781,0.055810109837589716,241.34863185882568,110.03954029083252,391.1019706726074,12519,1639,10880,10880,0,11,1709000.0
1709,1709999,21.96863126679069,38.26198929094344,0.05580934994421982,241.4643337726593,110.10576272010803,391.4225425720215,12520,1639,10881,10881,0,11,1710000.0
1710,1710999,21.96571721364307,38.257095393970594,0.055793344447920834,241.6183521747589,110.17042446136475,391.7343406677246,12522,1640,10882,10882,0,11,1711000.0
1711,1711999,21.963549015554204,38.25276998588685,0.0557885863762656,241.74348092079163,110.2354211807251,391.94929122924805,12523,1640,10883,10883,0,11,1712000.0
1712,1712999,21.96195890268922,38.248844686498416,0.055781006925602505,241.85916662216187,110.30032420158386,392.34446716308594,12526,1640,10886,10886,0,11,1713000.0
1713,1713999,21.960542829000516,38.244975011001316,0.05576290014341889,241.98165655136108,110.36513590812683,392.5574645996094,12526,1640,10886,10886,0,11,1714000.0
1714,1714999,21.959506377446054,38.25657206263843,0.055694819878144286,242.13395762443542,110.43006587028503,392.65343856811523,12528,1641,10887,10887,0,11,1715000.0
1715,1715999,21.959875126399115,38.256048415268324,0.055668726815991776,242.32792043685913,110.49582934379578,392.9600296020508,12544,1643,10901,10901,0,11,1716000.0
1716,1716999,21.960232810305175,38.25519286765387,0.05564991726298629,242.4447271823883,110.56002759933472,393.23244857788086,12544,1643,10901,10901,0,11,1717000.0
1717,1717999,21.96164983145706,38.2625885892719,0.05565317383874968,242.6214017868042,110.62484312057495,393.39184951782227,12548,1645,10903,10903,0,11,1718000.0
1718,1718999,21.963537139299028,38.266042564240344,0.055666081769999765,242.78674221038818,110.69093084335327,393.5341796875,12557,1646,10911,10911,0,11,1719000.0
1719,1719999,21.965295359905145,38.26883254245016,0.05568239270033892,242.92877554893494,110.75567770004272,393.85046005249023,12564,1647,10917,10917,0,11,1720000.0
1720,1720999,21.969233863336882,38.27590541767014,0.05570848929936756,243.07369542121887,110.82068371772766,394.03324127197266,12566,1648,10918,10918,0,11,1721000.0
1721,1721999,21.974263110201218,38.28984476003513,0.05572590185910775,243.22839379310608,110.88563084602356,394.34931564331055,12577,1649,10928,10928,0,11,1722000.0
1722,1722999,21.97925537628587,38.30359434514039,0.055733806472520464,243.34560418128967,110.9496693611145,394.56364822387695,12577,1649,10928,10928,0,11,1723000.0
1723,1723999,21.982976343387957,38.310134571088135,0.055732934574181825,243.4557991027832,111.01353287696838,394.686824798584,12577,1649,10928,10928,0,11,1724000.0
1724,1724999,21.987684335512718,38.318905595556934,0.055691669225215734,243.58311557769775,111.07901859283447,395.0235900878906,12579,1649,10930,10930,0,11,1725000.0
1725,1725999,21.98816968153996,38.318797401226234,0.05567929868436772,243.73600888252258,111.14320731163025,395.3536911010742,12583,1650,10933,10933,0,11,1726000.0
1726,1726999,21.983937332617806,38.31251513859943,0.05568555445790124,243.85308289527893,111.20751070976257,395.8255500793457,12585,1650,10935,10935,0,11,1727000.0
1727,1727999,21.97952421239048,38.30726101322545,0.055698973947636676,243.97936916351318,111.27326464653015,396.4716033935547,12587,1650,10937,10937,0,11,1728000.0
1728,1728999,21.975846394063765,38.3063216213007,0.05569839902035212,244.10079622268677,111.33967161178589,396.72480392456055,12587,1650,10937,10937,0,11,1729000.0
1729,1729999,21.97247077059962,38.30266266076016,0.05569391502363674,244.33843421936035,111.40575861930847,396.81928634643555,12604,1654,10950,10950,0,11,1730000.0
1730,1730999,21.970190000183226,38.29907626349258,0.055672638075415115,244.48928546905518,111.47107172012329,397.2073173522949,12608,1655,10953,10953,0,11,1731000.0
1731,1731999,21.967208183903228,38.29382039941339,0.05567019284951369,244.64048671722412,111.53713393211365,397.43286514282227,12610,1656,10954,10954,0,11,1732000.0
1732,1732999,21.964090155228664,38.28864799788872,0.05567330601816245,244.79290509223938,111.60188484191895,397.553466796875,12612,1657,10955,10955,0,11,1733000.0
1733,1733999,21.96175885954612,38.28427598627134,0.055655649004865415,244.94584202766418,111.66694617271423,397.9238586425781,12616,1658,10958,10958,0,11,1734000.0
1734,1734999,21.961061679627505,38.2836997499594,0.05564879342434115,245.10210585594177,111.73276233673096,398.10820388793945,12618,1659,10959,10959,0,11,1735000.0
1735,1735999,21.960690773784965,38.284347404483384,0.05560598216688617,245.26720762252808,111.7982006072998,398.2598419189453,12620,1660,10960,10960,0,11,1736000.0
1736,1736999,21.96107984353291,38.29714530200699,0.05558403016632241,245.4292275905609,111.8646068572998,398.8515739440918,12640,1661,10979,10979,0,11,1737000.0
1737,1737999,21.961270831258688,38.29724890364988,0.05556895721114241,245.5447175502777,111.92901253700256,399.0589828491211,12640,1661,10979,10979,0,11,1738000.0
1738,1738999,21.961701954001207,38.297203725696114,0.055592089256898736,245.71482038497925,111.99366235733032,399.13314056396484,12647,1663,10984,10984,0,11,1739000.0
1739,1739999,21.962330608821702,38.29728731364234,0.05558079844590047,245.84186148643494,112.0587317943573,399.4300346374512,12649,1663,10986,10986,0,11,1740000.0
1740,1740999,21.964333022883395,38.300167586795986,0.05556383985900748,245.9529092311859,112.12301468849182,399.60437393188477,12650,1663,10987,10987,0,11,1741000.0
1741,1741999,21.966663803806032,38.30370736527688,0.055591915606477915,246.11546301841736,112.18913888931274,399.80331802368164,12660,1664,10996,10996,0,11,1742000.0
1742,1742999,21.970773198386553,38.31362449174298,0.055540425524955195,246.22852444648743,112.25336241722107,400.18431854248047,12662,1664,10998,10998,0,11,1743000.0
1743,1743999,21.97592478031345,38.33416103681702,0.05548505610447585,246.34702038764954,112.31685185432434,400.3157539367676,12662,1664,10998,10998,0,11,1744000.0
1744,1744999,21.979025163534953,38.34130851711134,0.05551341645054886,246.46658444404602,112.38056659698486,400.43360900878906,12662,1664,10998,10998,0,11,1745000.0
1745,1745999,21.981115289134348,38.345294568506965,0.05547102374375912,246.57572603225708,112.444011926651,400.6604461669922,12662,1664,10998,10998,0,11,1746000.0
1746,1746999,21.979984899596438,38.34488197854707,0.055448462680308674,246.69786477088928,112.50808715820312,401.2883186340332,12673,1664,11009,11009,0,11,1747000.0
1747,1747999,21.97894222586873,38.346098005823876,0.055447062454020424,246.84490156173706,112.57444953918457,401.9138603210449,12679,1665,11014,11014,0,11,1748000.0
1748,1748999,21.976247940202047,38.342778680294714,0.05545269390415675,247.0579218864441,112.64120388031006,402.12878036499023,12688,1668,11020,11020,0,11,1749000.0
1749,1749999,21.97400593859704,38.34216245641925,0.055458658191445576,247.18274641036987,112.70687985420227,402.3731918334961,12688,1668,11020,11020,0,11,1750000.0
1750,1750999,21.972586895114173,38.34153948004224,0.055437766494150775,247.34092783927917,112.77286219596863,402.6839179992676,12692,1669,11023,11023,0,11,1751000.0
1751,1751999,21.971539336014416,38.343732222400185,0.0554026653668247,247.49119305610657,112.83786702156067,402.85882568359375,12698,1670,11028,11028,0,11,1752000.0
1752,1752999,21.97122752358568,38.343566265423725,0.055400971333104954,247.6481945514679,112.90342211723328,403.0814094543457,12700,1671,11029,11029,0,11,1753000.0
1753,1753999,21.97045778499832,38.34152283440779,0.055386896018947085,247.79651641845703,112.97038173675537,403.3745346069336,12707,1672,11035,11035,0,11,1754000.0
1754,1754999,21.96997353641093,38.34051558523622,0.05537636520779898,247.98978924751282,113.03982162475586,403.40105056762695,12711,1674,11037,11037,0,11,1755000.0
1755,1755999,21.969841877549058,38.33958577168944,0.05538408095952441,248.18148732185364,113.10509586334229,403.65685272216797,12723,1676,11047,11047,0,11,1756000.0
1756,1756999,21.969232161354885,38.33874102083397,0.05538069249181121,248.3303940296173,113.17114090919495,404.2004737854004,12734,1677,11057,11057,0,11,1757000.0
1757,1757999,21.97064774299541,38.34622616021188,0.0554019266196466,248.5279631614685,113.23627471923828,404.30298233032227,12749,1680,11069,11069,0,11,1758000.0
1758,1758999,21.970961381142345,38.34444003214123,0.055406179040192294,248.73394203186035,113.30198121070862,404.4305114746094,12763,1683,11080,11080,0,11,1759000.0
1759,1759999,21.97223577051804,38.34406144757538,0.055401105148228935,248.8793821334839,113.36759066581726,404.6619338989258,12769,1684,11085,11085,0,11,1760000.0
1760,1760999,21.97322338435232,38.34328764070451,0.05540346188787437,249.00123238563538,113.43264985084534,404.8212547302246,12769,1684,11085,11085,0,11,1761000.0
1761,1761999,21.975856723513665,38.34572072139463,0.05540374985463681,249.15000581741333,113.49732208251953,405.0474052429199,12780,1685,11095,11095,0,11,1762000.0
1762,1762999,21.97694700114424,38.345305542202894,0.055417176664520396,249.29280757904053,113.56263375282288,405.1879081726074,12782,1686,11096,11096,0,11,1763000.0
1763,1763999,21.97870585025962,38.349954532725526,0.05541907679894631,249.43561363220215,113.62730050086975,405.56495666503906,12794,1687,11107,11107,0,11,1764000.0
1764,1764999,21.97633951422688,38.34484975261114,0.05541197261344666,249.55593848228455,113.69270920753479,406.1874313354492,12805,1687,11118,11118,0,11,1765000.0
1765,1765999,21.97316730941377,38.34053886058904,0.055413718824819935,249.67249512672424,113.758127450943,406.6792869567871,12806,1687,11119,11119,0,11,1766000.0
1766,1766999,21.970451762497163,38.337440435961966,0.05541725211259396,249.84934067726135,113.82424974441528,406.9136276245117,12811,1689,11122,11122,0,11,1767000.0
1767,1767999,21.96810908738707,38.33447069454739,0.055397780393925955,250.0586495399475,113.89060473442078,406.99210357666016,12819,1692,11127,11127,0,11,1768000.0
1768,1768999,21.966380780210077,38.33137191200764,0.05536587566423834,250.2083616256714,113.95687580108643,407.30685806274414,12823,1693,11130,11130,0,11,1769000.0
1769,1769999,21.96494848119264,38.327122188394355,0.05531776462782367,250.3275682926178,114.02199935913086,407.5299415588379,12824,1693,11131,11131,0,11,1770000.0
1770,1770999,21.96379155669202,38.32276521832361,0.055255782138371456,250.4414622783661,114.08676481246948,407.8009452819824,12827,1693,11134,11134,0,11,1771000.0
1771,1771999,21.963672332487214,38.32229499172031,0.055165670450631366,250.5538728237152,114.15186810493469,408.0330047607422,12827,1693,11134,11134,0,11,1772000.0
1772,1772999,21.963300045640686,38.31945188538414,0.05510857944975811,250.7812478542328,114.21796727180481,408.0526428222656,12834,1696,11138,11138,0,11,1773000.0
1773,1773999,21.96253751774405,38.316817871072985,0.05508511444039843,250.90329027175903,114.28316473960876,408.25649642944336,12834,1696,11138,11138,0,11,1774000.0
1774,1774999,21.962449401053675,38.314021535102086,0.05504165092939928,251.05283427238464,114.34852862358093,408.62671279907227,12844,1697,11147,11147,0,11,1775000.0
1775,1775999,21.962939164678264,38.314305643669705,0.05501240899009319,251.26476860046387,114.41404724121094,408.6620903015137,12852,1700,11152,11152,0,11,1776000.0
1776,1776999,21.964241479006084,38.31724370413936,0.055017775437894434,251.3864665031433,114.47913956642151,408.8259582519531,12852,1700,11152,11152,0,11,1777000.0
1777,1777999,21.966399361399493,38.31770436865985,0.054975327952856645,251.50114727020264,114.54524493217468,409.1654853820801,12856,1700,11156,11156,0,11,1778000.0
1778,1778999,21.97037944988279,38.32180961872711,0.055019287813612316,251.67729663848877,114.6111147403717,409.3560447692871,12862,1702,11160,11160,0,11,1779000.0
1779,1779999,21.97435601650434,38.32515995635621,0.055065432468674014,251.83685898780823,114.67672920227051,409.53852462768555,12867,1703,11164,11164,0,11,1780000.0
1780,1780999,21.98168510010672,38.33372545582291,0.05511041287495555,252.0155999660492,114.74198770523071,409.72774505615234,12873,1705,11168,11168,0,11,1781000.0
1781,1781999,21.98875584824262,38.34388439787431,0.05517361323120773,252.24919486045837,114.80719566345215,409.73076248168945,12882,1709,11173,11173,0,11,1782000.0
1782,1782999,21.994919371256795,38.35287327061448,0.055283842060922184,252.42516946792603,114.87220644950867,409.98169326782227,12893,1711,11182,11182,0,11,1783000.0
1783,1783999,21.999564363365387,38.356530856204664,0.055270763858981664,252.60842299461365,114.93812561035156,410.14621353149414,12905,1713,11192,11192,0,11,1784000.0
1784,1784999,21.99992860390002,38.3536224887299,0.055223630179282335,252.75233054161072,115.0023844242096,410.5698890686035,12916,1714,11202,11202,0,11,1785000.0
1785,1785999,21.99756525596938,38.350401744405104,0.0552136644356751,252.8994014263153,115.06821322441101,410.9467964172363,12922,1715,11207,11207,0,11,1786000.0
1786,1786999,21.994540993956857,38.34512466106104,0.055217862372725635,253.07944297790527,115.13707327842712,411.11951065063477,12927,1717,11210,11210,0,11,1787000.0
1787,1787999,21.992186904109342,38.34199451710431,0.05521814979533801,253.289559841156,115.20274639129639,411.2113914489746,12934,1720,11214,11214,0,11,1788000.0
1788,1788999,21.99041820952235,38.33922246685778,0.055219495494471915,253.4392786026001,115.26914858818054,411.33455657958984,12936,1721,11215,11215,0,11,1789000.0
1789,1789999,21.98945904216097,38.336508215906626,0.05519130752451029,253.5919418334961,115.3340961933136,411.5870170593262,12969,1722,11247,11247,0,11,1790000.0
1790,1790999,21.98768255097989,38.330978791024066,0.05516091627903197,253.8174557685852,115.40012431144714,411.63671112060547,12976,1725,11251,11251,0,11,1791000.0
1791,1791999,21.98677706542878,38.32743680136513,0.05513786214741301,253.96159195899963,115.46464467048645,411.741943359375,12982,1726,11256,11256,0,11,1792000.0
1792,1792999,21.985794692465387,38.32220253443266,0.055101635202291166,254.11249136924744,115.53003144264221,411.857177734375,12984,1727,11257,11257,0,11,1793000.0
1793,1793999,21.98611339971571,38.32925874283639,0.05502886143063768,254.23746871948242,115.59501957893372,411.979679107666,12985,1727,11258,11258,0,11,1794000.0
1794,1794999,21.9864960317824,38.32634658131647,0.0550401435334662,254.40289521217346,115.66091394424438,412.02599334716797,12994,1728,11266,11266,0,11,1795000.0
1795,1795999,21.985827265959077,38.32198624239712,0.05500003132794651,254.5203766822815,115.72635197639465,412.35447692871094,12997,1728,11269,11269,0,11,1796000.0
1796,1796999,21.985597691069568,38.319127768526975,0.05497747256420171,254.67080235481262,115.79131412506104,412.4112358093262,12999,1729,11270,11270,0,11,1797000.0
1797,1797999,21.98466103091539,38.31441739423518,0.05498597383373738,254.82836532592773,115.85750937461853,412.5232048034668,13001,1730,11271,11271,0,11,1798000.0
1798,1798999,21.985093728877633,38.31131074764631,0.05494425641987044,254.9692735671997,115.92254281044006,412.8118324279785,13007,1731,11276,11276,0,11,1799000.0
1799,1799999,21.98668862654404,38.30921790488821,0.05490624394307664,255.15815210342407,115.9888117313385,412.9706230163574,13011,1733,11278,11278,0,11,1800000.0
1800,1800999,21.988515724990208,38.31564830783005,0.054869014369008484,255.34361386299133,116.05421471595764,413.0685501098633,13017,1735,11282,11282,0,11,1801000.0
1801,1801999,21.990308997401037,38.31394873161624,0.054803764908635144,255.49884343147278,116.11933732032776,413.37805557250977,13024,1736,11288,11288,0,11,1802000.0
1802,1802999,21.99164748873934,38.311279487159176,0.054775312160954326,255.65227675437927,116.18407464027405,413.4875144958496,13027,1737,11290,11290,0,11,1803000.0
1803,1803999,21.99188518112811,38.307309154571996,0.05476436695332876,255.769775390625,116.24811291694641,413.70330810546875,13030,1737,11293,11293,0,11,1804000.0
1804,1804999,21.99105811642278,38.30241308544251,0.05475935742623905,255.97507524490356,116.31386661529541,413.8046417236328,13043,1740,11303,11303,0,11,1805000.0
1805,1805999,21.988932181189398,38.29870184468613,0.054728693744481194,256.0984387397766,116.37963938713074,414.3643455505371,13057,1740,11317,11317,0,11,1806000.0
1806,1806999,21.98494731080013,38.2931951921971,0.054740205028326105,256.21486020088196,116.44460558891296,414.79922103881836,13059,1740,11319,11319,0,11,1807000.0
1807,1807999,21.982499916842748,38.291059390352565,0.054773151478910265,256.3671717643738,116.51038098335266,415.08034896850586,13061,1741,11320,11320,0,11,1808000.0
1808,1808999,21.98174520169651,38.29298869159796,0.05480529958124025,256.5470702648163,116.57583260536194,415.2529602050781,13066,1743,11323,11323,0,11,1809000.0
1809,1809999,21.980437700259678,38.29394937276147,0.05480532383619108,256.6959354877472,116.64216828346252,415.40074157714844,13068,1744,11324,11324,0,11,1810000.0
1810,1810999,21.980759134509864,38.29610785249664,0.05481531629682035,256.8781142234802,116.7066695690155,415.615177154541,13073,1746,11327,11327,0,11,1811000.0
1811,1811999,21.982348847173903,38.2998472987331,0.05480157586750278,256.9937376976013,116.77109479904175,415.7962760925293,13073,1746,11327,11327,0,11,1812000.0
1812,1812999,21.983594289023745,38.30017550795875,0.05481227105634778,257.1209526062012,116.83605098724365,416.00571060180664,13074,1746,11328,11328,0,11,1813000.0
1813,1813999,21.983473426871672,38.29908629678981,0.054804998872802324,257.27153992652893,116.90119218826294,416.1363410949707,13077,1747,11330,11330,0,11,1814000.0
1814,1814999,21.984115407145513,38.30008829253351,0.05479214329537174,257.4570827484131,116.96661067008972,416.2043037414551,13084,1749,11335,11335,0,11,1815000.0
1815,1815999,21.98557728731115,38.30386081922353,0.05482018041306791,257.6303400993347,117.03181052207947,416.616641998291,13101,1750,11351,11351,0,11,1816000.0
1816,1816999,21.98592000700982,38.30253546100693,0.054836307357032044,257.78381848335266,117.09778547286987,416.7642288208008,13105,1751,11354,11354,0,11,1817000.0
1817,1817999,21.985934117631327,38.30034237581438,0.054853624146635194,257.96762800216675,117.16273951530457,416.8176040649414,13109,1753,11356,11356,0,11,1818000.0
1818,1818999,21.988201930120994,38.30745198222039,0.05486014547433882,258.19588446617126,117.23179912567139,417.0140800476074,13137,1756,11381,11381,0,11,1819000.0
1819,1819999,21.989544817623347,38.306563395137395,0.05486359492515658,258.3698751926422,117.29668593406677,417.2051773071289,13145,1758,11387,11387,0,11,1820000.0
1820,1820999,21.991101592274788,38.306079620996755,0.05486044654646427,258.55580592155457,117.36405205726624,417.23917388916016,13149,1760,11389,11389,0,11,1821000.0
1821,1821999,21.993433674632968,38.30825583500398,0.05488246705279931,258.7046365737915,117.4292504787445,417.5397605895996,13155,1761,11394,11394,0,11,1822000.0
1822,1822999,21.994698899822108,38.3076489849499,0.0549099484881036,258.8521339893341,117.49378991127014,417.6662178039551,13157,1762,11395,11395,0,11,1823000.0
1823,1823999,21.998804967414994,38.312422837682796,0.05495773766478418,259.0155670642853,117.5582845211029,417.7588882446289,13159,1763,11396,11396,0,11,1824000.0
1824,1824999,22.001058318276325,38.31335826651191,0.05495375707217587,259.1266806125641,117.62324452400208,418.09020614624023,13162,1763,11399,11399,0,11,1825000.0
1825,1825999,21.99911073009874,38.30936167620526,0.054968593286826906,259.254065990448,117.69203019142151,418.4543228149414,13168,1763,11405,11405,0,11,1826000.0
1826,1826999,21.9949415488002,38.30527398943454,0.05497317948469105,260.6973373889923,117.7569375038147,418.77413177490234,13169,1763,11406,11406,0,11,1827000.0
1827,1827999,21.991184538605154,38.30037410724348,0.054984937713772664,260.8161005973816,117.82288026809692,419.08309173583984,13169,1763,11406,11406,0,11,1828000.0
1828,1828999,21.988992429468702,38.29969895390529,0.05498806834094072,260.941486120224,117.88906908035278,419.25905990600586,13169,1763,11406,11406,0,11,1829000.0
1829,1829999,21.985075155149914,38.29312495786193,0.05498393691381598,261.0693554878235,117.95569705963135,419.38526916503906,13169,1763,11406,11406,0,11,1830000.0
1830,1830999,21.983384005241806,38.300901261194326,0.05492520338001472,261.2057373523712,118.02099227905273,419.6515769958496,13172,1763,11409,11409,0,11,1831000.0
1831,1831999,21.981744252509284,38.29700313026588,0.05490063208621354,261.32419180870056,118.08673310279846,419.79027557373047,13172,1763,11409,11409,0,11,1832000.0
1832,1832999,21.980642357575444,38.29583017938405,0.054888700464845064,261.48490691185,118.15185809135437,419.9147033691406,13181,1764,11417,11417,0,11,1833000.0
1833,1833999,21.979628013345312,38.29284970807047,0.05488487299166711,261.6292977333069,118.2180917263031,419.99142837524414,13183,1765,11418,11418,0,11,1834000.0
1834,1834999,21.979669879023305,38.29193908991933,0.05487467974157778,261.7753756046295,118.28373265266418,420.0996551513672,13183,1765,11418,11418,0,11,1835000.0
1835,1835999,21.98132564470367,38.293080340878916,0.05490456306175007,261.97117161750793,118.34902095794678,420.1141815185547,13187,1767,11420,11420,0,11,1836000.0
1836,1836999,21.983390249473945,38.29520870685783,0.05494759038787822,262.1205723285675,118.41455721855164,420.49606704711914,13202,1768,11434,11434,0,11,1837000.0
1837,1837999,21.98574164852738,38.29704952983291,0.05503150460178985,262.28081464767456,118.48014664649963,420.65545654296875,13204,1769,11435,11435,0,11,1838000.0
1838,1838999,21.988056434427808,38.298268603013106,0.05512525197550433,262.41032791137695,118.5454351902008,420.7846221923828,13204,1769,11435,11435,0,11,1839000.0
1839,1839999,21.991842328352714,38.302536254456335,0.055205016233818904,262.60376596450806,118.61204791069031,421.1279830932617,13227,1771,11456,11456,0,11,1840000.0
1840,1840999,21.99644295723992,38.310087420349234,0.055264120054111854,262.7281491756439,118.67810821533203,421.4186325073242,13228,1771,11457,11457,0,11,1841000.0
1841,1841999,22.00251819963971,38.317994321833936,0.05535507091696601,262.87983655929565,118.74366807937622,421.52904891967773,13231,1772,11459,11459,0,11,1842000.0
1842,1842999,22.008226481369526,38.3245082558843,0.055427459832874115,263.0465385913849,118.80907106399536,421.7090301513672,13264,1773,11491,11491,0,11,1843000.0
1843,1843999,22.014816112757032,38.333743622664514,0.05554511501394854,263.16775131225586,118.87383604049683,421.8076629638672,13264,1773,11491,11491,0,11,1844000.0
1844,1844999,22.021587096246012,38.352375916445055,0.05563710442600389,263.3931076526642,118.9390377998352,421.8800392150879,13277,1776,11501,11501,0,11,1845000.0
1845,1845999,22.025387818979205,38.35720540783052,0.055686807537073335,263.5170407295227,119.00340986251831,422.0219917297363,13277,1776,11501,11501,0,11,1846000.0
1846,1846999,22.023859174926887,38.35356626021103,0.055724820622464866,263.6350350379944,119.0682942867279,422.41498947143555,13289,1776,11513,11513,0,11,1847000.0
1847,1847999,22.01976536395754,38.348146645644356,0.05574042019826542,263.78919434547424,119.133553981781,422.6729393005371,13297,1777,11520,11520,0,11,1848000.0
1848,1848999,22.015776175380754,38.34157348663797,0.055750002050681924,263.9496262073517,119.20093655586243,422.86209869384766,13307,1778,11529,11529,0,11,1849000.0
1849,1849999,22.01200837609153,38.337622000158795,0.055753349857022516,264.07460618019104,119.26776671409607,423.1304130554199,13308,1778,11530,11530,0,11,1850000.0
1850,1850999,22.008587075951567,38.33218827734707,0.05575962125729428,264.26353454589844,119.3338303565979,423.20673751831055,13317,1780,11537,11537,0,11,1851000.0
1851,1851999,22.006244364754224,38.326551984067684,0.05575017207941735,264.38692331314087,119.39863991737366,423.44337463378906,13318,1780,11538,11538,0,11,1852000.0
1852,1852999,22.003612144590257,38.32106702283981,0.055744042467666954,264.5973103046417,119.46516370773315,423.5167236328125,13323,1782,11541,11541,0,11,1853000.0
1853,1853999,22.001518431722847,38.315999063305554,0.055737428775741615,264.7276785373688,119.53162598609924,423.7211608886719,13326,1782,11544,11544,0,11,1854000.0
1854,1854999,21.999841603369678,38.3110533200585,0.055728424830414736,264.8510494232178,119.59642457962036,423.83275604248047,13326,1782,11544,11544,0,11,1855000.0
1855,1855999,21.99950748678024,38.30808361138896,0.05572308973666806,265.0188217163086,119.66163778305054,423.8500442504883,13328,1783,11545,11545,0,11,1856000.0
1856,1856999,21.998312037591965,38.303823644944245,0.05574047067754084,265.14550852775574,119.7258768081665,423.93999099731445,13328,1783,11545,11545,0,11,1857000.0
1857,1857999,21.998137632869607,38.301796357111314,0.055788942006511744,265.3265731334686,119.79093360900879,424.14176177978516,13335,1785,11550,11550,0,11,1858000.0
1858,1858999,21.99850959221624,38.30019767050663,0.05582323185723026,265.4858090877533,119.85630869865417,424.29631423950195,13337,1786,11551,11551,0,11,1859000.0
1859,1859999,21.999915597334976,38.30176459272079,0.055881598861287296,265.62046933174133,119.92117381095886,424.4251899719238,13337,1786,11551,11551,0,11,1860000.0
1860,1860999,22.001602993784296,38.30150472690409,0.05591850214196059,265.74816131591797,119.98629999160767,424.6679382324219,13341,1786,11555,11555,0,11,1861000.0
1861,1861999,22.004864235266087,38.304627485005916,0.05597551076964258,265.93655800819397,120.05192565917969,424.7277946472168,13345,1788,11557,11557,0,11,1862000.0
1862,1862999,22.00778199292119,38.306385476195196,0.056032841874189665,266.0971167087555,120.1174430847168,424.78723526000977,13348,1789,11559,11559,0,11,1863000.0
1863,1863999,22.01109843895072,38.30821893083216,0.05607543518909042,266.22387886047363,120.18246603012085,424.9902458190918,13350,1789,11561,11561,0,11,1864000.0
1864,1864999,22.014435170656967,38.31057171335061,0.05614448678650508,266.35480308532715,120.24731421470642,425.10628509521484,13350,1789,11561,11561,0,11,1865000.0
1865,1865999,22.01745864001578,38.311749087177915,0.05620066904244014,266.4840123653412,120.31166362762451,425.25372314453125,13352,1789,11563,11563,0,11,1866000.0
1866,1866999,22.018335375275143,38.31004700966211,0.05623424467243188,266.606388092041,120.37606406211853,425.39366149902344,13352,1789,11563,11563,0,11,1867000.0
1867,1867999,22.01605817964376,38.31037884656545,0.05622637346763426,266.72149896621704,120.44005560874939,425.67679595947266,13357,1789,11568,11568,0,11,1868000.0
1868,1868999,22.01051756945759,38.30252729622493,0.05625177031806783,266.8529601097107,120.50693702697754,425.96307373046875,13359,1789,11570,11570,0,11,1869000.0
1869,1869999,22.00648490211138,38.30034793547544,0.056262307959007885,267.01162028312683,120.57288384437561,426.1259346008301,13366,1790,11576,11576,0,11,1870000.0
1870,1870999,22.002395393479187,38.294224812681634,0.05628264111704839,267.17400217056274,120.6399097442627,426.21635818481445,13368,1791,11577,11577,0,11,1871000.0
1871,1871999,21.99827983411263,38.28753111519759,0.05629764680233451,267.3582751750946,120.70601415634155,426.2462158203125,13378,1793,11585,11585,0,11,1872000.0
1872,1872999,21.994597878076636,38.281500206224955,0.05629344826286098,267.6087794303894,120.77303266525269,426.42665100097656,13420,1797,11623,11623,0,11,1873000.0
1873,1873999,21.99152125069631,38.275066970583595,0.056300850634446786,267.776894569397,120.83888816833496,426.59051513671875,13422,1798,11624,11624,0,11,1874000.0
1874,1874999,21.988919942385085,38.27067894527042,0.056295595894105266,267.9375669956207,120.91023802757263,426.73098373413086,13426,1799,11627,11627,0,11,1875000.0
1875,1875999,21.98668402890988,38.26565841342212,0.056292092758888024,268.0606551170349,120.97495555877686,426.8338203430176,13426,1799,11627,11627,0,11,1876000.0
1876,1876999,21.984714023439896,38.26212406899198,0.05628903573909605,268.3192365169525,121.04024243354797,426.7110366821289,13437,1803,11634,11634,0,11,1877000.0
1877,1877999,21.983138028435636,38.260311415376876,0.05627618257682321,268.49918484687805,121.1054277420044,426.82746505737305,13471,1805,11666,11666,0,11,1878000.0
1878,1878999,21.98227038887208,38.25754485956246,0.05631871201979899,268.62786197662354,121.17509078979492,427.2588081359863,13482,1805,11677,11677,0,11,1879000.0
1879,1879999,21.98192287331162,38.25496431310173,0.05635123771957218,268.7595760822296,121.23972368240356,427.41049575805664,13483,1805,11678,11678,0,11,1880000.0
1880,1880999,21.981860672381867,38.258477667801316,0.056368239131137754,268.97593688964844,121.30766487121582,427.41264724731445,13498,1808,11690,11690,0,11,1881000.0
1881,1881999,21.98240075422683,38.256572792066365,0.05638883785864235,269.12963104248047,121.37284064292908,427.6373291015625,13508,1809,11699,11699,0,11,1882000.0
1882,1882999,21.98382059267396,38.255522716847466,0.056438842801374456,269.32951307296753,121.44579291343689,427.70666885375977,13518,1811,11707,11707,0,11,1883000.0
1883,1883999,21.984823431241274,38.253904771653865,0.056482740298605894,269.4765875339508,121.5111358165741,427.7898178100586,13521,1812,11709,11709,0,11,1884000.0
1884,1884999,21.987049249244,38.255294164409975,0.0565330171217574,269.6689748764038,121.57582950592041,427.9750862121582,13529,1814,11715,11715,0,11,1885000.0
1885,1885999,21.988200420685242,38.2541122120178,0.05661044414529115,269.8180742263794,121.64016008377075,428.0924644470215,13532,1815,11717,11717,0,11,1886000.0
1886,1886999,21.988704287540852,38.251640795521844,0.056670884568277735,270.00135922431946,121.7044849395752,428.12854385375977,13537,1817,11720,11720,0,11,1887000.0
1887,1887999,21.98913375652917,38.24949937049923,0.056701940096554826,270.1828134059906,121.768625497818,428.22010803222656,13546,1819,11727,11727,0,11,1888000.0
1888,1888999,21.98665324508887,38.24373047102816,0.05670225881701296,270.31046414375305,121.8337709903717,428.6504096984863,13559,1819,11740,11740,0,11,1889000.0
1889,1889999,21.98240658920054,38.23679765514839,0.05673063558433644,270.4614107608795,121.89960765838623,428.9816474914551,13564,1820,11744,11744,0,11,1890000.0
1890,1890999,21.97984470398164,38.233003165209965,0.0567496987817927,270.6062295436859,121.97570061683655,429.1774559020996,13565,1820,11745,11745,0,11,1891000.0
1891,1891999,21.976336754803945,38.22678355200977,0.056771840786676186,270.7609963417053,122.04093170166016,429.2494430541992,13568,1821,11747,11747,0,11,1892000.0
1892,1892999,21.973222072636407,38.220670742894114,0.056770817180967326,270.91333770751953,122.10623264312744,429.50643157958984,13573,1822,11751,11751,0,11,1893000.0
1893,1893999,21.971032545574307,38.2162797476661,0.056775456666677604,271.0609140396118,122.17111277580261,429.6868591308594,13576,1823,11753,11753,0,11,1894000.0
1894,1894999,21.968770915737924,38.21362450063065,0.05678336253182592,271.17305850982666,122.23563766479492,429.8589515686035,13576,1823,11753,11753,0,11,1895000.0
1895,1895999,21.967154675609873,38.2110955144785,0.05676815974077232,271.3313579559326,122.30135893821716,430.1546325683594,13587,1824,11763,11763,0,11,1896000.0
1896,1896999,21.96517805809508,38.20622620951264,0.056759471618965995,271.45689034461975,122.36615085601807,430.3107261657715,13587,1824,11763,11763,0,11,1897000.0
1897,1897999,21.96246847698591,38.200977254876754,0.05675252148303356,271.64790320396423,122.4314546585083,430.3698616027832,13592,1826,11766,11766,0,11,1898000.0
1898,1898999,21.96134047670013,38.19781556660647,0.05672693702362763,271.79449677467346,122.49762463569641,430.9231834411621,13607,1827,11780,11780,0,11,1899000.0
1899,1899999,21.95952986079439,38.19566489555524,0.056712862785054274,271.94396924972534,122.56297755241394,431.14047622680664,13615,1828,11787,11787,0,11,1900000.0
1900,1900999,21.957172225350998,38.189928830164284,0.056696998741964544,272.0717215538025,122.62821435928345,431.38321685791016,13620,1828,11792,11792,0,11,1901000.0
1901,1901999,21.955936522465997,38.185125596677956,0.05668245603519151,272.24620032310486,122.69407248497009,431.54358673095703,13660,1830,11830,11830,0,11,1902000.0
1902,1902999,21.95482777169915,38.181013264014865,0.05666800934408922,272.3980152606964,122.75897264480591,431.6424446105957,13663,1831,11832,11832,0,11,1903000.0
1903,1903999,21.955635149853872,38.178309321123315,0.05662639088704824,272.5861942768097,122.82423877716064,431.76303482055664,13668,1833,11835,11835,0,11,1904000.0
1904,1904999,21.95510737045326,38.17388849897945,0.05660190620939676,272.7092614173889,122.88894081115723,431.8612823486328,13668,1833,11835,11835,0,11,1905000.0
1905,1905999,21.95453533462195,38.1696497533712,0.05657178679331032,272.89481353759766,122.95330166816711,431.9617500305176,13675,1835,11840,11840,0,11,1906000.0
1906,1906999,21.951945132360603,38.16455113581001,0.05656765656417917,273.04883766174316,123.01865029335022,432.2792778015137,13688,1836,11852,11852,0,11,1907000.0
1907,1907999,21.947601603027927,38.15914089223252,0.05659353177524473,273.2322280406952,123.08504366874695,432.5985336303711,13695,1838,11857,11857,0,11,1908000.0
1908,1908999,21.943274604063944,38.15390194810116,0.05662622056603139,273.36875224113464,123.15047001838684,432.79679107666016,13695,1838,11857,11857,0,11,1909000.0
1909,1909999,21.938888962373948,38.148171187539994,0.05666163692274384,273.49616837501526,123.216628074646,432.9295425415039,13695,1838,11857,11857,0,11,1910000.0
1910,1910999,21.934799512900277,38.14203733589349,0.05669508642771104,273.62320923805237,123.2818603515625,433.17848205566406,13697,1838,11859,11859,0,11,1911000.0
1911,1911999,21.931153840956025,38.13540379151424,0.056730396220544654,273.7499465942383,123.34608745574951,433.3124809265137,13697,1838,11859,11859,0,11,1912000.0
1912,1912999,21.92668343051881,38.12799626583971,0.05676407561190833,273.8765482902527,123.41078567504883,433.4818344116211,13698,1838,11860,11860,0,11,1913000.0
1913,1913999,21.923273974422205,38.121840246794186,0.056787583948400555,274.0193109512329,123.47536754608154,433.5984230041504,13699,1838,11861,11861,0,11,1914000.0
1914,1914999,21.920062605741013,38.120766426138445,0.056796129253485095,274.17712330818176,123.54087328910828,433.6612968444824,13701,1839,11862,11862,0,11,1915000.0
1915,1915999,21.917252328416232,38.116933012878825,0.05680670242429153,274.2958769798279,123.60478019714355,433.7792434692383,13701,1839,11862,11862,0,11,1916000.0
1916,1916999,21.914041966307973,38.1112645510489,0.056830856297210186,274.47313809394836,123.66978287696838,434.0988578796387,13712,1841,11871,11871,0,11,1917000.0
1917,1917999,21.911171682881278,38.10664404924504,0.05685209382086198,274.6616187095642,123.7351803779602,434.16315841674805,13719,1843,11876,11876,0,11,1918000.0
1918,1918999,21.908918716846838,38.114635073817276,0.05682234879628001,274.7845227718353,123.79959893226624,434.285343170166,13719,1843,11876,11876,0,11,1919000.0
1919,1919999,21.907364143443733,38.11152610799381,0.05682883173226194,274.8980665206909,123.86518502235413,434.6158790588379,13724,1843,11881,11881,0,11,1920000.0
1920,1920999,21.90646838884875,38.109878020264375,0.05684382975451241,275.08316922187805,123.93036222457886,434.6850891113281,13729,1845,11884,11884,0,11,1921000.0
1921,1921999,21.905736085741232,38.10928743669938,0.056827305164138475,275.2130880355835,123.99491834640503,434.83921813964844,13730,1845,11885,11885,0,11,1922000.0
1922,1922999,21.90403600693351,38.10425000884752,0.056830968748025734,275.3445408344269,124.05940794944763,434.9358901977539,13730,1845,11885,11885,0,11,1923000.0
1923,1923999,21.902823851276494,38.100488052715484,0.05685639856062896,275.4987750053406,124.12340688705444,434.96718978881836,13733,1846,11887,11887,0,11,1924000.0
1924,1924999,21.900454834893566,38.095473144509576,0.05686605221152852,275.6544861793518,124.18849205970764,435.1002197265625,13739,1847,11892,11892,0,11,1925000.0
1925,1925999,21.898011745580796,38.09020211096357,0.056886383496569826,275.7765471935272,124.25294280052185,435.25907135009766,13739,1847,11892,11892,0,11,1926000.0
1926,1926999,21.894632250379935,38.08768702981116,0.05685755761282296,275.8920154571533,124.31766653060913,435.62143325805664,13748,1847,11901,11901,0,11,1927000.0
1927,1927999,21.889334706353917,38.08300554481804,0.056873419144879755,276.01120138168335,124.3821325302124,435.90765380859375,13749,1847,11902,11902,0,11,1928000.0
1928,1928999,21.884102815420285,38.076329248910575,0.056895037802356385,276.2097821235657,124.44884133338928,435.98069763183594,13755,1849,11906,11906,0,11,1929000.0
1929,1929999,21.87994185574041,38.072461204596614,0.05689913107834643,276.3325436115265,124.51410460472107,436.1423568725586,13755,1849,11906,11906,0,11,1930000.0
1930,1930999,21.875353016658295,38.06568147961612,0.05692178981162688,276.5156190395355,124.57958459854126,436.2051010131836,13772,1851,11921,11921,0,11,1931000.0
1931,1931999,21.870823176129818,38.05863599953196,0.056941151547897695,276.643027305603,124.64340806007385,436.4577293395996,13774,1851,11923,11923,0,11,1932000.0
1932,1932999,21.866829984468875,38.05182916382783,0.056949612120489324,276.82479643821716,124.70775651931763,436.473445892334,13784,1853,11931,11931,0,11,1933000.0
1933,1933999,21.86277613639068,38.04565926305063,0.05696294350400388,276.9615159034729,124.77386260032654,436.6748046875,13786,1853,11933,11933,0,11,1934000.0
1934,1934999,21.8591483628476,38.0401921256031,0.056966860590721646,277.10154914855957,124.83832907676697,436.7589988708496,13786,1853,11933,11933,0,11,1935000.0
1935,1935999,21.855222572043118,38.03387276962142,0.0569783794129789,277.21772742271423,124.90253829956055,436.8536796569824,13786,1853,11933,11933,0,11,1936000.0
1936,1936999,21.851852526443615,38.02799664444484,0.056991876115867646,277.3891739845276,124.96719026565552,436.931640625,13791,1854,11937,11937,0,11,1937000.0
1937,1937999,21.849505786863645,38.02520750720503,0.05699057291052645,277.5369236469269,125.03175139427185,437.2175178527832,13800,1855,11945,11945,0,11,1938000.0
1938,1938999,21.84599289584296,38.019686913888776,0.05700263786058146,277.72893047332764,125.09747314453125,437.3032569885254,13804,1857,11947,11947,0,11,1939000.0
1939,1939999,21.8432083373754,38.01423849539433,0.05699956717554322,277.92023229599,125.16300630569458,437.38154220581055,13808,1859,11949,11949,0,11,1940000.0
1940,1940999,21.840691529147765,38.0101132140527,0.056991788308815905,278.06536960601807,125.22834658622742,437.6802520751953,13815,1860,11955,11955,0,11,1941000.0
1941,1941999,21.838696212171516,38.006326537481925,0.05699369544000288,278.28457498550415,125.2947404384613,437.69804763793945,13829,1863,11966,11966,0,11,1942000.0
1942,1942999,21.83667397775221,38.0011439330103,0.05698934909961262,278.4117212295532,125.35989093780518,437.9376029968262,13833,1863,11970,11970,0,11,1943000.0
1943,1943999,21.83597729498336,38.00096092219356,0.05694916623357105,278.56712532043457,125.42492723464966,438.09925842285156,13836,1864,11972,11972,0,11,1944000.0
1944,1944999,21.834303254497826,37.995687375424154,0.05695420565527931,278.7555959224701,125.48991203308105,438.122257232666,13842,1866,11976,11976,0,11,1945000.0
1945,1945999,21.832420180456285,37.99060460475367,0.056941685386175944,278.9073166847229,125.5553572177887,438.4106979370117,13849,1867,11982,11982,0,11,1946000.0
1946,1946999,21.82933555621283,37.984712868512155,0.05694360505256246,279.0244359970093,125.61918306350708,438.6190605163574,13849,1867,11982,11982,0,11,1947000.0
1947,1947999,21.825740646928548,37.97903814876939,0.056952091069896404,279.1456809043884,125.68391513824463,439.0513114929199,13860,1867,11993,11993,0,11,1948000.0
1948,1948999,21.820375426597845,37.97263475451032,0.0569736870319959,279.2604603767395,125.74930715560913,439.4247856140137,13862,1867,11995,11995,0,11,1949000.0
1949,1949999,21.815288973581435,37.96608658149327,0.0570012182483105,279.4237756729126,125.81582689285278,439.6215629577637,13865,1868,11997,11997,0,11,1950000.0
1950,1950999,21.81102358067889,37.9618160161395,0.057010180129371535,279.5501503944397,125.88118720054626,439.8209342956543,13866,1868,11998,11998,0,11,1951000.0
1951,1951999,21.80638787116604,37.954797788209596,0.05703364693181401,279.68298268318176,125.94672560691833,440.0477294921875,13868,1868,12000,12000,0,11,1952000.0
1952,1952999,21.802194797749415,37.94836798349664,0.05704113410664302,279.85114336013794,126.01094889640808,440.21301651000977,13870,1869,12001,12001,0,11,1953000.0
1953,1953999,21.79791388285993,37.94197922124134,0.05705695132031241,279.9998526573181,126.07504367828369,440.3014717102051,13872,1870,12002,12002,0,11,1954000.0
1954,1954999,21.7935838661936,37.93475507214753,0.05707358901864856,280.12740087509155,126.13959312438965,440.5114936828613,13872,1870,12002,12002,0,11,1955000.0
1955,1955999,21.78950675986334,37.92989680612187,0.05706782833780755,280.25258588790894,126.20421719551086,440.6659393310547,13872,1870,12002,12002,0,11,1956000.0
1956,1956999,21.785587199857485,37.92401940220321,0.057101381968098885,280.4080400466919,126.26919317245483,440.71667098999023,13874,1871,12003,12003,0,11,1957000.0
1957,1957999,21.78273292215221,37.92091631412527,0.057101191907020454,280.54635524749756,126.33482384681702,441.02668380737305,13880,1871,12009,12009,0,11,1958000.0
1958,1958999,21.779607339939112,37.91814241345553,0.05708090030816737,280.66383624076843,126.39926314353943,441.2990379333496,13880,1871,12009,12009,0,11,1959000.0
1959,1959999,21.776439223049852,37.9137331454289,0.05709507911643197,280.85991191864014,126.46857810020447,441.39786529541016,13890,1873,12017,12017,0,11,1960000.0
1960,1960999,21.77362153758816,37.90835485817962,0.057091207224884144,281.0455975532532,126.5347375869751,441.470645904541,13894,1875,12019,12019,0,11,1961000.0
1961,1961999,21.7707219263429,37.90254071403824,0.057097707053918034,281.19678711891174,126.60061359405518,441.74435806274414,13901,1876,12025,12025,0,11,1962000.0
1962,1962999,21.768680441536517,37.89836423198326,0.057116466906035446,281.35077261924744,126.66554427146912,441.88486099243164,13903,1877,12026,12026,0,11,1963000.0
1963,1963999,21.76700788092489,37.89475175634906,0.057099746399630225,281.5016577243805,126.73049998283386,442.0860786437988,13912,1878,12034,12034,0,11,1964000.0
1964,1964999,21.76447622021422,37.88939661260754,0.05709731492774606,281.6156370639801,126.79539513587952,442.22889709472656,13912,1878,12034,12034,0,11,1965000.0
1965,1965999,21.763005858156596,37.88897627006311,0.05708595273605788,281.77022552490234,126.85944056510925,442.29527282714844,13914,1879,12035,12035,0,11,1966000.0
1966,1966999,21.76034622116457,37.88339862770582,0.05708598147511135,281.90101504325867,126.92725276947021,442.57633209228516,13918,1879,12039,12039,0,11,1967000.0
1967,1967999,21.75843633599,37.87891196777487,0.057089141898301055,282.0562753677368,126.99103617668152,442.709774017334,13920,1880,12040,12040,0,11,1968000.0
1968,1968999,21.756621609512774,37.881475852380355,0.057062939282032765,282.17718839645386,127.05614733695984,443.0435676574707,13927,1880,12047,12047,0,11,1969000.0
1969,1969999,21.75615676229763,37.88917664089201,0.057050665193623895,282.29514503479004,127.12148857116699,443.36252212524414,13928,1880,12048,12048,0,11,1970000.0
1970,1970999,21.755094542013996,37.89101947493885,0.0570643593939657,282.44807028770447,127.18788599967957,443.5165824890137,13932,1881,12051,12051,0,11,1971000.0
1971,1971999,21.755800727692318,37.8963308360117,0.057086365678508555,282.5698211193085,127.25335550308228,443.65064239501953,13933,1881,12052,12052,0,11,1972000.0
1972,1972999,21.75722234158986,37.90279222390058,0.05705963053331653,282.69986057281494,127.32005453109741,443.9004707336426,13937,1881,12056,12056,0,11,1973000.0
1973,1973999,21.762003496215485,37.91986043976997,0.05698863670003118,282.8908758163452,127.38685035705566,444.0164985656738,13952,1883,12069,12069,0,11,1974000.0
1974,1974999,21.766408037123597,37.93285198316626,0.057000761410860856,283.0474832057953,127.45214009284973,444.1748237609863,13954,1884,12070,12070,0,11,1975000.0
1975,1975999,21.76993787155191,37.94367033670209,0.05704336581224234,283.1967558860779,127.51891732215881,444.4196128845215,13964,1885,12079,12079,0,11,1976000.0
1976,1976999,21.773996918803608,37.95569132044587,0.056920466264165026,283.36202359199524,127.58467054367065,444.56681060791016,13967,1886,12081,12081,0,11,1977000.0
1977,1977999,21.778284109359902,37.96757884696149,0.05691985038729608,283.53219079971313,127.65280055999756,444.66857528686523,13970,1887,12083,12083,0,11,1978000.0
1978,1978999,21.783180924025935,37.98015969212692,0.05690314301276489,283.65982723236084,127.71872758865356,445.1063232421875,13979,1887,12092,12092,0,11,1979000.0
1979,1979999,21.78818359105074,37.995752585278915,0.056916776502705324,283.77483201026917,127.78328227996826,445.2609672546387,13979,1887,12092,12092,0,11,1980000.0
1980,1980999,21.791707766618252,38.00303103793194,0.05695201502329128,283.9592227935791,127.84832429885864,445.31137466430664,13985,1889,12096,12096,0,11,1981000.0
1981,1981999,21.79520559853074,38.00779443418125,0.05696222791699823,284.0807116031647,127.9150857925415,445.75011825561523,13994,1889,12105,12105,0,11,1982000.0
1982,1982999,21.800144657016922,38.01573975235367,0.0570669580029759,284.2333731651306,127.98148775100708,445.8619155883789,13996,1890,12106,12106,0,11,1983000.0
1983,1983999,21.8045073250088,38.02430117352014,0.05708743567883956,284.3858504295349,128.04809951782227,446.0666275024414,14003,1891,12112,12112,0,11,1984000.0
1984,1984999,21.809173339425048,38.03290374819734,0.05705341223135185,284.5387361049652,128.11285710334778,446.1512641906738,14006,1892,12114,12114,0,11,1985000.0
1985,1985999,21.814348570056314,38.04393399130942,0.05707415558650453,284.6917607784271,128.17732763290405,446.2653465270996,14010,1893,12117,12117,0,11,1986000.0
1986,1986999,21.818330204328625,38.048354542476126,0.057094915620140574,284.81724858283997,128.24259161949158,446.4573402404785,14012,1893,12119,12119,0,11,1987000.0
1987,1987999,21.820226544268326,38.0483737264444,0.05709743071979423,284.94946575164795,128.30988097190857,446.56287384033203,14012,1893,12119,12119,0,11,1988000.0
1988,1988999,21.816767056312884,38.04615271676544,0.057100754413324184,285.0684583187103,128.37559866905212,447.06212615966797,14022,1893,12129,12129,0,11,1989000.0
1989,1989999,21.81365831855446,38.041309090906076,0.05710909807500941,285.25824880599976,128.44217014312744,447.41309356689453,14037,1895,12142,12142,0,11,1990000.0
1990,1990999,21.81253436846783,38.04127853994977,0.05709939061117508,285.3804726600647,128.50769424438477,447.603271484375,14038,1895,12143,12143,0,11,1991000.0
1991,1991999,21.810567587121326,38.03759118521882,0.05710020100517321,285.5032684803009,128.57294058799744,447.74413681030273,14038,1895,12143,12143,0,11,1992000.0
1992,1992999,21.810862488948516,38.038250836314226,0.05708018361916234,285.6574549674988,128.6378457546234,447.9492378234863,14042,1896,12146,12146,0,11,1993000.0
1993,1993999,21.811743567242573,38.03954478036135,0.057042635493846805,285.88883686065674,128.7029013633728,447.9781150817871,14050,1899,12151,12151,0,11,1994000.0
1994,1994999,21.813464176926207,38.04232419753555,0.057022306190575134,286.0856547355652,128.7688024044037,448.0388946533203,14056,1901,12155,12155,0,11,1995000.0
1995,1995999,21.815862984444646,38.04527160234014,0.05699315994060816,286.20559072494507,128.83356952667236,448.2992286682129,14059,1901,12158,12158,0,11,1996000.0
1996,1996999,21.819614371988333,38.05225875963359,0.05697828264943039,286.3324520587921,128.89849185943604,448.42929458618164,14060,1901,12159,12159,0,11,1997000.0
1997,1997999,21.82259858982423,38.057526623834256,0.05701104617291952,286.5586016178131,128.96366095542908,448.36447525024414,14069,1904,12165,12165,0,11,1998000.0
1998,1998999,21.828187929011047,38.06692889491185,0.05707699237116359,286.7092640399933,129.02835369110107,448.6687355041504,14081,1905,12176,12176,0,11,1999000.0
1999,1999999,21.83425884299706,38.07558589311143,0.05712868405086846,286.86772871017456,129.09313225746155,448.7381706237793,14083,1906,12177,12177,0,11,2000000.0
2000,2000999,21.840594102233148,38.086072358685726,0.05726107039308914,286.99314188957214,129.15788531303406,448.89074325561523,14083,1906,12177,12177,0,11,2001000.0
2001,2001999,21.847593518792426,38.096708506810295,0.05737562019852893,287.11448788642883,129.22382760047913,449.1735954284668,14087,1906,12181,12181,0,11,2002000.0
2002,2002999,21.853691015545373,38.104751728901576,0.05748954869724221,287.2660446166992,129.28880643844604,449.2850875854492,14089,1907,12182,12182,0,11,2003000.0
2003,2003999,21.86011206838807,38.12068849852874,0.05755636684934551,287.4540271759033,129.3538942337036,449.3053855895996,14094,1909,12185,12185,0,11,2004000.0
2004,2004999,21.8665421152413,38.12867429587556,0.057590671964509066,287.57672238349915,129.41837811470032,449.52145767211914,14096,1909,12187,12187,0,11,2005000.0
2005,2005999,21.872943663849167,38.13764504853195,0.05767264864723154,287.734867811203,129.48283314704895,449.5905647277832,14098,1910,12188,12188,0,11,2006000.0
2006,2006999,21.880166748404683,38.14803910597108,0.05780881810989591,287.889493227005,129.54729866981506,449.6703186035156,14102,1911,12191,12191,0,11,2007000.0
2007,2007999,21.884815742777217,38.153706533197955,0.05783456154379907,288.04055309295654,129.61322140693665,449.8560791015625,14113,1912,12201,12201,0,11,2008000.0
2008,2008999,21.884947409787525,38.15615876796749,0.05783928831746732,288.1854393482208,129.67727136611938,450.0867500305176,14121,1913,12208,12208,0,11,2009000.0
2009,2009999,21.880947584868668,38.15388107680654,0.05784481313920198,288.3049695491791,129.741765499115,450.35342025756836,14122,1913,12209,12209,0,11,2010000.0
2010,2010999,21.87727133566489,38.14868102434092,0.057860110705713064,288.4692077636719,129.8070170879364,450.4908638000488,14127,1914,12213,12213,0,11,2011000.0
2011,2011999,21.874115199099176,38.14426034831124,0.05785941979709919,288.589759349823,129.87261748313904,450.64494705200195,14127,1914,12213,12213,0,11,2012000.0
2012,2012999,21.87118978157551,38.151500920346706,0.05781252226788047,288.7863359451294,129.9385678768158,450.72343826293945,14134,1916,12218,12218,0,11,2013000.0
2013,2013999,21.868001004638902,38.145264261285874,0.05780190337730862,288.90452313423157,130.00266027450562,451.0346374511719,14137,1916,12221,12221,0,11,2014000.0
2014,2014999,21.86535403795239,38.140351127041185,0.05778954940103509,289.10636734962463,130.0688829421997,451.08159255981445,14143,1918,12225,12225,0,11,2015000.0
2015,2015999,21.862769945513456,38.135199967515454,0.05778180614152051,289.259211063385,130.13489294052124,451.33864974975586,14149,1919,12230,12230,0,11,2016000.0
2016,2016999,21.86001726973527,38.12999635606585,0.057772943539084354,289.42226672172546,130.20045614242554,451.4521255493164,14157,1920,12237,12237,0,11,2017000.0
2017,2017999,21.858391715154212,38.128155894613094,0.05777439551329855,289.61035990715027,130.26637864112854,451.5212707519531,14161,1922,12239,12239,0,11,2018000.0
2018,2018999,21.856959253969826,38.12455295287605,0.05777272244567899,289.8025724887848,130.33165073394775,451.5907211303711,14169,1924,12245,12245,0,11,2019000.0
2019,2019999,21.85656768937427,38.121902698314855,0.05779371333151606,289.9946041107178,130.39900469779968,451.945369720459,14185,1926,12259,12259,0,11,2020000.0
2020,2020999,21.856621161509338,38.1193617748118,0.05781691111109266,290.15169310569763,130.4642505645752,452.13326263427734,14216,1927,12289,12289,0,11,2021000.0
2021,2021999,21.857174648451647,38.118966333584936,0.057858644379992,290.30806183815,130.52893662452698,452.2513999938965,14218,1928,12290,12290,0,11,2022000.0
2022,2022999,21.858783339261805,38.119861107185386,0.0578967976339374,290.4981167316437,130.59414076805115,452.4515190124512,14227,1930,12297,12297,0,11,2023000.0
2023,2023999,21.861933450268562,38.125439042847546,0.05800244476422889,290.6577298641205,130.65921688079834,452.56945419311523,14235,1931,12304,12304,0,11,2024000.0
2024,2024999,21.867319226474674,38.13723140641803,0.05812319881690964,290.80530619621277,130.7243196964264,452.79676055908203,14241,1932,12309,12309,0,11,2025000.0
2025,2025999,21.87410652194404,38.14865973260675,0.058245902583816456,291.0579662322998,130.7895486354828,452.7990303039551,14259,1936,12323,12323,0,11,2026000.0
2026,2026999,21.87991171949572,38.16062230154929,0.05836435193952627,291.2485089302063,130.8555600643158,452.94970321655273,14297,1938,12359,12359,0,11,2027000.0
2027,2027999,21.88379457365246,38.16521380800554,0.05842109034904053,291.47119402885437,130.9204556941986,453.01274490356445,14311,1941,12370,12370,0,11,2028000.0
2028,2028999,21.884902781004904,38.1654560453887,0.058464612194773835,291.58735752105713,130.984219789505,453.1311798095703,14311,1941,12370,12370,0,11,2029000.0
2029,2029999,21.882834018187026,38.16455914067241,0.058456909934262,291.7675824165344,131.0506386756897,453.6070747375488,14334,1943,12391,12391,0,11,2030000.0
2030,2030999,21.880777152522203,38.16118267860568,0.05845199434459636,291.91857409477234,131.116277217865,453.927978515625,14339,1944,12395,12395,0,11,2031000.0
2031,2031999,21.87773706574501,38.156900106091456,0.058464664652022824,292.1050407886505,131.18305659294128,454.0456352233887,14346,1946,12400,12400,0,11,2032000.0
2032,2032999,21.8761778981703,38.1574089190253,0.05845922187266539,292.289381980896,131.24943852424622,454.1228218078613,14352,1948,12404,12404,0,11,2033000.0
2033,2033999,21.8739701623815,38.15278489416158,0.0584547434054129,292.44743490219116,131.3154275417328,454.4433479309082,14362,1949,12413,12413,0,11,2034000.0
2034,2034999,21.871881253376653,38.148477206790595,0.0584498281025847,292.607750415802,131.38078212738037,454.6339912414551,14365,1950,12415,12415,0,11,2035000.0
2035,2035999,21.870764205972826,38.145131243811996,0.05843304124862714,292.7605826854706,131.4474356174469,455.0358581542969,14378,1951,12427,12427,0,11,2036000.0
2036,2036999,21.869569542099466,38.14564377477292,0.058408840528801576,292.8820323944092,131.5134778022766,455.27143478393555,14378,1951,12427,12427,0,11,2037000.0
2037,2037999,21.868394797317087,38.14384296826064,0.05837137135370829,293.20490312576294,131.58050870895386,455.1673355102539,14393,1957,12436,12436,0,11,2038000.0
2038,2038999,21.867987293955263,38.14649217827888,0.05832951874427883,293.39114904403687,131.6469910144806,455.6937599182129,14411,1959,12452,12452,0,11,2039000.0
2039,2039999,21.867589073702117,38.14918456189236,0.05828723204231101,293.54779863357544,131.7129876613617,455.9753227233887,14420,1960,12460,12460,0,11,2040000.0
2040,2040999,21.865924788859495,38.1442215548136,0.05827541029771033,293.72952914237976,131.779705286026,456.0806579589844,14432,1962,12470,12470,0,11,2041000.0
2041,2041999,21.865840008963094,38.14139198062406,0.05823636150648204,293.90339279174805,131.84780645370483,456.40164947509766,14446,1963,12483,12483,0,11,2042000.0
2042,2042999,21.865921430136503,38.13853079960699,0.05820102347536105,294.025000333786,131.9137773513794,456.5674057006836,14446,1963,12483,12483,0,11,2043000.0
2043,2043999,21.86691330423242,38.13903375336512,0.05814807839038583,294.1778495311737,131.97972345352173,456.7133102416992,14450,1964,12486,12486,0,11,2044000.0
2044,2044999,21.868279038094443,38.140025759745754,0.058062513233853585,294.3287410736084,132.04441380500793,456.8274459838867,14452,1965,12487,12487,0,11,2045000.0
2045,2045999,21.868655652087625,38.13646964179518,0.05800839425322846,294.4746034145355,132.1084806919098,456.88061904907227,14456,1966,12490,12490,0,11,2046000.0
2046,2046999,21.867716991741688,38.13147107384944,0.05798239718522691,294.5945043563843,132.17312669754028,457.04608154296875,14457,1966,12491,12491,0,11,2047000.0
2047,2047999,21.865301766560457,38.12649150087198,0.0579492301161032,294.7096211910248,132.23926615715027,457.58091735839844,14469,1966,12503,12503,0,11,2048000.0
2048,2048999,21.864530299920602,38.12655812771858,0.0579110852280027,294.83303713798523,132.3047170639038,457.8278274536133,14469,1966,12503,12503,0,11,2049000.0
2049,2049999,21.863341108497895,38.12295990793881,0.05789665238170505,294.9920175075531,132.37017059326172,457.96395111083984,14473,1967,12506,12506,0,11,2050000.0
2050,2050999,21.862028430276304,38.12034419830568,0.05787688618586695,295.1451687812805,132.43669390678406,458.20729064941406,14485,1968,12517,12517,0,11,2051000.0
2051,2051999,21.861556862647983,38.11731259404668,0.057817477630610736,295.3360471725464,132.50177550315857,458.3168029785156,14492,1970,12522,12522,0,11,2052000.0
2052,2052999,21.860900512575284,38.11809340089833,0.05777517252394726,295.4522895812988,132.5672047138214,458.4504089355469,14492,1970,12522,12522,0,11,2053000.0
2053,2053999,21.862005383392574,38.12091596406093,0.05776913368725811,295.5708062648773,132.6331250667572,458.6403274536133,14493,1970,12523,12523,0,11,2054000.0
2054,2054999,21.863261409481478,38.12392050063081,0.057760266451400644,295.8083379268646,132.69997763633728,458.5591011047363,14503,1973,12530,12530,0,11,2055000.0
2055,2055999,21.864617104977594,38.12433202732744,0.057739028726650043,295.9585282802582,132.76657104492188,458.73023223876953,14507,1974,12533,12533,0,11,2056000.0
2056,2056999,21.867613906623518,38.13037198049122,0.0577740898732676,296.12505888938904,132.83231210708618,459.03661727905273,14517,1975,12542,12542,0,11,2057000.0
2057,2057999,21.870226096430528,38.138424241052796,0.05779458199177667,296.2752616405487,132.89723587036133,459.2141227722168,14520,1976,12544,12544,0,11,2058000.0
2058,2058999,21.87411118013309,38.14639208157603,0.057861368202883234,296.4001853466034,132.96238613128662,459.3253974914551,14520,1976,12544,12544,0,11,2059000.0
2059,2059999,21.87943861174472,38.1579727710558,0.05791081784686192,296.5882143974304,133.0292685031891,459.6258659362793,14531,1978,12553,12553,0,11,2060000.0
2060,2060999,21.88442597905122,38.165232468678454,0.05795855122176796,296.80545353889465,133.09513783454895,459.73852157592773,14546,1981,12565,12565,0,11,2061000.0
2061,2061999,21.8884553416353,38.16848830077887,0.058004433352447204,296.93623423576355,133.16024947166443,459.87440490722656,14546,1981,12565,12565,0,11,2062000.0
2062,2062999,21.8955108282621,38.178212746446405,0.05810329758713162,297.08667755126953,133.22624468803406,460.14599227905273,14555,1982,12573,12573,0,11,2063000.0
2063,2063999,21.901232473105456,38.190448209200504,0.0582169333880197,297.2070815563202,133.291987657547,460.27477264404297,14555,1982,12573,12573,0,11,2064000.0
2064,2064999,21.907076076293333,38.19824183426782,0.05827959881344513,297.46175265312195,133.35727739334106,460.3717155456543,14574,1986,12588,12588,0,11,2065000.0
2065,2065999,21.909843978006645,38.20257430175761,0.058328645228604814,297.57672929763794,133.42124390602112,460.54275131225586,14575,1986,12589,12589,0,11,2066000.0
2066,2066999,21.909798056612807,38.21175106950636,0.058293689911198654,297.69340777397156,133.48768067359924,460.9411849975586,14583,1986,12597,12597,0,11,2067000.0
2067,2067999,21.908543668911296,38.21078894047811,0.05828423214006129,297.8506419658661,133.55290389060974,461.20691680908203,14589,1987,12602,12602,0,11,2068000.0
2068,2068999,21.90763892833861,38.2080830508143,0.0582918786208817,298.01450300216675,133.6194987297058,461.49052810668945,14639,1988,12651,12651,0,11,2069000.0
2069,2069999,21.9070707924198,38.20769607390998,0.05827184618789771,298.1804826259613,133.68553471565247,461.76366424560547,14642,1989,12653,12653,0,11,2070000.0
2070,2070999,21.907920732868405,38.21230114056289,0.05822130364641109,298.37265849113464,133.75122213363647,461.9863052368164,14652,1991,12661,12661,0,11,2071000.0
2071,2071999,21.908680043024205,38.21192763769858,0.05818885672939922,298.5008225440979,133.8167200088501,462.184268951416,14652,1991,12661,12661,0,11,2072000.0
2072,2072999,21.90944198870061,38.211394880509104,0.058179827785195815,298.68899273872375,133.88178992271423,462.30073165893555,14659,1993,12666,12666,0,11,2073000.0
2073,2073999,21.911435478907304,38.213399964847866,0.05817106993648913,298.8441767692566,133.9483199119568,462.5320472717285,14669,1994,12675,12675,0,11,2074000.0
2074,2074999,21.912866114443823,38.21344456084906,0.05817659502020134,299.07811427116394,134.01432251930237,462.6075973510742,14705,1997,12708,12708,0,11,2075000.0
2075,2075999,21.915679262432135,38.2171068820991,0.0582443131648922,299.1968970298767,134.07992386817932,462.73614501953125,14705,1997,12708,12708,0,11,2076000.0
2076,2076999,21.920021997828,38.22372381526354,0.05830395208251504,299.3196339607239,134.14607119560242,463.07483291625977,14708,1997,12711,12711,0,11,2077000.0
2077,2077999,21.92352384825008,38.22670310043219,0.05835599982148676,299.446405172348,134.21068739891052,463.1804428100586,14708,1997,12711,12711,0,11,2078000.0
2078,2078999,21.926844505745382,38.22983041076848,0.05841106633097726,299.63887119293213,134.27578902244568,463.1878547668457,14715,1999,12716,12716,0,11,2079000.0
2079,2079999,21.93126668185831,38.237678603048515,0.05841180152069492,299.7524485588074,134.34112453460693,463.52534103393555,14720,1999,12721,12721,0,11,2080000.0
2080,2080999,21.934364357619796,38.23902262226253,0.05844079304679661,299.91138339042664,134.40682411193848,463.63998794555664,14724,2000,12724,12724,0,11,2081000.0
2081,2081999,21.93815283861182,38.24130575484688,0.05848325273103949,300.1283595561981,134.4724576473236,463.6471633911133,14733,2003,12730,12730,0,11,2082000.0
2082,2082999,21.94196192520361,38.24922224230667,0.05844797579330674,300.31804490089417,134.53811621665955,463.90184783935547,14747,2005,12742,12742,0,11,2083000.0
2083,2083999,21.944760523139,38.250364547923525,0.05848133636111641,300.500497341156,134.6028025150299,463.9516258239746,14754,2007,12747,12747,0,11,2084000.0
2084,2084999,21.94746060824425,38.251219729055606,0.058491570762516876,300.62072372436523,134.66853666305542,464.2356300354004,14760,2007,12753,12753,0,11,2085000.0
2085,2085999,21.949346796822887,38.255420442637735,0.058506818652172665,300.735595703125,134.73254776000977,464.4260673522949,14760,2007,12753,12753,0,11,2086000.0
2086,2086999,21.948173011724798,38.253095961426745,0.05846233771407172,300.85534620285034,134.7977955341339,464.9430732727051,14774,2007,12767,12767,0,11,2087000.0
2087,2087999,21.944897880626108,38.248315610557384,0.058445198730008974,300.99407744407654,134.86370658874512,465.34133529663086,14777,2007,12770,12770,0,11,2088000.0
2088,2088999,21.941971322902297,38.24224046533464,0.058436124568042036,301.119873046875,134.92966651916504,465.5270652770996,14777,2007,12770,12770,0,11,2089000.0
2089,2089999,21.93947769353553,38.23869097114542,0.058412058684442436,301.28236961364746,134.9963457584381,465.68940353393555,14782,2008,12774,12774,0,11,2090000.0
2090,2090999,21.936267337715634,38.2334532745845,0.058405231128596746,301.3999252319336,135.06147146224976,465.94234466552734,14785,2008,12777,12777,0,11,2091000.0
2091,2091999,21.933100913822187,38.22735599601263,0.05839447227531691,301.5930142402649,135.12640738487244,466.1715202331543,14795,2010,12785,12785,0,11,2092000.0
2092,2092999,21.9302786956278,38.22181784768755,0.058395839833051744,301.7138695716858,135.1909339427948,466.37571716308594,14795,2010,12785,12785,0,11,2093000.0
2093,2093999,21.92797842888507,38.21652668531932,0.05837718390498836,301.8819890022278,135.2560784816742,466.584041595459,14801,2011,12790,12790,0,11,2094000.0
2094,2094999,21.926241874630765,38.21174209520349,0.058372575991352815,302.03514313697815,135.32125306129456,466.7621078491211,14810,2012,12798,12798,0,11,2095000.0
2095,2095999,21.924745804823196,38.20706669346323,0.05835836358133961,302.2033052444458,135.38702154159546,466.9611625671387,14816,2013,12803,12803,0,11,2096000.0
2096,2096999,21.924015781305645,38.20412412177567,0.05835943561474366,302.3540427684784,135.45211052894592,467.271053314209,14826,2014,12812,12812,0,11,2097000.0
2097,2097999,21.92273703695274,38.201005119718076,0.058379019953037514,302.47662901878357,135.51669001579285,467.46250915527344,14826,2014,12812,12812,0,11,2098000.0
2098,2098999,21.922204513220784,38.199446765387144,0.05838975269271307,302.6733009815216,135.5816068649292,467.5275459289551,14837,2016,12821,12821,0,11,2099000.0
2099,2099999,21.92241505071252,38.19846481411673,0.058396686386205765,302.7888922691345,135.64659547805786,467.77898025512695,14840,2016,12824,12824,0,11,2100000.0
2100,2100999,21.92271994019374,38.1970271549839,0.05843159718000235,302.9851655960083,135.7116551399231,467.9009895324707,14846,2018,12828,12828,0,11,2101000.0
2101,2101999,21.92428665733852,38.19700780941188,0.05852952724091087,303.1700985431671,135.77723503112793,468.1913833618164,14866,2020,12846,12846,0,11,2102000.0
2102,2102999,21.927699466154632,38.20023915173221,0.05858364555660356,303.3973352909088,135.8428192138672,468.4160270690918,14879,2023,12856,12856,0,11,2103000.0
2103,2103999,21.930778909051615,38.20342099191435,0.058659585547733095,303.5473372936249,135.90867471694946,468.6256446838379,14883,2024,12859,12859,0,11,2104000.0
2104,2104999,21.93302214680755,38.205304514134376,0.05873821020767833,303.7652711868286,135.97368717193604,468.68487548828125,14898,2027,12871,12871,0,11,2105000.0
2105,2105999,21.93472074119903,38.20527039581804,0.058786818485717096,303.95311641693115,136.03862953186035,469.0036926269531,14909,2029,12880,12880,0,11,2106000.0
2106,2106999,21.93285896085487,38.20075544658465,0.058800968446398816,304.0671660900116,136.10424709320068,469.3535804748535,14916,2029,12887,12887,0,11,2107000.0
2107,2107999,21.928486688584726,38.195541159417026,0.05882904951139023,304.1937029361725,136.1695785522461,469.70007705688477,14918,2029,12889,12889,0,11,2108000.0
2108,2108999,21.9249734769941,38.19088140528302,0.05883854864250149,304.3474419116974,136.23500680923462,469.82869720458984,14921,2030,12891,12891,0,11,2109000.0
2109,2109999,21.922589506960314,38.19167651027727,0.058833857958977887,304.54693603515625,136.30208134651184,469.92149353027344,14928,2032,12896,12896,0,11,2110000.0
2110,2110999,21.9185301362111,38.18533638951379,0.0588481580999779,304.7119574546814,136.36855936050415,470.0394630432129,14932,2033,12899,12899,0,11,2111000.0
2111,2111999,21.91706825840017,38.183478325869245,0.05881073179694096,304.8397719860077,136.43393516540527,470.34383392333984,14935,2033,12902,12902,0,11,2112000.0
2112,2112999,21.914156541744475,38.17769670890425,0.05880190517841666,304.9993212223053,136.4989767074585,470.4521713256836,14937,2034,12903,12903,0,11,2113000.0
2113,2113999,21.91164076895698,38.172743409660846,0.058793477943000494,305.11701798439026,136.565007686615,470.694522857666,14940,2034,12906,12906,0,11,2114000.0
2114,2114999,21.908999579677122,38.16770750099815,0.0587788812599338,305.3181402683258,136.63143825531006,470.7524719238281,14946,2036,12910,12910,0,11,2115000.0
2115,2115999,21.907301259824155,38.16364231303997,0.058750314983289864,305.5137152671814,136.69745230674744,470.8574104309082,14950,2038,12912,12912,0,11,2116000.0
2116,2116999,21.90571825110654,38.159095553236526,0.05872820044288252,305.63707852363586,136.7629587650299,471.20947647094727,14958,2038,12920,12920,0,11,2117000.0
2117,2117999,21.905148750669202,38.15595220301083,0.05867976223494098,305.7507789134979,136.82721495628357,471.5164985656738,14959,2038,12921,12921,0,11,2118000.0
2118,2118999,21.90480423531138,38.154218313758065,0.05865466325115953,305.9771707057953,136.8930163383484,471.54977798461914,14971,2041,12930,12930,0,11,2119000.0
2119,2119999,21.904326842585604,38.15153843785114,0.0586188572526547,306.16720724105835,136.9581117630005,471.6468505859375,14991,2043,12948,12948,0,11,2120000.0
2120,2120999,21.904978571225257,38.1492001000583,0.058567518562653076,306.40019273757935,137.02457427978516,472.09214782714844,15017,2046,12971,12971,0,11,2121000.0
2121,2121999,21.905669356783214,38.14826933401413,0.058527648022453804,306.52607011795044,137.09007620811462,472.32813262939453,15017,2046,12971,12971,0,11,2122000.0
2122,2122999,21.906886121519896,38.14612216698654,0.058498415748606036,306.68138122558594,137.15544080734253,472.5744972229004,15025,2047,12978,12978,0,11,2123000.0
2123,2123999,21.908306379896512,38.1447150668029,0.05847751839681026,306.838969707489,137.22010350227356,472.7326431274414,15027,2048,12979,12979,0,11,2124000.0
2124,2124999,21.91009580947295,38.14410075883638,0.05847675505193528,306.9866189956665,137.284973859787,472.84203338623047,15034,2049,12985,12985,0,11,2125000.0
2125,2125999,21.911475804158673,38.142572538707235,0.058475395378947526,307.18091583251953,137.34996461868286,472.9506416320801,15040,2051,12989,12989,0,11,2126000.0
2126,2126999,21.911479610620695,38.13956243625541,0.058440526136504856,307.41223549842834,137.41523337364197,473.01427841186523,15083,2054,13029,13029,0,11,2127000.0
2127,2127999,21.90786083274163,38.13284173351419,0.05846326465921625,307.56806683540344,137.480042219162,473.3921775817871,15099,2055,13044,13044,0,11,2128000.0
2128,2128999,21.90310806619772,38.125834399059485,0.058499656138624956,307.72275710105896,137.54505276679993,473.64912033081055,15102,2056,13046,13046,0,11,2129000.0
2129,2129999,21.89911205541848,38.120154246013,0.05852276242411836,307.8539011478424,137.61098909378052,473.8568687438965,15102,2056,13046,13046,0,11,2130000.0
2130,2130999,21.89561860695263,38.11567284250765,0.058547533881448954,307.9827666282654,137.6771478652954,473.9962615966797,15102,2056,13046,13046,0,11,2131000.0
2131,2131999,21.892215106700856,38.110364499420484,0.05856090079288123,308.1099498271942,137.74344635009766,474.1931800842285,15103,2056,13047,13047,0,11,2132000.0
2132,2132999,21.88875928313949,38.10438640494792,0.05857080314460461,308.3075842857361,137.80817985534668,474.2831039428711,15107,2058,13049,13049,0,11,2133000.0
2133,2133999,21.885749074352294,38.0993455024373,0.058568506523177355,308.4326455593109,137.87412762641907,474.4099807739258,15107,2058,13049,13049,0,11,2134000.0
2134,2134999,21.882204866941272,38.09305148951803,0.05857172164283997,308.5668661594391,137.9392819404602,474.6280212402344,15110,2058,13052,13052,0,11,2135000.0
2135,2135999,21.87905474482989,38.087365477216274,0.058576785581862856,308.72231554985046,138.00451922416687,474.6895980834961,15112,2059,13053,13053,0,11,2136000.0
2136,2136999,21.87609564375093,38.081425021971356,0.05857650732814079,308.86083579063416,138.06965804100037,474.78845596313477,15112,2059,13053,13053,0,11,2137000.0
2137,2137999,21.872849717331132,38.07533523583195,0.058571971830810865,309.06138491630554,138.13522577285767,474.95892333984375,15123,2061,13062,13062,0,11,2138000.0
2138,2138999,21.86958009120802,38.06957129518462,0.05856321999199332,309.2182354927063,138.19995713233948,475.15961837768555,15125,2062,13063,13063,0,11,2139000.0
2139,2139999,21.867064541522996,38.06501000159477,0.0585589757314261,309.40945529937744,138.26509881019592,475.33412170410156,15129,2064,13065,13065,0,11,2140000.0
2140,2140999,21.864100241525925,38.059678217629575,0.05854882267351724,309.57285618782043,138.3313171863556,475.5516242980957,15135,2065,13070,13070,0,11,2141000.0
2141,2141999,21.862771873141988,38.05577383403131,0.058517610778861195,309.7329568862915,138.39712953567505,475.86077880859375,15139,2066,13073,13073,0,11,2142000.0
2142,2142999,21.86129087962251,38.05162254218229,0.05848472602736832,309.9266233444214,138.46261405944824,475.9828453063965,15149,2068,13081,13081,0,11,2143000.0
2143,2143999,21.860645014310343,38.04808809662877,0.058460510170814994,310.08346581459045,138.52789449691772,476.2457084655762,15154,2069,13085,13085,0,11,2144000.0
2144,2144999,21.85944836588777,38.04346584223958,0.058445603775591826,310.2484323978424,138.593359708786,476.3734245300293,15161,2070,13091,13091,0,11,2145000.0
2145,2145999,21.858845588545318,38.04018419679764,0.058433210897101406,310.4062488079071,138.65839076042175,476.45720291137695,15163,2071,13092,13092,0,11,2146000.0
2146,2146999,21.85816595002954,38.036481973724676,0.05840065720751375,310.5746109485626,138.72315287590027,476.7322769165039,15170,2072,13098,13098,0,11,2147000.0
2147,2147999,21.855805827720605,38.031392048066316,0.05837784010283431,310.72245025634766,138.7886607646942,476.9071578979492,15172,2073,13099,13099,0,11,2148000.0
2148,2148999,21.850803816287307,38.024298587986735,0.058424444926191255,310.914510011673,138.85373330116272,477.1182632446289,15184,2075,13109,13109,0,11,2149000.0
2149,2149999,21.845630812759033,38.01727619624997,0.058469490177736505,311.0659890174866,138.91943502426147,477.4079933166504,15190,2076,13114,13114,0,11,2150000.0
2150,2150999,21.84103422712298,38.01106964645523,0.058511788401366616,311.2294478416443,138.9864478111267,477.53895568847656,15192,2077,13115,13115,0,11,2151000.0
2151,2151999,21.836818850346653,38.006540539165215,0.05854017165621117,311.3963346481323,139.05208277702332,477.5936050415039,15199,2078,13121,13121,0,11,2152000.0
2152,2152999,21.832604812183924,38.003354184203125,0.05856548604508616,311.51113057136536,139.11699843406677,477.807804107666,15201,2078,13123,13123,0,11,2153000.0
2153,2153999,21.828885555907064,37.9987191534352,0.05857643783726929,311.640483379364,139.1808512210846,477.94738006591797,15201,2078,13123,13123,0,11,2154000.0
2154,2154999,21.82472029432489,37.99282437134046,0.05859936741197225,311.8009340763092,139.2456340789795,478.0168151855469,15203,2079,13124,13124,0,11,2155000.0
2155,2155999,21.82117221355105,37.98873401107978,0.058603629024699955,311.99402356147766,139.31113052368164,478.13219833374023,15211,2081,13130,13130,0,11,2156000.0
2156,2156999,21.817542565954938,37.983218255454176,0.05861573580652757,312.1569035053253,139.37717151641846,478.1869316101074,15213,2082,13131,13131,0,11,2157000.0
2157,2157999,21.81406049480931,37.977324249224154,0.058622010062695074,312.32886004447937,139.443701505661,478.2631950378418,15215,2083,13132,13132,0,11,2158000.0
2158,2158999,21.810758588860182,37.97144222460908,0.05861454885555306,312.5271797180176,139.5096161365509,478.7698745727539,15241,2085,13156,13156,0,11,2159000.0
2159,2159999,21.808588598670205,37.967164224321124,0.05859594765195042,312.64229917526245,139.57418775558472,479.0215034484863,15241,2085,13156,13156,0,11,2160000.0
2160,2160999,21.806397971265987,37.96282243683752,0.05858587456195541,312.8656094074249,139.6394293308258,479.04980850219727,15250,2088,13162,13162,0,11,2161000.0
2161,2161999,21.80449535365122,37.95898558168494,0.05857883981052725,313.0977432727814,139.70564985275269,479.2446403503418,15277,2091,13186,13186,0,11,2162000.0
2162,2162999,21.80385755513133,37.96624978351467,0.058519318810731136,313.2628552913666,139.770751953125,479.4230194091797,15280,2092,13188,13188,0,11,2163000.0
2163,2163999,21.802987482123953,37.96340288072547,0.05849712465975465,313.42303800582886,139.83740782737732,479.50440979003906,15282,2093,13189,13189,0,11,2164000.0
2164,2164999,21.801528901879124,37.95907721979069,0.058484194610029405,313.53721928596497,139.90201878547668,479.8037986755371,15285,2093,13192,13192,0,11,2165000.0
2165,2165999,21.800005737502307,37.95565218010462,0.058467384388319776,313.73329615592957,139.96719932556152,479.89060974121094,15289,2095,13194,13194,0,11,2166000.0
2166,2166999,21.79816978803174,37.9513336235301,0.0584684125064201,313.85992336273193,140.03155207633972,480.04442596435547,15289,2095,13194,13194,0,11,2167000.0
2167,2167999,21.796458370287098,37.94688375830072,0.05845890697539824,314.01421093940735,140.0960190296173,480.1402397155762,15291,2096,13195,13195,0,11,2168000.0
2168,2168999,21.794143842958416,37.941604563568376,0.05844816323839119,314.17395520210266,140.15981006622314,480.2331008911133,15312,2097,13215,13215,0,11,2169000.0
2169,2169999,21.791261012627512,37.937158958827865,0.058454988320953194,314.2992808818817,140.22546815872192,480.71860122680664,15327,2097,13230,13230,0,11,2170000.0
2170,2170999,21.788299291216887,37.931708287351114,0.05847646460317979,314.4151759147644,140.2910840511322,481.0226707458496,15328,2097,13231,13231,0,11,2171000.0
2171,2171999,21.784905803426813,37.925670714237114,0.05853243941807684,314.64740800857544,140.35823273658752,481.0524482727051,15336,2100,13236,13236,0,11,2172000.0
2172,2172999,21.78244791224092,37.92204023951124,0.05854682162404101,314.84903621673584,140.4249677658081,481.1349678039551,15343,2102,13241,13241,0,11,2173000.0
2173,2173999,21.781389033057618,37.91906078431817,0.05851879467537335,315.01003789901733,140.49011373519897,481.3780326843262,15354,2103,13251,13251,0,11,2174000.0
2174,2174999,21.780455094076224,37.91630779766667,0.05849154816284774,315.1362988948822,140.55539846420288,481.5308532714844,15355,2103,13252,13252,0,11,2175000.0
2175,2175999,21.780553003447835,37.91431624944948,0.05842048894326435,315.2533550262451,140.6217029094696,481.74835205078125,15359,2103,13256,13256,0,11,2176000.0
2176,2176999,21.780330125967346,37.91120834667079,0.058364099040689954,315.44125151634216,140.6873321533203,481.7981643676758,15369,2105,13264,13264,0,11,2177000.0
2177,2177999,21.780137054095096,37.90792123755252,0.05831636557435638,315.6440782546997,140.75341939926147,481.86555099487305,15373,2107,13266,13266,0,11,2178000.0
2178,2178999,21.780017411978097,37.90552746996441,0.05821221112923358,315.77380180358887,140.82024502754211,482.43570709228516,15388,2107,13281,13281,0,11,2179000.0
2179,2179999,21.780282574180777,37.90355494116661,0.05811400964858815,315.942750453949,140.8941695690155,482.70654678344727,15390,2108,13282,13282,0,11,2180000.0
2180,2180999,21.779298210226326,37.89985093977965,0.058071044701343943,316.06044340133667,140.95961475372314,482.89300537109375,15390,2108,13282,13282,0,11,2181000.0
2181,2181999,21.77905790490099,37.89633296304719,0.058022867508745746,316.25586342811584,141.0255217552185,483.1123466491699,15408,2110,13298,13298,0,11,2182000.0
2182,2182999,21.77852337924794,37.89230943572397,0.05798308691267584,316.45465755462646,141.09142231941223,483.2498474121094,15421,2112,13309,13309,0,11,2183000.0
2183,2183999,21.77926631177673,37.889547334735006,0.05791743917959724,316.5767779350281,141.15709590911865,483.45960998535156,15423,2112,13311,13311,0,11,2184000.0
2184,2184999,21.780615261630658,37.8874947145206,0.057800489854911374,316.7038311958313,141.2221553325653,483.64228439331055,15424,2112,13312,13312,0,11,2185000.0
2185,2185999,21.780759072739766,37.88374594987072,0.05773587757346699,316.82046246528625,141.28632402420044,483.7996063232422,15426,2112,13314,13314,0,11,2186000.0
2186,2186999,21.779394844901553,37.879415846339384,0.05769638075870798,316.9383587837219,141.35074472427368,484.0614242553711,15431,2112,13319,13319,0,11,2187000.0
2187,2187999,21.776965647161955,37.87705155060442,0.05769605334975958,317.0581114292145,141.41626143455505,484.54602432250977,15438,2112,13326,13326,0,11,2188000.0
2188,2188999,21.774682289789038,37.87530550485984,0.057692287688615784,317.2481472492218,141.48321294784546,484.7523612976074,15443,2114,13329,13329,0,11,2189000.0
2189,2189999,21.772089636384813,37.87145708956611,0.05770191565712446,317.40678191185,141.54902458190918,484.86635971069336,15447,2115,13332,13332,0,11,2190000.0
2190,2190999,21.7693015304908,37.86628756806082,0.057711234238242204,317.62819147109985,141.61792087554932,485.0575180053711,15456,2117,13339,13339,0,11,2191000.0
2191,2191999,21.766748616079965,37.86090866386807,0.05770303161645718,317.77893567085266,141.68251872062683,485.2133102416992,15464,2118,13346,13346,0,11,2192000.0
2192,2192999,21.76401870852784,37.85843101855061,0.0576946060368595,317.9722752571106,141.74945831298828,485.2796211242676,15478,2120,13358,13358,0,11,2193000.0
2193,2193999,21.76179186802889,37.85309167099548,0.057664127198513215,318.09358501434326,141.8146059513092,485.5974884033203,15482,2120,13362,13362,0,11,2194000.0
2194,2194999,21.76002519810883,37.84879983567422,0.057632732339595205,318.3160707950592,141.88062930107117,485.6371078491211,15488,2123,13365,13365,0,11,2195000.0
2195,2195999,21.75809677136163,37.843781180549506,0.05760705530870913,318.4795198440552,141.94657969474792,485.81876373291016,15490,2124,13366,13366,0,11,2196000.0
2196,2196999,21.75705459196814,37.84005886288018,0.05754967860992011,318.63962602615356,142.0134150981903,486.19482040405273,15499,2125,13374,13374,0,11,2197000.0
2197,2197999,21.756639552072723,37.842518658320486,0.05748462026509016,318.7920653820038,142.07853841781616,486.41717529296875,15501,2126,13375,13375,0,11,2198000.0
2198,2198999,21.75550848225576,37.83917148987189,0.05743738842964474,319.0944776535034,142.14470219612122,486.35425567626953,15514,2131,13383,13383,0,11,2199000.0
2199,2199999,21.755153060231816,37.837271858670604,0.05739310414943588,319.24804735183716,142.21072936058044,486.7590637207031,15522,2132,13390,13390,0,11,2200000.0
2200,2200999,21.75504541682928,37.8354567439504,0.05734692058378188,319.4043734073639,142.27596473693848,486.9517250061035,15524,2133,13391,13391,0,11,2201000.0
2201,2201999,21.755668807859102,37.83751558371345,0.05729218165496275,319.63188791275024,142.34158968925476,486.9923400878906,15539,2136,13403,13403,0,11,2202000.0
2202,2202999,21.757497758639,37.83818489270864,0.05723074326665101,319.7960078716278,142.40706491470337,487.42572021484375,15547,2137,13410,13410,0,11,2203000.0
2203,2203999,21.7578942821742,37.83572900891795,0.05719013696285591,319.94862484931946,142.4718415737152,487.57799911499023,15549,2138,13411,13411,0,11,2204000.0
2204,2204999,21.758707998321835,37.83714333920283,0.057131886346510674,320.13968205451965,142.53762221336365,487.64595794677734,15555,2140,13415,13415,0,11,2205000.0
2205,2205999,21.758559168990462,37.83377750137957,0.0570912165925932,320.33119916915894,142.6026406288147,487.94114685058594,15564,2142,13422,13422,0,11,2206000.0
2206,2206999,21.757111270399292,37.82992192172852,0.05707120135207289,320.45184803009033,142.6668791770935,488.2568817138672,15571,2142,13429,13429,0,11,2207000.0
2207,2207999,21.753083619465574,37.82764542940392,0.05703717654845697,320.60540747642517,142.73147439956665,488.4815444946289,15584,2143,13441,13441,0,11,2208000.0
2208,2208999,21.74842382704431,37.82236554604288,0.05706678581548952,320.77075028419495,142.79819130897522,488.9156951904297,15587,2144,13443,13443,0,11,2209000.0
2209,2209999,21.74404510924205,37.81654513777431,0.057095688497711516,320.89544916152954,142.8639941215515,489.0877151489258,15587,2144,13443,13443,0,11,2210000.0
2210,2210999,21.739858770993408,37.81358201675091,0.057112935064682735,321.0546205043793,142.92960381507874,489.185848236084,15589,2145,13444,13444,0,11,2211000.0
2211,2211999,21.735484808559228,37.80703407611562,0.05714863264468473,321.21930146217346,142.99511456489563,489.3884048461914,15593,2146,13447,13447,0,11,2212000.0
2212,2212999,21.731151388405753,37.80118241686086,0.05716784428515864,321.3969705104828,143.0664246082306,489.51661682128906,15595,2147,13448,13448,0,11,2213000.0
2213,2213999,21.72691648512635,37.79454520719923,0.05719450031025708,321.54808616638184,143.13098168373108,489.6062469482422,15597,2148,13449,13449,0,11,2214000.0
2214,2214999,21.723375363993757,37.78890570052877,0.057209462958788926,321.68537640571594,143.19645714759827,489.79209899902344,15599,2148,13451,13451,0,11,2215000.0
2215,2215999,21.719525598655224,37.78281428696331,0.0572321161563103,321.84308886528015,143.2616584300995,489.8314514160156,15601,2149,13452,13452,0,11,2216000.0
2216,2216999,21.71621804315937,37.77703780220584,0.057248426450655865,322.0042724609375,143.32726955413818,489.9219398498535,15603,2150,13453,13453,0,11,2217000.0
2217,2217999,21.712949575474852,37.77136995917193,0.05726091815227652,322.1251525878906,143.39210867881775,490.2273406982422,15606,2150,13456,13456,0,11,2218000.0
2218,2218999,21.710076378405365,37.76687322114957,0.057258824641606476,322.27745938301086,143.4569194316864,490.3250923156738,15608,2151,13457,13457,0,11,2219000.0
2219,2219999,21.707217155763,37.7632018382461,0.057257090163268076,322.52532744407654,143.52246356010437,490.3650703430176,15621,2154,13467,13467,0,11,2220000.0
2220,2220999,21.70514925316407,37.75853704766493,0.05725528304829197,322.6493272781372,143.5935034751892,490.75186920166016,15626,2154,13472,13472,0,11,2221000.0
2221,2221999,21.703524761939843,37.75559133273012,0.0572358455093801,322.8018271923065,143.65812849998474,490.904541015625,15628,2155,13473,13473,0,11,2222000.0
2222,2222999,21.701722073299642,37.75146399035309,0.057229690537333844,322.9240081310272,143.72367787361145,491.05659103393555,15628,2155,13473,13473,0,11,2223000.0
2223,2223999,21.700124050542414,37.74665853186058,0.057217125663551416,323.0910680294037,143.7892985343933,491.47192764282227,15639,2156,13483,13483,0,11,2224000.0
2224,2224999,21.698963828189925,37.7474159969943,0.05720876136861541,323.24737787246704,143.8536581993103,491.59086990356445,15641,2157,13484,13484,0,11,2225000.0
2225,2225999,21.697275905871273,37.743318106572744,0.05721145057139243,323.47569823265076,143.91840624809265,491.61927032470703,15651,2160,13491,13491,0,11,2226000.0
2226,2226999,21.695187870516076,37.738206196970246,0.0572077284226461,323.66485571861267,143.9832239151001,491.85205078125,15660,2162,13498,13498,0,11,2227000.0
2227,2227999,21.692352947492214,37.732991893065204,0.05720924036366348,323.7817311286926,144.04754185676575,492.24495697021484,15672,2162,13510,13510,0,11,2228000.0
2228,2228999,21.688325370150345,37.72906309920092,0.057231577899567676,323.90399837493896,144.1124312877655,492.5895462036133,15677,2162,13515,13515,0,11,2229000.0
2229,2229999,21.684620970513674,37.7246758599463,0.05724932772504021,324.03046226501465,144.17780828475952,492.8130187988281,15677,2162,13515,13515,0,11,2230000.0
2230,2230999,21.680477056739196,37.718967353282615,0.057271221360779445,324.15357732772827,144.2433922290802,492.95825958251953,15677,2162,13515,13515,0,11,2231000.0
2231,2231999,21.677099554626633,37.71551163807786,0.05728206389215973,324.2807283401489,144.3092384338379,493.07673263549805,15677,2162,13515,13515,0,11,2232000.0
2232,2232999,21.67304753121267,37.70941178727065,0.057297935534037614,324.5052092075348,144.37413144111633,493.2424621582031,15686,2165,13521,13521,0,11,2233000.0
2233,2233999,21.66925979188876,37.70335306284896,0.05731730324413875,324.6335563659668,144.4384377002716,493.36149978637695,15686,2165,13521,13521,0,11,2234000.0
2234,2234999,21.666411971749348,37.698674888890636,0.05732328079464566,324.83215522766113,144.50353145599365,493.489990234375,15698,2167,13531,13531,0,11,2235000.0
2235,2235999,21.66344041344538,37.693189913918275,0.05732596187233474,324.9858822822571,144.56944370269775,493.611026763916,15706,2168,13538,13538,0,11,2236000.0
2236,2236999,21.661097651075934,37.688442233255444,0.05732591932480713,325.11285614967346,144.63568949699402,493.71651458740234,15706,2168,13538,13538,0,11,2237000.0
2237,2237999,21.659769024713633,37.68539059874446,0.057320342519409206,325.27672123908997,144.7019865512848,493.9602851867676,15714,2169,13545,13545,0,11,2238000.0
2238,2238999,21.659123771888652,37.68406405118016,0.057330653425595846,325.4374554157257,144.7670738697052,494.24531173706055,15725,2170,13555,13555,0,11,2239000.0
2239,2239999,21.65956115861582,37.69174700251602,0.05733202613580368,325.61501836776733,144.83332872390747,494.4236068725586,15729,2171,13558,13558,0,11,2240000.0
2240,2240999,21.66072222392668,37.703639600064676,0.05728009492438069,325.7772741317749,144.89842629432678,494.67912673950195,15739,2172,13567,13567,0,11,2241000.0
2241,2241999,21.661344792862618,37.71576842316204,0.05731322649827375,325.9398033618927,144.96456122398376,494.9066352844238,15745,2173,13572,13572,0,11,2242000.0
2242,2242999,21.664508566135886,37.73341792622477,0.05718928268228085,326.1699426174164,145.03145098686218,495.1155242919922,15759,2176,13583,13583,0,11,2243000.0
2243,2243999,21.666849626139655,37.73874213582239,0.057126917036331104,326.33010697364807,145.09633612632751,495.4049415588379,15763,2177,13586,13586,0,11,2244000.0
2244,2244999,21.667788868631998,37.74350014837917,0.057138511204951725,326.4613471031189,145.1615915298462,495.5699806213379,15763,2177,13586,13586,0,11,2245000.0
2245,2245999,21.668374450773463,37.74404764847307,0.05711506191011573,326.6884500980377,145.22632694244385,495.63367462158203,15772,2180,13592,13592,0,11,2246000.0
2246,2246999,21.668252035882887,37.74388995429978,0.05708990646560519,326.8826332092285,145.29124116897583,495.78922271728516,15780,2182,13598,13598,0,11,2247000.0
2247,2247999,21.666576471756414,37.74259229357904,0.05706618501682792,327.0395784378052,145.35593628883362,496.1117515563965,15799,2183,13616,13616,0,11,2248000.0
2248,2248999,21.665014362294933,37.74363753942062,0.057044549000397904,327.19842004776,145.4222071170807,496.36379623413086,15803,2184,13619,13619,0,11,2249000.0
2249,2249999,21.66412485895281,37.74544695351765,0.05704388617634093,327.3550658226013,145.48797345161438,496.6423873901367,15814,2185,13629,13629,0,11,2250000.0
2250,2250999,21.663029248911517,37.744957962155276,0.05704283812417721,327.6332323551178,145.55513095855713,496.6747055053711,15840,2189,13651,13651,0,11,2251000.0
2251,2251999,21.664251641759645,37.748199164234414,0.05702824722193556,327.7952516078949,145.62125754356384,496.97149658203125,15847,2190,13657,13657,0,11,2252000.0
2252,2252999,21.6666277977041,37.75223623904977,0.0570354385259183,327.96048164367676,145.6871373653412,497.2081985473633,15851,2191,13660,13660,0,11,2253000.0
2253,2253999,21.66867239635429,37.755800186677014,0.057045169726499645,328.0761332511902,145.752210855484,497.44271087646484,15852,2191,13661,13661,0,11,2254000.0
2254,2254999,21.672919972675587,37.76462975380843,0.05702800725428414,328.35065746307373,145.82881355285645,497.7455863952637,15865,2194,13671,13671,0,11,2255000.0
2255,2255999,21.676177445409802,37.76864345994125,0.057028055821576995,328.5450801849365,145.89564108848572,498.01374435424805,15877,2196,13681,13681,0,11,2256000.0
2256,2256999,21.680727133686126,37.77846141069388,0.05705216912648281,328.8081691265106,145.96245050430298,498.2130889892578,15901,2200,13701,13701,0,11,2257000.0
2257,2257999,21.685536022511492,37.78925109007299,0.05709764514290072,328.9724831581116,146.0296769142151,498.75048828125,15913,2201,13712,13712,0,11,2258000.0
2258,2258999,21.68990174998319,37.796226229935165,0.05715554186173866,329.0899794101715,146.09458088874817,499.0033645629883,15913,2201,13712,13712,0,11,2259000.0
2259,2259999,21.693498913739308,37.801791161653874,0.05717904030843357,329.24696612358093,146.16036772727966,499.1221923828125,15918,2202,13716,13716,0,11,2260000.0
2260,2260999,21.696817444035766,37.80772381487382,0.057189255854859566,329.40518379211426,146.2271065711975,499.62096405029297,15932,2203,13729,13729,0,11,2261000.0
2261,2261999,21.70060714018056,37.813019908154295,0.05724450502568701,329.5969967842102,146.29400849342346,499.81472396850586,15938,2205,13733,13733,0,11,2262000.0
2262,2262999,21.70470613766728,37.81869032594213,0.05726385897146857,329.7935972213745,146.36071634292603,500.02549743652344,15949,2207,13742,13742,0,11,2263000.0
2263,2263999,21.70783566210792,37.82151549049951,0.05727159698437889,329.9618413448334,146.43199253082275,500.3512191772461,15954,2208,13746,13746,0,11,2264000.0
2264,2264999,21.709717143892803,37.82211406460946,0.05729743088395467,330.08422446250916,146.49786734580994,500.4910774230957,15954,2208,13746,13746,0,11,2265000.0
2265,2265999,21.712070998676936,37.822786207149576,0.057311353606584015,330.2379357814789,146.5626060962677,500.68504333496094,15962,2209,13753,13753,0,11,2266000.0
2266,2266999,21.712229544557882,37.819992412889654,0.057310929300712465,330.4280607700348,146.62778997421265,500.80090713500977,15970,2211,13759,13759,0,11,2267000.0
2267,2267999,21.709831829465305,37.8178133388952,0.05729156688401926,330.54543352127075,146.69235181808472,501.22637939453125,15984,2211,13773,13773,0,11,2268000.0
2268,2268999,21.705997924600876,37.812876707857384,0.05730513069795384,330.70574378967285,146.75956988334656,501.5369071960449,15989,2212,13777,13777,0,11,2269000.0
2269,2269999,21.702450985543585,37.80811900785653,0.057314190999148695,330.8975703716278,146.8254313468933,501.6828384399414,16001,2214,13787,13787,0,11,2270000.0
2270,2270999,21.69965191095453,37.80453959706398,0.057315313394372014,331.06177282333374,146.89127659797668,501.8351249694824,16003,2215,13788,13788,0,11,2271000.0
2271,2271999,21.696494013812902,37.79972036734555,0.057318955233211955,331.17743492126465,146.95738577842712,502.1354751586914,16005,2215,13790,13790,0,11,2272000.0
2272,2272999,21.694256942088234,37.79567702270778,0.05731786798378791,331.40727257728577,147.022522687912,502.2202911376953,16011,2218,13793,13793,0,11,2273000.0
2273,2273999,21.692379459686347,37.79230451993165,0.057321719105409286,331.5656065940857,147.0887005329132,502.4399604797363,16013,2219,13794,13794,0,11,2274000.0
2274,2274999,21.691598522410445,37.79166276193507,0.05731668094150133,333.2889964580536,147.15487694740295,502.7939453125,16024,2220,13804,13804,0,11,2275000.0
2275,2275999,21.691608413762907,37.79857644681685,0.05729722112979341,333.4850835800171,147.22123050689697,502.9035987854004,16030,2222,13808,13808,0,11,2276000.0
2276,2276999,21.69220531875549,37.80134150256793,0.057278332931145925,333.7244198322296,147.28809070587158,502.99750900268555,16038,2225,13813,13813,0,11,2277000.0
2277,2277999,21.69376023594041,37.80596216622463,0.05729533367537054,333.8831698894501,147.3540554046631,503.2878227233887,16043,2226,13817,13817,0,11,2278000.0
2278,2278999,21.69654572584921,37.81336748872151,0.057378216767016044,334.0848197937012,147.41985821723938,503.42555236816406,16047,2228,13819,13819,0,11,2279000.0
2279,2279999,21.698651029656524,37.81887052856481,0.05745249140549724,334.2187464237213,147.48652172088623,503.5626220703125,16047,2228,13819,13819,0,11,2280000.0
2280,2280999,21.70114555879869,37.822733476848036,0.057536245473335246,334.46172404289246,147.55241298675537,503.70312118530273,16062,2231,13831,13831,0,11,2281000.0
2281,2281999,21.705125396673807,37.83297765508116,0.057560674151179714,334.81882095336914,147.61938452720642,503.71627044677734,16080,2237,13843,13843,0,11,2282000.0
2282,2282999,21.70939501735567,37.84005314528726,0.05762338710787407,334.93769931793213,147.68487071990967,503.93444061279297,16080,2237,13843,13843,0,11,2283000.0
2283,2283999,21.713071664801802,37.844005163603555,0.05761544974316635,335.1780524253845,147.75083255767822,504.11790466308594,16100,2240,13860,13860,0,11,2284000.0
2284,2284999,21.718043558339417,37.85107585585999,0.05766158965203938,335.3005919456482,147.81656074523926,504.2966766357422,16100,2240,13860,13860,0,11,2285000.0
2285,2285999,21.722361027469944,37.85628205999074,0.057670990818749046,335.4617898464203,147.8816361427307,504.3850517272949,16104,2241,13863,13863,0,11,2286000.0
2286,2286999,21.7246172743973,37.857120567093716,0.0576820610289569,335.69465351104736,147.94719171524048,504.6110610961914,16117,2244,13873,13873,0,11,2287000.0
2287,2287999,21.723587642687246,37.854350998737026,0.05767195258944435,335.89763832092285,148.01303505897522,504.8710517883301,16130,2246,13884,13884,0,11,2288000.0
2288,2288999,21.719870279374533,37.848938390900585,0.05766959307963049,336.02396845817566,148.07858324050903,505.1610412597656,16134,2246,13888,13888,0,11,2289000.0
2289,2289999,21.716859079896587,37.84429648563336,0.05768325144212483,336.25561904907227,148.14663457870483,505.3056221008301,16149,2249,13900,13900,0,11,2290000.0
2290,2290999,21.7152819523399,37.841981399916335,0.05767243494887464,336.3769176006317,148.2123658657074,505.51223373413086,16149,2249,13900,13900,0,11,2291000.0
2291,2291999,21.714114258213513,37.84133406330698,0.057678858704286795,336.54033851623535,148.27822756767273,505.6049995422363,16151,2250,13901,13901,0,11,2292000.0
2292,2292999,21.714112664644897,37.84144525704443,0.057651767443675395,336.6958086490631,148.34306073188782,505.83911895751953,16155,2251,13904,13904,0,11,2293000.0
2293,2293999,21.713481420990615,37.838965781575794,0.0576212922819459,336.9123775959015,148.4148325920105,505.95633697509766,16161,2253,13908,13908,0,11,2294000.0
2294,2294999,21.713426636664394,37.8379487323498,0.057597432081405664,337.15670442581177,148.48049116134644,505.99831771850586,16182,2256,13926,13926,0,11,2295000.0
2295,2295999,21.714187058745782,37.838560933636316,0.05757353349398597,337.2807846069336,148.54576992988586,506.1516799926758,16182,2256,13926,13926,0,11,2296000.0
2296,2296999,21.714728141487885,37.839539376396644,0.05753558536259096,337.45235538482666,148.61175513267517,506.1996078491211,16186,2257,13929,13929,0,11,2297000.0
2297,2297999,21.715357538403282,37.840477408600265,0.057513921415768166,337.69955229759216,148.6777539253235,506.1626205444336,16208,2260,13948,13948,0,11,2298000.0
2298,2298999,21.716486747616113,37.84031071002654,0.057505013921728465,337.828378200531,148.74431943893433,506.742000579834,16222,2260,13962,13962,0,11,2299000.0
2299,2299999,21.718007360482577,37.84046070047853,0.05750782627887108,337.9896116256714,148.81006860733032,506.9109764099121,16224,2261,13963,13963,0,11,2300000.0
2300,2300999,21.7196850844935,37.842679373704414,0.05755772082791977,338.23864221572876,148.8780689239502,507.31814193725586,16287,2264,14023,14023,0,11,2301000.0
2301,2301999,21.721414241111503,37.84378303228992,0.05757407883686372,338.3748309612274,148.94488668441772,507.72998046875,16291,2264,14027,14027,0,11,2302000.0
2302,2302999,21.72385798273655,37.84740479148142,0.057594876255555594,338.54445362091064,149.01426219940186,507.87689208984375,16301,2265,14036,14036,0,11,2303000.0
2303,2303999,21.726127680818415,37.85000268860614,0.05759252499781542,338.7092409133911,149.08023047447205,507.9988021850586,16306,2266,14040,14040,0,11,2304000.0
2304,2304999,21.729381915772596,37.86012328936644,0.05754397814833778,338.90666794776917,149.14568448066711,508.2835350036621,16313,2268,14045,14045,0,11,2305000.0
2305,2305999,21.731921231575384,37.86280474761631,0.057523816178024045,339.067663192749,149.21066546440125,508.42745208740234,16315,2269,14046,14046,0,11,2306000.0
2306,2306999,21.734520285700388,37.86859727883338,0.0575046216198144,339.3502697944641,149.27657461166382,508.4307174682617,16333,2273,14060,14060,0,11,2307000.0
2307,2307999,21.73515979519022,37.868015199513536,0.05748730238647781,339.5187406539917,149.34114861488342,508.6255302429199,16346,2274,14072,14072,0,11,2308000.0
2308,2308999,21.73338137410512,37.86533492639015,0.05750794761911404,339.6734154224396,149.40631890296936,508.9949836730957,16368,2275,14093,14093,0,11,2309000.0
2309,2309999,21.730819151771087,37.863857757864324,0.057502732023338665,339.80467987060547,149.47265243530273,509.3533401489258,16369,2275,14094,14094,0,11,2310000.0
2310,2310999,21.727642980840802,37.85862441607279,0.057535299955790764,340.04236006736755,149.5392725467682,509.4823684692383,16396,2278,14118,14118,0,11,2311000.0
2311,2311999,21.724478124622966,37.85333750653084,0.05756521863236097,340.2094569206238,149.60559725761414,509.6597900390625,16400,2279,14121,14121,0,11,2312000.0
2312,2312999,21.72193495710024,37.84827317791047,0.05757921418556389,340.37885546684265,149.67327523231506,509.939754486084,16413,2280,14133,14133,0,11,2313000.0
2313,2313999,21.719706550464576,37.84330164946413,0.05757790566810228,340.5766475200653,149.7387773990631,510.10684967041016,16418,2282,14136,14136,0,11,2314000.0
2314,2314999,21.716998227867464,37.83777174632282,0.05759482918753511,340.6945803165436,149.80389833450317,510.3781089782715,16420,2282,14138,14138,0,11,2315000.0
2315,2315999,21.71480028616219,37.832757650962115,0.0576033992173296,340.85744404792786,149.8697226047516,510.4886932373047,16425,2283,14142,14142,0,11,2316000.0
2316,2316999,21.7125764721191,37.82757847944936,0.05761295991252313,340.9866602420807,149.93637704849243,510.6213150024414,16425,2283,14142,14142,0,11,2317000.0
2317,2317999,21.710181913583856,37.82246982943584,0.05761444820483397,341.11929750442505,150.00229787826538,511.08008193969727,16439,2283,14156,14156,0,11,2318000.0
2318,2318999,21.708342361893852,37.81834925206009,0.05759020260461967,341.274382352829,150.06780648231506,511.38929748535156,16442,2284,14158,14158,0,11,2319000.0
2319,2319999,21.706484613191517,37.81446725324885,0.057585418763180685,341.4749274253845,150.13430523872375,511.5634956359863,16447,2286,14161,14161,0,11,2320000.0
2320,2320999,21.705572075497038,37.811049994370755,0.057565901673936604,341.6345238685608,150.20024943351746,511.9127082824707,16458,2287,14171,14171,0,11,2321000.0
2321,2321999,21.704407837558517,37.80804574390732,0.05754677167823641,341.80201482772827,150.26688313484192,512.1569023132324,16461,2288,14173,14173,0,11,2322000.0
2322,2322999,21.703600078779242,37.8043330803515,0.05753137274085074,341.9209041595459,150.33224248886108,512.3762741088867,16461,2288,14173,14173,0,11,2323000.0
2323,2323999,21.703798230137526,37.80146855630231,0.05746082797852692,342.0438349246979,150.39697098731995,512.6365051269531,16462,2288,14174,14174,0,11,2324000.0
2324,2324999,21.703280922795322,37.79772894450261,0.05742767490952283,342.1608319282532,150.46215963363647,512.7544364929199,16462,2288,14174,14174,0,11,2325000.0
2325,2325999,21.702041723037734,37.79352413469749,0.057414415199207425,342.3660657405853,150.52770018577576,512.9578704833984,16468,2290,14178,14178,0,11,2326000.0
2326,2326999,21.699097351657006,37.79225563210478,0.05743365610526119,342.5183975696564,150.5925636291504,513.3915367126465,16484,2291,14193,14193,0,11,2327000.0
2327,2327999,21.696524628091325,37.790615250133065,0.05745765313610729,342.68949031829834,150.65847396850586,513.6336097717285,16488,2292,14196,14196,0,11,2328000.0
2328,2328999,21.69346461085163,37.78521042926188,0.05749872738540096,342.8079876899719,150.72409296035767,513.818058013916,16488,2292,14196,14196,0,11,2329000.0
2329,2329999,21.690404539259717,37.77989043151054,0.05753410857432073,342.97489643096924,150.78993558883667,513.9601707458496,16493,2293,14200,14200,0,11,2330000.0
2330,2330999,21.687680049604108,37.774603021756775,0.057559939798910165,343.09799361228943,150.85439825057983,514.1741943359375,16495,2293,14202,14202,0,11,2331000.0
2331,2331999,21.684555136739505,37.76947207903887,0.0575802321469111,343.22150921821594,150.91924500465393,514.2935066223145,16495,2293,14202,14202,0,11,2332000.0
2332,2332999,21.681965101207094,37.7647964841213,0.05758852163520123,343.38103127479553,150.98422741889954,514.439811706543,16524,2294,14230,14230,0,11,2333000.0
2333,2333999,21.67957891664623,37.75984371044952,0.057594450771004224,343.5454070568085,151.04989671707153,514.5189437866211,16526,2295,14231,14231,0,11,2334000.0
2334,2334999,21.677668328445083,37.75791027875423,0.05758191000389634,343.71584010124207,151.11621856689453,514.6486625671387,16529,2296,14233,14233,0,11,2335000.0
2335,2335999,21.67611997685001,37.75501799087041,0.05756219621435821,343.8389081954956,151.18184876441956,514.997688293457,16535,2296,14239,14239,0,11,2336000.0
2336,2336999,21.673902540520213,37.75090105186571,0.05756586198073499,343.994708776474,151.24708938598633,515.1793174743652,16537,2297,14240,14240,0,11,2337000.0
2337,2337999,21.67266280733177,37.75481551910497,0.05752363987398712,344.1540353298187,151.3122706413269,515.2843704223633,16542,2298,14244,14244,0,11,2338000.0
2338,2338999,21.671167480127156,37.75144591598998,0.057509099815358455,344.3539123535156,151.37819385528564,515.6491928100586,16563,2300,14263,14263,0,11,2339000.0
2339,2339999,21.669389341055144,37.747114105959746,0.0574955580535661,344.5100266933441,151.44273138046265,515.816780090332,16573,2301,14272,14272,0,11,2340000.0
2340,2340999,21.66853790483678,37.744443147815105,0.05748028422666562,344.6339693069458,151.50714707374573,515.9690475463867,16573,2301,14272,14272,0,11,2341000.0
2341,2341999,21.66763217335669,37.740593893066276,0.05744753924779189,344.80289340019226,151.57215642929077,516.1529731750488,16577,2302,14275,14275,0,11,2342000.0
2342,2342999,21.667941968802715,37.74279726357183,0.057396727052577035,344.9224750995636,151.63601422309875,516.269947052002,16577,2302,14275,14275,0,11,2343000.0
2343,2343999,21.666946804695442,37.738790224167666,0.05738735825979002,345.15182971954346,151.7009801864624,516.3099555969238,16584,2305,14279,14279,0,11,2344000.0
2344,2344999,21.66627014948739,37.73548421713469,0.05734968570003707,345.42549657821655,151.76617097854614,516.4274711608887,16602,2309,14293,14293,0,11,2345000.0
2345,2345999,21.663889936492424,37.73008797163797,0.057337721621863236,345.5397708415985,151.82966351509094,516.6309509277344,16602,2309,14293,14293,0,11,2346000.0
2346,2346999,21.661031648457755,37.731631074344634,0.057289679937175486,345.66653847694397,151.895250082016,516.975227355957,16611,2309,14302,14302,0,11,2347000.0
2347,2347999,21.657068187596096,37.72635573820484,0.05731448239132242,345.8625762462616,151.9610743522644,517.1387329101562,16617,2311,14306,14306,0,11,2348000.0
2348,2348999,21.652600312946223,37.71979902282939,0.057355854622162306,346.2136356830597,152.02828669548035,517.2239227294922,16635,2317,14318,14318,0,11,2349000.0
2349,2349999,21.648953769044496,37.71480202075435,0.05738742068052627,346.37332582473755,152.0943763256073,517.4023590087891,16638,2318,14320,14320,0,11,2350000.0
2350,2350999,21.645173235842346,37.708899553169275,0.05741156263412506,346.57961893081665,152.1620991230011,517.5533905029297,16652,2320,14332,14332,0,11,2351000.0
2351,2351999,21.641614662918453,37.7035867074588,0.05743394438467486,346.74067401885986,152.2268033027649,517.7285041809082,16654,2321,14333,14333,0,11,2352000.0
2352,2352999,21.63781528463396,37.69746210817719,0.057455019288348286,346.90733885765076,152.29195976257324,517.8104019165039,16662,2322,14340,14340,0,11,2353000.0
2353,2353999,21.634603941529114,37.692377377436834,0.05746707122700656,347.024569272995,152.3572700023651,518.0568466186523,16665,2322,14343,14343,0,11,2354000.0
2354,2354999,21.632053312212815,37.687796837880114,0.05747846064412221,347.1488108634949,152.4223186969757,518.1784057617188,16665,2322,14343,14343,0,11,2355000.0
2355,2355999,21.629249562307983,37.68278424498487,0.05748418074674688,347.2729687690735,152.48815774917603,518.348072052002,16665,2322,14343,14343,0,11,2356000.0
2356,2356999,21.62708020867768,37.6784675031835,0.05748830018549822,347.4339487552643,152.55377840995789,518.6270332336426,16670,2323,14347,14347,0,11,2357000.0
2357,2357999,21.62523388762398,37.67456916323821,0.05749335870412875,347.62778639793396,152.6187629699707,518.7575950622559,16674,2325,14349,14349,0,11,2358000.0
2358,2358999,21.624016705391984,37.67222167247846,0.057481879689364246,347.7951018810272,152.68393111228943,518.822582244873,16679,2326,14353,14353,0,11,2359000.0
2359,2359999,21.622750017138895,37.6691690036471,0.05746974735225874,347.92289185523987,152.74919176101685,519.1189460754395,16683,2326,14357,14357,0,11,2360000.0
2360,2360999,21.622546962564932,37.667627565555684,0.05744972348049182,348.085480928421,152.81405425071716,519.3146781921387,16686,2327,14359,14359,0,11,2361000.0
2361,2361999,21.622808003974455,37.66680222517076,0.05742210333832565,348.2018780708313,152.878808259964,519.5552177429199,16686,2327,14359,14359,0,11,2362000.0
2362,2362999,21.62264224858923,37.66507593872812,0.05741501038472463,348.3656430244446,152.94350171089172,519.7962417602539,16692,2328,14364,14364,0,11,2363000.0
2363,2363999,21.623533310950613,37.664281097742176,0.05743139069060876,348.6022918224335,153.00843119621277,519.8459548950195,16703,2331,14372,14372,0,11,2364000.0
2364,2364999,21.622998984215663,37.66195877580651,0.05747213178946331,348.7303454875946,153.07290506362915,520.0170402526855,16703,2331,14372,14372,0,11,2365000.0
2365,2365999,21.62202930167487,37.658217653670846,0.05746542627703699,348.9632475376129,153.13812375068665,520.284595489502,16718,2334,14384,14384,0,11,2366000.0
2366,2366999,21.62049958129334,37.655238670898825,0.05745057901510042,349.074654340744,153.2033417224884,520.6293716430664,16726,2334,14392,14392,0,11,2367000.0
2367,2367999,21.61736748670773,37.65000801002047,0.057464890674222446,349.23561215400696,153.26844191551208,521.0367050170898,16740,2335,14405,14405,0,11,2368000.0
2368,2368999,21.61471184976379,37.647991913103354,0.05746352646428299,349.39972949028015,153.33415579795837,521.3615913391113,16745,2336,14409,14409,0,11,2369000.0
2369,2369999,21.61124401308148,37.64199011415156,0.05747885464724045,349.55792593955994,153.39994645118713,521.6152954101562,16749,2337,14412,14412,0,11,2370000.0
2370,2370999,21.608233896631308,37.63689541508373,0.05748778649814945,349.72027587890625,153.4665229320526,521.7929077148438,16752,2338,14414,14414,0,11,2371000.0
2371,2371999,21.605883546395066,37.632403637703135,0.057476371366491974,349.92511081695557,153.5324468612671,522.0049781799316,16761,2340,14421,14421,0,11,2372000.0
2372,2372999,21.60392344985278,37.63006012376152,0.05745147396778316,350.1183204650879,153.59765076637268,522.1568946838379,16766,2342,14424,14424,0,11,2373000.0
2373,2373999,21.60181096247442,37.625101598223594,0.05743537043606051,350.24895572662354,153.6629638671875,522.3322410583496,16766,2342,14424,14424,0,11,2374000.0
2374,2374999,21.600206657040207,37.62060253184206,0.057407203747098734,350.3645830154419,153.72847270965576,522.5820579528809,16769,2342,14427,14427,0,11,2375000.0
2375,2375999,21.598485223391275,37.615955830253704,0.05738557646032538,350.5266389846802,153.79378747940063,522.699031829834,16771,2343,14428,14428,0,11,2376000.0
2376,2376999,21.596490065617573,37.61140267574355,0.05736663156235644,350.72270941734314,153.85990810394287,522.7817306518555,16779,2345,14434,14434,0,11,2377000.0
2377,2377999,21.595848176037,37.60843321109368,0.05731086221329251,350.930850982666,153.92737460136414,523.1120452880859,16793,2347,14446,14446,0,11,2378000.0
2378,2378999,21.59433186904386,37.604594923109,0.05729179584519628,351.16556000709534,153.99255228042603,523.2188491821289,16810,2350,14460,14460,0,11,2379000.0
2379,2379999,21.593390454391418,37.602893288573924,0.05727465652719321,351.4089946746826,154.058424949646,523.2738075256348,16828,2353,14475,14475,0,11,2380000.0
2380,2380999,21.59562350704696,37.61088285476319,0.05719766880761257,351.56843066215515,154.12423038482666,523.7456207275391,16837,2354,14483,14483,0,11,2381000.0
2381,2381999,21.59821946284519,37.61331243893324,0.0571594044019228,351.7645363807678,154.19021129608154,523.9048728942871,16842,2356,14486,14486,0,11,2382000.0
2382,2382999,21.601268794623156,37.615940971444786,0.057101900714949805,351.888564825058,154.25635766983032,524.128360748291,16845,2356,14489,14489,0,11,2383000.0
2383,2383999,21.60601857230962,37.62126297486239,0.05701570643521714,352.1203498840332,154.32258534431458,524.3661766052246,16858,2359,14499,14499,0,11,2384000.0
2384,2384999,21.60986129651277,37.62387847134467,0.05695801791968813,352.31672501564026,154.38766360282898,524.4758796691895,16863,2361,14502,14502,0,11,2385000.0
2385,2385999,21.61395728939405,37.6267731865316,0.056869844239932466,352.48043870925903,154.45302820205688,524.7374687194824,16871,2362,14509,14509,0,11,2386000.0
2386,2386999,21.617136246185808,37.627823688956674,0.05680983237295467,352.63809084892273,154.5188503265381,524.9525299072266,16876,2363,14513,14513,0,11,2387000.0
2387,2387999,21.61421343348281,37.62277584121157,0.05681547113473184,352.75371837615967,154.5844132900238,525.4084701538086,16890,2363,14527,14527,0,11,2388000.0
2388,2388999,21.611264788532097,37.61833891186184,0.056817760047975785,352.91326212882996,154.65122818946838,525.7600364685059,16897,2364,14533,14533,0,11,2389000.0
2389,2389999,21.609082720241872,37.616032276452984,0.056808945209530726,353.0723443031311,154.71726036071777,525.8964920043945,16905,2365,14540,14540,0,11,2390000.0
2390,2390999,21.606330756165057,37.61173705710624,0.0568165311920692,353.24667739868164,154.78361773490906,526.0116996765137,16907,2366,14541,14541,0,11,2391000.0
2391,2391999,21.603773642659252,37.606901539278006,0.05681226587995447,353.3776800632477,154.8495488166809,526.2863998413086,16910,2366,14544,14544,0,11,2392000.0
2392,2392999,21.601837042589043,37.60218664218206,0.05680024377905091,353.54279470443726,154.91429996490479,526.4163398742676,16923,2367,14556,14556,0,11,2393000.0
2393,2393999,21.59990162971812,37.597502755620134,0.05678941685396377,353.6986870765686,154.9797682762146,526.5404472351074,16927,2368,14559,14559,0,11,2394000.0
2394,2394999,21.5985244274446,37.59301123310021,0.05675989602560694,353.8180410861969,155.04470086097717,526.7792778015137,16930,2368,14562,14562,0,11,2395000.0
2395,2395999,21.597493682561954,37.589406596133024,0.05673060078505898,354.01998138427734,155.11004757881165,526.7909889221191,16936,2370,14566,14566,0,11,2396000.0
2396,2396999,21.59633117719831,37.58677004792535,0.056691015868317374,354.15125346183777,155.17529463768005,526.9367599487305,16936,2370,14566,14566,0,11,2397000.0
2397,2397999,21.595742328803425,37.58348838381286,0.056630387531530824,354.31969118118286,155.24196457862854,527.314266204834,16954,2371,14583,14583,0,11,2398000.0
2398,2398999,21.595106448120116,37.58070752855289,0.056589191123791904,354.4707787036896,155.30659294128418,527.5157203674316,16956,2372,14584,14584,0,11,2399000.0
2399,2399999,21.594747424113738,37.57885858947853,0.05656367659152273,354.6294448375702,155.37139987945557,527.6432418823242,16965,2373,14592,14592,0,11,2400000.0
2400,2400999,21.59562390835056,37.578901629763116,0.056533775766803074,354.839111328125,155.43755340576172,528.0034446716309,16989,2375,14614,14614,0,11,2401000.0
2401,2401999,21.59649631976535,37.57780006282338,0.05649359461051473,355.0378336906433,155.50424456596375,528.2788734436035,16999,2377,14622,14622,0,11,2402000.0
2402,2402999,21.597613426318457,37.57718001514569,0.05647122785271119,355.15462493896484,155.56981706619263,528.4781799316406,16999,2377,14622,14622,0,11,2403000.0
2403,2403999,21.602024171647784,37.58312490743472,0.056451420841485134,355.36980676651,155.6362669467926,528.7777137756348,17013,2379,14634,14634,0,11,2404000.0
2404,2404999,21.605852528708944,37.5893144440265,0.0564488154186813,355.5269937515259,155.70122742652893,528.9741859436035,17015,2380,14635,14635,0,11,2405000.0
2405,2405999,21.609543436822953,37.5931926240532,0.056486214117596245,355.6798813343048,155.76573634147644,529.0657691955566,17017,2381,14636,14636,0,11,2406000.0
2406,2406999,21.61197903517895,37.594777268231766,0.056493532061088425,355.8710777759552,155.8319375514984,529.278636932373,17027,2383,14644,14644,0,11,2407000.0
2407,2407999,21.611121809417266,37.59478526199685,0.05647380244613098,356.02903294563293,155.8972783088684,529.6530838012695,17047,2384,14663,14663,0,11,2408000.0
2408,2408999,21.60859704790783,37.6036563698142,0.05643433882191928,356.14548087120056,155.96200227737427,529.9186363220215,17050,2384,14666,14666,0,11,2409000.0
2409,2409999,21.605878337437208,37.599687850045356,0.05645369214287832,356.26626920700073,156.02759838104248,530.1512145996094,17053,2384,14669,14669,0,11,2410000.0
2410,2410999,21.603505126546228,37.595735762094975,0.05645896811470197,356.5028359889984,156.09400081634521,530.2633361816406,17059,2387,14672,14672,0,11,2411000.0
2411,2411999,21.60097924287047,37.591645192007455,0.05645327712899273,356.6766993999481,156.15999937057495,530.3794555664062,17061,2388,14673,14673,0,11,2412000.0
2412,2412999,21.598761185589442,37.58794880916642,0.05645035099122009,356.8010354042053,156.22504687309265,530.6094741821289,17062,2388,14674,14674,0,11,2413000.0
2413,2413999,21.596338982959004,37.58316690270943,0.05644347353389545,357.0021493434906,156.2913303375244,530.6883811950684,17066,2390,14676,14676,0,11,2414000.0
2414,2414999,21.594664356613993,37.57928135489441,0.05643530532015506,357.1286551952362,156.35636949539185,530.9285354614258,17069,2390,14679,14679,0,11,2415000.0
2415,2415999,21.59324522526291,37.576075373563334,0.05640413868554184,357.24611926078796,156.42264032363892,531.1707344055176,17072,2390,14682,14682,0,11,2416000.0
2416,2416999,21.591875462750632,37.57217958457774,0.056377734556997905,357.4621276855469,156.48835515975952,531.2519950866699,17076,2392,14684,14684,0,11,2417000.0
2417,2417999,21.590730913548736,37.569389091940735,0.05634895342183743,357.62136125564575,156.55437397956848,531.4399566650391,17078,2393,14685,14685,0,11,2418000.0
2418,2418999,21.589157389362786,37.56557472209375,0.05631902340888484,357.7797656059265,156.61940002441406,531.7880706787109,17083,2394,14689,14689,0,11,2419000.0
2419,2419999,21.588632782262028,37.564399527765744,0.05628646469166643,357.90055990219116,156.68378925323486,532.0189208984375,17083,2394,14689,14689,0,11,2420000.0
2420,2420999,21.588195822822613,37.56324358703351,0.05626351337043067,358.0258274078369,156.74876952171326,532.1519584655762,17083,2394,14689,14689,0,11,2421000.0
2421,2421999,21.589293303368244,37.565510101854365,0.05623656407339106,358.2587454319,156.81437849998474,532.3967247009277,17095,2397,14698,14698,0,11,2422000.0
2422,2422999,21.590167176936287,37.56794651585638,0.05622022453874698,358.50655364990234,156.88000059127808,532.5010604858398,17102,2400,14702,14702,0,11,2423000.0
2423,2423999,21.592675677484024,37.57182956049323,0.05622196667598345,358.6307201385498,156.94520497322083,532.6770896911621,17102,2400,14702,14702,0,11,2424000.0
2424,2424999,21.596056571758616,37.577379878903315,0.05617042943861039,358.75237226486206,157.0120165348053,532.9780044555664,17106,2400,14706,14706,0,11,2425000.0
2425,2425999,21.59947290628661,37.58326401009398,0.05614720186132316,358.9496350288391,157.07689142227173,533.048641204834,17111,2402,14709,14709,0,11,2426000.0
2426,2426999,21.60096725148304,37.584279189911356,0.05613936683411325,359.1109857559204,157.14123344421387,533.1898803710938,17115,2403,14712,14712,0,11,2427000.0
2427,2427999,21.60256972376989,37.58864672164966,0.05611759370817715,359.27740573883057,157.20544743537903,533.315746307373,17122,2404,14718,14718,0,11,2428000.0
2428,2428999,21.600614707529868,37.58666922277395,0.05610834606156201,359.4353165626526,157.2703800201416,533.5511054992676,17140,2405,14735,14735,0,11,2429000.0
2429,2429999,21.597509669459196,37.58552890793387,0.0561084237150441,359.5549771785736,157.33500623703003,533.7493591308594,17141,2405,14736,14736,0,11,2430000.0
2430,2430999,21.594967559252144,37.58279889535106,0.05611379167143782,359.6768250465393,157.3999879360199,533.8720817565918,17142,2405,14737,14737,0,11,2431000.0
2431,2431999,21.59198907325469,37.57869856076009,0.05611423583010666,359.8576955795288,157.46554374694824,533.9580993652344,17144,2406,14738,14738,0,11,2432000.0
2432,2432999,21.589387075192896,37.574893123032766,0.056104863627871926,360.025470495224,157.53112387657166,534.0617904663086,17146,2407,14739,14739,0,11,2433000.0
2433,2433999,21.587780155692528,37.5734142964825,0.05608904556932881,360.1908919811249,157.59480500221252,534.2276306152344,17150,2408,14742,14742,0,11,2434000.0
2434,2434999,21.585645870798242,37.571138241831584,0.05607798431135724,360.3606858253479,157.65945768356323,534.3677711486816,17152,2409,14743,14743,0,11,2435000.0
2435,2435999,21.583479701439604,37.56709921058516,0.05606623613460715,360.52510356903076,157.72452640533447,534.4838104248047,17156,2410,14746,14746,0,11,2436000.0
2436,2436999,21.58147274716693,37.56281050505171,0.05605272663863592,360.65855288505554,157.78870344161987,534.5793037414551,17156,2410,14746,14746,0,11,2437000.0
2437,2437999,21.579506739899042,37.55877800898538,0.056034125298694226,360.7863738536835,157.85343194007874,534.6671257019043,17156,2410,14746,14746,0,11,2438000.0
2438,2438999,21.577791136856373,37.55520133648284,0.05600475422961915,360.9707601070404,157.91926670074463,534.7348175048828,17161,2411,14750,14750,0,11,2439000.0
2439,2439999,21.576745305998895,37.552047360250846,0.055960447216371834,361.1314377784729,157.98479795455933,535.4596748352051,17177,2412,14765,14765,0,11,2440000.0
2440,2440999,21.575562062152922,37.54928082970142,0.055936719044885286,361.2648856639862,158.05054187774658,535.7698249816895,17177,2412,14765,14765,0,11,2441000.0
2441,2441999,21.574627237180003,37.54689788958147,0.0559208082621393,361.4290761947632,158.1156508922577,535.9013710021973,17179,2413,14766,14766,0,11,2442000.0
2442,2442999,21.573787828600558,37.54331820959704,0.0558871697724741,361.59085750579834,158.18074226379395,536.2658958435059,17190,2414,14776,14776,0,11,2443000.0
2443,2443999,21.573797943333535,37.541260432386615,0.055848819432875674,361.71859908103943,158.24577689170837,536.4477691650391,17192,2414,14778,14778,0,11,2444000.0
2444,2444999,21.573582272391448,37.538345897778704,0.05581814940281882,361.88298058509827,158.3108298778534,536.611457824707,17198,2415,14783,14783,0,11,2445000.0
2445,2445999,21.574344624288347,37.53664124232895,0.05575369501240912,362.0811128616333,158.37584447860718,536.7774200439453,17202,2417,14785,14785,0,11,2446000.0
2446,2446999,21.574385123587106,37.53434273816645,0.05570949865946029,362.19532537460327,158.43966484069824,536.9426460266113,17202,2417,14785,14785,0,11,2447000.0
2447,2447999,21.57490925286342,37.531975352080956,0.05565932257185169,362.40288949012756,158.50520491600037,537.0659408569336,17208,2419,14789,14789,0,11,2448000.0
2448,2448999,21.57499168496802,37.53217964845012,0.05561540329146519,362.5183074474335,158.56868267059326,537.2091293334961,17208,2419,14789,14789,0,11,2449000.0
2449,2449999,21.573527098473352,37.53270926046186,0.0555935484667609,362.63409209251404,158.63305807113647,537.5575790405273,17220,2419,14801,14801,0,11,2450000.0
2450,2450999,21.570704719025613,37.5287662068456,0.05559959038025786,362.76491236686707,158.69791460037231,537.8510437011719,17223,2419,14804,14804,0,11,2451000.0
2451,2451999,21.568522559325558,37.524792640126364,0.055618316768781706,362.8907389640808,158.76372623443604,538.0233116149902,17225,2419,14806,14806,0,11,2452000.0
2452,2452999,21.56636237122633,37.52104582077018,0.055625138615745695,363.01548194885254,158.82931470870972,538.1599044799805,17225,2419,14806,14806,0,11,2453000.0
2453,2453999,21.565074212905586,37.51950162910769,0.055580027183876446,363.1867697238922,158.89474272727966,538.394474029541,17237,2420,14817,14817,0,11,2454000.0
2454,2454999,21.564063477593482,37.51836520008219,0.055579093652844636,363.3089351654053,158.95935535430908,538.5556297302246,17238,2420,14818,14818,0,11,2455000.0
2455,2455999,21.56252807631534,37.5148198189695,0.055577445035664974,363.43977427482605,159.02441906929016,538.7204132080078,17239,2420,14819,14819,0,11,2456000.0
2456,2456999,21.561611687056022,37.51339849732844,0.055561975328781266,363.5718674659729,159.08915758132935,538.8195419311523,17239,2420,14819,14819,0,11,2457000.0
2457,2457999,21.560366458724676,37.51060834188872,0.055556355257767254,363.7419788837433,159.1537492275238,538.8901519775391,17242,2421,14821,14821,0,11,2458000.0
2458,2458999,21.55930670501608,37.507052819026825,0.05553581051309442,363.9561369419098,159.21929264068604,539.1713562011719,17266,2423,14843,14843,0,11,2459000.0
2459,2459999,21.558972389790434,37.50538258927651,0.05549324307188752,364.07182002067566,159.28505396842957,539.5829925537109,17269,2423,14846,14846,0,11,2460000.0
2460,2460999,21.55827418320844,37.50734659245467,0.055460474555273365,364.1949825286865,159.35014963150024,539.8316917419434,17269,2423,14846,14846,0,11,2461000.0
2461,2461999,21.558150459054268,37.50593993842726,0.05543820910873554,364.3549597263336,159.41521620750427,540.1696090698242,17287,2424,14863,14863,0,11,2462000.0
2462,2462999,21.557860491902268,37.502934691878,0.05541470224066791,364.5521094799042,159.4808361530304,540.5044631958008,17295,2426,14869,14869,0,11,2463000.0
2463,2463999,21.557558327060264,37.50006030410059,0.05539560085497419,364.7484459877014,159.5472936630249,540.741138458252,17307,2428,14879,14879,0,11,2464000.0
2464,2464999,21.558562286411348,37.4983260338417,0.05534047351716198,364.8711562156677,159.61191511154175,540.9191741943359,17309,2428,14881,14881,0,11,2465000.0
2465,2465999,21.558180534466562,37.49485110135046,0.055304728239505385,364.9949173927307,159.67578196525574,541.0211944580078,17309,2428,14881,14881,0,11,2466000.0
2466,2466999,21.557563364274007,37.491317297186924,0.05527426392484236,365.11536598205566,159.7396330833435,541.240550994873,17310,2428,14882,14882,0,11,2467000.0
2467,2467999,21.555802289435753,37.49112641223045,0.05525552102106368,365.2347626686096,159.80471277236938,541.7049446105957,17323,2428,14895,14895,0,11,2468000.0
2468,2468999,21.553841837645173,37.489431352424894,0.055256228904073224,365.36404848098755,159.8705940246582,541.9894866943359,17326,2428,14898,14898,0,11,2469000.0
2469,2469999,21.551815079649685,37.48732626133966,0.05526026080415891,365.48507356643677,159.93606638908386,542.163818359375,17326,2428,14898,14898,0,11,2470000.0
2470,2470999,21.550063475974063,37.48459261116032,0.05525896698136956,365.642596244812,160.00148105621338,542.3750991821289,17332,2429,14903,14903,0,11,2471000.0
2471,2471999,21.54873760640599,37.48222840258918,0.055244229171868664,365.76594042778015,160.06658172607422,542.7746200561523,17333,2429,14904,14904,0,11,2472000.0
2472,2472999,21.54666011459986,37.47820186319107,0.055236365855280356,365.930123090744,160.13134360313416,542.8981742858887,17337,2430,14907,14907,0,11,2473000.0
2473,2473999,21.546421496311776,37.477648157036036,0.05520808939610666,366.064870595932,160.19737720489502,543.1311340332031,17340,2430,14910,14910,0,11,2474000.0
2474,2474999,21.544660811475765,37.474240483949984,0.05521611898556633,366.1831953525543,160.26219177246094,543.246223449707,17340,2430,14910,14910,0,11,2475000.0
2475,2475999,21.543875940964888,37.47973515415041,0.05517654195283839,366.44028902053833,160.3288233280182,543.2511749267578,17353,2433,14920,14920,0,11,2476000.0
2476,2476999,21.54334214799393,37.47763996436324,0.05515100310271992,366.62902188301086,160.3946557044983,543.596736907959,17364,2434,14930,14930,0,11,2477000.0
2477,2477999,21.543804042530763,37.479476624804235,0.05515056760971948,366.8278455734253,160.46076822280884,543.7048721313477,17368,2436,14932,14932,0,11,2478000.0
2478,2478999,21.54383678921008,37.4777980797254,0.05514399412733528,366.99524903297424,160.52598524093628,543.8407287597656,17372,2437,14935,14935,0,11,2479000.0
2479,2479999,21.54481048487118,37.477814858765925,0.05513475261480438,367.1678910255432,160.59197282791138,544.1474189758301,17382,2438,14944,14944,0,11,2480000.0
2480,2480999,21.54591655174378,37.47758314012242,0.055113635995165056,367.3343594074249,160.65795636177063,544.3804321289062,17387,2439,14948,14948,0,11,2481000.0
2481,2481999,21.54758764744295,37.47872978327923,0.05512857724387987,367.57467126846313,160.72351050376892,544.577449798584,17403,2442,14961,14961,0,11,2482000.0
2482,2482999,21.549693895057285,37.48631793201255,0.055091798760290356,367.7426173686981,160.78910756111145,544.9034996032715,17412,2443,14969,14969,0,11,2483000.0
2483,2483999,21.55182644448608,37.489019472306204,0.05507503688105431,367.90512704849243,160.85457611083984,545.0400733947754,17415,2444,14971,14971,0,11,2484000.0
2484,2484999,21.553145088634782,37.4886801191242,0.055064633385322526,368.0569930076599,160.91902995109558,545.1284141540527,17418,2445,14973,14973,0,11,2485000.0
2485,2485999,21.555011784495655,37.491505795924084,0.05504837379180383,368.2548291683197,160.98366451263428,545.2500801086426,17427,2447,14980,14980,0,11,2486000.0
2486,2486999,21.55462662227642,37.488821809410595,0.055038354722864224,368.3775305747986,161.04710507392883,545.3959350585938,17427,2447,14980,14980,0,11,2487000.0
2487,2487999,21.552172817390506,37.48638855908121,0.055040254162459945,368.55885648727417,161.11879992485046,545.7202453613281,17441,2448,14993,14993,0,11,2488000.0
2488,2488999,21.54988269490327,37.48459803801056,0.05504199019754563,368.6810534000397,161.18398332595825,545.9976654052734,17442,2448,14994,14994,0,11,2489000.0
2489,2489999,21.547936646035726,37.48253289845765,0.055043296592437785,368.8882510662079,161.25064969062805,546.1233024597168,17447,2450,14997,14997,0,11,2490000.0
2490,2490999,21.546581477086615,37.48114943330186,0.055036188869998504,369.0969705581665,161.3168501853943,546.2353553771973,17457,2452,15005,15005,0,11,2491000.0
2491,2491999,21.544720396263177,37.4797558936576,0.05502670965244927,369.2629256248474,161.38337635993958,546.4809913635254,17462,2453,15009,15009,0,11,2492000.0
2492,2492999,21.543004637430602,37.476944353441,0.05501736086188769,369.465970993042,161.44804692268372,546.5987358093262,17466,2455,15011,15011,0,11,2493000.0
2493,2493999,21.541385495624176,37.47438219474918,0.05499641007212752,369.59316873550415,161.51285815238953,546.7655067443848,17466,2455,15011,15011,0,11,2494000.0
2494,2494999,21.53957461267934,37.470716580418326,0.05498626810166585,369.7218749523163,161.5782163143158,547.0558471679688,17471,2455,15016,15016,0,11,2495000.0
2495,2495999,21.538293116216416,37.46980318439836,0.054975834194026185,369.8456609249115,161.64398789405823,547.1723594665527,17471,2455,15016,15016,0,11,2496000.0
2496,2496999,21.536185043642696,37.464870777147645,0.05497353245326375,370.0116617679596,161.70910000801086,547.2799339294434,17475,2456,15019,15019,0,11,2497000.0
2497,2497999,21.53513109102689,37.46591093011151,0.05494240880784951,370.1901161670685,161.77823328971863,547.5543670654297,17480,2457,15023,15023,0,11,2498000.0
2498,2498999,21.53399061204436,37.46276681265223,0.05493161991781548,370.3121829032898,161.84319162368774,547.6818084716797,17480,2457,15023,15023,0,11,2499000.0
2499,2499999,21.532863337091246,37.45905317243296,0.05492062184798463,370.6042866706848,161.9090964794159,547.560619354248,17491,2461,15030,15030,0,11,2500000.0
2500,2500999,21.532259022283167,37.45769039269347,0.05489913652876033,370.76534819602966,161.9755163192749,547.871452331543,17500,2462,15038,15038,0,11,2501000.0
2501,2501999,21.531344648321593,37.45402600640146,0.05488042241711111,370.9382212162018,162.04033541679382,548.0096664428711,17502,2463,15039,15039,0,11,2502000.0
2502,2502999,21.530368832705296,37.450508229346326,0.05486254336204566,371.0998706817627,162.1070032119751,548.1203117370605,17506,2464,15042,15042,0,11,2503000.0
2503,2503999,21.53031791789052,37.44759786841092,0.05482771682827403,371.21290278434753,162.17180800437927,548.4624061584473,17512,2464,15048,15048,0,11,2504000.0
2504,2504999,21.529781765521896,37.44390912803747,0.05479951624752821,371.33700299263,162.23621702194214,548.6125068664551,17512,2464,15048,15048,0,11,2505000.0
2505,2505999,21.52902564293832,37.44038107867336,0.05477745703285419,371.4985611438751,162.3013768196106,548.6985931396484,17514,2465,15049,15049,0,11,2506000.0
2506,2506999,21.528183818902267,37.4365322898599,0.054765536269545834,371.6222229003906,162.36633777618408,548.968620300293,17518,2465,15053,15053,0,11,2507000.0
2507,2507999,21.526176445933448,37.432481945648455,0.05474804942299416,371.75077199935913,162.43039965629578,549.2349624633789,17525,2465,15060,15060,0,11,2508000.0
2508,2508999,21.521938805785293,37.426163112019786,0.05479123457066659,371.90993785858154,162.49543952941895,549.5274200439453,17539,2466,15073,15073,0,11,2509000.0
2509,2509999,21.5186647930867,37.42206573201928,0.05482589764414081,372.03879475593567,162.56044125556946,549.7405128479004,17540,2466,15074,15074,0,11,2510000.0
2510,2510999,21.515433632772524,37.41768779529036,0.05486302205909388,372.16263484954834,162.62598204612732,549.8713989257812,17541,2466,15075,15075,0,11,2511000.0
2511,2511999,21.512613547776716,37.4167146014755,0.05489213367159085,372.2785851955414,162.6909339427948,550.0009613037109,17543,2466,15077,15077,0,11,2512000.0
2512,2512999,21.508838987148977,37.411261910800825,0.054929100022772404,372.4835453033447,162.75602436065674,550.1099662780762,17549,2468,15081,15081,0,11,2513000.0
2513,2513999,21.50579715072489,37.40716558186791,0.05495518727254889,372.6884882450104,162.82035064697266,550.1939010620117,17562,2470,15092,15092,0,11,2514000.0
2514,2514999,21.50206039339006,37.40148325664009,0.05498420472645282,372.89662885665894,162.8856053352356,550.2774772644043,17576,2472,15104,15104,0,11,2515000.0
2515,2515999,21.49885599027398,37.39772150201416,0.055003241869521546,373.03399634361267,162.95050597190857,550.3985824584961,17576,2472,15104,15104,0,11,2516000.0
2516,2516999,21.495673404658895,37.39226737364348,0.055025220078145254,373.19219160079956,163.01474690437317,550.4079475402832,17580,2473,15107,15107,0,11,2517000.0
2517,2517999,21.49313925166546,37.38770907876552,0.0550428192290936,373.3579740524292,163.0793685913086,550.4782409667969,17584,2474,15110,15110,0,11,2518000.0
2518,2518999,21.49072902720306,37.38372669166046,0.05504421273528137,373.5929310321808,163.14475536346436,550.7109260559082,17603,2476,15127,15127,0,11,2519000.0
2519,2519999,21.48820242802668,37.37880595653038,0.05504798522461518,373.718270778656,163.2105746269226,550.9118270874023,17603,2476,15127,15127,0,11,2520000.0
2520,2520999,21.485435612029562,37.373554860255055,0.05505827150320142,373.8359673023224,163.27513813972473,551.0392417907715,17603,2476,15127,15127,0,11,2521000.0
2521,2521999,21.483186065017502,37.36923983182872,0.05505567264543654,374.0847909450531,163.34098315238953,551.249641418457,17627,2479,15148,15148,0,11,2522000.0
2522,2522999,21.48077402935093,37.36490981297244,0.055066750721831426,374.24287033081055,163.40594673156738,551.4825630187988,17630,2480,15150,15150,0,11,2523000.0
2523,2523999,21.47892622978557,37.3613773024,0.05507367278040631,374.3754403591156,163.47087931632996,551.6949234008789,17630,2480,15150,15150,0,11,2524000.0
2524,2524999,21.477624989512726,37.35735642354286,0.05507226019328615,374.49108028411865,163.5348677635193,551.9473876953125,17633,2480,15153,15153,0,11,2525000.0
2525,2525999,21.476150885716628,37.35355363724352,0.05506039799945206,374.6037015914917,163.598623752594,552.0490493774414,17633,2480,15153,15153,0,11,2526000.0
2526,2526999,21.474380781688527,37.349255759403874,0.05505861696073411,374.816419839859,163.66358160972595,552.0926856994629,17641,2482,15159,15159,0,11,2527000.0
2527,2527999,21.472703630081714,37.34540578710721,0.055045221533275956,374.9321041107178,163.7272083759308,552.2718963623047,17642,2482,15160,15160,0,11,2528000.0
2528,2528999,21.469672418898263,37.34064013190611,0.05506689731107273,375.04747009277344,163.7922818660736,552.5852165222168,17651,2482,15169,15169,0,11,2529000.0
2529,2529999,21.466102743710252,37.3369645077232,0.055090320521118064,375.1729414463043,163.85733222961426,552.8148727416992,17652,2482,15170,15170,0,11,2530000.0
2530,2530999,21.462654379418186,37.332121694219815,0.055120943157025426,375.41888451576233,163.9234583377838,552.9287490844727,17720,2485,15235,15235,0,11,2531000.0
2531,2531999,21.459743376668598,37.33055229052755,0.05516196236242821,375.58568835258484,163.98910808563232,553.061351776123,17724,2486,15238,15238,0,11,2532000.0
2532,2532999,21.45633999032306,37.32584540170138,0.055183128017952776,375.7100372314453,164.05464577674866,553.1978225708008,17726,2486,15240,15240,0,11,2533000.0
2533,2533999,21.454248005753822,37.32221455139613,0.0551941669199324,375.8422031402588,164.1195616722107,553.3920860290527,17727,2486,15241,15241,0,11,2534000.0
2534,2534999,21.451646067211787,37.31730380558076,0.05520876219077753,376.12141013145447,164.1849284172058,553.3107719421387,17749,2490,15259,15259,0,11,2535000.0
2535,2535999,21.448826571147364,37.312346657936054,0.05522030962982327,376.3692252635956,164.25091671943665,553.50927734375,17769,2493,15276,15276,0,11,2536000.0
2536,2536999,21.446655956126083,37.30851430181974,0.05522900543051623,376.5807044506073,164.31626105308533,553.597484588623,17777,2495,15282,15282,0,11,2537000.0
2537,2537999,21.443878418454386,37.30337648551771,0.05524088355955192,376.797155380249,164.38140511512756,553.6756324768066,17785,2497,15288,15288,0,11,2538000.0
2538,2538999,21.441741533843594,37.29931570848845,0.05524218051046914,376.9596633911133,164.44645524024963,554.0260314941406,17800,2498,15302,15302,0,11,2539000.0
2539,2539999,21.439566050858204,37.294593614685866,0.055243438597999406,377.1302168369293,164.51280975341797,554.2851829528809,17812,2499,15313,15313,0,11,2540000.0
2540,2540999,21.437480630271885,37.29029786729909,0.05525291861220938,377.28909850120544,164.57754707336426,554.4496078491211,17814,2500,15314,15314,0,11,2541000.0
2541,2541999,21.435880668712144,37.287080214872645,0.05524646687927737,377.4910674095154,164.6429467201233,554.5601043701172,17825,2502,15323,15323,0,11,2542000.0
2542,2542999,21.43635037135913,37.29018611493143,0.05522220183984761,377.6594021320343,164.70981168746948,554.9811363220215,17843,2503,15340,15340,0,11,2543000.0
2543,2543999,21.437063567848202,37.29074083687001,0.055218070497064176,377.8155493736267,164.77644443511963,555.2134056091309,17848,2504,15344,15344,0,11,2544000.0
2544,2544999,21.437787245834258,37.29111613967896,0.055226158286780236,377.9369170665741,164.84158515930176,555.6694450378418,17856,2504,15352,15352,0,11,2545000.0
2545,2545999,21.43935618294665,37.29530078975273,0.05520518203625702,378.09460043907166,164.9067418575287,555.8668060302734,17866,2505,15361,15361,0,11,2546000.0
2546,2546999,21.440792616626112,37.29631081378479,0.05519973370143427,378.2505247592926,164.97122311592102,555.9968070983887,17879,2506,15373,15373,0,11,2547000.0
2547,2547999,21.440527868089728,37.29366063266505,0.05520242237617212,378.3745129108429,165.03607773780823,556.2278289794922,17883,2506,15377,15377,0,11,2548000.0
2548,2548999,21.439654066785735,37.291094513177434,0.05519074618838071,378.49868965148926,165.10028314590454,556.3644561767578,17884,2506,15378,15378,0,11,2549000.0
2549,2549999,21.43648675435456,37.288161116567196,0.05520133007359218,378.6255769729614,165.17008113861084,556.6888008117676,17893,2506,15387,15387,0,11,2550000.0
2550,2550999,21.43360480236303,37.28495436467667,0.05523170153265289,378.7858669757843,165.23551058769226,556.8920364379883,17906,2507,15399,15399,0,11,2551000.0
2551,2551999,21.430344849811267,37.28010540322919,0.05525647877097595,378.95662331581116,165.3014326095581,557.0411491394043,17910,2508,15402,15402,0,11,2552000.0
2552,2552999,21.427359832090165,37.27600957459708,0.055237147075674065,379.0744490623474,165.3663671016693,557.1323280334473,17910,2508,15402,15402,0,11,2553000.0
2553,2553999,21.42554773142923,37.27412702246013,0.05523200099679171,379.198215007782,165.43108105659485,557.3052558898926,17911,2508,15403,15403,0,11,2554000.0
2554,2554999,21.423375973879732,37.27060351926925,0.0552398319443409,379.4461281299591,165.49652647972107,557.3465843200684,17925,2511,15414,15414,0,11,2555000.0
2555,2555999,21.42161209798723,37.2695485055234,0.05524655852633986,379.5791428089142,165.56149244308472,557.4845962524414,17925,2511,15414,15414,0,11,2556000.0
2556,2556999,21.420371755797156,37.275210754018445,0.05522391494718282,379.70633840560913,165.62614822387695,557.7342529296875,17929,2511,15418,15418,0,11,2557000.0
2557,2557999,21.41939399911223,37.27424191397558,0.05521323949597379,379.85337233543396,165.698792219162,557.8217620849609,17929,2511,15418,15418,0,11,2558000.0
2558,2558999,21.417869688754262,37.27179461015303,0.055215291313221226,379.98002886772156,165.76365160942078,557.9055252075195,17929,2511,15418,15418,0,11,2559000.0
2559,2559999,21.417892359834,37.272730331868694,0.055198270822368944,380.1028163433075,165.8290159702301,558.2043380737305,17932,2511,15421,15421,0,11,2560000.0
2560,2560999,21.41752153226094,37.27196334191987,0.05519550778967475,380.2973954677582,165.8937258720398,558.2994384765625,17936,2513,15423,15423,0,11,2561000.0
2561,2561999,21.418717646801337,37.27453165915275,0.0551776978229811,380.47366547584534,165.95856261253357,558.4033432006836,17939,2514,15425,15425,0,11,2562000.0
2562,2562999,21.421194764225373,37.28003856144592,0.055163739064076456,380.6783215999603,166.023752450943,558.5878677368164,17950,2516,15434,15434,0,11,2563000.0
2563,2563999,21.423462431154277,37.282827491215805,0.055156123128182744,380.8907494544983,166.09011340141296,558.6678504943848,17965,2518,15447,15447,0,11,2564000.0
2564,2564999,21.426947549012425,37.288388947640044,0.055159437628133356,381.06542348861694,166.15559124946594,558.7660446166992,17968,2519,15449,15449,0,11,2565000.0
2565,2565999,21.43137190778515,37.29499851917634,0.05514778778925156,381.22829246520996,166.22121047973633,558.9551239013672,17974,2520,15454,15454,0,11,2566000.0
2566,2566999,21.436847825391173,37.30525214140643,0.05513995937896077,381.39572620391846,166.28559684753418,559.0793571472168,17979,2521,15458,15458,0,11,2567000.0
2567,2567999,21.440683038109448,37.313441814668174,0.05515302300406677,381.5144274234772,166.3499948978424,559.1675796508789,17979,2521,15458,15458,0,11,2568000.0
2568,2568999,21.445676560976267,37.32197262474078,0.05521192578143086,381.6303062438965,166.4151759147644,559.4594268798828,17983,2521,15462,15462,0,11,2569000.0
2569,2569999,21.447165144461355,37.32777615924803,0.05518847790882275,381.75704193115234,166.47913551330566,559.6963882446289,17987,2521,15466,15466,0,11,2570000.0
2570,2570999,21.44402364861518,37.32398971173571,0.05520311426091418,381.88382959365845,166.54360389709473,559.904613494873,17992,2521,15471,15471,0,11,2571000.0
2571,2571999,21.441292598263335,37.320991015237134,0.05521475115136121,382.10190773010254,166.61404085159302,560.0499229431152,17997,2523,15474,15474,0,11,2572000.0
2572,2572999,21.439218461057795,37.32110980595744,0.05520927482801463,382.230051279068,166.67970037460327,560.2131576538086,17997,2523,15474,15474,0,11,2573000.0
2573,2573999,21.437116543161867,37.31790013081723,0.055198553392791005,382.40060353279114,166.74559903144836,560.2629356384277,17999,2524,15475,15475,0,11,2574000.0
2574,2574999,21.43523140064448,37.31490110471985,0.055195950937510174,382.52151250839233,166.8101987838745,560.543098449707,18002,2524,15478,15478,0,11,2575000.0
2575,2575999,21.433542011137277,37.31167132830291,0.055190354814320886,382.68964767456055,166.8748869895935,560.6715087890625,18005,2525,15480,15480,0,11,2576000.0
2576,2576999,21.431926427484537,37.30805286854849,0.05518602568387376,382.86088705062866,166.93976855278015,560.7080192565918,18008,2526,15482,15482,0,11,2577000.0
2577,2577999,21.43129841115692,37.30531420291877,0.05517195531553387,382.9863097667694,167.0052251815796,560.9213027954102,18012,2526,15486,15486,0,11,2578000.0
2578,2578999,21.430656138655582,37.30393126023755,0.05516141968102417,383.1505060195923,167.07029032707214,560.9804534912109,18014,2527,15487,15487,0,11,2579000.0
2579,2579999,21.429316431131934,37.300558687920756,0.055160334523915444,383.37213039398193,167.13572525978088,561.0352363586426,18021,2529,15492,15492,0,11,2580000.0
2580,2580999,21.429422686918176,37.2991267395727,0.05515288391431039,383.5049922466278,167.20188069343567,561.5633583068848,18035,2529,15506,15506,0,11,2581000.0
2581,2581999,21.4294837089847,37.297890804891914,0.05514887348215525,383.63667154312134,167.26710081100464,561.778923034668,18035,2529,15506,15506,0,11,2582000.0
2582,2582999,21.429949565195823,37.297330399667956,0.055139391069184196,383.801940202713,167.33212327957153,561.8776931762695,18037,2530,15507,15507,0,11,2583000.0
2583,2583999,21.430580019622397,37.29747526677828,0.05514909954772362,383.9349899291992,167.39716386795044,562.1577568054199,18043,2530,15513,15513,0,11,2584000.0
2584,2584999,21.431273464466305,37.29746395986454,0.05517713647810207,384.0986430644989,167.4628872871399,562.261173248291,18057,2531,15526,15526,0,11,2585000.0
2585,2585999,21.432335890116402,37.297187815131664,0.055187210713567025,384.2192277908325,167.52794289588928,562.367488861084,18057,2531,15526,15526,0,11,2586000.0
2586,2586999,21.434434692990948,37.29796790739119,0.05519622627109899,384.3418552875519,167.59262371063232,562.6904067993164,18062,2531,15531,15531,0,11,2587000.0
2587,2587999,21.436094062341695,37.298552219637365,0.055194915532352784,384.4632897377014,167.65682744979858,562.8091506958008,18062,2531,15531,15531,0,11,2588000.0
2588,2588999,21.438456056091876,37.30031369384506,0.05521036708558691,384.62661361694336,167.72135305404663,562.8505172729492,18064,2532,15532,15532,0,11,2589000.0
2589,2589999,21.44166084013981,37.30537282149294,0.0551945956234815,384.7958846092224,167.78715634346008,563.0201759338379,18071,2533,15538,15538,0,11,2590000.0
2590,2590999,21.441174681582574,37.303186229622256,0.05519670474770677,384.9218966960907,167.85133290290833,563.4487266540527,18086,2533,15553,15553,0,11,2591000.0
2591,2591999,21.43840626141307,37.300548438306784,0.055208102240763446,385.0815408229828,167.91768264770508,563.9060325622559,18099,2534,15565,15565,0,11,2592000.0
2592,2592999,21.435842543234717,37.29755299140592,0.05522270092820092,385.2116940021515,167.98338079452515,564.1185874938965,18100,2534,15566,15566,0,11,2593000.0
2593,2593999,21.433005130588207,37.29300403781033,0.05523979626205544,385.36929965019226,168.0492160320282,564.2296867370605,18102,2535,15567,15567,0,11,2594000.0
2594,2594999,21.430217786806825,37.288075918269925,0.05525985250499987,385.61207151412964,168.11499738693237,564.3883018493652,18125,2538,15587,15587,0,11,2595000.0
2595,2595999,21.428002337746197,37.28359599119261,0.05527226689079612,385.77940940856934,168.18093252182007,564.5456962585449,18128,2539,15589,15589,0,11,2596000.0
2596,2596999,21.425378178944875,37.278747030281394,0.05527867173547896,385.9861922264099,168.2461256980896,564.6332397460938,18152,2541,15611,15611,0,11,2597000.0
2597,2597999,21.423465271963806,37.27489649322378,0.055267898051818753,386.20567297935486,168.3122682571411,564.8003044128418,18172,2543,15629,15629,0,11,2598000.0
2598,2598999,21.422209163526535,37.27151791971057,0.05525437889662266,386.34079670906067,168.3782501220703,564.9266128540039,18173,2543,15630,15630,0,11,2599000.0
2599,2599999,21.420648494832843,37.26733171076701,0.05524557802739427,386.50251603126526,168.44344472885132,565.0589294433594,18177,2544,15633,15633,0,11,2600000.0
2600,2600999,21.4199783108122,37.26520592672019,0.05518950998839767,386.70688557624817,168.50924611091614,565.5854721069336,18196,2546,15650,15650,0,11,2601000.0
2601,2601999,21.418999512188176,37.26224161616726,0.05517529373479102,386.8713757991791,168.57423210144043,565.7724914550781,18198,2547,15651,15651,0,11,2602000.0
2602,2602999,21.418330872806305,37.26023684349709,0.05515904811772354,386.99270009994507,168.63943910598755,565.9931373596191,18200,2547,15653,15653,0,11,2603000.0
2603,2603999,21.418725715514526,37.25838911208542,0.055120187514085206,387.15354895591736,168.70468711853027,566.3189926147461,18220,2548,15672,15672,0,11,2604000.0
2604,2604999,21.419401424818993,37.25714191377087,0.05510052890574302,387.31500005722046,168.77003264427185,566.4180526733398,18222,2549,15673,15673,0,11,2605000.0
2605,2605999,21.421295113126682,37.25726087291033,0.05505787335371248,387.4401104450226,168.83479404449463,566.6473236083984,18224,2549,15675,15675,0,11,2606000.0
2606,2606999,21.422333260105862,37.25693775656858,0.05501697615208623,387.65069246292114,168.90106225013733,566.650707244873,18231,2551,15680,15680,0,11,2607000.0
2607,2607999,21.42374963822579,37.256120087038525,0.05498987075481454,387.771803855896,168.96534276008606,566.8353385925293,18232,2551,15681,15681,0,11,2608000.0
2608,2608999,21.421854532471897,37.25285654452086,0.054972268809422076,387.942391872406,169.03721737861633,567.2234001159668,18251,2552,15699,15699,0,11,2609000.0
2609,2609999,21.418852675046377,37.24816368595512,0.054996818371782386,388.06201791763306,169.102126121521,567.5050048828125,18254,2552,15702,15702,0,11,2610000.0
2610,2610999,21.415891637953216,37.24411763981897,0.05502600467816077,388.22957491874695,169.16827988624573,567.6249656677246,18259,2553,15706,15706,0,11,2611000.0
2611,2611999,21.41243627144214,37.23866307819101,0.055057473351386665,388.39890241622925,169.23392248153687,567.7033882141113,18262,2554,15708,15708,0,11,2612000.0
2612,2612999,21.40947867854001,37.23395635931247,0.055090213381208564,388.5225591659546,169.29869079589844,567.933910369873,18265,2554,15711,15711,0,11,2613000.0
2613,2613999,21.40623309165801,37.22860891885518,0.0551195727416216,388.72717452049255,169.36398005485535,568.005500793457,18273,2556,15717,15717,0,11,2614000.0
2614,2614999,21.40311114985911,37.22411809179185,0.05513965667074627,388.88564467430115,169.4303970336914,568.2814064025879,18282,2557,15725,15725,0,11,2615000.0
2615,2615999,21.40015955689001,37.219383911989446,0.055151648408274134,389.0168557167053,169.4964566230774,568.4701843261719,18282,2557,15725,15725,0,11,2616000.0
2616,2616999,21.397094666928684,37.21396375804011,0.05517373774406986,389.3471601009369,169.56308579444885,568.4476432800293,18296,2562,15734,15734,0,11,2617000.0
2617,2617999,21.39449087905675,37.2095903235402,0.055182930879884684,389.5641701221466,169.6291320323944,568.560359954834,18304,2564,15740,15740,0,11,2618000.0
2618,2618999,21.39167946364621,37.2049387139553,0.05519164984206759,389.72336983680725,169.69436073303223,568.9553375244141,18311,2565,15746,15746,0,11,2619000.0
2619,2619999,21.38966357931067,37.20202492022567,0.05519708017196867,389.96929454803467,169.75973916053772,569.0294227600098,18317,2568,15749,15749,0,11,2620000.0
2620,2620999,21.38813839931667,37.1998630239395,0.05519694825332144,390.22572565078735,169.8256962299347,569.0891990661621,18328,2571,15757,15757,0,11,2621000.0
2621,2621999,21.38747123155933,37.19802022323104,0.05520244829766696,390.3555610179901,169.89111709594727,569.5302696228027,18336,2571,15765,15765,0,11,2622000.0
2622,2622999,21.388516293943017,37.20276740699834,0.05521001106806478,390.50985169410706,169.95613718032837,569.6818656921387,18338,2572,15766,15766,0,11,2623000.0
2623,2623999,21.38922471919961,37.202289057017765,0.05520970947275272,390.6336877346039,170.02206206321716,569.965389251709,18343,2572,15771,15771,0,11,2624000.0
2624,2624999,21.39038571172289,37.20240234431465,0.0552058880857228,390.7530243396759,170.08627128601074,570.1941833496094,18343,2572,15771,15771,0,11,2625000.0
2625,2625999,21.390968099146367,37.20166236760235,0.05521497775877671,390.87291955947876,170.15064239501953,570.3139686584473,18343,2572,15771,15771,0,11,2626000.0
2626,2626999,21.391286884989277,37.19953775552065,0.0552016868618348,391.07187581062317,170.21489024162292,570.4533462524414,18361,2574,15787,15787,0,11,2627000.0
2627,2627999,21.39050540467796,37.19633984640744,0.05517965199557151,391.3174226284027,170.27959442138672,570.5374526977539,18373,2577,15796,15796,0,11,2628000.0
2628,2628999,21.38732088916291,37.191073882896085,0.055187646242433774,391.4429545402527,170.34426593780518,571.0389060974121,18388,2577,15811,15811,0,11,2629000.0
2629,2629999,21.38379963272045,37.187822009588906,0.05519320488573942,391.5668957233429,170.41033625602722,571.5355682373047,18396,2577,15819,15819,0,11,2630000.0
2630,2630999,21.380299153325197,37.18267073046836,0.055203907915722494,391.78045535087585,170.47709965705872,571.8520851135254,18412,2579,15833,15833,0,11,2631000.0
2631,2631999,21.377632986553095,37.17842519767643,0.05520194807812895,391.90565633773804,170.54351043701172,572.0346908569336,18413,2579,15834,15834,0,11,2632000.0
2632,2632999,21.374400217671248,37.17333539953812,0.055218645186091986,392.07115602493286,170.60935473442078,572.281494140625,18420,2580,15840,15840,0,11,2633000.0
2633,2633999,21.371612592421723,37.16928984640242,0.05522199398995242,392.31128096580505,170.6744086742401,572.4018058776855,18435,2583,15852,15852,0,11,2634000.0
2634,2634999,21.368478792868327,37.164700787081436,0.05522683907484505,392.47654247283936,170.73949003219604,572.5589942932129,18437,2584,15853,15853,0,11,2635000.0
2635,2635999,21.365544768499102,37.159681881453565,0.05522685808415784,392.6972539424896,170.80593085289001,572.8667526245117,18453,2586,15867,15867,0,11,2636000.0
2636,2636999,21.36303437150696,37.15750737069699,0.05521391474775361,392.892703294754,170.87110328674316,572.9783973693848,18465,2588,15877,15877,0,11,2637000.0
2637,2637999,21.360404912425498,37.15321695336703,0.055216908243288954,393.09879207611084,170.93693017959595,573.1402893066406,18471,2590,15881,15881,0,11,2638000.0
2638,2638999,21.35779829652219,37.14861140739815,0.055212003260136644,393.3101313114166,171.00395345687866,573.497127532959,18482,2592,15890,15890,0,11,2639000.0
2639,2639999,21.355648901494177,37.14563999642258,0.05520300574704462,393.4726731777191,171.06889247894287,573.7266464233398,18487,2593,15894,15894,0,11,2640000.0
2640,2640999,21.35360411747545,37.14145056923482,0.05520120185666777,393.73209857940674,171.13681602478027,573.7478332519531,18506,2596,15910,15910,0,11,2641000.0
2641,2641999,21.351797398661443,37.13818074507039,0.0551921900065927,393.96176314353943,171.20678973197937,573.8230056762695,18510,2598,15912,15912,0,11,2642000.0
2642,2642999,21.351344981008808,37.13603576519819,0.05516453574455271,394.1254382133484,171.27363896369934,574.103385925293,18519,2599,15920,15920,0,11,2643000.0
2643,2643999,21.3509619811094,37.13347529004956,0.055146127369176234,394.3354914188385,171.3386106491089,574.1718368530273,18525,2601,15924,15924,0,11,2644000.0
2644,2644999,21.350990695411795,37.13134816618454,0.05514025684506885,394.5788254737854,171.40437197685242,574.3511199951172,18544,2604,15940,15940,0,11,2645000.0
2645,2645999,21.35289145875955,37.13198301733765,0.05514002385742878,394.74693393707275,171.4691240787506,574.5301704406738,18549,2605,15944,15944,0,11,2646000.0
2646,2646999,21.353888733036044,37.130670576947026,0.05515085784807816,394.91408371925354,171.53492140769958,574.6474876403809,18553,2606,15947,15947,0,11,2647000.0
2647,2647999,21.355723315744132,37.13161351242093,0.0551597192455735,395.1195113658905,171.59970426559448,574.7846450805664,18567,2608,15959,15959,0,11,2648000.0
2648,2648999,21.356028556223734,37.13124659443749,0.05515746870373206,395.24304604530334,171.6636803150177,574.9853477478027,18568,2608,15960,15960,0,11,2649000.0
2649,2649999,21.35378386311165,37.12778349222325,0.05514063496542099,395.35599279403687,171.72897267341614,575.4534301757812,18581,2608,15973,15973,0,11,2650000.0
2650,2650999,21.351378894572957,37.124102207730715,0.055108304162490906,395.4813942909241,171.79460072517395,575.8190498352051,18588,2608,15980,15980,0,11,2651000.0
2651,2651999,21.348953708269807,37.119840357223815,0.05508892850020786,395.6076533794403,171.85990452766418,575.9771690368652,18588,2608,15980,15980,0,11,2652000.0
2652,2652999,21.347021271368092,37.11653966080243,0.05505981314752617,395.7357954978943,171.92561721801758,576.0731544494629,18588,2608,15980,15980,0,11,2653000.0
2653,2653999,21.345454643690243,37.11355742733977,0.05503508897393394,395.95840549468994,171.99122428894043,576.1345825195312,18610,2610,16000,16000,0,11,2654000.0
2654,2654999,21.34378031384877,37.11057749034444,0.05502892234571988,396.24480175971985,172.05707049369812,576.2862815856934,18629,2614,16015,16015,0,11,2655000.0
2655,2655999,21.341966200296003,37.106954125657225,0.055026174558656216,396.4111375808716,172.12219500541687,576.4339981079102,18633,2615,16018,16018,0,11,2656000.0
2656,2656999,21.341033939763353,37.10383284784809,0.05498839213852158,396.5752127170563,172.18972778320312,576.6846160888672,18641,2616,16025,16025,0,11,2657000.0
2657,2657999,21.34080569234014,37.10184339745343,0.05495360220455081,396.7426030635834,172.2559666633606,576.8224678039551,18643,2617,16026,16026,0,11,2658000.0
2658,2658999,21.34098133273996,37.1004803213696,0.05494198030576847,396.86300683021545,172.3217384815216,577.0072593688965,18644,2617,16027,16027,0,11,2659000.0
2659,2659999,21.342526134800373,37.10232707809515,0.05494813924463282,397.0454206466675,172.3879578113556,577.3649673461914,18654,2618,16036,16036,0,11,2660000.0
2660,2660999,21.344570336360935,37.104848988463466,0.054994042045290126,397.16753005981445,172.45379400253296,577.6108779907227,18654,2618,16036,16036,0,11,2661000.0
2661,2661999,21.347182391598395,37.10900715611513,0.055019077689593465,397.425767660141,172.51935052871704,577.6298942565918,18663,2621,16042,16042,0,11,2662000.0
2662,2662999,21.3522387718184,37.12086058821577,0.055015063853243173,397.55502104759216,172.5852029323578,578.1074409484863,18672,2621,16051,16051,0,11,2663000.0
2663,2663999,21.35853515279081,37.1355068263877,0.05505888325094099,397.7161421775818,172.65040040016174,578.2796401977539,18674,2622,16052,16052,0,11,2664000.0
2664,2664999,21.36432836395595,37.1467677908113,0.05512731835186169,397.8858871459961,172.71603059768677,578.3990364074707,18679,2623,16056,16056,0,11,2665000.0
2665,2665999,21.369654012209118,37.15243274292607,0.05514977332770754,398.04718375205994,172.78136467933655,578.7580032348633,18690,2624,16066,16066,0,11,2666000.0
2666,2666999,21.37636171943222,37.16251739171298,0.05527074559247169,398.205029964447,172.84664344787598,578.8896217346191,18692,2625,16067,16067,0,11,2667000.0
2667,2667999,21.38140966403204,37.167284879149506,0.05528397412367758,398.49647665023804,172.9121446609497,579.0015487670898,18716,2629,16087,16087,0,11,2668000.0
2668,2668999,21.385226695592795,37.1729300921234,0.05526694085873063,398.6644368171692,172.97665214538574,579.1943054199219,18719,2630,16089,16089,0,11,2669000.0
2669,2669999,21.384031256614303,37.1730523888528,0.055221426878032887,398.78281021118164,173.0412085056305,579.5822944641113,18732,2630,16102,16102,0,11,2670000.0
2670,2670999,21.38253450168483,37.1731511695261,0.05520306473991776,398.90463399887085,173.10703802108765,579.8195915222168,18735,2630,16105,16105,0,11,2671000.0
2671,2671999,21.380085034858173,37.169420942848525,0.055198741713466615,399.0717263221741,173.17278957366943,579.9345703125,18745,2631,16114,16114,0,11,2672000.0
2672,2672999,21.377848830180632,37.1661619047529,0.05519208951868959,399.3203933238983,173.23983359336853,579.9413375854492,18758,2634,16124,16124,0,11,2673000.0
2673,2673999,21.37600598476733,37.16309340959714,0.05517218879534691,399.4885342121124,173.30659937858582,580.1638565063477,18763,2635,16128,16128,0,11,2674000.0
2674,2674999,21.373849060658827,37.15903542015156,0.05516143605509971,399.6114172935486,173.3712296485901,580.3847923278809,18765,2635,16130,16130,0,11,2675000.0
2675,2675999,21.371777909616846,37.15471982696345,0.055144021873818505,399.78513765335083,173.43651962280273,580.5138397216797,18775,2636,16139,16139,0,11,2676000.0
2676,2676999,21.37083144115985,37.15273881659174,0.05511865305224439,399.91219568252563,173.50199604034424,580.8374290466309,18779,2636,16143,16143,0,11,2677000.0
2677,2677999,21.369548638069784,37.149780030356716,0.05511975386033818,400.1985111236572,173.57624888420105,580.8150978088379,18790,2639,16151,16151,0,11,2678000.0
2678,2678999,21.36866731405923,37.1489365708031,0.05513714207631637,400.37671422958374,173.6429727077484,580.9763298034668,18795,2640,16155,16155,0,11,2679000.0
2679,2679999,21.36943011047613,37.15245516932621,0.055272918844036734,400.5028374195099,173.70865178108215,581.4391975402832,18807,2640,16167,16167,0,11,2680000.0
2680,2680999,21.372274868704242,37.159496515703204,0.055372310769809086,400.66882133483887,173.77348446846008,581.7140731811523,18809,2641,16168,16168,0,11,2681000.0
2681,2681999,21.375473900896342,37.16674606084296,0.055431967883280975,400.78608202934265,173.83821439743042,581.9271278381348,18809,2641,16168,16168,0,11,2682000.0
2682,2682999,21.38083223648921,37.18209682148972,0.05557303193063412,400.993545293808,173.9045844078064,582.2511863708496,18826,2643,16183,16183,0,11,2683000.0
2683,2683999,21.38677614661383,37.19549857290431,0.055619270391360276,401.1189866065979,173.97176098823547,582.5166015625,18826,2643,16183,16183,0,11,2684000.0
2684,2684999,21.39321269081279,37.20846428516452,0.05576670331817124,401.2376947402954,174.03731155395508,582.6936378479004,18826,2643,16183,16183,0,11,2685000.0
2685,2685999,21.40071398531598,37.22378068957267,0.055913656435300996,401.44423627853394,174.10307574272156,583.0197715759277,18843,2645,16198,16198,0,11,2686000.0
2686,2686999,21.408197574880063,37.23801518180672,0.05612021015062252,401.56569814682007,174.1688883304596,583.2287521362305,18843,2645,16198,16198,0,11,2687000.0
2687,2687999,21.414819888026134,37.25116151696823,0.05626826676982,401.6955122947693,174.2338662147522,583.3831825256348,18843,2645,16198,16198,0,11,2688000.0
2688,2688999,21.420559007109606,37.2623598452627,0.05637806520976418,401.8183629512787,174.2983751296997,583.6684455871582,18847,2645,16202,16202,0,11,2689000.0
2689,2689999,21.42126722561726,37.26188482688153,0.05640445078921885,401.93800830841064,174.36361837387085,584.019229888916,18858,2645,16213,16213,0,11,2690000.0
2690,2690999,21.419334521022623,37.26295690753592,0.05637853027863038,402.14204359054565,174.42872023582458,584.2560195922852,18868,2647,16221,16221,0,11,2691000.0
2691,2691999,21.417104952833025,37.25913607128124,0.056366560000973176,402.31853461265564,174.49459385871887,584.4341506958008,18870,2648,16222,16222,0,11,2692000.0
2692,2692999,21.414832578038094,37.25606718733585,0.05636267267575068,402.44492745399475,174.5602400302887,584.5895690917969,18871,2648,16223,16223,0,11,2693000.0
2693,2693999,21.4122465901492,37.252182079613334,0.05636113314721303,402.61613035202026,174.62697410583496,584.6586494445801,18873,2649,16224,16224,0,11,2694000.0
2694,2694999,21.409913355912053,37.24831795261678,0.05634698320180076,402.7412016391754,174.69185161590576,584.9613342285156,18877,2649,16228,16228,0,11,2695000.0
2695,2695999,21.408269531922127,37.24633845055463,0.05633580748983236,403.0364234447479,174.7574713230133,584.9962120056152,18887,2653,16234,16234,0,11,2696000.0
2696,2696999,21.40602328725119,37.24253267576076,0.05632389847309194,403.16844606399536,174.82336497306824,585.2586479187012,18890,2653,16237,16237,0,11,2697000.0
2697,2697999,21.40386006915402,37.23823144157853,0.05630851888954824,403.2863624095917,174.88933444023132,585.4494705200195,18891,2653,16238,16238,0,11,2698000.0
2698,2698999,21.40190153611224,37.23413465014882,0.05629307593314836,403.5103030204773,174.95609593391418,585.493766784668,18895,2655,16240,16240,0,11,2699000.0
2699,2699999,21.400219683177834,37.231840834005745,0.05627756788066718,403.62974977493286,175.02170300483704,585.6166114807129,18895,2655,16240,16240,0,11,2700000.0
2700,2700999,21.39878714085126,37.22868082377771,0.05625700098794706,403.83522868156433,175.0866997241974,585.8679580688477,18905,2657,16248,16248,0,11,2701000.0
2701,2701999,21.396856494340465,37.2251068197589,0.056248146272178556,404.0480840206146,175.1532325744629,586.0294380187988,18916,2659,16257,16257,0,11,2702000.0
2702,2702999,21.395046080008523,37.221851449253144,0.05623125234240822,404.23713421821594,175.21867108345032,586.1747932434082,18920,2660,16260,16260,0,11,2703000.0
2703,2703999,21.394668801796975,37.22412894163851,0.05619426340810896,404.36230397224426,175.28398442268372,586.5850639343262,18928,2660,16268,16268,0,11,2704000.0
2704,2704999,21.39420647949573,37.221959212320904,0.05616265887405891,404.57921290397644,175.3506565093994,586.705192565918,18937,2662,16275,16275,0,11,2705000.0
2705,2705999,21.39340654640303,37.21895515471244,0.05613278580195358,404.7909049987793,175.4162781238556,586.7994651794434,18942,2664,16278,16278,0,11,2706000.0
2706,2706999,21.3937422557973,37.21673709213829,0.05609667007205721,404.9504039287567,175.48139667510986,587.1502876281738,18952,2665,16287,16287,0,11,2707000.0
2707,2707999,21.393751706340275,37.21525413394625,0.0560709363740477,405.21020674705505,175.5473141670227,587.2549858093262,18962,2668,16294,16294,0,11,2708000.0
2708,2708999,21.39339264573763,37.212373305129496,0.056042832296420264,405.3682553768158,175.612473487854,587.4182510375977,18967,2669,16298,16298,0,11,2709000.0
2709,2709999,21.392499195103117,37.20923754520232,0.056008996274996004,405.53249526023865,175.67741346359253,587.6631889343262,18972,2670,16302,16302,0,11,2710000.0
2710,2710999,21.39025351639835,37.20488453675199,0.05599886109388519,405.6501045227051,175.74156141281128,587.898868560791,18976,2670,16306,16306,0,11,2711000.0
2711,2711999,21.386631742731073,37.20018828128929,0.05601831050525252,405.7853775024414,175.80662870407104,588.1566009521484,18981,2670,16311,16311,0,11,2712000.0
2712,2712999,21.38291825214202,37.1946745913585,0.05603871232570323,405.9078974723816,175.87181878089905,588.3445434570312,18982,2670,16312,16312,0,11,2713000.0
2713,2713999,21.379688577426116,37.18992197947777,0.05605634155216521,406.0799767971039,175.93763828277588,588.4604377746582,18985,2671,16314,16314,0,11,2714000.0
2714,2714999,21.376785955196514,37.18590172959701,0.05606249616071568,406.25222754478455,176.0043921470642,588.6071395874023,18991,2672,16319,16319,0,11,2715000.0
2715,2715999,21.373823391734604,37.18123357535658,0.056066359046437975,406.4175362586975,176.06919312477112,588.7858734130859,19001,2673,16328,16328,0,11,2716000.0
2716,2716999,21.371652071945356,37.17900531518476,0.05605543855849626,406.54331040382385,176.13375401496887,588.8895606994629,19001,2673,16328,16328,0,11,2717000.0
2717,2717999,21.369727226812692,37.175423440614075,0.05605269643107036,406.7634298801422,176.19951343536377,588.9244232177734,19006,2675,16331,16331,0,11,2718000.0
2718,2718999,21.36803326539167,37.17193035094366,0.05606852536353579,406.93380546569824,176.26501870155334,589.1575927734375,19011,2676,16335,16335,0,11,2719000.0
2719,2719999,21.366349324862828,37.16847365195604,0.056063323456376324,407.15631008148193,176.33128762245178,589.24462890625,19019,2678,16341,16341,0,11,2720000.0
2720,2720999,21.364534373716033,37.164764634891036,0.0560684464377641,407.3325819969177,176.39739418029785,589.3812484741211,19021,2679,16342,16342,0,11,2721000.0
2721,2721999,21.364344778545824,37.16272015837741,0.056055546230499576,407.54973316192627,176.4648666381836,589.8776397705078,19043,2681,16362,16362,0,11,2722000.0
2722,2722999,21.36417128554191,37.16163773094197,0.056064527021283395,407.6646785736084,176.53001260757446,590.1188087463379,19043,2681,16362,16362,0,11,2723000.0
2723,2723999,21.364580152136803,37.16049331124203,0.056056905818888,407.8854854106903,176.59711408615112,590.1955947875977,19057,2683,16374,16374,0,11,2724000.0
2724,2724999,21.36508087846668,37.15961166159531,0.05605822366133917,408.00163745880127,176.6622712612152,590.540168762207,19065,2683,16382,16382,0,11,2725000.0
2725,2725999,21.36572705279693,37.158502074900625,0.0560779893713409,408.1245183944702,176.72758650779724,590.6915626525879,19066,2683,16383,16383,0,11,2726000.0
2726,2726999,21.366581958517855,37.158182135650264,0.056084182938689,408.34654688835144,176.79689073562622,590.6992492675781,19070,2685,16385,16385,0,11,2727000.0
2727,2727999,21.367954173826366,37.15823981306024,0.056079230888573695,408.51313066482544,176.86204528808594,591.0203437805176,19079,2686,16393,16393,0,11,2728000.0
2728,2728999,21.369666578689174,37.15889143431098,0.05610262446423864,408.8002939224243,176.9270842075348,591.0758323669434,19102,2690,16412,16412,0,11,2729000.0
2729,2729999,21.370946331636453,37.15847501974474,0.05612355643749556,408.9660222530365,176.99194836616516,591.2008857727051,19108,2691,16417,16417,0,11,2730000.0
2730,2730999,21.3715533787868,37.15756363791228,0.056117873944006136,409.0832211971283,177.0562183856964,591.4312782287598,19110,2691,16419,16419,0,11,2731000.0
2731,2731999,21.370200649225,37.15492029029492,0.05612656489034196,409.28660559654236,177.1218137741089,591.7379112243652,19129,2693,16436,16436,0,11,2732000.0
2732,2732999,21.366899768993527,37.150964324024365,0.056153524250049824,409.40429639816284,177.18704056739807,592.0322265625,19134,2693,16441,16441,0,11,2733000.0
2733,2733999,21.36436623164066,37.149240474792485,0.05616515544900902,409.52914571762085,177.25261807441711,592.2165489196777,19135,2693,16442,16442,0,11,2734000.0
2734,2734999,21.361275502998307,37.144400692852756,0.05618988276941561,409.74213671684265,177.31923413276672,592.2729301452637,19148,2695,16453,16453,0,11,2735000.0
2735,2735999,21.358526235824716,37.14013003747458,0.05621320719623091,409.8750853538513,177.3848967552185,592.5349769592285,19154,2695,16459,16459,0,11,2736000.0
2736,2736999,21.35624108542263,37.136634120806164,0.05622992572872898,409.9992513656616,177.4499135017395,592.7481689453125,19156,2695,16461,16461,0,11,2737000.0
2737,2737999,21.354142828763436,37.133279194412445,0.056243402959840205,410.12804794311523,177.51521611213684,592.8970794677734,19157,2695,16462,16462,0,11,2738000.0
2738,2738999,21.352136415071143,37.12993976321785,0.05624214686187223,410.2965350151062,177.58141112327576,593.1246337890625,19168,2696,16472,16472,0,11,2739000.0
2739,2739999,21.350416487484683,37.12684420863614,0.05624353580413688,410.46819972991943,177.6471929550171,593.3126983642578,19176,2697,16479,16479,0,11,2740000.0
2740,2740999,21.348382872587628,37.12317537272387,0.05625032904591687,410.6013648509979,177.71256041526794,593.4519462585449,19176,2697,16479,16479,0,11,2741000.0
2741,2741999,21.346978177210683,37.12019170468155,0.056235331030378255,410.76850938796997,177.77863955497742,594.0816268920898,19193,2698,16495,16495,0,11,2742000.0
2742,2742999,21.345190761902884,37.117615484914545,0.05623669749829352,410.9050381183624,177.84488606452942,594.3533592224121,19194,2698,16496,16496,0,11,2743000.0
2743,2743999,21.343625591887932,37.11562489447357,0.05624552348914946,411.0299565792084,177.9106719493866,594.5760498046875,19196,2698,16498,16498,0,11,2744000.0
2744,2744999,21.34234226892987,37.11241892409952,0.05624691707841756,411.15463733673096,177.97613549232483,595.0160636901855,19205,2698,16507,16507,0,11,2745000.0
2745,2745999,21.34177398486928,37.11082949173835,0.05623970675118761,411.31494545936584,178.04268097877502,595.1903228759766,19214,2699,16515,16515,0,11,2746000.0
2746,2746999,21.3411272812296,37.10770879708349,0.05622686750616812,411.4381422996521,178.10819292068481,595.4726676940918,19217,2699,16518,16518,0,11,2747000.0
2747,2747999,21.340423487588108,37.10451747067419,0.05621211656868985,411.57434916496277,178.1730613708496,595.613842010498,19219,2699,16520,16520,0,11,2748000.0
2748,2748999,21.339311988232595,37.10120692594537,0.05620370658391416,411.7358431816101,178.23761558532715,595.803394317627,19223,2700,16523,16523,0,11,2749000.0
2749,2749999,21.33678763218828,37.09751906446178,0.0562067525184935,411.91047382354736,178.30252242088318,596.0952758789062,19239,2701,16538,16538,0,11,2750000.0
2750,2750999,21.333190874569514,37.092911962039686,0.056233900889424704,412.0270359516144,178.36745762825012,596.3043022155762,19240,2701,16539,16539,0,11,2751000.0
2751,2751999,21.329444482417067,37.08743305547061,0.05627792529207942,412.15266370773315,178.43402576446533,596.5022277832031,19243,2701,16542,16542,0,11,2752000.0
2752,2752999,21.32607476340713,37.08296006027391,0.05630412871064838,412.2821183204651,178.49970602989197,596.597785949707,19243,2701,16542,16542,0,11,2753000.0
2753,2753999,21.323169025300707,37.07863530862045,0.056336335828934825,412.41439270973206,178.5661735534668,596.8105163574219,19246,2701,16545,16545,0,11,2754000.0
2754,2754999,21.319923376540658,37.07411205336942,0.056363030533222336,412.54442286491394,178.63078594207764,596.9169235229492,19246,2701,16545,16545,0,11,2755000.0
2755,2755999,21.317035513295977,37.07031098970591,0.05637436940064977,412.67393803596497,178.69551825523376,597.0331230163574,19246,2701,16545,16545,0,11,2756000.0
2756,2756999,21.314243155084977,37.066476992697915,0.05638253861452791,412.80845856666565,178.7609782218933,597.2041664123535,19248,2701,16547,16547,0,11,2757000.0
2757,2757999,21.31158012691342,37.06258422004259,0.05639335712526106,413.02688550949097,178.826988697052,597.2609062194824,19260,2703,16557,16557,0,11,2758000.0
2758,2758999,21.30888837438574,37.05858872295328,0.05640364730375247,413.2009575366974,178.89281034469604,597.4517211914062,19263,2704,16559,16559,0,11,2759000.0
2759,2759999,21.307788072245934,37.063156823617376,0.05636991587882001,413.3203070163727,178.95844984054565,597.8798675537109,19270,2704,16566,16566,0,11,2760000.0
2760,2760999,21.305814184174658,37.05982421991468,0.05637278533579737,413.585791349411,179.0244483947754,597.9112167358398,19279,2707,16572,16572,0,11,2761000.0
2761,2761999,21.30456530213021,37.05727519937087,0.05635552061668825,413.85188484191895,179.09098386764526,597.9530639648438,19310,2710,16600,16600,0,11,2762000.0
2762,2762999,21.303319126401362,37.054740040274275,0.056347455122983,414.0214624404907,179.15694403648376,598.263786315918,19321,2711,16610,16610,0,11,2763000.0
2763,2763999,21.30351156980394,37.0544575959615,0.056339446308027896,414.1889805793762,179.22240662574768,598.4172668457031,19324,2712,16612,16612,0,11,2764000.0
2764,2764999,21.30299558128992,37.052855741024736,0.05632843863176573,414.36315178871155,179.28781867027283,598.4823570251465,19326,2713,16613,16613,0,11,2765000.0
2765,2765999,21.30264640634682,37.05184479322368,0.05631555689206891,414.5804419517517,179.35430216789246,598.6239967346191,19334,2715,16619,16619,0,11,2766000.0
2766,2766999,21.30222113649428,37.05045609906651,0.056308478878819956,414.7976574897766,179.41971445083618,598.6621170043945,19344,2717,16627,16627,0,11,2767000.0
2767,2767999,21.301611130307837,37.04821989769096,0.05629478137036503,414.9186625480652,179.48401880264282,598.7472038269043,19344,2717,16627,16627,0,11,2768000.0
2768,2768999,21.30055268475926,37.045461645416665,0.056282922739834595,415.0393052101135,179.54827880859375,598.941349029541,19346,2717,16629,16629,0,11,2769000.0
2769,2769999,21.298151280626865,37.04218619895262,0.05627845865694514,415.2023837566376,179.61323285102844,599.19091796875,19359,2718,16641,16641,0,11,2770000.0
2770,2770999,21.294693026240836,37.03722565951207,0.05629337261721501,415.3183717727661,179.67837071418762,599.4418601989746,19364,2718,16646,16646,0,11,2771000.0
2771,2771999,21.291604424434077,37.03302046912024,0.056297341569433335,415.48343896865845,179.74477171897888,599.6087341308594,19366,2719,16647,16647,0,11,2772000.0
2772,2772999,21.288268409112323,37.029117531588334,0.05630851731679998,415.652220249176,179.81117057800293,599.726936340332,19373,2720,16653,16653,0,11,2773000.0
2773,2773999,21.28545230084159,37.02552622686255,0.056318365035972096,415.8262255191803,179.87717413902283,599.7742347717285,19378,2721,16657,16657,0,11,2774000.0
2774,2774999,21.282857069843296,37.02151310557843,0.056310120261598984,415.9550869464874,179.94193863868713,599.9961585998535,19381,2721,16660,16660,0,11,2775000.0
2775,2775999,21.280533222577137,37.01705613071969,0.056301822386636835,416.0936861038208,180.00648546218872,600.082633972168,19381,2721,16660,16660,0,11,2776000.0
2776,2776999,21.277850976738115,37.01233063290637,0.05629782928334848,416.25927805900574,180.07266473770142,600.1945114135742,19384,2722,16662,16662,0,11,2777000.0
2777,2777999,21.275910737469122,37.00841740538458,0.05627791074725419,416.37578082084656,180.13784337043762,600.3328018188477,19386,2722,16664,16664,0,11,2778000.0
2778,2778999,21.274209308383607,37.004351812630745,0.05625537655264656,416.5012288093567,180.20348191261292,600.4153213500977,19386,2722,16664,16664,0,11,2779000.0
2779,2779999,21.272182330105352,37.00015279336151,0.05623452600875822,416.63629364967346,180.2685887813568,600.4922027587891,19386,2722,16664,16664,0,11,2780000.0
2780,2780999,21.271321121756426,36.99803096265391,0.056180869811402245,416.7468101978302,180.33317756652832,600.8382530212402,19391,2722,16669,16669,0,11,2781000.0
2781,2781999,21.269532095595736,36.994463792377765,0.05615864382505176,416.97343730926514,180.39916276931763,600.9184074401855,19395,2724,16671,16671,0,11,2782000.0
2782,2782999,21.26798317297811,36.991463489330116,0.0561382543868334,417.1850936412811,180.46452069282532,600.9169540405273,19405,2726,16679,16679,0,11,2783000.0
2783,2783999,21.266534766855504,36.988075363168235,0.056114850201700595,417.35214495658875,180.52990865707397,601.1641540527344,19413,2727,16686,16686,0,11,2784000.0
2784,2784999,21.26544940309828,36.984802630348526,0.05609131458630234,417.5263979434967,180.59505581855774,601.2774810791016,19415,2728,16687,16687,0,11,2785000.0
2785,2785999,21.264953043497027,36.98246498429851,0.05605705919648463,417.669385433197,180.67284178733826,601.4080619812012,19416,2728,16688,16688,0,11,2786000.0
2786,2786999,21.26459195135281,36.97955237067023,0.0560157939301863,417.84048891067505,180.73744368553162,601.6347160339355,19426,2729,16697,16697,0,11,2787000.0
2787,2787999,21.26417229697933,36.9787247606418,0.0559695130448542,417.960657119751,180.8014464378357,601.7470970153809,19426,2729,16697,16697,0,11,2788000.0
2788,2788999,21.263190294694976,36.9755925177579,0.05594802178505187,418.0855438709259,180.8657295703888,601.821647644043,19426,2729,16697,16697,0,11,2789000.0
2789,2789999,21.261524735183567,36.97184634517881,0.055925178591129776,418.2428660392761,180.93003845214844,602.084098815918,19452,2730,16722,16722,0,11,2790000.0
2790,2790999,21.261429682335926,36.97576547977358,0.05589955590537721,418.3555197715759,180.99546933174133,602.4142723083496,19462,2730,16732,16732,0,11,2791000.0
2791,2791999,21.26104370969681,36.976798433566415,0.055882687650597895,418.52901005744934,181.06133270263672,602.7070808410645,19481,2731,16750,16750,0,11,2792000.0
2792,2792999,21.259303524074994,36.975671793800814,0.055877529260050074,418.6496047973633,181.12700581550598,602.8830223083496,19481,2731,16750,16750,0,11,2793000.0
2793,2793999,21.25795746686624,36.97507679704989,0.05588804312438789,418.77405071258545,181.19391179084778,603.0316009521484,19482,2731,16751,16751,0,11,2794000.0
2794,2794999,21.25671427249532,36.97404332734956,0.055879041008536134,418.90567922592163,181.25996923446655,603.1210136413574,19482,2731,16751,16751,0,11,2795000.0
2795,2795999,21.256953672805736,36.97665080956031,0.05584458658438596,419.1151764392853,181.32503652572632,603.2772483825684,19489,2733,16756,16756,0,11,2796000.0
2796,2796999,21.25527932534303,36.9738182413891,0.05588360450263441,419.3359909057617,181.39091444015503,603.3899002075195,19493,2735,16758,16758,0,11,2797000.0
2797,2797999,21.254445741513816,36.97317347264424,0.05591635400578332,419.4572665691376,181.4570038318634,603.6039390563965,19494,2735,16759,16759,0,11,2798000.0
2798,2798999,21.254287275603605,36.97314317846633,0.055913162596376687,419.5812566280365,181.52247619628906,603.741828918457,19495,2735,16760,16760,0,11,2799000.0
2799,2799999,21.2542113283749,36.97862663558721,0.05587463187854036,419.8349552154541,181.58852338790894,603.7516632080078,19501,2738,16763,16763,0,11,2800000.0
2800,2800999,21.253766528092253,36.977176277551024,0.05589566136586155,419.97216725349426,181.65466713905334,604.0663032531738,19509,2738,16771,16771,0,11,2801000.0
2801,2801999,21.253518437764754,36.97595523139856,0.05588066010086601,420.1842362880707,183.64499640464783,604.2864837646484,19514,2740,16774,16774,0,11,2802000.0
2802,2802999,21.253516224624065,36.97567091810967,0.05587554211497092,420.3594994544983,183.71058630943298,604.4569511413574,19528,2741,16787,16787,0,11,2803000.0
2803,2803999,21.253555226847574,36.97537876199535,0.055841382501384706,420.5346486568451,183.77636861801147,604.615665435791,19532,2742,16790,16790,0,11,2804000.0
2804,2804999,21.253427945203487,36.97414450844101,0.05580409137544373,420.6605222225189,183.84268808364868,604.9020195007324,19536,2742,16794,16794,0,11,2805000.0
2805,2805999,21.25355702257037,36.972578104526846,0.05579287039694425,420.88300108909607,183.90902423858643,604.9845657348633,19541,2744,16797,16797,0,11,2806000.0
2806,2806999,21.25411306687018,36.97157511606466,0.05577681666096168,421.0215492248535,183.97460651397705,605.3061599731445,19547,2744,16803,16803,0,11,2807000.0
2807,2807999,21.255774525830496,36.9782659277179,0.05574057496815399,421.1428918838501,184.0403482913971,605.4906005859375,19547,2744,16803,16803,0,11,2808000.0
2808,2808999,21.256222194943987,36.97691142798453,0.05571467901417915,421.2667200565338,184.10524368286133,605.6139259338379,19547,2744,16803,16803,0,11,2809000.0
2809,2809999,21.25654511114499,36.97523179083773,0.055681755272712796,421.43785977363586,184.17079138755798,605.8253021240234,19554,2745,16809,16809,0,11,2810000.0
2810,2810999,21.25520163262168,36.97145201491729,0.05566781692469491,421.6115198135376,184.23542094230652,605.99267578125,19561,2746,16815,16815,0,11,2811000.0
2811,2811999,21.251583131786177,36.96707925860668,0.05567935323729023,421.7329316139221,184.30128598213196,606.3111000061035,19572,2746,16826,16826,0,11,2812000.0
2812,2812999,21.248136178188542,36.962761459805705,0.05569405073728628,421.8611454963684,184.36742568016052,606.5081481933594,19572,2746,16826,16826,0,11,2813000.0
2813,2813999,21.2446444046251,36.95850508580415,0.05571491403603168,422.1439290046692,184.43498015403748,606.5140724182129,19589,2749,16840,16840,0,11,2814000.0
2814,2814999,21.24125632026807,36.953718583573846,0.055736086388912254,422.4165418148041,184.5019176006317,606.5297355651855,19602,2752,16850,16850,0,11,2815000.0
2815,2815999,21.238090579062778,36.949013670431555,0.055756672307312294,422.55627036094666,184.57145833969116,606.7884979248047,19607,2752,16855,16855,0,11,2816000.0
2816,2816999,21.235411252492817,36.945627117274476,0.05576572627120613,422.73953104019165,184.63764023780823,606.9290885925293,19609,2753,16856,16856,0,11,2817000.0
2817,2817999,21.232810613880233,36.941950647424,0.05576810358205464,422.8594903945923,184.70311737060547,607.0470275878906,19609,2753,16856,16856,0,11,2818000.0
2818,2818999,21.23010363990412,36.937829262700134,0.05577201707143076,422.9992461204529,184.76892638206482,607.2627868652344,19612,2753,16859,16859,0,11,2819000.0
2819,2819999,21.227389903791234,36.933257583658296,0.05577160080780963,423.22670578956604,184.83476400375366,607.2814788818359,19616,2755,16861,16861,0,11,2820000.0
2820,2820999,21.225023592087922,36.92900116221327,0.05576760376455159,423.3639235496521,184.90053248405457,607.3847999572754,19616,2755,16861,16861,0,11,2821000.0
2821,2821999,21.22331295772701,36.92616630818698,0.05574311492437356,423.49904131889343,184.9668424129486,607.8378295898438,19628,2755,16873,16873,0,11,2822000.0
2822,2822999,21.222931363612823,36.93299431778404,0.05570032991749774,423.76895546913147,185.03342819213867,608.027961730957,19643,2758,16885,16885,0,11,2823000.0
2823,2823999,21.222921387840554,36.933128607287976,0.05567838891423804,423.93967056274414,185.09937644004822,608.1787872314453,19648,2759,16889,16889,0,11,2824000.0
2824,2824999,21.22295291008996,36.932906704551776,0.05567491938192737,424.1075863838196,185.16573214530945,608.5144653320312,19660,2760,16900,16900,0,11,2825000.0
2825,2825999,21.22428810840739,36.93487576324728,0.055658570472606805,424.23764872550964,185.23260760307312,608.7464599609375,19660,2760,16900,16900,0,11,2826000.0
2826,2826999,21.225206117985874,36.93518820418653,0.05565484372614704,424.41118812561035,185.30094265937805,608.9089431762695,19681,2761,16920,16920,0,11,2827000.0
2827,2827999,21.225658553454746,36.93405384740479,0.055629674703634,424.5936403274536,185.36779594421387,609.3843040466309,19718,2762,16956,16956,0,11,2828000.0
2828,2828999,21.227542193271024,36.93566259739349,0.055627318002525294,424.8279995918274,185.43540978431702,609.5473670959473,19722,2764,16958,16958,0,11,2829000.0
2829,2829999,21.228495187231125,36.935238950725534,0.0556389236763154,425.051531791687,185.5011637210846,609.6498756408691,19732,2766,16966,16966,0,11,2830000.0
2830,2830999,21.228658751100753,36.93352780205391,0.05563031275703845,425.21937894821167,185.5668067932129,609.9536094665527,19739,2767,16972,16972,0,11,2831000.0
2831,2831999,21.227617757333316,36.930880119789336,0.05561574535448377,425.39550733566284,185.63237643241882,610.3083267211914,19755,2768,16987,16987,0,11,2832000.0
2832,2832999,21.224956299063347,36.92820172659051,0.05559985601123707,425.6079385280609,185.6978747844696,610.4580421447754,19772,2770,17002,17002,0,11,2833000.0
2833,2833999,21.222014769164435,36.92496758327863,0.05561181661025083,425.7294125556946,185.7639091014862,610.6782379150391,19774,2770,17004,17004,0,11,2834000.0
2834,2834999,21.218759253940224,36.920064566702194,0.055623738255683786,425.8584449291229,185.83082175254822,610.8295593261719,19775,2770,17005,17005,0,11,2835000.0
2835,2835999,21.216313932205097,36.91614701375305,0.05563803380728416,426.02964997291565,185.89707827568054,610.9174003601074,19781,2771,17010,17010,0,11,2836000.0
2836,2836999,21.214291164333265,36.91382060282727,0.05563901706723395,426.199161529541,185.96271061897278,611.1035804748535,19786,2772,17014,17014,0,11,2837000.0
2837,2837999,21.212734571889452,36.912375849113275,0.05563771433535014,426.51199173927307,186.02861881256104,611.1352729797363,19797,2776,17021,17021,0,11,2838000.0
2838,2838999,21.211930706326626,36.91183165163129,0.05564046101719222,426.6379728317261,186.09399366378784,611.2609214782715,19797,2776,17021,17021,0,11,2839000.0
2839,2839999,21.211596502246618,36.913511971377545,0.055642738806015446,426.7640345096588,186.15992403030396,611.5439071655273,19801,2776,17025,17025,0,11,2840000.0
2840,2840999,21.211758553257102,36.91565613794359,0.055644595397283725,426.9918382167816,186.2265260219574,611.6120491027832,19806,2778,17028,17028,0,11,2841000.0
2841,2841999,21.21250344417535,36.91868806463615,0.05565748262640646,427.1274311542511,186.29235649108887,611.7617301940918,19806,2778,17028,17028,0,11,2842000.0
2842,2842999,21.214745706232705,36.92484264113858,0.05568686980396054,427.2524857521057,186.35751676559448,612.0331077575684,19809,2778,17031,17031,0,11,2843000.0
2843,2843999,21.219109463382058,36.94011967742834,0.05571863679210798,427.5271852016449,186.42349457740784,612.0809097290039,19815,2781,17034,17034,0,11,2844000.0
2844,2844999,21.222326900393515,36.94743419561958,0.05578887483841233,427.660368680954,186.48874521255493,612.2274894714355,19815,2781,17034,17034,0,11,2845000.0
2845,2845999,21.227104307761028,36.96081949076308,0.05584440035896465,427.84190678596497,186.5548689365387,612.625114440918,19830,2782,17048,17048,0,11,2846000.0
2846,2846999,21.231942867113524,36.97264409652573,0.055880001756937525,428.004807472229,186.620751619339,612.8007621765137,19832,2783,17049,17049,0,11,2847000.0
2847,2847999,21.23715051098367,36.98711288415373,0.05591199964070592,428.1708548069,186.68757915496826,612.9343490600586,19838,2784,17054,17054,0,11,2848000.0
2848,2848999,21.242500293654942,37.0010460530466,0.05589534344861591,428.33985447883606,186.75270700454712,613.1606178283691,19855,2785,17070,17070,0,11,2849000.0
2849,2849999,21.246264267552,37.00902726608723,0.05594144211281593,428.6094219684601,186.8183877468109,613.1410446166992,19867,2788,17079,17079,0,11,2850000.0
2850,2850999,21.251150270422073,37.01948658710809,0.056002836118574595,428.83138489723206,186.88384079933167,613.3480110168457,19877,2790,17087,17087,0,11,2851000.0
2851,2851999,21.253754754428325,37.024256040011004,0.056010704851822135,428.950786113739,186.94985008239746,613.5875358581543,19878,2790,17088,17088,0,11,2852000.0
2852,2852999,21.252091310500877,37.02174054736095,0.056007381246615306,429.06596279144287,187.01432466506958,614.0462188720703,19890,2790,17100,17100,0,11,2853000.0
2853,2853999,21.249562734259015,37.01864707592829,0.05600669918728174,429.23942255973816,187.081401348114,614.4410934448242,19903,2791,17112,17112,0,11,2854000.0
2854,2854999,21.246711844913122,37.01414755371369,0.05601547653527661,429.3655843734741,187.14723944664001,614.6602363586426,19903,2791,17112,17112,0,11,2855000.0
2855,2855999,21.245612669389995,37.01714979500013,0.05599248376684263,429.4882638454437,187.21309351921082,614.7797966003418,19903,2791,17112,17112,0,11,2856000.0
2856,2856999,21.243675370746963,37.013818139988615,0.055984598082498116,429.7124996185303,187.28050875663757,614.7978744506836,19907,2793,17114,17114,0,11,2857000.0
2857,2857999,21.24232720193911,37.011142592421585,0.055967744884175885,429.8340640068054,187.34617280960083,615.1264877319336,19910,2793,17117,17117,0,11,2858000.0
2858,2858999,21.240499481340922,37.00737872011565,0.055955692853554506,430.0459966659546,187.41125559806824,615.1856002807617,19914,2795,17119,17119,0,11,2859000.0
2859,2859999,21.239445726741764,37.005428990989856,0.05594119079771753,430.2191722393036,187.47668623924255,615.4045372009277,19922,2796,17126,17126,0,11,2860000.0
2860,2860999,21.23871006665386,37.00444403930182,0.05592013238193139,430.38758754730225,187.54333305358887,615.5322608947754,19925,2797,17128,17128,0,11,2861000.0
2861,2861999,21.237996370739854,37.00226077001007,0.055906096688126516,430.5070071220398,187.6101725101471,615.6981201171875,19925,2797,17128,17128,0,11,2862000.0
2862,2862999,21.237024358503692,37.00015739524717,0.05589257768549849,430.77554726600647,187.6767680644989,615.7392044067383,19931,2800,17131,17131,0,11,2863000.0
2863,2863999,21.237159880524842,37.00020660755267,0.05584519786422104,430.9192099571228,187.75111317634583,616.390796661377,19949,2800,17149,17149,0,11,2864000.0
2864,2864999,21.236838834707154,36.99834065952664,0.05583869697684496,431.08671832084656,187.8164267539978,616.5383415222168,19963,2801,17162,17162,0,11,2865000.0
2865,2865999,21.236734351276887,36.99767132386513,0.05582986666442291,431.2566246986389,187.88221645355225,616.6423263549805,19965,2802,17163,17163,0,11,2866000.0
2866,2866999,21.23727141639707,36.996977047292155,0.05581026717862425,431.4289996623993,187.9497148990631,617.1481628417969,19979,2803,17176,17176,0,11,2867000.0
2867,2867999,21.237337826619,36.997025173109456,0.05580879812117978,431.59775471687317,188.01584029197693,617.3604850769043,19985,2804,17181,17181,0,11,2868000.0
2868,2868999,21.237718044744625,36.99606744981208,0.055799750140550386,431.76788902282715,188.08187246322632,617.4715614318848,19987,2805,17182,17182,0,11,2869000.0
2869,2869999,21.23848529812041,36.99564141718682,0.055784682552726284,431.8917484283447,188.14774179458618,617.829704284668,19993,2805,17188,17188,0,11,2870000.0
2870,2870999,21.238856354627337,36.99415264621957,0.0557683570601718,432.09823179244995,188.21341013908386,617.9065704345703,20008,2807,17201,17201,0,11,2871000.0
2871,2871999,21.23905911861712,36.99253830089335,0.05575545544196259,432.32266211509705,188.27926445007324,618.0025291442871,20016,2809,17207,17207,0,11,2872000.0
2872,2872999,21.238773604746726,36.98991322885838,0.05573724965620719,432.534298658371,188.34413194656372,618.1340065002441,20024,2811,17213,17213,0,11,2873000.0
2873,2873999,21.236781751540832,36.98577204962848,0.05573323261249796,432.7131190299988,188.40920424461365,618.5249938964844,20043,2812,17231,17231,0,11,2874000.0
2874,2874999,21.233741452851074,36.981502068540536,0.05574648923721237,432.8770682811737,188.47614359855652,618.8273658752441,20056,2813,17243,17243,0,11,2875000.0
2875,2875999,21.231022754936447,36.979073048144514,0.055753625886420966,433.00094413757324,188.5419409275055,619.0272827148438,20057,2813,17244,17244,0,11,2876000.0
2876,2876999,21.22842642300835,36.97540284605362,0.05576223086085508,433.22258949279785,188.6086483001709,619.0595359802246,20064,2815,17249,17249,0,11,2877000.0
2877,2877999,21.225628845224126,36.97089718668501,0.05577670966371684,433.3936541080475,188.67646551132202,619.4099540710449,20079,2816,17263,17263,0,11,2878000.0
2878,2878999,21.22362737221136,36.96766807764895,0.05576869331736323,433.6504075527191,188.74265336990356,619.5637397766113,20090,2819,17271,17271,0,11,2879000.0
2879,2879999,21.221267021298512,36.96375260605656,0.05577146139042044,433.81195187568665,188.80826950073242,619.7661247253418,20099,2820,17279,17279,0,11,2880000.0
2880,2880999,21.219534364109023,36.96066761255764,0.05576520571167276,433.9312391281128,188.87548637390137,620.2296485900879,20106,2820,17286,17286,0,11,2881000.0
2881,2881999,21.218181701076887,36.95783163294989,0.05575654864410129,434.19676399230957,188.9436070919037,620.3456039428711,20113,2823,17290,17290,0,11,2882000.0
2882,2882999,21.217180941481338,36.956020702437236,0.05575693936814097,434.46004343032837,189.01059341430664,620.3896827697754,20124,2826,17298,17298,0,11,2883000.0
2883,2883999,21.217072367318632,36.954295238358036,0.0557548393834395,434.62815833091736,189.0772521495819,621.0558815002441,20155,2827,17328,17328,0,11,2884000.0
2884,2884999,21.217211256401733,36.954031235914385,0.05576819742984407,434.8922510147095,189.1438295841217,621.2660789489746,20177,2830,17347,17347,0,11,2885000.0
2885,2885999,21.21777126572789,36.95295785969192,0.05577899061332903,435.0103905200958,189.2102975845337,621.6552505493164,20185,2830,17355,17355,0,11,2886000.0
2886,2886999,21.2194137959547,36.9533991399294,0.05578301874253344,435.1777386665344,189.27651286125183,621.9717102050781,20194,2831,17363,17363,0,11,2887000.0
2887,2887999,21.22083179975765,36.95313288653747,0.055811618064215196,435.3518981933594,189.3422372341156,622.1500930786133,20196,2832,17364,17364,0,11,2888000.0
2888,2888999,21.222463594916032,36.95255088144635,0.05581036317330257,435.52236795425415,189.40776419639587,622.4497566223145,20207,2833,17374,17374,0,11,2889000.0
2889,2889999,21.223072588526975,36.951159251092356,0.05580340818235918,435.69219851493835,189.4730715751648,622.5882263183594,20212,2834,17378,17378,0,11,2890000.0
2890,2890999,21.223019361471856,36.948452967826505,0.0558049382396254,435.9073715209961,189.53910493850708,622.7704010009766,20227,2836,17391,17391,0,11,2891000.0
2891,2891999,21.221622945219007,36.94991033887566,0.05578192033849849,436.0337014198303,189.60499835014343,623.3163871765137,20241,2836,17405,17405,0,11,2892000.0
2892,2892999,21.219391377053046,36.946922349814,0.05580073884352099,436.16799569129944,189.67218708992004,623.6775093078613,20247,2836,17411,17411,0,11,2893000.0
2893,2893999,21.217331642895147,36.9427058281172,0.05581951632490534,436.33747124671936,189.73871302604675,623.9663543701172,20264,2837,17427,17427,0,11,2894000.0
2894,2894999,21.21602964601681,36.94065947254694,0.05584857344310712,436.52289843559265,189.80544781684875,624.4001998901367,20278,2838,17440,17440,0,11,2895000.0
2895,2895999,21.214421641388775,36.937705692022774,0.055852521081547146,436.69773530960083,189.87146186828613,624.6746597290039,20293,2839,17454,17454,0,11,2896000.0
2896,2896999,21.213102738221185,36.93474442508088,0.05584623834523805,436.8694806098938,189.9374179840088,624.9335594177246,20303,2840,17463,17463,0,11,2897000.0
2897,2897999,21.211405178806082,36.93106054334919,0.05584587817123998,437.0040771961212,190.00335669517517,625.1826820373535,20311,2840,17471,17471,0,11,2898000.0
2898,2898999,21.20985861106805,36.92791328718133,0.05584165305159594,437.1353724002838,190.0691637992859,625.3525428771973,20316,2840,17476,17476,0,11,2899000.0
2899,2899999,21.208663496638763,36.92567508258371,0.05582314603642946,437.2623088359833,190.1346926689148,625.8034934997559,20327,2840,17487,17487,0,11,2900000.0
2900,2900999,21.208055417845742,36.92414048875259,0.055795832464629935,437.42866134643555,190.20020008087158,626.0331840515137,20332,2841,17491,17491,0,11,2901000.0
2901,2901999,21.206858441586064,36.9214808810851,0.055790973625446494,437.6073839664459,190.26643323898315,626.1141815185547,20337,2842,17495,17495,0,11,2902000.0
2902,2902999,21.206352643386523,36.91971230771278,0.05577956302449527,437.733736038208,190.3326554298401,626.5232238769531,20346,2842,17504,17504,0,11,2903000.0
2903,2903999,21.206423248038945,36.921438656422296,0.055752421471092606,437.9017024040222,190.3986852169037,626.8696670532227,20359,2843,17516,17516,0,11,2904000.0
2904,2904999,21.206536854261667,36.920018716329146,0.055728596693324306,438.0773117542267,190.46445178985596,627.1442756652832,20367,2844,17523,17523,0,11,2905000.0
2905,2905999,21.206926074125136,36.91911016080043,0.05571191749636162,438.2956335544586,190.52997303009033,627.2028923034668,20371,2846,17525,17525,0,11,2906000.0
2906,2906999,21.207526800921023,36.91878722168829,0.05569291664989018,438.4156060218811,190.59440779685974,627.3719863891602,20372,2846,17526,17526,0,11,2907000.0
2907,2907999,21.207234403161355,36.91884746841276,0.05566376900437342,438.6478588581085,190.66207146644592,627.4830894470215,20380,2848,17532,17532,0,11,2908000.0
2908,2908999,21.204459861570648,36.91427753690288,0.05568739484205265,438.7752377986908,190.7282555103302,627.9077415466309,20392,2848,17544,17544,0,11,2909000.0
2909,2909999,21.201954377073662,36.91167960307062,0.05571230823831652,438.90071058273315,190.7942533493042,628.2786102294922,20398,2848,17550,17550,0,11,2910000.0
2910,2910999,21.19955150282295,36.90850990528295,0.055745015642847395,439.0852539539337,190.86182117462158,628.6154518127441,20412,2849,17563,17563,0,11,2911000.0
2911,2911999,21.197104328403313,36.905493286190506,0.055776632233846435,439.3082318305969,190.93025851249695,628.8653030395508,20427,2851,17576,17576,0,11,2912000.0
2912,2912999,21.19431596641212,36.901483221488114,0.05580900007973588,439.4873306751251,190.99487686157227,628.9981002807617,20444,2852,17592,17592,0,11,2913000.0
2913,2913999,21.191682690511072,36.89766922007041,0.05583113832333453,439.71474742889404,191.0599081516266,629.0756454467773,20454,2854,17600,17600,0,11,2914000.0
2914,2914999,21.189716160931425,36.89427556131439,0.05583831194510558,439.85285806655884,191.12757897377014,629.3759269714355,20462,2854,17608,17608,0,11,2915000.0
2915,2915999,21.18882612508839,36.89439152132638,0.0558185180189541,439.9821426868439,191.1931893825531,629.5253868103027,20465,2854,17611,17611,0,11,2916000.0
2916,2916999,21.188409146308576,36.89497952105113,0.055798983669195,440.1136095523834,191.25880455970764,629.672664642334,20469,2854,17615,17615,0,11,2917000.0
2917,2917999,21.18819994764275,36.8960770154908,0.05577118257079172,440.2885150909424,191.3243854045868,629.8940277099609,20477,2855,17622,17622,0,11,2918000.0
2918,2918999,21.189133453238536,36.897819257640826,0.05573849523312713,440.50338530540466,191.39014172554016,630.0136642456055,20481,2857,17624,17624,0,11,2919000.0
2919,2919999,21.18901950040004,36.897663140792154,0.055726067227886644,440.6783092021942,191.4553894996643,630.1367416381836,20495,2858,17637,17637,0,11,2920000.0
2920,2920999,21.189257796046107,36.89817867820731,0.05571101243712673,440.8461546897888,191.521413564682,630.3395004272461,20502,2859,17643,17643,0,11,2921000.0
2921,2921999,21.18937279012032,36.897799981006564,0.055688670468526213,440.9623508453369,191.5862443447113,630.5150146484375,20502,2859,17643,17643,0,11,2922000.0
2922,2922999,21.18970062517316,36.89746096314724,0.05567242271384876,441.0929203033447,191.65095829963684,630.6227111816406,20503,2859,17644,17644,0,11,2923000.0
2923,2923999,21.19073191942277,36.9002355529284,0.055628406502015726,441.3109290599823,191.71647548675537,630.807544708252,20515,2861,17654,17654,0,11,2924000.0
2924,2924999,21.19188922416957,36.90029166547485,0.05560296034986678,441.43018221855164,191.780522108078,630.9643325805664,20515,2861,17654,17654,0,11,2925000.0
2925,2925999,21.191553447131568,36.89785377126527,0.055580168918548,441.6907801628113,191.84530186653137,630.9864387512207,20525,2864,17661,17661,0,11,2926000.0
2926,2926999,21.191345634401575,36.896016805341404,0.055551063314883686,441.8109972476959,191.91002130508423,631.3006858825684,20531,2864,17667,17667,0,11,2927000.0
2927,2927999,21.18970587862394,36.89264987106834,0.05553982154121795,442.02165174484253,191.97520971298218,631.3804321289062,20539,2866,17673,17673,0,11,2928000.0
2928,2928999,21.186818710095874,36.88862110824654,0.055550170510676344,442.2363967895508,192.04098391532898,631.923942565918,20570,2868,17702,17702,0,11,2929000.0
2929,2929999,21.18318665148645,36.884333946066796,0.055569151654359494,442.4059627056122,192.10741066932678,632.2044944763184,20576,2869,17707,17707,0,11,2930000.0
2930,2930999,21.17974050360482,36.87945524636893,0.055588439995369776,442.6180703639984,192.1736991405487,632.3401527404785,20583,2871,17712,17712,0,11,2931000.0
2931,2931999,21.17650783238989,36.87540495879409,0.0556100159482521,442.7514979839325,192.23998427391052,632.4489593505859,20583,2871,17712,17712,0,11,2932000.0
2932,2932999,21.173663339452492,36.87097467611295,0.055622802240146485,443.02117919921875,192.30608654022217,632.5279884338379,20593,2874,17719,17719,0,11,2933000.0
2933,2933999,21.17111077889025,36.8666704733745,0.05563445528809541,443.14321780204773,192.37063479423523,632.7276649475098,20593,2874,17719,17719,0,11,2934000.0
2934,2934999,21.168755429133455,36.86302231070796,0.05564195002811079,443.37167501449585,192.43641114234924,632.7807807922363,20597,2876,17721,17721,0,11,2935000.0
2935,2935999,21.166355752761223,36.8588532168147,0.0556475827749795,443.49909353256226,192.50141525268555,632.9634742736816,20598,2876,17722,17722,0,11,2936000.0
2936,2936999,21.164400030720568,36.8560762860197,0.05564225767669817,443.6346700191498,192.5666320323944,633.0527458190918,20598,2876,17722,17722,0,11,2937000.0
2937,2937999,21.163188034877944,36.855347220884724,0.055645173062921494,443.8139879703522,192.6320924758911,633.1273307800293,20607,2877,17730,17730,0,11,2938000.0
2938,2938999,21.163315729745754,36.85691804416459,0.055658620373737366,443.946382522583,192.69795489311218,633.5271377563477,20616,2877,17739,17739,0,11,2939000.0
2939,2939999,21.164111683219357,36.86658042412949,0.055624183526217674,444.0719542503357,192.76340079307556,633.7318153381348,20616,2877,17739,17739,0,11,2940000.0
2940,2940999,21.165102323678532,36.87129101235376,0.055666568108236225,444.25967741012573,192.82856798171997,633.8585357666016,20625,2878,17747,17747,0,11,2941000.0
2941,2941999,21.165937051681464,36.87374770780053,0.05572204651663293,444.38106179237366,192.89381527900696,634.1250343322754,20631,2878,17753,17753,0,11,2942000.0
2942,2942999,21.166097831973495,36.874512401148486,0.05572135328769301,444.5980272293091,192.95952653884888,634.209171295166,20635,2880,17755,17755,0,11,2943000.0
2943,2943999,21.1671098570992,36.8766718571389,0.05571810540380606,444.7125964164734,193.02452778816223,634.3966369628906,20636,2880,17756,17756,0,11,2944000.0
2944,2944999,21.167552752447136,36.87677720537184,0.05573636635318968,444.93414211273193,193.09012842178345,634.5857467651367,20644,2882,17762,17762,0,11,2945000.0
2945,2945999,21.168991551348196,36.879051486119614,0.055777933146958114,445.1110563278198,193.1547555923462,634.6567001342773,20646,2883,17763,17763,0,11,2946000.0
2946,2946999,21.168767387163417,36.87777184804437,0.05581074640265027,445.23128747940063,193.21915102005005,634.7974548339844,20646,2883,17763,17763,0,11,2947000.0
2947,2947999,21.16875574611305,36.87669393123824,0.05582248967027259,445.3566007614136,193.2837154865265,635.0356903076172,20650,2883,17767,17767,0,11,2948000.0
2948,2948999,21.1681332042494,36.87865071886239,0.05582599613833117,445.58853483200073,193.34885215759277,635.1984786987305,20668,2885,17783,17783,0,11,2949000.0
2949,2949999,21.165309632828336,36.87731699844029,0.055844435396629644,445.70799469947815,193.4147243499756,635.6837196350098,20673,2885,17788,17788,0,11,2950000.0
2950,2950999,21.162648547499327,36.87591734283687,0.05585119963291829,445.88091349601746,193.48191285133362,635.8626670837402,20675,2886,17789,17789,0,11,2951000.0
2951,2951999,21.160603818498043,36.87466876826127,0.055874805345880074,446.0106997489929,193.54795622825623,636.0561370849609,20675,2886,17789,17789,0,11,2952000.0
2952,2952999,21.15940892375124,36.87566500094631,0.05589653264401295,446.1873302459717,193.61432003974915,636.134349822998,20679,2887,17792,17792,0,11,2953000.0
2953,2953999,21.16000433996468,36.87858574231473,0.05590936742899255,446.3201982975006,193.68005752563477,636.3796272277832,20684,2887,17797,17797,0,11,2954000.0
2954,2954999,21.15974241006872,36.87912374237171,0.055922808764040655,446.4379999637604,193.7447807788849,636.480110168457,20684,2887,17797,17797,0,11,2955000.0
2955,2955999,21.159376434218174,36.879310903506905,0.055941360799702355,446.61312675476074,193.81044673919678,636.5923347473145,20689,2888,17801,17801,0,11,2956000.0
2956,2956999,21.159376668981736,36.88565328395364,0.055924932267484295,446.84557723999023,193.87642073631287,636.6105842590332,20693,2890,17803,17803,0,11,2957000.0
2957,2957999,21.159123139667205,36.88536828684215,0.05592841504020196,447.0720434188843,193.94217920303345,636.6967582702637,20700,2892,17808,17808,0,11,2958000.0
2958,2958999,21.15890824981192,36.88513174953426,0.05593052990667391,447.24959897994995,194.01022219657898,636.8546600341797,20703,2893,17810,17810,0,11,2959000.0
2959,2959999,21.1585182794955,36.8836230782861,0.05592509863105999,447.369108915329,194.07538604736328,637.3478012084961,20714,2893,17821,17821,0,11,2960000.0
2960,2960999,21.159041162148576,36.88385854920386,0.055926544269886636,447.50401973724365,194.14447164535522,637.5046195983887,20714,2893,17821,17821,0,11,2961000.0
2961,2961999,21.15996064358471,36.88755049565441,0.055941077509383264,447.63112688064575,194.20901656150818,637.6943702697754,20714,2893,17821,17821,0,11,2962000.0
2962,2962999,21.160714715224223,36.887403861367616,0.055964288778307725,447.75537300109863,194.27476596832275,638.1275062561035,20724,2893,17831,17831,0,11,2963000.0
2963,2963999,21.162560805869678,36.88900553300533,0.05599428960472286,447.8752555847168,194.34082102775574,638.3406219482422,20726,2893,17833,17833,0,11,2964000.0
2964,2964999,21.16399521041109,36.88996691280087,0.056031033177382894,448.0882351398468,194.4067792892456,638.5526313781738,20757,2895,17862,17862,0,11,2965000.0
2965,2965999,21.16615971154072,36.89174092596886,0.05606547393662198,448.2103781700134,194.47107982635498,638.7310562133789,20758,2895,17863,17863,0,11,2966000.0
2966,2966999,21.167285942541415,36.89169336086861,0.05611087214960098,448.3338267803192,194.53582048416138,638.8456878662109,20758,2895,17863,17863,0,11,2967000.0
2967,2967999,21.167878559642265,36.890410258716344,0.05613665542416779,448.4491741657257,194.60003471374512,639.0805435180664,20763,2895,17868,17868,0,11,2968000.0
2968,2968999,21.16765143133791,36.88843604285807,0.05614302248826486,448.5742611885071,194.66402983665466,639.2298545837402,20763,2895,17868,17868,0,11,2969000.0
2969,2969999,21.164980503782484,36.88400797406856,0.056157905158299215,448.7450203895569,194.72951793670654,639.5963554382324,20774,2896,17878,17878,0,11,2970000.0
2970,2970999,21.162246060916704,36.88089467624625,0.05617338294915197,448.87186312675476,194.79603266716003,639.9315338134766,20777,2896,17881,17881,0,11,2971000.0
2971,2971999,21.159592945162224,36.87751277047732,0.056185867966162206,449.13531517982483,194.8636553287506,640.0807456970215,20783,2899,17884,17884,0,11,2972000.0
2972,2972999,21.157304856397577,36.876501440808624,0.05619044485325242,449.256724357605,194.93017745018005,640.2752990722656,20783,2899,17884,17884,0,11,2973000.0
2973,2973999,21.154800868956393,36.873188605220484,0.056202476815286784,449.44141578674316,194.99677157402039,640.5083160400391,20786,2900,17886,17886,0,11,2974000.0
2974,2974999,21.152779054359268,36.87585105475703,0.056188042608383615,449.6651563644409,195.0629940032959,640.6335678100586,20791,2902,17889,17889,0,11,2975000.0
2975,2975999,21.150418137702562,36.872121078549576,0.056187858958114956,449.88120770454407,195.12834858894348,640.7702903747559,20795,2904,17891,17891,0,11,2976000.0
2976,2976999,21.148177758303017,36.86823094663769,0.05618499723599124,450.0036664009094,195.19371390342712,641.0930557250977,20799,2904,17895,17895,0,11,2977000.0
2977,2977999,21.14642687995865,36.86473077840034,0.056173183611563315,450.13798666000366,195.25937151908875,641.3056449890137,20799,2904,17895,17895,0,11,2978000.0
2978,2978999,21.144905938633066,36.862240282820494,0.056163078674593137,450.26381516456604,195.32549476623535,641.4876747131348,20799,2904,17895,17895,0,11,2979000.0
2979,2979999,21.143452379662744,36.85996592838826,0.05615872760491858,450.38030529022217,195.3902862071991,641.738109588623,20802,2904,17898,17898,0,11,2980000.0
2980,2980999,21.14303156792293,36.8590074634636,0.05614419067449139,450.60017800331116,195.4550485610962,641.9462547302246,20809,2906,17903,17903,0,11,2981000.0
2981,2981999,21.142747206886412,36.85884625652344,0.056124849042557545,450.7617709636688,195.52002882957458,642.1480598449707,20818,2907,17911,17911,0,11,2982000.0
2982,2982999,21.143024927924515,36.85919311587021,0.05611315976065112,450.93633913993835,195.5851173400879,642.3002738952637,20824,2908,17916,17916,0,11,2983000.0
2983,2983999,21.143757460111658,36.8590675361123,0.056102640245331514,451.1510136127472,195.65120911598206,642.594409942627,20834,2910,17924,17924,0,11,2984000.0
2984,2984999,21.144971553592878,36.85971289744759,0.05611166328869455,451.3778977394104,195.72304439544678,642.7749671936035,20839,2912,17927,17927,0,11,2985000.0
2985,2985999,21.147357193789507,36.862199036609525,0.0561183503862458,451.57834100723267,195.79739260673523,643.0044136047363,20844,2913,17931,17931,0,11,2986000.0
2986,2986999,21.14903676824657,36.863750958470966,0.05610247700563609,451.75321197509766,195.86218094825745,643.1633720397949,20846,2914,17932,17932,0,11,2987000.0
2987,2987999,21.151158815182903,36.866133313111256,0.05611533133847124,451.97594928741455,195.92699909210205,643.2038116455078,20856,2916,17940,17940,0,11,2988000.0
2988,2988999,21.15393218071246,36.87125100277786,0.056153614504685034,452.0941045284271,195.9912383556366,643.5081100463867,20860,2916,17944,17944,0,11,2989000.0
2989,2989999,21.155170628432508,36.87438845932272,0.056143596875769974,452.3008372783661,196.0553126335144,643.670352935791,20893,2918,17975,17975,0,11,2990000.0
2990,2990999,21.15346974977457,36.873821535291896,0.056137172108174926,452.4670658111572,196.1204137802124,644.1258010864258,20909,2919,17990,17990,0,11,2991000.0
2991,2991999,21.151440687999337,36.87337103480655,0.05612320029363316,452.5865845680237,196.18663811683655,644.5940704345703,20918,2919,17999,17999,0,11,2992000.0
2992,2992999,21.148727190842294,36.86914619594806,0.05612849695027955,452.76504397392273,196.25310707092285,644.7953834533691,20921,2920,18001,18001,0,11,2993000.0
2993,2993999,21.14633025762663,36.86623466990384,0.05613189362494442,452.94095492362976,196.3202064037323,644.9303741455078,20924,2921,18003,18003,0,11,2994000.0
2994,2994999,21.14431699528193,36.86377441030376,0.05612892717943396,453.0649709701538,196.38668084144592,645.249095916748,20929,2921,18008,18008,0,11,2995000.0
2995,2995999,21.142292581794802,36.85996824085174,0.05612581698438002,453.2829496860504,196.45204854011536,645.387866973877,20936,2923,18013,18013,0,11,2996000.0
2996,2996999,21.14055132526346,36.857024049247904,0.0561290228828365,453.45552611351013,196.51892971992493,645.5395851135254,20942,2924,18018,18018,0,11,2997000.0
2997,2997999,21.139067310221556,36.85383587280577,0.05611805649032786,453.66047525405884,196.59562873840332,645.8679161071777,20954,2925,18029,18029,0,11,2998000.0
2998,2998999,21.137486880848783,36.850645403326816,0.05611270718359973,453.8291223049164,196.66152429580688,646.0749664306641,20956,2926,18030,18030,0,11,2999000.0
2999,2999999,21.136578053857054,36.84825970479213,0.056104760750381844,454.0115895271301,196.72727370262146,646.2040672302246,20959,2927,18032,18032,0,11,3000000.0
3000,3000999,21.136082993054966,36.84655467159538,0.056093911587404066,454.18829250335693,196.7992000579834,646.6480407714844,20978,2928,18050,18050,0,11,3001000.0
3001,3001999,21.13572996828733,36.84436843036286,0.05606971815119299,454.3108432292938,196.86502504348755,647.0811424255371,20981,2928,18053,18053,0,11,3002000.0
3002,3002999,21.135620641155782,36.844193254473545,0.05604915242390618,454.4232828617096,196.9296989440918,647.303882598877,20981,2928,18053,18053,0,11,3003000.0
3003,3003999,21.136744090686605,36.846357641804566,0.0560552765268203,454.64385867118835,196.9956738948822,647.4368515014648,20985,2930,18055,18055,0,11,3004000.0
3004,3004999,21.139785767656765,36.85165172443542,0.05608145355857164,454.8176679611206,197.06179189682007,647.8072700500488,20996,2931,18065,18065,0,11,3005000.0
3005,3005999,21.14389369154911,36.86030231116958,0.056167795435607015,455.23038506507874,197.1285195350647,647.7750205993652,21047,2937,18110,18110,0,11,3006000.0
3006,3006999,21.14896723694871,36.868378606230934,0.056256374553985355,455.54407835006714,197.19520330429077,647.9794921875,21066,2941,18125,18125,0,11,3007000.0
3007,3007999,21.155314444407637,36.8794994659587,0.056390820934778985,455.7137749195099,197.26021146774292,648.1731719970703,21068,2942,18126,18126,0,11,3008000.0
3008,3008999,21.161735256854058,36.892921521138966,0.05659725583365238,455.9293689727783,197.32705092430115,648.2384796142578,21075,2944,18131,18131,0,11,3009000.0
3009,3009999,21.168290891810553,36.90219125891638,0.05676051135458382,456.1013743877411,197.39231300354004,648.5304641723633,21085,2945,18140,18140,0,11,3010000.0
3010,3010999,21.171825888968044,36.90657413962207,0.05681874639151019,456.21688437461853,197.4559428691864,648.6788330078125,21085,2945,18140,18140,0,11,3011000.0
3011,3011999,21.170565279043295,36.90887700481018,0.056803105529440456,456.4403486251831,197.52313828468323,649.1686248779297,21142,2947,18195,18195,0,11,3012000.0
3012,3012999,21.168908448865167,36.9078501166803,0.0567990604636156,456.5666298866272,197.58882856369019,649.4807777404785,21143,2947,18196,18196,0,11,3013000.0
3013,3013999,21.167358177992735,36.905676978026946,0.056795738168545995,456.75050234794617,197.6552631855011,649.6018409729004,21145,2948,18197,18197,0,11,3014000.0
3014,3014999,21.165348565051083,36.9033564656692,0.056801885703567256,456.9222369194031,197.7219944000244,649.691234588623,21159,2949,18210,18210,0,11,3015000.0
3015,3015999,21.164482730077694,36.90251190460887,0.05678176643678767,457.09812808036804,197.78725600242615,650.0558052062988,21173,2950,18223,18223,0,11,3016000.0
3016,3016999,21.162640464203587,36.899780028233245,0.056777890307260326,457.2604446411133,197.85184335708618,650.1991920471191,21179,2951,18228,18228,0,11,3017000.0
3017,3017999,21.161544865577508,36.896999429159486,0.05676307349196463,457.4365699291229,197.91744780540466,650.3829956054688,21183,2952,18231,18231,0,11,3018000.0
3018,3018999,21.160411486238978,36.89425966402327,0.056754438971821086,457.5660855770111,197.98347234725952,650.4853668212891,21184,2952,18232,18232,0,11,3019000.0
3019,3019999,21.15899217543213,36.89107466570956,0.05674870375612007,457.6910774707794,198.0487208366394,650.5824203491211,21184,2952,18232,18232,0,11,3020000.0
3020,3020999,21.158098648127826,36.8883762379854,0.05673654403974726,457.8693995475769,198.1148715019226,651.1232872009277,21206,2953,18253,18253,0,11,3021000.0
3021,3021999,21.157375014036177,36.88629241044661,0.05673559772650838,458.09139466285706,198.18107748031616,651.2940063476562,21213,2955,18258,18258,0,11,3022000.0
3022,3022999,21.157431199449285,36.88611418387122,0.0567262901105412,458.21753334999084,198.24661231040955,651.5283813476562,21214,2955,18259,18259,0,11,3023000.0
3023,3023999,21.158987186579285,36.886958242727495,0.05670759826336402,458.33797430992126,198.31273770332336,652.0553436279297,21227,2955,18272,18272,0,11,3024000.0
3024,3024999,21.1599085656634,36.8860011292137,0.056700246540762556,458.50076603889465,198.37843704223633,652.2886428833008,21233,2956,18277,18277,0,11,3025000.0
3025,3025999,21.162096045005356,36.89377224154115,0.056434455449893894,458.61536026000977,198.44374346733093,652.6226768493652,21240,2956,18284,18284,0,11,3026000.0
3026,3026999,21.164084846089413,36.89430490444441,0.05636907160202698,458.78706765174866,198.50853514671326,652.7574157714844,21245,2957,18288,18288,0,11,3027000.0
3027,3027999,21.16441380276994,36.8922542266333,0.05633805134062131,459.00652146339417,198.57401943206787,652.891529083252,21265,2959,18306,18306,0,11,3028000.0
3028,3028999,21.16347498375227,36.889146602367006,0.05632214003930891,459.1314685344696,198.638667345047,653.1916809082031,21271,2959,18312,18312,0,11,3029000.0
3029,3029999,21.162132945114482,36.89088178715614,0.0563119306220653,459.2994034290314,198.7041413784027,653.566951751709,21280,2960,18320,18320,0,11,3030000.0
3030,3030999,21.160632626049367,36.88899009707444,0.05632273282724354,459.4246735572815,198.7698278427124,653.7963981628418,21282,2960,18322,18322,0,11,3031000.0
3031,3031999,21.160315344127966,36.889155887737594,0.056330171554380803,459.595929145813,198.8356900215149,653.8860321044922,21286,2961,18325,18325,0,11,3032000.0
3032,3032999,21.160365062617434,36.88925808857867,0.056330113218841404,459.72938990592957,198.9017252922058,654.1099510192871,21289,2961,18328,18328,0,11,3033000.0
3033,3033999,21.16076043094592,36.88947326702241,0.05630542331115573,459.90991592407227,198.96660447120667,654.2431221008301,21293,2962,18331,18331,0,11,3034000.0
3034,3034999,21.160465423196033,36.889241728340046,0.05629708445941839,460.03579211235046,199.03194665908813,654.3556747436523,21294,2962,18332,18332,0,11,3035000.0
3035,3035999,21.161303334454686,36.889706384977025,0.05629667748088829,460.32887029647827,199.10383939743042,654.4297904968262,21314,2965,18349,18349,0,11,3036000.0
3036,3036999,21.161910668578734,36.889349142768836,0.056295915077842595,460.4448010921478,199.16885423660278,654.5435104370117,21315,2965,18350,18350,0,11,3037000.0
3037,3037999,21.16302063809233,36.89139409058605,0.05630263450706252,460.67479372024536,199.23471522331238,654.5686187744141,21327,2967,18360,18360,0,11,3038000.0
3038,3038999,21.165091085131976,36.897344396031954,0.05633160460380726,460.7937660217285,199.3003544807434,655.0346755981445,21337,2967,18370,18370,0,11,3039000.0
3039,3039999,21.16680429294816,36.89986433291769,0.0564399958436379,461.0609607696533,199.36722707748413,655.1916580200195,21344,2970,18374,18374,0,11,3040000.0
3040,3040999,21.168198313782977,36.90127290406131,0.05652024380810594,461.18465089797974,199.4320170879364,655.3480758666992,21344,2970,18374,18374,0,11,3041000.0
3041,3041999,21.171087158610536,36.90721400157076,0.0566018776260071,461.30721282958984,199.49827551841736,655.7701034545898,21355,2970,18385,18385,0,11,3042000.0
3042,3042999,21.17545302103858,36.921742368829875,0.05665876179823326,461.48308277130127,199.5637011528015,655.9146957397461,21358,2971,18387,18387,0,11,3043000.0
3043,3043999,21.179402085407478,36.929558205884916,0.05675063844332262,461.6060736179352,199.628427028656,656.0733032226562,21362,2971,18391,18391,0,11,3044000.0
3044,3044999,21.18328845056223,36.93451924980482,0.056839035256028514,461.7212166786194,199.69270539283752,656.2791404724121,21364,2971,18393,18393,0,11,3045000.0
3045,3045999,21.187282049021288,36.93893840849807,0.05692487743633645,461.8997197151184,199.75726914405823,656.3338356018066,21366,2972,18394,18394,0,11,3046000.0
3046,3046999,21.191445059623987,36.94394548064761,0.05703635931745066,462.069452047348,199.82171392440796,656.3703994750977,21368,2973,18395,18395,0,11,3047000.0
3047,3047999,21.195374151764028,36.95128249652342,0.0570651330431855,462.1953010559082,199.8864085674286,656.5857696533203,21370,2973,18397,18397,0,11,3048000.0
3048,3048999,21.194837311255043,36.949773384788145,0.05708283150229809,462.4134724140167,199.95099020004272,656.8329696655273,21392,2975,18417,18417,0,11,3049000.0
3049,3049999,21.19250784349706,36.94847284633938,0.057081302540697654,462.58671379089355,200.01723074913025,657.141471862793,21397,2976,18421,18421,0,11,3050000.0
3050,3050999,21.19046880824713,36.947111264569955,0.05709683543192812,462.7051844596863,200.08235883712769,657.3052825927734,21398,2976,18422,18422,0,11,3051000.0
3051,3051999,21.188736196949346,36.944702122743266,0.057093239982632604,462.83343863487244,200.14786338806152,657.4472694396973,21399,2976,18423,18423,0,11,3052000.0
3052,3052999,21.187036300753604,36.94307838053487,0.057093408890224295,463.0680727958679,200.21412706375122,657.514892578125,21409,2978,18431,18431,0,11,3053000.0
3053,3053999,21.185643613613518,36.940316734002735,0.057088523066044394,463.2079813480377,200.27951073646545,657.7712173461914,21413,2978,18435,18435,0,11,3054000.0
3054,3054999,21.184708116784538,36.93849422292056,0.057079846286334446,463.33321261405945,200.3432695865631,657.862060546875,21413,2978,18435,18435,0,11,3055000.0
3055,3055999,21.183961054707236,36.93627767162497,0.05707801175330629,463.5554482936859,200.40835618972778,657.9817123413086,21418,2980,18438,18438,0,11,3056000.0
3056,3056999,21.183506227485932,36.93472370434158,0.057071566693068565,463.72691011428833,200.4733681678772,658.0950698852539,21426,2981,18445,18445,0,11,3057000.0
3057,3057999,21.18344336974125,36.93375885324145,0.05708156080982796,463.85662961006165,200.5379056930542,658.1612129211426,21426,2981,18445,18445,0,11,3058000.0
3058,3058999,21.184148660874605,36.933906314859804,0.0570910267922321,464.0376286506653,200.60252571105957,658.1385803222656,21428,2982,18446,18446,0,11,3059000.0
3059,3059999,21.187533081207953,36.938955885395075,0.05711117492908546,464.2821636199951,200.66831707954407,658.3706817626953,21437,2984,18453,18453,0,11,3060000.0
3060,3060999,21.18974742115828,36.94202419976904,0.05717897799450966,464.5018422603607,200.73476815223694,658.536922454834,21470,2986,18484,18484,0,11,3061000.0
3061,3061999,21.19234484814254,36.94558089149226,0.057254892142731495,464.6798825263977,200.80007457733154,658.6597938537598,21475,2987,18488,18488,0,11,3062000.0
3062,3062999,21.196543856192662,36.955167744298905,0.05727790281452538,464.79933166503906,200.86511158943176,659.0440559387207,21482,2987,18495,18495,0,11,3063000.0
3063,3063999,21.201778983652215,36.96569511937638,0.057392037737680424,464.97079253196716,200.9312858581543,659.1738929748535,21484,2988,18496,18496,0,11,3064000.0
3064,3064999,21.20667539720992,36.973900581637295,0.057445230551619875,465.10345101356506,200.996107339859,659.4541130065918,21490,2988,18502,18502,0,11,3065000.0
3065,3065999,21.210571280342396,36.979632710977384,0.05750653480942092,465.22016739845276,201.06013655662537,659.6025352478027,21490,2988,18502,18502,0,11,3066000.0
3066,3066999,21.214305296586097,36.98489870700591,0.05758317391285772,465.34830594062805,201.12409782409668,659.7034797668457,21490,2988,18502,18502,0,11,3067000.0
3067,3067999,21.21778132928209,36.9889506259437,0.05762561625451945,465.480003118515,201.1896755695343,659.9319763183594,21494,2988,18506,18506,0,11,3068000.0
3068,3068999,21.218848970320824,36.989120528167376,0.05764139786727418,465.604674577713,201.25312900543213,660.0851440429688,21494,2988,18506,18506,0,11,3069000.0
3069,3069999,21.21696227097064,36.98901063900992,0.05763631069977515,465.8275249004364,201.31884050369263,660.5387077331543,21520,2990,18530,18530,0,11,3070000.0
3070,3070999,21.214623488330858,36.98699875935075,0.05765005304983806,465.95250964164734,201.3851137161255,660.769702911377,21521,2990,18531,18531,0,11,3071000.0
3071,3071999,21.212563085701102,36.984543884596576,0.05765644069793541,466.08519196510315,201.4507019519806,660.9243698120117,21521,2990,18531,18531,0,11,3072000.0
3072,3072999,21.210888678072976,36.98397606222926,0.05764195534000616,466.26109313964844,201.51591277122498,660.9697761535645,21523,2991,18532,18532,0,11,3073000.0
3073,3073999,21.209040409890747,36.98041116637985,0.05763908504074122,466.4377558231354,201.58112907409668,661.1434020996094,21527,2992,18535,18535,0,11,3074000.0
3074,3074999,21.20761688248657,36.97925929054844,0.057642776390965045,466.60852575302124,201.6452989578247,661.289421081543,21529,2993,18536,18536,0,11,3075000.0
3075,3075999,21.206252840519518,36.97702801278622,0.057634806426924534,466.73226404190063,201.7099609375,661.4236526489258,21530,2993,18537,18537,0,11,3076000.0
3076,3076999,21.205139182803798,36.97484913665719,0.057625272519660875,466.90921902656555,201.77576804161072,661.5664901733398,21562,2994,18568,18568,0,11,3077000.0
3077,3077999,21.204153419571007,36.9725222289606,0.05762129935061433,467.042320728302,201.84023475646973,661.6482810974121,21562,2994,18568,18568,0,11,3078000.0
3078,3078999,21.20375296257685,36.971850413540125,0.05761909357509598,467.17730498313904,201.90463495254517,661.6998710632324,21562,2994,18568,18568,0,11,3079000.0
3079,3079999,21.203691416781375,36.97066176273865,0.05762501700045508,467.2979300022125,201.96969437599182,662.0854110717773,21572,2994,18578,18578,0,11,3080000.0
3080,3080999,21.203931051839305,36.970163035436116,0.05763179086735515,467.4233467578888,202.0358326435089,662.3070373535156,21572,2994,18578,18578,0,11,3081000.0
3081,3081999,21.203854045901494,36.96881122633666,0.057622676676459594,467.6026372909546,202.1010594367981,662.4202194213867,21588,2995,18593,18593,0,11,3082000.0
3082,3082999,21.204655780095695,36.96934781111274,0.05762291984014678,467.7771074771881,202.16705107688904,662.732292175293,21598,2996,18602,18602,0,11,3083000.0
3083,3083999,21.205111468830143,36.96899160673528,0.05763003721628479,467.94419050216675,202.23195958137512,662.8513259887695,21600,2997,18603,18603,0,11,3084000.0
3084,3084999,21.205455218661665,36.96764885512851,0.057645616322450466,468.07361459732056,202.29684114456177,663.0021286010742,21601,2997,18604,18604,0,11,3085000.0
3085,3085999,21.20659266326169,36.96738540975438,0.05765434732498276,468.26982593536377,202.36739897727966,663.1412506103516,21606,2998,18608,18608,0,11,3086000.0
3086,3086999,21.207171582447476,36.966386311022646,0.057661131129078336,468.39114713668823,202.43146991729736,663.247428894043,21606,2998,18608,18608,0,11,3087000.0
3087,3087999,21.207279959271787,36.96448781939189,0.05765330011213077,468.5163006782532,202.496102809906,663.3227767944336,21606,2998,18608,18608,0,11,3088000.0
3088,3088999,21.207140705689802,36.962212722326754,0.05764981002879288,468.7433590888977,202.56084728240967,663.5116081237793,21614,3000,18614,18614,0,11,3089000.0
3089,3089999,21.205876001962125,36.958747014219455,0.05764679949338092,468.8918364048004,202.63089227676392,663.8307685852051,21624,3000,18624,18624,0,11,3090000.0
3090,3090999,21.203253992695696,36.95537366733811,0.057650382731076366,469.1231064796448,202.69682025909424,664.0946807861328,21634,3002,18632,18632,0,11,3091000.0
3091,3091999,21.200449151421378,36.95167584560687,0.057662933122334614,469.2699131965637,202.76943969726562,664.2071685791016,21634,3002,18632,18632,0,11,3092000.0
3092,3092999,21.198267277723048,36.95009693945436,0.05766751875621945,469.39743876457214,202.8350899219513,664.3206672668457,21634,3002,18632,18632,0,11,3093000.0
3093,3093999,21.19584222196355,36.94655958419075,0.05767203522582287,469.52837586402893,202.90034747123718,664.3984451293945,21634,3002,18632,18632,0,11,3094000.0
3094,3094999,21.193715649078943,36.943484569152396,0.05766860734485346,469.65360474586487,202.9655725955963,664.7019271850586,21641,3002,18639,18639,0,11,3095000.0
3095,3095999,21.19151512675469,36.939659959264,0.05766470453313299,469.8729476928711,203.03060173988342,664.7929420471191,21663,3004,18659,18659,0,11,3096000.0
3096,3096999,21.18995292402604,36.93865633659588,0.05765345703287017,470.05224442481995,203.096661567688,665.0412940979004,21679,3005,18674,18674,0,11,3097000.0
3097,3097999,21.188704483951863,36.937668715287394,0.05763561003628204,470.21945333480835,203.1631302833557,665.2739791870117,21683,3006,18677,18677,0,11,3098000.0
3098,3098999,21.187625029596404,36.93536680810706,0.057627397031647654,470.4481785297394,203.2287735939026,665.3906860351562,21687,3008,18679,18679,0,11,3099000.0
3099,3099999,21.18651049339199,36.93313072735347,0.05761709969284434,470.68205976486206,203.29479598999023,665.5039863586426,21696,3010,18686,18686,0,11,3100000.0
3100,3100999,21.186976575388552,36.93325245344815,0.05757347351314568,470.80787205696106,203.36133313179016,666.095386505127,21709,3010,18699,18699,0,11,3101000.0
3101,3101999,21.18743171931309,36.934132397371116,0.05757799352425985,471.04666900634766,203.43434190750122,666.251636505127,21727,3012,18715,18715,0,11,3102000.0
3102,3102999,21.188037490245236,36.934449232669174,0.05757064133879175,471.17078709602356,203.49955368041992,666.4252433776855,21727,3012,18715,18715,0,11,3103000.0
3103,3103999,21.188922785150364,36.935344526277916,0.05753691166187891,471.34589290618896,203.56597995758057,667.0069198608398,21744,3013,18731,18731,0,11,3104000.0
3104,3104999,21.1895175789628,36.93476084575295,0.05750997158941695,471.4617745876312,203.6323277950287,667.2777366638184,21745,3013,18732,18732,0,11,3105000.0
3105,3105999,21.190593647735728,36.93553407637722,0.057498329427853045,471.5894544124603,203.69818997383118,667.6103858947754,21751,3013,18738,18738,0,11,3106000.0
3106,3106999,21.191568979700325,36.9359489436288,0.05748627257735772,471.7094945907593,203.76373434066772,668.0495491027832,21759,3013,18746,18746,0,11,3107000.0
3107,3107999,21.193032320209635,36.93729303148329,0.05750237109731937,471.9429724216461,203.82978463172913,668.1662979125977,21795,3015,18780,18780,0,11,3108000.0
3108,3108999,21.19421017481409,36.93733805338645,0.057507481984725994,472.05696511268616,203.895489692688,668.4351844787598,21799,3015,18784,18784,0,11,3109000.0
3109,3109999,21.194810960529637,36.93632352291221,0.05751352113422603,472.1814179420471,203.95997714996338,668.6329956054688,21800,3015,18785,18785,0,11,3110000.0
3110,3110999,21.193105978861258,36.93392682469765,0.05751751731490473,472.36141180992126,204.0255789756775,669.0855827331543,21818,3016,18802,18802,0,11,3111000.0
3111,3111999,21.190401888097245,36.93031143095614,0.05752389213544984,472.4781107902527,204.09095740318298,669.4467544555664,21824,3016,18808,18808,0,11,3112000.0
3112,3112999,21.188075378508614,36.927703219736415,0.057525148283615546,472.7071182727814,204.15740942955017,669.5510482788086,21836,3018,18818,18818,0,11,3113000.0
3113,3113999,21.185629067895334,36.92430000403665,0.05753103185305142,472.88689255714417,204.22443652153015,669.7044486999512,21851,3019,18832,18832,0,11,3114000.0
3114,3114999,21.183211777619398,36.920561934654835,0.057536017641052095,473.01829957962036,204.29064846038818,669.9309463500977,21854,3019,18835,18835,0,11,3115000.0
3115,3115999,21.18126370578953,36.91887213582393,0.0575328113225968,473.1878261566162,204.35519218444824,670.2045288085938,21858,3020,18838,18838,0,11,3116000.0
3116,3116999,21.179604061933766,36.916713315680305,0.057545553151327034,473.3676438331604,204.4204294681549,670.3863563537598,21861,3021,18840,18840,0,11,3117000.0
3117,3117999,21.17839604996249,36.91447180971616,0.05754355848804038,473.6160433292389,204.48651671409607,670.6517105102539,21889,3023,18866,18866,0,11,3118000.0
3118,3118999,21.177630752277913,36.912695809606916,0.057539034980517156,473.7292785644531,204.55160880088806,670.8937721252441,21889,3023,18866,18866,0,11,3119000.0
3119,3119999,21.177187960568595,36.91156945000994,0.05754261748481937,473.85106778144836,204.61660075187683,671.0558700561523,21889,3023,18866,18866,0,11,3120000.0
3120,3120999,21.17758161554908,36.91246494954374,0.05754546910862035,473.98990774154663,204.6817181110382,671.234920501709,21892,3023,18869,18869,0,11,3121000.0
3121,3121999,21.177673231523357,36.911958495293455,0.05755244068503851,474.1567895412445,204.74600386619568,671.4877738952637,21894,3024,18870,18870,0,11,3122000.0
3122,3122999,21.177852418609692,36.91232623908995,0.057589312086346656,474.3422977924347,204.81074333190918,671.6218223571777,21896,3025,18871,18871,0,11,3123000.0
3123,3123999,21.178731910830596,36.913726858477425,0.057602864391997355,474.5185627937317,204.87534713745117,671.6832084655762,21898,3026,18872,18872,0,11,3124000.0
3124,3124999,21.179875334377126,36.91507336196582,0.057587158388133,474.64232778549194,204.9407079219818,672.1654396057129,21907,3026,18881,18881,0,11,3125000.0
3125,3125999,21.181281783627416,36.91693062044747,0.05758790238736522,474.80846762657166,205.0056607723236,672.3172836303711,21909,3027,18882,18882,0,11,3126000.0
3126,3126999,21.18209692034295,36.91711915275399,0.057572595834401885,474.98363494873047,205.0709421634674,672.5463562011719,21920,3028,18892,18892,0,11,3127000.0
3127,3127999,21.18265225532434,36.91661742647735,0.057574369381513724,475.11567664146423,205.1359646320343,672.7387847900391,21921,3028,18893,18893,0,11,3128000.0
3128,3128999,21.18325683979516,36.91639476204238,0.0575763195170127,475.34238147735596,205.20076537132263,672.7666091918945,21928,3030,18898,18898,0,11,3129000.0
3129,3129999,21.183206122874864,36.915047141022676,0.05757829873716447,475.46285820007324,205.26510739326477,672.9949531555176,21931,3030,18901,18901,0,11,3130000.0
3130,3130999,21.182581440301792,36.91282457788087,0.05757631554218612,475.63681077957153,205.3302505016327,673.1747207641602,21937,3031,18906,18906,0,11,3131000.0
3131,3131999,21.180913361196744,36.91452851916055,0.05756324241170119,475.86471366882324,205.3950912952423,673.5104103088379,21954,3033,18921,18921,0,11,3132000.0
3132,3132999,21.177951344590163,36.910811452448286,0.057572822387626954,475.9928879737854,205.46057677268982,673.7691993713379,21957,3033,18924,18924,0,11,3133000.0
3133,3133999,21.175116485301476,36.90741006723212,0.05758129324413397,476.17565536499023,205.5261778831482,673.8408966064453,21964,3034,18930,18930,0,11,3134000.0
3134,3134999,21.1727885172769,36.906110486051304,0.05758272541558429,476.300758600235,205.59172081947327,673.9619407653809,21965,3034,18931,18931,0,11,3135000.0
3135,3135999,21.17124777398573,36.90460856998514,0.057589319365902614,476.59107542037964,205.65919613838196,673.9935111999512,21975,3037,18938,18938,0,11,3136000.0
3136,3136999,21.1701914072443,36.903350540229546,0.057575171783494805,476.71149039268494,205.7230098247528,674.2182083129883,21976,3037,18939,18939,0,11,3137000.0
3137,3137999,21.16925670853977,36.9020528737416,0.05755492187232325,476.9380099773407,205.78773546218872,674.2445068359375,21983,3039,18944,18944,0,11,3138000.0
3138,3138999,21.168689202793086,36.901903010422174,0.057528814410304996,477.2152018547058,205.85285758972168,674.3559074401855,21992,3042,18950,18950,0,11,3139000.0
3139,3139999,21.168739410419036,36.901801681846536,0.05752658004943789,477.34139490127563,205.9177143573761,674.5550308227539,21992,3042,18950,18950,0,11,3140000.0
3140,3140999,21.17056244421736,36.91045891696507,0.057464932323110784,477.5228431224823,205.9825427532196,674.6639785766602,22003,3043,18960,18960,0,11,3141000.0
3141,3141999,21.17460144928216,36.919695715780556,0.057432596700962124,477.74733114242554,206.04767966270447,674.7502670288086,22014,3045,18969,18969,0,11,3142000.0
3142,3142999,21.181904133692992,36.93597630820038,0.057408084046591035,477.8741521835327,206.11408042907715,675.3359756469727,22026,3045,18981,18981,0,11,3143000.0
3143,3143999,21.190090015233668,36.965548884215046,0.05744945148215441,478.04405903816223,206.1791479587555,675.5024147033691,22042,3046,18996,18996,0,11,3144000.0
3144,3144999,21.19864614102063,36.98982863775538,0.05762234788505838,478.16880798339844,206.2441165447235,675.6853828430176,22042,3046,18996,18996,0,11,3145000.0
3145,3145999,21.209526907775142,37.025623926851274,0.0576692184844243,478.3448259830475,206.3109631538391,676.0937080383301,22067,3047,19020,19020,0,11,3146000.0
3146,3146999,21.22253847177078,37.06627852818112,0.05777495056248749,478.578316450119,206.37737727165222,676.2692985534668,22101,3049,19052,19052,0,11,3147000.0
3147,3147999,21.23463495323246,37.103213101241145,0.0579055530875916,478.7651216983795,206.44312596321106,676.6720771789551,22115,3050,19065,19065,0,11,3148000.0
3148,3148999,21.24617830491262,37.130608363377554,0.05794981549840539,478.88610911369324,206.50814175605774,676.880672454834,22115,3050,19065,19065,0,11,3149000.0
3149,3149999,21.257857387281454,37.16000947601724,0.05806578622424308,479.0642261505127,206.5724630355835,676.9734878540039,22120,3051,19069,19069,0,11,3150000.0
3150,3150999,21.26932832978054,37.18852200902851,0.058166597243110685,479.2958199977875,206.6371772289276,677.1772766113281,22157,3053,19104,19104,0,11,3151000.0
3151,3151999,21.276016362605603,37.205431395019765,0.058161215642297925,479.42342948913574,206.70200419425964,677.5171089172363,22169,3053,19116,19116,0,11,3152000.0
3152,3152999,21.274946480633993,37.21013698394276,0.05812553035357293,479.6478364467621,206.7674572467804,677.8582191467285,22183,3055,19128,19128,0,11,3153000.0
3153,3153999,21.273459092118635,37.20904663303915,0.05811265921483799,479.83108162879944,206.83395338058472,678.0437660217285,22187,3056,19131,19131,0,11,3154000.0
3154,3154999,21.272122055391062,37.20841754301757,0.05810415057311291,480.0133044719696,206.90203070640564,678.2010803222656,22193,3057,19136,19136,0,11,3155000.0
3155,3155999,21.27111408190244,37.20784623012132,0.05806329929348242,480.14068961143494,206.96794486045837,678.567310333252,22201,3057,19144,19144,0,11,3156000.0
3156,3156999,21.270178833736214,37.20648275176348,0.058049713213280674,480.3612265586853,207.03338861465454,678.8110656738281,22214,3059,19155,19155,0,11,3157000.0
3157,3157999,21.268790763723466,37.20387820047921,0.058042533162688925,480.591459274292,207.10049772262573,678.9672470092773,22246,3061,19185,19185,0,11,3158000.0
3158,3158999,21.268253865717302,37.208227113943224,0.05800724770857457,480.71711015701294,207.1658079624176,679.2661018371582,22250,3061,19189,19189,0,11,3159000.0
3159,3159999,21.266904265607902,37.205912796243325,0.058002293565864615,480.89557003974915,207.23037552833557,679.3026084899902,22258,3062,19196,19196,0,11,3160000.0
3160,3160999,21.266038499327234,37.20432521148999,0.05798705193588849,481.03080463409424,207.2951271533966,679.4168014526367,22258,3062,19196,19196,0,11,3161000.0
3161,3161999,21.265175642095357,37.20280082234317,0.057967062717834694,481.2115340232849,207.3615152835846,679.9652938842773,22279,3063,19216,19216,0,11,3162000.0
3162,3162999,21.26505892866414,37.202672290803335,0.05795372641151808,481.3885519504547,207.42691564559937,680.2224082946777,22281,3064,19217,19217,0,11,3163000.0
3163,3163999,21.26495775558363,37.20226165812958,0.05794148322475001,481.60885882377625,207.49377155303955,680.4238624572754,22298,3066,19232,19232,0,11,3164000.0
3164,3164999,21.265225488759253,37.20194596825237,0.05792093034428514,481.779456615448,207.55953216552734,680.978157043457,22315,3067,19248,19248,0,11,3165000.0
3165,3165999,21.265203463980885,37.200531410764135,0.057911798810136306,481.9033501148224,207.62458562850952,681.246955871582,22316,3067,19249,19249,0,11,3166000.0
3166,3166999,21.26506155411386,37.198594793247494,0.05790474563557846,482.02206802368164,207.6901969909668,681.563232421875,22321,3067,19254,19254,0,11,3167000.0
3167,3167999,21.265308664248455,37.19767760958453,0.057886883808453304,482.2000181674957,207.7552032470703,681.7824668884277,22327,3068,19259,19259,0,11,3168000.0
3168,3168999,21.265377505077,37.19610430194253,0.05788079888522146,482.3259871006012,207.82022714614868,681.9711875915527,22328,3068,19260,19260,0,11,3169000.0
3169,3169999,21.264578076710208,37.19504089415853,0.05786407195754295,482.44881296157837,207.88547039031982,682.1772575378418,22329,3068,19261,19261,0,11,3170000.0
3170,3170999,21.262586674049707,37.19204776927585,0.05786788250461783,482.6804852485657,207.95113921165466,682.5806579589844,22368,3070,19298,19298,0,11,3171000.0
3171,3171999,21.259957358998886,37.18867852495142,0.05787859072876855,482.8531336784363,208.01833987236023,682.8596992492676,22385,3071,19314,19314,0,11,3172000.0
3172,3172999,21.257389709007242,37.18536827884838,0.05788886434824625,482.9813551902771,208.08426523208618,683.0608558654785,22385,3071,19314,19314,0,11,3173000.0
3173,3173999,21.25445307788534,37.18091523379847,0.057903790440715586,483.1065020561218,208.14971613883972,683.1879425048828,22385,3071,19314,19314,0,11,3174000.0
3174,3174999,21.252182500404853,37.17718433988484,0.05790825725812765,483.25050497055054,208.2152338027954,683.4650993347168,22390,3071,19319,19319,0,11,3175000.0
3175,3175999,21.24983744727619,37.17441705739646,0.05791286241501081,483.3761637210846,208.28018617630005,683.5869445800781,22391,3071,19320,19320,0,11,3176000.0
3176,3176999,21.24743381982057,37.170505670255764,0.05791601208075259,483.616352558136,208.3467025756836,683.7638969421387,22416,3073,19343,19343,0,11,3177000.0
3177,3177999,21.245310213128057,37.16676780955418,0.0579134470640158,483.79911828041077,208.4121811389923,683.9607467651367,22427,3074,19353,19353,0,11,3178000.0
3178,3178999,21.243260063493437,37.164614390159876,0.057904894522153416,483.97488021850586,208.4773509502411,684.0804595947266,22429,3075,19354,19354,0,11,3179000.0
3179,3179999,21.241396830044227,37.161733345991586,0.057906339046476574,484.1072633266449,208.5423629283905,684.1892051696777,22429,3075,19354,19354,0,11,3180000.0
3180,3180999,21.2395608657525,37.158513080751085,0.05789981903368413,484.3266611099243,208.6088535785675,684.5395355224609,22442,3077,19365,19365,0,11,3181000.0
3181,3181999,21.237825019788268,37.15529641237905,0.05789767705857418,484.4514455795288,208.67450213432312,684.8121490478516,22442,3077,19365,19365,0,11,3182000.0
3182,3182999,21.236337098749715,37.15214611588875,0.057890171922992284,484.67845916748047,208.74099206924438,684.9115905761719,22463,3079,19384,19384,0,11,3183000.0
3183,3183999,21.23570907972681,37.15054728509669,0.0578751752116311,484.80189633369446,208.8066484928131,685.29931640625,22470,3079,19391,19391,0,11,3184000.0
3184,3184999,21.23582441718615,37.15262382848857,0.05785030186175799,484.98608016967773,208.87178874015808,685.4413261413574,22472,3080,19392,19392,0,11,3185000.0
3185,3185999,21.236155166536562,37.15300786542231,0.057838932242845864,485.1630401611328,208.9367835521698,685.518497467041,22475,3081,19394,19394,0,11,3186000.0
3186,3186999,21.236173725878043,37.152269195878986,0.057841600016466765,485.3376305103302,209.00233626365662,685.7299995422363,22480,3082,19398,19398,0,11,3187000.0
3187,3187999,21.236716122429314,37.15259821461346,0.057842965800610546,485.5210862159729,209.06654238700867,685.8133697509766,22485,3083,19402,19402,0,11,3188000.0
3188,3188999,21.237153492083074,37.15267579149681,0.05786174432713731,485.6457772254944,209.13059282302856,685.9018669128418,22485,3083,19402,19402,0,11,3189000.0
3189,3189999,21.237556976538954,37.15174901888397,0.05785148108629756,485.7700002193451,209.19535303115845,686.1396293640137,22488,3083,19405,19405,0,11,3190000.0
3190,3190999,21.237050725038358,37.151253252196916,0.05784298076986527,485.88464403152466,209.25995993614197,686.3924026489258,22494,3083,19411,19411,0,11,3191000.0
3191,3191999,21.234004267935592,37.14674931585874,0.0578592114110017,486.0055284500122,209.32439827919006,686.614673614502,22498,3083,19415,19415,0,11,3192000.0
3192,3192999,21.231513995426152,37.14389132755274,0.05786501988562209,486.1264679431915,209.38959956169128,686.787036895752,22498,3083,19415,19415,0,11,3193000.0
3193,3193999,21.229305986534953,37.14118205444282,0.05786897389758294,486.24726605415344,209.45522236824036,686.9357643127441,22498,3083,19415,19415,0,11,3194000.0
3194,3194999,21.227034074825184,37.13881414978965,0.057869879279835224,486.3839409351349,209.5207703113556,687.0196075439453,22498,3083,19415,19415,0,11,3195000.0
3195,3195999,21.224710106974808,37.13692946387082,0.05786333913237607,486.51970386505127,209.58595204353333,687.3820838928223,22504,3083,19421,19421,0,11,3196000.0
3196,3196999,21.222494373206132,37.13318356124817,0.0578606205153519,486.74199771881104,209.65101099014282,687.5046119689941,22508,3085,19423,19423,0,11,3197000.0
3197,3197999,21.220391450943946,37.12965877891023,0.05785953740876526,486.92315220832825,209.7164876461029,687.599437713623,22517,3086,19431,19431,0,11,3198000.0
3198,3198999,21.218917053584253,37.12840491518185,0.05784438898674149,487.0425763130188,209.78156280517578,687.8569641113281,22521,3086,19435,19435,0,11,3199000.0
3199,3199999,21.217313516942568,37.12510456766069,0.05784326725308442,487.16579246520996,209.84734177589417,687.9788436889648,22521,3086,19435,19435,0,11,3200000.0
3200,3200999,21.216239460793748,37.12353668246768,0.05783457950681048,487.3509871959686,209.91208505630493,688.0611724853516,22538,3087,19451,19451,0,11,3201000.0
3201,3201999,21.216058039336705,37.12348567354473,0.05781836769664117,487.47078013420105,209.97678899765015,688.3957443237305,22543,3087,19456,19456,0,11,3202000.0
3202,3202999,21.215946867125073,37.12281429656611,0.057815177344825774,487.7985632419586,210.0433120727539,688.4856643676758,22553,3091,19462,19462,0,11,3203000.0
3203,3203999,21.217782610361667,37.12725162393096,0.057810619791036966,487.9172103404999,210.10820531845093,688.6514892578125,22553,3091,19462,19462,0,11,3204000.0
3204,3204999,21.221125308010965,37.13395002538417,0.05782230293291668,488.04233050346375,210.17382383346558,688.9812240600586,22558,3091,19467,19467,0,11,3205000.0
3205,3205999,21.225118311192347,37.14422479468448,0.05784086778979358,488.2255184650421,210.23865747451782,689.1302680969238,22561,3092,19469,19469,0,11,3206000.0
3206,3206999,21.229657045580968,37.15187714819498,0.05787009266369081,488.3500485420227,210.30338954925537,689.2717819213867,22561,3092,19469,19469,0,11,3207000.0
3207,3207999,21.23414845026277,37.15911244474299,0.05795532554973504,488.47940707206726,210.3680500984192,689.5912170410156,22567,3092,19475,19475,0,11,3208000.0
3208,3208999,21.23816300612058,37.166051853557896,0.058073331675243645,488.6041781902313,210.43252110481262,689.7541923522949,22567,3092,19475,19475,0,11,3209000.0
3209,3209999,21.242105517132266,37.173134184965555,0.058154837267138326,488.7181317806244,210.49697518348694,689.868335723877,22568,3092,19476,19476,0,11,3210000.0
3210,3210999,21.246652182245846,37.18061524158359,0.05824863051053086,488.84359407424927,210.56134963035583,690.1961441040039,22574,3092,19482,19482,0,11,3211000.0
3211,3211999,21.24959528446143,37.192112081011594,0.058285963518538986,488.98256373405457,210.62634468078613,690.5404586791992,22584,3092,19492,19492,0,11,3212000.0
3212,3212999,21.24695750975675,37.18948802772822,0.0582902963914218,489.09973192214966,210.69128155708313,690.9305458068848,22595,3092,19503,19503,0,11,3213000.0
3213,3213999,21.244433011558105,37.186011058033515,0.05829797392412206,489.2781448364258,210.75742053985596,691.2954597473145,22605,3093,19512,19512,0,11,3214000.0
3214,3214999,21.241927034451997,37.182483962439704,0.05830590170674088,489.4033422470093,210.82305002212524,691.4849090576172,22605,3093,19512,19512,0,11,3215000.0
3215,3215999,21.23976310118979,37.17915107098992,0.05831594840398768,489.5247585773468,210.88834190368652,691.6056823730469,22605,3093,19512,19512,0,11,3216000.0
3216,3216999,21.237775903929666,37.1769305902235,0.058314154606870394,489.81024408340454,210.95482397079468,691.7030448913574,22646,3096,19550,19550,0,11,3217000.0
3217,3217999,21.236284685537168,37.17520176877023,0.058309955486607556,489.9949245452881,211.0193691253662,691.8249969482422,22649,3097,19552,19552,0,11,3218000.0
3218,3218999,21.23484856089738,37.1736426556189,0.05830853386909296,490.17972922325134,211.08443021774292,691.873779296875,22655,3098,19557,19557,0,11,3219000.0
3219,3219999,21.234121467816642,37.17364524900827,0.05830849518711145,490.3613531589508,211.15001893043518,692.0684928894043,22660,3099,19561,19561,0,11,3220000.0
3220,3220999,21.234145183431224,37.177581380395914,0.05830390922441553,490.48830127716064,211.2152144908905,692.2412338256836,22660,3099,19561,19561,0,11,3221000.0
3221,3221999,21.235228590466907,37.182411194846935,0.058291977957385055,490.6182987689972,211.28028011322021,692.3676643371582,22660,3099,19561,19561,0,11,3222000.0
3222,3222999,21.23865549602978,37.19242780557325,0.05834368928489031,490.750657081604,211.34588313102722,692.8242874145508,22671,3099,19572,19572,0,11,3223000.0
3223,3223999,21.242792068479837,37.205653515625634,0.05838886245667141,490.88000893592834,211.41070985794067,693.0621795654297,22671,3099,19572,19572,0,11,3224000.0
3224,3224999,21.248331118853677,37.22057598261747,0.05852950670637713,491.0506134033203,211.47675108909607,693.1677169799805,22673,3100,19573,19573,0,11,3225000.0
3225,3225999,21.255607136160272,37.23926883414205,0.05863839293474005,491.17185711860657,211.54206895828247,693.4818725585938,22677,3100,19577,19577,0,11,3226000.0
3226,3226999,21.262531328506537,37.25587554167261,0.05867133806306091,491.3000545501709,211.60686039924622,693.6636352539062,22678,3100,19578,19578,0,11,3227000.0
3227,3227999,21.270689010781055,37.27718129952699,0.05877173816260728,491.4168436527252,211.67139506340027,693.7707252502441,22678,3100,19578,19578,0,11,3228000.0
3228,3228999,21.277916596339058,37.29820183790403,0.05883009383434523,491.5989890098572,211.73659348487854,694.0113983154297,22691,3101,19590,19590,0,11,3229000.0
3229,3229999,21.285986863961696,37.31733499002846,0.05891664674397745,491.7628719806671,211.80082654953003,694.1195793151855,22693,3102,19591,19591,0,11,3230000.0
3230,3230999,21.295756486264885,37.34432927733958,0.059048732558397043,491.98108100891113,211.86529207229614,694.260009765625,22708,3104,19604,19604,0,11,3231000.0
3231,3231999,21.301346024564992,37.356387112898865,0.0590723935044396,492.15558099746704,211.9298222064972,694.4226608276367,22715,3105,19610,19610,0,11,3232000.0
3232,3232999,21.301398255364653,37.35751444486298,0.05907893127202124,492.28690361976624,211.99429631233215,694.8054618835449,22729,3105,19624,19624,0,11,3233000.0
3233,3233999,21.299457117093944,37.355538794247515,0.05907558115230638,492.41408109664917,212.05960726737976,695.0815124511719,22733,3105,19628,19628,0,11,3234000.0
3234,3234999,21.297774454343482,37.35797246668108,0.05905698015494476,492.5971927642822,212.12546610832214,695.2092399597168,22740,3106,19634,19634,0,11,3235000.0
3235,3235999,21.29623972621962,37.35649340716223,0.0590581761126604,492.8287863731384,212.19173192977905,695.2671585083008,22748,3108,19640,19640,0,11,3236000.0
3236,3236999,21.29463020796067,37.35449882404688,0.05905347390812066,493.1239035129547,212.25904631614685,695.4459648132324,22791,3111,19680,19680,0,11,3237000.0
3237,3237999,21.293385307655186,37.352263667438116,0.059053616156820254,493.31441617012024,212.33217096328735,695.6570281982422,22799,3112,19687,19687,0,11,3238000.0
3238,3238999,21.291520390496473,37.34870376155179,0.05905736656991023,493.59841418266296,212.39915347099304,695.7515258789062,22812,3115,19697,19697,0,11,3239000.0
3239,3239999,21.290165687397003,37.34588110401067,0.059050334055629095,493.83097410202026,212.46602654457092,696.148380279541,22839,3117,19722,19722,0,11,3240000.0
3240,3240999,21.289183067342876,37.34368797202199,0.059040715963273205,494.00524282455444,212.53182315826416,696.2712936401367,22841,3118,19723,19723,0,11,3241000.0
3241,3241999,21.288474441226064,37.34182742558012,0.059037345032472155,494.239120721817,212.59811878204346,696.4107780456543,22845,3120,19725,19725,0,11,3242000.0
3242,3242999,21.28805496673082,37.3398326590648,0.05902202449088467,494.5305173397064,212.66625022888184,696.7063636779785,22873,3123,19750,19750,0,11,3243000.0
3243,3243999,21.289367172816103,37.341525973194855,0.059026098503153324,494.6503071784973,212.73245549201965,697.148509979248,22876,3123,19753,19753,0,11,3244000.0
3244,3244999,21.291048790632757,37.34325208378148,0.05902177416583654,494.82183027267456,212.79868340492249,697.3420753479004,22878,3124,19754,19754,0,11,3245000.0
3245,3245999,21.293879529260277,37.3490095606247,0.059045029325292875,495.0503604412079,212.8645360469818,697.5824089050293,22893,3126,19767,19767,0,11,3246000.0
3246,3246999,21.298132004978815,37.36126599659182,0.05905016587929324,495.1760380268097,212.93021178245544,697.9994163513184,22898,3126,19772,19772,0,11,3247000.0
3247,3247999,21.302931917731822,37.37029644449632,0.05907244406373968,495.36419773101807,212.9962933063507,698.1846046447754,22900,3127,19773,19773,0,11,3248000.0
3248,3248999,21.308349866793865,37.38062497389616,0.059144816573511116,495.54700994491577,213.06245613098145,698.5693969726562,22916,3128,19788,19788,0,11,3249000.0
3249,3249999,21.31309135297848,37.38954548733839,0.05920755936302702,495.7792122364044,213.12892818450928,698.869384765625,22954,3130,19824,19824,0,11,3250000.0
3250,3250999,21.31766363559296,37.395895899793864,0.05930511831479657,496.01073837280273,213.19460105895996,698.9699516296387,22965,3132,19833,19833,0,11,3251000.0
3251,3251999,21.3232317126601,37.40383129943692,0.059411287411048175,496.1356592178345,213.26084923744202,699.3663139343262,22973,3132,19841,19841,0,11,3252000.0
3252,3252999,21.32627321327091,37.40958813145466,0.05942906060613751,496.3061239719391,213.32541179656982,699.5105094909668,22979,3133,19846,19846,0,11,3253000.0
3253,3253999,21.324331726351534,37.40687660400187,0.059427022257376616,496.47896432876587,213.3914132118225,700.0912818908691,23005,3134,19871,19871,0,11,3254000.0
3254,3254999,21.321819737862093,37.403474674601405,0.059433608105170066,496.5994760990143,213.45796012878418,700.6784439086914,23015,3134,19881,19881,0,11,3255000.0
3255,3255999,21.320150538627868,37.404973491473505,0.05940965569161716,496.722736120224,213.52434587478638,700.9683952331543,23016,3134,19882,19882,0,11,3256000.0
3256,3256999,21.31836418098082,37.402004156168246,0.05940459885179239,496.9138140678406,213.59572410583496,701.1130790710449,23026,3135,19891,19891,0,11,3257000.0
3257,3257999,21.316665622554815,37.40069206329641,0.05940177394810542,497.0906581878662,213.6621289253235,701.4446029663086,23034,3136,19898,19898,0,11,3258000.0
3258,3258999,21.31551697837598,37.39913578228151,0.059388503596307096,497.2598035335541,213.72686862945557,701.6329574584961,23037,3137,19900,19900,0,11,3259000.0
3259,3259999,21.314001987726556,37.398147822612174,0.0593776426262812,497.5039324760437,213.79510951042175,701.7884101867676,23043,3139,19904,19904,0,11,3260000.0
3260,3260999,21.312577153964256,37.395504366743424,0.059367407453820076,497.7300362586975,213.86141848564148,702.1725120544434,23060,3141,19919,19919,0,11,3261000.0
3261,3261999,21.311240198456822,37.39292949337013,0.05935393812526457,497.90110778808594,213.9284543991089,702.3992958068848,23062,3142,19920,19920,0,11,3262000.0
3262,3262999,21.310365403802255,37.39143796474672,0.05933923248242312,498.08005118370056,213.9946587085724,702.5742530822754,23064,3143,19921,19921,0,11,3263000.0
3263,3263999,21.30948557397696,37.390601218188074,0.05933117214328942,498.1975271701813,214.06053686141968,702.9269714355469,23069,3143,19926,19926,0,11,3264000.0
3264,3264999,21.30955042729721,37.38959772670122,0.05933139200823456,498.4269931316376,214.1262891292572,703.1156272888184,23073,3145,19928,19928,0,11,3265000.0
3265,3265999,21.309723653199903,37.38888304698044,0.05932881394288814,498.54537773132324,214.1917634010315,703.336612701416,23073,3145,19928,19928,0,11,3266000.0
3266,3266999,21.310508599482805,37.38909021517958,0.059354522099580365,498.73247933387756,214.2592134475708,703.5338821411133,23081,3146,19935,19935,0,11,3267000.0
3267,3267999,21.313159317919542,37.39233025055831,0.05935343101064516,498.9630780220032,214.32598280906677,703.9259757995605,23097,3148,19949,19949,0,11,3268000.0
3268,3268999,21.316050870764542,37.39511946583745,0.059388770426291315,499.14826917648315,214.39135551452637,704.0979309082031,23099,3149,19950,19950,0,11,3269000.0
3269,3269999,21.319249589933722,37.39900114697451,0.05942553217090207,499.278128862381,214.45766353607178,704.4204711914062,23106,3149,19957,19957,0,11,3270000.0
3270,3270999,21.322707735848923,37.40308230188207,0.05946482509351758,499.5004897117615,214.52279257774353,704.5778846740723,23117,3151,19966,19966,0,11,3271000.0
3271,3271999,21.325477818810974,37.405053038697424,0.05950702424728971,499.6178994178772,214.5871045589447,704.7293853759766,23117,3151,19966,19966,0,11,3272000.0
3272,3272999,21.32826667524893,37.40713146836513,0.059522367742144255,499.8114047050476,214.65257692337036,704.9297523498535,23123,3152,19971,19971,0,11,3273000.0
3273,3273999,21.330187686493616,37.40824938629366,0.05954205818978542,499.92846179008484,214.7176902294159,705.1413917541504,23123,3152,19971,19971,0,11,3274000.0
3274,3274999,21.32916396951836,37.405748489754465,0.05953855292692578,500.09806776046753,214.78213548660278,705.5163421630859,23136,3153,19983,19983,0,11,3275000.0
3275,3275999,21.327074905367112,37.40251236541946,0.05953536712197294,500.3311460018158,214.84780550003052,705.7457237243652,23158,3155,20003,20003,0,11,3276000.0
3276,3276999,21.325087794240943,37.39953937870375,0.059530020009882834,500.45378494262695,214.91418957710266,705.922679901123,23158,3155,20003,20003,0,11,3277000.0
3277,3277999,21.32385566815417,37.3968565262358,0.05951035735437871,500.733327627182,214.98036289215088,705.9265670776367,23173,3158,20015,20015,0,11,3278000.0
3278,3278999,21.321806216720685,37.39316808065477,0.0595064323033766,500.93506813049316,215.05201649665833,706.0080032348633,23178,3159,20019,20019,0,11,3279000.0
3279,3279999,21.320826787674065,37.39423514932769,0.05948060254090104,501.1102485656738,215.11756563186646,706.4370384216309,23192,3160,20032,20032,0,11,3280000.0
3280,3280999,21.31910903230045,37.39117272610537,0.05947354425718987,501.28789162635803,215.18740820884705,706.5257949829102,23194,3161,20033,20033,0,11,3281000.0
3281,3281999,21.31767427508143,37.388030151146005,0.05945338209157591,501.57019662857056,215.2536723613739,706.7253837585449,23228,3164,20064,20064,0,11,3282000.0
3282,3282999,21.31669639704606,37.38531515491247,0.05941720194017863,501.7451558113098,215.31976580619812,706.8991851806641,23230,3165,20065,20065,0,11,3283000.0
3283,3283999,21.316182324290814,37.38292414959528,0.059373797504730486,501.8785443305969,215.38579678535461,707.0468482971191,23230,3165,20065,20065,0,11,3284000.0
3284,3284999,21.31614195108387,37.382019903757794,0.05934245969833252,502.1694393157959,215.4523069858551,707.0651321411133,23242,3168,20074,20074,0,11,3285000.0
3285,3285999,21.316944653225953,37.381637003516595,0.059274501175446415,502.2869653701782,215.51924228668213,707.7217864990234,23259,3168,20091,20091,0,11,3286000.0
3286,3286999,21.317870376133975,37.38092626369088,0.05924608242444429,502.40691566467285,215.58451104164124,707.9792861938477,23259,3168,20091,20091,0,11,3287000.0
3287,3287999,21.31887054808631,37.38068791518998,0.0592262614625515,502.523948431015,215.6493685245514,708.1605567932129,23259,3168,20091,20091,0,11,3288000.0
3288,3288999,21.320940307413093,37.381846887806475,0.05916483678422968,502.8250513076782,215.71677017211914,708.5414505004883,23311,3171,20140,20140,0,11,3289000.0
3289,3289999,21.32309006119272,37.382874333894605,0.05909438145162782,503.0499472618103,215.78265523910522,708.7069778442383,23318,3173,20145,20145,0,11,3290000.0
3290,3290999,21.324951564654032,37.38307865581699,0.05903622013588783,503.27890181541443,215.84832334518433,708.771785736084,23325,3175,20150,20150,0,11,3291000.0
3291,3291999,21.326646812279368,37.38283846974542,0.058999190506218824,503.4579939842224,215.91518020629883,709.2753791809082,23341,3176,20165,20165,0,11,3292000.0
3292,3292999,21.32875319237912,37.38588230982309,0.05894896072824152,503.6369993686676,215.98039770126343,709.4542694091797,23346,3177,20169,20169,0,11,3293000.0
3293,3293999,21.330921694178326,37.39233052820615,0.058883001018099956,503.8138084411621,216.0454466342926,709.5934371948242,23348,3178,20170,20170,0,11,3294000.0
3294,3294999,21.332054370513355,37.39150968388891,0.058836666269262206,504.00361704826355,216.1175138950348,709.9078521728516,23357,3179,20178,20178,0,11,3295000.0
3295,3295999,21.331922163618525,37.39088637268062,0.05878894959796299,504.17728972435,216.1825466156006,710.3310852050781,23376,3180,20196,20196,0,11,3296000.0
3296,3296999,21.330880056397316,37.38991089455631,0.058800687905930515,504.3010187149048,216.24823021888733,710.7700958251953,23384,3180,20204,20204,0,11,3297000.0
3297,3297999,21.329738015857814,37.38772196087127,0.05881729267849978,504.4271092414856,216.31423783302307,710.9802436828613,23385,3180,20205,20205,0,11,3298000.0
3298,3298999,21.32894828479831,37.38596419155267,0.05881582058072621,504.6150071620941,216.38083791732788,711.1185073852539,23388,3181,20207,20207,0,11,3299000.0
3299,3299999,21.32850316991877,37.385039689270315,0.05881066358755138,504.7446584701538,216.4471733570099,711.338134765625,23391,3181,20210,20210,0,11,3300000.0
3300,3300999,21.328039133104113,37.383464016009434,0.05881777488375928,504.86817693710327,216.51383924484253,711.6965446472168,23398,3181,20217,20217,0,11,3301000.0
3301,3301999,21.328086459967473,37.38292245149836,0.058808536832485214,505.04496240615845,216.57920956611633,711.8788681030273,23414,3182,20232,20232,0,11,3302000.0
3302,3302999,21.32835958579223,37.382053180427114,0.05878320442283602,505.32581210136414,216.64534616470337,712.092456817627,23441,3185,20256,20256,0,11,3303000.0
3303,3303999,21.329842803378554,37.384706164752124,0.058771327253512085,505.50982761383057,216.71145462989807,712.2652206420898,23457,3186,20271,20271,0,11,3304000.0
3304,3304999,21.33099139327741,37.38665194722994,0.05876600729979098,505.63669896125793,216.77726912498474,712.4055404663086,23457,3186,20271,20271,0,11,3305000.0
3305,3305999,21.333813971696184,37.397609500180295,0.05875481838739616,505.8269476890564,216.84388709068298,712.9294853210449,23478,3187,20291,20291,0,11,3306000.0
3306,3306999,21.337518818230873,37.406801201879475,0.05890432203575724,505.99786162376404,216.91041254997253,713.2024116516113,23481,3188,20293,20293,0,11,3307000.0
3307,3307999,21.340517837288086,37.41239383371187,0.05908264281661424,506.1321597099304,216.98221611976624,713.4499588012695,23481,3188,20293,20293,0,11,3308000.0
3308,3308999,21.343962982954203,37.419067943409125,0.059226099930962506,506.3046808242798,217.0485179424286,713.9385871887207,23494,3189,20305,20305,0,11,3309000.0
3309,3309999,21.34758158381203,37.42442060621528,0.059362584671167284,506.53923749923706,217.11450338363647,714.1079368591309,23504,3191,20313,20313,0,11,3310000.0
3310,3310999,21.35127998326017,37.4289904730802,0.05942465749938197,506.7155108451843,217.18093466758728,714.2921943664551,23522,3192,20330,20330,0,11,3311000.0
3311,3311999,21.355609433184437,37.43624266489112,0.05949495433917451,506.9467875957489,217.24772548675537,714.5280342102051,23537,3194,20343,20343,0,11,3312000.0
3312,3312999,21.358585539086445,37.44002420290056,0.05954651405757572,507.1804509162903,217.31458473205566,714.6163024902344,23544,3196,20348,20348,0,11,3313000.0
3313,3313999,21.361164358502972,37.44224160975825,0.05955200304890773,507.4138388633728,217.37967133522034,714.8201675415039,23583,3198,20385,20385,0,11,3314000.0
3314,3314999,21.36110969983707,37.44295532188004,0.059528832911472485,507.5419125556946,217.4461796283722,715.2650527954102,23600,3198,20402,20402,0,11,3315000.0
3315,3315999,21.360073743286883,37.442339089021104,0.05951396029816747,507.71897411346436,217.51197576522827,715.5277824401855,23633,3199,20434,20434,0,11,3316000.0
3316,3316999,21.358706052737883,37.44047454397078,0.05952716642854172,507.9036545753479,217.578138589859,715.6718063354492,23639,3200,20439,20439,0,11,3317000.0
3317,3317999,21.357830367575783,37.44109321567364,0.05952607376345542,508.0839228630066,217.64411211013794,715.786190032959,23645,3201,20444,20444,0,11,3318000.0
3318,3318999,21.35807437888141,37.44165945488305,0.05951414347071893,508.27884125709534,217.71044945716858,716.0947341918945,23654,3202,20452,20452,0,11,3319000.0
3319,3319999,21.358167897957742,37.443272434780646,0.059515154976019,508.40655303001404,217.7761631011963,716.2537803649902,23654,3202,20452,20452,0,11,3320000.0
3320,3320999,21.358347442363904,37.44476215851845,0.05951987786877888,508.5285449028015,217.84118795394897,716.3783760070801,23654,3202,20452,20452,0,11,3321000.0
3321,3321999,21.35973785178609,37.44756921374522,0.059502987644398875,508.71995067596436,217.90730023384094,716.5809516906738,23658,3203,20455,20455,0,11,3322000.0
3322,3322999,21.360603091900938,37.44809997123307,0.05951784169245655,508.90870928764343,217.97314858436584,716.6597595214844,23660,3204,20456,20456,0,11,3323000.0
3323,3323999,21.36225153731182,37.45093755115973,0.059530636292349226,509.03810143470764,218.03867554664612,716.7546806335449,23660,3204,20456,20456,0,11,3324000.0
3324,3324999,21.364358684171545,37.45406887315065,0.05953763152866587,509.2132022380829,218.10450434684753,717.2084655761719,23673,3205,20468,20468,0,11,3325000.0
3325,3325999,21.366334165047107,37.45629495993812,0.05958615341728857,509.4402701854706,218.17050313949585,717.3872337341309,23677,3207,20470,20470,0,11,3326000.0
3326,3326999,21.369005369301767,37.46535997202741,0.05961413276606087,509.56874680519104,218.23560857772827,717.5571174621582,23677,3207,20470,20470,0,11,3327000.0
3327,3327999,21.37149427538266,37.47087465774673,0.059651590361227136,509.7396273612976,218.30157446861267,717.9924163818359,23688,3208,20480,20480,0,11,3328000.0
3328,3328999,21.37447002167391,37.47832513885911,0.05968608770067041,509.87056136131287,218.3677113056183,718.2134284973145,23688,3208,20480,20480,0,11,3329000.0
3329,3329999,21.376832624676886,37.48131937573682,0.05971492281259805,510.11411333084106,218.4334855079651,718.2311630249023,23692,3210,20482,20482,0,11,3330000.0
3330,3330999,21.379748983598073,37.487007942697176,0.059756443376968504,510.30482053756714,218.50025272369385,718.7030487060547,23708,3211,20497,20497,0,11,3331000.0
3331,3331999,21.381855168702664,37.48962654282647,0.059796928953620654,510.48837876319885,218.56516027450562,718.8791618347168,23712,3212,20500,20500,0,11,3332000.0
3332,3332999,21.384399643280776,37.494982024952336,0.05983461901264919,510.6075894832611,218.6296272277832,719.0587120056152,23713,3212,20501,20501,0,11,3333000.0
3333,3333999,21.3863872101565,37.49663863215695,0.05987068559525777,510.7261230945587,218.6943018436432,719.3287162780762,23715,3212,20503,20503,0,11,3334000.0
3334,3334999,21.38723248842432,37.50067990675794,0.05986978266834475,510.84573578834534,218.75821232795715,719.6034736633301,23723,3212,20511,20511,0,11,3335000.0
3335,3335999,21.385001820583994,37.49881899833272,0.059872913999961974,510.96507596969604,218.82236695289612,719.8093719482422,23725,3212,20513,20513,0,11,3336000.0
3336,3336999,21.382607479923944,37.495542532892195,0.059875919732022886,511.09615182876587,218.88803243637085,720.1650466918945,23728,3212,20516,20516,0,11,3337000.0
3337,3337999,21.380176572639133,37.49196861947899,0.059882234542089074,511.22717213630676,218.95529174804688,720.3007698059082,23728,3212,20516,20516,0,11,3338000.0
3338,3338999,21.378470742431976,37.49022566207214,0.059876214013128815,511.3477120399475,219.0208592414856,720.4228324890137,23728,3212,20516,20516,0,11,3339000.0
3339,3339999,21.37630122013091,37.48674571241028,0.059876282049503904,511.5284974575043,219.0864806175232,720.651294708252,23736,3213,20523,20523,0,11,3340000.0
3340,3340999,21.374952203898253,37.48546408237417,0.05986299130558881,511.75773644447327,219.15101265907288,720.7230415344238,23740,3215,20525,20525,0,11,3341000.0
3341,3341999,21.373543111834156,37.48294982702593,0.05985459820291095,511.8872039318085,219.21563243865967,720.8282203674316,23740,3215,20525,20525,0,11,3342000.0
3342,3342999,21.37253535751124,37.48069470179536,0.05984019584441136,512.0223066806793,219.28114795684814,721.1126251220703,23743,3215,20528,20528,0,11,3343000.0
3343,3343999,21.372332524960978,37.48054224736193,0.05983085327797566,512.207453250885,219.3471601009369,721.2887840270996,23753,3216,20537,20537,0,11,3344000.0
3344,3344999,21.37218980860546,37.47999586832648,0.059811499653732225,512.3883283138275,219.41293907165527,721.3523864746094,23755,3217,20538,20538,0,11,3345000.0
3345,3345999,21.37333777120349,37.48268185271478,0.059822936100404345,512.5157785415649,219.4798789024353,721.737548828125,23760,3217,20543,20543,0,11,3346000.0
3346,3346999,21.37580433796744,37.48737111920013,0.059849658211835965,512.6902885437012,219.54599738121033,721.9379234313965,23764,3218,20546,20546,0,11,3347000.0
3347,3347999,21.378226344849747,37.490607374853376,0.05990535595331037,512.8641078472137,219.61097192764282,722.0269203186035,23766,3219,20547,20547,0,11,3348000.0
3348,3348999,21.381156130567753,37.49538175460793,0.05994974397268105,513.0582695007324,219.6772539615631,722.3306999206543,23774,3220,20554,20554,0,11,3349000.0
3349,3349999,21.3853781595415,37.5038210832909,0.05998002031563865,513.231707572937,219.74217176437378,722.4795265197754,23776,3221,20555,20555,0,11,3350000.0
3350,3350999,21.390081571742147,37.5116287681149,0.060067821836152,513.3559756278992,219.80702376365662,722.6543731689453,23776,3221,20555,20555,0,11,3351000.0
3351,3351999,21.395129177912853,37.52776677324193,0.06007583860336119,513.5366251468658,219.87220430374146,722.9740676879883,23790,3222,20568,20568,0,11,3352000.0
3352,3352999,21.39930311511755,37.53520460941959,0.06007853309040245,513.658417224884,219.93826818466187,723.151725769043,23790,3222,20568,20568,0,11,3353000.0
3353,3353999,21.40355810622341,37.542805577249965,0.060101613241845486,513.777291059494,220.00237917900085,723.2762718200684,23790,3222,20568,20568,0,11,3354000.0
3354,3354999,21.406324483790332,37.545502297693545,0.06011008582463695,513.9015860557556,220.06670928001404,723.5566749572754,23794,3222,20572,20572,0,11,3355000.0
3355,3355999,21.40736884167123,37.54667319262001,0.06010091305572851,514.0776646137238,220.13106727600098,723.7933883666992,23806,3223,20583,20583,0,11,3356000.0
3356,3356999,21.405411077222528,37.5448870659366,0.06009383488670561,514.2556715011597,220.19693112373352,724.1772727966309,23822,3224,20598,20598,0,11,3357000.0
3357,3357999,21.40380358687394,37.54554450628767,0.060082118041931865,514.4404165744781,220.26307487487793,724.4910583496094,23828,3225,20603,20603,0,11,3358000.0
3358,3358999,21.40212576518689,37.544207923868974,0.06007468961854445,514.6179051399231,220.3289692401886,724.5996170043945,23830,3226,20604,20604,0,11,3359000.0
3359,3359999,21.400120419522437,37.54097842006867,0.060077735904750074,514.7391033172607,220.39531135559082,724.7099227905273,23830,3226,20604,20604,0,11,3360000.0
3360,3360999,21.398706752360933,37.53840000604111,0.06006434807224281,514.8591711521149,220.4602975845337,724.9146270751953,23832,3226,20606,20606,0,11,3361000.0
3361,3361999,21.397872837973022,37.53677957466172,0.06005045282499566,515.0961394309998,220.5251259803772,724.9961242675781,23836,3228,20608,20608,0,11,3362000.0
3362,3362999,21.396836350423172,37.53464935172024,0.06003882770475044,515.2189447879791,220.58948826789856,725.1078071594238,23836,3228,20608,20608,0,11,3363000.0
3363,3363999,21.39582628986358,37.53449063511764,0.06002306873924579,515.4086377620697,220.65532898902893,725.2509002685547,23838,3229,20609,20609,0,11,3364000.0
3364,3364999,21.394689486488918,37.53297064093463,0.060007846096781337,515.5279886722565,220.72188210487366,725.3626480102539,23839,3229,20610,20610,0,11,3365000.0
3365,3365999,21.394073170006347,37.53174138752267,0.059997647891502526,515.6677718162537,220.78761959075928,725.4396934509277,23839,3229,20610,20610,0,11,3366000.0
3366,3366999,21.395026409598973,37.53862131867373,0.05995313915407374,515.8049643039703,220.85779094696045,725.8169898986816,23849,3229,20620,20620,0,11,3367000.0
3367,3367999,21.397504972535096,37.54785457485251,0.05993153958576414,515.9952046871185,220.9252896308899,725.9959869384766,23851,3230,20621,20621,0,11,3368000.0
3368,3368999,21.40122270495755,37.55540128085779,0.05995584638330864,516.1778235435486,220.9916079044342,726.1399765014648,23855,3231,20624,20624,0,11,3369000.0
3369,3369999,21.40540240502664,37.56670968031931,0.05997804229882875,516.302708864212,221.05710196495056,726.478889465332,23861,3231,20630,20630,0,11,3370000.0
3370,3370999,21.41313993000811,37.58743326739184,0.059992620832408305,516.5333888530731,221.12279987335205,726.6702728271484,23884,3233,20651,20651,0,11,3371000.0
3371,3371999,21.42291351550046,37.61410589533125,0.060030150915514446,516.6549451351166,221.18921041488647,726.9055938720703,23885,3233,20652,20652,0,11,3372000.0
3372,3372999,21.43244490487843,37.640733008872544,0.06012616423118855,516.7874329090118,221.25469326972961,727.2141189575195,23890,3233,20657,20657,0,11,3373000.0
3373,3373999,21.44114722594008,37.66393484075226,0.06016359536415561,516.9081883430481,221.31934595108032,727.3556671142578,23890,3233,20657,20657,0,11,3374000.0
3374,3374999,21.449573228376302,37.681967632407556,0.06029792236422882,517.0331165790558,221.38340973854065,727.4523773193359,23890,3233,20657,20657,0,11,3375000.0
3375,3375999,21.457373960988523,37.698160024170775,0.06039954475173315,517.1486999988556,221.4484724998474,727.8500823974609,23896,3233,20663,20663,0,11,3376000.0
3376,3376999,21.46013711187761,37.70500301333447,0.060444904464684535,517.3260414600372,221.5134699344635,728.1612548828125,23908,3234,20674,20674,0,11,3377000.0
3377,3377999,21.459098655764993,37.705414605255406,0.060422527996839004,517.5047814846039,221.57950353622437,728.4776992797852,23917,3235,20682,20682,0,11,3378000.0
3378,3378999,21.45834397370782,37.70664175436147,0.060393820383171315,517.626827955246,221.64536929130554,728.6551055908203,23917,3235,20682,20682,0,11,3379000.0
3379,3379999,21.459107505215346,37.71199081664228,0.060343066886264674,517.8114264011383,221.7112114429474,728.7201156616211,23920,3236,20684,20684,0,11,3380000.0
3380,3380999,21.45992487462455,37.719643163384035,0.06028619731341789,517.9463441371918,221.7772138118744,728.8454895019531,23920,3236,20684,20684,0,11,3381000.0
3381,3381999,21.460545063769313,37.7208298978144,0.060241956762223436,518.0821373462677,221.84332609176636,729.2736015319824,23927,3236,20691,20691,0,11,3382000.0
3382,3382999,21.462150900956146,37.72402226398309,0.0601972927990122,518.2028353214264,221.9084792137146,729.4061737060547,23927,3236,20691,20691,0,11,3383000.0
3383,3383999,21.463419990147912,37.72569593511936,0.060166571875356234,518.4408433437347,221.9745454788208,729.6161117553711,23952,3238,20714,20714,0,11,3384000.0
3384,3384999,21.46430007267219,37.72745509823273,0.0601202578926926,518.5667283535004,222.04040837287903,729.8355026245117,23952,3238,20714,20714,0,11,3385000.0
3385,3385999,21.464654984937482,37.72841595900968,0.060079219447317644,518.6877641677856,222.10661482810974,729.9556732177734,23952,3238,20714,20714,0,11,3386000.0
3386,3386999,21.46588722088067,37.73036027130238,0.06005457282312465,518.878794670105,222.17238402366638,730.0281829833984,23954,3239,20715,20715,0,11,3387000.0
3387,3387999,21.46656361262808,37.730040555056014,0.060047715453393935,518.9941599369049,222.2379560470581,730.5987129211426,23968,3239,20729,20729,0,11,3388000.0
3388,3388999,21.46772337446875,37.731888122773704,0.06004801787466385,519.1681723594666,222.30437326431274,730.8018226623535,23970,3240,20730,20730,0,11,3389000.0
3389,3389999,21.468794658543196,37.73313362497522,0.06006989236954341,519.2868523597717,222.36919403076172,730.9650688171387,23970,3240,20730,20730,0,11,3390000.0
3390,3390999,21.469769774538932,37.733433222024374,0.06007347498586757,519.4071621894836,222.4352743625641,731.4279441833496,23981,3240,20741,20741,0,11,3391000.0
3391,3391999,21.471380987396664,37.737400519670466,0.06007253314587502,519.6495668888092,222.50296187400818,731.6284217834473,24004,3242,20762,20762,0,11,3392000.0
3392,3392999,21.4727785461485,37.7384330149716,0.06007583181962761,519.8277356624603,222.56911063194275,731.7708396911621,24006,3243,20763,20763,0,11,3393000.0
3393,3393999,21.473997961104246,37.73993544860595,0.060050619003174543,520.0698416233063,222.63565111160278,732.0963096618652,24019,3245,20774,20774,0,11,3394000.0
3394,3394999,21.47465909130764,37.739977300749906,0.06004146327258275,522.5962357521057,222.70200610160828,732.2081871032715,24030,3247,20783,20783,0,11,3395000.0
3395,3395999,21.475639670301568,37.73966511488366,0.06003374977986675,522.8403668403625,222.76758122444153,732.3098487854004,24037,3249,20788,20788,0,11,3396000.0
3396,3396999,21.47605362586607,37.74097646916712,0.06002444061631562,523.0236489772797,222.8337218761444,732.588924407959,24058,3250,20808,20808,0,11,3397000.0
3397,3397999,21.475397583289215,37.74366970639214,0.06000338384875237,523.1573843955994,222.89886116981506,732.940013885498,24068,3250,20818,20818,0,11,3398000.0
3398,3398999,21.47330533223086,37.743239360678096,0.059996239577381205,523.3444564342499,222.96495580673218,733.2155418395996,24079,3251,20828,20828,0,11,3399000.0
3399,3399999,21.470861334433575,37.73979269672515,0.059997573728376885,523.5295612812042,223.03290438652039,733.457347869873,24086,3252,20834,20834,0,11,3400000.0
3400,3400999,21.468404111282954,37.73715978258782,0.05999807286478265,523.6566903591156,223.09911584854126,733.5926246643066,24086,3252,20834,20834,0,11,3401000.0
3401,3401999,21.465941559939857,37.73373609957272,0.06000343372775829,523.8447108268738,223.1658697128296,733.6746788024902,24089,3253,20836,20836,0,11,3402000.0
3402,3402999,21.463957610434047,37.7318379584747,0.05999456193648578,523.9706177711487,223.23276948928833,733.8890037536621,24091,3253,20838,20838,0,11,3403000.0
3403,3403999,21.461978630482758,37.728328899441586,0.05999091935737455,524.2238705158234,223.2989640235901,733.9519233703613,24096,3255,20841,20841,0,11,3404000.0
3404,3404999,21.45999985142854,37.724773693265846,0.059986889394062826,524.4323160648346,223.36504006385803,734.022834777832,24101,3256,20845,20845,0,11,3405000.0
3405,3405999,21.458015885706935,37.720928323726774,0.05998047559491726,524.6224782466888,223.43138313293457,734.2676620483398,24106,3257,20849,20849,0,11,3406000.0
3406,3406999,21.45732440383675,37.719957144763,0.05995649661910696,524.8109192848206,223.4974365234375,734.3426742553711,24108,3258,20850,20850,0,11,3407000.0
3407,3407999,21.45635717758486,37.71745710047952,0.05994448276011288,524.9477372169495,223.56346583366394,734.4564666748047,24109,3258,20851,20851,0,11,3408000.0
3408,3408999,21.455706767486134,37.71531929016651,0.05991963676361167,525.0700101852417,223.62944841384888,734.7880554199219,24113,3258,20855,20855,0,11,3409000.0
3409,3409999,21.456101233741045,37.71635033425862,0.05988091704681242,525.3092362880707,223.69530081748962,734.9870948791504,24117,3260,20857,20857,0,11,3410000.0
3410,3410999,21.455650131279686,37.714899970624955,0.05985737957175641,525.4365086555481,223.76092100143433,735.1391983032227,24117,3260,20857,20857,0,11,3411000.0
3411,3411999,21.456093149291583,37.71476556621889,0.059841221076431195,525.6875777244568,223.82746648788452,735.4513893127441,24130,3262,20868,20868,0,11,3412000.0
3412,3412999,21.457360008275394,37.720368656540835,0.05982695200626542,525.8686611652374,223.8932387828827,735.6504898071289,24133,3263,20870,20870,0,11,3413000.0
3413,3413999,21.459228848427877,37.72387562204698,0.05992036667833234,526.0501239299774,223.9591419696808,735.7439956665039,24135,3264,20871,20871,0,11,3414000.0
3414,3414999,21.462611825068702,37.735168287147076,0.05992335099042667,526.1875548362732,224.02507543563843,736.0022277832031,24139,3264,20875,20875,0,11,3415000.0
3415,3415999,21.46599724692117,37.74273456002909,0.05993263529297799,526.3167879581451,224.09007287025452,736.1175498962402,24139,3264,20875,20875,0,11,3416000.0
3416,3416999,21.469653807368164,37.751496557066694,0.059949554788148895,526.5043761730194,224.15490627288818,736.1453628540039,24143,3265,20878,20878,0,11,3417000.0
3417,3417999,21.473366669849288,37.75965142732029,0.05995863116272249,526.6948049068451,224.22040915489197,736.4130668640137,24149,3266,20883,20883,0,11,3418000.0
3418,3418999,21.47478276301742,37.76211543200045,0.059948966501338075,526.8149683475494,224.2847707271576,736.6101989746094,24152,3266,20886,20886,0,11,3419000.0
3419,3419999,21.473136449241903,37.76280743740131,0.059853087187171417,527.0000505447388,224.3500952720642,736.8389511108398,24161,3267,20894,20894,0,11,3420000.0
3420,3420999,21.47103425323552,37.76181908594582,0.05985132567073226,527.183833360672,224.41642713546753,737.1108818054199,24165,3268,20897,20897,0,11,3421000.0
3421,3421999,21.469219982056448,37.76059854531031,0.059844274055579905,527.3100292682648,224.48268127441406,737.2597045898438,24165,3268,20897,20897,0,11,3422000.0
3422,3422999,21.467040291602764,37.75772546345863,0.059842408319778606,527.4968390464783,224.54926919937134,737.3233833312988,24167,3269,20898,20898,0,11,3423000.0
3423,3423999,21.4649748431187,37.75474584225512,0.05983569820038426,527.6215648651123,224.6153757572174,737.6384887695312,24171,3269,20902,20902,0,11,3424000.0
3424,3424999,21.46317125427996,37.75167978593389,0.059828533284858265,527.8618321418762,224.68089747428894,737.8228340148926,24182,3271,20911,20911,0,11,3425000.0
3425,3425999,21.461249717915532,37.74874256411331,0.059820780378168736,528.0420966148376,224.74672746658325,737.9962158203125,24187,3272,20915,20915,0,11,3426000.0
3426,3426999,21.45998148493897,37.74710771584298,0.05980101707427621,528.2328972816467,224.81471180915833,738.2273902893066,24192,3273,20919,20919,0,11,3427000.0
3427,3427999,21.45871653973534,37.7444124899643,0.05979336363198362,528.4152987003326,224.8808832168579,738.3553886413574,24197,3274,20923,20923,0,11,3428000.0
3428,3428999,21.457799914094522,37.74603906944332,0.05978160978661751,528.7195618152618,224.94775652885437,738.3840789794922,24211,3277,20934,20934,0,11,3429000.0
3429,3429999,21.457276230145165,37.744651711580744,0.05976776297424624,528.8446774482727,225.01459574699402,738.9885482788086,24229,3277,20952,20952,0,11,3430000.0
3430,3430999,21.456701676971477,37.74277440499642,0.05975523174617148,528.9698717594147,225.08165073394775,739.2985572814941,24229,3277,20952,20952,0,11,3431000.0
3431,3431999,21.45669506389064,37.742344843855776,0.05975185549918316,529.1620447635651,225.1480827331543,739.4569358825684,24247,3278,20969,20969,0,11,3432000.0
3432,3432999,21.457792126437905,37.745409512685754,0.05974550921422428,529.2808842658997,225.21588134765625,739.8766746520996,24257,3278,20979,20979,0,11,3433000.0
3433,3433999,21.459025898992188,37.747909052684165,0.05974208488346833,529.3972074985504,225.28159928321838,740.183521270752,24259,3278,20981,20981,0,11,3434000.0
3434,3434999,21.460409341936717,37.748759227916686,0.05975441181074215,529.5778939723969,225.34733057022095,740.2874717712402,24267,3279,20988,20988,0,11,3435000.0
3435,3435999,21.462036011343173,37.74971524995759,0.0597449125840358,529.7012977600098,225.4147412776947,740.6651802062988,24275,3279,20996,20996,0,11,3436000.0
3436,3436999,21.4641520278457,37.751526644341304,0.059745327397970116,529.8253734111786,225.4798662662506,740.8514862060547,24275,3279,20996,20996,0,11,3437000.0
3437,3437999,21.466249413042227,37.75573455084653,0.05974091872992482,529.9589309692383,225.54505610466003,740.9817771911621,24275,3279,20996,20996,0,11,3438000.0
3438,3438999,21.467927335150222,37.75609546574852,0.05974903037484658,530.0762541294098,225.61035585403442,741.2721176147461,24279,3279,21000,21000,0,11,3439000.0
3439,3439999,21.4683738107797,37.75476694108203,0.05974233612119917,530.3647177219391,225.67577743530273,741.3302040100098,24304,3282,21022,21022,0,11,3440000.0
3440,3440999,21.466210767749427,37.75181417259642,0.0597456206719813,530.4867851734161,225.7409040927887,741.9136810302734,24324,3282,21042,21042,0,11,3441000.0
3441,3441999,21.46349704567983,37.74808666325276,0.059759726155580006,530.6652700901031,225.80752110481262,742.2439842224121,24332,3283,21049,21049,0,11,3442000.0
3442,3442999,21.46079139588224,37.74437032595821,0.05977589257755467,530.9006175994873,225.87382006645203,742.3945808410645,24342,3285,21057,21057,0,11,3443000.0
3443,3443999,21.45807209815772,37.740663379679646,0.059788792133719904,531.022783279419,225.93989753723145,742.5464286804199,24342,3285,21057,21057,0,11,3444000.0
3444,3444999,21.455767371344105,37.73799662363371,0.05979193476993838,531.2672007083893,226.00629043579102,742.8777236938477,24358,3287,21071,21071,0,11,3445000.0
3445,3445999,21.453718846224646,37.73604991059598,0.05978992305873565,531.3909869194031,226.07128024101257,743.0930366516113,24359,3287,21072,21072,0,11,3446000.0
3446,3446999,21.451661824587198,37.73306565078402,0.05978711285106997,531.5224072933197,226.13662791252136,743.3217277526855,24362,3287,21075,21075,0,11,3447000.0
3447,3447999,21.449576823004907,37.73229949335606,0.05978030235680132,531.7114205360413,226.20316910743713,743.4032783508301,24365,3288,21077,21077,0,11,3448000.0
3448,3448999,21.44797637819466,37.73400712904406,0.05976447694094933,531.8327214717865,226.26871848106384,743.5052719116211,24365,3288,21077,21077,0,11,3449000.0
3449,3449999,21.446413080680383,37.732614136551284,0.05976001091785976,532.139240026474,226.33468103408813,743.4529800415039,24380,3291,21089,21089,0,11,3450000.0
3450,3450999,21.445817009616082,37.736468894505364,0.05970077987520872,532.2613589763641,226.40190839767456,744.1976661682129,24399,3291,21108,21108,0,11,3451000.0
3451,3451999,21.444618965088498,37.73403335682059,0.0596888323087863,532.3860218524933,226.46713137626648,744.4554252624512,24399,3291,21108,21108,0,11,3452000.0
3452,3452999,21.44341426271217,37.7318360014185,0.059681720415214135,532.514212846756,226.5332989692688,744.6705551147461,24400,3291,21109,21109,0,11,3453000.0
3453,3453999,21.44300011900733,37.73019884866938,0.05964856586197076,532.6327662467957,226.5999414920807,745.16552734375,24410,3291,21119,21119,0,11,3454000.0
3454,3454999,21.44195533698043,37.727466095331394,0.05964035940827839,532.8648772239685,226.66564989089966,745.2735710144043,24418,3293,21125,21125,0,11,3455000.0
3455,3455999,21.441131417404872,37.72461767502553,0.059624972640182405,533.0444786548615,226.7312798500061,745.6827354431152,24444,3294,21150,21150,0,11,3456000.0
3456,3456999,21.440311463679343,37.722103845954905,0.059612682374066694,533.1659436225891,226.79624319076538,745.9328727722168,24444,3294,21150,21150,0,11,3457000.0
3457,3457999,21.43968146499615,37.719301218208415,0.059602627822718635,533.2887234687805,226.86116695404053,746.1778411865234,24447,3294,21153,21153,0,11,3458000.0
3458,3458999,21.438416809329933,37.71640166031698,0.05959848327114414,533.5273163318634,226.9275197982788,746.3661804199219,24453,3296,21157,21157,0,11,3459000.0
3459,3459999,21.436141499759444,37.71397816484672,0.059603982081746776,533.7091822624207,226.99351334571838,746.9509506225586,24478,3297,21181,21181,0,11,3460000.0
3460,3460999,21.434158607172584,37.714644019694944,0.05959987053522808,533.9481761455536,227.05989170074463,747.0853805541992,24485,3299,21186,21186,0,11,3461000.0
3461,3461999,21.431902438462572,37.71155318458818,0.05961707707577801,534.183141708374,227.125994682312,747.1673622131348,24492,3301,21191,21191,0,11,3462000.0
3462,3462999,21.429487039786455,37.70786424673194,0.05962693861418289,534.3176965713501,227.19239902496338,747.3803100585938,24494,3301,21193,21193,0,11,3463000.0
3463,3463999,21.42783005416898,37.70666070231994,0.05962959573657611,534.4439914226532,227.25709199905396,747.640983581543,24497,3301,21196,21196,0,11,3464000.0
3464,3464999,21.425742663544295,37.703893835890874,0.05963534120769476,534.6837089061737,227.32211017608643,747.7112007141113,24514,3303,21211,21211,0,11,3465000.0
3465,3465999,21.423856836507223,37.70133954792653,0.05963195448438441,534.7991192340851,227.38812637329102,747.9317665100098,24516,3303,21213,21213,0,11,3466000.0
3466,3466999,21.422517837958384,37.69877560193365,0.05962439779224871,534.919712305069,227.45305037498474,748.0354118347168,24516,3303,21213,21213,0,11,3467000.0
3467,3467999,21.421191644711502,37.69602697531428,0.0596241184199543,535.2825174331665,227.5196132659912,747.9979248046875,24533,3307,21226,21226,0,11,3468000.0
3468,3468999,21.4198745578876,37.693522710965176,0.059611763143727625,535.462509393692,227.58599996566772,748.4266891479492,24547,3308,21239,21239,0,11,3469000.0
3469,3469999,21.419320637157547,37.696018589282474,0.05957544294848738,535.7018547058105,227.65173649787903,748.6215705871582,24551,3310,21241,21241,0,11,3470000.0
3470,3470999,21.418800164077368,37.695929036120454,0.0595517690357622,535.8247609138489,227.71713829040527,748.8569793701172,24551,3310,21241,21241,0,11,3471000.0
3471,3471999,21.418013438558237,37.69427892409685,0.05954202900630112,535.9475438594818,227.78230571746826,749.0498390197754,24553,3310,21243,21243,0,11,3472000.0
3472,3472999,21.418162147013895,37.69299524823842,0.05949328898082262,536.1220955848694,227.8487410545349,749.4531898498535,24562,3311,21251,21251,0,11,3473000.0
3473,3473999,21.417983842776597,37.69164349520916,0.05946545092257571,536.3012566566467,227.91415810585022,749.613452911377,24564,3312,21252,21252,0,11,3474000.0
3474,3474999,21.418428301702395,37.69108750089082,0.05942738070701181,536.4870357513428,227.9813015460968,749.8464241027832,24572,3313,21259,21259,0,11,3475000.0
3475,3475999,21.419114182561405,37.69101648257685,0.05940079353975358,536.6725332736969,228.04634046554565,749.9620704650879,24574,3314,21260,21260,0,11,3476000.0
3476,3476999,21.419503490422716,37.689950668559824,0.05938292080452068,536.794709444046,228.11080646514893,750.1107330322266,24574,3314,21260,21260,0,11,3477000.0
3477,3477999,21.420002572691228,37.68890777908559,0.059367620369343954,537.0921216011047,228.17601227760315,750.2674942016602,24604,3317,21287,21287,0,11,3478000.0
3478,3478999,21.41961671140689,37.68692342106826,0.05935092640677608,537.2698504924774,228.2401828765869,750.4073944091797,24609,3318,21291,21291,0,11,3479000.0
3479,3479999,21.417908410148286,37.68414629062584,0.059350570769976185,537.5759012699127,228.305894613266,750.7995948791504,24645,3321,21324,21324,0,11,3480000.0
3480,3480999,21.41511503862048,37.680275028220876,0.059361294855658886,537.7044138908386,228.3727469444275,751.2014312744141,24649,3321,21328,21328,0,11,3481000.0
3481,3481999,21.412654236613527,37.677086752831336,0.05936923798822702,537.8846652507782,228.4389877319336,751.3812217712402,24651,3322,21329,21329,0,11,3482000.0
3482,3482999,21.410938978504955,37.675162525438346,0.059366944315106585,538.0130248069763,228.50528120994568,751.5750961303711,24651,3322,21329,21329,0,11,3483000.0
3483,3483999,21.408921541832385,37.67411196433358,0.05935802925818012,538.1470172405243,228.571839094162,751.6891632080078,24651,3322,21329,21329,0,11,3484000.0
3484,3484999,21.407559242473656,37.67303845901671,0.05934305726201261,538.3261678218842,228.63746786117554,752.0008544921875,24658,3323,21335,21335,0,11,3485000.0
3485,3485999,21.40648850031929,37.670850887468816,0.05933575552669679,538.4461395740509,228.70245337486267,752.1908912658691,24658,3323,21335,21335,0,11,3486000.0
3486,3486999,21.406345422404982,37.67096288047498,0.059326296103455856,538.6295936107635,228.76794576644897,752.4695510864258,24666,3324,21342,21342,0,11,3487000.0
3487,3487999,21.40699448810524,37.67169973532763,0.059325989647533106,538.805093050003,228.8337321281433,752.661922454834,24670,3325,21345,21345,0,11,3488000.0
3488,3488999,21.40866078403587,37.67473747169081,0.05934593352365147,539.038414478302,228.90054512023926,752.7557525634766,24674,3327,21347,21347,0,11,3489000.0
3489,3489999,21.41158233285073,37.681114551363805,0.05935579830396176,539.22514128685,228.96701955795288,752.961784362793,24686,3328,21358,21358,0,11,3490000.0
3490,3490999,21.41553901175113,37.68785039953255,0.05937323423969332,539.4617261886597,229.03263902664185,753.2944641113281,24709,3330,21379,21379,0,11,3491000.0
3491,3491999,21.420283761347388,37.69553596156904,0.05946516124781176,539.7033998966217,229.0986032485962,753.4636650085449,24713,3332,21381,21381,0,11,3492000.0
3492,3492999,21.425642708559824,37.70301998080103,0.05961787241708727,539.8887193202972,229.16432905197144,753.569206237793,24715,3333,21382,21382,0,11,3493000.0
3493,3493999,21.431478898765995,37.711379076975575,0.059696565670073864,540.0020005702972,229.23080849647522,754.1099166870117,24725,3333,21392,21392,0,11,3494000.0
3494,3494999,21.438509945593733,37.72370828829344,0.05987731071045421,540.1204349994659,229.29598903656006,754.3022804260254,24725,3333,21392,21392,0,11,3495000.0
3495,3495999,21.446280479258288,37.73794448462707,0.060046613239278734,540.3044214248657,229.36246967315674,754.6042022705078,24734,3334,21400,21400,0,11,3496000.0
3496,3496999,21.4536269590772,37.75281469456717,0.0600954988364788,540.482914686203,229.42848229408264,754.7852020263672,24740,3335,21405,21405,0,11,3497000.0
3497,3497999,21.459093657131685,37.76374232516599,0.060167551366301364,540.6659317016602,229.49336409568787,754.8838386535645,24746,3336,21410,21410,0,11,3498000.0
3498,3498999,21.466339454410317,37.775972792568226,0.06023056842353236,540.7840528488159,229.55813598632812,755.2391624450684,24753,3336,21417,21417,0,11,3499000.0
3499,3499999,21.47131548144624,37.78478853509884,0.060385273883452495,540.8992009162903,229.62222170829773,755.5019149780273,24754,3336,21418,21418,0,11,3500000.0
3500,3500999,21.469870055350214,37.78281225602727,0.06037727074254162,541.0391752719879,229.69570016860962,756.0327377319336,24774,3336,21438,21438,0,11,3501000.0
3501,3501999,21.468041333279093,37.78107922660431,0.06036878022232506,541.163330078125,229.7615966796875,756.4165267944336,24778,3336,21442,21442,0,11,3502000.0
3502,3502999,21.46684253533053,37.780410474724206,0.0603564413752995,541.3504323959351,229.8281602859497,756.5772247314453,24780,3337,21443,21443,0,11,3503000.0
3503,3503999,21.465741248229946,37.779449622336074,0.06033818329110352,541.4784903526306,229.89433097839355,756.7549667358398,24780,3337,21443,21443,0,11,3504000.0
3504,3504999,21.46427518078948,37.77787650045556,0.060326588198663655,541.5987229347229,229.95999670028687,757.0492630004883,24784,3337,21447,21447,0,11,3505000.0
3505,3505999,21.463239478636098,37.77556243277905,0.06034025747359195,541.8386940956116,230.02529668807983,757.1520919799805,24788,3339,21449,21449,0,11,3506000.0
3506,3506999,21.462427711363176,37.77690069040609,0.06031474289360006,542.0689096450806,230.0907974243164,757.2516250610352,24795,3341,21454,21454,0,11,3507000.0
3507,3507999,21.461922116411063,37.776746820607165,0.06029977667733977,542.3064074516296,230.15695762634277,757.6447792053223,24825,3343,21482,21482,0,11,3508000.0
3508,3508999,21.461623624803327,37.77601395500459,0.06029192586051568,542.5463914871216,230.22377061843872,757.8537902832031,24830,3345,21485,21485,0,11,3509000.0
3509,3509999,21.46360595829446,37.78312032820722,0.060302538686116236,542.7829298973083,230.29015469551086,758.0256462097168,24838,3347,21491,21491,0,11,3510000.0
3510,3510999,21.467292873627503,37.793209331489145,0.06037927001859633,542.965569972992,230.35780596733093,758.5038108825684,24852,3348,21504,21504,0,11,3511000.0
3511,3511999,21.472791449556357,37.810768585782746,0.06057202207229628,543.0844111442566,230.42293047904968,758.8506546020508,24855,3348,21507,21507,0,11,3512000.0
3512,3512999,21.47781983700753,37.8231374899386,0.06065649892395664,543.2092597484589,230.48867964744568,759.0476570129395,24855,3348,21507,21507,0,11,3513000.0
3513,3513999,21.484153441874618,37.839616119432364,0.060704322293874347,543.4421725273132,230.55510902404785,759.3367958068848,24895,3350,21545,21545,0,11,3514000.0
3514,3514999,21.489477321919118,37.857600472285405,0.06085185282715044,543.6853120326996,230.62122559547424,759.4928207397461,24899,3352,21547,21547,0,11,3515000.0
3515,3515999,21.49396197151226,37.8660929108834,0.060974785934601705,543.8031458854675,230.68654799461365,759.6611251831055,24899,3352,21547,21547,0,11,3516000.0
3516,3516999,21.499869860538055,37.878231245493886,0.061035052451961835,544.1617019176483,230.75285267829895,759.9633522033691,24927,3356,21571,21571,0,11,3517000.0
3517,3517999,21.504956057586163,37.888410332985636,0.06112653290193881,544.4071612358093,230.8184106349945,760.1235542297363,24933,3358,21575,21575,0,11,3518000.0
3518,3518999,21.509390286959302,37.89518174320903,0.06121697115332769,544.5978908538818,230.88917231559753,760.3855361938477,24941,3359,21582,21582,0,11,3519000.0
3519,3519999,21.512153545469662,37.89916231491672,0.06124198411488002,544.7247204780579,230.95514678955078,760.6269340515137,24941,3359,21582,21582,0,11,3520000.0
3520,3520999,21.511340475401873,37.898789539014444,0.06121844039499358,545.0155882835388,231.02052116394043,760.9151763916016,24965,3362,21603,21603,0,11,3521000.0
3521,3521999,21.510073508227293,37.89845309308292,0.0611830407196714,545.2016892433167,231.08801317214966,761.2023620605469,24973,3363,21610,21610,0,11,3522000.0
3522,3522999,21.50875732364723,37.89868968701294,0.061170712804290095,545.3811483383179,231.154301404953,761.3808364868164,24981,3364,21617,21617,0,11,3523000.0
3523,3523999,21.5083239809796,37.90173755680287,0.06113996886892026,545.624340057373,231.2209951877594,761.4915008544922,24988,3366,21622,21622,0,11,3524000.0
3524,3524999,21.507279385651163,37.90032780866101,0.061125545245614976,545.754029750824,231.28756833076477,761.7596206665039,24994,3366,21628,21628,0,11,3525000.0
3525,3525999,21.50670217738901,37.89990708011952,0.061107162024401473,546.0111498832703,231.353901386261,761.8951148986816,25000,3368,21632,21632,0,11,3526000.0
3526,3526999,21.505736355415163,37.89808467055196,0.06109081174327258,546.124716758728,231.42003893852234,762.0737724304199,25000,3368,21632,21632,0,11,3527000.0
3527,3527999,21.50504399200375,37.897034620900314,0.06108392761659742,546.3091382980347,231.48583555221558,762.3222846984863,25007,3369,21638,21638,0,11,3528000.0
3528,3528999,21.50535928453322,37.89936073848483,0.06105577638508097,546.4385008811951,231.55130910873413,762.4897193908691,25007,3369,21638,21638,0,11,3529000.0
3529,3529999,21.507898509797513,37.90875593322284,0.06103124913388125,546.6225688457489,231.6168553829193,762.5410461425781,25009,3370,21639,21639,0,11,3530000.0
3530,3530999,21.511188256030966,37.91683602861982,0.06104920367884792,546.7523300647736,231.68399953842163,763.0229339599609,25023,3370,21653,21653,0,11,3531000.0
3531,3531999,21.516882228453923,37.93243127484938,0.061103699088498664,546.9246342182159,231.74918484687805,763.3073348999023,25025,3371,21654,21654,0,11,3532000.0
3532,3532999,21.52387837081557,37.94930296661383,0.06120744791757193,547.1066675186157,231.81479668617249,763.492259979248,25027,3372,21655,21655,0,11,3533000.0
3533,3533999,21.531705071241458,37.97134849840568,0.061395068659241714,547.2356188297272,231.88109588623047,763.9533004760742,25037,3372,21665,21665,0,11,3534000.0
3534,3534999,21.54226651040782,38.003118946667705,0.0615205612641927,547.4178247451782,231.94783544540405,764.2112503051758,25044,3373,21671,21671,0,11,3535000.0
3535,3535999,21.554393157263473,38.04237065512987,0.061777588002944195,547.5467691421509,232.01320004463196,764.3908386230469,25044,3373,21671,21671,0,11,3536000.0
3536,3536999,21.567056518506956,38.08391889302326,0.0617623495569356,547.7926115989685,232.08132410049438,764.763916015625,25057,3375,21682,21682,0,11,3537000.0
3537,3537999,21.57962807663925,38.12035531499146,0.0618889048604806,547.936173915863,232.15485310554504,764.933723449707,25057,3375,21682,21682,0,11,3538000.0
3538,3538999,21.593588269067766,38.1584682454467,0.06200065251699871,548.0638966560364,232.2201554775238,765.2971954345703,25063,3375,21688,21688,0,11,3539000.0
3539,3539999,21.600407135425474,38.17277369295797,0.06203062244582691,548.3585660457611,232.28505492210388,765.5268630981445,25095,3378,21717,21717,0,11,3540000.0
3540,3540999,21.599100038054747,38.173523083401356,0.06196033749323726,548.542254447937,232.35028457641602,765.8688201904297,25107,3379,21728,21728,0,11,3541000.0
3541,3541999,21.598198558152102,38.177399749054246,0.061928972591301035,548.7251670360565,232.41661071777344,766.1492156982422,25112,3380,21732,21732,0,11,3542000.0
3542,3542999,21.598046811870564,38.18056583361018,0.061883265944792765,548.9130280017853,232.48363709449768,766.3307609558105,25114,3381,21733,21733,0,11,3543000.0
3543,3543999,21.59798241784512,38.18268135541514,0.061849695921548764,549.1012105941772,232.55081820487976,766.4336051940918,25116,3382,21734,21734,0,11,3544000.0
3544,3544999,21.598392655965995,38.18613734010535,0.061804531445326605,549.2319490909576,232.61625337600708,766.7199859619141,25121,3382,21739,21739,0,11,3545000.0
3545,3545999,21.598084643300233,38.185436068076065,0.0617846779279555,549.4230356216431,232.6818287372589,766.860969543457,25123,3383,21740,21740,0,11,3546000.0
3546,3546999,21.598495647455852,38.187149093445555,0.06176186608995127,549.5714240074158,232.75388169288635,767.0788116455078,25126,3383,21743,21743,0,11,3547000.0
3547,3547999,21.598955286704932,38.18861925696676,0.06173285273702944,549.7593214511871,232.8196358680725,767.1891212463379,25128,3384,21744,21744,0,11,3548000.0
3548,3548999,21.6005455683741,38.19266209226032,0.06169041303398748,549.8861420154572,232.88472294807434,767.2783889770508,25128,3384,21744,21744,0,11,3549000.0
3549,3549999,21.602709547154998,38.19614165809756,0.061666463581816267,550.0277950763702,232.95030808448792,767.3740386962891,25128,3384,21744,21744,0,11,3550000.0
3550,3550999,21.605650594571582,38.20381212477306,0.06166296277017613,550.1424171924591,233.01465439796448,767.6653480529785,25131,3384,21747,21747,0,11,3551000.0
3551,3551999,21.610139979154084,38.213043502199376,0.06168819477122889,550.268805027008,233.07871413230896,767.7806549072266,25131,3384,21747,21747,0,11,3552000.0
3552,3552999,21.614874293601826,38.22129567350313,0.06174182371449344,550.5624899864197,233.14458894729614,767.8067741394043,25154,3387,21767,21767,0,11,3553000.0
3553,3553999,21.62036116724538,38.23181218472308,0.061776354713611537,550.7477569580078,233.2100851535797,768.1673736572266,25167,3388,21779,21779,0,11,3554000.0
3554,3554999,21.62640394326125,38.24880883790097,0.0618373001197805,550.9912362098694,233.27617716789246,768.2749366760254,25171,3390,21781,21781,0,11,3555000.0
3555,3555999,21.63461854993775,38.26773972689704,0.06188500677509823,551.191602230072,233.34198427200317,768.4913864135742,25181,3391,21790,21790,0,11,3556000.0
3556,3556999,21.64276517478807,38.28997520162031,0.06189868979967528,551.3133244514465,233.4070405960083,768.7304267883301,25182,3391,21791,21791,0,11,3557000.0
3557,3557999,21.64961942571552,38.305242695659956,0.06198169535251863,551.4293041229248,233.47142577171326,768.8520698547363,25182,3391,21791,21791,0,11,3558000.0
3558,3558999,21.660274299901296,38.33358198216321,0.062054588303604885,551.56729388237,233.5417082309723,769.1538314819336,25186,3391,21795,21795,0,11,3559000.0
3559,3559999,21.668193292311507,38.3497700587498,0.062098677933626445,551.6857419013977,233.60671949386597,769.4160270690918,25188,3391,21797,21797,0,11,3560000.0
3560,3560999,21.66718403561459,38.350411019970025,0.06207644948821822,551.8063297271729,233.67276859283447,769.7341613769531,25196,3391,21805,21805,0,11,3561000.0
3561,3561999,21.665484603390524,38.35084706736312,0.06205298583576979,551.9889245033264,233.73856234550476,769.9389305114746,25199,3392,21807,21807,0,11,3562000.0
3562,3562999,21.664258252591328,38.35115529294125,0.06202814671109813,552.1169140338898,233.80557799339294,770.121955871582,25199,3392,21807,21807,0,11,3563000.0
3563,3563999,21.66356523255763,38.35830586965384,0.061981067559420566,552.303642988205,233.87117171287537,770.1641426086426,25201,3393,21808,21808,0,11,3564000.0
3564,3564999,21.662060446271383,38.35673815286159,0.061969963985796794,552.4319519996643,233.93668627738953,770.4043502807617,25204,3393,21811,21811,0,11,3565000.0
3565,3565999,21.66115447576094,38.35538338448909,0.061952338484029035,552.6153435707092,234.00078511238098,770.5247344970703,25206,3394,21812,21812,0,11,3566000.0
3566,3566999,21.659897007269564,38.35495039997934,0.06192971944452652,552.7581100463867,234.07454371452332,770.6371383666992,25206,3394,21812,21812,0,11,3567000.0
3567,3567999,21.659242073280268,38.35309045131278,0.061914183604045214,552.9339172840118,234.14093494415283,770.8565368652344,25210,3395,21815,21815,0,11,3568000.0
3568,3568999,21.65843458406301,38.35130535081722,0.061897518919231564,553.0739905834198,234.2062771320343,770.9701118469238,25210,3395,21815,21815,0,11,3569000.0
3569,3569999,21.65868271087729,38.353575565254005,0.0618699627074446,553.2064690589905,234.27139234542847,771.0932121276855,25210,3395,21815,21815,0,11,3570000.0
3570,3570999,21.658728097600967,38.352809396418486,0.06185018519362917,553.441972732544,234.33753943443298,771.507396697998,25232,3397,21835,21835,0,11,3571000.0
3571,3571999,21.6587961700079,38.35188634868981,0.06184183939824639,553.5620396137238,234.40248918533325,771.819149017334,25232,3397,21835,21835,0,11,3572000.0
3572,3572999,21.660207824353847,38.35559534523387,0.06183649037421968,553.6806724071503,234.46720027923584,772.0262756347656,25232,3397,21835,21835,0,11,3573000.0
3573,3573999,21.662083892643377,38.3603285631275,0.06185257991252624,553.7977342605591,234.53272128105164,772.3824043273926,25240,3397,21843,21843,0,11,3574000.0
3574,3574999,21.66440852937178,38.36390255743801,0.06185561363176528,553.9935357570648,234.59883975982666,772.6912422180176,25249,3398,21851,21851,0,11,3575000.0
3575,3575999,21.66703691143867,38.36631605183233,0.061882947339983785,554.1778643131256,234.66398882865906,772.8119697570801,25269,3399,21870,21870,0,11,3576000.0
3576,3576999,21.67079900737797,38.3750530900067,0.06188198140145684,554.478917837143,234.73074316978455,772.9643440246582,25280,3402,21878,21878,0,11,3577000.0
3577,3577999,21.67538131050144,38.381632093163816,0.061887014293380505,554.6022198200226,234.79510307312012,773.1584663391113,25280,3402,21878,21878,0,11,3578000.0
3578,3578999,21.678640082005348,38.38541431010897,0.06190442216160408,554.7192175388336,234.85902643203735,773.2717895507812,25280,3402,21878,21878,0,11,3579000.0
3579,3579999,21.68309936939323,38.39189284541199,0.0619200899873289,554.903284072876,234.92404890060425,773.461971282959,25285,3403,21882,21882,0,11,3580000.0
3580,3580999,21.685691532731,38.398025175646325,0.06191561142261959,555.0762665271759,234.98804926872253,773.6015014648438,25296,3404,21892,21892,0,11,3581000.0
3581,3581999,21.684379163699752,38.39574851780949,0.06190552184536913,555.1995952129364,235.05279684066772,774.0271034240723,25310,3404,21906,21906,0,11,3582000.0
3582,3582999,21.68224261186628,38.392949623115676,0.06191026475264527,555.3271088600159,235.11895608901978,774.3030586242676,25313,3404,21909,21909,0,11,3583000.0
3583,3583999,21.680221771120987,38.39078817708063,0.06191925254474362,555.4480013847351,235.18474340438843,774.4567565917969,25314,3404,21910,21910,0,11,3584000.0
3584,3584999,21.678353999497332,38.3879286810085,0.061916563271599,555.5748801231384,235.25063395500183,774.6063079833984,25315,3404,21911,21911,0,11,3585000.0
3585,3585999,21.67705157687447,38.387215424434245,0.06190282640020894,555.7014594078064,235.31653451919556,774.981632232666,25326,3404,21922,21922,0,11,3586000.0
3586,3586999,21.675864231461063,38.38546300409738,0.061892371325094286,555.8346049785614,235.3812117576599,775.1604766845703,25327,3404,21923,21923,0,11,3587000.0
3587,3587999,21.674341167056923,38.383217740797406,0.0618839623662325,555.9565992355347,235.44670367240906,775.3575553894043,25329,3404,21925,21925,0,11,3588000.0
3588,3588999,21.673585086158056,38.38280466023445,0.061864465933375024,556.2603034973145,235.51293540000916,775.5232925415039,25368,3407,21961,21961,0,11,3589000.0
3589,3589999,21.672950685450832,38.38124539344816,0.06185090696513795,556.4580655097961,235.57894897460938,775.7198524475098,25379,3408,21971,21971,0,11,3590000.0
3590,3590999,21.672904927322282,38.38470458180145,0.061833109864621094,556.7059433460236,235.64492630958557,775.8034973144531,25383,3410,21973,21973,0,11,3591000.0
3591,3591999,21.673768023924215,38.38535853969465,0.0618129788678079,556.830157995224,235.713134765625,776.4986457824707,25402,3410,21992,21992,0,11,3592000.0
3592,3592999,21.674619059901065,38.38564650606592,0.061814175508482117,556.9572269916534,235.77904510498047,776.7411918640137,25402,3410,21992,21992,0,11,3593000.0
3593,3593999,21.675713303236066,38.38619285313696,0.06184929194595301,557.0799329280853,235.8446671962738,776.9296379089355,25402,3410,21992,21992,0,11,3594000.0
3594,3594999,21.676926402021465,38.38982410064806,0.06181287531473567,557.2671394348145,235.9106867313385,777.3502006530762,25414,3411,22003,22003,0,11,3595000.0
3595,3595999,21.678981354979655,38.39650811565608,0.06183091039509192,557.3939301967621,235.97661232948303,777.5392379760742,25414,3411,22003,22003,0,11,3596000.0
3596,3596999,21.68065839040645,38.40039277454984,0.06184199051593964,557.516937494278,236.04149198532104,777.7369537353516,25416,3411,22005,22005,0,11,3597000.0
3597,3597999,21.681749122525034,38.401446879348576,0.0618458491607633,557.8213098049164,236.107075214386,777.7988319396973,25438,3414,22024,22024,0,11,3598000.0
3598,3598999,21.68313228766442,38.40320421376086,0.06184908828563673,557.9449424743652,236.17164087295532,777.9869728088379,25440,3414,22026,22026,0,11,3599000.0
3599,3599999,21.685751589302722,38.40693605881356,0.06183327749254408,558.0606374740601,236.23620176315308,778.2623062133789,25443,3414,22029,22029,0,11,3600000.0
3600,3600999,21.683970587894464,38.40498759380682,0.06183645375469504,558.2408034801483,236.30137705802917,778.684455871582,25454,3415,22039,22039,0,11,3601000.0
3601,3601999,21.681823032408683,38.403525005854675,0.061838811829316276,558.4867417812347,236.36813259124756,779.0248146057129,25471,3417,22054,22054,0,11,3602000.0
3602,3602999,21.679902848542014,38.40051233742979,0.06184451349792608,558.672892332077,236.4345452785492,779.2382926940918,25475,3418,22057,22057,0,11,3603000.0
3603,3603999,21.67808739896668,38.39856540212422,0.061839887340314315,558.8024008274078,236.5008521080017,779.4576301574707,25476,3418,22058,22058,0,11,3604000.0
3604,3604999,21.676813880322136,38.396502802140695,0.061842725641402585,558.9467692375183,236.5662693977356,779.7602043151855,25479,3418,22061,22061,0,11,3605000.0
3605,3605999,21.675666969906683,38.39519711420815,0.0618323259473087,559.1286470890045,236.63281679153442,779.9192237854004,25481,3419,22062,22062,0,11,3606000.0
3606,3606999,21.674749452309154,38.3947930050494,0.06181849245523152,559.252599477768,236.69854640960693,780.1817932128906,25485,3419,22066,22066,0,11,3607000.0
3607,3607999,21.67442863794492,38.39471065905585,0.06180452982122753,559.4415149688721,236.76457405090332,780.3686714172363,25495,3420,22075,22075,0,11,3608000.0
3608,3608999,21.67469368911505,38.39515487111834,0.06181417727477867,559.6198592185974,236.83029341697693,780.4812850952148,25497,3421,22076,22076,0,11,3609000.0
3609,3609999,21.675441957955094,38.397206965930394,0.0618212490024741,559.8148400783539,236.89698028564453,780.6592597961426,25505,3422,22083,22083,0,11,3610000.0
3610,3610999,21.67790479929722,38.401841908687864,0.061816918400816157,559.9354012012482,236.96235036849976,780.8728561401367,25506,3422,22084,22084,0,11,3611000.0
3611,3611999,21.68105742178725,38.41189381479638,0.061826361931499485,560.1202285289764,237.028546333313,780.9757919311523,25508,3423,22085,22085,0,11,3612000.0
3612,3612999,21.68522297872817,38.421048069904664,0.0618882714027168,560.3030080795288,237.09446382522583,781.1290473937988,25512,3424,22088,22088,0,11,3613000.0
3613,3613999,21.68961151389188,38.43115853164957,0.06186775480307938,560.5504472255707,237.16201162338257,781.2594299316406,25518,3426,22092,22092,0,11,3614000.0
3614,3614999,21.695304636520028,38.450151720269844,0.06191171711881727,560.788779258728,237.22773933410645,781.3403472900391,25532,3428,22104,22104,0,11,3615000.0
3615,3615999,21.700818117102788,38.46110969772145,0.06196847788655058,561.0990798473358,237.29386377334595,781.5125350952148,25541,3431,22110,22110,0,11,3616000.0
3616,3616999,21.705692802603657,38.47327960855748,0.06206229805477981,561.2262263298035,237.35971927642822,781.7113914489746,25542,3431,22111,22111,0,11,3617000.0
3617,3617999,21.710526798314262,38.48221170507974,0.06210614299725992,561.5279681682587,237.42514061927795,781.7189559936523,25559,3434,22125,22125,0,11,3618000.0
3618,3618999,21.7147158888102,38.48698114515393,0.06216603415872424,561.711231470108,237.49078679084778,781.9777030944824,25567,3435,22132,22132,0,11,3619000.0
3619,3619999,21.71813778594371,38.49206770006959,0.062287587439585845,561.8877108097076,237.55496430397034,782.1076354980469,25570,3436,22134,22134,0,11,3620000.0
3620,3620999,21.716525225439174,38.48995562801275,0.06228782807487199,562.0147361755371,237.62045288085938,782.4075813293457,25576,3436,22140,22140,0,11,3621000.0
3621,3621999,21.715147262433586,38.48876684123118,0.06229343015273825,562.3731951713562,237.68716979026794,782.5204620361328,25600,3440,22160,22160,0,11,3622000.0
3622,3622999,21.71393397888321,38.488478699633234,0.06228802705353742,562.5014095306396,237.75323367118835,782.7282829284668,25602,3440,22162,22162,0,11,3623000.0
3623,3623999,21.712779840608047,38.487052335951915,0.06228928406527967,562.6236639022827,237.81933856010437,782.8468360900879,25603,3440,22163,22163,0,11,3624000.0
3624,3624999,21.71161574321486,38.48505039320247,0.06228575734598618,562.8711841106415,237.88509154319763,782.9681663513184,25609,3442,22167,22167,0,11,3625000.0
3625,3625999,21.71079553023208,38.483327808810934,0.06228635097196811,563.055983543396,237.94962978363037,783.0279693603516,25613,3443,22170,22170,0,11,3626000.0
3626,3626999,21.70998980341175,38.48144026575219,0.062298349802838326,563.2407853603363,238.01459574699402,783.1063346862793,25628,3444,22184,22184,0,11,3627000.0
3627,3627999,21.709614474578597,38.48079724226409,0.06229420227158933,563.3670699596405,238.08009815216064,783.3030586242676,25629,3444,22185,22185,0,11,3628000.0
3628,3628999,21.710121802609077,38.48225165492061,0.06232059736389839,563.6208341121674,238.1463007926941,783.3465805053711,25636,3446,22190,22190,0,11,3629000.0
3629,3629999,21.710937292806083,38.48772093128713,0.06230857019705982,563.9325370788574,238.21214389801025,783.2815628051758,25654,3449,22205,22205,0,11,3630000.0
3630,3630999,21.7125508570548,38.49078911758923,0.06229110462458565,564.0633451938629,238.27974891662598,783.5354843139648,25655,3449,22206,22206,0,11,3631000.0
3631,3631999,21.714620882024946,38.49405777083431,0.062262330685410205,564.1880383491516,238.3448007106781,783.6647491455078,25655,3449,22206,22206,0,11,3632000.0
3632,3632999,21.716218127671397,38.49579738282299,0.06227079607304953,564.3719294071198,238.40990710258484,783.7428283691406,25668,3450,22218,22218,0,11,3633000.0
3633,3633999,21.718446956478104,38.498785313507895,0.062282452594278115,564.6191506385803,238.47597813606262,783.9663543701172,25676,3452,22224,22224,0,11,3634000.0
3634,3634999,21.720931936385057,38.50601326834935,0.06227778268357287,564.8069489002228,238.5414125919342,784.0807991027832,25678,3453,22225,22225,0,11,3635000.0
3635,3635999,21.723322696564946,38.50826799588775,0.062285720013263046,565.009489774704,238.61116409301758,784.203784942627,25687,3454,22233,22233,0,11,3636000.0
3636,3636999,21.726017675643593,38.51162755191691,0.06227425092395367,565.2469098567963,238.67640924453735,784.5581665039062,25704,3456,22248,22248,0,11,3637000.0
3637,3637999,21.727406234908862,38.513808883363005,0.06228661435013649,565.4893007278442,238.74159622192383,784.6280059814453,25710,3458,22252,22252,0,11,3638000.0
3638,3638999,21.729570695503057,38.516704858797446,0.062302280085197115,565.7918560504913,238.8067605495453,784.7253799438477,25721,3461,22260,22260,0,11,3639000.0
3639,3639999,21.73074500114728,38.52219682360734,0.06228258366990569,565.9099791049957,238.87119960784912,784.9275283813477,25722,3461,22261,22261,0,11,3640000.0
3640,3640999,21.729968365838477,38.51952312900831,0.06228385595396713,566.0837740898132,238.93540954589844,785.0933609008789,25725,3462,22263,22263,0,11,3641000.0
3641,3641999,21.728059182413308,38.51638623389447,0.06229697281149027,566.2106766700745,239.00101709365845,785.389720916748,25726,3462,22264,22264,0,11,3642000.0
3642,3642999,21.726251277189032,38.5133125756076,0.06230523552288347,566.3344120979309,239.0675082206726,785.5365715026855,25726,3462,22264,22264,0,11,3643000.0
3643,3643999,21.724512999627795,38.50988052634954,0.062320745421135526,566.4594895839691,239.1334934234619,785.6096611022949,25726,3462,22264,22264,0,11,3644000.0
3644,3644999,21.723052991855376,38.50702998463571,0.06231885370046475,566.605103969574,239.19964170455933,785.7131500244141,25727,3462,22265,22265,0,11,3645000.0
3645,3645999,21.722373641174585,38.504977752507514,0.06229731340184841,566.7860941886902,239.2640905380249,785.7676277160645,25729,3463,22266,22266,0,11,3646000.0
3646,3646999,21.720793854833374,38.501680221505424,0.06229687692181851,567.1494641304016,239.32993125915527,785.7371520996094,25745,3467,22278,22278,0,11,3647000.0
3647,3647999,21.719672019105914,38.50036135496459,0.062281051622674166,567.282190322876,239.39536046981812,785.9435577392578,25746,3467,22279,22279,0,11,3648000.0
3648,3648999,21.718611768784392,38.497260597011795,0.062277263281226736,567.4155173301697,239.46046447753906,786.0140151977539,25746,3467,22279,22279,0,11,3649000.0
3649,3649999,21.717727394477777,38.49467220698533,0.06228457197984649,567.7332699298859,239.52628588676453,785.8484764099121,25762,3470,22292,22292,0,11,3650000.0
3650,3650999,21.716577460104933,38.49150383895242,0.06227526350050305,567.9806241989136,239.59350609779358,786.0409851074219,25767,3472,22295,22295,0,11,3651000.0
3651,3651999,21.71627318339785,38.48933423439517,0.062263029033751915,568.160626411438,239.65907216072083,786.1667594909668,25784,3473,22311,22311,0,11,3652000.0
3652,3652999,21.715712000287528,38.48721679166215,0.06228667318315062,568.3982872962952,239.7242922782898,786.2158088684082,25788,3475,22313,22313,0,11,3653000.0
3653,3653999,21.716920669605965,38.488130959639754,0.06228406721922153,568.6458642482758,239.7904086112976,786.4009437561035,25793,3477,22316,22316,0,11,3654000.0
3654,3654999,21.71781420752186,38.48739200915249,0.06228745988475637,568.839884519577,239.85779571533203,786.4595413208008,25799,3478,22321,22321,0,11,3655000.0
3655,3655999,21.719150105990224,38.48808770339451,0.06228412704938413,568.9617609977722,239.92336750030518,786.5505599975586,25799,3478,22321,22321,0,11,3656000.0
3656,3656999,21.720918291855526,38.490023254763855,0.06228555986873141,569.1001582145691,239.98798942565918,786.6938285827637,25799,3478,22321,22321,0,11,3657000.0
3657,3657999,21.72212597699761,38.490601527982236,0.06227745619937586,569.2227156162262,240.05188941955566,786.7714614868164,25799,3478,22321,22321,0,11,3658000.0
3658,3658999,21.723508654907846,38.49196304371389,0.06226949049059294,569.338282585144,240.1160171031952,786.8614158630371,25799,3478,22321,22321,0,11,3659000.0
3659,3659999,21.72370935696799,38.49037313884422,0.06226779046193487,569.5157573223114,240.18005537986755,786.9029693603516,25805,3479,22326,22326,0,11,3660000.0
3660,3660999,21.722075037168384,38.48872397100856,0.062273362350722006,569.7028687000275,240.24472784996033,787.0694274902344,25807,3480,22327,22327,0,11,3661000.0
3661,3661999,21.72039877491567,38.486399245159596,0.06228445785338732,569.8328654766083,240.31137418746948,787.3237228393555,25808,3480,22328,22328,0,11,3662000.0
3662,3662999,21.718826482380106,38.48425049706181,0.06230431999938435,570.0211534500122,240.37820172309875,787.4206581115723,25815,3481,22334,22334,0,11,3663000.0
3663,3663999,21.717325577703903,38.481109339398046,0.062311115175881615,570.2205791473389,240.44689798355103,787.5037078857422,25818,3482,22336,22336,0,11,3664000.0
3664,3664999,21.716481263795522,38.47834644472077,0.062307542187748144,570.4868643283844,240.5218210220337,787.5744400024414,25827,3484,22343,22343,0,11,3665000.0
3665,3665999,21.71539362171371,38.47555230206001,0.062309445917468786,570.6798887252808,240.58890676498413,787.7324714660645,25829,3485,22344,22344,0,11,3666000.0
3666,3666999,21.714680707225213,38.4728860189357,0.062298209394819004,570.8050100803375,240.65410590171814,787.9390754699707,25830,3485,22345,22345,0,11,3667000.0
3667,3667999,21.71404415636202,38.47038858370684,0.062295712796010205,571.050662279129,240.7198929786682,787.9351806640625,25843,3487,22356,22356,0,11,3668000.0
3668,3668999,21.71338101815795,38.473199524752545,0.06227435958679228,571.3062655925751,240.785813331604,787.8884658813477,25855,3489,22366,22366,0,11,3669000.0
3669,3669999,21.713384014380324,38.471280289631416,0.062237214837630006,571.5560073852539,240.85157775878906,787.9980621337891,25863,3491,22372,22372,0,11,3670000.0
3670,3670999,21.714203005908043,38.46975405203421,0.062181959176912605,571.7419567108154,240.91691493988037,788.085807800293,25865,3492,22373,22373,0,11,3671000.0
3671,3671999,21.713709081658372,38.467329606600124,0.06216206330505791,571.8772268295288,240.9826374053955,788.2375335693359,25865,3492,22373,22373,0,11,3672000.0
3672,3672999,21.71508849269568,38.46900758313136,0.06207651850111506,572.0005149841309,241.04800868034363,788.4515380859375,25868,3492,22376,22376,0,11,3673000.0
3673,3673999,21.71582992697363,38.46741535429435,0.06204104443474023,572.4268329143524,241.11445236206055,788.3405914306641,25886,3497,22389,22389,0,11,3674000.0
3674,3674999,21.716961124599486,38.46591649509731,0.06199054864666986,572.6724495887756,241.18037915229797,788.5630950927734,25891,3499,22392,22392,0,11,3675000.0
3675,3675999,21.717937633252454,38.464538698187184,0.06195311909489376,572.9224355220795,241.24520421028137,788.5748481750488,25903,3501,22402,22402,0,11,3676000.0
3676,3676999,21.719019165505458,38.466095607258666,0.06191009786621404,573.1007785797119,241.3120150566101,788.834358215332,25909,3502,22407,22407,0,11,3677000.0
3677,3677999,21.71835655689616,38.463066843954635,0.06189295183565968,573.278254032135,241.37622618675232,788.9790153503418,25917,3503,22414,22414,0,11,3678000.0
3678,3678999,21.7160137374942,38.45965625191684,0.06189768613472357,573.520956993103,241.44105195999146,789.0906448364258,25943,3505,22438,22438,0,11,3679000.0
3679,3679999,21.713611154058857,38.45605965960838,0.0619066343985164,573.7657115459442,241.50724005699158,789.2467727661133,25956,3507,22449,22449,0,11,3680000.0
3680,3680999,21.711380315666947,38.452552773086545,0.06191650825785178,573.895623922348,241.5745391845703,789.3958129882812,25956,3507,22449,22449,0,11,3681000.0
3681,3681999,21.709318287549273,38.44898804848756,0.061924068257998455,574.021009683609,241.6404995918274,789.4912033081055,25956,3507,22449,22449,0,11,3682000.0
3682,3682999,21.707827354051165,38.44693763049468,0.06192587226120683,574.2236182689667,241.70538067817688,789.5529441833496,25961,3508,22453,22453,0,11,3683000.0
3683,3683999,21.706040033695487,38.44344503771124,0.06192261376382613,574.3505012989044,241.770281791687,789.6791152954102,25961,3508,22453,22453,0,11,3684000.0
3684,3684999,21.7049421348738,38.44106034622085,0.06191439296317569,574.603262424469,241.83563041687012,789.7057342529297,25982,3510,22472,22472,0,11,3685000.0
3685,3685999,21.70405862344646,38.43865067256076,0.06189957989520645,574.7957980632782,241.90055537223816,789.7368698120117,25984,3511,22473,22473,0,11,3686000.0
3686,3686999,21.70322008088078,38.43715913536423,0.06188771015054184,574.9435977935791,241.96566772460938,789.8088073730469,25984,3511,22473,22473,0,11,3687000.0
3687,3687999,21.702604065261674,38.43496976507479,0.06188210043201203,575.1284098625183,242.0309681892395,789.8196258544922,25987,3512,22475,22475,0,11,3688000.0
3688,3688999,21.702622667610726,38.433970767289196,0.06186722478254525,575.26638007164,242.0963442325592,789.9440689086914,25987,3512,22475,22475,0,11,3689000.0
3689,3689999,21.7032496930443,38.43563856942116,0.061845243573374065,575.3997371196747,242.16106009483337,790.0098648071289,25987,3512,22475,22475,0,11,3690000.0
3690,3690999,21.703689328560678,38.43522744857313,0.06182286966942685,575.5383968353271,242.22596716880798,790.1728973388672,25987,3512,22475,22475,0,11,3691000.0
3691,3691999,21.704508019125495,38.435498132437786,0.06179764293418899,575.6612079143524,242.29132413864136,790.3183631896973,25987,3512,22475,22475,0,11,3692000.0
3692,3692999,21.70560927372747,38.43555297316882,0.06177621693123214,575.8541164398193,242.35666513442993,790.3963813781738,25989,3513,22476,22476,0,11,3693000.0
3693,3693999,21.70676518276173,38.437821661677596,0.06176502490837865,576.0377006530762,242.42177486419678,790.547534942627,25996,3514,22482,22482,0,11,3694000.0
3694,3694999,21.70742682328473,38.43712845462299,0.06175490702503672,576.2291133403778,242.48622345924377,790.6097946166992,25998,3515,22483,22483,0,11,3695000.0
3695,3695999,21.70812415697125,38.435845073119204,0.06175785719855775,576.4125010967255,242.55040287971497,790.6713752746582,26000,3516,22484,22484,0,11,3696000.0
3696,3696999,21.708371142569938,38.43477876592949,0.06175103174128238,576.5366864204407,242.61579036712646,790.799690246582,26000,3516,22484,22484,0,11,3697000.0
3697,3697999,21.706879402673252,38.432375667424544,0.06175553983351911,576.7847986221313,242.68028831481934,791.0229835510254,26014,3518,22496,22496,0,11,3698000.0
3698,3698999,21.704035970746464,38.428149516854944,0.0617726972307705,576.9207806587219,242.75543522834778,791.2599601745605,26014,3518,22496,22496,0,11,3699000.0
3699,3699999,21.701735126230627,38.425213575476164,0.06178310065797754,577.0610783100128,242.8210825920105,791.385799407959,26014,3518,22496,22496,0,11,3700000.0
3700,3700999,21.699389913810133,38.42141263844567,0.06180144507721841,577.1868941783905,242.8866274356842,791.472785949707,26014,3518,22496,22496,0,11,3701000.0
3701,3701999,21.696956185968173,38.41877179330733,0.06181093083238676,577.4284839630127,242.9526243209839,791.495174407959,26022,3520,22502,22502,0,11,3702000.0
3702,3702999,21.695074328701004,38.41512510763628,0.06181858469868273,577.5680167675018,243.01752066612244,791.7156372070312,26024,3520,22504,22504,0,11,3703000.0
3703,3703999,21.693213910953503,38.411621459776626,0.06182457415356357,577.6879806518555,243.08191752433777,791.8204956054688,26024,3520,22504,22504,0,11,3704000.0
3704,3704999,21.692135207276596,38.41009644122004,0.061818340984409414,577.8804631233215,243.1477816104889,792.0779266357422,26044,3521,22523,22523,0,11,3705000.0
3705,3705999,21.691572023633295,38.41196546044276,0.061798582207219344,578.0607738494873,243.21318936347961,792.1791305541992,26047,3522,22525,22525,0,11,3706000.0
3706,3706999,21.690838900727268,38.41066561890921,0.06179140054844712,578.1928734779358,243.27861428260803,792.3666114807129,26047,3522,22525,22525,0,11,3707000.0
3707,3707999,21.691242135983007,38.41140422776136,0.06177925909687665,578.3842270374298,243.34438157081604,792.4776916503906,26053,3523,22530,22530,0,11,3708000.0
3708,3708999,21.69220877250146,38.41278240925939,0.06176249007880252,578.5635671615601,243.4100263118744,792.7998695373535,26072,3524,22548,22548,0,11,3709000.0
3709,3709999,21.693511793161548,38.419016281193095,0.06174815874726414,578.7464926242828,243.47640323638916,792.9029693603516,26078,3525,22553,22553,0,11,3710000.0
3710,3710999,21.69442166116327,38.41912698157932,0.06176678115087275,578.9390294551849,243.5420525074005,793.0057983398438,26080,3526,22554,22554,0,11,3711000.0
3711,3711999,21.696002058822323,38.42117982896486,0.06173368846985017,579.1237065792084,243.6085250377655,793.5854225158691,26094,3527,22567,22567,0,11,3712000.0
3712,3712999,21.69716853058568,38.421276761313045,0.06172391130758281,579.3639225959778,243.67489528656006,793.705436706543,26107,3529,22578,22578,0,11,3713000.0
3713,3713999,21.699032906507743,38.424926638939844,0.06169785991141297,579.5505020618439,243.7408323287964,794.1329498291016,26117,3530,22587,22587,0,11,3714000.0
3714,3714999,21.700583455547676,38.426288351637815,0.061675223510358146,579.7890756130219,243.80585289001465,794.3168411254883,26126,3532,22594,22594,0,11,3715000.0
3715,3715999,21.701721578711663,38.426543825217664,0.061667373670285075,580.0346608161926,243.87271547317505,794.4168281555176,26134,3534,22600,22600,0,11,3716000.0
3716,3716999,21.702653109613887,38.4262384123822,0.0616574747305112,580.2132675647736,243.93738555908203,794.657299041748,26143,3535,22608,22608,0,11,3717000.0
3717,3717999,21.702827641538743,38.42487709233226,0.061629410711156796,580.3951363563538,244.00193166732788,794.8420677185059,26148,3536,22612,22612,0,11,3718000.0
3718,3718999,21.70101506400379,38.42373676512582,0.061633203006386306,580.5818457603455,244.06712007522583,795.0586700439453,26156,3537,22619,22619,0,11,3719000.0
3719,3719999,21.698930962627795,38.42072586093805,0.0616429579866592,580.8388466835022,244.13386225700378,795.2392921447754,26166,3539,22627,22627,0,11,3720000.0
3720,3720999,21.696573823768244,38.41728494720528,0.061658806072307226,581.0287034511566,244.20058393478394,795.3681411743164,26168,3540,22628,22628,0,11,3721000.0
3721,3721999,21.694823975530667,38.41432098031279,0.061668307802487665,581.2181940078735,244.26681756973267,795.4493141174316,26170,3541,22629,22629,0,11,3722000.0
3722,3722999,21.692795467081783,38.410959849101936,0.06167661029976623,581.4043080806732,244.3329141139984,795.8196411132812,26190,3542,22648,22648,0,11,3723000.0
3723,3723999,21.691398627024093,38.40851678439714,0.06167807395979796,581.5330700874329,244.39777994155884,795.9711112976074,26190,3542,22648,22648,0,11,3724000.0
3724,3724999,21.689901638875234,38.40559643167487,0.061676218690317586,581.73153424263,244.46386075019836,796.1743125915527,26195,3543,22652,22652,0,11,3725000.0
3725,3725999,21.68852504639393,38.40320122291935,0.06167440300315019,581.8588852882385,244.5291223526001,796.3459587097168,26196,3543,22653,22653,0,11,3726000.0
3726,3726999,21.687766459544378,38.401891203726485,0.061667790380369625,581.9908928871155,244.59474730491638,796.4665794372559,26197,3543,22654,22654,0,11,3727000.0
3727,3727999,21.686669493864887,38.39946212783269,0.06165998743867973,582.291538476944,244.6604516506195,796.4566116333008,26215,3546,22669,22669,0,11,3728000.0
3728,3728999,21.685575243966664,38.39701025895536,0.06165797679499674,582.4141867160797,244.7259612083435,796.7600364685059,26215,3546,22669,22669,0,11,3729000.0
3729,3729999,21.685041959655003,38.395633161383195,0.06165369359299977,582.5429289340973,244.79196071624756,796.8776664733887,26215,3546,22669,22669,0,11,3730000.0
3730,3730999,21.684172944969678,38.39321693955169,0.06165171114414891,582.7213191986084,244.85747051239014,796.9775543212891,26217,3547,22670,22670,0,11,3731000.0
3731,3731999,21.68371588806341,38.39209918538512,0.06163537948209119,582.8470056056976,244.92279434204102,797.371223449707,26223,3547,22676,22676,0,11,3732000.0
3732,3732999,21.68292770961826,38.38980231648889,0.061628933306474565,583.0259892940521,244.98805785179138,797.4867515563965,26225,3548,22677,22677,0,11,3733000.0
3733,3733999,21.68295725993319,38.390820023248175,0.06160952472613812,583.2745039463043,245.0534906387329,797.671875,26235,3550,22685,22685,0,11,3734000.0
3734,3734999,21.682593851172385,38.3887238786379,0.06159880766086068,583.460440158844,245.1196641921997,797.7905731201172,26239,3551,22688,22688,0,11,3735000.0
3735,3735999,21.682098896289027,38.38623726358229,0.06159579621562694,583.6487600803375,245.18399143218994,797.9315338134766,26258,3552,22706,22706,0,11,3736000.0
3736,3736999,21.681271690785117,38.38512655810196,0.061578529026357964,583.7767446041107,245.25501132011414,798.0795669555664,26258,3552,22706,22706,0,11,3737000.0
3737,3737999,21.67913353566111,38.382698812921326,0.06155713378958638,583.8998129367828,245.31981110572815,798.3135147094727,26263,3552,22711,22711,0,11,3738000.0
3738,3738999,21.67673387965461,38.37993887932496,0.06156871398875119,584.0944380760193,245.3858242034912,798.4379043579102,26265,3553,22712,22712,0,11,3739000.0
3739,3739999,21.674414268596717,38.37621471643536,0.061588375827724806,584.2831947803497,245.4532470703125,798.4960861206055,26271,3554,22717,22717,0,11,3740000.0
3740,3740999,21.67262704179662,38.37371033471076,0.061592048836518254,584.4938151836395,245.52473735809326,798.4972229003906,26279,3555,22724,22724,0,11,3741000.0
3741,3741999,21.671190269023427,38.37344592168804,0.061586681470961024,584.6370449066162,245.58965420722961,798.7536544799805,26281,3555,22726,22726,0,11,3742000.0
3742,3742999,21.6695934904531,38.371051499222126,0.06158221532036767,584.7799985408783,245.663259267807,798.8389625549316,26281,3555,22726,22726,0,11,3743000.0
3743,3743999,21.6681619148108,38.36935422997944,0.061573790876404244,584.9738237857819,245.72845935821533,798.8698959350586,26288,3556,22732,22732,0,11,3744000.0
3744,3744999,21.667447630650884,38.36844133177228,0.06155931065830034,585.1052207946777,245.79319286346436,798.9380645751953,26288,3556,22732,22732,0,11,3745000.0
3745,3745999,21.66695218187675,38.372001701081864,0.06153700566324816,585.2369277477264,245.85794115066528,798.9934005737305,26288,3556,22732,22732,0,11,3746000.0
3746,3746999,21.66733728270654,38.372221315430956,0.061519119171671965,585.4881236553192,245.92342519760132,798.9152908325195,26300,3558,22742,22742,0,11,3747000.0
3747,3747999,21.66759151061446,38.373326060929756,0.061523397135518354,585.6217129230499,245.98832368850708,799.1307334899902,26301,3558,22743,22743,0,11,3748000.0
3748,3748999,21.66820623038662,38.373621598890026,0.061522407510297694,585.9922983646393,246.05405235290527,798.948127746582,26320,3562,22758,22758,0,11,3749000.0
3749,3749999,21.669793359513477,38.377330851194216,0.061516201611937604,586.1120879650116,246.12015438079834,799.1161079406738,26320,3562,22758,22758,0,11,3750000.0
3750,3750999,21.671941930424403,38.38425082904796,0.061507902225152344,586.2940015792847,246.18529796600342,799.3184509277344,26324,3563,22761,22761,0,11,3751000.0
3751,3751999,21.674404123974426,38.390578970954145,0.061495327196844474,586.5301432609558,246.25202202796936,799.3637809753418,26336,3565,22771,22771,0,11,3752000.0
3752,3752999,21.676404670684878,38.39414350296528,0.06148667118345219,586.7995784282684,246.31789565086365,799.4402275085449,26342,3567,22775,22775,0,11,3753000.0
3753,3753999,21.67897917049004,38.40144999737605,0.06147041307525003,586.9907329082489,246.38322162628174,799.6116905212402,26347,3568,22779,22779,0,11,3754000.0
3754,3754999,21.681204685152586,38.40349594826341,0.0614713802789576,587.1105041503906,246.44795775413513,799.7335586547852,26347,3568,22779,22779,0,11,3755000.0
3755,3755999,21.683301496099205,38.407626007522516,0.06147428262407606,587.2998094558716,246.51253032684326,799.8445243835449,26353,3569,22784,22784,0,11,3756000.0
3756,3756999,21.684242899854432,38.407313184041854,0.061464539082709546,587.474324464798,246.57666325569153,799.9372673034668,26357,3570,22787,22787,0,11,3757000.0
3757,3757999,21.682939871117075,38.40444273698512,0.0614633982832522,587.6567432880402,246.64117217063904,800.1231651306152,26361,3571,22790,22790,0,11,3758000.0
3758,3758999,21.680457822651128,38.40186326082863,0.06146971040001015,587.7873530387878,246.70639634132385,800.3483619689941,26363,3571,22792,22792,0,11,3759000.0
3759,3759999,21.678114803133496,38.39891663834066,0.061473789932713685,587.978663444519,246.77238035202026,800.4489555358887,26365,3572,22793,22793,0,11,3760000.0
3760,3760999,21.676109985328058,38.39687599039585,0.061474957190316704,588.1651725769043,246.8384931087494,800.5358047485352,26367,3573,22794,22794,0,11,3761000.0
3761,3761999,21.67478930320813,38.398368846714106,0.0614655347737717,588.2855951786041,246.9041759967804,800.5968132019043,26367,3573,22794,22794,0,11,3762000.0
3762,3762999,21.673381909248253,38.39623823593408,0.06145842278725899,588.4747738838196,246.96969437599182,800.795108795166,26378,3574,22804,22804,0,11,3763000.0
3763,3763999,21.672374596198164,38.39615170234358,0.06144105898063401,588.5998029708862,247.0347616672516,800.9496803283691,26378,3574,22804,22804,0,11,3764000.0
3764,3764999,21.671255424390043,38.394458978151484,0.06143210578002323,588.7281019687653,247.0998933315277,801.0522880554199,26378,3574,22804,22804,0,11,3765000.0
3765,3765999,21.670214106416886,38.39265131102467,0.06142571686414944,588.929297208786,247.1651270389557,801.1438026428223,26383,3575,22808,22808,0,11,3766000.0
3766,3766999,21.66977091515932,38.39216481540322,0.061408817359476564,589.1916792392731,247.2307071685791,801.0862083435059,26398,3577,22821,22821,0,11,3767000.0
3767,3767999,21.66928303344496,38.391322616958945,0.061404694181256714,589.383663892746,247.2960488796234,801.1322708129883,26400,3578,22822,22822,0,11,3768000.0
3768,3768999,21.66991576969116,38.392866468907165,0.06138215910470424,589.580846786499,247.36262893676758,801.2537879943848,26403,3579,22824,22824,0,11,3769000.0
3769,3769999,21.67210335304937,38.400002025123094,0.061372230635935554,589.7617270946503,247.42793822288513,801.3062782287598,26405,3580,22825,22825,0,11,3770000.0
3770,3770999,21.675156361114162,38.4073364466632,0.06138782570811663,590.0180859565735,247.4941427707672,801.3379402160645,26413,3582,22831,22831,0,11,3771000.0
3771,3771999,21.679568627771552,38.42089361334084,0.061365922090375835,590.2048532962799,247.56002688407898,801.4568176269531,26421,3583,22838,22838,0,11,3772000.0
3772,3772999,21.6834102465653,38.42905148187419,0.06137744377584442,590.5716469287872,247.62607669830322,801.471923828125,26456,3587,22869,22869,0,11,3773000.0
3773,3773999,21.688671512961378,38.441614000714985,0.06140322057496339,590.9585335254669,247.6930718421936,801.4047241210938,26483,3591,22892,22892,0,11,3774000.0
3774,3774999,21.69377695153534,38.45443826004452,0.06138613481935351,591.1472628116608,247.75828981399536,801.6362762451172,26492,3592,22900,22900,0,11,3775000.0
3775,3775999,21.69777007858492,38.46097105171678,0.061392396882217204,591.2617647647858,247.82239890098572,801.7537651062012,26492,3592,22900,22900,0,11,3776000.0
3776,3776999,21.702065216218312,38.46755958296274,0.061450168246702574,591.6327035427094,247.88842296600342,801.7380485534668,26516,3596,22920,22920,0,11,3777000.0
3777,3777999,21.704700938832094,38.47112461680014,0.06143174263504814,591.7523648738861,247.9526047706604,801.8624305725098,26516,3596,22920,22920,0,11,3778000.0
3778,3778999,21.704479866246405,38.4704252012029,0.061423965061758734,591.8697907924652,248.01848649978638,802.1021118164062,26517,3596,22921,22921,0,11,3779000.0
3779,3779999,21.702427700042307,38.471673559124866,0.061408663572398714,592.0569171905518,248.08370661735535,802.2192344665527,26528,3597,22931,22931,0,11,3780000.0
3780,3780999,21.700696766328083,38.47060279914512,0.06139570972291952,592.3120970726013,248.15065455436707,802.2453727722168,26534,3599,22935,22935,0,11,3781000.0
3781,3781999,21.698870147890236,38.46870570959474,0.06139437287255678,592.5565910339355,248.21706986427307,802.3000183105469,26543,3601,22942,22942,0,11,3782000.0
3782,3782999,21.697413687936315,38.467403091626224,0.06137935260802185,592.6832304000854,248.28326749801636,802.3900108337402,26543,3601,22942,22942,0,11,3783000.0
3783,3783999,21.696068504484995,38.46514650351285,0.06136377337107268,592.884946346283,248.34961318969727,802.4653663635254,26549,3602,22947,22947,0,11,3784000.0
3784,3784999,21.69469580678263,38.464182456170796,0.06134979825272191,593.21675157547,248.42131090164185,802.3863677978516,26561,3605,22956,22956,0,11,3785000.0
3785,3785999,21.693758662912348,38.46277598575781,0.06133699108974766,593.4350814819336,248.49875569343567,802.4375381469727,26567,3606,22961,22961,0,11,3786000.0
3786,3786999,21.692579684212443,38.46098768580653,0.06132052711211389,593.568051815033,248.5638463497162,802.5541801452637,26567,3606,22961,22961,0,11,3787000.0
3787,3787999,21.69250448232779,38.46360022496259,0.06129512640523571,593.7611672878265,248.62926650047302,802.5454139709473,26573,3607,22966,22966,0,11,3788000.0
3788,3788999,21.694398388165364,38.47074680628235,0.06125336030092143,593.9592227935791,248.69532561302185,802.5648994445801,26575,3608,22967,22967,0,11,3789000.0
3789,3789999,21.698962367644345,38.48485696439771,0.06123641368974653,594.1417837142944,248.76088094711304,802.8679504394531,26577,3609,22968,22968,0,11,3790000.0
3790,3790999,21.7039395226794,38.50366018344854,0.06124988127188946,594.3275401592255,248.82620763778687,802.9777374267578,26579,3610,22969,22969,0,11,3791000.0
3791,3791999,21.710298814574852,38.5220262965798,0.0612904902701239,594.5017278194427,248.89154386520386,803.1222648620605,26581,3611,22970,22970,0,11,3792000.0
3792,3792999,21.717710732613575,38.53944080941168,0.061300862542644,594.7044584751129,248.957768201828,803.2630653381348,26588,3612,22976,22976,0,11,3793000.0
3793,3793999,21.725544781881602,38.556745406783904,0.06150788288135811,595.0170092582703,249.0242371559143,803.2964820861816,26599,3615,22984,22984,0,11,3794000.0
3794,3794999,21.73368913296663,38.573834565379066,0.06169738986518769,595.4595732688904,249.09209942817688,803.1984825134277,26627,3620,23007,23007,0,11,3795000.0
3795,3795999,21.742699319154156,38.59409658438863,0.06174480833074403,595.7085151672363,249.15802645683289,803.3428726196289,26635,3622,23013,23013,0,11,3796000.0
3796,3796999,21.750491906020212,38.60962989875579,0.06183272239486348,595.9503383636475,249.22304487228394,803.4204711914062,26647,3624,23023,23023,0,11,3797000.0
3797,3797999,21.759003933109764,38.626059388575,0.06194964486295995,596.1893136501312,249.2877287864685,803.4635047912598,26659,3626,23033,23033,0,11,3798000.0
3798,3798999,21.763740691609705,38.63344500051788,0.06204290234806287,596.428525686264,249.35305643081665,803.5280990600586,26664,3628,23036,23036,0,11,3799000.0
3799,3799999,21.763175021827497,38.63334981440496,0.06203410946060317,596.5513541698456,249.41754841804504,803.6793403625488,26664,3628,23036,23036,0,11,3800000.0
3800,3800999,21.76120177181046,38.63098582614885,0.062026839626292074,596.6780452728271,249.48360633850098,803.9040565490723,26665,3628,23037,23037,0,11,3801000.0
3801,3801999,21.7596811838276,38.62964966785005,0.062017144464647345,596.8030550479889,249.54934453964233,804.0074844360352,26665,3628,23037,23037,0,11,3802000.0
3802,3802999,21.759570667523086,38.6318318530206,0.06198712001583051,596.9915878772736,249.61535596847534,804.0205345153809,26671,3629,23042,23042,0,11,3803000.0
3803,3803999,21.75873621858129,38.63054940794853,0.061973907411763784,597.1884984970093,249.68201446533203,804.1264724731445,26678,3630,23048,23048,0,11,3804000.0
3804,3804999,21.758166345957527,38.62898480345982,0.06195217692916699,597.4928247928619,249.74748539924622,804.1300735473633,26684,3633,23051,23051,0,11,3805000.0
3805,3805999,21.757857884298215,38.62857350161863,0.06192953751372643,597.6241869926453,249.8202784061432,804.328929901123,26684,3633,23051,23051,0,11,3806000.0
3806,3806999,21.758096269146883,38.62806429475989,0.061899544113565685,597.752988576889,249.8858654499054,804.4898796081543,26686,3633,23053,23053,0,11,3807000.0
3807,3807999,21.75879980257496,38.632720118625784,0.06185674177403566,598.0186123847961,249.9522647857666,804.481388092041,26695,3635,23060,23060,0,11,3808000.0
3808,3808999,21.76009704315734,38.633949146564355,0.061833118376504737,598.1531138420105,250.01801347732544,804.5941200256348,26695,3635,23060,23060,0,11,3809000.0
3809,3809999,21.76093407549807,38.63512861170939,0.06181681802690353,598.2751536369324,250.0830798149109,804.7510986328125,26695,3635,23060,23060,0,11,3810000.0
3810,3810999,21.763915362947905,38.64320320514701,0.06181365289574181,598.4622859954834,250.14818453788757,804.9014320373535,26698,3636,23062,23062,0,11,3811000.0
3811,3811999,21.76681017972651,38.64746709847861,0.061841456319812416,598.6414120197296,250.21443152427673,804.9718322753906,26700,3637,23063,23063,0,11,3812000.0
3812,3812999,21.769832816552707,38.650849711655084,0.0618589196815138,598.8878402709961,250.2802128791809,805.0481300354004,26709,3639,23070,23070,0,11,3813000.0
3813,3813999,21.774203493985166,38.65745244140803,0.06187839005086204,599.0722146034241,250.34607315063477,805.1060905456543,26715,3640,23075,23075,0,11,3814000.0
3814,3814999,21.779036500996526,38.66723427655708,0.06193826655201884,599.3972001075745,250.41262912750244,805.1268272399902,26725,3643,23082,23082,0,11,3815000.0
3815,3815999,21.784155176399732,38.676045166274896,0.06200668961314837,599.589959859848,250.47865509986877,805.2476501464844,26734,3644,23090,23090,0,11,3816000.0
3816,3816999,21.788004250417618,38.6816618866021,0.06207506013061781,599.9021055698395,250.5444827079773,805.2974281311035,26744,3647,23097,23097,0,11,3817000.0
3817,3817999,21.792254645307764,38.68789549780524,0.062138928156896145,600.2115249633789,250.60952425003052,805.2297210693359,26761,3650,23111,23111,0,11,3818000.0
3818,3818999,21.79575958052652,38.69154409786054,0.06220434173808409,600.3246967792511,250.6744260787964,805.4607734680176,26762,3650,23112,23112,0,11,3819000.0
3819,3819999,21.796867539720154,38.69126807336575,0.062228458253224095,600.4383511543274,250.7382571697235,805.6767883300781,26765,3650,23115,23115,0,11,3820000.0
3820,3820999,21.795213547500754,38.68970167162831,0.062207461669578135,600.6262731552124,250.80575966835022,805.7923736572266,26775,3651,23124,23124,0,11,3821000.0
3821,3821999,21.793583706754642,38.68758092473661,0.06219249824359652,600.8928799629211,250.8727412223816,806.0193824768066,26785,3653,23132,23132,0,11,3822000.0
3822,3822999,21.792242944115902,38.68614651056104,0.06218197077008003,601.0161604881287,250.9389886856079,806.1661796569824,26785,3653,23132,23132,0,11,3823000.0
3823,3823999,21.790487468378842,38.68338867000832,0.06217690932562925,601.1416809558868,251.0057156085968,806.2710609436035,26785,3653,23132,23132,0,11,3824000.0
3824,3824999,21.788948475692912,38.68059305990991,0.06216304484118462,601.2829465866089,251.08225560188293,806.4385528564453,26786,3653,23133,23133,0,11,3825000.0
3825,3825999,21.787530442182238,38.677497253851385,0.062144283159182634,601.6107025146484,251.14827394485474,806.3757934570312,26797,3656,23141,23141,0,11,3826000.0
3826,3826999,21.786256683715845,38.67474300929217,0.06213268032797559,601.7376637458801,251.21372413635254,806.5150566101074,26797,3656,23141,23141,0,11,3827000.0
3827,3827999,21.78555261507994,38.672885481532894,0.06210874443003589,601.9248654842377,251.2794108390808,806.6383018493652,26802,3657,23145,23145,0,11,3828000.0
3828,3828999,21.784386073282832,38.670095927384104,0.06209227533679296,602.1191928386688,251.34626817703247,806.656623840332,26809,3658,23151,23151,0,11,3829000.0
3829,3829999,21.78370597538951,38.66860863496221,0.062070424195142415,602.3144631385803,251.41202211380005,806.6933059692383,26815,3659,23156,23156,0,11,3830000.0
3830,3830999,21.783623323147413,38.66720902935691,0.062031297567490484,602.5579180717468,251.47711634635925,806.6962890625,26825,3661,23164,23164,0,11,3831000.0
3831,3831999,21.784616101610265,38.66675248436752,0.06197333566133845,602.6905930042267,251.54157209396362,806.8144264221191,26825,3661,23164,23164,0,11,3832000.0
3832,3832999,21.785007945257238,38.66573927514395,0.06193726251363718,602.8723819255829,251.60618257522583,806.8228950500488,26827,3662,23165,23165,0,11,3833000.0
3833,3833999,21.785110492685188,38.66406663156601,0.06190246900570395,603.0105895996094,251.67169046401978,807.0267715454102,26827,3662,23165,23165,0,11,3834000.0
3834,3834999,21.785807191286963,38.66321068983143,0.06185556921253044,603.1995000839233,251.73711705207825,807.0889053344727,26829,3663,23166,23166,0,11,3835000.0
3835,3835999,21.786430683602415,38.66205963820491,0.06183419529641454,603.3270328044891,251.80215716362,807.1839561462402,26829,3663,23166,23166,0,11,3836000.0
3836,3836999,21.787395683613905,38.661490429883436,0.061809466217789266,603.5916471481323,251.86810040473938,807.2448997497559,26841,3665,23176,23176,0,11,3837000.0
3837,3837999,21.788175870658446,38.660751276318585,0.061790500783523106,603.8393619060516,251.93315815925598,807.2498626708984,26849,3667,23182,23182,0,11,3838000.0
3838,3838999,21.788663497613115,38.65939542355215,0.06177679588569962,604.1117525100708,252.00271725654602,807.2903823852539,26861,3669,23192,23192,0,11,3839000.0
3839,3839999,21.78964838263196,38.65840019231268,0.061759387178396574,604.4258008003235,252.0686845779419,807.3340492248535,26877,3672,23205,23205,0,11,3840000.0
3840,3840999,21.789568532830245,38.65629669613451,0.06174620562417599,604.5544798374176,252.14315605163574,807.4393997192383,26877,3672,23205,23205,0,11,3841000.0
3841,3841999,21.787876499440664,38.65379904237352,0.061744491909485055,604.8033554553986,252.20802545547485,807.6882019042969,26901,3674,23227,23227,0,11,3842000.0
3842,3842999,21.785980525929286,38.65217043109998,0.06174368334973257,604.9197261333466,252.27324533462524,807.9298210144043,26903,3674,23229,23229,0,11,3843000.0
3843,3843999,21.783847924652594,38.64944171461065,0.06174989925596941,605.0472331047058,252.33897471427917,808.1103019714355,26903,3674,23229,23229,0,11,3844000.0
3844,3844999,21.78162830252749,38.64636295180266,0.061760097090097,605.1986365318298,252.41549634933472,808.2073440551758,26903,3674,23229,23229,0,11,3845000.0
3845,3845999,21.779298927640497,38.64273006777087,0.06176625502437827,605.3226799964905,252.4815673828125,808.2923316955566,26903,3674,23229,23229,0,11,3846000.0
3846,3846999,21.77768446763178,38.63999566374564,0.06176891710930621,605.44278383255,252.54649448394775,808.5875511169434,26906,3674,23232,23232,0,11,3847000.0
3847,3847999,21.775937966425662,38.636927140866064,0.06177491767233978,605.6296856403351,252.6118769645691,808.6813278198242,26908,3675,23233,23233,0,11,3848000.0
3848,3848999,21.77423990447285,38.63362440513118,0.06178045306752822,605.8291132450104,252.67814230918884,808.8606872558594,26915,3676,23239,23239,0,11,3849000.0
3849,3849999,21.772970710831636,38.630845023949796,0.06177629913379967,605.9477074146271,252.74414086341858,809.0610389709473,26915,3676,23239,23239,0,11,3850000.0
3850,3850999,21.771822333082937,38.62856375517582,0.06177237951171832,606.1394948959351,252.81084203720093,809.1923179626465,26917,3677,23240,23240,0,11,3851000.0
3851,3851999,21.770871495124283,38.62659195078333,0.06176998782841825,606.3924012184143,252.87706351280212,809.2773857116699,26923,3679,23244,23244,0,11,3852000.0
3852,3852999,21.77066759569745,38.62631185607941,0.06175657422046854,606.5090160369873,252.9436333179474,809.6864204406738,26925,3679,23246,23246,0,11,3853000.0
3853,3853999,21.770583422301915,38.62516306402584,0.0617453939519671,606.6846590042114,253.00885224342346,809.810489654541,26927,3680,23247,23247,0,11,3854000.0
3854,3854999,21.770825809823762,38.62949362474558,0.06172696278573597,606.9518165588379,253.07795810699463,809.9455909729004,26933,3682,23251,23251,0,11,3855000.0
3855,3855999,21.770718026039493,38.62740142034387,0.061707126791722966,607.194718837738,253.1438205242157,810.2408676147461,26945,3684,23261,23261,0,11,3856000.0
3856,3856999,21.771186769720057,38.62619425444489,0.06168578909502376,607.3088202476501,253.20946335792542,810.4505882263184,26945,3684,23261,23261,0,11,3857000.0
3857,3857999,21.77123033099367,38.625332563582056,0.061669972081045854,607.7592439651489,253.2799699306488,810.4214973449707,26981,3689,23292,23292,0,11,3858000.0
3858,3858999,21.772276270968998,38.625429618170905,0.061649232772676754,607.9447982311249,253.34675240516663,810.832462310791,26993,3690,23303,23303,0,11,3859000.0
3859,3859999,21.772658551408167,38.624174437630565,0.06162626923558456,608.3159418106079,253.4126296043396,810.8878135681152,27017,3694,23323,23323,0,11,3860000.0
3860,3860999,21.773032070694143,38.62309614663463,0.061606383097584594,608.5007536411285,253.47760581970215,810.9763526916504,27022,3695,23327,23327,0,11,3861000.0
3861,3861999,21.773462805665876,38.62149923635127,0.06158081317274733,608.6800494194031,253.54246711730957,811.3711700439453,27029,3696,23333,23333,0,11,3862000.0
3862,3862999,21.773061346256505,38.62077577307239,0.061565738777060064,608.8135533332825,253.61710619926453,811.8053817749023,27038,3696,23342,23342,0,11,3863000.0
3863,3863999,21.7707606132138,38.61766781877147,0.061579589590127215,608.9310052394867,253.6830930709839,812.2143440246582,27047,3696,23351,23351,0,11,3864000.0
3864,3864999,21.768740720444054,38.615130249724196,0.061589568577066656,609.0647368431091,253.75854516029358,812.527214050293,27049,3696,23353,23353,0,11,3865000.0
3865,3865999,21.76704740127076,38.61386740294081,0.061590998717418466,609.3727898597717,253.8252182006836,812.5770454406738,27068,3699,23369,23369,0,11,3866000.0
3866,3866999,21.765192001018146,38.611287411913565,0.061597673743739256,609.562304019928,253.89208984375,812.7118034362793,27087,3700,23387,23387,0,11,3867000.0
3867,3867999,21.76364232950081,38.609226774333614,0.06159608210196921,609.6955406665802,253.95833802223206,813.1753005981445,27092,3700,23392,23392,0,11,3868000.0
3868,3868999,21.76189133719058,38.6057495159861,0.061595124026744164,610.0148763656616,254.02508401870728,813.3259658813477,27117,3703,23414,23414,0,11,3869000.0
3869,3869999,21.76131295028533,38.605850621834215,0.06157676900608511,610.2083234786987,254.0911853313446,813.6590766906738,27124,3704,23420,23420,0,11,3870000.0
3870,3870999,21.76132644622075,38.60501906057613,0.06156243859906052,610.4490511417389,254.15823602676392,813.784366607666,27132,3706,23426,23426,0,11,3871000.0
3871,3871999,21.761661216230213,38.605687248662505,0.0615486114794882,610.7559230327606,254.22435569763184,813.8637428283691,27142,3709,23433,23433,0,11,3872000.0
3872,3872999,21.76218689185696,38.605702969987775,0.06152820020070304,610.8863520622253,254.2911021709442,814.1354713439941,27143,3709,23434,23434,0,11,3873000.0
3873,3873999,21.762605813907957,38.60509027059569,0.061505993522136815,611.0068080425262,254.35626816749573,814.2898750305176,27143,3709,23434,23434,0,11,3874000.0
3874,3874999,21.763419272953293,38.605585218317586,0.06148258016011365,611.2577569484711,254.42285585403442,814.3290176391602,27147,3711,23436,23436,0,11,3875000.0
3875,3875999,21.76392508069892,38.60502298684585,0.06146434195673023,611.440744638443,254.48877382278442,814.6350746154785,27155,3712,23443,23443,0,11,3876000.0
3876,3876999,21.76436039370595,38.604242299978715,0.0614423825254361,611.5642650127411,254.55399417877197,814.8591690063477,27155,3712,23443,23443,0,11,3877000.0
3877,3877999,21.76500899998911,38.60337056711527,0.0614254708148283,611.8769121170044,254.61987280845642,814.8596801757812,27167,3715,23452,23452,0,11,3878000.0
3878,3878999,21.765908023171818,38.60290288715626,0.06139889434951251,612.0603411197662,254.68638443946838,815.1707534790039,27174,3716,23458,23458,0,11,3879000.0
3879,3879999,21.76663253533247,38.60243821928206,0.061378214943932474,612.2538132667542,254.75798916816711,815.3202133178711,27180,3717,23463,23463,0,11,3880000.0
3880,3880999,21.76726765330797,38.60115392136447,0.06135649198118032,612.4388229846954,254.82300782203674,815.4765014648438,27182,3718,23464,23464,0,11,3881000.0
3881,3881999,21.766220304501516,38.598256021835915,0.061346639340152165,612.6222794055939,254.88911819458008,815.8275947570801,27191,3719,23472,23472,0,11,3882000.0
3882,3882999,21.764199179616,38.5949510835815,0.061346777385185014,612.7408149242401,254.9546205997467,816.191822052002,27196,3719,23477,23477,0,11,3883000.0
3883,3883999,21.762608244612043,38.59220751527614,0.06134250137979402,612.9294035434723,255.0210738182068,816.2822570800781,27198,3720,23478,23478,0,11,3884000.0
3884,3884999,21.76088651412951,38.589436335357426,0.06134470562044325,613.1157057285309,255.0873520374298,816.3529968261719,27204,3721,23483,23483,0,11,3885000.0
3885,3885999,21.759709769600853,38.58722136554555,0.06133681773872246,613.2403752803802,255.15339040756226,816.6996612548828,27211,3721,23490,23490,0,11,3886000.0
3886,3886999,21.75866541466653,38.58559171834812,0.06133163518822493,613.5498104095459,255.21959972381592,816.861385345459,27217,3724,23493,23493,0,11,3887000.0
3887,3887999,21.757578040300263,38.58297210670424,0.06132541157089011,613.7309107780457,255.2856686115265,817.0206260681152,27222,3725,23497,23497,0,11,3888000.0
3888,3888999,21.756921637057545,38.580724309811856,0.06130305983557316,613.9234395027161,255.35262060165405,817.2069282531738,27229,3726,23503,23503,0,11,3889000.0
3889,3889999,21.756887893433696,38.57957686471573,0.06128042648505827,614.1828563213348,255.4196183681488,817.2462692260742,27240,3728,23512,23512,0,11,3890000.0
3890,3890999,21.75692875306396,38.579334291667976,0.061249909565392335,614.4392466545105,255.48644495010376,817.2838134765625,27247,3730,23517,23517,0,11,3891000.0
3891,3891999,21.757309844107066,38.57907516791311,0.06123564719985908,614.570193529129,255.5522859096527,817.5198059082031,27248,3730,23518,23518,0,11,3892000.0
3892,3892999,21.758305256133,38.579243148640906,0.06123044325993021,614.8194296360016,255.61855268478394,817.6836280822754,27265,3732,23533,23533,0,11,3893000.0
3893,3893999,21.759225385807827,38.58255763710973,0.06120155286413864,615.0058178901672,255.68484807014465,817.9300804138184,27268,3733,23535,23535,0,11,3894000.0
3894,3894999,21.7603092493179,38.58281407934064,0.061186559123956874,615.124308347702,255.75064325332642,818.2300682067871,27273,3733,23540,23540,0,11,3895000.0
3895,3895999,21.761935561659342,38.58396819374378,0.06118112915559859,615.3843441009521,255.8164927959442,818.2602958679199,27290,3735,23555,23555,0,11,3896000.0
3896,3896999,21.764069756756065,38.58675783509583,0.06118127882767521,615.7066428661346,255.88236093521118,818.2330513000488,27305,3738,23567,23567,0,11,3897000.0
3897,3897999,21.76614388269145,38.589391561205034,0.06117714284745357,615.8946123123169,255.94821333885193,818.634937286377,27317,3739,23578,23578,0,11,3898000.0
3898,3898999,21.767972699946455,38.591829398653836,0.06119371938560991,616.0189764499664,256.01299142837524,818.8147430419922,27317,3739,23578,23578,0,11,3899000.0
3899,3899999,21.770082278891962,38.595399906647145,0.06119238395939075,616.2649478912354,256.078373670578,818.8879737854004,27341,3741,23600,23600,0,11,3900000.0
3900,3900999,21.771718503027973,38.595670975257235,0.06120746209958727,616.4498097896576,256.14414405822754,819.1188812255859,27348,3742,23606,23606,0,11,3901000.0
3901,3901999,21.772178985003947,38.594173132164144,0.06120820668730076,616.5618238449097,256.2085361480713,819.3065490722656,27349,3742,23607,23607,0,11,3902000.0
3902,3902999,21.77073707564518,38.594845726029035,0.06120598396637966,616.6856210231781,256.2766125202179,819.7233924865723,27358,3742,23616,23616,0,11,3903000.0
3903,3903999,21.7685383478953,38.59156545710298,0.06120798727782595,616.8056058883667,256.34203267097473,819.9331855773926,27360,3742,23618,23618,0,11,3904000.0
3904,3904999,21.766548110315284,38.588377409210274,0.06121473559840129,617.0674448013306,256.4097189903259,819.9864387512207,27365,3744,23621,23621,0,11,3905000.0
3905,3905999,21.7648258043103,38.58672517257584,0.06121045104599787,617.2622363567352,256.4760458469391,820.0650825500488,27367,3745,23622,23622,0,11,3906000.0
3906,3906999,21.763149926246996,38.58406431030244,0.061202029226839816,617.3844056129456,256.5425615310669,820.2563362121582,27367,3745,23622,23622,0,11,3907000.0
3907,3907999,21.76188012729841,38.58156718217328,0.06119020286260057,617.5129919052124,256.60760974884033,820.4066581726074,27367,3745,23622,23622,0,11,3908000.0
3908,3908999,21.760806814940686,38.581755567472335,0.0611671792525913,617.7854483127594,256.67968678474426,820.447078704834,27382,3747,23635,23635,0,11,3909000.0
3909,3909999,21.759783159633848,38.57904016939574,0.06115209989349524,617.9735956192017,256.74569845199585,820.6101951599121,27387,3748,23639,23639,0,11,3910000.0
3910,3910999,21.759697482363492,38.57808018289622,0.061121724983026815,618.1084413528442,256.81285762786865,820.7451515197754,27387,3748,23639,23639,0,11,3911000.0
3911,3911999,21.7594647375229,38.57664436264067,0.06109645390621554,618.2340083122253,256.87887811660767,820.8365707397461,27387,3748,23639,23639,0,11,3912000.0
3912,3912999,21.759570252905444,38.57524237207662,0.06105918725489623,618.6269183158875,256.9457767009735,820.7346725463867,27406,3752,23654,23654,0,11,3913000.0
3913,3913999,21.761578463291723,38.583277066081,0.06096302479818483,618.8824260234833,257.0118844509125,820.9313087463379,27412,3754,23658,23658,0,11,3914000.0
3914,3914999,21.762694552204433,38.583192089087504,0.060925723197907344,619.0084178447723,257.07914900779724,821.1029396057129,27412,3754,23658,23658,0,11,3915000.0
3915,3915999,21.763796918885443,38.5829845896966,0.06089058271166414,619.1343612670898,257.1449570655823,821.2251853942871,27412,3754,23658,23658,0,11,3916000.0
3916,3916999,21.765314999761188,38.58326404001722,0.060865057716621096,619.2592027187347,257.2109725475311,821.4845771789551,27413,3754,23659,23659,0,11,3917000.0
3917,3917999,21.766811176718242,38.583848578786615,0.060833828308130666,619.4454424381256,257.2764835357666,821.5779838562012,27419,3755,23664,23664,0,11,3918000.0
3918,3918999,21.76857591036844,38.58466677013002,0.060824582702816654,619.6971943378448,257.34230947494507,821.6934051513672,27426,3757,23669,23669,0,11,3919000.0
3919,3919999,21.77057362075799,38.58590832757307,0.06079155952260973,619.8962836265564,257.40861439704895,821.998161315918,27437,3758,23679,23679,0,11,3920000.0
3920,3920999,21.77184248167557,38.58592901940783,0.06077955741759822,620.1423244476318,257.4740912914276,822.1044006347656,27450,3760,23690,23690,0,11,3921000.0
3921,3921999,21.774341124034677,38.58996477046262,0.06076843321691139,620.3865034580231,257.53935861587524,822.185604095459,27458,3762,23696,23696,0,11,3922000.0
3922,3922999,21.775745674093898,38.59045331767038,0.060746509095637724,620.5664837360382,257.60414838790894,822.307071685791,27464,3763,23701,23701,0,11,3923000.0
3923,3923999,21.77556049589815,38.589184963821324,0.060731473628274024,620.7436232566833,257.668493270874,822.545051574707,27471,3764,23707,23707,0,11,3924000.0
3924,3924999,21.77336494207597,38.58583481744075,0.06073848597836018,620.8669700622559,257.7339389324188,822.7589492797852,27473,3764,23709,23709,0,11,3925000.0
3925,3925999,21.77152499772933,38.58333100880867,0.06073648023095013,621.0122430324554,257.80995440483093,822.8856086730957,27473,3764,23709,23709,0,11,3926000.0
3926,3926999,21.769964878508194,38.58159654460853,0.06073312438992251,621.1412944793701,257.8756194114685,822.9598655700684,27473,3764,23709,23709,0,11,3927000.0
3927,3927999,21.768296171851407,38.57920523353684,0.060734485392087256,621.2754747867584,257.9418931007385,823.0564804077148,27473,3764,23709,23709,0,11,3928000.0
3928,3928999,21.767044380198037,38.57741262407298,0.06072481117851036,621.4133749008179,258.0071370601654,823.2137069702148,27475,3764,23711,23711,0,11,3929000.0
3929,3929999,21.766042204995383,38.57483971957047,0.0607164811275096,621.5352356433868,258.0720467567444,823.3060874938965,27475,3764,23711,23711,0,11,3930000.0
3930,3930999,21.765086213314433,38.5724287669084,0.060707591355825374,621.6723120212555,258.14469718933105,823.3568687438965,27475,3764,23711,23711,0,11,3931000.0
3931,3931999,21.76403082190475,38.56959867579726,0.06070079109550597,621.8947932720184,258.21567463874817,823.5035972595215,27480,3765,23715,23715,0,11,3932000.0
3932,3932999,21.763225851503258,38.567414483550145,0.06068798926039265,622.1575365066528,258.282164812088,823.484302520752,27484,3767,23717,23717,0,11,3933000.0
3933,3933999,21.7631988032936,38.57021117689424,0.06066011190633158,622.3513185977936,258.3482828140259,823.5611419677734,27492,3768,23724,23724,0,11,3934000.0
3934,3934999,21.762767300962977,38.56852710249064,0.060644355443746134,622.6127672195435,258.4147491455078,823.7755317687988,27499,3770,23729,23729,0,11,3935000.0
3935,3935999,21.762955011935116,38.56824734452617,0.06062122973301309,622.7322900295258,258.4804685115814,823.9398307800293,27500,3770,23730,23730,0,11,3936000.0
3936,3936999,21.76353222735159,38.56799011583635,0.060616663738632615,622.9825789928436,258.54760360717773,823.9438247680664,27513,3772,23741,23741,0,11,3937000.0
3937,3937999,21.76478342745925,38.568867807628344,0.06061452956006497,623.2359862327576,258.6137101650238,824.2100868225098,27521,3774,23747,23747,0,11,3938000.0
3938,3938999,21.765766810916016,38.56893489411884,0.060594808911337394,623.4886786937714,258.67994499206543,824.2871360778809,27535,3776,23759,23759,0,11,3939000.0
3939,3939999,21.76764614459693,38.570285434916364,0.06058600238908529,623.6270530223846,258.7464780807495,824.3772125244141,27535,3776,23759,23759,0,11,3940000.0
3940,3940999,21.769591823407605,38.57141436912681,0.06059081280121992,623.8195853233337,258.81369042396545,824.6856994628906,27551,3777,23774,23774,0,11,3941000.0
3941,3941999,21.77169911121836,38.57249007590012,0.060595376595749983,624.0051870346069,258.8788287639618,824.8225975036621,27557,3778,23779,23779,0,11,3942000.0
3942,3942999,21.772570109030095,38.57188029657211,0.060597398294314986,624.3162291049957,258.9446439743042,824.8574981689453,27573,3781,23792,23792,0,11,3943000.0
3943,3943999,21.773547685000672,38.57129657589317,0.06060338722294678,624.4505677223206,259.01655173301697,824.9655265808105,27573,3781,23792,23792,0,11,3944000.0
3944,3944999,21.77334507381811,38.569507910056636,0.060597591092804826,624.6326720714569,259.08104944229126,825.0296401977539,27578,3782,23796,23796,0,11,3945000.0
3945,3945999,21.771868123094883,38.5689341436785,0.06058843304417272,624.755047082901,259.1461477279663,825.1785087585449,27578,3782,23796,23796,0,11,3946000.0
3946,3946999,21.77048242249875,38.568576203209666,0.060583758380493125,624.8904292583466,259.2159550189972,825.5021820068359,27583,3782,23801,23801,0,11,3947000.0
3947,3947999,21.769809025136887,38.570889818910466,0.060568927546843065,625.0087792873383,259.28201246261597,825.619213104248,27583,3782,23801,23801,0,11,3948000.0
3948,3948999,21.76971424473611,38.57334854160021,0.06061301716286582,625.2775144577026,259.3488976955414,825.6741256713867,27592,3784,23808,23808,0,11,3949000.0
3949,3949999,21.770204800150978,38.578555122830224,0.060615292569501045,625.4847285747528,259.4153461456299,825.8106918334961,27595,3785,23810,23810,0,11,3950000.0
3950,3950999,21.770467198446752,38.580495475656846,0.06060767307600834,625.8641412258148,259.48250699043274,825.7830276489258,27603,3789,23814,23814,0,11,3951000.0
3951,3951999,21.77101012512609,38.58372460853923,0.06059157590505593,625.9848048686981,259.5482847690582,825.9231948852539,27603,3789,23814,23814,0,11,3952000.0
3952,3952999,21.771937159709164,38.58657569530983,0.06059105195839021,626.1796219348907,259.61459946632385,826.0068206787109,27611,3790,23821,23821,0,11,3953000.0
3953,3953999,21.77327694427895,38.59217150167001,0.060571540765509746,626.4401996135712,259.6818823814392,826.0843124389648,27615,3792,23823,23823,0,11,3954000.0
3954,3954999,21.77451927277514,38.59561583701456,0.060573742586215396,626.5615751743317,259.7480001449585,826.1930122375488,27615,3792,23823,23823,0,11,3955000.0
3955,3955999,21.776190312189236,38.60033266076362,0.06058217594120474,626.7615213394165,259.8140904903412,826.385498046875,27621,3793,23828,23828,0,11,3956000.0
3956,3956999,21.777270715040284,38.603468700525056,0.06059813583003326,626.8889498710632,259.8805649280548,826.561580657959,27621,3793,23828,23828,0,11,3957000.0
3957,3957999,21.778822227423632,38.60570153952753,0.06061410479770679,627.0059187412262,259.9460837841034,826.6728248596191,27621,3793,23828,23828,0,11,3958000.0
3958,3958999,21.780713152484054,38.60885676415602,0.06063460291969336,627.2557046413422,260.01189661026,826.7607345581055,27645,3795,23850,23850,0,11,3959000.0
3959,3959999,21.782976926939558,38.611745291512584,0.06066632231820035,627.5039987564087,260.07807207107544,826.759765625,27653,3797,23856,23856,0,11,3960000.0
3960,3960999,21.785781150588587,38.61581960287689,0.06071616899815224,627.8435773849487,260.145653963089,826.762752532959,27668,3800,23868,23868,0,11,3961000.0
3961,3961999,21.790418393862225,38.63335874520989,0.06075598947196792,628.0433518886566,260.2112593650818,827.0128707885742,27678,3801,23877,23877,0,11,3962000.0
3962,3962999,21.793845823229557,38.64023626081281,0.06084045424155449,628.4970192909241,260.27788639068604,826.9402770996094,27701,3806,23895,23895,0,11,3963000.0
3963,3963999,21.79784781116368,38.64845923471269,0.0609022000258973,628.6860182285309,260.3435688018799,827.0927429199219,27708,3807,23901,23901,0,11,3964000.0
3964,3964999,21.80082463996957,38.65279988570298,0.06093975641719962,628.876971244812,260.4088771343231,827.2160110473633,27715,3808,23907,23907,0,11,3965000.0
3965,3965999,21.801194061197585,38.65621707270315,0.06093856422462729,629.0093517303467,260.47980761528015,827.4967422485352,27718,3808,23910,23910,0,11,3966000.0
3966,3966999,21.79979711849519,38.65642497104544,0.060926185182007764,629.2180380821228,260.5577218532562,827.651554107666,27722,3809,23913,23913,0,11,3967000.0
3967,3967999,21.798842495055816,38.65669611614042,0.06091937455861929,629.4260151386261,260.626256942749,827.7209625244141,27729,3810,23919,23919,0,11,3968000.0
3968,3968999,21.79846693379215,38.6582492562997,0.060911566857321686,629.7447810173035,260.6930236816406,827.677074432373,27745,3813,23932,23932,0,11,3969000.0
3969,3969999,21.798132379346324,38.658326239963834,0.06092947941422644,629.9530906677246,260.76199769973755,827.7650604248047,27752,3814,23938,23938,0,11,3970000.0
3970,3970999,21.798770277922046,38.65985394254101,0.060911528895741585,630.218252658844,260.82984256744385,827.7919769287109,27764,3816,23948,23948,0,11,3971000.0
3971,3971999,21.799626117681957,38.6611543799428,0.06090308161272573,630.3606770038605,260.9003176689148,827.9096183776855,27764,3816,23948,23948,0,11,3972000.0
3972,3972999,21.801276904639202,38.66511918732087,0.06089723805277003,630.4844989776611,260.9676237106323,828.0748519897461,27764,3816,23948,23948,0,11,3973000.0
3973,3973999,21.803278194349737,38.66955575373039,0.060887985068658446,630.7370004653931,261.0336911678314,827.9827346801758,27778,3818,23960,23960,0,11,3974000.0
3974,3974999,21.805941797439907,38.674127608800106,0.06088848815338066,630.9181516170502,261.10013127326965,828.0870399475098,27784,3819,23965,23965,0,11,3975000.0
3975,3975999,21.810195408386324,38.68270823085883,0.06094866273374733,631.1083054542542,261.1663007736206,828.1922874450684,27790,3820,23970,23970,0,11,3976000.0
3976,3976999,21.815383438827713,38.698653558832305,0.06102551438852266,631.4379758834839,261.2327661514282,828.1227149963379,27801,3823,23978,23978,0,11,3977000.0
3977,3977999,21.820963596784004,38.70697708494748,0.06121021746600297,631.6980135440826,261.29905581474304,828.1680679321289,27808,3825,23983,23983,0,11,3978000.0
3978,3978999,21.82721337581955,38.71703095587041,0.06137981135248449,631.957756280899,261.36656379699707,828.2385444641113,27817,3827,23990,23990,0,11,3979000.0
3979,3979999,21.833218158248318,38.730067702424144,0.06144387580158317,632.2061252593994,261.43287420272827,828.4272193908691,27824,3829,23995,23995,0,11,3980000.0
3980,3980999,21.840944720035786,38.74719503746627,0.06165389682182576,632.4613635540009,261.4992051124573,828.4875907897949,27836,3831,24005,24005,0,11,3981000.0
3981,3981999,21.847617936058665,38.76006583171518,0.0618024322593278,632.9256508350372,261.56622099876404,828.4779930114746,27862,3836,24026,24026,0,11,3982000.0
3982,3982999,21.854474028067948,38.773327693391145,0.06196536335850422,633.5717129707336,261.63465881347656,828.2858276367188,27910,3844,24066,24066,0,11,3983000.0
3983,3983999,21.860293618958377,38.78152537222966,0.062170752191167966,633.8201065063477,261.7004642486572,828.3871116638184,27923,3846,24077,24077,0,11,3984000.0
3984,3984999,21.866129474521042,38.79204741206934,0.06239324033006732,634.1306066513062,261.7659504413605,828.5265922546387,27940,3849,24091,24091,0,11,3985000.0
3985,3985999,21.87067423968247,38.801627270299086,0.0625131733358838,634.3168799877167,261.8308744430542,828.6284103393555,27942,3850,24092,24092,0,11,3986000.0
3986,3986999,21.869112040912363,38.80046084520703,0.0625049013127903,634.5062253475189,261.898069858551,828.7855834960938,27951,3851,24100,24100,0,11,3987000.0
3987,3987999,21.867457118822657,38.79863673849065,0.06249772204313675,634.6379227638245,261.96396803855896,828.9180717468262,27951,3851,24100,24100,0,11,3988000.0
3988,3988999,21.86630621843982,38.79732630048317,0.062488760873701366,634.8943841457367,262.0303511619568,828.8608436584473,27955,3853,24102,24102,0,11,3989000.0
3989,3989999,21.86530944964385,38.79738208062138,0.06247244375576355,635.0304210186005,262.10598707199097,828.946605682373,27955,3853,24102,24102,0,11,3990000.0
3990,3990999,21.8639906315546,38.79527435422754,0.06246369636870297,635.1678311824799,262.1772780418396,829.0987586975098,27956,3853,24103,24103,0,11,3991000.0
3991,3991999,21.862704416660485,38.793011002784375,0.062457737130481084,635.2954065799713,262.2427637577057,829.1980171203613,27956,3853,24103,24103,0,11,3992000.0
3992,3992999,21.86195125782602,38.79172750824986,0.06244514346489316,635.5568904876709,262.3085868358612,829.1868019104004,27969,3855,24114,24114,0,11,3993000.0
3993,3993999,21.86153348370702,38.79083834526993,0.06242855003197123,635.6804435253143,262.3738548755646,829.289493560791,27969,3855,24114,24114,0,11,3994000.0
3994,3994999,21.861085695743103,38.789827970411096,0.062405351356653704,635.9509813785553,262.43994188308716,829.22802734375,27994,3857,24137,24137,0,11,3995000.0
3995,3995999,21.860702752684613,38.78878677457395,0.062392805742213286,636.0693490505219,262.50558066368103,829.3100242614746,27994,3857,24137,24137,0,11,3996000.0
3996,3996999,21.8610554912298,38.78897654262984,0.06237365696508401,636.2676248550415,262.57163858413696,829.4523124694824,28001,3858,24143,24143,0,11,3997000.0
3997,3997999,21.86182500404973,38.7891906274708,0.062347804586523226,636.4537980556488,262.6372275352478,829.5789031982422,28007,3859,24148,24148,0,11,3998000.0
3998,3998999,21.86293124068426,38.79036508308069,0.06239121518612312,636.7726697921753,262.7034454345703,829.5850868225098,28014,3862,24152,24152,0,11,3999000.0
3999,3999999,21.8639518524804,38.7907699706408,0.06240849064954557,636.9544818401337,262.77046513557434,829.8776626586914,28017,3863,24154,24154,0,11,4000000.0
4000,4000999,21.865270179249165,38.79196290588866,0.06241831232466699,637.1524250507355,262.83684182167053,830.0445442199707,28023,3864,24159,24159,0,11,4001000.0
4001,4001999,21.866709513396373,38.79265659096863,0.0624318472036165,637.359902381897,262.9081151485443,830.1419525146484,28030,3865,24165,24165,0,11,4002000.0
4002,4002999,21.86759555767394,38.792158309933406,0.06244220149728252,637.694721698761,262.9744083881378,830.2480964660645,28043,3868,24175,24175,0,11,4003000.0
4003,4003999,21.86898159204599,38.79296288266043,0.0624334804002592,638.0825397968292,263.0405058860779,830.2443962097168,28063,3872,24191,24191,0,11,4004000.0
4004,4004999,21.870141404457943,38.793097528273876,0.06242938362346606,638.3473136425018,263.10632967948914,830.2917594909668,28072,3874,24198,24198,0,11,4005000.0
4005,4005999,21.87117048713299,38.79294472664086,0.06244599546923557,638.461154460907,263.17113852500916,830.5407867431641,28074,3874,24200,24200,0,11,4006000.0
4006,4006999,21.871153318521362,38.79146165788124,0.062463554682924305,638.645500421524,263.2357609272003,830.6524276733398,28081,3875,24206,24206,0,11,4007000.0
4007,4007999,21.869428984633604,38.78846057973451,0.062461093241979126,638.7680158615112,263.3001437187195,830.8849411010742,28085,3875,24210,24210,0,11,4008000.0
4008,4008999,21.8675219463977,38.7863407513691,0.06246583419630447,638.9592852592468,263.3674621582031,831.019905090332,28090,3876,24214,24214,0,11,4009000.0
4009,4009999,21.86586893139721,38.78662832480298,0.06245968084985665,639.2149426937103,263.43408155441284,831.1505126953125,28123,3878,24245,24245,0,11,4010000.0
4010,4010999,21.863956132545496,38.78369652037319,0.062471268499813104,639.3431367874146,263.5002806186676,831.2469215393066,28123,3878,24245,24245,0,11,4011000.0
4011,4011999,21.862355925208647,38.78081871171161,0.062470836743084956,639.4682841300964,263.56659150123596,831.4915046691895,28123,3878,24245,24245,0,11,4012000.0
4012,4012999,21.861042774776973,38.77809482508728,0.06246550190028788,639.6660461425781,263.63198947906494,831.5776557922363,28125,3879,24246,24246,0,11,4013000.0
4013,4013999,21.85956085246399,38.775425218582704,0.06246218772108547,639.9970109462738,263.6979401111603,831.5948753356934,28131,3882,24249,24249,0,11,4014000.0
4014,4014999,21.85863358436521,38.77385130502405,0.06244475468360078,640.1412763595581,263.76548409461975,831.7826766967773,28131,3882,24249,24249,0,11,4015000.0
4015,4015999,21.857598595687826,38.771288047059116,0.06243413177416879,640.3287744522095,263.8315284252167,831.8045539855957,28133,3883,24250,24250,0,11,4016000.0
4016,4016999,21.856658468447918,38.77065692695137,0.06241744849606967,640.4650683403015,263.89737200737,831.866024017334,28133,3883,24250,24250,0,11,4017000.0
4017,4017999,21.855714505316538,38.76855124853542,0.06240147177791111,640.5811743736267,263.96291279792786,832.073974609375,28134,3883,24251,24251,0,11,4018000.0
4018,4018999,21.854744469682732,38.766339252440986,0.0623912404081014,640.7030308246613,264.02842712402344,832.2006530761719,28134,3883,24251,24251,0,11,4019000.0
4019,4019999,21.854834403419343,38.7717516453367,0.062351021569419074,640.8892338275909,264.09411573410034,832.2408790588379,28136,3884,24252,24252,0,11,4020000.0
4020,4020999,21.854686992454987,38.77136097154292,0.06233284701428832,641.0831825733185,264.1608200073242,832.4564819335938,28157,3885,24272,24272,0,11,4021000.0
4021,4021999,21.855213165805907,38.77308283781136,0.06231306375686141,641.2772116661072,264.22663593292236,832.5096626281738,28159,3886,24273,24273,0,11,4022000.0
4022,4022999,21.855734347480045,38.77199869628147,0.0623033762227625,641.4893403053284,264.29295802116394,832.6260299682617,28167,3887,24280,24280,0,11,4023000.0
4023,4023999,21.856644974004283,38.77300196671001,0.06228876579528131,641.6823616027832,264.3582489490509,832.7210540771484,28169,3888,24281,24281,0,11,4024000.0
4024,4024999,21.857455271703888,38.772177086866364,0.06227422196273735,641.9405484199524,264.42333483695984,832.7418899536133,28186,3890,24296,24296,0,11,4025000.0
4025,4025999,21.857040965772033,38.77028543861225,0.06226340362564664,642.0576756000519,264.48746156692505,832.8412055969238,28186,3890,24296,24296,0,11,4026000.0
4026,4026999,21.855418736454272,38.76776999489142,0.06226605984189382,642.1816599369049,264.55244159698486,833.0181159973145,28186,3890,24296,24296,0,11,4027000.0
4027,4027999,21.85379830342607,38.76665327488648,0.06226634288195221,642.3087160587311,264.6188271045685,833.195873260498,28187,3890,24297,24297,0,11,4028000.0
4028,4028999,21.851893148750218,38.76343626091972,0.06228002100604357,642.4495007991791,264.68545722961426,833.2691268920898,28187,3890,24297,24297,0,11,4029000.0
4029,4029999,21.850098658745537,38.76081889287717,0.06228074392921068,642.702662229538,264.75224137306213,833.3024368286133,28199,3892,24307,24307,0,11,4030000.0
4030,4030999,21.84877032231367,38.75927456632874,0.062274248936793564,642.9007604122162,264.81804895401,833.5145683288574,28202,3893,24309,24309,0,11,4031000.0
4031,4031999,21.847023480766932,38.75597070652956,0.06227496161298485,643.2259776592255,264.88458037376404,833.5443115234375,28214,3896,24318,24318,0,11,4032000.0
4032,4032999,21.845764820813734,38.75429126835931,0.062265678044092554,643.4809639453888,264.95236372947693,833.8510704040527,28258,3898,24360,24360,0,11,4033000.0
4033,4033999,21.844890820171173,38.75772560304765,0.062243139668493486,643.6032671928406,265.0186388492584,834.0116157531738,28258,3898,24360,24360,0,11,4034000.0
4034,4034999,21.84398102987934,38.75601589884539,0.062236114676584076,643.7282648086548,265.0844988822937,834.0976982116699,28258,3898,24360,24360,0,11,4035000.0
4035,4035999,21.84318799482956,38.754503370406454,0.06222666906188856,644.0571670532227,265.15128660202026,834.0891494750977,28269,3901,24368,24368,0,11,4036000.0
4036,4036999,21.843117757780615,38.755626060145204,0.06219179191804436,644.3181111812592,265.2176933288574,834.2559242248535,28293,3903,24390,24390,0,11,4037000.0
4037,4037999,21.842947007891947,38.754356965325506,0.06216269774696981,644.4485564231873,265.2846689224243,834.3922309875488,28293,3903,24390,24390,0,11,4038000.0
4038,4038999,21.84273933147158,38.75386367037788,0.06213829891953204,644.576827287674,265.35061717033386,834.484203338623,28293,3903,24390,24390,0,11,4039000.0
4039,4039999,21.84293418773757,38.75521309251744,0.0621116164153388,644.8294353485107,265.41653656959534,834.5959739685059,28300,3905,24395,24395,0,11,4040000.0
4040,4040999,21.84289129767027,38.753832564576165,0.06209771475283743,644.962652683258,265.4823365211487,834.7365989685059,28300,3905,24395,24395,0,11,4041000.0
4041,4041999,21.84388719090602,38.75372908605134,0.06208072289518596,645.1682298183441,265.54793643951416,834.8614616394043,28308,3906,24402,24402,0,11,4042000.0
4042,4042999,21.844428536181976,38.75276644206149,0.062063898912111504,645.4367980957031,265.6161005496979,835.041088104248,28317,3908,24409,24409,0,11,4043000.0
4043,4043999,21.845409786567004,38.752517465338926,0.06204786596464573,645.5536150932312,265.68092346191406,835.1708221435547,28317,3908,24409,24409,0,11,4044000.0
4044,4044999,21.84638000599201,38.75202317953343,0.062041772122042094,645.6674091815948,265.7458245754242,835.3976936340332,28320,3908,24412,24412,0,11,4045000.0
4045,4045999,21.846768535238425,38.7508740405971,0.06202654563387011,645.8522844314575,265.810391664505,835.5208358764648,28327,3909,24418,24418,0,11,4046000.0
4046,4046999,21.845731124965596,38.749349746068,0.062028502751595105,646.1260118484497,265.8757908344269,835.6620292663574,28341,3911,24430,24430,0,11,4047000.0
4047,4047999,21.843427478405978,38.74808264231076,0.06203417255198951,646.3134868144989,265.9421772956848,835.8239250183105,28349,3912,24437,24437,0,11,4048000.0
4048,4048999,21.84130128633891,38.74506307839152,0.06204387609719908,646.4997169971466,266.0081181526184,835.918888092041,28351,3913,24438,24438,0,11,4049000.0
4049,4049999,21.83939585170265,38.74270306360331,0.06204742419358078,646.6366620063782,266.07458782196045,836.0199203491211,28351,3913,24438,24438,0,11,4050000.0
4050,4050999,21.83755599506793,38.73968374334362,0.06205138293489754,646.9636104106903,266.14217948913574,836.0387001037598,28360,3916,24444,24444,0,11,4051000.0
4051,4051999,21.83621971376192,38.737233996249,0.06204240250993753,647.084584236145,266.20763421058655,836.245922088623,28360,3916,24444,24444,0,11,4052000.0
4052,4052999,21.835299601029536,38.735768711064885,0.06203282145112965,647.4127924442291,266.2731626033783,836.2124404907227,28375,3919,24456,24456,0,11,4053000.0
4053,4053999,21.834700408206004,38.734372243948165,0.062025461801246684,647.6773178577423,266.3390600681305,836.1620178222656,28384,3921,24463,24463,0,11,4054000.0
4054,4054999,21.834225420488256,38.73330427567675,0.06201633720633681,647.8005714416504,266.4060471057892,836.2796974182129,28384,3921,24463,24463,0,11,4055000.0
4055,4055999,21.834166454500874,38.733228961215715,0.06200342322879904,648.2651007175446,266.4729914665222,836.0978012084961,28412,3926,24486,24486,0,11,4056000.0
4056,4056999,21.834527035325728,38.734114747231864,0.062004566731366006,648.4600784778595,266.53900241851807,836.1797218322754,28420,3927,24493,24493,0,11,4057000.0
4057,4057999,21.83531341820958,38.73546034382992,0.061996784337211897,648.7927598953247,266.60530066490173,836.2218856811523,28431,3930,24501,24501,0,11,4058000.0
4058,4058999,21.836353461779048,38.73773386568863,0.06198722582832772,648.9193980693817,266.67113876342773,836.3776054382324,28431,3930,24501,24501,0,11,4059000.0
4059,4059999,21.83760946710179,38.7393755327511,0.06198707103358514,649.0441265106201,266.738981962204,836.4989433288574,28432,3930,24502,24502,0,11,4060000.0
4060,4060999,21.83890182029587,38.74063970995069,0.06197174170147823,649.3001444339752,266.80514883995056,836.6417999267578,28443,3932,24511,24511,0,11,4061000.0
4061,4061999,21.840895370643548,38.743240331801985,0.061966381948989624,649.4891912937164,266.8712294101715,836.7385215759277,28445,3933,24512,24512,0,11,4062000.0
4062,4062999,21.84309299287336,38.745768576549864,0.061970456094151416,649.8167355060577,266.93774032592773,836.7594299316406,28465,3936,24529,24529,0,11,4063000.0
4063,4063999,21.84533570624865,38.74785234723446,0.061955347268711325,650.0784842967987,267.0055751800537,837.1160049438477,28483,3938,24545,24545,0,11,4064000.0
4064,4064999,21.8470495251567,38.74909707281697,0.061949038427353,650.5351305007935,267.0717477798462,837.1319808959961,28508,3943,24565,24565,0,11,4065000.0
4065,4065999,21.849055587453933,38.75044195621879,0.061949191957675676,650.720897436142,267.1368942260742,837.2473220825195,28515,3944,24571,24571,0,11,4066000.0
4066,4066999,21.850321041900006,38.75047141690398,0.06194424316872704,651.0514950752258,267.20675468444824,837.3427200317383,28544,3947,24597,24597,0,11,4067000.0
4067,4067999,21.851396786700654,38.75299146800747,0.061936875032419625,651.3113131523132,267.273845911026,837.5279960632324,28553,3949,24604,24604,0,11,4068000.0
4068,4068999,21.8492610703002,38.749656102603595,0.06194606839151473,651.5009438991547,267.33935809135437,837.7204627990723,28555,3950,24605,24605,0,11,4069000.0
4069,4069999,21.84733256211502,38.747159646975575,0.06195569591926109,651.7589900493622,267.4058084487915,837.8323669433594,28560,3952,24608,24608,0,11,4070000.0
4070,4070999,21.84564385768265,38.74711974894582,0.061950899728559716,652.01677775383,267.4724450111389,837.8616104125977,28565,3954,24611,24611,0,11,4071000.0
4071,4071999,21.84358993137994,38.743928956047164,0.06196309965971647,652.2183337211609,267.53938722610474,837.9854469299316,28567,3955,24612,24612,0,11,4072000.0
4072,4072999,21.84171539842356,38.74128676761153,0.06197155113580399,652.557327747345,267.605459690094,838.0186882019043,28576,3958,24618,24618,0,11,4073000.0
4073,4073999,21.840122936423363,38.73936915821727,0.06197659132016653,652.7494904994965,267.67052245140076,838.091365814209,28584,3959,24625,24625,0,11,4074000.0
4074,4074999,21.838382764260157,38.73627110015845,0.06197894340811971,652.8706431388855,267.7352623939514,838.1783905029297,28584,3959,24625,24625,0,11,4075000.0
4075,4075999,21.837049588887837,38.734018576025235,0.061979518866922545,653.0698525905609,267.80177760124207,838.4220085144043,28588,3960,24628,24628,0,11,4076000.0
4076,4076999,21.83551974201088,38.73091804065369,0.061980077293175784,653.2704215049744,267.8678603172302,838.4850044250488,28590,3961,24629,24629,0,11,4077000.0
4077,4077999,21.834183880268483,38.72848952749547,0.06198297625246296,653.5332865715027,267.9353449344635,838.5145606994629,28595,3963,24632,24632,0,11,4078000.0
4078,4078999,21.832988049307705,38.72597522812061,0.061976094564118456,653.6554412841797,268.001336812973,838.7480583190918,28596,3963,24633,24633,0,11,4079000.0
4079,4079999,21.832308121718377,38.723855848891795,0.0619592182522859,653.9057428836823,268.067010641098,838.8452682495117,28611,3965,24646,24646,0,11,4080000.0
4080,4080999,21.83183415449411,38.72229825718057,0.0619411657653286,654.0369007587433,268.13286113739014,839.046875,28611,3965,24646,24646,0,11,4081000.0
4081,4081999,21.831172502314757,38.72007633014264,0.0619186443505656,654.2269585132599,268.1987187862396,839.2158050537109,28620,3966,24654,24654,0,11,4082000.0
4082,4082999,21.83113721505036,38.72196696698044,0.06188382401122461,654.4859442710876,268.26562118530273,839.218994140625,28629,3968,24661,24661,0,11,4083000.0
4083,4083999,21.831220928984035,38.7210233483752,0.061858882999388576,654.7483155727386,268.3320004940033,839.3449974060059,28648,3970,24678,24678,0,11,4084000.0
4084,4084999,21.831225820232977,38.719605675775995,0.06183874780300569,655.0188176631927,268.3983187675476,839.5293960571289,28660,3972,24688,24688,0,11,4085000.0
4085,4085999,21.831056662819915,38.717651713559036,0.06182174308917543,655.3707025051117,268.46573424339294,839.5343589782715,28672,3975,24697,24697,0,11,4086000.0
4086,4086999,21.830687855856567,38.71548178218055,0.06181254466199371,655.6331136226654,268.531378030777,839.6147804260254,28686,3977,24709,24709,0,11,4087000.0
4087,4087999,21.83057608702188,38.71339119486177,0.061796483416672876,655.7550413608551,268.59805488586426,839.7761459350586,28687,3977,24710,24710,0,11,4088000.0
4088,4088999,21.829890251662217,38.71102719328975,0.06178581657935256,655.8813428878784,268.6625370979309,839.8866958618164,28687,3977,24710,24710,0,11,4089000.0
4089,4089999,21.828146891020683,38.70775721457444,0.061783141992311164,655.9988589286804,268.7272708415985,840.1847343444824,28694,3977,24717,24717,0,11,4090000.0
4090,4090999,21.82625256655231,38.70426676205515,0.06178568052985611,656.325811624527,268.7939088344574,840.3252105712891,28736,3980,24756,24756,0,11,4091000.0
4091,4091999,21.8242917885254,38.70102520200694,0.061788818403694434,656.5178322792053,268.86132049560547,840.4078712463379,28743,3981,24762,24762,0,11,4092000.0
4092,4092999,21.82263155747007,38.6979350048322,0.061794764175957084,656.7055952548981,268.927939414978,840.4669380187988,28745,3982,24763,24763,0,11,4093000.0
4093,4093999,21.821377311603555,38.695461118377814,0.06179003340490741,656.8376438617706,268.99565148353577,840.6119575500488,28746,3982,24764,24764,0,11,4094000.0
4094,4094999,21.820219550004357,38.692967527677965,0.061785789293138715,656.9550485610962,269.0610902309418,840.7952690124512,28746,3982,24764,24764,0,11,4095000.0
4095,4095999,21.819078413344542,38.68996882402266,0.06177884816869328,657.2124967575073,269.12745213508606,840.8444709777832,28750,3984,24766,24766,0,11,4096000.0
4096,4096999,21.81838086509806,38.68766056225381,0.061758533482961675,657.4061481952667,269.1938683986664,840.9967765808105,28758,3985,24773,24773,0,11,4097000.0
4097,4097999,21.817936449247483,38.68628973110372,0.06172882812127922,657.6041572093964,269.2617783546448,841.1386947631836,28760,3986,24774,24774,0,11,4098000.0
4098,4098999,21.817684948150937,38.684927953033245,0.06170327289393063,657.7880601882935,269.3286232948303,841.243724822998,28762,3987,24775,24775,0,11,4099000.0
4099,4099999,21.816936218068793,38.68321027424946,0.06169018233664991,658.0454320907593,269.3954117298126,841.3629913330078,28771,3989,24782,24782,0,11,4100000.0
4100,4100999,21.81701668272778,38.681959929638886,0.06166286467370041,658.3080811500549,269.46125864982605,841.5569877624512,28781,3991,24790,24790,0,11,4101000.0
4101,4101999,21.817819104927466,38.685339191606886,0.06166421718882953,658.5001020431519,269.5272889137268,841.7332038879395,28794,3992,24802,24802,0,11,4102000.0
4102,4102999,21.818017462727813,38.6839412844679,0.06164886159478422,658.6240367889404,269.59281277656555,841.9401702880859,28794,3992,24802,24802,0,11,4103000.0
4103,4103999,21.818986995752045,38.68353720945834,0.061622434682717,658.8096182346344,269.65902280807495,842.2457466125488,28802,3993,24809,24809,0,11,4104000.0
4104,4104999,21.819942975471413,38.6834717344658,0.06158892393540516,659.2005088329315,269.7260568141937,842.2294006347656,28810,3997,24813,24813,0,11,4105000.0
4105,4105999,21.82064743784628,38.68287209603226,0.06156844706821352,659.4754350185394,269.7950232028961,842.389045715332,28820,3999,24821,24821,0,11,4106000.0
4106,4106999,21.822007458621577,38.6827675802757,0.06153540823055903,659.7388544082642,269.8608305454254,842.5741806030273,28828,4001,24827,24827,0,11,4107000.0
4107,4107999,21.82311885189267,38.682366678728165,0.06151429903034222,660.0601449012756,269.9272003173828,842.578441619873,28842,4004,24838,24838,0,11,4108000.0
4108,4108999,21.824421104173314,38.681894743814674,0.061506490766254585,660.2480387687683,269.9936215877533,842.7268905639648,28852,4005,24847,24847,0,11,4109000.0
4109,4109999,21.82515655005021,38.68054840183373,0.061491645738099954,660.4293923377991,270.0586621761322,842.9212951660156,28855,4006,24849,24849,0,11,4110000.0
4110,4110999,21.824636416919258,38.678856745966996,0.06149057067649066,660.5476605892181,270.12360310554504,843.2510566711426,28861,4006,24855,24855,0,11,4111000.0
4111,4111999,21.822909726064243,38.676200414241706,0.06149896551038758,660.7382354736328,270.1893148422241,843.455078125,28866,4007,24859,24859,0,11,4112000.0
4112,4112999,21.82191670203584,38.674558173822525,0.06151182310739722,661.0080242156982,270.25650000572205,843.6167106628418,28870,4009,24861,24861,0,11,4113000.0
4113,4113999,21.82154398197562,38.67451350509992,0.061529481954813,661.1333048343658,270.32391476631165,843.7257232666016,28870,4009,24861,24861,0,11,4114000.0
4114,4114999,21.821459689506998,38.674904395737215,0.06151931775519426,661.331125497818,270.3911998271942,843.765811920166,28872,4010,24862,24862,0,11,4115000.0
4115,4115999,21.821539268013026,38.67446283607886,0.06151220803805191,661.4613044261932,270.457257270813,844.0109214782715,28874,4010,24864,24864,0,11,4116000.0
4116,4116999,21.821977516561756,38.674302731375725,0.06150667334876592,661.7953839302063,270.5239489078522,844.0529861450195,28880,4013,24867,24867,0,11,4117000.0
4117,4117999,21.822285118267658,38.674998233881176,0.061489357304109316,661.9254343509674,270.59013175964355,844.2722511291504,28885,4013,24872,24872,0,11,4118000.0
4118,4118999,21.822870911832144,38.67842487868887,0.061472870227992304,662.0420854091644,270.65719962120056,844.5790519714355,28889,4013,24876,24876,0,11,4119000.0
4119,4119999,21.823773297563324,38.678974505451826,0.061462743160439315,662.2947683334351,270.7236568927765,844.6847457885742,28893,4015,24878,24878,0,11,4120000.0
4120,4120999,21.824575233043845,38.679281548599256,0.06146869945986322,662.4150681495667,270.7895531654358,844.8515434265137,28893,4015,24878,24878,0,11,4121000.0
4121,4121999,21.825755202181814,38.68063213467555,0.061454105482983135,662.6206033229828,270.8555340766907,844.944034576416,28897,4016,24881,24881,0,11,4122000.0
4122,4122999,21.827482572231855,38.68207918292343,0.06145755031225275,662.751077413559,270.9207675457001,845.012752532959,28897,4016,24881,24881,0,11,4123000.0
4123,4123999,21.829094113702865,38.68378558148596,0.0614706416274996,662.9446423053741,270.9858977794647,845.042423248291,28899,4017,24882,24882,0,11,4124000.0
4124,4124999,21.831253912168677,38.687796795745385,0.06148700468771273,663.2106676101685,271.05235147476196,845.1240119934082,28911,4019,24892,24892,0,11,4125000.0
4125,4125999,21.833477527021714,38.689773692365215,0.06149169144641564,663.5534610748291,271.1194040775299,845.1624565124512,28927,4022,24905,24905,0,11,4126000.0
4126,4126999,21.83624980345226,38.69286531248306,0.06152421601638558,663.829975605011,271.1859302520752,845.1702346801758,28936,4024,24912,24912,0,11,4127000.0
4127,4127999,21.83861444017758,38.6950898476704,0.061536945225513895,664.0896210670471,271.25237560272217,845.5628089904785,28970,4026,24944,24944,0,11,4128000.0
4128,4128999,21.841851321227903,38.702928556200014,0.06159492867653715,664.3635449409485,271.3189549446106,845.7175483703613,28974,4028,24946,24946,0,11,4129000.0
4129,4129999,21.84429101422404,38.70491278574161,0.06163809076958249,664.4782967567444,271.38420510292053,845.8304405212402,28974,4028,24946,24946,0,11,4130000.0
4130,4130999,21.846131489217598,38.70592400292111,0.06166462254750249,664.6672420501709,271.4494876861572,845.92626953125,28993,4029,24964,24964,0,11,4131000.0
4131,4131999,21.8462932142325,38.70729830458605,0.06166976550475234,664.8599383831024,271.5141501426697,846.0823783874512,28996,4030,24966,24966,0,11,4132000.0
4132,4132999,21.845049405930848,38.7071006514473,0.06165699716066564,665.0614285469055,271.5796630382538,846.2415962219238,29004,4031,24973,24973,0,11,4133000.0
4133,4133999,21.84374362896319,38.70588155304347,0.06164125536865639,665.2487881183624,271.6456596851349,846.413703918457,29008,4032,24976,24976,0,11,4134000.0
4134,4134999,21.84233871059247,38.70484490246308,0.061629312580053774,665.4516217708588,271.71223282814026,846.5579223632812,29040,4033,25007,25007,0,11,4135000.0
4135,4135999,21.841269177532055,38.70456837944451,0.06161660867024754,665.7236032485962,271.77942872047424,846.5916175842285,29049,4035,25014,25014,0,11,4136000.0
4136,4136999,21.840287294208483,38.70256702967215,0.06160674162449309,665.937707901001,271.84580063819885,846.7571983337402,29058,4036,25022,25022,0,11,4137000.0
4137,4137999,21.839241905167004,38.7004069227173,0.0615910763889399,666.1305072307587,271.91106605529785,846.835521697998,29060,4037,25023,25023,0,11,4138000.0
4138,4138999,21.838193286623778,38.69823899042244,0.06158071916693908,666.2612707614899,271.97748827934265,846.9460792541504,29060,4037,25023,25023,0,11,4139000.0
4139,4139999,21.837293961837748,38.69678418099612,0.061565606671028505,666.400799036026,272.0431082248688,847.0610733032227,29061,4037,25024,25024,0,11,4140000.0
4140,4140999,21.836374118936543,38.69464900266201,0.061557328048617355,666.6695818901062,272.1093771457672,847.0842552185059,29068,4039,25029,25029,0,11,4141000.0
4141,4141999,21.835781196907863,38.69412134192564,0.061549517626942274,666.8594136238098,272.17526173591614,847.1408081054688,29070,4040,25030,25030,0,11,4142000.0
4142,4142999,21.83590582967103,38.69392452056769,0.06153547794374514,666.9977090358734,272.24112033843994,847.3802871704102,29071,4040,25031,25031,0,11,4143000.0
4143,4143999,21.83697704780483,38.69977189793653,0.061516923672299106,667.184604883194,272.3069226741791,847.4950294494629,29089,4041,25048,25048,0,11,4144000.0
4144,4144999,21.83847440111639,38.702184459959895,0.06151699471174543,667.5072033405304,272.3730070590973,847.56201171875,29095,4044,25051,25051,0,11,4145000.0
4145,4145999,21.840917191166056,38.71047514809212,0.06151398512604178,667.6978480815887,272.4391601085663,847.8742141723633,29098,4045,25053,25053,0,11,4146000.0
4146,4146999,21.844057446311332,38.720109006943076,0.061557825722605375,667.8196263313293,272.505024433136,848.095890045166,29098,4045,25053,25053,0,11,4147000.0
4147,4147999,21.850063389377812,38.73528341129057,0.0616518563495797,668.0871863365173,272.5720920562744,848.1252365112305,29106,4047,25059,25059,0,11,4148000.0
4148,4148999,21.855978295273296,38.750365350421,0.06173750349837426,668.2911012172699,272.638267993927,848.3442573547363,29114,4048,25066,25066,0,11,4149000.0
4149,4149999,21.861104084653928,38.760165122838,0.06181890262430989,668.4813411235809,272.70391154289246,848.4417152404785,29121,4049,25072,25072,0,11,4150000.0
4150,4150999,21.867041269631358,38.77299671969014,0.06194152418900689,668.6136574745178,272.76903200149536,848.5473518371582,29121,4049,25072,25072,0,11,4151000.0
4151,4151999,21.872825101482405,38.78436878354105,0.06200941097701218,668.7332491874695,272.83388471603394,848.6804733276367,29121,4049,25072,25072,0,11,4152000.0
4152,4152999,21.874827359683238,38.78759295290488,0.062045085319952564,668.9188878536224,272.89824080467224,848.855152130127,29127,4050,25077,25077,0,11,4153000.0
4153,4153999,21.872930309170506,38.78545510593896,0.062046023975560693,669.0696175098419,272.9709026813507,849.107608795166,29131,4050,25081,25081,0,11,4154000.0
4154,4154999,21.87124118479066,38.7837557327759,0.062042478177281035,669.1982421875,273.03756976127625,849.2843933105469,29131,4050,25081,25081,0,11,4155000.0
4155,4155999,21.870106901430212,38.78413826857125,0.062042927352737864,669.3271150588989,273.10427069664,849.4065437316895,29132,4050,25082,25082,0,11,4156000.0
4156,4156999,21.869174032509356,38.78292927880823,0.0620313083745625,669.5991585254669,273.1717224121094,849.6978569030762,29156,4052,25104,25104,0,11,4157000.0
4157,4157999,21.867847703014576,38.780384809336084,0.06202194945551964,669.8666596412659,273.2380256652832,849.8275566101074,29161,4054,25107,25107,0,11,4158000.0
4158,4158999,21.86658896281209,38.77847407035619,0.06201051607290642,670.0675857067108,273.3044469356537,849.9419212341309,29163,4055,25108,25108,0,11,4159000.0
4159,4159999,21.865690390989357,38.77659549594839,0.061999577705952436,670.2745227813721,273.37058186531067,850.0668258666992,29165,4056,25109,25109,0,11,4160000.0
4160,4160999,21.864940218160754,38.77553565305222,0.061984508742288336,670.5454576015472,273.43721055984497,850.0501823425293,29174,4058,25116,25116,0,11,4161000.0
4161,4161999,21.864473000604303,38.774401170451824,0.06196997082697864,670.7420854568481,273.5034177303314,850.0672225952148,29178,4059,25119,25119,0,11,4162000.0
4162,4162999,21.86449957557333,38.774125257031436,0.06194492987783973,670.8646206855774,273.5714445114136,850.2292671203613,29178,4059,25119,25119,0,11,4163000.0
4163,4163999,21.864706389897457,38.77402555008075,0.06191855534842572,670.9837486743927,273.63671231269836,850.3445587158203,29178,4059,25119,25119,0,11,4164000.0
4164,4164999,21.865595643660452,38.77523652884784,0.06189963948245103,671.2461032867432,273.70269203186035,850.342887878418,29182,4061,25121,25121,0,11,4165000.0
4165,4165999,21.866397241485874,38.775753911742854,0.061872326775488595,671.3647840023041,273.7685785293579,850.5534133911133,29182,4061,25121,25121,0,11,4166000.0
4166,4166999,21.868298711545595,38.78213165173821,0.061828699544628885,671.7534348964691,273.8349254131317,850.4379463195801,29199,4065,25134,25134,0,11,4167000.0
4167,4167999,21.86905349194791,38.782138452905784,0.06181397501529673,671.9698832035065,273.91169834136963,850.6433982849121,29205,4066,25139,25139,0,11,4168000.0
4168,4168999,21.869993205822638,38.78217982613557,0.061791824466629786,672.245522737503,273.97800278663635,850.7422065734863,29211,4068,25143,25143,0,11,4169000.0
4169,4169999,21.870948750039783,38.78224392089589,0.06177922410583914,672.4519431591034,274.0462703704834,850.842456817627,29213,4069,25144,25144,0,11,4170000.0
4170,4170999,21.871334519312395,38.78152525660707,0.061773431788633926,672.5891847610474,274.122496843338,851.0058784484863,29214,4069,25145,25145,0,11,4171000.0
4171,4171999,21.869749647845946,38.778650064466035,0.061774980929843126,672.7079446315765,274.1870810985565,851.2215118408203,29215,4069,25146,25146,0,11,4172000.0
4172,4172999,21.867557147198518,38.77552255983076,0.061783876002608484,672.9011180400848,274.25404620170593,851.3872222900391,29222,4070,25152,25152,0,11,4173000.0
4173,4173999,21.865700790668335,38.77389065670237,0.061791380216124736,673.104560136795,274.3207697868347,851.4993515014648,29224,4071,25153,25153,0,11,4174000.0
4174,4174999,21.86397998337132,38.771666261758085,0.06180161790793681,673.2374467849731,274.38719725608826,851.6313095092773,29224,4071,25153,25153,0,11,4175000.0
4175,4175999,21.86275735552725,38.76969087104486,0.06179911399477356,673.3790581226349,274.4529252052307,851.913215637207,29224,4071,25153,25153,0,11,4176000.0
4176,4176999,21.861660037075207,38.76792699073116,0.061790215809830906,673.6519088745117,274.52013540267944,852.1548118591309,29235,4073,25162,25162,0,11,4177000.0
4177,4177999,21.86061108117855,38.76690551337232,0.06177661234036125,673.7822744846344,274.5866959095001,852.3963966369629,29236,4073,25163,25163,0,11,4178000.0
4178,4178999,21.861092425436436,38.77046608832337,0.06176046131734669,674.0547676086426,274.652911901474,852.3205070495605,29248,4075,25173,25173,0,11,4179000.0
4179,4179999,21.86480050506054,38.78300282693593,0.061723413485382905,674.1784191131592,274.7194082736969,852.4701347351074,29248,4075,25173,25173,0,11,4180000.0
4180,4180999,21.868805565409172,38.79493787748813,0.06172536017475938,674.6450033187866,274.78668117523193,852.3680572509766,29274,4080,25194,25194,0,11,4181000.0
4181,4181999,21.87527588820721,38.81897097044331,0.0617091408351601,674.7703537940979,274.8526792526245,852.7538108825684,29276,4080,25196,25196,0,11,4182000.0
4182,4182999,21.882317372813826,38.8391238127097,0.06178559931739258,675.0332643985748,274.91942715644836,852.8222007751465,29284,4082,25202,25202,0,11,4183000.0
4183,4183999,21.890339631557644,38.86158751970833,0.061914876177326605,675.2214112281799,274.9864225387573,852.9917488098145,29290,4083,25207,25207,0,11,4184000.0
4184,4184999,21.89778798930514,38.88224729964467,0.06193439978792947,675.5501825809479,275.0538773536682,853.0033302307129,29304,4086,25218,25218,0,11,4185000.0
4185,4185999,21.90662692054193,38.90192021137818,0.06207666524198663,675.8835916519165,275.1206109523773,853.0447845458984,29335,4089,25246,25246,0,11,4186000.0
4186,4186999,21.9165853969173,38.930810512506355,0.06214701769899744,676.0710070133209,275.18610525131226,853.2041625976562,29341,4090,25251,25251,0,11,4187000.0
4187,4187999,21.92414331176986,38.947032545954016,0.062199007150256946,676.4651498794556,275.25277161598206,853.2061004638672,29366,4094,25272,25272,0,11,4188000.0
4188,4188999,21.933022884396042,38.969307260518676,0.062317162307253926,676.7959291934967,275.3188536167145,853.2270164489746,29378,4097,25281,25281,0,11,4189000.0
4189,4189999,21.940693322158854,38.985587837032895,0.06241368386657353,677.1269314289093,275.38671588897705,853.2634429931641,29395,4100,25295,25295,0,11,4190000.0
4190,4190999,21.94407848460224,38.992769316475204,0.06246521779793357,677.3184368610382,275.45136618614197,853.3908729553223,29399,4101,25298,25298,0,11,4191000.0
4191,4191999,21.943216049832987,38.9946879453265,0.06243776800047052,677.4360976219177,275.5166435241699,853.5517578125,29401,4101,25300,25300,0,11,4192000.0
4192,4192999,21.9428128759139,38.99784715460179,0.06241059324391218,677.5664749145508,275.58295130729675,853.6692085266113,29401,4101,25300,25300,0,11,4193000.0
4193,4193999,21.942529786449814,38.999040249789466,0.06238767174971305,677.6928372383118,275.64906883239746,853.7467842102051,29401,4101,25300,25300,0,11,4194000.0
4194,4194999,21.94233295861406,38.999748580986946,0.0623660534546876,677.8145499229431,275.71535539627075,853.8537673950195,29401,4101,25300,25300,0,11,4195000.0
4195,4195999,21.941855983618755,38.99928991658917,0.0623409085509673,678.0843510627747,275.781222820282,853.9056663513184,29407,4103,25304,25304,0,11,4196000.0
4196,4196999,21.941095234688515,38.99841255686437,0.06233153287000692,678.2834668159485,275.84683442115784,853.9375419616699,29409,4104,25305,25305,0,11,4197000.0
4197,4197999,21.941029534648745,38.99807608029207,0.06231378620324746,678.4800548553467,275.91260862350464,853.9867897033691,29415,4105,25310,25310,0,11,4198000.0
4198,4198999,21.941064680761585,38.99879842475856,0.06229906872078561,678.6664133071899,275.97867703437805,854.0981025695801,29423,4106,25317,25317,0,11,4199000.0
4199,4199999,21.941296285511317,38.999603188786814,0.06229141442802211,678.9277808666229,276.04498171806335,854.1436653137207,29428,4108,25320,25320,0,11,4200000.0
4200,4200999,21.942239046460617,39.00182560095583,0.06228617022174898,679.1321203708649,276.11190009117126,854.1702194213867,29434,4109,25325,25325,0,11,4201000.0
4201,4201999,21.94344059623418,39.00423872234518,0.06228498416139283,679.468222618103,276.1800286769867,854.4771537780762,29452,4112,25340,25340,0,11,4202000.0
4202,4202999,21.94546304569388,39.007166599890944,0.06230622756143944,679.5981454849243,276.2461440563202,854.7078666687012,29452,4112,25340,25340,0,11,4203000.0
4203,4203999,21.94754503214795,39.01044489679237,0.062331236739573415,679.711635351181,276.31196451187134,854.8697280883789,29452,4112,25340,25340,0,11,4204000.0
4204,4204999,21.94997988564755,39.01340691741601,0.06233792843825514,679.9053843021393,276.3784737586975,855.007080078125,29455,4113,25342,25342,0,11,4205000.0
4205,4205999,21.953491648140165,39.01885323452924,0.06235714683128568,680.2394988536835,276.44600081443787,854.9892158508301,29471,4116,25355,25355,0,11,4206000.0
4206,4206999,21.956600663711715,39.022449568891446,0.062392841388305254,680.5074322223663,276.51238679885864,855.0119323730469,29479,4118,25361,25361,0,11,4207000.0
4207,4207999,21.960135093426352,39.028186443062765,0.06239953306696877,680.8359994888306,276.5780167579651,855.0997467041016,29497,4121,25376,25376,0,11,4208000.0
4208,4208999,21.96279181701731,39.03093253296759,0.06242944435119324,680.9595367908478,276.6429531574249,855.2147827148438,29497,4121,25376,25376,0,11,4209000.0
4209,4209999,21.965901928868576,39.03443473795439,0.062479785898211015,681.2168478965759,276.7079520225525,855.2618789672852,29509,4123,25386,25386,0,11,4210000.0
4210,4210999,21.967544649525507,39.035259177882885,0.06249730942339904,681.541907787323,276.7731454372406,855.3174133300781,29523,4126,25397,25397,0,11,4211000.0
4211,4211999,21.96801165939836,39.03578130324894,0.062478479041553014,681.73419880867,276.8383409976959,855.5926475524902,29534,4127,25407,25407,0,11,4212000.0
4212,4212999,21.966123393698574,39.034278712357384,0.06247753677869505,681.8547155857086,276.90346789360046,855.9803352355957,29542,4127,25415,25415,0,11,4213000.0
4213,4213999,21.96423484360501,39.03160849120331,0.06248301174602933,682.0470590591431,276.9701862335205,856.2736549377441,29548,4128,25420,25420,0,11,4214000.0
4214,4214999,21.96275232694476,39.02923264941884,0.06248401562206207,682.2487173080444,277.03742718696594,856.455379486084,29550,4129,25421,25421,0,11,4215000.0
4215,4215999,21.961129355747005,39.02661746805738,0.062485063124864015,682.3768501281738,277.1039023399353,856.6190567016602,29550,4129,25421,25421,0,11,4216000.0
4216,4216999,21.959676140867998,39.02472628303364,0.06248233698538508,682.6513047218323,277.1703052520752,856.7478103637695,29562,4131,25431,25431,0,11,4217000.0
4217,4217999,21.958095562187996,39.02197713657362,0.062491567885267774,682.7808322906494,277.2367305755615,856.8951072692871,29562,4131,25431,25431,0,11,4218000.0
4218,4218999,21.956589659580626,39.019232870572324,0.06249030754343099,682.9054327011108,277.3016254901886,857.0251693725586,29563,4131,25432,25432,0,11,4219000.0
4219,4219999,21.955695710752007,39.01819225601778,0.062477808974810145,683.118989944458,277.36820697784424,857.2271461486816,29567,4132,25435,25435,0,11,4220000.0
4220,4220999,21.95481968038747,39.01687274995074,0.06247035905007414,683.3094110488892,277.43442964553833,857.3297157287598,29569,4133,25436,25436,0,11,4221000.0
4221,4221999,21.95384915733811,39.014775595281534,0.062463970215261955,683.6471409797668,277.50029587745667,857.2896423339844,29592,4136,25456,25456,0,11,4222000.0
4222,4222999,21.95330026264765,39.013268614620955,0.062473157588866624,683.7855203151703,277.56806087493896,858.0765190124512,29604,4136,25468,25468,0,11,4223000.0
4223,4223999,21.95427429525823,39.01490402037334,0.06249221762678936,683.9731636047363,277.6347723007202,858.3610992431641,29623,4137,25486,25486,0,11,4224000.0
4224,4224999,21.955214780079242,39.01659028094563,0.06250285989766269,684.0896248817444,277.69973158836365,858.5456809997559,29623,4137,25486,25486,0,11,4225000.0
4225,4225999,21.957201676099924,39.01907355154992,0.0625031638282233,684.2785921096802,277.7658486366272,858.9178924560547,29636,4138,25498,25498,0,11,4226000.0
4226,4226999,21.95892382447072,39.02180169016151,0.06250698037130153,684.4718773365021,277.8324365615845,859.1109199523926,29638,4139,25499,25499,0,11,4227000.0
4227,4227999,21.961184104660266,39.02829857981183,0.062521999301696,684.592696428299,277.8977954387665,859.287036895752,29639,4139,25500,25500,0,11,4228000.0
4228,4228999,21.96377118382945,39.032636737941175,0.06252915983195262,684.7831809520721,277.96304416656494,859.5412330627441,29645,4140,25505,25505,0,11,4229000.0
4229,4229999,21.96564557508557,39.035626467943004,0.06254461574769199,684.9020075798035,278.02743005752563,859.7070350646973,29645,4140,25505,25505,0,11,4230000.0
4230,4230999,21.96731244379929,39.03634220728558,0.0625596236653605,685.0192077159882,278.092481136322,859.827709197998,29645,4140,25505,25505,0,11,4231000.0
4231,4231999,21.968868149073135,39.03697936052188,0.06256874655543931,685.1404857635498,278.15701508522034,860.1596031188965,29649,4140,25509,25509,0,11,4232000.0
4232,4232999,21.96887271865016,39.03556058616992,0.06256839275787962,685.2621338367462,278.2214386463165,860.5103073120117,29658,4140,25518,25518,0,11,4233000.0
4233,4233999,21.96691421414743,39.03298070098842,0.06256623293031593,685.384791135788,278.28837871551514,860.9550285339355,29673,4140,25533,25533,0,11,4234000.0
4234,4234999,21.964913380781812,39.03183076337823,0.06251700758144207,685.645810842514,278.3556978702545,861.3471145629883,29691,4142,25549,25549,0,11,4235000.0
4235,4235999,21.962847055603785,39.02897063857149,0.0625094827574566,685.7699480056763,278.422611951828,861.5877952575684,29693,4142,25551,25551,0,11,4236000.0
4236,4236999,21.960965500964033,39.02633665082054,0.06250798539140434,685.8944373130798,278.4889132976532,861.7998542785645,29697,4142,25555,25555,0,11,4237000.0
4237,4237999,21.95980086539558,39.02501878720277,0.062499878243974405,686.022768497467,278.5564122200012,862.1693382263184,29706,4142,25564,25564,0,11,4238000.0
4238,4238999,21.9585242889623,39.022553844966545,0.062493941358274796,686.1430175304413,278.62215399742126,862.3591194152832,29707,4142,25565,25565,0,11,4239000.0
4239,4239999,21.957558479381632,39.02078251005259,0.062481012964925475,686.2682158946991,278.6882793903351,862.5210647583008,29708,4142,25566,25566,0,11,4240000.0
4240,4240999,21.9569259811102,39.01920117321257,0.062466363889496,686.5357446670532,278.7551312446594,862.8452796936035,29722,4144,25578,25578,0,11,4241000.0
4241,4241999,21.9568620877326,39.01930634056645,0.06245195355159805,686.7320568561554,278.8213541507721,863.0127639770508,29724,4145,25579,25579,0,11,4242000.0
4242,4242999,21.956939522667952,39.018808243789906,0.06244027771174754,686.9399163722992,278.8879108428955,863.1943321228027,29726,4146,25580,25580,0,11,4243000.0
4243,4243999,21.957031000726342,39.01793684681635,0.06242937842935825,687.1260328292847,278.95510149002075,863.6937828063965,29749,4147,25602,25602,0,11,4244000.0
4244,4244999,21.95802055498761,39.0182468760163,0.06243507887087629,687.3143794536591,279.02118158340454,864.0841827392578,29752,4148,25604,25604,0,11,4245000.0
4245,4245999,21.959389628684214,39.021407162084586,0.06246933933318066,687.5828585624695,279.08845949172974,864.2483863830566,29756,4150,25606,25606,0,11,4246000.0
4246,4246999,21.961382321341183,39.02308531943433,0.06252163799405352,687.7059128284454,279.15525245666504,864.7952346801758,29772,4150,25622,25622,0,11,4247000.0
4247,4247999,21.963161325947397,39.02437756544458,0.06254338849927032,687.975926399231,279.2239944934845,865.076904296875,29786,4152,25634,25634,0,11,4248000.0
4248,4248999,21.965746337140278,39.02747784889854,0.06259307294656435,688.1699407100677,279.29097080230713,865.290599822998,29788,4153,25635,25635,0,11,4249000.0
4249,4249999,21.968589970523755,39.03001464073974,0.06260699440164097,688.3018934726715,279.357825756073,865.749153137207,29800,4153,25647,25647,0,11,4250000.0
4250,4250999,21.971622770351917,39.03278326144693,0.06262489010956396,688.6718306541443,279.43136858940125,865.8413543701172,29817,4156,25661,25661,0,11,4251000.0
4251,4251999,21.974032653880155,39.03460212220937,0.06263720332510403,688.8752377033234,279.4980676174164,866.0093307495117,29820,4157,25663,25663,0,11,4252000.0
4252,4252999,21.976929042715934,39.03652337867741,0.06262479821352884,689.1417565345764,279.56612491607666,866.2605590820312,29840,4159,25681,25681,0,11,4253000.0
4253,4253999,21.978620515487215,39.03852676889906,0.06260682973259946,689.2643864154816,279.6312463283539,866.4775238037109,29841,4159,25682,25682,0,11,4254000.0
4254,4254999,21.976824356485785,39.03553920179621,0.06261338664012395,689.4643807411194,279.6973879337311,866.9286117553711,29862,4160,25702,25702,0,11,4255000.0
4255,4255999,21.974793209590207,39.03303428817979,0.0626180695539702,689.6675827503204,279.76662039756775,867.2796974182129,29870,4161,25709,25709,0,11,4256000.0
4256,4256999,21.97296153523066,39.030609607302054,0.0626240169580976,689.7999835014343,279.83358430862427,867.4530906677246,29870,4161,25709,25709,0,11,4257000.0
4257,4257999,21.971446128428568,39.02880071578531,0.06262825105283754,689.9238593578339,279.90014457702637,867.5926818847656,29871,4161,25710,25710,0,11,4258000.0
4258,4258999,21.97025292213105,39.0281326621883,0.0626177148913929,690.1987571716309,279.967098236084,867.7736740112305,29884,4163,25721,25721,0,11,4259000.0
4259,4259999,21.968905473132153,39.026871086844785,0.06261791347663337,690.3974511623383,280.03266620635986,867.9679641723633,29888,4164,25724,25724,0,11,4260000.0
4260,4260999,21.96749393964924,39.02433264548227,0.06261209589479877,690.6008145809174,280.09859442710876,868.0641441345215,29895,4165,25730,25730,0,11,4261000.0
4261,4261999,21.966291059165222,39.02192011044483,0.06260711122292384,690.8055324554443,280.16474437713623,868.3122749328613,29903,4166,25737,25737,0,11,4262000.0
4262,4262999,21.96519954990163,39.01969013143399,0.06260045327277652,691.1548399925232,280.23156905174255,868.3718338012695,29915,4169,25746,25746,0,11,4263000.0
4263,4263999,21.964758123087456,39.01901845838476,0.0625894441226833,691.2846343517303,280.29760456085205,868.4860496520996,29915,4169,25746,25746,0,11,4264000.0
4264,4264999,21.963971415674276,39.016850648993966,0.06258130604428846,691.4938015937805,280.3640139102936,868.660041809082,29927,4170,25757,25757,0,11,4265000.0
4265,4265999,21.96350240796472,39.015362891471256,0.06256345621041914,691.7771866321564,280.43606424331665,868.8940353393555,29934,4172,25762,25762,0,11,4266000.0
4266,4266999,21.963697458733346,39.01644729498231,0.06254991223841799,692.0543615818024,280.50353145599365,869.0035858154297,29943,4174,25769,25769,0,11,4267000.0
4267,4267999,21.963348433964146,39.01457076826205,0.06254265591213837,692.3987703323364,280.5703475475311,869.1032371520996,29957,4177,25780,25780,0,11,4268000.0
4268,4268999,21.963670975710436,39.01409943129811,0.06252665210715491,692.5267724990845,280.6391360759735,869.6676216125488,29967,4177,25790,25790,0,11,4269000.0
4269,4269999,21.964139780309143,39.01460958934259,0.06251175683040822,692.7232348918915,280.70515418052673,869.8210220336914,29969,4178,25791,25791,0,11,4270000.0
4270,4270999,21.964333425320714,39.013887591414814,0.06250759569023179,693.0084199905396,280.77282643318176,870.022274017334,29985,4180,25805,25805,0,11,4271000.0
4271,4271999,21.965206638051946,39.016281397353914,0.06249735759634589,693.1427674293518,280.841881275177,870.4641151428223,29991,4180,25811,25811,0,11,4272000.0
4272,4272999,21.965102393672797,39.01442770843802,0.06248548659074438,693.5629796981812,280.90823435783386,870.4853324890137,30009,4184,25825,25825,0,11,4273000.0
4273,4273999,21.965310590352733,39.013065524543585,0.06247906151796678,693.6832363605499,280.97404980659485,870.7510185241699,30014,4184,25830,25830,0,11,4274000.0
4274,4274999,21.96480548750448,39.01105156357817,0.06246677945263768,693.8047518730164,281.03923058509827,870.9480323791504,30014,4184,25830,25830,0,11,4275000.0
4275,4275999,21.963646316936305,39.00894148945933,0.062462996201686716,694.012797832489,281.11333298683167,871.1827659606934,30029,4185,25844,25844,0,11,4276000.0
4276,4276999,21.961593365677654,39.00677526257076,0.062463147887448334,694.3936364650726,281.1968483924866,871.3366928100586,30046,4188,25858,25858,0,11,4277000.0
4277,4277999,21.959372989538725,39.00334545679092,0.062469428753175404,694.7351067066193,281.26374411582947,871.4143333435059,30059,4191,25868,25868,0,11,4278000.0
4278,4278999,21.957501690360964,39.00064845110495,0.06247819819527811,694.8625857830048,281.32994174957275,871.528133392334,30059,4191,25868,25868,0,11,4279000.0
4279,4279999,21.95618474033336,38.99986511769776,0.06247390205707026,695.0795233249664,281.39935398101807,871.6159019470215,30066,4192,25874,25874,0,11,4280000.0
4280,4280999,21.954533959299948,38.99685372763669,0.06247372901471371,695.2048380374908,281.4651069641113,871.8850059509277,30069,4192,25877,25877,0,11,4281000.0
4281,4281999,21.9529102476114,38.994245579725295,0.062475015579716464,695.4738235473633,281.5306396484375,871.9303970336914,30078,4194,25884,25884,0,11,4282000.0
4282,4282999,21.95159461731849,38.991765458590336,0.062470542392699335,695.7456917762756,281.5963325500488,871.9482955932617,30091,4196,25895,25895,0,11,4283000.0
4283,4283999,21.950597625669115,38.99029418151051,0.062459682496389,696.0959663391113,281.66504740715027,872.1901206970215,30103,4199,25904,25904,0,11,4284000.0
4284,4284999,21.9492371032265,38.98754180664663,0.06245991635151904,696.2215292453766,281.73094868659973,872.3860206604004,30103,4199,25904,25904,0,11,4285000.0
4285,4285999,21.948367751509096,38.98562933426758,0.06245946415825798,696.5019013881683,281.7975800037384,872.4235763549805,30108,4201,25907,25907,0,11,4286000.0
4286,4286999,21.94837138061978,38.98648097529026,0.062452002359236314,696.6330304145813,281.86618638038635,873.1824722290039,30128,4201,25927,25927,0,11,4287000.0
4287,4287999,21.94813282587685,38.98543361405165,0.06244753729334751,696.7543497085571,281.93204617500305,873.4627990722656,30128,4201,25927,25927,0,11,4288000.0
4288,4288999,21.948056715356497,38.984279888793104,0.0624423674432687,697.0237889289856,281.9998700618744,873.5740966796875,30132,4203,25929,25929,0,11,4289000.0
4289,4289999,21.949137720121673,38.98653593341784,0.06244895265962669,697.1610326766968,282.06719160079956,874.1784019470215,30148,4203,25945,25945,0,11,4290000.0
4290,4290999,21.95081843326798,38.987926530246924,0.062455816453149904,697.3551139831543,282.13531398773193,874.4189796447754,30155,4204,25951,25951,0,11,4291000.0
4291,4291999,21.952386255222635,38.989514751936305,0.0624830670405665,697.6196036338806,282.2015151977539,874.525260925293,30168,4206,25962,25962,0,11,4292000.0
4292,4292999,21.954618810941994,38.99269406899908,0.06249006897009968,697.7488632202148,282.26733446121216,874.8415222167969,30173,4206,25967,25967,0,11,4293000.0
4293,4293999,21.957534498646922,38.999418243727014,0.0625113913572436,697.9510164260864,282.3329744338989,874.934211730957,30180,4207,25973,25973,0,11,4294000.0
4294,4294999,21.9607807870923,39.00881251070478,0.0625684372268821,698.0827252864838,282.397967338562,875.0094795227051,30180,4207,25973,25973,0,11,4295000.0
4295,4295999,21.963185237944096,39.01222892095925,0.0625998904779782,698.2069571018219,282.4629476070404,875.3022537231445,30185,4207,25978,25978,0,11,4296000.0
4296,4296999,21.964233727448786,39.01428543573634,0.0626046686036098,698.3300063610077,282.5279757976532,875.6194038391113,30194,4207,25987,25987,0,11,4297000.0
4297,4297999,21.96227110614245,39.012568545931295,0.06260956348825342,698.4619064331055,282.59510684013367,875.9960670471191,30205,4207,25998,25998,0,11,4298000.0
4298,4298999,21.960453734115735,39.01089060971675,0.06261498999337367,698.6541159152985,282.66175866127014,876.1853179931641,30212,4208,26004,26004,0,11,4299000.0
4299,4299999,21.959009766531505,39.00993968019841,0.06261562618031202,698.9193449020386,282.728759765625,876.2603912353516,30228,4210,26018,26018,0,11,4300000.0
4300,4300999,21.95729067333566,39.007758113720314,0.06261978157984271,699.0666375160217,282.79595375061035,876.5139083862305,30235,4210,26025,26025,0,11,4301000.0
4301,4301999,21.955790934264076,39.005313270334774,0.06261898594276205,699.2666680812836,282.8620328903198,876.8599739074707,30249,4211,26038,26038,0,11,4302000.0
4302,4302999,21.954219565662306,39.00316346120492,0.06261627578554274,699.3874037265778,282.92796659469604,877.1024131774902,30250,4211,26039,26039,0,11,4303000.0
4303,4303999,21.953254568282436,39.001568868180804,0.06260721596221663,699.5880706310272,282.9947683811188,877.5140762329102,30262,4212,26050,26050,0,11,4304000.0
4304,4304999,21.952033159452373,38.99938580034759,0.0625999276599396,699.8521640300751,283.0614776611328,877.6013641357422,30271,4214,26057,26057,0,11,4305000.0
4305,4305999,21.951148538363746,38.99770355187849,0.06259223375606127,700.1191515922546,283.1280691623688,877.7441062927246,30277,4216,26061,26061,0,11,4306000.0
4306,4306999,21.9506731042066,38.99639162593909,0.0625695434509882,700.3230571746826,283.19844484329224,878.324047088623,30299,4217,26082,26082,0,11,4307000.0
4307,4307999,21.950438900349326,38.99562291735197,0.06255093835067527,700.5993621349335,283.2648501396179,878.5494689941406,30314,4219,26095,26095,0,11,4308000.0
4308,4308999,21.949600578860245,38.99354272902948,0.06253913247194864,700.7953033447266,283.33336114883423,878.7685775756836,30321,4220,26101,26101,0,11,4309000.0
4309,4309999,21.94925178208498,38.992091657136484,0.06252526794623392,700.996098279953,283.4005386829376,879.1905174255371,30343,4221,26122,26122,0,11,4310000.0
4310,4310999,21.949679058934695,38.9981192360321,0.06248978666090277,701.2567110061646,283.46647810935974,879.4278526306152,30348,4223,26125,26125,0,11,4311000.0
4311,4311999,21.949646483871792,38.996996023958985,0.06247811938708414,701.5153024196625,283.5327444076538,879.6148300170898,30375,4225,26150,26150,0,11,4312000.0
4312,4312999,21.94979716851678,38.99557774088006,0.06246169322805417,701.7265181541443,283.59956455230713,879.9766159057617,30390,4226,26164,26164,0,11,4313000.0
4313,4313999,21.949780660464736,38.99420962791531,0.06244886627027568,701.8549304008484,283.66458201408386,880.0929794311523,30390,4226,26164,26164,0,11,4314000.0
4314,4314999,21.949476714530338,38.99256664934911,0.062439772687288064,702.0427556037903,283.7306113243103,880.2358703613281,30399,4227,26172,26172,0,11,4315000.0
4315,4315999,21.948336906771992,38.99035789713313,0.06243188952413348,702.1721243858337,283.7955765724182,880.5758895874023,30411,4227,26184,26184,0,11,4316000.0
4316,4316999,21.94688374780099,38.98868290138915,0.06243759601064258,702.3036692142487,283.8612473011017,880.9546928405762,30418,4227,26191,26191,0,11,4317000.0
4317,4317999,21.94620229567276,38.988700089086606,0.062440062029147536,702.4286851882935,283.9269299507141,881.1538009643555,30418,4227,26191,26191,0,11,4318000.0
4318,4318999,21.94526506512822,38.98815203369332,0.06244324501591447,702.5635573863983,283.99328780174255,881.3222503662109,30418,4227,26191,26191,0,11,4319000.0
4319,4319999,21.94469875319441,38.986827766396814,0.06243841356120261,702.7724068164825,284.059232711792,881.5336456298828,30431,4228,26203,26203,0,11,4320000.0
4320,4320999,21.944643183153097,38.98673680809795,0.062429987190852576,702.964821100235,284.1241464614868,881.6280364990234,30438,4229,26209,26209,0,11,4321000.0
4321,4321999,21.94466529583031,38.98597544257841,0.062420133306263614,703.0882711410522,284.18891739845276,881.7485160827637,30438,4229,26209,26209,0,11,4322000.0
4322,4322999,21.94443078869585,38.98525092529069,0.06240983536548228,703.2891108989716,284.25476121902466,882.0242042541504,30454,4230,26224,26224,0,11,4323000.0
4323,4323999,21.944276464595877,38.98445375353449,0.06239551180235192,703.6464130878448,284.32068967819214,882.3901748657227,30484,4233,26251,26251,0,11,4324000.0
4324,4324999,21.944370453678882,38.983967031290604,0.062380108769590215,703.7621479034424,284.3859324455261,882.7344360351562,30484,4233,26251,26251,0,11,4325000.0
4325,4325999,21.944748596570488,38.9837278930393,0.06236289372387216,703.8880460262299,284.4521996974945,883.2205352783203,30495,4233,26262,26262,0,11,4326000.0
4326,4326999,21.945529717804924,38.985510003711255,0.062348130421115755,704.020131111145,284.5168056488037,883.422248840332,30496,4233,26263,26263,0,11,4327000.0
4327,4327999,21.94595181092977,38.98545559961596,0.062343711988402495,704.3558011054993,284.58232164382935,883.4352226257324,30506,4236,26270,26270,0,11,4328000.0
4328,4328999,21.946637856638265,38.9855355864622,0.062335458545659805,704.5018076896667,284.65434527397156,883.839485168457,30514,4236,26278,26278,0,11,4329000.0
4329,4329999,21.94805836944821,38.9890888208592,0.0623482915418353,704.6200847625732,284.71870136260986,884.0145530700684,30514,4236,26278,26278,0,11,4330000.0
4330,4330999,21.94963035633157,38.9904695781595,0.06236287452604694,704.8225703239441,284.7849507331848,884.0767593383789,30516,4237,26279,26279,0,11,4331000.0
4331,4331999,21.95243822403203,38.99448172787695,0.06237861980374615,704.9700675010681,284.85058093070984,884.3268356323242,30519,4237,26282,26282,0,11,4332000.0
4332,4332999,21.95484124105348,38.99803366772853,0.06240185520880326,705.2417991161346,284.9155101776123,884.3346252441406,30528,4239,26289,26289,0,11,4333000.0
4333,4333999,21.957502976643745,39.00093912599116,0.06243568618782391,705.4366843700409,284.9796550273895,884.4137382507324,30535,4240,26295,26295,0,11,4334000.0
4334,4334999,21.960199069658934,39.00394045185486,0.06245271642466299,705.5554394721985,285.044082403183,884.6255073547363,30538,4240,26298,26298,0,11,4335000.0
4335,4335999,21.961275639495025,39.004589862441854,0.06244982836437285,705.6711587905884,285.10808873176575,884.866382598877,30546,4240,26306,26306,0,11,4336000.0
4336,4336999,21.95929485211511,39.003183835547404,0.06244536463898864,705.7960855960846,285.17309641838074,885.2396926879883,30559,4240,26319,26319,0,11,4337000.0
4337,4337999,21.957798876871962,39.00501767727958,0.06243237688682435,706.0574944019318,285.2390959262848,885.3930892944336,30570,4242,26328,26328,0,11,4338000.0
4338,4338999,21.95595576324649,39.00281241657472,0.06243374458659268,706.3331696987152,285.3059768676758,885.4663124084473,30577,4244,26333,26333,0,11,4339000.0
4339,4339999,21.954499437321832,39.00136828717927,0.06242836226271775,706.5437695980072,285.37221336364746,885.5844955444336,30583,4245,26338,26338,0,11,4340000.0
4340,4340999,21.952879576499868,38.999061742627035,0.06242408272259903,706.6649634838104,285.4375865459442,885.8900032043457,30589,4245,26344,26344,0,11,4341000.0
4341,4341999,21.95172851540012,38.99852060625016,0.06241061889506472,706.9307956695557,285.5024492740631,885.9693145751953,30600,4247,26353,26353,0,11,4342000.0
4342,4342999,21.95110942332738,38.99836804800739,0.06239626184737457,707.1250314712524,285.56809735298157,886.0708122253418,30602,4248,26354,26354,0,11,4343000.0
4343,4343999,21.95035166876293,38.99688289207663,0.062388771166692836,707.3152251243591,285.63384652137756,886.4043579101562,30617,4249,26368,26368,0,11,4344000.0
4344,4344999,21.94979067107023,38.99506643919142,0.062386832129803116,707.5077276229858,285.69958114624023,886.5767478942871,30619,4250,26369,26369,0,11,4345000.0
4345,4345999,21.950253696667726,38.995865633576344,0.062381508767797245,707.6464698314667,285.7698121070862,886.7474822998047,30619,4250,26369,26369,0,11,4346000.0
4346,4346999,21.950818831474464,38.99636339410174,0.062384333327744956,707.8387570381165,285.8354125022888,887.0316352844238,30632,4251,26381,26381,0,11,4347000.0
4347,4347999,21.951475778189245,38.99682626492794,0.06239153266690545,708.0361366271973,285.90048360824585,887.2203979492188,30636,4252,26384,26384,0,11,4348000.0
4348,4348999,21.95246484177757,38.99800937477738,0.0623959309876565,708.2349960803986,285.96630573272705,887.3860092163086,30639,4253,26386,26386,0,11,4349000.0
4349,4349999,21.954441446795308,39.00272462316018,0.0623883447229171,708.3664216995239,286.032098531723,887.7937278747559,30651,4253,26398,26398,0,11,4350000.0
4350,4350999,21.956420514993816,39.00955049098632,0.06241068914629766,708.5558423995972,286.09728717803955,888.0155792236328,30653,4254,26399,26399,0,11,4351000.0
4351,4351999,21.958707438439035,39.012240402047105,0.06245628120152702,708.7502336502075,286.1629726886749,888.2511749267578,30660,4255,26405,26405,0,11,4352000.0
4352,4352999,21.96130394236183,39.01508114665749,0.06246923340926147,708.8725707530975,286.22841000556946,888.7665939331055,30674,4255,26419,26419,0,11,4353000.0
4353,4353999,21.96380079403891,39.01794928901744,0.06249222583919467,709.1424949169159,286.2937071323395,888.9434623718262,30689,4257,26432,26432,0,11,4354000.0
4354,4354999,21.96609062351066,39.01993528947062,0.06251621065673074,709.4017052650452,286.35908460617065,889.0645790100098,30705,4259,26446,26446,0,11,4355000.0
4355,4355999,21.96898524838789,39.023050929037666,0.06254473609058209,709.5923125743866,286.4240348339081,889.3792266845703,30713,4260,26453,26453,0,11,4356000.0
4356,4356999,21.96971366348279,39.02236892114769,0.06255381633295509,709.787565946579,286.48844742774963,889.4468803405762,30720,4261,26459,26459,0,11,4357000.0
4357,4357999,21.968059371957096,39.020114991613,0.06255838912612877,709.9180161952972,286.5550765991211,889.9847831726074,30740,4261,26479,26479,0,11,4358000.0
4358,4358999,21.966505212053644,39.020136382841635,0.06255079128028895,710.0388650894165,286.62062311172485,890.3920745849609,30748,4261,26487,26487,0,11,4359000.0
4359,4359999,21.96530797606215,39.01943497300887,0.06255497554862766,710.2320897579193,286.68676137924194,890.5531959533691,30753,4262,26491,26491,0,11,4360000.0
4360,4360999,21.964380312270034,39.018613517797704,0.06256112816901349,710.4288718700409,286.7525591850281,890.659309387207,30761,4263,26498,26498,0,11,4361000.0
4361,4361999,21.964488047466997,39.02059520277578,0.06253803429954297,710.5552115440369,286.81850385665894,890.8807029724121,30763,4263,26500,26500,0,11,4362000.0
4362,4362999,21.964740987692117,39.021016049904844,0.06252527128123231,710.8202602863312,286.8829548358917,891.0126266479492,30768,4265,26503,26503,0,11,4363000.0
4363,4363999,21.964357977852018,39.01977918395579,0.06251788293685578,711.0847399234772,286.9487535953522,891.0581970214844,30772,4267,26505,26505,0,11,4364000.0
4364,4364999,21.96425398554995,39.01915271282513,0.06251501493833,711.2965862751007,287.01579093933105,891.2843856811523,30785,4268,26517,26517,0,11,4365000.0
4365,4365999,21.9636999080626,39.01771986788787,0.062508302552301,711.4238195419312,287.0810582637787,891.5379981994629,30786,4268,26518,26518,0,11,4366000.0
4366,4366999,21.963819465233925,39.01736628428098,0.06250636656361275,711.5438373088837,287.1459684371948,891.7023658752441,30786,4268,26518,26518,0,11,4367000.0
4367,4367999,21.963500783926825,39.0165845320813,0.06249888526540959,711.8209495544434,287.21302819252014,891.9860610961914,30802,4270,26532,26532,0,11,4368000.0
4368,4368999,21.963842887838638,39.0165082388822,0.06249229025098535,711.947514295578,287.2786557674408,892.311466217041,30803,4270,26533,26533,0,11,4369000.0
4369,4369999,21.96437785810533,39.01714634065567,0.06248242911659285,712.1454446315765,287.34419870376587,892.4413833618164,30822,4271,26551,26551,0,11,4370000.0
4370,4370999,21.964917966970038,39.017189886378915,0.06247021821419141,712.3495705127716,287.417197227478,892.5482406616211,30829,4272,26557,26557,0,11,4371000.0
4371,4371999,21.965268342307734,39.016765798382366,0.06246153251912978,712.5525822639465,287.4835968017578,892.9291572570801,30853,4273,26580,26580,0,11,4372000.0
4372,4372999,21.966176746996517,39.01767518743822,0.062458483831243194,712.8228101730347,287.54934883117676,893.0146980285645,30858,4275,26583,26583,0,11,4373000.0
4373,4373999,21.96701796948465,39.017946359573116,0.06245889494001067,713.0239820480347,287.6146869659424,893.3039093017578,30872,4276,26596,26596,0,11,4374000.0
4374,4374999,21.967624278663727,39.018875688369874,0.062447282150636774,713.3718082904816,287.67967987060547,893.4134750366211,30889,4279,26610,26610,0,11,4375000.0
4375,4375999,21.96827474690449,39.01958859104784,0.06243817876740054,713.5657937526703,287.74453115463257,893.5314750671387,30892,4280,26612,26612,0,11,4376000.0
4376,4376999,21.96869322546729,39.01906607576767,0.0624368577334633,713.7659997940063,287.8098533153534,893.7541236877441,30898,4281,26617,26617,0,11,4377000.0
4377,4377999,21.968802975301497,39.01893967480092,0.06242587620943563,713.8890612125397,287.8737828731537,893.9167709350586,30899,4281,26618,26618,0,11,4378000.0
4378,4378999,21.96834895729047,39.01916337719499,0.06240451866017849,714.0112247467041,287.94013929367065,894.3508605957031,30917,4281,26636,26636,0,11,4379000.0
4379,4379999,21.967432863556446,39.02011445398513,0.062385932584980375,714.2075524330139,288.00626277923584,894.5365371704102,30928,4282,26646,26646,0,11,4380000.0
4380,4380999,21.96621725635703,39.01890063899799,0.06239000669714245,714.4211893081665,288.07251596450806,894.6015815734863,30935,4283,26652,26652,0,11,4381000.0
4381,4381999,21.965606085432217,39.01882747516126,0.062377497941144,714.5586624145508,288.1383767127991,894.6960716247559,30935,4283,26652,26652,0,11,4382000.0
4382,4382999,21.965256086071292,39.018706274043126,0.062370209263135856,714.6885197162628,288.20535945892334,894.8391380310059,30937,4283,26654,26654,0,11,4383000.0
4383,4383999,21.965902903261792,39.02936589042281,0.062324025445042674,714.803510427475,288.2702159881592,895.1696243286133,30944,4283,26661,26661,0,11,4384000.0
4384,4384999,21.965567438057747,39.02899282566416,0.062314388757711,714.9977810382843,288.33580493927,895.2678985595703,30952,4284,26668,26668,0,11,4385000.0
4385,4385999,21.965830644710476,39.02927264506407,0.062305532786906426,715.2063646316528,288.40230536460876,895.5191078186035,30961,4285,26676,26676,0,11,4386000.0
4386,4386999,21.96552674525979,39.02908636888078,0.062300586308670414,715.4042408466339,288.468195438385,895.626880645752,30968,4286,26682,26682,0,11,4387000.0
4387,4387999,21.965500172721686,39.02906730086482,0.06229974530928706,715.6038999557495,288.5335352420807,895.7642517089844,30970,4287,26683,26683,0,11,4388000.0
4388,4388999,21.965859701499586,39.02967362830799,0.062296986307919466,715.7321453094482,288.5988404750824,895.8373031616211,30970,4287,26683,26683,0,11,4389000.0
4389,4389999,21.96634840764747,39.02944497235889,0.06230456653176808,716.0095381736755,288.6660692691803,896.3500823974609,30994,4289,26705,26705,0,11,4390000.0
4390,4390999,21.966958561784914,39.03068722877952,0.06231514622245249,716.1983971595764,288.73180055618286,896.5589179992676,30996,4290,26706,26706,0,11,4391000.0
4391,4391999,21.967697259491327,39.031199851915225,0.06231802075176762,716.3985877037048,288.7968919277191,896.6759605407715,30998,4291,26707,26707,0,11,4392000.0
4392,4392999,21.96852755020806,39.031755160487435,0.062323176010490866,716.5945398807526,288.86292815208435,897.1008186340332,31017,4292,26725,26725,0,11,4393000.0
4393,4393999,21.969487523452003,39.03217425419713,0.06234068580351293,716.7873134613037,288.9286639690399,897.2759628295898,31024,4293,26731,26731,0,11,4394000.0
4394,4394999,21.971493565912603,39.0384664650088,0.062337631335771526,717.2066013813019,288.9957399368286,897.4118041992188,31051,4297,26754,26754,0,11,4395000.0
4395,4395999,21.972638673185696,39.040442313884064,0.062342221176146406,717.3317859172821,289.0627443790436,897.7040977478027,31055,4297,26758,26758,0,11,4396000.0
4396,4396999,21.973847166874158,39.04211030585103,0.06233860689086457,717.5213837623596,289.1276514530182,897.7741661071777,31057,4298,26759,26759,0,11,4397000.0
4397,4397999,21.97498340399501,39.04435212798631,0.06234278692546347,717.7103016376495,289.1922698020935,898.0031318664551,31065,4299,26766,26766,0,11,4398000.0
4398,4398999,21.975313237282766,39.04350648928246,0.06234684817233771,717.8331277370453,289.25800609588623,898.1879768371582,31066,4299,26767,26767,0,11,4399000.0
4399,4399999,21.97414516395074,39.04129875170592,0.06235128723344674,718.0282483100891,289.3233428001404,898.5495834350586,31088,4300,26788,26788,0,11,4400000.0
4400,4400999,21.97201368298365,39.040831893118444,0.0623508706165099,718.3010549545288,289.3893105983734,898.8260307312012,31097,4302,26795,26795,0,11,4401000.0
4401,4401999,21.96993707490263,39.03866975147752,0.06236230464281223,718.4301269054413,289.45591831207275,899.0200996398926,31098,4302,26796,26796,0,11,4402000.0
4402,4402999,21.968045414849552,39.036818217159826,0.06236495193859315,718.7027225494385,289.5224187374115,899.038703918457,31115,4304,26811,26811,0,11,4403000.0
4403,4403999,21.966077447680277,39.03406268087468,0.06237128685270643,718.8285257816315,289.5886347293854,899.2041625976562,31115,4304,26811,26811,0,11,4404000.0
4404,4404999,21.964835334388457,39.03223952219524,0.06236195148832313,719.0159869194031,289.6541528701782,899.6166763305664,31126,4305,26821,26821,0,11,4405000.0
4405,4405999,21.96344880728153,39.029540574015144,0.062361378577241,719.3157668113708,289.72360348701477,899.8125,31130,4307,26823,26823,0,11,4406000.0
4406,4406999,21.962666147727884,39.02823568763871,0.062352634604011636,719.5889217853546,289.7896225452423,900.016471862793,31140,4309,26831,26831,0,11,4407000.0
4407,4407999,21.962113349183944,39.02795917528767,0.06234478446112357,719.7239756584167,289.85625171661377,900.2885322570801,31141,4309,26832,26832,0,11,4408000.0
4408,4408999,21.9625232511337,39.030549341237304,0.062327408187318634,719.9191491603851,289.9222106933594,900.4233627319336,31143,4310,26833,26833,0,11,4409000.0
4409,4409999,21.96476925203917,39.03850594377285,0.06228761063849886,720.0493626594543,289.98754715919495,900.5439910888672,31143,4310,26833,26833,0,11,4410000.0
4410,4410999,21.969160761168567,39.04990018530662,0.06226473569881397,720.3804311752319,290.05278515815735,900.7791328430176,31157,4313,26844,26844,0,11,4411000.0
4411,4411999,21.97452865899633,39.06723269664073,0.06227825154181987,720.5819005966187,290.1197352409363,900.9527778625488,31159,4314,26845,26845,0,11,4412000.0
4412,4412999,21.979599769118376,39.079032214448986,0.06233999666839363,720.7791845798492,290.18494296073914,901.0415000915527,31166,4315,26851,26851,0,11,4413000.0
4413,4413999,21.985762548998814,39.095053660547066,0.06236209974665308,720.9777913093567,290.25117444992065,901.5900802612305,31185,4316,26869,26869,0,11,4414000.0
4414,4414999,21.99256978253137,39.1126973068946,0.062429497803420886,721.1727068424225,290.31799697875977,901.8127059936523,31187,4317,26870,26870,0,11,4415000.0
4415,4415999,21.99976429199097,39.13314926298949,0.0625242355813479,721.515899181366,290.38432455062866,901.9623031616211,31201,4320,26881,26881,0,11,4416000.0
4416,4416999,22.006470718699564,39.148330358338875,0.06260501293439669,721.9356832504272,290.4524154663086,902.2366676330566,31227,4324,26903,26903,0,11,4417000.0
4417,4417999,22.012919894364888,39.16387573424943,0.06272733984602441,722.1290867328644,290.51787996292114,902.3686180114746,31229,4325,26904,26904,0,11,4418000.0
4418,4418999,22.020536389330516,39.18107361858318,0.06289090279500142,722.3909747600555,290.58356285095215,902.5450134277344,31244,4327,26917,26917,0,11,4419000.0
4419,4419999,22.026199336839547,39.195187433277454,0.06292942993771444,722.5853219032288,290.64853167533875,902.6752433776855,31251,4328,26923,26923,0,11,4420000.0
4420,4420999,22.02555778614309,39.1953676785834,0.06293264579152025,722.8625025749207,290.7154402732849,902.9641952514648,31274,4330,26944,26944,0,11,4421000.0
4421,4421999,22.02349623986378,39.1928870511969,0.06293557927382065,723.1306076049805,290.78195428848267,903.2326164245605,31294,4332,26962,26962,0,11,4422000.0
4422,4422999,22.02184114092785,39.190557051443186,0.06293332929781448,723.3236467838287,290.8477072715759,903.3857841491699,31296,4333,26963,26963,0,11,4423000.0
4423,4423999,22.020986540219155,39.19467302740611,0.06291037525616006,723.5236392021179,290.91407203674316,903.4781036376953,31303,4334,26969,26969,0,11,4424000.0
4424,4424999,22.020265716795727,39.19435295106725,0.06290085570676762,723.7942340373993,290.98059034347534,903.6526870727539,31321,4336,26985,26985,0,11,4425000.0
4425,4425999,22.019475179281873,39.19319692232405,0.06288857798368774,723.9809064865112,291.0454912185669,903.8881874084473,31324,4337,26987,26987,0,11,4426000.0
4426,4426999,22.018375904966486,39.19103273750212,0.06288610823939567,724.1738674640656,291.1117079257965,904.0478210449219,31326,4338,26988,26988,0,11,4427000.0
4427,4427999,22.017751247216175,39.1891855002806,0.06288677700391543,724.5209624767303,291.17800545692444,904.1282958984375,31341,4341,27000,27000,0,11,4428000.0
4428,4428999,22.017305577158464,39.187855427229586,0.06287946993480054,724.790693283081,291.24401473999023,904.1537094116211,31356,4343,27013,27013,0,11,4429000.0
4429,4429999,22.017563839460472,39.19129369406284,0.06287104540616961,724.9888076782227,291.3100757598877,904.2624359130859,31362,4344,27018,27018,0,11,4430000.0
4430,4430999,22.018283749225002,39.19227129388438,0.06287403255642676,725.1162269115448,291.3759832382202,904.5659523010254,31369,4344,27025,27025,0,11,4431000.0
4431,4431999,22.01946582034064,39.19329396094203,0.06289022330203509,725.3133492469788,291.4428827762604,905.1703948974609,31391,4345,27046,27046,0,11,4432000.0
4432,4432999,22.020420417919038,39.194171702889086,0.06292006328285471,725.5828471183777,291.50876927375793,905.3117942810059,31405,4347,27058,27058,0,11,4433000.0
4433,4433999,22.0217940750396,39.19558265441345,0.06294481133749952,725.7064757347107,291.5797338485718,905.5053443908691,31405,4347,27058,27058,0,11,4434000.0
4434,4434999,22.023738179114666,39.19884879202341,0.06296312003581872,725.9764513969421,291.6474087238312,906.1542167663574,31433,4349,27084,27084,0,11,4435000.0
4435,4435999,22.026211789056454,39.20215653359882,0.06303632534547621,726.171884059906,291.71387219429016,906.3382759094238,31440,4350,27090,27090,0,11,4436000.0
4436,4436999,22.02844757727593,39.20879099323493,0.06304979340398775,726.5195498466492,291.7808632850647,906.6254615783691,31480,4353,27127,27127,0,11,4437000.0
4437,4437999,22.030947996077103,39.21158628728415,0.06307111874503057,727.2326321601868,291.84725546836853,906.5776481628418,31538,4361,27177,27177,0,11,4438000.0
4438,4438999,22.03366173191402,39.216086996370045,0.06308544688019624,727.5759394168854,291.91326117515564,906.6880874633789,31548,4364,27184,27184,0,11,4439000.0
4439,4439999,22.036370710164064,39.22063399359499,0.06313740231470155,728.0045244693756,291.9817428588867,906.8295745849609,31576,4368,27208,27208,0,11,4440000.0
4440,4440999,22.038214343719943,39.222428174073016,0.06315122409496887,728.2654476165771,292.04655361175537,906.9732055664062,31590,4370,27220,27220,0,11,4441000.0
4441,4441999,22.0377403630714,39.221080306055974,0.06316753311603263,728.4567918777466,292.1113541126251,907.2657432556152,31605,4371,27234,27234,0,11,4442000.0
4442,4442999,22.035998376846162,39.218825724042674,0.06317793780520353,728.6676917076111,292.1778721809387,907.5983352661133,31623,4372,27251,27251,0,11,4443000.0
4443,4443999,22.034275239166888,39.21739743513471,0.06318508240400544,728.9335207939148,292.2443211078644,907.7827033996582,31640,4374,27266,27266,0,11,4444000.0
4444,4444999,22.032333182585162,39.215019828736644,0.06319487669746338,729.1382462978363,292.311731338501,907.9065093994141,31648,4375,27273,27273,0,11,4445000.0
4445,4445999,22.030769507391966,39.21250444237586,0.0631986413656348,729.2657043933868,292.3794033527374,908.3385047912598,31661,4375,27286,27286,0,11,4446000.0
4446,4446999,22.02926070111676,39.21003791800309,0.06320020032320817,729.4617149829865,292.4445185661316,908.5549545288086,31664,4376,27288,27288,0,11,4447000.0
4447,4447999,22.027783231141292,39.2077410199998,0.06320226060914891,729.5793125629425,292.5099287033081,908.7590103149414,31666,4376,27290,27290,0,11,4448000.0
4448,4448999,22.026594735240074,39.20522654004317,0.06320356343249767,729.718088388443,292.5766463279724,909.0909576416016,31673,4376,27297,27297,0,11,4449000.0
4449,4449999,22.025566232383497,39.20284958890988,0.0632018417886766,729.9890089035034,292.6425213813782,909.1715850830078,31677,4378,27299,27299,0,11,4450000.0
4450,4450999,22.024572545461886,39.200969410234784,0.06320025137487661,730.2508988380432,292.708144903183,909.2108612060547,31681,4380,27301,27301,0,11,4451000.0
4451,4451999,22.023980233281748,39.19899184746258,0.06318640868770531,730.3950662612915,292.77436089515686,909.8859481811523,31701,4380,27321,27321,0,11,4452000.0
4452,4452999,22.02346982405013,39.19787001159814,0.06317159677070161,730.5892307758331,292.83980107307434,910.1733131408691,31712,4381,27331,27331,0,11,4453000.0
4453,4453999,22.022584214354236,39.195599801963446,0.06316305571603609,730.7204215526581,292.90555596351624,910.3763542175293,31712,4381,27331,27331,0,11,4454000.0
4454,4454999,22.022068983434476,39.19378507949491,0.06315144331478684,730.9240252971649,292.9717118740082,910.8381881713867,31732,4382,27350,27350,0,11,4455000.0
4455,4455999,22.021634946568458,39.19177050814982,0.06314206641977438,731.2003536224365,293.03785490989685,911.0496406555176,31760,4384,27376,27376,0,11,4456000.0
4456,4456999,22.021443064627295,39.19016124520755,0.06312936238999556,731.5421144962311,293.1047887802124,911.1993064880371,31794,4387,27407,27407,0,11,4457000.0
4457,4457999,22.02177928944024,39.18868898889352,0.06310301610707303,731.6654613018036,293.1695325374603,911.470531463623,31795,4387,27408,27408,0,11,4458000.0
4458,4458999,22.02174405090496,39.18697176740688,0.06308242845595469,731.9378945827484,293.235121011734,911.574836730957,31807,4389,27418,27418,0,11,4459000.0
4459,4459999,22.02186490121174,39.18568194435306,0.06305849619151604,732.065423488617,293.2998766899109,911.7927131652832,31810,4389,27421,27421,0,11,4460000.0
4460,4460999,22.020796325399406,39.184292786138705,0.06305405245759577,732.1885888576508,293.36579728126526,912.288330078125,31831,4389,27442,27442,0,11,4461000.0
4461,4461999,22.018738189258254,39.181513189251575,0.06306599079207464,732.3911237716675,293.4333577156067,912.6419296264648,31846,4390,27456,27456,0,11,4462000.0
4462,4462999,22.01707366382104,39.179897783287615,0.06307124838707345,732.7356526851654,293.50022649765015,912.7043838500977,31860,4393,27467,27467,0,11,4463000.0
4463,4463999,22.015135225998332,39.177114350824006,0.06308974992292404,733.0094010829926,293.56674909591675,912.8269271850586,31875,4395,27480,27480,0,11,4464000.0
4464,4464999,22.013757946333378,39.17521653403852,0.06308957502848878,733.1333491802216,293.6328868865967,913.2037391662598,31881,4395,27486,27486,0,11,4465000.0
4465,4465999,22.012452637681022,39.173582324876214,0.06309324011170825,733.404078245163,293.700110912323,913.3215370178223,31891,4397,27494,27494,0,11,4466000.0
4466,4466999,22.01127747667415,39.17511388750424,0.06308021357815863,733.5256354808807,293.76569175720215,913.50927734375,31892,4397,27495,27495,0,11,4467000.0
4467,4467999,22.009919534755493,39.17244924441783,0.06307670415690836,733.6413185596466,293.8315715789795,913.8254089355469,31897,4397,27500,27500,0,11,4468000.0
4468,4468999,22.00871243668862,39.170021480102214,0.06307323470834247,734.0582497119904,293.8980495929718,913.821346282959,31916,4401,27515,27515,0,11,4469000.0
4469,4469999,22.007503359482808,39.16766566470369,0.06307154482268451,734.2521188259125,293.964182138443,913.9545288085938,31923,4402,27521,27521,0,11,4470000.0
4470,4470999,22.006956944033664,39.16612021080686,0.06305028902815157,734.5258295536041,294.0304043292999,914.3665542602539,31937,4404,27533,27533,0,11,4471000.0
4471,4471999,22.006672229780822,39.16471122441414,0.06303555594269838,734.8707165718079,294.0973699092865,914.4696846008301,31943,4407,27536,27536,0,11,4472000.0
4472,4472999,22.006225366923875,39.16374953649671,0.06302257401449973,734.9909262657166,294.16527104377747,914.6338653564453,31943,4407,27536,27536,0,11,4473000.0
4473,4473999,22.006242042027303,39.16276200370343,0.06299923473710545,735.2732796669006,294.23248529434204,914.976131439209,31963,4409,27554,27554,0,11,4474000.0
4474,4474999,22.00618693216221,39.1615359034757,0.06298191475319437,735.4741785526276,294.29843640327454,915.1442527770996,31965,4410,27555,27555,0,11,4475000.0
4475,4475999,22.00633639551182,39.16014467840877,0.06296800954943049,735.6798174381256,294.3643481731415,915.1757659912109,31972,4411,27561,27561,0,11,4476000.0
4476,4476999,22.00669299811973,39.158750885896154,0.06294389469738171,735.905930519104,294.4405879974365,915.5325965881348,31983,4412,27571,27571,0,11,4477000.0
4477,4477999,22.007528217848797,39.158339118449845,0.06292206487796059,736.1793434619904,294.5053322315216,915.5866737365723,31998,4414,27584,27584,0,11,4478000.0
4478,4478999,22.00799581071463,39.15721541695173,0.06290729052741262,736.3744320869446,294.5714576244354,915.7119979858398,32005,4415,27590,27590,0,11,4479000.0
4479,4479999,22.008255649211566,39.156063618189506,0.06288851301308629,736.4924621582031,294.6360080242157,915.9734039306641,32009,4415,27594,27594,0,11,4480000.0
4480,4480999,22.008041800307435,39.15501402671528,0.06287470976328724,736.6198205947876,294.7009987831116,916.2140655517578,32016,4415,27601,27601,0,11,4481000.0
4481,4481999,22.005831303354217,39.15271916687164,0.06288984584784396,736.8285722732544,294.7667570114136,916.6093635559082,32034,4416,27618,27618,0,11,4482000.0
4482,4482999,22.004111358424332,39.15337414740586,0.06288305895952817,736.9528651237488,294.83271503448486,916.9280090332031,32038,4416,27622,27622,0,11,4483000.0
4483,4483999,22.002044340398935,39.150947035445014,0.06289024354813333,737.2190244197845,294.8990812301636,917.0868301391602,32048,4418,27630,27630,0,11,4484000.0
4484,4484999,22.00044986616554,39.15011442690609,0.0628912489978043,737.4205830097198,294.96545910835266,917.166690826416,32055,4419,27636,27636,0,11,4485000.0
4485,4485999,21.998643950382196,39.147556377317976,0.06289335588144673,737.5532727241516,295.0314540863037,917.5374031066895,32062,4419,27643,27643,0,11,4486000.0
4486,4486999,21.996949946306227,39.145027981797476,0.06289508709235525,737.7517330646515,295.09651160240173,917.6814193725586,32064,4420,27644,27644,0,11,4487000.0
4487,4487999,21.995046118841067,39.142232863963876,0.06289874069432311,738.0229241847992,295.16229820251465,917.7703437805176,32073,4422,27651,27651,0,11,4488000.0
4488,4488999,21.993937117765412,39.14029655723197,0.06289389425420244,738.1418783664703,295.2288703918457,918.1259880065918,32080,4422,27658,27658,0,11,4489000.0
4489,4489999,21.992690405575342,39.137626384559695,0.0628896101020826,738.3486766815186,295.294718503952,918.2472763061523,32082,4423,27659,27659,0,11,4490000.0
4490,4490999,21.99133628320263,39.13507741396468,0.06288925857217365,738.5449857711792,295.3605201244354,918.3785667419434,32086,4424,27662,27662,0,11,4491000.0
4491,4491999,21.990579415948933,39.13338756694195,0.06287986176000682,738.7429535388947,295.4276268482208,918.7784957885742,32095,4425,27670,27670,0,11,4492000.0
4492,4492999,21.9903479827874,39.13288511459558,0.06285941717105914,738.9398460388184,295.4924786090851,918.9412155151367,32097,4426,27671,27671,0,11,4493000.0
4493,4493999,21.990101089399452,39.1318789395034,0.06285078622201756,739.1300311088562,295.5577871799469,919.1057281494141,32099,4427,27672,27672,0,11,4494000.0
4494,4494999,21.989658784613837,39.130827249707856,0.06283922963637789,739.4840652942657,295.6242218017578,919.2465744018555,32121,4430,27691,27691,0,11,4495000.0
4495,4495999,21.990082505559602,39.13046895697269,0.06281116025483746,739.7582845687866,295.6904106140137,919.5809555053711,32133,4432,27701,27701,0,11,4496000.0
4496,4496999,21.990125325190007,39.12895133136452,0.06279558939120733,740.0292155742645,295.75633001327515,919.7260055541992,32142,4434,27708,27708,0,11,4497000.0
4497,4497999,21.990055003958478,39.127579679636675,0.06278038158617205,740.4584805965424,295.8243260383606,920.2367286682129,32200,4438,27762,27762,0,11,4498000.0
4498,4498999,21.990147575894877,39.12657138555565,0.06276688645345063,740.7309710979462,295.8903911113739,920.4950942993164,32209,4440,27769,27769,0,11,4499000.0
4499,4499999,21.989830606588352,39.12485551977029,0.06275503824968698,740.9249765872955,295.95566868782043,920.6369972229004,32211,4441,27770,27770,0,11,4500000.0
4500,4500999,21.990068961265905,39.1253161011579,0.0627373746410067,741.122673034668,296.0211043357849,921.0024948120117,32224,4442,27782,27782,0,11,4501000.0
4501,4501999,21.989845469545365,39.12362249196465,0.06272812226095825,741.3154807090759,296.08662271499634,921.2150459289551,32231,4443,27788,27788,0,11,4502000.0
4502,4502999,21.988938727612624,39.1227847128688,0.0627258593306036,741.4428930282593,296.1525740623474,921.9243659973145,32258,4443,27815,27815,0,11,4503000.0
4503,4503999,21.987244939549402,39.12236938019361,0.06272959372604558,741.645171880722,296.2196719646454,922.3944473266602,32273,4444,27829,27829,0,11,4504000.0
4504,4504999,21.98566461905968,39.11974453423081,0.06273981927338357,741.8385841846466,296.28578877449036,922.6976547241211,32296,4445,27851,27851,0,11,4505000.0
4505,4505999,21.98430869058176,39.117643597958285,0.06274492274164756,741.9600446224213,296.3523871898651,922.9247779846191,32296,4445,27851,27851,0,11,4506000.0
4506,4506999,21.982683374586113,39.11473931316139,0.06275298869349644,742.0817985534668,296.4185972213745,923.0778045654297,32296,4445,27851,27851,0,11,4507000.0
4507,4507999,21.981793289537038,39.11330622337736,0.06275554835116148,742.2773633003235,296.48358130455017,923.3954162597656,32304,4446,27858,27858,0,11,4508000.0
4508,4508999,21.981282397226263,39.11159283129448,0.0627529205268802,742.6307902336121,296.5508577823639,923.5322303771973,32310,4449,27861,27861,0,11,4509000.0
4509,4509999,21.98075090849989,39.10996176512875,0.06274794317542054,742.8332867622375,296.6167502403259,923.7940101623535,32319,4450,27869,27869,0,11,4510000.0
4510,4510999,21.980092215334995,39.107927486967874,0.06274466393389555,742.9494097232819,296.6825051307678,924.0422134399414,32319,4450,27869,27869,0,11,4511000.0
4511,4511999,21.979646016852282,39.106558258551104,0.06274308209762813,743.2169449329376,296.7493243217468,924.1676940917969,32323,4452,27871,27871,0,11,4512000.0
4512,4512999,21.979325498495793,39.104771741944084,0.06274123372418994,743.3419301509857,296.815003156662,924.3246307373047,32323,4452,27871,27871,0,11,4513000.0
4513,4513999,21.97932960946576,39.10382808472724,0.06273342425056172,743.4567546844482,296.88086676597595,924.921257019043,32337,4452,27885,27885,0,11,4514000.0
4514,4514999,21.97921179804555,39.10275188640992,0.0627269595025387,743.6513824462891,296.94722962379456,925.1038589477539,32339,4453,27886,27886,0,11,4515000.0
4515,4515999,21.97914492854425,39.10169621614227,0.06272114980767818,743.9306056499481,297.01303267478943,925.1750068664551,32346,4455,27891,27891,0,11,4516000.0
4516,4516999,21.979140860339236,39.100136735886515,0.062709990514898,744.0548484325409,297.07994270324707,925.7288780212402,32359,4455,27904,27904,0,11,4517000.0
4517,4517999,21.979265138230787,39.09892101229794,0.062701295795618,744.4783794879913,297.1461851596832,925.817943572998,32380,4459,27921,27921,0,11,4518000.0
4518,4518999,21.97929034116961,39.09737887733677,0.06269532194007921,744.6870539188385,297.21256041526794,926.0334358215332,32384,4460,27924,27924,0,11,4519000.0
4519,4519999,21.979835723961727,39.09677176065471,0.0626787130576788,744.8115229606628,297.2790174484253,926.5012741088867,32394,4460,27934,27934,0,11,4520000.0
4520,4520999,21.98020913257941,39.09576691969503,0.06267181979299385,745.0122292041779,297.343781709671,926.5755233764648,32401,4461,27940,27940,0,11,4521000.0
4521,4521999,21.98024960558214,39.09415988438971,0.06266931742405268,745.2833886146545,297.40912675857544,926.6301345825195,32410,4463,27947,27947,0,11,4522000.0
4522,4522999,21.980377083275656,39.09290908512879,0.06266269553397907,745.4001965522766,297.47404313087463,926.906421661377,32415,4463,27952,27952,0,11,4523000.0
4523,4523999,21.979588716957966,39.0910230449035,0.0626565646697097,745.518324136734,297.53987550735474,927.3419761657715,32429,4463,27966,27966,0,11,4524000.0
4524,4524999,21.977617921806342,39.089066194145964,0.0626673965500526,745.7174289226532,297.605509519577,927.6206665039062,32440,4464,27976,27976,0,11,4525000.0
4525,4525999,21.975845437695046,39.08660517451024,0.06267106307427428,745.840737581253,297.6725821495056,927.9065704345703,32444,4464,27980,27980,0,11,4526000.0
4526,4526999,21.973850318252175,39.08382900152657,0.06268046024946217,745.9696371555328,297.7388663291931,928.0514259338379,32444,4464,27980,27980,0,11,4527000.0
4527,4527999,21.9723176097648,39.08289560910101,0.06268013829234198,746.2387552261353,297.805340051651,928.0929718017578,32459,4466,27993,27993,0,11,4528000.0
4528,4528999,21.971020029382593,39.08061180930806,0.06267885628101089,746.4475107192993,297.87245297431946,928.5435600280762,32481,4467,28014,28014,0,11,4529000.0
4529,4529999,21.969478846450176,39.07766937408754,0.06268029866271718,746.573478937149,297.9441885948181,928.7973518371582,32482,4467,28015,28015,0,11,4530000.0
4530,4530999,21.96800943009827,39.074902221012174,0.06267985640685658,746.7669358253479,298.0098762512207,928.9076995849609,32484,4468,28016,28016,0,11,4531000.0
4531,4531999,21.967050081775152,39.07296133891734,0.06266663653921112,746.8913550376892,298.076402425766,929.2667350769043,32492,4468,28024,28024,0,11,4532000.0
4532,4532999,21.966238594785967,39.07084417677153,0.06264891749696921,747.0155947208405,298.1428587436676,929.3991966247559,32492,4468,28024,28024,0,11,4533000.0
4533,4533999,21.965472794642423,39.06878607280601,0.06263206451632308,747.2252895832062,298.20922470092773,929.4379615783691,32494,4469,28025,28025,0,11,4534000.0
4534,4534999,21.964916059383768,39.067110401169494,0.06261439925887535,747.3445580005646,298.2753555774689,929.9827995300293,32509,4469,28040,28040,0,11,4535000.0
4535,4535999,21.96474306306906,39.06717788943186,0.06259237889741487,747.459395647049,298.34097170829773,930.2248954772949,32510,4469,28041,28041,0,11,4536000.0
4536,4536999,21.96429561812157,39.06577156086598,0.06257805352157975,747.6529519557953,298.4063835144043,930.3585205078125,32512,4470,28042,28042,0,11,4537000.0
4537,4537999,21.96397074337362,39.06425936101867,0.06256049207286507,747.7766289710999,298.4731321334839,930.8505363464355,32526,4470,28056,28056,0,11,4538000.0
4538,4538999,21.96416150030529,39.06309890202326,0.06253466287838172,747.9888713359833,298.54077911376953,931.0481643676758,32528,4471,28057,28057,0,11,4539000.0
4539,4539999,21.964642831426325,39.0623651035213,0.06250895595172212,748.3335764408112,298.60718154907227,931.1320114135742,32564,4474,28090,28090,0,11,4540000.0
4540,4540999,21.965462647971368,39.062218830083104,0.062475371917088074,748.5308961868286,298.6744396686554,931.6124267578125,32582,4475,28107,28107,0,11,4541000.0
4541,4541999,21.96660753578345,39.062037786123355,0.062458607942056266,748.8064637184143,298.7404878139496,931.793155670166,32593,4477,28116,28116,0,11,4542000.0
4542,4542999,21.967770249482005,39.062153329955606,0.06244198433392312,748.9300937652588,298.8057208061218,931.9708633422852,32593,4477,28116,28116,0,11,4543000.0
4543,4543999,21.96914785750489,39.06220820476432,0.06242438219466029,749.1307857036591,298.8724248409271,932.2895240783691,32632,4478,28154,28154,0,11,4544000.0
4544,4544999,21.96939004924151,39.060892469238496,0.062396471586812496,749.3299634456635,298.9368793964386,932.4824447631836,32636,4479,28157,28157,0,11,4545000.0
4545,4545999,21.967348804936258,39.05764067617241,0.062408254400099894,749.4548261165619,299.00298857688904,932.9886512756348,32654,4479,28175,28175,0,11,4546000.0
4546,4546999,21.965601117076,39.055945669363,0.0624098524779414,749.5792729854584,299.07013273239136,933.3008613586426,32660,4479,28181,28181,0,11,4547000.0
4547,4547999,21.96399882402689,39.05532627375875,0.06240595357903944,749.7748808860779,299.13675570487976,933.4808692932129,32669,4480,28189,28189,0,11,4548000.0
4548,4548999,21.962781370315017,39.05360398669231,0.06240409073348696,749.9109871387482,299.20349073410034,933.6436805725098,32669,4480,28189,28189,0,11,4549000.0
4549,4549999,21.96217547636343,39.053379153667585,0.06239304118330402,750.1168143749237,299.27108907699585,933.8622055053711,32678,4481,28197,28197,0,11,4550000.0
4550,4550999,21.961776053352683,39.05242497685596,0.06238457043990775,750.3070321083069,299.335871219635,934.0572128295898,32680,4482,28198,28198,0,11,4551000.0
4551,4551999,21.961275035021025,39.05205760350773,0.06237578339207517,750.4314367771149,299.4016225337982,934.2417411804199,32681,4482,28199,28199,0,11,4552000.0
4552,4552999,21.961329314965948,39.052881022603295,0.06236150560353704,750.7120394706726,299.4692392349243,934.4757652282715,32691,4484,28207,28207,0,11,4553000.0
4553,4553999,21.961992868048167,39.05398537253115,0.06234783102197683,750.8441987037659,299.53538846969604,934.6460838317871,32691,4484,28207,28207,0,11,4554000.0
4554,4554999,21.962816777738425,39.055326889677,0.0623338415683935,750.9600927829742,299.6009614467621,934.7600288391113,32691,4484,28207,28207,0,11,4555000.0
4555,4555999,21.96368453352911,39.05690881861363,0.06233459050526824,751.2484147548676,299.66773557662964,934.9453163146973,32705,4486,28219,28219,0,11,4556000.0
4556,4556999,21.965028417909636,39.05816671148968,0.06233719909860591,751.6012024879456,299.7332625389099,935.0089530944824,32716,4489,28227,28227,0,11,4557000.0
4557,4557999,21.966549329507536,39.06058170919967,0.06232991198041393,751.8139312267303,299.80719208717346,935.1234283447266,32719,4490,28229,28229,0,11,4558000.0
4558,4558999,21.969163029954835,39.06464734541387,0.06232126143396832,752.091059923172,299.87370467185974,935.4162750244141,32737,4492,28245,28245,0,11,4559000.0
4559,4559999,21.972044050796686,39.067905255650324,0.06232459043402416,752.44371509552,299.9399664402008,935.6383781433105,32759,4495,28264,28264,0,11,4560000.0
4560,4560999,21.97432072734532,39.070199307660296,0.06236393467912538,752.8047308921814,300.006623506546,935.8900413513184,32793,4498,28295,28295,0,11,4561000.0
4561,4561999,21.97706609818592,39.07304593500365,0.062413016570775026,753.0133969783783,300.072984457016,936.3895492553711,32810,4499,28311,28311,0,11,4562000.0
4562,4562999,21.979967197798043,39.07662021556235,0.062458734749317624,753.2183792591095,300.1388838291168,936.5992240905762,32817,4500,28317,28317,0,11,4563000.0
4563,4563999,21.98300331888993,39.08021272655578,0.06253673869892118,753.5761618614197,300.20517802238464,936.6453323364258,32831,4503,28328,28328,0,11,4564000.0
4564,4564999,21.9861174548592,39.08375458527421,0.06259948435236329,753.7671325206757,300.2715377807617,936.9235343933105,32845,4504,28341,28341,0,11,4565000.0
4565,4565999,21.98829515084959,39.08549889401784,0.06265581480943672,753.8882853984833,300.3362309932709,937.102466583252,32845,4504,28341,28341,0,11,4566000.0
4566,4566999,21.986797275185936,39.082852669289494,0.06265725705421887,754.0142681598663,300.4017264842987,937.4692573547363,32859,4504,28355,28355,0,11,4567000.0
4567,4567999,21.98512792954198,39.08085759167526,0.06267179573586545,754.1354413032532,300.46837162971497,937.7567825317383,32863,4504,28359,28359,0,11,4568000.0
4568,4568999,21.983561788633924,39.07952944919063,0.06267185491612937,754.2611849308014,300.53452587127686,937.9125175476074,32863,4504,28359,28359,0,11,4569000.0
4569,4569999,21.981872245980842,39.076664019546364,0.06267570100151887,754.4691843986511,300.6011891365051,937.9619522094727,32871,4505,28366,28366,0,11,4570000.0
4570,4570999,21.98012642638179,39.07385288906346,0.06267755017976617,754.677895784378,300.6676561832428,938.1089172363281,32877,4506,28371,28371,0,11,4571000.0
4571,4571999,21.978769844687054,39.07166004016201,0.06267533367630818,754.8693840503693,300.73253560066223,938.293384552002,32880,4507,28373,28373,0,11,4572000.0
4572,4572999,21.977475617480838,39.06998264787286,0.06266808048365058,755.0117905139923,300.8077883720398,938.4526214599609,32880,4507,28373,28373,0,11,4573000.0
4573,4573999,21.9762441021992,39.068364733841044,0.06266026326967178,755.3087978363037,300.87431740760803,938.7241744995117,32899,4509,28390,28390,0,11,4574000.0
4574,4574999,21.975217115235004,39.06677117756354,0.06265134446062626,755.5917890071869,300.941034078598,938.8829498291016,32904,4511,28393,28393,0,11,4575000.0
4575,4575999,21.97451857842934,39.06577808227106,0.0626420872230955,755.9552617073059,301.00850343704224,938.9310836791992,32922,4514,28408,28408,0,11,4576000.0
4576,4576999,21.97433658902559,39.06999035230212,0.06261988786247663,756.0913171768188,301.0753436088562,939.5646286010742,32944,4514,28430,28430,0,11,4577000.0
4577,4577999,21.97535328353517,39.07256664543382,0.06262787679030879,756.285347700119,301.1420726776123,939.9569358825684,32953,4515,28438,28438,0,11,4578000.0
4578,4578999,21.977753822290218,39.07874025525616,0.06266450516719524,756.4809679985046,301.20771837234497,940.2017478942871,32957,4516,28441,28441,0,11,4579000.0
4579,4579999,21.980591429540844,39.08471984949945,0.06271994324978925,756.7573947906494,301.27569031715393,940.7248992919922,32985,4518,28467,28467,0,11,4580000.0
4580,4580999,21.98403027398544,39.092413883012945,0.06279798192828534,756.8742904663086,301.342556476593,941.171875,32987,4518,28469,28469,0,11,4581000.0
4581,4581999,21.988596070559748,39.10253511313831,0.06295035495488521,756.9959106445312,301.40863490104675,941.3651733398438,32987,4518,28469,28469,0,11,4582000.0
4582,4582999,21.99312591174943,39.111714283013555,0.06308707445697825,757.2065076828003,301.47585248947144,942.0285835266113,33008,4519,28489,28489,0,11,4583000.0
4583,4583999,21.99810460140221,39.123144116802806,0.06325124571779595,757.3202223777771,301.5402355194092,942.2576370239258,33008,4519,28489,28489,0,11,4584000.0
4584,4584999,22.00224688793869,39.13011944335379,0.0633431464092521,757.4493656158447,301.60531067848206,942.4620399475098,33008,4519,28489,28489,0,11,4585000.0
4585,4585999,22.00720524585042,39.1382619656863,0.06344946243387695,757.6523683071136,301.6705274581909,942.6477355957031,33020,4520,28500,28500,0,11,4586000.0
4586,4586999,22.00933581380669,39.141297847950554,0.0634734454599678,757.9271063804626,301.7361891269684,942.8139953613281,33063,4522,28541,28541,0,11,4587000.0
4587,4587999,22.007950132378607,39.14036417267879,0.06347038797179294,758.1438193321228,301.80240631103516,943.1723251342773,33090,4523,28567,28567,0,11,4588000.0
4588,4588999,22.006704792947183,39.139788163779244,0.06346435219154745,758.2643985748291,301.8702323436737,943.5433311462402,33096,4523,28573,28573,0,11,4589000.0
4589,4589999,22.005442876816538,39.13796246248005,0.0634630273063923,758.4768846035004,301.93754959106445,943.6292724609375,33104,4524,28580,28580,0,11,4590000.0
4590,4590999,22.003975486115277,39.13562023581623,0.0634664933903566,758.7627975940704,302.00510573387146,943.7422943115234,33120,4526,28594,28594,0,11,4591000.0
4591,4591999,22.002959370159832,39.134419959496746,0.06345780541728396,758.8882248401642,302.0711393356323,944.3051795959473,33133,4526,28607,28607,0,11,4592000.0
4592,4592999,22.001912645033812,39.13327883926275,0.06344964987392288,759.0833926200867,302.1366639137268,944.4682159423828,33140,4527,28613,28613,0,11,4593000.0
4593,4593999,22.0007906109197,39.131007191742206,0.0634440262652517,759.2864890098572,302.20389699935913,944.736988067627,33148,4528,28620,28620,0,11,4594000.0
4594,4594999,21.999827912244452,39.12891022997513,0.06343742286448717,759.4960827827454,302.27087473869324,944.9033241271973,33155,4529,28626,28626,0,11,4595000.0
4595,4595999,21.999311261570227,39.12732875292965,0.0634262993890774,759.7034676074982,302.336975812912,944.9853935241699,33161,4530,28631,28631,0,11,4596000.0
4596,4596999,21.999131581633083,39.12644751084636,0.06341007400024468,759.9993553161621,302.40480732917786,945.3878288269043,33183,4532,28651,28651,0,11,4597000.0
4597,4597999,21.999114843130062,39.12641979793654,0.0633925092645311,760.2754380702972,302.47174310684204,945.6724548339844,33208,4534,28674,28674,0,11,4598000.0
4598,4598999,21.999047468904347,39.125409469997656,0.06337875237801649,760.3963632583618,302.53746366500854,945.923469543457,33208,4534,28674,28674,0,11,4599000.0
4599,4599999,21.99939127405908,39.12507226490937,0.06336431963678779,760.6047186851501,302.60409283638,946.3484878540039,33228,4535,28693,28693,0,11,4600000.0
4600,4600999,22.00051144727299,39.128732303847485,0.06333584328144615,760.810754776001,302.6705889701843,946.7335548400879,33238,4536,28702,28702,0,11,4601000.0
4601,4601999,22.001125083882098,39.12969763634322,0.0633206650155329,761.1756582260132,302.73777532577515,946.9064331054688,33274,4539,28735,28735,0,11,4602000.0
4602,4602999,22.00225684490394,39.13117726716439,0.06330411007131487,761.3778536319733,302.80396366119385,947.402172088623,33296,4540,28756,28756,0,11,4603000.0
4603,4603999,22.00306390318165,39.13246443950023,0.06329170530412698,761.6515083312988,302.8696835041046,947.5312194824219,33311,4542,28769,28769,0,11,4604000.0
4604,4604999,22.0036243440861,39.1317610804772,0.06328220535673013,761.9325883388519,302.93684697151184,947.7229537963867,33337,4544,28793,28793,0,11,4605000.0
4605,4605999,22.00326305564428,39.130806605401396,0.06326931576524508,762.1471409797668,303.00291538238525,948.1104393005371,33354,4545,28809,28809,0,11,4606000.0
4606,4606999,22.002086622828834,39.130518526333816,0.0632731360804849,762.3424224853516,303.06917929649353,948.5681800842285,33374,4546,28828,28828,0,11,4607000.0
4607,4607999,22.000589550243166,39.12896423418562,0.06326960154129035,762.5457720756531,303.13588643074036,948.7774124145508,33377,4547,28830,28830,0,11,4608000.0
4608,4608999,21.999158118849795,39.12702408814694,0.0632744516681818,762.8245503902435,303.20278453826904,948.9208641052246,33388,4549,28839,28839,0,11,4609000.0
4609,4609999,21.99891301491658,39.12841071872944,0.0632641783566289,762.9446225166321,303.26944398880005,949.2736587524414,33393,4549,28844,28844,0,11,4610000.0
4610,4610999,21.999450919427566,39.12939510716987,0.0632704912501264,763.2328681945801,303.3353838920593,949.4016494750977,33431,4551,28880,28880,0,11,4611000.0
4611,4611999,22.00014771454197,39.13017953846633,0.06327466513566138,763.3518025875092,303.4002993106842,949.5266265869141,33431,4551,28880,28880,0,11,4612000.0
4612,4612999,22.001284091242464,39.13301565315218,0.06326499133987784,763.6293957233429,303.46654295921326,949.7522583007812,33451,4553,28898,28898,0,11,4613000.0
4613,4613999,22.002240031921684,39.13364167772868,0.0632435590167102,763.9209487438202,303.5338206291199,949.8099174499512,33455,4555,28900,28900,0,11,4614000.0
4614,4614999,22.003517284283873,39.1352631334945,0.06325292751670808,764.1953301429749,303.60076689720154,949.9097480773926,33459,4557,28902,28902,0,11,4615000.0
4615,4615999,22.00590656074763,39.13928668673655,0.06323681201219888,764.4780938625336,303.6676163673401,950.3324661254883,33478,4559,28919,28919,0,11,4616000.0
4616,4616999,22.008124738135276,39.14206783172252,0.06326389201577942,764.772570848465,303.73503518104553,950.4939575195312,33485,4561,28924,28924,0,11,4617000.0
4617,4617999,22.00968116175062,39.14358545041572,0.06328251546243524,764.974127292633,303.8008453845978,950.605899810791,33487,4562,28925,28925,0,11,4618000.0
4618,4618999,22.01178608401855,39.14666082654862,0.06328977748750175,765.2562906742096,303.86809158325195,951.099552154541,33510,4564,28946,28946,0,11,4619000.0
4619,4619999,22.014777258882127,39.152044775828536,0.0632864452013252,765.537535905838,303.936386346817,951.2396850585938,33519,4566,28953,28953,0,11,4620000.0
4620,4620999,22.017334977548078,39.15577951067994,0.06329684974867777,765.7426962852478,304.00219678878784,951.3484115600586,33525,4567,28958,28958,0,11,4621000.0
4621,4621999,22.020281175362562,39.1612961766645,0.06330712641716518,766.183413028717,304.06951808929443,951.7002105712891,33558,4571,28987,28987,0,11,4622000.0
4622,4622999,22.0235029592005,39.165938910683046,0.06332903923178113,766.5353457927704,304.1358993053436,951.8985633850098,33573,4574,28999,28999,0,11,4623000.0
4623,4623999,22.0259051792277,39.16855661171902,0.0633572121883067,766.978985786438,304.20251083374023,951.9436340332031,33595,4578,29017,29017,0,11,4624000.0
4624,4624999,22.0281649487147,39.17175779918185,0.0633816671648385,767.1741623878479,304.26812839508057,952.359245300293,33608,4579,29029,29029,0,11,4625000.0
4625,4625999,22.028770792494992,39.1716172008841,0.06339213551966827,767.2899792194366,304.3336203098297,952.8384208679199,33623,4579,29044,29044,0,11,4626000.0
4626,4626999,22.02728837040208,39.170313657065606,0.06339323358676707,767.5711307525635,304.39970326423645,953.0965385437012,33640,4581,29059,29059,0,11,4627000.0
4627,4627999,22.02598846828542,39.16852747280422,0.06340271098631123,767.7788970470428,304.466162443161,953.1999931335449,33647,4582,29065,29065,0,11,4628000.0
4628,4628999,22.024918808539685,39.16682273148448,0.06340438788553815,767.9104762077332,304.53254556655884,953.3354721069336,33648,4582,29066,29066,0,11,4629000.0
4629,4629999,22.024240254683058,39.165902818976974,0.06340220458719026,768.193920135498,304.59922099113464,953.388069152832,33663,4584,29079,29079,0,11,4630000.0
4630,4630999,22.02434396507127,39.16659958317037,0.06338972514846763,768.3164455890656,304.6656756401062,953.7082595825195,33668,4584,29084,29084,0,11,4631000.0
4631,4631999,22.024318614578767,39.16630053002918,0.06339300906756873,768.5164959430695,304.7281928062439,953.857780456543,33671,4585,29086,29086,0,11,4632000.0
4632,4632999,22.024142850560356,39.16521007406649,0.06339184041462265,768.6350548267365,304.78996205329895,953.9943656921387,33673,4585,29088,29088,0,11,4633000.0
4633,4633999,22.024186118483957,39.16457259348957,0.0633912429690453,768.7501218318939,304.8534483909607,954.2260398864746,33675,4585,29090,29090,0,11,4634000.0
4634,4634999,22.025037464341985,39.16786488087543,0.0633744495708467,769.1105661392212,304.91750407218933,954.2573699951172,33688,4588,29100,29100,0,11,4635000.0
4635,4635999,22.02535834971111,39.16815749036357,0.06337496211216531,769.2388441562653,304.98374032974243,954.3779754638672,33688,4588,29100,29100,0,11,4636000.0
4636,4636999,22.02723751743174,39.17172520739834,0.06338045623058097,769.4292945861816,305.0466504096985,954.7286338806152,33701,4589,29112,29112,0,11,4637000.0
4637,4637999,22.029528066512487,39.17568276567035,0.06340063692065712,769.7026526927948,305.1095449924469,954.8811225891113,33705,4591,29114,29114,0,11,4638000.0
4638,4638999,22.031387150207042,39.17789055516545,0.06341035152563546,769.9946939945221,305.17562198638916,954.9243087768555,33717,4593,29124,29124,0,11,4639000.0
4639,4639999,22.034029550263813,39.18182491496044,0.0634124550036046,770.3453106880188,305.23928236961365,955.1800994873047,33759,4596,29163,29163,0,11,4640000.0
4640,4640999,22.03695605960255,39.18548160246829,0.06345079738678272,770.5392162799835,305.3030378818512,955.3559608459473,33761,4597,29164,29164,0,11,4641000.0
4641,4641999,22.040095704798382,39.18983437098951,0.06346609046976848,770.6654839515686,305.36583971977234,955.482177734375,33761,4597,29164,29164,0,11,4642000.0
4642,4642999,22.04352984129552,39.19711413443745,0.06346635673177237,770.8661801815033,305.4280934333801,955.886531829834,33775,4598,29177,29177,0,11,4643000.0
4643,4643999,22.04719368238689,39.20595004412059,0.06347698372417732,771.1391007900238,305.49159240722656,956.0026893615723,33788,4600,29188,29188,0,11,4644000.0
4644,4644999,22.05013903878535,39.21046848880131,0.06348866113184193,771.3475468158722,305.5545790195465,956.2129058837891,33796,4601,29195,29195,0,11,4645000.0
4645,4645999,22.05222218604129,39.21274539334258,0.06351403820339907,771.5427248477936,305.6200792789459,956.434684753418,33806,4602,29204,29204,0,11,4646000.0
4646,4646999,22.052440648439823,39.21429473905692,0.06344425111520824,771.7537176609039,305.69172763824463,956.8816108703613,33822,4603,29219,29219,0,11,4647000.0
4647,4647999,22.051006734677973,39.213543765517194,0.06344488758392053,771.9502251148224,305.7563621997833,957.3308868408203,33841,4604,29237,29237,0,11,4648000.0
4648,4648999,22.049693504501903,39.21201812987118,0.06344531487744542,772.0703494548798,305.819783449173,957.5640754699707,33843,4604,29239,29239,0,11,4649000.0
4649,4649999,22.04877427367813,39.210708569096866,0.06344423834629798,772.2031824588776,305.8853409290314,957.6897354125977,33843,4604,29239,29239,0,11,4650000.0
4650,4650999,22.048031794953054,39.2103173893265,0.06343731759483939,772.327398777008,305.95088815689087,957.802661895752,33843,4604,29239,29239,0,11,4651000.0
4651,4651999,22.047806193844885,39.20931238178617,0.06343101386112993,772.6960978507996,306.0140254497528,957.8914947509766,33875,4607,29268,29268,0,11,4652000.0
4652,4652999,22.047427112980788,39.20836411315664,0.06342806480114405,772.9714677333832,306.0763006210327,957.9009552001953,33883,4609,29274,29274,0,11,4653000.0
4653,4653999,22.046894243878963,39.2067605058539,0.06342734187548638,773.085143327713,306.13876032829285,958.1077842712402,33884,4609,29275,29275,0,11,4654000.0
4654,4654999,22.047062532672584,39.207272448839525,0.06341397392231507,773.456508398056,306.20768451690674,958.0802040100098,33905,4612,29293,29293,0,11,4655000.0
4655,4655999,22.047522589326604,39.208427433679866,0.06339958041039251,773.5925562381744,306.2704916000366,958.1491546630859,33905,4612,29293,29293,0,11,4656000.0
4656,4656999,22.048151266387475,39.209459642422786,0.06339168150158025,773.7908129692078,306.33441400527954,958.5126457214355,33930,4613,29317,29317,0,11,4657000.0
4657,4657999,22.049622913263498,39.214201924002545,0.0633770681390643,773.9850656986237,306.39748907089233,958.8334732055664,33933,4614,29319,29319,0,11,4658000.0
4658,4658999,22.0507410802744,39.21604401725054,0.06337617154953035,774.100254535675,306.4597418308258,959.0337677001953,33933,4614,29319,29319,0,11,4659000.0
4659,4659999,22.051686561072128,39.21666782471436,0.06337420011974959,774.3784368038177,306.52427792549133,959.2870216369629,33947,4616,29331,29331,0,11,4660000.0
4660,4660999,22.052813757536605,39.217670426313,0.06337239113782844,774.4893507957458,306.5868968963623,959.6089324951172,33951,4616,29335,29335,0,11,4661000.0
4661,4661999,22.05496557765969,39.220267672421286,0.06340170399459022,774.6889464855194,306.6491918563843,959.727783203125,33953,4617,29336,29336,0,11,4662000.0
4662,4662999,22.057093407950422,39.22422049294489,0.06340216063643767,774.8124942779541,306.71252703666687,959.9803314208984,33958,4617,29341,29341,0,11,4663000.0
4663,4663999,22.058889882909806,39.225835858849145,0.06341356888296013,774.9396152496338,306.77423071861267,960.1019287109375,33958,4617,29341,29341,0,11,4664000.0
4664,4664999,22.06045613906616,39.22650205368319,0.06342165991494408,775.0637674331665,306.8368430137634,960.2006340026855,33959,4617,29342,29342,0,11,4665000.0
4665,4665999,22.062108586446737,39.22786763985548,0.06342639136097816,775.4089257717133,306.89907908439636,960.2534484863281,33969,4620,29349,29349,0,11,4666000.0
4666,4666999,22.062687536833206,39.22733211331815,0.06342606347683388,775.6146214008331,306.96556758880615,960.5648651123047,33981,4621,29360,29360,0,11,4667000.0
4667,4667999,22.061007684625007,39.225446399243125,0.0634305300299175,775.8176608085632,307.0307912826538,960.783088684082,33988,4622,29366,29366,0,11,4668000.0
4668,4668999,22.059290718051077,39.22323382097458,0.0634351684987472,776.1010768413544,307.09445786476135,960.9933776855469,34012,4624,29388,29388,0,11,4669000.0
4669,4669999,22.057515462756424,39.220551406696906,0.06344775767482236,776.224851846695,307.1582684516907,961.1409454345703,34012,4624,29388,29388,0,11,4670000.0
4670,4670999,22.056135094807928,39.219275040734225,0.0634496296324999,776.3499264717102,307.2214479446411,961.2780609130859,34012,4624,29388,29388,0,11,4671000.0
4671,4671999,22.05466795198563,39.21671332524489,0.06345142118598524,776.4708919525146,307.28742575645447,961.577693939209,34018,4624,29394,29394,0,11,4672000.0
4672,4672999,22.05326432162381,39.21387919344532,0.06345428471395975,776.6664190292358,307.35071754455566,961.7256240844727,34021,4625,29396,29396,0,11,4673000.0
4673,4673999,22.052519513831868,39.21305787652942,0.06345167925716477,776.7836315631866,307.4132413864136,961.8500366210938,34021,4625,29396,29396,0,11,4674000.0
4674,4674999,22.0515160034424,39.21080865555101,0.06345169754740909,776.9851667881012,307.47856974601746,962.177188873291,34030,4626,29404,29404,0,11,4675000.0
4675,4675999,22.050835758542252,39.20914896679187,0.06344633884555462,777.187353849411,307.5423426628113,962.3134613037109,34032,4627,29405,29405,0,11,4676000.0
4676,4676999,22.05026715290284,39.207806070170754,0.06344687533786353,777.3901016712189,307.6051752567291,962.3811569213867,34034,4628,29406,29406,0,11,4677000.0
4677,4677999,22.050206108265538,39.206976671128075,0.0634376835168653,777.5086472034454,307.66964173316956,962.904483795166,34049,4628,29421,29421,0,11,4678000.0
4678,4678999,22.05045220141043,39.20916659028381,0.06343576624123415,777.628556728363,307.7316040992737,963.1438217163086,34049,4628,29421,29421,0,11,4679000.0
4679,4679999,22.050259910695335,39.20810986021619,0.06344053713670139,777.9096608161926,307.79464650154114,963.2675399780273,34059,4630,29429,29429,0,11,4680000.0
4680,4680999,22.050869131627536,39.208012154541706,0.06344390147612344,778.027797460556,307.85848093032837,963.7122611999512,34072,4630,29442,29442,0,11,4681000.0
4681,4681999,22.051745601641144,39.20848528903918,0.06345431173362559,778.3872740268707,307.9252438545227,963.8203125,34089,4633,29456,29456,0,11,4682000.0
4682,4682999,22.05267182191341,39.20832981242191,0.06348551682192238,778.4995412826538,307.98780727386475,963.9918785095215,34089,4633,29456,29456,0,11,4683000.0
4683,4683999,22.055368963949128,39.22031071375128,0.06347452507478657,778.7828705310822,308.0538980960846,964.3356285095215,34111,4635,29476,29476,0,11,4684000.0
4684,4684999,22.056743666642966,39.22145964790354,0.06348513369141418,778.8997151851654,308.11578345298767,964.5550804138184,34111,4635,29476,29476,0,11,4685000.0
4685,4685999,22.058122707764138,39.224205487191156,0.06351299140497635,779.0186088085175,308.17770504951477,964.7021369934082,34111,4635,29476,29476,0,11,4686000.0
4686,4686999,22.05975387096341,39.225556815274196,0.06351652028899646,779.1453309059143,308.2427580356598,965.1857070922852,34123,4635,29488,29488,0,11,4687000.0
4687,4687999,22.059525390438527,39.22453546678481,0.0635165031090682,779.3429152965546,308.3066771030426,965.6793937683105,34150,4636,29514,29514,0,11,4688000.0
4688,4688999,22.05810541835113,39.2236242620257,0.06351134406893155,779.615875005722,308.36997509002686,966.0094528198242,34162,4638,29524,29524,0,11,4689000.0
4689,4689999,22.05700002061339,39.22435559457029,0.0635107295479963,779.9780077934265,308.4372630119324,966.1629447937012,34187,4641,29546,29546,0,11,4690000.0
4690,4690999,22.0558225630756,39.22320030413906,0.06351085883996976,780.0982096195221,308.50235533714294,966.3943862915039,34189,4641,29548,29548,0,11,4691000.0
4691,4691999,22.054268487229464,39.2208262666489,0.063514501384771,780.545262336731,308.56923055648804,966.464672088623,34211,4645,29566,29566,0,11,4692000.0
4692,4692999,22.053397356224938,39.21924677602373,0.06350981486008789,780.7461314201355,308.63361501693726,966.7621688842773,34221,4646,29575,29575,0,11,4693000.0
4693,4693999,22.052816275889043,39.218611129211816,0.0635097556840265,781.0101592540741,308.69606161117554,966.9211311340332,34226,4648,29578,29578,0,11,4694000.0
4694,4694999,22.05197032554847,39.216688962924316,0.06350901763903616,781.2101197242737,308.7598445415497,967.0656814575195,34231,4649,29582,29582,0,11,4695000.0
4695,4695999,22.051510950884303,39.21626721566696,0.06350056154635486,781.6471030712128,308.82462191581726,967.2703971862793,34251,4653,29598,29598,0,11,4696000.0
4696,4696999,22.05176719503187,39.21707137834825,0.06348929767851141,781.9185333251953,308.8881561756134,967.4206619262695,34257,4655,29602,29602,0,11,4697000.0
4697,4697999,22.052213690090884,39.21898123135943,0.06349139487865152,782.113471031189,308.9519021511078,967.5692443847656,34259,4656,29603,29603,0,11,4698000.0
4698,4698999,22.052957243786004,39.22065220592934,0.06350489489344857,782.300666809082,309.01640152931213,967.8372459411621,34265,4657,29608,29608,0,11,4699000.0
4699,4699999,22.054492638835704,39.22471695258149,0.06357511126734638,782.4943573474884,309.0795485973358,968.0531044006348,34268,4658,29610,29610,0,11,4700000.0
4700,4700999,22.05645788491485,39.2290513073346,0.06358748833805727,782.6888782978058,309.14236283302307,968.1399993896484,34270,4659,29611,29611,0,11,4701000.0
4701,4701999,22.05927026091974,39.236078265343075,0.06359402537699588,782.8966314792633,309.20672392845154,968.6999740600586,34287,4660,29627,29627,0,11,4702000.0
4702,4702999,22.062488725395916,39.24380939952052,0.06363512743759436,783.168535232544,309.27070212364197,968.8629417419434,34296,4662,29634,29634,0,11,4703000.0
4703,4703999,22.066520877698437,39.25466301451751,0.06364387281399642,783.4453890323639,309.33436918258667,969.2778015136719,34323,4664,29659,29659,0,11,4704000.0
4704,4704999,22.07067944620906,39.26488479309044,0.0636721426614576,783.8706345558167,309.39812564849854,969.4510803222656,34348,4668,29680,29680,0,11,4705000.0
4705,4705999,22.074632056084255,39.27435421633581,0.06371747587519416,784.141035079956,309.4615659713745,969.5310516357422,34358,4670,29688,29688,0,11,4706000.0
4706,4706999,22.079542122946926,39.28584009483144,0.0637091702872391,784.4930307865143,309.5242772102356,969.8105316162109,34383,4673,29710,29710,0,11,4707000.0
4707,4707999,22.081887609195224,39.290314765330905,0.06373995260127918,784.7622947692871,309.58704113960266,970.1574592590332,34408,4675,29733,29733,0,11,4708000.0
4708,4708999,22.07990099884908,39.28741842046909,0.06374405277709572,784.9716627597809,309.6540958881378,970.5068435668945,34426,4676,29750,29750,0,11,4709000.0
4709,4709999,22.078918704930512,39.28727820135532,0.06372956623874626,785.2508194446564,309.7182071208954,970.7711982727051,34461,4678,29783,29783,0,11,4710000.0
4710,4710999,22.077842386203194,39.28660537908724,0.06372236878069526,785.3672754764557,309.7804789543152,970.9289207458496,34461,4678,29783,29783,0,11,4711000.0
4711,4711999,22.076499322708347,39.285084962816136,0.06371924371212312,785.4907341003418,309.84549617767334,971.1087341308594,34461,4678,29783,29783,0,11,4712000.0
4712,4712999,22.075688894657144,39.28377808679492,0.06370897887814775,785.6168458461761,309.9093403816223,971.3781051635742,34464,4678,29786,29786,0,11,4713000.0
4713,4713999,22.074773857786152,39.28159191125502,0.06370274628315764,785.8117134571075,309.9718632698059,971.5151100158691,34467,4679,29788,29788,0,11,4714000.0
4714,4714999,22.07406527108544,39.27978277675246,0.06369369845325523,786.0881307125092,310.03522539138794,971.5207252502441,34479,4681,29798,29798,0,11,4715000.0
4715,4715999,22.073557712939486,39.278369049935726,0.0636838645062131,786.2891793251038,310.0991299152374,971.6979217529297,34482,4682,29800,29800,0,11,4716000.0
4716,4716999,22.07315221241431,39.27860870625789,0.06366759236057895,786.487978219986,310.16290163993835,971.8133544921875,34484,4683,29801,29801,0,11,4717000.0
4717,4717999,22.07307678341058,39.2782214291353,0.06365373177756739,786.7760579586029,310.2264595031738,971.9125862121582,34499,4685,29814,29814,0,11,4718000.0
4718,4718999,22.073421178028724,39.27845772577473,0.06363566081582184,786.8969614505768,310.29050159454346,972.6152954101562,34519,4685,29834,29834,0,11,4719000.0
4719,4719999,22.0738469522755,39.278967319826045,0.06363800743430514,787.0188314914703,310.35656332969666,972.8742637634277,34519,4685,29834,29834,0,11,4720000.0
4720,4720999,22.074930632165145,39.28061550722975,0.06362628099496681,787.1479699611664,310.41954803466797,973.0672950744629,34519,4685,29834,29834,0,11,4721000.0
4721,4721999,22.07737207797325,39.28454390204654,0.06360208137746581,787.2703778743744,310.4863352775574,973.6794700622559,34538,4685,29853,29853,0,11,4722000.0
4722,4722999,22.080733941279348,39.29068069885441,0.06361108723353526,787.3917329311371,310.55180764198303,973.936897277832,34538,4685,29853,29853,0,11,4723000.0
4723,4723999,22.084910745853016,39.29806555923519,0.0636586746818687,787.5050556659698,310.61361479759216,974.0858154296875,34538,4685,29853,29853,0,11,4724000.0
4724,4724999,22.088415176464224,39.3030867447008,0.06370412132489178,787.698587179184,310.6761336326599,974.5546798706055,34558,4686,29872,29872,0,11,4725000.0
4725,4725999,22.092410260753983,39.3096233499165,0.06376051983388287,787.8841507434845,310.73874521255493,974.6671981811523,34563,4687,29876,29876,0,11,4726000.0
4726,4726999,22.097114622159843,39.31987748766988,0.06382820084306173,788.0004348754883,310.80263590812683,974.8959503173828,34566,4687,29879,29879,0,11,4727000.0
4727,4727999,22.101040791349373,39.32714188991877,0.06386998079638107,788.2132880687714,310.86782002449036,975.0563507080078,34569,4688,29881,29881,0,11,4728000.0
4728,4728999,22.101917013761533,39.32802508646343,0.06387245796078744,788.494624376297,310.9304869174957,975.4807395935059,34601,4690,29911,29911,0,11,4729000.0
4729,4729999,22.101327573474713,39.32874575903125,0.0638587367767336,788.937760591507,310.99682784080505,975.9566879272461,34668,4694,29974,29974,0,11,4730000.0
4730,4730999,22.10076246232988,39.3288312646927,0.06384548548663571,789.3731069564819,311.0625991821289,976.1410865783691,34737,4698,30039,30039,0,11,4731000.0
4731,4731999,22.10055205600738,39.32939316133841,0.06383279668278963,789.4962310791016,311.1292998790741,976.4360198974609,34737,4698,30039,30039,0,11,4732000.0
4732,4732999,22.100830887926726,39.33105588914891,0.06377963009231025,789.6117599010468,311.1938352584839,977.0599098205566,34752,4698,30054,30054,0,11,4733000.0
4733,4733999,22.10059192669985,39.33050790365207,0.06375395558436747,789.8075711727142,311.2581298351288,977.3030967712402,34755,4699,30056,30056,0,11,4734000.0
4734,4734999,22.100156535367883,39.329993576525986,0.06375335803360149,790.0814290046692,311.321768283844,977.5451126098633,34771,4701,30070,30070,0,11,4735000.0
4735,4735999,22.099583439105306,39.32920130843423,0.0637450759111301,790.203503370285,311.38612604141235,977.952018737793,34777,4701,30076,30076,0,11,4736000.0
4736,4736999,22.099592710106602,39.32921352943716,0.06373096490623609,790.316166639328,311.44956612586975,978.1487197875977,34777,4701,30076,30076,0,11,4737000.0
4737,4737999,22.09989619225727,39.329418130281475,0.06372750958173057,790.6773197650909,311.51476526260376,978.1477851867676,34788,4704,30084,30084,0,11,4738000.0
4738,4738999,22.100005117978824,39.32904614096615,0.06371322208916053,790.9597809314728,311.5816807746887,978.8762664794922,34816,4706,30110,30110,0,11,4739000.0
4739,4739999,22.1001737827696,39.32869784410177,0.06372042346206253,791.1531791687012,311.6445982456207,979.1429481506348,34818,4707,30111,30111,0,11,4740000.0
4740,4740999,22.100516525606334,39.328738465896606,0.06371224812776921,791.3553953170776,311.71005511283875,979.6061706542969,34853,4708,30145,30145,0,11,4741000.0
4741,4741999,22.101751217233584,39.330624497211915,0.06369554524548793,791.4693796634674,311.7747132778168,980.1132392883301,34859,4708,30151,30151,0,11,4742000.0
4742,4742999,22.103692124800983,39.33418803752195,0.06368256522429361,791.5793733596802,311.8364489078522,980.3487167358398,34860,4708,30152,30152,0,11,4743000.0
4743,4743999,22.105546733057093,39.33608167002607,0.06366883731929862,791.790177822113,311.90143871307373,980.7938385009766,34875,4709,30166,30166,0,11,4744000.0
4744,4744999,22.106847450360952,39.33780862477833,0.06366904966389919,792.0745968818665,311.96633195877075,980.8688468933105,34886,4711,30175,30175,0,11,4745000.0
4745,4745999,22.10848573457733,39.340733323914264,0.06366442448493514,792.1892764568329,312.0286521911621,981.2075042724609,34891,4711,30180,30180,0,11,4746000.0
4746,4746999,22.10877097844679,39.34306250896975,0.0636529496913808,792.5389385223389,312.09308218955994,981.612548828125,34932,4714,30218,30218,0,11,4747000.0
4747,4747999,22.107440325338086,39.34178367267413,0.06365881854011701,792.6667788028717,312.15615224838257,982.034252166748,34939,4714,30225,30225,0,11,4748000.0
4748,4748999,22.105839610501793,39.33898886918838,0.0636753399698251,792.7795796394348,312.2194674015045,982.2645645141602,34942,4714,30228,30228,0,11,4749000.0
4749,4749999,22.104402399404204,39.337352392623316,0.06368246175188219,792.9812119007111,312.2841773033142,982.3721237182617,34944,4715,30229,30229,0,11,4750000.0
4750,4750999,22.10289328239298,39.33492639716412,0.0636927580865676,793.0921809673309,312.34699988365173,982.7713356018066,34951,4715,30236,30236,0,11,4751000.0
4751,4751999,22.101820335939912,39.333178679026865,0.06369067495211256,793.2904121875763,312.4101402759552,982.9458885192871,34954,4716,30238,30238,0,11,4752000.0
4752,4752999,22.100362571734635,39.33037586873498,0.0636975501118483,793.4085037708282,312.47240686416626,983.1475944519043,34958,4716,30242,30242,0,11,4753000.0
4753,4753999,22.09895495899962,39.32798624570762,0.06370180166473749,793.680584192276,312.53583216667175,983.4958381652832,34975,4718,30257,30257,0,11,4754000.0
4754,4754999,22.097819421691927,39.325832807150036,0.0636972169463017,794.0319740772247,312.5996353626251,983.6531639099121,34981,4721,30260,30260,0,11,4755000.0
4755,4755999,22.096669108649046,39.323431465875714,0.06369491884779854,794.3146407604218,312.6654968261719,983.7862129211426,34985,4723,30262,30262,0,11,4756000.0
4756,4756999,22.0965735468747,39.32255282582709,0.06366437277879611,794.6758151054382,312.72938871383667,984.1842918395996,35003,4726,30277,30277,0,11,4757000.0
4757,4757999,22.0965580073872,39.32172079482592,0.06363897570784116,794.8692162036896,312.79201102256775,984.4383163452148,35005,4727,30278,30278,0,11,4758000.0
4758,4758999,22.09619891893791,39.320264965439776,0.06362433184015182,795.0813932418823,312.85548734664917,984.5730476379395,35013,4728,30285,30285,0,11,4759000.0
4759,4759999,22.09727575589749,39.320707559151444,0.06360564830859594,795.1898312568665,312.9177505970001,985.0381355285645,35024,4728,30296,30296,0,11,4760000.0
4760,4760999,22.098844924754726,39.322811343036165,0.06357915248731605,795.3867182731628,312.98214530944824,985.22802734375,35026,4729,30297,30297,0,11,4761000.0
4761,4761999,22.100232252367903,39.323062478403045,0.06357333273301691,795.5935988426208,313.0469608306885,985.3514289855957,35032,4730,30302,30302,0,11,4762000.0
4762,4762999,22.102004803711036,39.32596304145853,0.06355981813413658,795.7156915664673,313.1091706752777,985.8024406433105,35043,4730,30313,30313,0,11,4763000.0
4763,4763999,22.10330636777833,39.326263866409185,0.0635676876515282,795.8362729549408,313.1726689338684,985.9672966003418,35043,4730,30313,30313,0,11,4764000.0
4764,4764999,22.104169983901144,39.32537913433394,0.06356501863998332,796.114179611206,313.2347218990326,985.9826698303223,35053,4732,30321,30321,0,11,4765000.0
4765,4765999,22.10497726907813,39.32458430689119,0.06354825407484066,796.3102889060974,313.2981503009796,986.2163124084473,35063,4733,30330,30330,0,11,4766000.0
4766,4766999,22.105429587307903,39.32760966529966,0.06352150221606123,796.513418674469,313.3610517978668,986.534252166748,35082,4734,30348,30348,0,11,4767000.0
4767,4767999,22.103310021044837,39.324876636108364,0.06353660219622081,796.8690204620361,313.4253842830658,986.7142715454102,35101,4737,30364,30364,0,11,4768000.0
4768,4768999,22.10156544443531,39.32222757158905,0.06354656282157711,796.9999892711639,313.49110770225525,987.1115989685059,35108,4737,30371,30371,0,11,4769000.0
4769,4769999,22.09983694515429,39.31958194911101,0.06356108250091086,797.201774597168,313.55446767807007,987.2168388366699,35110,4738,30372,30372,0,11,4770000.0
4770,4770999,22.0982958392015,39.31732127747026,0.06356689792566983,797.4832646846771,313.6197154521942,987.2951240539551,35120,4740,30380,30380,0,11,4771000.0
4771,4771999,22.0970626987544,39.31481118560999,0.06356922373128748,797.6068780422211,313.6830184459686,987.6280860900879,35126,4740,30386,30386,0,11,4772000.0
4772,4772999,22.09569168000129,39.31258798462447,0.06357402169025228,797.9625663757324,313.74572467803955,987.6723823547363,35132,4743,30389,30389,0,11,4773000.0
4773,4773999,22.094474615343145,39.310166191673225,0.06357836766064795,798.0873520374298,313.8100869655609,987.7902526855469,35132,4743,30389,30389,0,11,4774000.0
4774,4774999,22.09390711688639,39.30874082257648,0.06356915558077514,798.4425337314606,313.8738124370575,987.9918785095215,35157,4746,30411,30411,0,11,4775000.0
4775,4775999,22.09288567289155,39.306642355738795,0.06356902370688278,798.6424281597137,313.93813610076904,988.2226409912109,35159,4747,30412,30412,0,11,4776000.0
4776,4776999,22.091817721571047,39.304181904865516,0.0635661057325283,798.7616493701935,314.0003170967102,988.3711814880371,35159,4747,30412,30412,0,11,4777000.0
4777,4777999,22.09110429118533,39.30242103091875,0.06356178181089567,798.8842511177063,314.0625956058502,988.7155380249023,35165,4747,30418,30418,0,11,4778000.0
4778,4778999,22.090151724695573,39.30009887310743,0.06355524655272282,799.0863103866577,314.12558937072754,988.8504409790039,35167,4748,30419,30419,0,11,4779000.0
4779,4779999,22.089571964602744,39.298771091606994,0.06354545183492122,799.2819316387177,314.18797731399536,988.9552536010742,35169,4749,30420,30420,0,11,4780000.0
4780,4780999,22.089369475014692,39.297410016252854,0.0635296269653306,799.4793155193329,314.2510735988617,989.2434501647949,35179,4750,30429,30429,0,11,4781000.0
4781,4781999,22.089492094443287,39.29643808681774,0.06350637420189076,799.6888525485992,314.31704330444336,989.4006004333496,35181,4751,30430,30430,0,11,4782000.0
4782,4782999,22.09001760211442,39.29583927130995,0.06347902168891162,799.9657518863678,314.38231229782104,989.5115585327148,35200,4753,30447,30447,0,11,4783000.0
4783,4783999,22.090706069589213,39.29548187781514,0.06344933506844441,800.2403841018677,314.4446837902069,989.7733116149902,35217,4755,30462,30462,0,11,4784000.0
4784,4784999,22.09173941055635,39.29571455500743,0.0634141492757343,800.4443111419678,314.5073518753052,989.8813362121582,35225,4756,30469,30469,0,11,4785000.0
4785,4785999,22.09218192554344,39.2948765449619,0.06338912515793438,800.6356580257416,314.5694749355316,990.0012435913086,35233,4757,30476,30476,0,11,4786000.0
4786,4786999,22.0927154616728,39.2937920938142,0.06336145884534816,800.9031178951263,314.629994392395,990.1761207580566,35248,4759,30489,30489,0,11,4787000.0
4787,4787999,22.09272340289233,39.29572351051513,0.06332939938240467,801.1835823059082,314.6922118663788,990.3457984924316,35266,4761,30505,30505,0,11,4788000.0
4788,4788999,22.090983735696348,39.29442929470294,0.06333501010194098,801.4624667167664,314.75530982017517,990.7400207519531,35319,4763,30556,30556,0,11,4789000.0
4789,4789999,22.08889208285686,39.29117832388925,0.06335529656004502,801.5866794586182,314.8188953399658,991.1081352233887,35325,4763,30562,30562,0,11,4790000.0
4790,4790999,22.087109160933945,39.28926210104546,0.06336719050024853,801.7144706249237,314.88299036026,991.2730827331543,35326,4763,30563,30563,0,11,4791000.0
4791,4791999,22.085311321455546,39.28630869345681,0.0633880010410075,802.0742416381836,314.9480183124542,991.3108329772949,35347,4766,30581,30581,0,11,4792000.0
4792,4792999,22.08358624694911,39.28380142215506,0.0634018503509145,802.3525865077972,315.01190733909607,991.4685249328613,35365,4768,30597,30597,0,11,4793000.0
4793,4793999,22.082002115524674,39.28149166432063,0.06341155182877789,802.6393790245056,315.0761094093323,991.5786285400391,35377,4770,30607,30607,0,11,4794000.0
4794,4794999,22.08029098829103,39.27865574554103,0.06342456538848062,802.8374881744385,315.1385827064514,991.6886825561523,35379,4771,30608,30608,0,11,4795000.0
4795,4795999,22.078779631832454,39.27582426685578,0.06343293216979617,803.1211361885071,315.20466709136963,991.8777122497559,35386,4773,30613,30613,0,11,4796000.0
4796,4796999,22.077412495571767,39.273207328409214,0.06343763202209907,803.4125375747681,315.270307302475,991.9146156311035,35396,4775,30621,30621,0,11,4797000.0
4797,4797999,22.0761074890908,39.27085977090522,0.06344515629760905,803.5417125225067,315.3330805301666,992.0562324523926,35396,4775,30621,30621,0,11,4798000.0
4798,4798999,22.075207452686925,39.26854017814796,0.06344052274739964,803.8313493728638,315.3971915245056,992.3921928405762,35419,4777,30642,30642,0,11,4799000.0
4799,4799999,22.07419250794663,39.266187591525494,0.06343785629352416,804.0289783477783,315.46131110191345,992.595817565918,35421,4778,30643,30643,0,11,4800000.0
4800,4800999,22.073120726793555,39.2641043178163,0.06343992026745049,804.4128625392914,315.5300693511963,992.6623382568359,35470,4781,30689,30689,0,11,4801000.0
4801,4801999,22.07258351938837,39.262620436841765,0.06342348846419932,804.6098735332489,315.5937135219574,993.0106391906738,35482,4782,30700,30700,0,11,4802000.0
4802,4802999,22.07244597604275,39.261356169109284,0.06340604671404515,804.895614862442,315.6568834781647,993.160774230957,35490,4784,30706,30706,0,11,4803000.0
4803,4803999,22.07231475771935,39.25966635764647,0.06339688671647292,805.0149347782135,315.72180223464966,993.3417663574219,35490,4784,30706,30706,0,11,4804000.0
4804,4804999,22.072262603571758,39.25801679893268,0.06338167800544403,805.1392891407013,315.7876317501068,993.7317428588867,35498,4784,30714,30714,0,11,4805000.0
4805,4805999,22.072667420900267,39.258325692703835,0.0633559272477533,805.2599811553955,315.8506586551666,993.9011878967285,35498,4784,30714,30714,0,11,4806000.0
4806,4806999,22.072585544495468,39.256371482400034,0.06334245746721001,805.3707621097565,315.91253995895386,994.0041007995605,35498,4784,30714,30714,0,11,4807000.0
4807,4807999,22.072446297435803,39.254360792199265,0.06332592691254502,805.684374332428,315.98238015174866,994.203685760498,35532,4786,30746,30746,0,11,4808000.0
4808,4808999,22.072266994988844,39.2550083482651,0.06327619806933338,805.8860092163086,316.04458951950073,994.4925537109375,35547,4787,30760,30760,0,11,4809000.0
4809,4809999,22.070144138599304,39.25251968826191,0.06329880210743644,806.320463180542,316.10883617401123,994.5909423828125,35570,4791,30779,30779,0,11,4810000.0
4810,4810999,22.06811383660636,39.24950376895274,0.06331781893234656,806.6116807460785,316.1733350753784,994.735538482666,35584,4793,30791,30791,0,11,4811000.0
4811,4811999,22.066595079621244,39.24849847091548,0.06332833071926669,806.7407858371735,316.23582553863525,994.8311309814453,35584,4793,30791,30791,0,11,4812000.0
4812,4812999,22.064799029606046,39.2457715775651,0.0633451539451455,806.9563717842102,316.3025085926056,994.8315277099609,35594,4794,30800,30800,0,11,4813000.0
4813,4813999,22.06319252558337,39.243358173363866,0.0633555711553968,807.1521511077881,316.36736965179443,995.1578941345215,35603,4795,30808,30808,0,11,4814000.0
4814,4814999,22.061594815555907,39.24125712879653,0.06336392116991207,807.5244188308716,316.432190656662,995.1903495788574,35615,4798,30817,30817,0,11,4815000.0
4815,4815999,22.060027391427287,39.23865685596612,0.0633730866613128,807.7298202514648,316.49509930610657,995.269229888916,35622,4799,30823,30823,0,11,4816000.0
4816,4816999,22.058508973529253,39.236113375989675,0.06337741670651553,808.0285863876343,316.5667288303375,995.6906852722168,35639,4801,30838,30838,0,11,4817000.0
4817,4817999,22.05730307963223,39.23402759272024,0.06337246135191832,808.3047111034393,316.63023829460144,995.8147850036621,35643,4803,30840,30840,0,11,4818000.0
4818,4818999,22.056539499179756,39.232341432499936,0.06336120938722689,808.5068454742432,316.6951324939728,995.9457740783691,35645,4804,30841,30841,0,11,4819000.0
4819,4819999,22.05617154599898,39.23124280693882,0.0633425818664417,808.6275618076324,316.76137685775757,996.5726699829102,35661,4804,30857,30857,0,11,4820000.0
4820,4820999,22.057372655840457,39.23297225521193,0.06333305044592352,808.8216822147369,316.8265929222107,996.811954498291,35663,4805,30858,30858,0,11,4821000.0
4821,4821999,22.059080512079202,39.23467130610101,0.0633451406416401,809.1118664741516,316.89144706726074,996.909065246582,35674,4807,30867,30867,0,11,4822000.0
4822,4822999,22.061451155717023,39.237422773497094,0.06337261224247759,809.3892507553101,316.95568561553955,997.3263816833496,35700,4809,30891,30891,0,11,4823000.0
4823,4823999,22.063725531428496,39.239412381142664,0.06340303806653325,809.8228168487549,317.0185511112213,997.3872489929199,35727,4813,30914,30914,0,11,4824000.0
4824,4824999,22.06598845528289,39.241553525262034,0.06344626246401686,810.029477596283,317.0815169811249,997.578197479248,35733,4814,30919,30919,0,11,4825000.0
4825,4825999,22.068358455430168,39.24316482630441,0.06346285856145495,810.4037659168243,317.1458520889282,998.1111450195312,35768,4817,30951,30951,0,11,4826000.0
4826,4826999,22.070796962392322,39.24516466768893,0.06348566703731362,810.5954251289368,317.20908522605896,998.3360366821289,35775,4818,30957,30957,0,11,4827000.0
4827,4827999,22.07262304851394,39.24740888755196,0.06349962556224165,810.7106781005859,317.27194118499756,998.6232452392578,35781,4818,30963,30963,0,11,4828000.0
4828,4828999,22.073980012451834,39.2476276705614,0.06351127061286044,810.9082005023956,317.3368949890137,998.8706665039062,35791,4819,30972,30972,0,11,4829000.0
4829,4829999,22.0734987152112,39.24616310663144,0.06351524890638982,811.0215253829956,317.4001216888428,999.2410659790039,35802,4819,30983,30983,0,11,4830000.0
4830,4830999,22.071549527580768,39.24327450117206,0.06352779192113,811.4638993740082,317.463915348053,999.4457817077637,35830,4823,31007,31007,0,11,4831000.0
4831,4831999,22.069744891183788,39.240585176650846,0.06353786466041056,811.8295347690582,317.52771043777466,999.4764556884766,35849,4826,31023,31023,0,11,4832000.0
4832,4832999,22.068213874007,39.23812600932553,0.06354777144230506,811.9584875106812,317.59433126449585,999.6359634399414,35850,4826,31024,31024,0,11,4833000.0
4833,4833999,22.066922458288186,39.236653049393226,0.06354847322094259,812.3205654621124,317.65764355659485,999.653076171875,35874,4829,31045,31045,0,11,4834000.0
4834,4834999,22.065390829925267,39.234293951549674,0.06355225241496154,812.4304196834564,317.71827816963196,999.9782867431641,35878,4829,31049,31049,0,11,4835000.0
4835,4835999,22.06390137451622,39.23183202795309,0.06355643715131576,812.8891654014587,317.7807593345642,1000.0239868164062,35896,4833,31063,31063,0,11,4836000.0
4836,4836999,22.062566993455018,39.22964188288727,0.0635561688509263,813.0920312404633,317.8425352573395,1000.2714195251465,35902,4834,31068,31068,0,11,4837000.0
4837,4837999,22.061514915526985,39.227382842322264,0.0635639194354074,813.3730385303497,317.90476417541504,1000.4014129638672,35911,4836,31075,31075,0,11,4838000.0
4838,4838999,22.060462164592266,39.224831193858435,0.06355987773971528,813.4816672801971,317.966689825058,1000.5412178039551,35911,4836,31075,31075,0,11,4839000.0
4839,4839999,22.059562367443462,39.22321698943204,0.06356652244791494,813.7679736614227,318.0304946899414,1000.5903625488281,35915,4838,31077,31077,0,11,4840000.0
4840,4840999,22.058824945222362,39.221372585909506,0.06355752190532604,814.0710258483887,318.1026213169098,1000.7849502563477,35932,4840,31092,31092,0,11,4841000.0
4841,4841999,22.058899856490047,39.22274355697879,0.0635523515470725,814.4401230812073,318.16791820526123,1000.9024124145508,35945,4843,31102,31102,0,11,4842000.0
4842,4842999,22.05959635427044,39.22395306564631,0.06359720125583046,814.6455550193787,318.230370759964,1001.0773735046387,35949,4844,31105,31105,0,11,4843000.0
4843,4843999,22.06125967305848,39.22595082450122,0.06361156195134599,815.106418132782,318.29568314552307,1001.3460655212402,35978,4848,31130,31130,0,11,4844000.0
4844,4844999,22.06333246062573,39.22840533990932,0.06364482426326623,815.3919050693512,318.3606495857239,1001.5859069824219,35987,4850,31137,31137,0,11,4845000.0
4845,4845999,22.066279991641604,39.237192481302486,0.06368636927159699,815.504426240921,318.4234161376953,1001.7960662841797,35987,4850,31137,31137,0,11,4846000.0
4846,4846999,22.068785286697587,39.24005817539961,0.06372385549003967,815.8883695602417,318.4868333339691,1002.1970825195312,36010,4853,31157,31157,0,11,4847000.0
4847,4847999,22.070811149307136,39.242321965927054,0.06374583837352288,816.0092759132385,318.5516777038574,1002.3822784423828,36010,4853,31157,31157,0,11,4848000.0
4848,4848999,22.07301981595421,39.24429601795525,0.06380435134617357,816.122376203537,318.61426615715027,1002.6225700378418,36014,4853,31161,31161,0,11,4849000.0
4849,4849999,22.07451779407517,39.24644908006457,0.06382017003103424,816.3219003677368,318.6783185005188,1002.8137245178223,36023,4854,31169,31169,0,11,4850000.0
4850,4850999,22.074280209959944,39.24611169095243,0.06383153139184161,816.520251750946,318.742404460907,1003.0867500305176,36034,4855,31179,31179,0,11,4851000.0
4851,4851999,22.0725068302662,39.24374493460678,0.06384206944446191,816.8048071861267,318.805682182312,1003.3622589111328,36051,4857,31194,31194,0,11,4852000.0
4852,4852999,22.07072095030611,39.2415947533491,0.063850626640377,817.0106720924377,318.8691494464874,1003.5504608154297,36082,4858,31224,31224,0,11,4853000.0
4853,4853999,22.069200552732905,39.240343727538615,0.06385465455954387,817.211701631546,318.9334890842438,1003.6186103820801,36085,4859,31226,31226,0,11,4854000.0
4854,4854999,22.067418835194076,39.23815250955171,0.06386707549192705,817.7393207550049,318.9979317188263,1003.5866622924805,36110,4864,31246,31246,0,11,4855000.0
4855,4855999,22.065964199625984,39.23603368416183,0.06387241959006451,817.9449739456177,319.06061720848083,1003.8236885070801,36115,4865,31250,31250,0,11,4856000.0
4856,4856999,22.06451445434804,39.23364401557991,0.06387493985429327,818.2287874221802,319.1228759288788,1003.9280891418457,36119,4867,31252,31252,0,11,4857000.0
4857,4857999,22.063234668961744,39.2322012204706,0.06387426774355631,818.3526408672333,319.18738985061646,1004.0907516479492,36121,4867,31254,31254,0,11,4858000.0
4858,4858999,22.061989472252275,39.23048057154802,0.06387036302773053,818.6432821750641,319.25202202796936,1004.1932487487793,36127,4869,31258,31258,0,11,4859000.0
4859,4859999,22.060735217114864,39.227952592146785,0.06387302373123838,818.7625348567963,319.31442427635193,1004.3281326293945,36127,4869,31258,31258,0,11,4860000.0
4860,4860999,22.06014239141813,39.22690282333987,0.063866588863695,818.9779150485992,319.37744140625,1004.4933662414551,36134,4870,31264,31264,0,11,4861000.0
4861,4861999,22.059758583517876,39.22592513839364,0.06384273213617497,819.1053256988525,319.44191336631775,1005.1824913024902,36154,4870,31284,31284,0,11,4862000.0
4862,4862999,22.059701210711896,39.225656178014475,0.06383870308042927,819.3065044879913,319.50733709335327,1005.4376792907715,36169,4871,31298,31298,0,11,4863000.0
4863,4863999,22.05963584661872,39.22510083084525,0.06383175194077606,819.4321513175964,319.57277393341064,1005.6191520690918,36169,4871,31298,31298,0,11,4864000.0
4864,4864999,22.06015640129727,39.224895761468595,0.06382285891002537,819.5554649829865,319.6389350891113,1006.1311798095703,36185,4871,31314,31314,0,11,4865000.0
4865,4865999,22.061615209879314,39.226565627854754,0.0638012567137688,819.7568120956421,319.7014219760895,1006.3270492553711,36188,4872,31316,31316,0,11,4866000.0
4866,4866999,22.063172435623084,39.22772462785173,0.06379117860360684,819.8772675991058,319.766898393631,1006.4476623535156,36188,4872,31316,31316,0,11,4867000.0
4867,4867999,22.06494933390993,39.22928156145336,0.0637859110861102,820.003015756607,319.8286945819855,1006.7487487792969,36194,4872,31322,31322,0,11,4868000.0
4868,4868999,22.066522932864306,39.230516536045364,0.0637870560802557,820.1136972904205,319.88973093032837,1006.8483390808105,36194,4872,31322,31322,0,11,4869000.0
4869,4869999,22.067706109027405,39.2310204292224,0.0638043552579417,820.3085000514984,319.9507279396057,1006.8963737487793,36212,4873,31339,31339,0,11,4870000.0
4870,4870999,22.068915657062426,39.231377997651215,0.06380226912822262,820.4162769317627,320.01197385787964,1007.1254844665527,36216,4873,31343,31343,0,11,4871000.0
4871,4871999,22.069089486912503,39.23057553534078,0.06380098843875348,820.5313904285431,320.0734350681305,1007.531909942627,36230,4873,31357,31357,0,11,4872000.0
4872,4872999,22.067596615306197,39.22857202875943,0.06381099724750616,820.8221275806427,320.137864112854,1008.2506332397461,36289,4875,31414,31414,0,11,4873000.0
4873,4873999,22.06631119494044,39.22962744084298,0.06380035029698305,820.9463889598846,320.20203375816345,1008.7467727661133,36302,4875,31427,31427,0,11,4874000.0
4874,4874999,22.065274007768533,39.230709080597975,0.06377491514612088,821.1502020359039,320.26609325408936,1009.0959358215332,36320,4876,31444,31444,0,11,4875000.0
4875,4875999,22.064004579215943,39.23382396897151,0.06384355810328224,821.3798840045929,320.33407831192017,1009.6560134887695,36341,4877,31464,31464,0,11,4876000.0
4876,4876999,22.06327904759374,39.23586198664124,0.06373660717512775,821.496664762497,320.3965640068054,1010.0090675354004,36346,4877,31469,31469,0,11,4877000.0
4877,4877999,22.061683636004666,39.233781835801935,0.06369858883422241,821.6196093559265,320.45983147621155,1010.2750511169434,36349,4877,31472,31472,0,11,4878000.0
4878,4878999,22.0603086269137,39.231108083357164,0.06370703153553592,821.7353763580322,320.52374720573425,1010.7469139099121,36360,4877,31483,31483,0,11,4879000.0
4879,4879999,22.05907993031468,39.228457662043574,0.06370863722884013,822.0186307430267,320.5883643627167,1010.8551063537598,36370,4879,31491,31491,0,11,4880000.0
4880,4880999,22.057918391214322,39.22597895935725,0.06371103202960715,822.2239124774933,320.6514804363251,1010.9969787597656,36372,4880,31492,31492,0,11,4881000.0
4881,4881999,22.05716555317368,39.22633466844255,0.06369194460849703,822.3481774330139,320.71566677093506,1011.9118804931641,36399,4880,31519,31519,0,11,4882000.0
4882,4882999,22.056132603898256,39.224007291695166,0.0636968259536903,822.5477199554443,320.7822368144989,1012.2399139404297,36420,4881,31539,31539,0,11,4883000.0
4883,4883999,22.055185196597993,39.22242355573139,0.06370059250703497,822.6605100631714,320.8451361656189,1012.5969085693359,36426,4881,31545,31545,0,11,4884000.0
4884,4884999,22.055040645610934,39.2213446623693,0.06367089695794126,822.8626236915588,320.9119596481323,1013.2825393676758,36453,4882,31571,31571,0,11,4885000.0
4885,4885999,22.054986951891316,39.219847077713055,0.06364976105491715,822.9843988418579,320.9781160354614,1013.5513496398926,36454,4882,31572,31572,0,11,4886000.0
4886,4886999,22.055592844932832,39.218763263026965,0.06361099751632027,823.1864581108093,321.0424168109894,1014.1440849304199,36488,4883,31605,31605,0,11,4887000.0
4887,4887999,22.055903039467697,39.217342911652096,0.06357557868501307,823.465439081192,321.1063141822815,1014.3549957275391,36507,4885,31622,31622,0,11,4888000.0
4888,4888999,22.056274320158252,39.21687914404942,0.06354052389600029,823.8275563716888,321.16956424713135,1014.8364067077637,36546,4888,31658,31658,0,11,4889000.0
4889,4889999,22.05542895182257,39.21746204904853,0.06354388823974533,824.300660610199,321.239355802536,1015.2774353027344,36565,4892,31673,31673,0,11,4890000.0
4890,4890999,22.054420316166585,39.216123006086214,0.06355157325790772,824.4262402057648,321.30296993255615,1015.5208892822266,36566,4892,31674,31674,0,11,4891000.0
4891,4891999,22.05329324067356,39.21567826685821,0.06351869981035085,824.5460779666901,321.3662579059601,1015.903736114502,36575,4892,31683,31683,0,11,4892000.0
4892,4892999,22.051690605463943,39.21302014956141,0.06353507952617721,824.6673576831818,321.428377866745,1016.2266387939453,36577,4892,31685,31685,0,11,4893000.0
4893,4893999,22.04989864224134,39.21002823748259,0.06355377509781557,824.957629442215,321.4914503097534,1016.3514366149902,36589,4894,31695,31695,0,11,4894000.0
4894,4894999,22.049112505912408,39.20778758139738,0.06356002569455532,825.0788881778717,321.5546748638153,1016.6724967956543,36596,4894,31702,31702,0,11,4895000.0
4895,4895999,22.048280930291288,39.20568509381146,0.06356554454800745,825.2074251174927,321.6168417930603,1016.7921714782715,36596,4894,31702,31702,0,11,4896000.0
4896,4896999,22.047508683394927,39.203571912165394,0.06356941285302498,825.4151787757874,321.67920660972595,1016.8383026123047,36603,4895,31708,31708,0,11,4897000.0
4897,4897999,22.046379160923475,39.20172310312893,0.06357334989983499,825.6218149662018,321.74385809898376,1017.3863792419434,36618,4896,31722,31722,0,11,4898000.0
4898,4898999,22.045091164752584,39.19936428057786,0.06358536772522394,825.9900395870209,321.80868458747864,1017.5018768310547,36640,4899,31741,31741,0,11,4899000.0
4899,4899999,22.044027941552965,39.196956776330644,0.06359395471740603,826.2097177505493,321.87560057640076,1017.8439865112305,36659,4900,31759,31759,0,11,4900000.0
4900,4900999,22.04343275470986,39.19502581042039,0.06358975958079915,826.6039328575134,321.94231033325195,1017.9666366577148,36676,4903,31773,31773,0,11,4901000.0
4901,4901999,22.04320115222367,39.19337544895417,0.06359147286203837,826.8831222057343,322.0055661201477,1018.1180076599121,36686,4905,31781,31781,0,11,4902000.0
4902,4902999,22.042894364259904,39.19140589517739,0.06358819507528979,827.1780138015747,322.07220578193665,1018.6068801879883,36710,4907,31803,31803,0,11,4903000.0
4903,4903999,22.04199981494621,39.18894430905205,0.0635976412642264,827.5573554039001,322.1363434791565,1018.7427177429199,36744,4910,31834,31834,0,11,4904000.0
4904,4904999,22.04207804653891,39.18767469409806,0.06358419354887224,827.7615015506744,322.2011160850525,1019.0375709533691,36756,4911,31845,31845,0,11,4905000.0
4905,4905999,22.041186321642474,39.185904473001116,0.06359140670667818,828.210292339325,322.26596760749817,1019.3932914733887,36797,4915,31882,31882,0,11,4906000.0
4906,4906999,22.039599260638578,39.1834933457174,0.06360577016645996,828.4225735664368,322.3292303085327,1019.7866134643555,36802,4916,31886,31886,0,11,4907000.0
4907,4907999,22.03872399110013,39.18419050263584,0.06360441952262275,828.6297273635864,322.39409351348877,1019.9952201843262,36806,4917,31889,31889,0,11,4908000.0
4908,4908999,22.037497644341983,39.18233246877114,0.06362362191373949,828.9990668296814,322.45801162719727,1020.0816040039062,36852,4920,31932,31932,0,11,4909000.0
4909,4909999,22.036031936394178,39.17983526299965,0.06363348879093611,829.1213524341583,322.5205554962158,1020.5072708129883,36861,4920,31941,31941,0,11,4910000.0
4910,4910999,22.034427912261904,39.17740129989556,0.06364781187370627,829.4061529636383,322.58268117904663,1020.6930618286133,36865,4922,31943,31943,0,11,4911000.0
4911,4911999,22.032913160389686,39.175221552084935,0.06365791117941366,829.5270102024078,322.645010471344,1020.883674621582,36866,4922,31944,31944,0,11,4912000.0
4912,4912999,22.032048588526973,39.17376436831558,0.06364995323148548,829.7267599105835,322.70836186408997,1021.2293815612793,36881,4923,31958,31958,0,11,4913000.0
4913,4913999,22.031083352239463,39.17247810765107,0.06365405163160853,830.0191419124603,322.7734203338623,1021.3636016845703,36886,4925,31961,31961,0,11,4914000.0
4914,4914999,22.030639043396476,39.171740301963325,0.06364272778586866,830.1481096744537,322.83632588386536,1021.5050582885742,36886,4925,31961,31961,0,11,4915000.0
4915,4915999,22.03012869644001,39.1704767255811,0.06363474709889105,830.3494074344635,322.8993082046509,1021.8169784545898,36893,4926,31967,31967,0,11,4916000.0
4916,4916999,22.029841333107896,39.16969288478483,0.06362682478870252,830.5586531162262,322.9615385532379,1021.9609451293945,36895,4927,31968,31968,0,11,4917000.0
4917,4917999,22.029400080924244,39.16877886540032,0.06361630505912863,831.0245695114136,323.02568221092224,1021.8990592956543,36908,4931,31977,31977,0,11,4918000.0
4918,4918999,22.029656258590876,39.16874830565216,0.06360159947302713,831.1528491973877,323.08925580978394,1022.4135856628418,36919,4931,31988,31988,0,11,4919000.0
4919,4919999,22.029575414556,39.16752227449111,0.0635899311754412,831.5289540290833,323.15217757225037,1022.5026702880859,36930,4934,31996,31996,0,11,4920000.0
4920,4920999,22.030133439050477,39.16869317096057,0.06357292629296196,831.8257098197937,323.2152683734894,1022.6257095336914,36934,4936,31998,31998,0,11,4921000.0
4921,4921999,22.030817546192807,39.16828309810965,0.06354840293044828,832.0294079780579,323.2774283885956,1022.888542175293,36942,4937,32005,32005,0,11,4922000.0
4922,4922999,22.031411736553007,39.16752386932632,0.06352810941890608,832.3227245807648,323.3420145511627,1022.9536819458008,36958,4939,32019,32019,0,11,4923000.0
4923,4923999,22.03170757771293,39.166304337292104,0.0635050820982318,832.4359345436096,323.4035794734955,1023.0526351928711,36958,4939,32019,32019,0,11,4924000.0
4924,4924999,22.032212196172672,39.165576423221964,0.06348752394311863,832.642605304718,323.4658305644989,1023.3061256408691,36972,4940,32032,32032,0,11,4925000.0
4925,4925999,22.03140008791026,39.163324452420646,0.06348013432700483,832.7664704322815,323.5304570198059,1023.650218963623,36982,4940,32042,32042,0,11,4926000.0
4926,4926999,22.029451851259214,39.16142060603717,0.06349141882734088,832.9692096710205,323.59336280822754,1023.9033241271973,36997,4941,32056,32056,0,11,4927000.0
4927,4927999,22.02734112706362,39.1583074274573,0.06350553426616912,833.0967478752136,323.6582350730896,1024.3042755126953,37006,4941,32065,32065,0,11,4928000.0
4928,4928999,22.025498934389024,39.155855936779,0.06351603080047474,833.2155072689056,323.7234237194061,1024.4735412597656,37006,4941,32065,32065,0,11,4929000.0
4929,4929999,22.023776901794314,39.153018663498926,0.06353185172605713,833.3400912284851,323.78602719306946,1024.6117324829102,37006,4941,32065,32065,0,11,4930000.0
4930,4930999,22.02188173614113,39.15009579014723,0.06354129133360265,833.4592521190643,323.8515877723694,1024.92484664917,37010,4941,32069,32069,0,11,4931000.0
4931,4931999,22.020480905484334,39.14790788814169,0.06354562126577301,833.7460689544678,323.9134554862976,1025.0312805175781,37014,4943,32071,32071,0,11,4932000.0
4932,4932999,22.01906008434236,39.14539813625493,0.06355068896745164,833.9427733421326,323.97514033317566,1025.1426887512207,37016,4944,32072,32072,0,11,4933000.0
4933,4933999,22.017568477822117,39.14309021357011,0.06355578078809987,834.2359752655029,324.03874349594116,1025.4773902893066,37031,4946,32085,32085,0,11,4934000.0
4934,4934999,22.016446546197145,39.14104646522728,0.06355462784819843,834.5273649692535,324.1015975475311,1025.625675201416,37035,4948,32087,32087,0,11,4935000.0
4935,4935999,22.015270079942887,39.13874790679831,0.06356296423159391,834.8294036388397,324.1653518676758,1025.7580032348633,37039,4950,32089,32089,0,11,4936000.0
4936,4936999,22.014148349025202,39.136610011785166,0.06356414797470566,835.0324954986572,324.23011541366577,1026.3516693115234,37065,4951,32114,32114,0,11,4937000.0
4937,4937999,22.013292536089907,39.13451067618096,0.06356278795320591,835.1393723487854,324.29205322265625,1026.6706504821777,37066,4951,32115,32115,0,11,4938000.0
4938,4938999,22.012302887737878,39.132808094802776,0.0635603790951268,835.4239957332611,324.355491399765,1026.8284492492676,37080,4953,32127,32127,0,11,4939000.0
4939,4939999,22.011861892093236,39.13119801633837,0.06355087953482519,835.7250988483429,324.41963720321655,1027.27486038208,37099,4955,32144,32144,0,11,4940000.0
4940,4940999,22.01121358440697,39.1295427596364,0.06354207293466163,835.8402223587036,324.4828567504883,1027.5388793945312,37099,4955,32144,32144,0,11,4941000.0
4941,4941999,22.01062353351183,39.127838162321794,0.06353857090955572,835.9612939357758,324.5452365875244,1027.7107849121094,37099,4955,32144,32144,0,11,4942000.0
4942,4942999,22.01043405553617,39.12608618837812,0.06352611272618003,836.1680614948273,324.6078186035156,1028.0480842590332,37110,4956,32154,32154,0,11,4943000.0
4943,4943999,22.01048545805594,39.12499761629123,0.0635155451829611,836.277086019516,324.6710138320923,1028.2320404052734,37111,4956,32155,32155,0,11,4944000.0
4944,4944999,22.010295358850804,39.12393978340462,0.06350571427219953,836.6630318164825,324.7338469028473,1028.182228088379,37128,4959,32169,32169,0,11,4945000.0
4945,4945999,22.010079517839564,39.1222736993973,0.06349209617361617,836.8676333427429,324.79400181770325,1028.399269104004,37140,4960,32180,32180,0,11,4946000.0
4946,4946999,22.009214189415296,39.12108678734559,0.06347803137641217,837.1672508716583,324.8565092086792,1028.7229270935059,37163,4962,32201,32201,0,11,4947000.0
4947,4947999,22.00779831801871,39.11927054926258,0.06349530377845403,837.3724853992462,324.9208822250366,1029.1054306030273,37182,4963,32219,32219,0,11,4948000.0
4948,4948999,22.00605347821057,39.11660982815148,0.06351308122709831,837.493353843689,324.98455119132996,1029.4370346069336,37189,4963,32226,32226,0,11,4949000.0
4949,4949999,22.004527289454277,39.114030454822064,0.06353266554328685,837.6128785610199,325.0491769313812,1029.6180000305176,37192,4963,32229,32229,0,11,4950000.0
4950,4950999,22.003258731810106,39.111870539921156,0.06354364529354717,837.764187335968,325.1224949359894,1029.8175048828125,37197,4963,32234,32234,0,11,4951000.0
4951,4951999,22.00202611628315,39.109369787565235,0.06354274483213618,837.9744007587433,325.18678879737854,1030.1668395996094,37214,4964,32250,32250,0,11,4952000.0
4952,4952999,22.001000449401666,39.10733870867445,0.06354548787194858,838.0903015136719,325.24893712997437,1030.3633728027344,37214,4964,32250,32250,0,11,4953000.0
4953,4953999,21.99992521393477,39.10507058683961,0.06354567107139109,838.2950167655945,325.30974102020264,1030.601879119873,37220,4965,32255,32255,0,11,4954000.0
4954,4954999,21.999365867508605,39.10936877020618,0.06352513694884765,838.4957611560822,325.3734803199768,1030.7817115783691,37225,4966,32259,32259,0,11,4955000.0
4955,4955999,21.998369366518062,39.1071302496757,0.06352311510435771,838.6989495754242,325.43565011024475,1030.8581733703613,37233,4967,32266,32266,0,11,4956000.0
4956,4956999,21.997671734969238,39.10550982207475,0.06351637336515636,838.8293702602386,325.50099873542786,1031.0234298706055,37235,4967,32268,32268,0,11,4957000.0
4957,4957999,21.99693205861049,39.103509005138896,0.06350517243950049,839.0241665840149,325.5623993873596,1031.5845260620117,37250,4968,32282,32282,0,11,4958000.0
4958,4958999,21.995985429665488,39.10134877731769,0.0634968374559024,839.3070659637451,325.6253414154053,1031.734001159668,37254,4970,32284,32284,0,11,4959000.0
4959,4959999,21.995050245169026,39.09940405887436,0.06349044796243064,839.4355821609497,325.68741393089294,1031.919620513916,37254,4970,32284,32284,0,11,4960000.0
4960,4960999,21.994495380742,39.097266517905936,0.0634803653949223,839.543829202652,325.74872970581055,1032.4907188415527,37270,4970,32300,32300,0,11,4961000.0
4961,4961999,21.994033099575212,39.09524303963296,0.06347270287160256,839.7386479377747,325.810085773468,1032.6732292175293,37273,4971,32302,32302,0,11,4962000.0
4962,4962999,21.993820503967978,39.093446285742296,0.06346260398570847,839.8633847236633,325.87255597114563,1032.9870567321777,37280,4971,32309,32309,0,11,4963000.0
4963,4963999,21.994204514443744,39.0923691392586,0.06344508776094404,839.9841465950012,325.9353883266449,1033.2382431030273,37284,4971,32313,32313,0,11,4964000.0
4964,4964999,21.994046795691677,39.09059705434244,0.06343625467289904,840.1976742744446,325.99804425239563,1033.3411140441895,37296,4972,32324,32324,0,11,4965000.0
4965,4965999,21.993745745534156,39.088523389830684,0.0634209950446829,840.327155828476,326.0598576068878,1033.6347885131836,37301,4972,32329,32329,0,11,4966000.0
4966,4966999,21.993132745990827,39.086357128532576,0.063408179995179,840.4399819374084,326.1210901737213,1033.8069076538086,37303,4972,32331,32331,0,11,4967000.0
4967,4967999,21.991474429808434,39.08515735489248,0.06342451010646266,840.6506803035736,326.18515181541443,1034.431053161621,37329,4973,32356,32356,0,11,4968000.0
4968,4968999,21.989504026634282,39.08317223510234,0.06344749509577208,840.9320278167725,326.2482466697693,1034.7562294006348,37343,4975,32368,32368,0,11,4969000.0
4969,4969999,21.987449711513236,39.080196737653814,0.06346391551313812,841.053781747818,326.3120667934418,1035.0177192687988,37344,4975,32369,32369,0,11,4970000.0
4970,4970999,21.985460951612808,39.07698453812372,0.06348713631793212,841.2593278884888,326.37362241744995,1035.1737213134766,37351,4976,32375,32375,0,11,4971000.0
4971,4971999,21.983612081690307,39.07424884414367,0.06350163991989966,841.3728783130646,326.4364848136902,1035.5331687927246,37359,4976,32383,32383,0,11,4972000.0
4972,4972999,21.98187683257752,39.07148194111437,0.06351756859422086,841.5012476444244,326.5011134147644,1035.7698402404785,37360,4976,32384,32384,0,11,4973000.0
4973,4973999,21.980151631687473,39.06886190929346,0.06352988697146678,841.8764836788177,326.5637776851654,1035.8099937438965,37366,4979,32387,32387,0,11,4974000.0
4974,4974999,21.978396567625012,39.06590101175236,0.0635382738160436,841.9845108985901,326.62509393692017,1036.2832832336426,37375,4979,32396,32396,0,11,4975000.0
4975,4975999,21.976808373196384,39.06323872568333,0.06354590252583148,842.2818367481232,326.6892638206482,1036.4097290039062,37379,4981,32398,32398,0,11,4976000.0
4976,4976999,21.975416165704615,39.06108173143838,0.06354782423987915,842.4763994216919,326.7517201900482,1036.573314666748,37383,4982,32401,32401,0,11,4977000.0
4977,4977999,21.97416504195295,39.0588398618866,0.06354661674902762,842.6048114299774,326.81436562538147,1036.935634613037,37388,4982,32406,32406,0,11,4978000.0
4978,4978999,21.97296898539583,39.05641454350985,0.06353670486721097,842.8935010433197,330.1891016960144,1037.0954475402832,37392,4984,32408,32408,0,11,4979000.0
4979,4979999,21.971756882718815,39.05416985075483,0.06353700285307062,843.1168186664581,330.2544002532959,1037.2460594177246,37400,4985,32415,32415,0,11,4980000.0
4980,4980999,21.970756733912435,39.05256565639841,0.0635320678515141,843.2400324344635,330.3182430267334,1037.6467895507812,37413,4985,32428,32428,0,11,4981000.0
4981,4981999,21.970590673239965,39.05211845341861,0.06352924500283086,843.4534895420074,330.38167333602905,1037.984172821045,37422,4986,32436,32436,0,11,4982000.0
4982,4982999,21.9705186268424,39.051327456704485,0.06352042333637464,843.567901134491,330.4427080154419,1038.1604461669922,37422,4986,32436,32436,0,11,4983000.0
4983,4983999,21.971298575617826,39.05163811935788,0.06350961534181765,843.7784848213196,330.5060405731201,1038.6728477478027,37440,4987,32453,32453,0,11,4984000.0
4984,4984999,21.972076143680983,39.05172724372882,0.06350551793651027,843.8956933021545,330.56833839416504,1038.9507675170898,37440,4987,32453,32453,0,11,4985000.0
4985,4985999,21.97245488590168,39.05101192435952,0.0635076871502912,844.0201148986816,330.6333837509155,1039.1300010681152,37440,4987,32453,32453,0,11,4986000.0
4986,4986999,21.972894551647997,39.050356795287094,0.06350901606140602,844.4199349880219,330.6984236240387,1039.2991676330566,37462,4990,32472,32472,0,11,4987000.0
4987,4987999,21.97283505794556,39.05006302140907,0.06349726448894721,844.6213312149048,330.7603259086609,1039.522560119629,37472,4991,32481,32481,0,11,4988000.0
4988,4988999,21.97123694197938,39.047953118898825,0.06350881205029002,844.8516972064972,330.82585191726685,1039.9393119812012,37488,4992,32496,32496,0,11,4989000.0
4989,4989999,21.969226115204492,39.044765589794515,0.06352499350374397,845.068728685379,330.8916234970093,1040.3653717041016,37495,4993,32502,32502,0,11,4990000.0
4990,4990999,21.967556664773994,39.04301499703365,0.06353381822143045,845.1949853897095,330.9584982395172,1040.543788909912,37495,4993,32502,32502,0,11,4991000.0
4991,4991999,21.966117830331985,39.040302412246625,0.06354707901207501,845.413685798645,331.02336525917053,1040.6153144836426,37497,4994,32503,32503,0,11,4992000.0
4992,4992999,21.96481821242141,39.0382054666831,0.06354915275148665,845.6377665996552,331.0874228477478,1040.8696746826172,37504,4995,32509,32509,0,11,4993000.0
4993,4993999,21.96395858810362,39.03653063681923,0.06355070275172714,846.0361516475677,331.1490728855133,1040.9822044372559,37521,4998,32523,32523,0,11,4994000.0
4994,4994999,21.963180054133677,39.03482182828058,0.0635514224535777,846.2540347576141,331.21360206604004,1041.0927238464355,37523,4999,32524,32524,0,11,4995000.0
4995,4995999,21.962495119045265,39.033332181009726,0.06355156598281264,846.4694111347198,331.2769932746887,1041.4266510009766,37535,5000,32535,32535,0,11,4996000.0
4996,4996999,21.962071456433566,39.03197991577977,0.06355356751616414,846.6821329593658,331.3423807621002,1041.647575378418,37538,5001,32537,32537,0,11,4997000.0
4997,4997999,21.961765711523523,39.03102460942256,0.06355145994017253,846.9053871631622,331.4067416191101,1041.7803268432617,37540,5002,32538,32538,0,11,4998000.0
4998,4998999,21.96168284017022,39.03038583320589,0.06356235201132432,847.1455774307251,331.4721930027008,1042.392505645752,37563,5003,32560,32560,0,11,4999000.0
4999,4999999,21.961864824578313,39.03007003918349,0.06356302132958747,847.2689139842987,331.53803873062134,1042.747730255127,37563,5003,32560,32560,0,11,5000000.0
5000,5000999,21.961853235724295,39.029521306240525,0.06356671603814956,847.3865330219269,331.60254311561584,1043.001968383789,37565,5003,32562,32562,0,11,5001000.0
5001,5001999,21.96242939777536,39.03008244080971,0.06354333966356651,847.6165390014648,331.6670227050781,1043.4970016479492,37612,5004,32608,32608,0,11,5002000.0
5002,5002999,21.963483747835383,39.03080161888419,0.06353068432043651,847.7290065288544,331.7299678325653,1043.9625778198242,37618,5004,32614,32614,0,11,5003000.0
5003,5003999,21.96420229236831,39.032267420285095,0.0635253539752616,847.8477518558502,331.7950220108032,1044.1880569458008,37618,5004,32614,32614,0,11,5004000.0
5004,5004999,21.96485831996276,39.032430780957746,0.0635307403553017,847.9718241691589,331.85832500457764,1044.6434783935547,37629,5004,32625,32625,0,11,5005000.0
5005,5005999,21.965478480376685,39.031944081179695,0.0635304178607532,848.096657037735,331.92042684555054,1044.8360748291016,37630,5004,32626,32626,0,11,5006000.0
5006,5006999,21.965774917233905,39.03131601442173,0.06352506350249054,848.3062682151794,331.9846215248108,1044.9231071472168,37632,5005,32627,32627,0,11,5007000.0
5007,5007999,21.965836237541108,39.030266636814844,0.06351959753567205,848.5312519073486,332.0472164154053,1045.1652793884277,37639,5006,32633,32633,0,11,5008000.0
5008,5008999,21.965381441406,39.02874937897611,0.06351758503338789,848.9197840690613,332.1100900173187,1045.3028297424316,37660,5009,32651,32651,0,11,5009000.0
5009,5009999,21.96379491997707,39.02617650267848,0.06353199691145917,849.0587222576141,332.17421221733093,1045.9350357055664,37685,5009,32676,32676,0,11,5010000.0
5010,5010999,21.96228647364665,39.02438629882066,0.06355060906488053,849.1772594451904,332.2376940250397,1046.2534790039062,37688,5009,32679,32679,0,11,5011000.0
5011,5011999,21.96047192473728,39.021386797931584,0.06357502582471375,849.306275844574,332.3026819229126,1046.432689666748,37689,5009,32680,32680,0,11,5012000.0
5012,5012999,21.959250805501878,39.02027525864232,0.0635792500064728,849.4261314868927,332.3668785095215,1046.8935470581055,37703,5009,32694,32694,0,11,5013000.0
5013,5013999,21.957657139111486,39.01815269561653,0.06359165341839934,849.7151968479156,332.4313232898712,1047.2049598693848,37715,5011,32704,32704,0,11,5014000.0
5014,5014999,21.956339986013514,39.01611135403765,0.0635977301364774,849.831951379776,332.494176864624,1047.4992637634277,37716,5011,32705,32705,0,11,5015000.0
5015,5015999,21.95517149369641,39.01385796588483,0.06360724445699695,849.9550287723541,332.56081223487854,1047.937656402588,37724,5011,32713,32713,0,11,5016000.0
5016,5016999,21.9538172445791,39.01130807880907,0.06361749381646609,850.1746802330017,332.6265048980713,1048.0844116210938,37726,5012,32714,32714,0,11,5017000.0
5017,5017999,21.953119183378043,39.01681608074811,0.06359807212840074,850.3035140037537,332.68904876708984,1048.2211952209473,37727,5012,32715,32715,0,11,5018000.0
5018,5018999,21.952282658198513,39.0147836868365,0.06359111474654366,850.5151772499084,332.7545533180237,1048.9236793518066,37758,5013,32745,32745,0,11,5019000.0
5019,5019999,21.951236713496364,39.012320372628075,0.0635939069760072,850.8901596069336,332.8183083534241,1049.1275215148926,37781,5016,32765,32765,0,11,5020000.0
5020,5020999,21.950402348914906,39.012936022318115,0.06358726344892984,851.0103490352631,332.88143658638,1049.3897705078125,37782,5016,32766,32766,0,11,5021000.0
5021,5021999,21.950065541308923,39.01126563454444,0.06357652162947858,851.2217860221863,332.9484841823578,1049.9883117675781,37807,5017,32790,32790,0,11,5022000.0
5022,5022999,21.949688159788145,39.009568210470924,0.06356812032528458,851.3547241687775,333.0138096809387,1050.222454071045,37808,5017,32791,32791,0,11,5023000.0
5023,5023999,21.94967291515543,39.007958428811655,0.06355279486110543,851.6520082950592,333.07908368110657,1050.6030616760254,37830,5019,32811,32811,0,11,5024000.0
5024,5024999,21.949497204721204,39.006759271152085,0.0635435856023393,851.9452755451202,333.14163637161255,1050.7607765197754,37849,5021,32828,32828,0,11,5025000.0
5025,5025999,21.949531229842645,39.005118651859576,0.06352800043971252,852.1560950279236,333.2049789428711,1051.037425994873,37863,5022,32841,32841,0,11,5026000.0
5026,5026999,21.947882652029836,39.003285392236954,0.06354210393042448,852.2753112316132,333.2688157558441,1051.638355255127,37880,5022,32858,32858,0,11,5027000.0
5027,5027999,21.946062625789125,39.000495450740154,0.06356307062674849,852.391172170639,333.3316299915314,1051.9099006652832,37883,5022,32861,32861,0,11,5028000.0
5028,5028999,21.944286947409193,38.99811367932562,0.06358208856783931,852.596355676651,333.39475560188293,1052.0279350280762,37885,5023,32862,32862,0,11,5029000.0
5029,5029999,21.942933600166004,38.996728952883956,0.0635896337562557,852.7146074771881,333.4575996398926,1052.3903312683105,37891,5023,32868,32868,0,11,5030000.0
5030,5030999,21.941410913019933,38.99476087880207,0.0635990121302209,852.9175930023193,333.5201292037964,1052.6789360046387,37896,5024,32872,32872,0,11,5031000.0
5031,5031999,21.94040250653588,38.99379835048033,0.06359540621083115,853.0336940288544,333.58353447914124,1052.8914604187012,37898,5024,32874,32874,0,11,5032000.0
5032,5032999,21.93922947036653,38.992027119862996,0.06360411362607088,853.1454737186432,333.6454257965088,1053.1586685180664,37902,5024,32878,32878,0,11,5033000.0
5033,5033999,21.938125088133287,38.989960470578666,0.0636104214790193,853.366771697998,333.70938897132874,1053.2580833435059,37904,5025,32879,32879,0,11,5034000.0
5034,5034999,21.93733863597315,38.98814925090069,0.0636077507380155,853.5959577560425,333.7728145122528,1053.316505432129,37907,5026,32881,32881,0,11,5035000.0
5035,5035999,21.937155158497834,38.98785062465383,0.06359502325182087,853.7175123691559,333.8371479511261,1053.8149681091309,37919,5026,32893,32893,0,11,5036000.0
5036,5036999,21.937196982109235,38.987792202453015,0.06360474517365278,854.0085570812225,333.9037666320801,1054.0507202148438,37926,5028,32898,32898,0,11,5037000.0
5037,5037999,21.937228324972622,38.98751230055325,0.06360568648258247,854.2077193260193,333.9663166999817,1054.2509574890137,37934,5029,32905,32905,0,11,5038000.0
5038,5038999,21.937645231984064,38.987352289825985,0.063602739029617,854.6792404651642,334.0310754776001,1054.6403007507324,37966,5033,32933,32933,0,11,5039000.0
5039,5039999,21.93791312454446,38.98708456349889,0.06359746594061766,854.8873062133789,334.0943212509155,1054.9418029785156,37970,5034,32936,32936,0,11,5040000.0
5040,5040999,21.938416365437874,38.98812247461477,0.06360293026354402,855.0859749317169,334.1566882133484,1055.122215270996,37978,5035,32943,32943,0,11,5041000.0
5041,5041999,21.938831905578823,38.987704038797524,0.06359225709524974,855.2823617458344,334.21785140037537,1055.7482299804688,38001,5036,32965,32965,0,11,5042000.0
5042,5042999,21.939199091642514,38.987110161354806,0.06359690080719993,855.8466091156006,334.2817678451538,1055.908462524414,38062,5041,33021,33021,0,11,5043000.0
5043,5043999,21.939164899834452,38.985771668514445,0.06359005953251817,855.9579908847809,334.3446099758148,1056.1557807922363,38062,5041,33021,33021,0,11,5044000.0
5044,5044999,21.939316572798486,38.98442280499585,0.06358208280005606,856.26327085495,334.4085009098053,1056.4006690979004,38083,5043,33040,33040,0,11,5045000.0
5045,5045999,21.938919057563403,38.98322677800698,0.06357253609639768,856.5697424411774,334.472234249115,1056.8764152526855,38109,5045,33064,33064,0,11,5046000.0
5046,5046999,21.93730373274971,38.98109440107144,0.0635723473487888,856.8596420288086,334.5359387397766,1057.2547454833984,38134,5047,33087,33087,0,11,5047000.0
5047,5047999,21.936554599183328,38.98229716572814,0.06357704690869503,856.9815278053284,334.6011266708374,1057.6674270629883,38136,5047,33089,33089,0,11,5048000.0
5048,5048999,21.935795441357964,38.982040327654204,0.0636039532879148,857.1846513748169,334.66476011276245,1057.7969360351562,38138,5048,33090,33090,0,11,5049000.0
5049,5049999,21.93514863313349,38.981882378778984,0.06362244156690078,857.4761617183685,334.7292866706848,1057.9095420837402,38154,5050,33104,33104,0,11,5050000.0
5050,5050999,21.936009926779423,38.990283739716354,0.06362718178496529,857.5855569839478,334.7931091785431,1058.3586540222168,38161,5050,33111,33111,0,11,5051000.0
5051,5051999,21.936179581905826,38.99092332153382,0.063633574942776,857.8823437690735,334.85605549812317,1058.5358238220215,38168,5052,33116,33116,0,11,5052000.0
5052,5052999,21.936475743005534,38.99181325090431,0.06364527053981817,858.1733348369598,334.9195923805237,1058.796401977539,38178,5054,33124,33124,0,11,5053000.0
5053,5053999,21.937389387582954,38.99503865238552,0.06364845731646762,858.2906787395477,334.98411870002747,1059.078411102295,38178,5054,33124,33124,0,11,5054000.0
5054,5054999,21.93838629997544,39.00187512068975,0.06362699515772241,858.4981660842896,335.04869270324707,1059.2146377563477,38187,5055,33132,33132,0,11,5055000.0
5055,5055999,21.939123504434413,39.00233111869714,0.06363704466005149,858.7074484825134,335.1142716407776,1059.3307304382324,38189,5056,33133,33133,0,11,5056000.0
5056,5056999,21.939964861168484,39.002986860711246,0.06364331818336777,859.0031187534332,335.17799139022827,1059.7372779846191,38203,5058,33145,33145,0,11,5057000.0
5057,5057999,21.940930753001613,39.00402063590784,0.06366235936148301,859.4712975025177,335.24164843559265,1059.8180770874023,38221,5062,33159,33159,0,11,5058000.0
5058,5058999,21.941310309408266,39.00359416480306,0.063683889273218,859.6862807273865,335.3074383735657,1059.9365539550781,38230,5063,33167,33167,0,11,5059000.0
5059,5059999,21.942360469759286,39.0042240168123,0.06368672137406073,860.0797197818756,335.37206530570984,1060.4862899780273,38258,5066,33192,33192,0,11,5060000.0
5060,5060999,21.94332891736052,39.00459431046123,0.06371334938946871,860.2772884368896,335.4360988140106,1060.7455673217773,38260,5067,33193,33193,0,11,5061000.0
5061,5061999,21.944514073771156,39.00532534707559,0.06373883674506353,860.588841676712,335.5015730857849,1061.2527923583984,38290,5069,33221,33221,0,11,5062000.0
5062,5062999,21.94566495962646,39.00563317057283,0.06378699566203072,860.8762700557709,335.56508445739746,1061.606689453125,38300,5071,33229,33229,0,11,5063000.0
5063,5063999,21.946434631487975,39.00534296394292,0.06383897354714385,860.9947383403778,335.62726283073425,1061.8374099731445,38300,5071,33229,33229,0,11,5064000.0
5064,5064999,21.947433258730282,39.00523153570496,0.06385158164750226,861.1105711460114,335.69006180763245,1062.2922058105469,38309,5071,33238,33238,0,11,5065000.0
5065,5065999,21.947635498870657,39.00446631367091,0.06384755271314813,861.3950231075287,335.7519323825836,1062.5332298278809,38327,5073,33254,33254,0,11,5066000.0
5066,5066999,21.94629913644268,39.00342852117545,0.06384023697622565,861.695588350296,335.814857006073,1062.896297454834,38356,5075,33281,33281,0,11,5067000.0
5067,5067999,21.944590341688567,39.00098290065112,0.06384749582379845,861.8164734840393,335.8782196044922,1063.394790649414,38367,5075,33292,33292,0,11,5068000.0
5068,5068999,21.94300982048885,38.99952812243786,0.06385358644513994,861.9425668716431,335.94134998321533,1063.615577697754,38368,5075,33293,33293,0,11,5069000.0
5069,5069999,21.94140868779579,38.99694071601982,0.06386177075227173,862.2379140853882,336.00829124450684,1063.7189559936523,38384,5077,33307,33307,0,11,5070000.0
5070,5070999,21.94010859884098,38.994662218238325,0.06386440280745542,862.4379930496216,336.0707108974457,1064.001480102539,38395,5078,33317,33317,0,11,5071000.0
5071,5071999,21.93913041683267,38.99265788474736,0.06386284373897033,862.7284693717957,336.1331877708435,1064.1356353759766,38399,5080,33319,33319,0,11,5072000.0
5072,5072999,21.938623547011836,38.99197987774257,0.06386668163321385,863.0294735431671,336.1960883140564,1064.2725715637207,38411,5082,33329,33329,0,11,5073000.0
5073,5073999,21.938757968376034,38.992138366146,0.06385175644692564,863.227701663971,336.2596757411957,1064.4164772033691,38421,5083,33338,33338,0,11,5074000.0
5074,5074999,21.939137852065148,38.992090233499006,0.06385211478294961,863.5378084182739,336.32332396507263,1064.4993019104004,38425,5085,33340,33340,0,11,5075000.0
5075,5075999,21.93952727516187,38.9923398682166,0.06385374437754898,863.6559655666351,336.3858823776245,1064.610538482666,38425,5085,33340,33340,0,11,5076000.0
5076,5076999,21.940171959794792,38.99290238416159,0.06386352961562325,863.7731158733368,336.45021963119507,1065.2678260803223,38442,5085,33357,33357,0,11,5077000.0
5077,5077999,21.940756908647092,38.9937679855526,0.06387572430335753,863.972978591919,336.51284313201904,1065.4520568847656,38444,5086,33358,33358,0,11,5078000.0
5078,5078999,21.941435664246306,38.994295018933414,0.06388764343541964,864.1808619499207,336.57560992240906,1065.588523864746,38452,5087,33365,33365,0,11,5079000.0
5079,5079999,21.942570146397003,38.994755280632184,0.06389227732590497,864.3887405395508,336.63948106765747,1066.130214691162,38468,5088,33380,33380,0,11,5080000.0
5080,5080999,21.943686551310016,38.99507278569015,0.06392581685305854,864.5926229953766,336.70217728614807,1066.2996864318848,38470,5089,33381,33381,0,11,5081000.0
5081,5081999,21.94456088518842,38.994768780587904,0.06393930934304837,864.8890814781189,336.76519083976746,1066.553321838379,38494,5091,33403,33403,0,11,5082000.0
5082,5082999,21.945484208794745,38.99452068868759,0.06395383845210256,865.0094821453094,336.82889461517334,1066.79683303833,38495,5091,33404,33404,0,11,5083000.0
5083,5083999,21.94588760019845,38.993619803517035,0.06396051487712306,865.3204100131989,336.9000508785248,1066.8426780700684,38506,5093,33413,33413,0,11,5084000.0
5084,5084999,21.946769494778426,38.99303021830332,0.06394926852072091,865.6202733516693,336.96199679374695,1067.0295791625977,38514,5095,33419,33419,0,11,5085000.0
5085,5085999,21.94681367579682,38.99215603716033,0.06393561199246922,865.8338186740875,337.02595591545105,1067.4285316467285,38537,5096,33441,33441,0,11,5086000.0
5086,5086999,21.945326715331,38.992201028097995,0.06393286574972123,866.1284849643707,337.0917556285858,1067.8286895751953,38559,5098,33461,33461,0,11,5087000.0
5087,5087999,21.94326716438087,38.98908557359662,0.06395194742616406,866.3463099002838,337.15756130218506,1068.2643852233887,38572,5099,33473,33473,0,11,5088000.0
5088,5088999,21.941409013378273,38.98662814849521,0.06396747917392165,866.5454306602478,337.22092390060425,1068.387825012207,38580,5100,33480,33480,0,11,5089000.0
5089,5089999,21.939501947039336,38.98399129693227,0.06398243737625542,866.8444318771362,337.2857012748718,1068.4998207092285,38596,5102,33494,33494,0,11,5090000.0
5090,5090999,21.937986381446272,38.98153164325677,0.06398795073484032,866.9543299674988,337.34874749183655,1068.9135131835938,38604,5102,33502,33502,0,11,5091000.0
5091,5091999,21.936489102335795,38.97909562907227,0.0639927673289663,867.2489423751831,337.41327714920044,1069.0415229797363,38614,5104,33510,33510,0,11,5092000.0
5092,5092999,21.934918665846894,38.97659655412584,0.06399907656004633,867.5567646026611,337.47845482826233,1069.3505477905273,38635,5106,33529,33529,0,11,5093000.0
5093,5093999,21.93379681618637,38.97480427136444,0.06399575180149086,867.7623193264008,337.5431799888611,1069.6110153198242,38638,5107,33531,33531,0,11,5094000.0
5094,5094999,21.932587776663564,38.97273010223351,0.06400250807647612,867.9632012844086,337.6061041355133,1069.779125213623,38640,5108,33532,33532,0,11,5095000.0
5095,5095999,21.931557238186375,38.97081908350717,0.06400642423985003,868.1726157665253,337.66951179504395,1069.9117889404297,38642,5109,33533,33533,0,11,5096000.0
5096,5096999,21.930465721454404,38.968466016741495,0.06400915055366874,868.289012670517,337.7329354286194,1070.5331344604492,38657,5109,33548,33548,0,11,5097000.0
5097,5097999,21.92946991298078,38.966448656384706,0.06401281085033106,868.4899146556854,337.79570055007935,1070.7232208251953,38659,5110,33549,33549,0,11,5098000.0
5098,5098999,21.928410238535808,38.964809843072715,0.06401127925169448,868.6078069210052,337.857782125473,1070.8842086791992,38659,5110,33549,33549,0,11,5099000.0
5099,5099999,21.928056149005073,38.96297658514016,0.06399570506163077,868.8197131156921,337.92126965522766,1071.4054222106934,38679,5111,33568,33568,0,11,5100000.0
5100,5100999,21.927630710995206,38.9613753073897,0.06399024894104466,869.103353023529,337.984735250473,1071.5385246276855,38689,5113,33576,33576,0,11,5101000.0
5101,5101999,21.92715782741178,38.95957457526332,0.06398277970841193,869.3066732883453,338.0477955341339,1071.829677581787,38700,5114,33586,33586,0,11,5102000.0
5102,5102999,21.92735417828235,38.958673113420694,0.06396155852796748,869.4344501495361,338.120069026947,1072.2969703674316,38708,5114,33594,33594,0,11,5103000.0
5103,5103999,21.926819330559955,38.9564363091254,0.06395122484237814,869.5441198348999,338.1816291809082,1072.4848518371582,38708,5114,33594,33594,0,11,5104000.0
5104,5104999,21.926750784156113,38.95475520938906,0.06393915550757734,869.9567847251892,338.2504184246063,1072.5561485290527,38726,5117,33609,33609,0,11,5105000.0
5105,5105999,21.926475282272698,38.95342602913149,0.06392251016271921,870.0704090595245,338.31222128868103,1072.8204231262207,38727,5117,33610,33610,0,11,5106000.0
5106,5106999,21.924948822042087,38.95064052266392,0.06393226734850765,870.2808909416199,338.3755712509155,1073.4139671325684,38752,5118,33634,33634,0,11,5107000.0
5107,5107999,21.92294274420715,38.94834884865016,0.06394711349949833,870.4910199642181,338.43918681144714,1073.8103561401367,38765,5119,33646,33646,0,11,5108000.0
5108,5108999,21.92098602205133,38.94554835213982,0.06395952550168482,870.6025257110596,338.5019862651825,1074.0968208312988,38766,5119,33647,33647,0,11,5109000.0
5109,5109999,21.919005007398265,38.94273346820663,0.06397758767801565,870.9009380340576,338.5656135082245,1074.1787147521973,38779,5121,33658,33658,0,11,5110000.0
5110,5110999,21.917001582750142,38.939634424911574,0.06399172316901791,871.1185438632965,338.6297538280487,1074.5150833129883,38789,5122,33667,33667,0,11,5111000.0
5111,5111999,21.91507937964496,38.936623328806235,0.06400390526967781,871.3207318782806,338.69158840179443,1074.7280502319336,38794,5123,33671,33671,0,11,5112000.0
5112,5112999,21.913225686257093,38.9337091424813,0.06401266613590062,871.6313827037811,338.759019613266,1074.9130058288574,38805,5125,33680,33680,0,11,5113000.0
5113,5113999,21.911655056413988,38.931472468329666,0.06401472631415794,871.8424007892609,338.82367300987244,1075.3333015441895,38815,5126,33689,33689,0,11,5114000.0
5114,5114999,21.910338219727773,38.92944456466156,0.06401633022813635,871.9605476856232,338.88682675361633,1075.5123672485352,38815,5126,33689,33689,0,11,5115000.0
5115,5115999,21.908868299146768,38.926763591255735,0.06402255347676389,872.1679217815399,338.95015025138855,1075.683925628662,38817,5127,33690,33690,0,11,5116000.0
5116,5116999,21.907829879915326,38.92489635131306,0.06402018914243313,872.3897395133972,339.0148913860321,1075.9840660095215,38825,5128,33697,33697,0,11,5117000.0
5117,5117999,21.907696550993485,38.92419346703004,0.06400984014334798,872.5968496799469,339.0771675109863,1076.192211151123,38827,5129,33698,33698,0,11,5118000.0
5118,5118999,21.907844767907413,38.92349824275261,0.06400804353165168,872.8061385154724,339.14014315605164,1076.25386428833,38829,5130,33699,33699,0,11,5119000.0
5119,5119999,21.908118074245888,38.92584099017654,0.0640433724185645,873.1051805019379,339.20392084121704,1076.578769683838,38843,5132,33711,33711,0,11,5120000.0
5120,5120999,21.90914013915587,38.92679763583301,0.06402137103641203,873.2249541282654,339.26716566085815,1077.1274108886719,38852,5132,33720,33720,0,11,5121000.0
5121,5121999,21.910064458250616,38.92741426042564,0.06401348562717368,873.3335409164429,339.32956099510193,1077.3258171081543,38852,5132,33720,33720,0,11,5122000.0
5122,5122999,21.911274286188885,38.92859469367916,0.0640218443034608,873.89657330513,339.3934450149536,1077.7151336669922,38892,5137,33755,33755,0,11,5123000.0
5123,5123999,21.911789384694405,38.929008696425505,0.0640215809941792,874.090439081192,339.4553472995758,1078.120018005371,38894,5138,33756,33756,0,11,5124000.0
5124,5124999,21.911558548301354,38.92776132393413,0.06401811784271927,874.2965366840363,339.5191345214844,1078.3321800231934,38902,5139,33763,33763,0,11,5125000.0
5125,5125999,21.912136753828413,38.92747855676392,0.06401196248080177,874.4176070690155,339.5818657875061,1078.756763458252,38909,5139,33770,33770,0,11,5126000.0
5126,5126999,21.912529387463216,38.92700881261289,0.06402021761804322,874.7821793556213,339.642023563385,1078.9430122375488,38930,5142,33788,33788,0,11,5127000.0
5127,5127999,21.910904279519904,38.92475867930354,0.06403168831316275,875.1593532562256,339.70522356033325,1079.5314903259277,38970,5145,33825,33825,0,11,5128000.0
5128,5128999,21.909147973347476,38.922551610361275,0.06403904301369334,875.2794256210327,339.770033121109,1080.1417655944824,38981,5145,33836,33836,0,11,5129000.0
5129,5129999,21.907435513956734,38.91998108315404,0.06405182929592323,875.4829344749451,339.83340978622437,1080.45072555542,38990,5146,33844,33844,0,11,5130000.0
5130,5130999,21.905873959331156,38.9183193968471,0.06405670629535765,875.6850628852844,339.89642667770386,1080.5885696411133,38992,5147,33845,33845,0,11,5131000.0
5131,5131999,21.904314480082075,38.9159810682953,0.06405719880291849,875.79518866539,339.95828080177307,1080.9979362487793,38999,5147,33852,33852,0,11,5132000.0
5132,5132999,21.9032846451596,38.914191658950564,0.06405409476430268,875.9937264919281,340.01978063583374,1081.1735191345215,39001,5148,33853,33853,0,11,5133000.0
5133,5133999,21.90205355427756,38.91203091789942,0.06405542078546833,876.3070888519287,340.0860662460327,1081.259178161621,39008,5150,33858,33858,0,11,5134000.0
5134,5134999,21.901025928325815,38.90994647872326,0.06405283825965191,876.5158922672272,340.15010476112366,1081.639446258545,39018,5151,33867,33867,0,11,5135000.0
5135,5135999,21.8999635026648,38.91007541216672,0.0640464418804696,876.649266242981,340.22372460365295,1081.8841972351074,39018,5151,33867,33867,0,11,5136000.0
5136,5136999,21.89922111406237,38.90878639116724,0.06404543195655588,877.1137828826904,340.28712821006775,1081.9628219604492,39035,5155,33880,33880,0,11,5137000.0
5137,5137999,21.899126735439392,38.9085254949886,0.06403731764740539,877.4377179145813,340.3547217845917,1082.6036567687988,39063,5157,33906,33906,0,11,5138000.0
5138,5138999,21.899513605423298,38.91106961572546,0.06402528136121688,877.5546288490295,340.41800689697266,1083.017978668213,39063,5157,33906,33906,0,11,5139000.0
5139,5139999,21.900477392785966,38.9148165581323,0.06403513248153236,877.6664710044861,340.48223757743835,1083.2867813110352,39063,5157,33906,33906,0,11,5140000.0
5140,5140999,21.90179505840808,38.91632993541863,0.06406211252474969,877.8767337799072,340.54557943344116,1083.7413177490234,39082,5158,33924,33924,0,11,5141000.0
5141,5141999,21.903856500804842,38.91902141924782,0.0640830061311326,877.9856975078583,340.60827445983887,1084.2060585021973,39085,5158,33927,33927,0,11,5142000.0
5142,5142999,21.905712421133803,38.920941535895444,0.06414769287931421,878.0978021621704,340.6711673736572,1084.425609588623,39085,5158,33927,33927,0,11,5143000.0
5143,5143999,21.908259725512107,38.92654627789216,0.064121275201653,878.2158246040344,340.73393964767456,1084.948673248291,39098,5158,33940,33940,0,11,5144000.0
5144,5144999,21.91105842400619,38.93061466524155,0.06411319123569348,878.3315725326538,340.797082901001,1085.2052574157715,39099,5158,33941,33941,0,11,5145000.0
5145,5145999,21.91259910615297,38.93202975111155,0.0641238632377169,878.5495898723602,340.8593511581421,1085.3053855895996,39101,5159,33942,33942,0,11,5146000.0
5146,5146999,21.914426814044287,38.933531006341134,0.06413660152042078,878.7618892192841,340.9214541912079,1085.518497467041,39106,5160,33946,33946,0,11,5147000.0
5147,5147999,21.916253883549743,38.93621167768182,0.06414186432855229,878.963960647583,340.9811656475067,1085.6845207214355,39117,5161,33956,33956,0,11,5148000.0
5148,5148999,21.915005861629005,38.93403459280488,0.06415090890698327,879.0874402523041,341.0452239513397,1086.4482231140137,39144,5161,33983,33983,0,11,5149000.0
5149,5149999,21.91382950812791,38.93246176502089,0.0641551154824348,879.2159349918365,341.10954236984253,1086.9345741271973,39152,5161,33991,33991,0,11,5150000.0
5150,5150999,21.91243056149253,38.93020024072008,0.06416436687754956,879.3300278186798,341.1724970340729,1087.1152114868164,39152,5161,33991,33991,0,11,5151000.0
5151,5151999,21.91167844070195,38.93075718932154,0.06413113514827962,879.4532544612885,341.23534774780273,1087.6386375427246,39170,5161,34009,34009,0,11,5152000.0
5152,5152999,21.910534229786943,38.932038141127016,0.06411805730596076,879.5677509307861,341.2977616786957,1088.0696029663086,39172,5161,34011,34011,0,11,5153000.0
5153,5153999,21.909167542675846,38.92936304718292,0.06412411020578723,879.679690361023,341.3606517314911,1088.3320922851562,39173,5161,34012,34012,0,11,5154000.0
5154,5154999,21.908495174542956,38.92769508848751,0.06411636495825401,879.7904949188232,341.4237689971924,1088.7083129882812,39181,5161,34020,34020,0,11,5155000.0
5155,5155999,21.907786972199844,38.92623177273864,0.06410829021136988,880.1052029132843,341.4876456260681,1088.7914009094238,39197,5163,34034,34034,0,11,5156000.0
5156,5156999,21.90702806424567,38.924513111195274,0.06410138877585814,880.314329624176,341.55090951919556,1088.9074172973633,39200,5164,34036,34036,0,11,5157000.0
5157,5157999,21.906579322621813,38.92293603328996,0.06408845131756102,880.538031578064,341.61625814437866,1089.6276550292969,39225,5165,34060,34060,0,11,5158000.0
5158,5158999,21.90603688861617,38.92355304485342,0.06407250668572018,880.6483309268951,341.67991733551025,1089.9396324157715,39226,5165,34061,34061,0,11,5159000.0
5159,5159999,21.905051513868788,38.92131690394969,0.0640755157525148,880.8521363735199,341.74273467063904,1090.0942306518555,39235,5166,34069,34069,0,11,5160000.0
5160,5160999,21.904770092587512,38.92002005070311,0.06405829385271267,880.9766008853912,341.8058226108551,1090.869686126709,39257,5166,34091,34091,0,11,5161000.0
5161,5161999,21.90476095756355,38.9208189739671,0.0640266364652966,881.1913869380951,341.8784816265106,1091.0627403259277,39261,5167,34094,34094,0,11,5162000.0
5162,5162999,21.90491733345457,38.919361846968144,0.06399899174870294,881.4872953891754,341.9423589706421,1091.6429176330566,39293,5169,34124,34124,0,11,5163000.0
5163,5163999,21.904692093467308,38.91740346745532,0.06398179940043913,881.6001462936401,342.00635147094727,1091.934226989746,39293,5169,34124,34124,0,11,5164000.0
5164,5164999,21.904814010386083,38.916612190148136,0.06395325713301836,881.8113856315613,342.0698125362396,1092.3322677612305,39308,5170,34138,34138,0,11,5165000.0
5165,5165999,21.90327337880296,38.9137132839983,0.0639659874586821,882.0325717926025,342.1341817378998,1092.911808013916,39329,5171,34158,34158,0,11,5166000.0
5166,5166999,21.901789511444445,38.91139835414363,0.06397847189936212,882.2421138286591,342.19797253608704,1093.2712211608887,39340,5172,34168,34168,0,11,5167000.0
5167,5167999,21.90030375311797,38.90991400737513,0.06398806607795049,882.4588277339935,342.26358580589294,1093.3741264343262,39348,5173,34175,34175,0,11,5168000.0
5168,5168999,21.89881113613587,38.90714091427811,0.06399856601260823,882.6696734428406,342.32737946510315,1093.642162322998,39361,5174,34187,34187,0,11,5169000.0
5169,5169999,21.897710088051788,38.905194643508395,0.06400458497206296,882.7920138835907,342.38969254493713,1093.8367042541504,39361,5174,34187,34187,0,11,5170000.0
5170,5170999,21.89681800896052,38.90346500792646,0.0640051728299188,883.0162575244904,342.4553265571594,1093.9405326843262,39370,5175,34195,34195,0,11,5171000.0
5171,5171999,21.89601524182683,38.902649437747016,0.0639983408544027,883.308730840683,342.518577337265,1094.14164352417,39387,5177,34210,34210,0,11,5172000.0
5172,5172999,21.895210497256908,38.900926216774344,0.06398858777101124,883.5276157855988,342.58178758621216,1094.3810729980469,39399,5178,34221,34221,0,11,5173000.0
5173,5173999,21.89484301850508,38.90002734846228,0.06396778272680126,883.8338675498962,342.64486622810364,1094.4872093200684,39403,5180,34223,34223,0,11,5174000.0
5174,5174999,21.894268398665243,38.89870764068535,0.06393779067767047,883.9537162780762,342.70844411849976,1095.0644454956055,39416,5180,34236,34236,0,11,5175000.0
5175,5175999,21.893645252517395,38.89753846094375,0.06391741350107338,884.3461155891418,342.77308082580566,1095.2607154846191,39425,5183,34242,34242,0,11,5176000.0
5176,5176999,21.893371133262264,38.89734345982588,0.06390142413319355,884.6446466445923,342.83887791633606,1095.7118072509766,39446,5185,34261,34261,0,11,5177000.0
5177,5177999,21.89324611214472,38.89661361971645,0.06388343760879345,884.7658386230469,342.9050884246826,1096.2610206604004,39457,5185,34272,34272,0,11,5178000.0
5178,5178999,21.893034263625395,38.89524444762964,0.06386290022559316,884.8879075050354,342.97024369239807,1096.531982421875,39458,5185,34273,34273,0,11,5179000.0
5179,5179999,21.893533689640126,38.89515627011461,0.06382946329644612,885.0928440093994,343.0329055786133,1096.6278800964355,39460,5186,34274,34274,0,11,5180000.0
5180,5180999,21.89371459561044,38.89408740286109,0.06379753936258281,885.3084020614624,343.0958127975464,1097.1487083435059,39477,5187,34290,34290,0,11,5181000.0
5181,5181999,21.89406433534794,38.89318757528655,0.06375245674780006,885.792501449585,343.1587610244751,1097.256259918213,39499,5191,34308,34308,0,11,5182000.0
5182,5182999,21.893916232102402,38.89192914882294,0.06373647004069383,886.0885787010193,343.21976494789124,1097.4497528076172,39513,5193,34320,34320,0,11,5183000.0
5183,5183999,21.894841685422975,38.899578506189826,0.06345697855517185,886.3914849758148,343.2838795185089,1097.6785888671875,39529,5195,34334,34334,0,11,5184000.0
5184,5184999,21.895101487740487,38.9010843975733,0.06339535603004132,886.605640411377,343.3489029407501,1097.9927139282227,39541,5196,34345,34345,0,11,5185000.0
5185,5185999,21.893427240222543,38.899102249616206,0.0634046539495784,886.7324373722076,343.4111692905426,1098.3109016418457,39549,5196,34353,34353,0,11,5186000.0
5186,5186999,21.89184338801441,38.89769675300756,0.06340593328374089,886.9666855335236,343.476277589798,1098.7374229431152,39564,5197,34367,34367,0,11,5187000.0
5187,5187999,21.89037804455044,38.89675160761681,0.06340558377315497,887.1904628276825,343.543240070343,1098.8525199890137,39572,5198,34374,34374,0,11,5188000.0
5188,5188999,21.889045915345218,38.894825065145355,0.0634095519813499,887.3228316307068,343.60903239250183,1099.0010452270508,39572,5198,34374,34374,0,11,5189000.0
5189,5189999,21.888211652134814,38.8937894199795,0.06340845076944279,887.4432845115662,343.6744797229767,1099.3342475891113,39578,5198,34380,34380,0,11,5190000.0
5190,5190999,21.887163299664813,38.892033507779814,0.06340819900319761,887.8423042297363,343.7375340461731,1099.4390487670898,39587,5201,34386,34386,0,11,5191000.0
5191,5191999,21.886124247869216,38.890122913272705,0.06340332876804944,887.9668054580688,343.80019640922546,1099.6094436645508,39587,5201,34386,34386,0,11,5192000.0
5192,5192999,21.885158440644137,38.88798225554936,0.06339967907256461,888.2755174636841,343.8678035736084,1099.8389320373535,39602,5203,34399,34399,0,11,5193000.0
5193,5193999,21.884530634259935,38.886249129920685,0.06339228778266592,888.4798002243042,343.93087577819824,1099.9708824157715,39604,5204,34400,34400,0,11,5194000.0
5194,5194999,21.884222755909366,38.88583571900526,0.06338279122366597,888.6187274456024,343.996826171875,1100.092700958252,39604,5204,34400,34400,0,11,5195000.0
5195,5195999,21.883694142304424,38.88408991853968,0.06336853925344033,888.7357420921326,344.0618224143982,1100.5119895935059,39613,5204,34409,34409,0,11,5196000.0
5196,5196999,21.883203827620417,38.882908207421934,0.06336006620817058,888.9418964385986,344.12413239479065,1100.7065887451172,39615,5205,34410,34410,0,11,5197000.0
5197,5197999,21.88247331876026,38.88118711983344,0.06335768279207665,889.1528856754303,344.187043428421,1100.8368110656738,39617,5206,34411,34411,0,11,5198000.0
5198,5198999,21.882540901069678,38.882774213188426,0.06332635544205722,889.3665862083435,344.25128388404846,1101.219539642334,39630,5207,34423,34423,0,11,5199000.0
5199,5199999,21.882233906092427,38.88114210050605,0.06331028603178968,889.6589918136597,344.3138802051544,1101.415584564209,39641,5209,34432,34432,0,11,5200000.0
5200,5200999,21.88199910765067,38.8795891146728,0.06328922674451787,889.7708876132965,344.3762996196747,1101.6142539978027,39641,5209,34432,34432,0,11,5201000.0
5201,5201999,21.88217969266432,38.879164990498175,0.06325678260703482,889.9877192974091,344.4396150112152,1102.2173957824707,39660,5210,34450,34450,0,11,5202000.0
5202,5202999,21.882091522324863,38.877744499917235,0.06323703212891607,890.1035706996918,344.50166296958923,1102.4863891601562,39660,5210,34450,34450,0,11,5203000.0
5203,5203999,21.88146778670121,38.875716841194006,0.06322373661958958,890.4975340366364,344.5645520687103,1102.607852935791,39696,5213,34483,34483,0,11,5204000.0
5204,5204999,21.880809761633227,38.87363607318836,0.0632095642568159,890.611786365509,344.62672686576843,1102.95112991333,39702,5213,34489,34489,0,11,5205000.0
5205,5205999,21.880385309652482,38.87182600373682,0.06319605394078975,890.828191280365,344.6926953792572,1103.3011512756348,39722,5214,34508,34508,0,11,5206000.0
5206,5206999,21.878563366447896,38.869048218214026,0.06321429953877766,891.1358466148376,344.75599336624146,1103.5231819152832,39740,5216,34524,34524,0,11,5207000.0
5207,5207999,21.876713008689,38.86624982926312,0.06322757872593776,891.3566222190857,344.8198583126068,1103.9361724853516,39749,5217,34532,34532,0,11,5208000.0
5208,5208999,21.874962309455444,38.86336936016094,0.06324666565034598,891.4806845188141,344.883606672287,1104.086524963379,39749,5217,34532,34532,0,11,5209000.0
5209,5209999,21.873328182542696,38.86073537129552,0.06326075362519135,891.7880449295044,344.9473030567169,1104.164680480957,39755,5219,34536,34536,0,11,5210000.0
5210,5210999,21.872176482848563,38.85965869321658,0.06325975364100012,891.903858423233,345.0092055797577,1104.470359802246,39758,5219,34539,34539,0,11,5211000.0
5211,5211999,21.87067999009007,38.85705318674512,0.06326987449156585,892.2937483787537,345.0730450153351,1104.568099975586,39770,5222,34548,34548,0,11,5212000.0
5212,5212999,21.869337230175503,38.85457060357226,0.06327556221521691,892.4146935939789,345.1354122161865,1104.8018188476562,39774,5222,34552,34552,0,11,5213000.0
5213,5213999,21.86843375513928,38.8523076679973,0.06327578431697167,892.5320920944214,345.1989598274231,1104.968547821045,39774,5222,34552,34552,0,11,5214000.0
5214,5214999,21.867691823605586,38.85080726530462,0.06326958452854836,892.7434718608856,345.26211810112,1105.0933570861816,39777,5223,34554,34554,0,11,5215000.0
5215,5215999,21.8669726969565,38.849031441469265,0.06326976205365198,893.1387481689453,345.3257749080658,1105.1747970581055,39795,5226,34569,34569,0,11,5216000.0
5216,5216999,21.866111845216704,38.84679616256475,0.06326264706507456,893.2489984035492,345.38952827453613,1105.7291946411133,39807,5226,34581,34581,0,11,5217000.0
5217,5217999,21.865283391770134,38.84464518365587,0.0632531768646094,893.4556572437286,345.45230317115784,1105.893165588379,39809,5227,34582,34582,0,11,5218000.0
5218,5218999,21.86465908067275,38.843081136367005,0.06324570982985656,893.5665221214294,345.51422214508057,1106.0601272583008,39809,5227,34582,34582,0,11,5219000.0
5219,5219999,21.86447312696319,38.841798671580676,0.06322326686808033,893.7789034843445,345.5805780887604,1106.5999946594238,39824,5228,34596,34596,0,11,5220000.0
5220,5220999,21.864462323420476,38.841277414672845,0.06320868721555617,894.0807921886444,345.64447951316833,1106.7195472717285,39828,5230,34598,34598,0,11,5221000.0
5221,5221999,21.864411545029476,38.84002594230152,0.0631924747186422,894.2998836040497,345.708074092865,1107.1690864562988,39851,5231,34620,34620,0,11,5222000.0
5222,5222999,21.864417720402805,38.83906879110565,0.06317850383550616,894.416247844696,345.7730338573456,1107.4651336669922,39851,5231,34620,34620,0,11,5223000.0
5223,5223999,21.864143768208795,38.83873170898739,0.06316606336342057,894.6181144714355,345.835750579834,1107.6091995239258,39859,5232,34627,34627,0,11,5224000.0
5224,5224999,21.863772354292454,38.83799075849602,0.06314378714916147,895.3639998435974,345.89997696876526,1107.66890335083,39914,5239,34675,34675,0,11,5225000.0
5225,5225999,21.863259886517888,38.83601800326116,0.06313602641900895,895.7560379505157,345.96304750442505,1107.9594802856445,39943,5242,34701,34701,0,11,5226000.0
5226,5226999,21.86183796178062,38.834861593192635,0.06314612745023385,895.8767261505127,346.02709579467773,1108.3103485107422,39954,5242,34712,34712,0,11,5227000.0
5227,5227999,21.860041032317902,38.832078147434196,0.06316040738319018,896.089457988739,346.0906434059143,1108.770351409912,39970,5243,34727,34727,0,11,5228000.0
5228,5228999,21.858208596876732,38.82913116701293,0.0631736064127697,896.2027850151062,346.15416049957275,1108.944667816162,39971,5243,34728,34728,0,11,5229000.0
5229,5229999,21.856570345004375,38.82647399945197,0.06318477675029122,896.4263541698456,346.2190616130829,1109.0630111694336,39978,5244,34734,34734,0,11,5230000.0
5230,5230999,21.85537906512756,38.82456176948381,0.06318942943716943,896.8139381408691,346.28125405311584,1109.33345413208,40004,5247,34757,34757,0,11,5231000.0
5231,5231999,21.853965776756656,38.82194550841394,0.0631943023409085,897.1100528240204,346.344064950943,1109.503189086914,40008,5249,34759,34759,0,11,5232000.0
5232,5232999,21.852765333809085,38.81995423482042,0.06319796788868404,897.3246660232544,346.410347700119,1109.7832717895508,40023,5250,34773,34773,0,11,5233000.0
5233,5233999,21.851568813358583,38.81812647953261,0.06320064825683536,897.5264067649841,346.4737865924835,1110.1226959228516,40028,5251,34777,34777,0,11,5234000.0
5234,5234999,21.85027054612817,38.81571125272966,0.06320235780061023,897.7272536754608,346.53707337379456,1110.3039817810059,40030,5252,34778,34778,0,11,5235000.0
5235,5235999,21.849004851895604,38.81329161302957,0.06320584522284012,898.0250933170319,346.60177421569824,1110.4809303283691,40042,5254,34788,34788,0,11,5236000.0
5236,5236999,21.848021812646145,38.81162506141871,0.06319722099472491,898.4133248329163,346.6666738986969,1111.015266418457,40064,5257,34807,34807,0,11,5237000.0
5237,5237999,21.84689731462793,38.80963158234558,0.06319816187496707,898.7163074016571,346.7298254966736,1111.2400207519531,40073,5259,34814,34814,0,11,5238000.0
5238,5238999,21.845463687525267,38.80730218819394,0.06320391709073092,899.2133662700653,346.7939682006836,1111.3554611206055,40099,5263,34836,34836,0,11,5239000.0
5239,5239999,21.844810332758996,38.80542153178635,0.06318609479917325,899.5155909061432,346.85858726501465,1111.9365730285645,40131,5265,34866,34866,0,11,5240000.0
5240,5240999,21.844094344128838,38.804736591648386,0.06316842636395703,899.822972536087,346.9235100746155,1112.2083702087402,40145,5267,34878,34878,0,11,5241000.0
5241,5241999,21.843413082959046,38.802693619657866,0.0631576288647211,899.9366776943207,346.9867925643921,1112.4202117919922,40145,5267,34878,34878,0,11,5242000.0
5242,5242999,21.842979146192665,38.80104315116541,0.06314005102802844,900.252387046814,347.05425000190735,1113.195468902588,40179,5269,34910,34910,0,11,5243000.0
5243,5243999,21.842053809475274,38.79882827915237,0.06313285984542505,900.5491070747375,347.11764192581177,1113.4268188476562,40197,5271,34926,34926,0,11,5244000.0
5244,5244999,21.84087747852015,38.796432468134974,0.06312720037199548,900.6600148677826,347.1811718940735,1113.84521484375,40206,5271,34935,34935,0,11,5245000.0
5245,5245999,21.840056631926785,38.794384506381625,0.06311245286593392,901.1437294483185,347.2442307472229,1114.0390968322754,40235,5275,34960,34960,0,11,5246000.0
5246,5246999,21.838566892293944,38.7916867433776,0.06312404117287451,901.352921962738,347.3077483177185,1114.638053894043,40264,5276,34988,34988,0,11,5247000.0
5247,5247999,21.83637664697731,38.78872031632049,0.0631421320084079,901.5751202106476,347.3720245361328,1114.9517669677734,40275,5277,34998,34998,0,11,5248000.0
5248,5248999,21.834494035778548,38.7859722306121,0.0631562689831251,901.6935698986053,347.43860244750977,1115.1703987121582,40276,5277,34999,34999,0,11,5249000.0
5249,5249999,21.832810877516543,38.78324055477834,0.0631729098630347,901.8179602622986,347.5017502307892,1115.3400230407715,40277,5277,35000,35000,0,11,5250000.0
5250,5250999,21.831141777627867,38.78069417444818,0.06318395826740053,901.9380576610565,347.5660135746002,1115.5425987243652,40279,5277,35002,35002,0,11,5251000.0
5251,5251999,21.830012941528814,38.779457761824276,0.06318472219499738,902.233473777771,347.6282694339752,1115.6529693603516,40292,5279,35013,35013,0,11,5252000.0
5252,5252999,21.828487870629424,38.777518253999155,0.06319247964595365,902.451402425766,347.6929850578308,1115.7916297912598,40294,5280,35014,35014,0,11,5253000.0
5253,5253999,21.827260097021114,38.775677301294586,0.06319956148444317,902.5716390609741,347.7565140724182,1116.1982650756836,40301,5280,35021,35021,0,11,5254000.0
5254,5254999,21.826162364293697,38.77371024244623,0.06319991669864211,902.6821649074554,347.81783866882324,1116.388069152832,40301,5280,35021,35021,0,11,5255000.0
5255,5255999,21.825050581173862,38.771667459087865,0.06320046854999906,902.8923180103302,347.88106203079224,1116.5529098510742,40304,5281,35023,35023,0,11,5256000.0
5256,5256999,21.82413437142319,38.76968268559099,0.06319777586802044,903.1010038852692,347.9447259902954,1116.6948509216309,40308,5282,35026,35026,0,11,5257000.0
5257,5257999,21.823081339211903,38.76783769843367,0.06319319420298797,903.2179143428802,348.006596326828,1116.9391784667969,40310,5282,35028,35028,0,11,5258000.0
5258,5258999,21.822245051864357,38.766205846198595,0.06318911433121621,903.4329590797424,348.0705873966217,1117.1125373840332,40312,5283,35029,35029,0,11,5259000.0
5259,5259999,21.821132956899728,38.76414834302445,0.06318901521244336,903.6498370170593,348.13279938697815,1117.2181663513184,40314,5284,35030,35030,0,11,5260000.0
5260,5260999,21.82073319015162,38.76490864286763,0.0631749555735992,903.8521447181702,348.19575905799866,1117.6695709228516,40327,5285,35042,35042,0,11,5261000.0
5261,5261999,21.82028257841887,38.764357568071325,0.06316797126624363,904.0650019645691,348.25774598121643,1117.745018005371,40331,5286,35045,35045,0,11,5262000.0
5262,5262999,21.820014140905958,38.76465544017189,0.0631568195379697,904.5658690929413,348.32250022888184,1117.970500946045,40353,5290,35063,35063,0,11,5263000.0
5263,5263999,21.81999770599973,38.763891469480306,0.0631492452664193,904.7708914279938,348.38486313819885,1118.2240600585938,40355,5291,35064,35064,0,11,5264000.0
5264,5264999,21.819932403528643,38.76386413431612,0.0631377980530008,904.8955543041229,348.44987964630127,1118.4347229003906,40355,5291,35064,35064,0,11,5265000.0
5265,5265999,21.819544362703862,38.76216909300641,0.06313095160881588,905.0148038864136,348.5135681629181,1118.7083854675293,40360,5291,35069,35069,0,11,5266000.0
5266,5266999,21.818720519624527,38.760241727383345,0.06312843912217392,905.2245230674744,348.57530331611633,1118.9043045043945,40370,5292,35078,35078,0,11,5267000.0
5267,5267999,21.817425053134592,38.7595219860827,0.06313126572161976,905.4352626800537,348.6380112171173,1119.3568572998047,40393,5293,35100,35100,0,11,5268000.0
5268,5268999,21.815550992108985,38.75700329108485,0.06314387240367858,905.5494854450226,348.7014088630676,1119.740634918213,40399,5293,35106,35106,0,11,5269000.0
5269,5269999,21.814128792721863,38.75571365453166,0.0631509658369821,905.66654920578,348.76425981521606,1119.9080429077148,40399,5293,35106,35106,0,11,5270000.0
5270,5270999,21.812789018883702,38.75385105831322,0.0631598940626058,905.7864897251129,348.8271164894104,1120.0368270874023,40399,5293,35106,35106,0,11,5271000.0
5271,5271999,21.812001303630908,38.75273741877602,0.0631398282394311,906.005368232727,348.89163088798523,1120.249168395996,40405,5294,35111,35111,0,11,5272000.0
5272,5272999,21.810942614787958,38.750522584295084,0.06314010808088644,906.1284537315369,348.9531624317169,1120.420352935791,40405,5294,35111,35111,0,11,5273000.0
5273,5273999,21.810027559875362,38.749247363031124,0.06313371835402648,906.2530317306519,349.01482629776,1120.5348358154297,40405,5294,35111,35111,0,11,5274000.0
5274,5274999,21.8091393371397,38.74739933224975,0.06312933706865875,906.3730807304382,349.0803198814392,1120.7512092590332,40408,5294,35114,35114,0,11,5275000.0
5275,5275999,21.808321404600857,38.745450188628,0.06312504757306203,906.687586069107,349.1440637111664,1120.836223602295,40421,5296,35125,35125,0,11,5276000.0
5276,5276999,21.807767141365456,38.74651560438629,0.06311467232296064,906.8213810920715,349.20727729797363,1120.9933280944824,40421,5296,35125,35125,0,11,5277000.0
5277,5277999,21.806807538136525,38.74438412626159,0.06311020183581517,906.9415857791901,349.2714476585388,1121.560646057129,40441,5296,35145,35145,0,11,5278000.0
5278,5278999,21.806486749928244,38.74329883728617,0.06310476871355009,907.0620377063751,349.3364644050598,1121.983081817627,40443,5296,35147,35147,0,11,5279000.0
5279,5279999,21.806093028199218,38.7418990303477,0.06309953555236014,907.172324180603,349.39891600608826,1122.2535591125488,40443,5296,35147,35147,0,11,5280000.0
5280,5280999,21.80611724087448,38.743162511866906,0.06309354259513988,907.3871765136719,349.4623782634735,1122.5321998596191,40454,5297,35157,35157,0,11,5281000.0
5281,5281999,21.806368279491636,38.74272680617218,0.0630781165395442,907.6905648708344,349.5262713432312,1122.9734153747559,40484,5299,35185,35185,0,11,5282000.0
5282,5282999,21.806603364044715,38.742071120359135,0.06307393563395047,907.8186964988708,349.5894536972046,1123.1961708068848,40485,5299,35186,35186,0,11,5283000.0
5283,5283999,21.807013350073653,38.74288751410067,0.0630574379960187,907.946097612381,349.6546165943146,1123.4904174804688,40491,5299,35192,35192,0,11,5284000.0
5284,5284999,21.807462946209284,38.74221632036161,0.06304832898149415,908.0622537136078,349.71639227867126,1123.666690826416,40492,5299,35193,35193,0,11,5285000.0
5285,5285999,21.807857094239722,38.74140891471963,0.06303135875007815,908.2799143791199,349.7769351005554,1123.7559394836426,40501,5300,35201,35201,0,11,5286000.0
5286,5286999,21.80791959947077,38.740085104244365,0.0630209690742487,908.5789341926575,349.8393588066101,1123.8584022521973,40507,5302,35205,35205,0,11,5287000.0
5287,5287999,21.80795873860421,38.738725507770404,0.0630038429921762,908.7049052715302,349.9011173248291,1124.0252799987793,40508,5302,35206,35206,0,11,5288000.0
5288,5288999,21.806657809910725,38.73715015580731,0.06300774592981162,909.0163514614105,349.9650206565857,1124.5448379516602,40545,5304,35241,35241,0,11,5289000.0
5289,5289999,21.805183888314026,38.73494437165224,0.06301835707871783,909.3180768489838,350.02979278564453,1124.855167388916,40559,5306,35253,35253,0,11,5290000.0
5290,5290999,21.803702517941378,38.73245858683134,0.06303283861215792,909.4343674182892,350.092853307724,1125.0141410827637,40559,5306,35253,35253,0,11,5291000.0
5291,5291999,21.802485660261812,38.7304322400292,0.06303699808879815,909.5616981983185,350.1567018032074,1125.2925109863281,40566,5306,35260,35260,0,11,5292000.0
5292,5292999,21.801307964883275,38.72827462443264,0.06304161311046508,909.7691349983215,350.22152280807495,1125.6305389404297,40574,5307,35267,35267,0,11,5293000.0
5293,5293999,21.79999099483189,38.72638663316079,0.06304281880745133,909.984867811203,350.2845001220703,1125.8617782592773,40577,5308,35269,35269,0,11,5294000.0
5294,5294999,21.79923956342479,38.72470099776556,0.06304390675204974,910.1994214057922,350.34913992881775,1126.2172088623047,40592,5309,35283,35283,0,11,5295000.0
5295,5295999,21.798583656375733,38.722897479148166,0.06304107573713236,910.4058878421783,350.41190814971924,1126.2986907958984,40594,5310,35284,35284,0,11,5296000.0
5296,5296999,21.79779585301262,38.72089333745391,0.06304028503624193,910.6285827159882,350.4758687019348,1126.4346046447754,40604,5311,35293,35293,0,11,5297000.0
5297,5297999,21.797387482267485,38.719606482593896,0.06304222622627931,910.8509669303894,350.5408191680908,1127.092197418213,40628,5312,35316,35316,0,11,5298000.0
5298,5298999,21.796960167962613,38.71803936460298,0.06305096983590763,911.0604920387268,350.60397362709045,1127.4264183044434,40635,5313,35322,35322,0,11,5299000.0
5299,5299999,21.796334067049383,38.716286173159425,0.06305679828403488,911.1710848808289,350.66521549224854,1127.6881370544434,40636,5313,35323,35323,0,11,5300000.0
5300,5300999,21.796578907130712,38.716054253567414,0.06304112925488947,911.4901847839355,350.7321903705597,1128.2126426696777,40668,5315,35353,35353,0,11,5301000.0
5301,5301999,21.796434344048063,38.71494147381242,0.06303688501145299,911.6043581962585,350.795845746994,1128.4627838134766,40669,5315,35354,35354,0,11,5302000.0
5302,5302999,21.79661081790909,38.713929522521646,0.06301941028577207,911.9218246936798,350.862416267395,1128.86234664917,40692,5317,35375,35375,0,11,5303000.0
5303,5303999,21.796701962470706,38.7126213923118,0.06301434694463925,912.1312313079834,350.925035238266,1129.0161323547363,40701,5318,35383,35383,0,11,5304000.0
5304,5304999,21.796486786906204,38.71071150106312,0.06300917732129396,912.4303357601166,350.98883724212646,1129.3724060058594,40720,5320,35400,35400,0,11,5305000.0
5305,5305999,21.795046586283583,38.71014378409495,0.06301807969764572,912.6481521129608,351.0531849861145,1130.0320510864258,40753,5321,35432,35432,0,11,5306000.0
5306,5306999,21.793553431629487,38.70943396653879,0.06302886797530716,912.7721738815308,351.1166150569916,1130.4662742614746,40759,5321,35438,35438,0,11,5307000.0
5307,5307999,21.79192741491932,38.706843172128316,0.06304939772684559,912.8921756744385,351.18044233322144,1130.647144317627,40759,5321,35438,35438,0,11,5308000.0
5308,5308999,21.790546703634334,38.70525831942086,0.06306943551444633,913.2050187587738,351.2448363304138,1130.8588790893555,40772,5323,35449,35449,0,11,5309000.0
5309,5309999,21.788958732218088,38.70269039546132,0.06308855400109514,913.4110083580017,351.307733297348,1131.1068153381348,40777,5324,35453,35453,0,11,5310000.0
5310,5310999,21.78741325815576,38.700581835046926,0.0630992393223142,913.6139290332794,351.3704466819763,1131.2836151123047,40780,5325,35455,35455,0,11,5311000.0
5311,5311999,21.78614860725705,38.69901559933722,0.06309932531235107,913.8203020095825,351.4346776008606,1131.608585357666,40792,5326,35466,35466,0,11,5312000.0
5312,5312999,21.784758741866398,38.69701569050347,0.06310061244519793,914.0321881771088,351.4984064102173,1131.7955894470215,40795,5327,35468,35468,0,11,5313000.0
5313,5313999,21.78359411614454,38.6950885894233,0.06310182612096094,914.5288391113281,351.5624101161957,1131.8246955871582,40809,5331,35478,35478,0,11,5314000.0
5314,5314999,21.782746648335404,38.69375957948575,0.0630905927037192,914.6431403160095,351.6268265247345,1132.2862663269043,40819,5331,35488,35488,0,11,5315000.0
5315,5315999,21.782033123397714,38.69344545216521,0.06307732250261022,915.0412709712982,351.69001507759094,1132.4515495300293,40825,5334,35491,35491,0,11,5316000.0
5316,5316999,21.78128556019632,38.69286440849132,0.063070838029197,915.2634637355804,351.7530333995819,1132.670566558838,40831,5335,35496,35496,0,11,5317000.0
5317,5317999,21.780604971525086,38.691705480246775,0.06306323087767995,915.5726301670074,351.81718373298645,1133.120403289795,40859,5337,35522,35522,0,11,5318000.0
5318,5318999,21.77984579761895,38.69014070835093,0.06305389696478281,915.6777911186218,351.88019251823425,1133.4977531433105,40860,5337,35523,35523,0,11,5319000.0
5319,5319999,21.7791737944651,38.68854693341934,0.06304503104960102,916.0781207084656,351.9441511631012,1133.581874847412,40874,5340,35534,35534,0,11,5320000.0
5320,5320999,21.779039660794126,38.687818141473095,0.06302908600178658,916.2921934127808,352.0080542564392,1134.1336059570312,40898,5341,35557,35557,0,11,5321000.0
5321,5321999,21.778838583856086,38.686844046957184,0.06301578908827787,916.5012376308441,352.06873631477356,1134.3817558288574,40900,5342,35558,35558,0,11,5322000.0
5322,5322999,21.77826537218685,38.68502360578973,0.06300769673083861,916.6171503067017,352.1305980682373,1134.5946922302246,40900,5342,35558,35558,0,11,5323000.0
5323,5323999,21.777862620773103,38.68358347016007,0.06299624403002069,916.9186944961548,352.19258975982666,1134.966438293457,40920,5344,35576,35576,0,11,5324000.0
5324,5324999,21.77708160279401,38.68194035351658,0.06299354699747506,917.0408625602722,352.2551019191742,1135.3318557739258,40926,5344,35582,35582,0,11,5325000.0
5325,5325999,21.77551726297082,38.68100753533843,0.0629968229132929,917.2599289417267,352.32147097587585,1135.734218597412,40943,5345,35598,35598,0,11,5326000.0
5326,5326999,21.774018332045753,38.67920888199339,0.06300311583668039,917.5866515636444,352.386599779129,1136.019515991211,40950,5347,35603,35603,0,11,5327000.0
5327,5327999,21.772493655334483,38.67724592519485,0.06300871306746936,917.8985641002655,352.45087790489197,1136.1020240783691,40956,5349,35607,35607,0,11,5328000.0
5328,5328999,21.771137420491716,38.675375599998766,0.06301559828361869,918.1166343688965,352.51518392562866,1136.2540969848633,40959,5350,35609,35609,0,11,5329000.0
5329,5329999,21.769776926707753,38.67351610911875,0.06301949878137625,918.2349941730499,352.5771872997284,1136.5938606262207,40965,5350,35615,35615,0,11,5330000.0
5330,5330999,21.768396554629067,38.671070450833184,0.06302707086886294,918.639675617218,352.6402292251587,1136.715732574463,40971,5353,35618,35618,0,11,5331000.0
5331,5331999,21.767038724283168,38.669255190796235,0.06302968458619829,918.8556969165802,352.7030899524689,1136.8849411010742,40980,5354,35626,35626,0,11,5332000.0
5332,5332999,21.76588020251194,38.66706890155604,0.06302781337258456,919.0770533084869,352.7694854736328,1137.0956916809082,40991,5355,35636,35636,0,11,5333000.0
5333,5333999,21.764841950300596,38.66486103848084,0.06302816175933235,919.2901570796967,352.8326756954193,1137.2051849365234,40993,5356,35637,35637,0,11,5334000.0
5334,5334999,21.764034140265533,38.66317919023192,0.06302531417770174,919.4250693321228,352.895845413208,1137.3258666992188,40993,5356,35637,35637,0,11,5335000.0
5335,5335999,21.762996746312783,38.66127822675379,0.06302488586590138,919.6273899078369,352.9594135284424,1137.5934715270996,41006,5357,35649,35649,0,11,5336000.0
5336,5336999,21.762280562945666,38.65948481813537,0.06302096909347354,919.7443554401398,353.02114057540894,1137.7345809936523,41006,5357,35649,35649,0,11,5337000.0
5337,5337999,21.761221695099188,38.6573291738654,0.06302192091907732,920.0552699565887,353.084853887558,1137.8168334960938,41010,5359,35651,35651,0,11,5338000.0
5338,5338999,21.760614682949377,38.656185913846016,0.06301597565543016,920.1829352378845,353.14803075790405,1138.20219039917,41020,5359,35661,35661,0,11,5339000.0
5339,5339999,21.760192587046046,38.654641055799125,0.06300507785712595,920.4925575256348,353.2134487628937,1138.3313064575195,41031,5361,35670,35670,0,11,5340000.0
5340,5340999,21.75991645886514,38.65342941685383,0.0629983069222001,920.6072292327881,353.2787001132965,1138.5468101501465,41031,5361,35670,35670,0,11,5341000.0
5341,5341999,21.759847496608757,38.652181628026426,0.0629836847266596,920.8279027938843,353.34146785736084,1138.9858016967773,41054,5362,35692,35692,0,11,5342000.0
5342,5342999,21.760137336335095,38.65286008363222,0.06296833518379641,921.056985616684,353.40556287765503,1139.1665000915527,41062,5363,35699,35699,0,11,5343000.0
5343,5343999,21.759958036449262,38.65128712601517,0.06295931674820499,921.1690287590027,353.4699857234955,1139.2988891601562,41062,5363,35699,35699,0,11,5344000.0
5344,5344999,21.759201152868027,38.649094620444494,0.06295381472975081,921.4681656360626,353.5322723388672,1139.5741577148438,41080,5365,35715,35715,0,11,5345000.0
5345,5345999,21.758530570142923,38.647074445472434,0.06294872461988343,921.7851495742798,353.597873210907,1140.0225296020508,41113,5367,35746,35746,0,11,5346000.0
5346,5346999,21.756877252934057,38.6450671612705,0.06295456277247935,921.998946428299,353.6615376472473,1140.453815460205,41130,5368,35762,35762,0,11,5347000.0
5347,5347999,21.75494861847547,38.64204122749396,0.06296593934712968,922.2142157554626,353.7255845069885,1140.9362907409668,41138,5369,35769,35769,0,11,5348000.0
5348,5348999,21.753147385964542,38.639270840782615,0.06297919026795229,922.4224231243134,353.78753209114075,1141.0715255737305,41148,5370,35778,35778,0,11,5349000.0
5349,5349999,21.751617840528787,38.6372673592721,0.06298583457230589,922.5357780456543,353.8506851196289,1141.2447967529297,41148,5370,35778,35778,0,11,5350000.0
5350,5350999,21.7500881590548,38.63527701339781,0.06298934160287606,922.6552221775055,353.91593527793884,1141.6067123413086,41152,5370,35782,35782,0,11,5351000.0
5351,5351999,21.748830464771867,38.633050798064744,0.06299508701035395,922.9617884159088,353.97873616218567,1141.7918243408203,41156,5372,35784,35784,0,11,5352000.0
5352,5352999,21.747557864546213,38.63118297295358,0.0630027642159613,923.2766115665436,354.04315757751465,1142.0383911132812,41175,5374,35801,35801,0,11,5353000.0
5353,5353999,21.74794430014876,38.63374296932356,0.06299677316071173,923.4882683753967,354.1064558029175,1142.2261199951172,41177,5375,35802,35802,0,11,5354000.0
5354,5354999,21.74829683249801,38.63434981706143,0.06299713136108309,923.7961790561676,354.1699547767639,1142.3554420471191,41181,5377,35804,35804,0,11,5355000.0
5355,5355999,21.74904786455882,38.63554868577142,0.0629848027177925,923.920334815979,354.23452854156494,1142.8196563720703,41197,5377,35820,35820,0,11,5356000.0
5356,5356999,21.75049348645922,38.63746128792876,0.06297470744574618,924.2307453155518,354.29770278930664,1143.2157821655273,41227,5379,35848,35848,0,11,5357000.0
5357,5357999,21.751816369177455,38.63942606709661,0.06297643013998022,924.634952545166,354.3615183830261,1143.3915481567383,41261,5382,35879,35879,0,11,5358000.0
5358,5358999,21.753748410577096,38.64207875367266,0.06298411417549066,924.8456609249115,354.42517733573914,1143.8636207580566,41275,5383,35892,35892,0,11,5359000.0
5359,5359999,21.755965966084812,38.644762945308905,0.06299833845839298,925.1462242603302,354.48846459388733,1144.1595153808594,41288,5385,35903,35903,0,11,5360000.0
5360,5360999,21.757707960613736,38.646326705543565,0.06303456002881813,925.4521470069885,354.55264472961426,1144.2928428649902,41292,5387,35905,35905,0,11,5361000.0
5361,5361999,21.75949519592136,38.648513786812025,0.06303646592709167,925.6759440898895,354.61612606048584,1144.7271156311035,41305,5388,35917,35917,0,11,5362000.0
5362,5362999,21.7618924521299,38.65085238495792,0.06303695874422344,925.9014749526978,354.6817331314087,1144.8971061706543,41308,5389,35919,35919,0,11,5363000.0
5363,5363999,21.76342326059121,38.65183475770943,0.06304105692445439,926.11439037323,354.746155500412,1144.9740676879883,41317,5390,35927,35927,0,11,5364000.0
5364,5364999,21.764013307409105,38.651274034040966,0.06304416537470536,926.2309980392456,354.8084833621979,1145.384864807129,41325,5390,35935,35935,0,11,5365000.0
5365,5365999,21.76349372102381,38.649661608721104,0.06304152136259744,926.4408895969391,354.8727939128876,1145.8903770446777,41349,5391,35958,35958,0,11,5366000.0
5366,5366999,21.761898980211782,38.64753587418056,0.06304907406374427,926.7471766471863,354.936074256897,1146.0891723632812,41368,5393,35975,35975,0,11,5367000.0
5367,5367999,21.760415115545204,38.64519568239285,0.06305517053560783,926.9734361171722,355.002370595932,1146.359546661377,41397,5394,36003,36003,0,11,5368000.0
5368,5368999,21.75908037484507,38.6431240781929,0.0630651326995777,927.1016845703125,355.0674788951874,1146.4826126098633,41397,5394,36003,36003,0,11,5369000.0
5369,5369999,21.757793217184833,38.64136721285598,0.06306677116759207,927.3279211521149,355.1319348812103,1146.668529510498,41410,5395,36015,36015,0,11,5370000.0
5370,5370999,21.756693943365267,38.63917985172741,0.0630672651189429,927.6357204914093,355.1950857639313,1146.8752822875977,41424,5397,36027,36027,0,11,5371000.0
5371,5371999,21.755491497363597,38.63697222775526,0.06307031134667374,927.7479295730591,355.2579491138458,1147.0469665527344,41424,5397,36027,36027,0,11,5372000.0
5372,5372999,21.75424087872801,38.63480694312358,0.06307190620679459,927.8653144836426,355.3219473361969,1147.5455703735352,41437,5397,36040,36040,0,11,5373000.0
5373,5373999,21.752843217683058,38.632361483214275,0.06307688577303305,928.0761919021606,355.38503670692444,1147.7286682128906,41439,5398,36041,36041,0,11,5374000.0
5374,5374999,21.751792093719992,38.63095154598405,0.06307381241761345,928.29474568367,355.45221638679504,1147.9213485717773,41441,5399,36042,36042,0,11,5375000.0
5375,5375999,21.75056443850757,38.62878064506738,0.06307074298050386,928.705283164978,355.5178031921387,1148.275161743164,41462,5402,36060,36060,0,11,5376000.0
5376,5376999,21.74989786470846,38.62712881946112,0.0630573209735964,928.8198370933533,355.5811679363251,1148.6498794555664,41464,5402,36062,36062,0,11,5377000.0
5377,5377999,21.74924387125204,38.62579435474066,0.06304650031255277,929.2391097545624,355.6442174911499,1148.7520942687988,41483,5405,36078,36078,0,11,5378000.0
5378,5378999,21.748451444249344,38.62393511630686,0.06303649621714214,929.3578133583069,355.70846009254456,1149.2287521362305,41496,5405,36091,36091,0,11,5379000.0
5379,5379999,21.748125336165256,38.622241979953635,0.06301786944281784,929.6625754833221,355.77177119255066,1149.508502960205,41506,5407,36099,36099,0,11,5380000.0
5380,5380999,21.74786623774852,38.621113773264256,0.06300564002767839,929.8838956356049,355.8367531299591,1149.6702690124512,41515,5408,36107,36107,0,11,5381000.0
5381,5381999,21.747873565293368,38.62008778182483,0.06299113332095752,930.1964385509491,355.90252923965454,1150.1173820495605,41536,5410,36126,36126,0,11,5382000.0
5382,5382999,21.748066166028327,38.619104753049115,0.06297441650096214,930.4136078357697,355.9683005809784,1150.4059295654297,41547,5411,36136,36136,0,11,5383000.0
5383,5383999,21.748218961728515,38.617832115761445,0.06296491392910397,930.5221059322357,356.0304718017578,1150.6369438171387,41547,5411,36136,36136,0,11,5384000.0
5384,5384999,21.74855955206133,38.61684606022535,0.0629551730951271,930.7372026443481,356.0941801071167,1151.0485038757324,41559,5412,36147,36147,0,11,5385000.0
5385,5385999,21.748373105718123,38.615130618360645,0.06295301284886556,931.0576817989349,356.1602466106415,1151.4347686767578,41589,5414,36175,36175,0,11,5386000.0
5386,5386999,21.746870584161123,38.61346993631122,0.06296206509220714,931.2742631435394,356.2228002548218,1151.6866836547852,41600,5415,36185,36185,0,11,5387000.0
5387,5387999,21.745317548016523,38.61169584643859,0.06296458356474266,931.4050147533417,356.286607503891,1152.1760444641113,41610,5415,36195,36195,0,11,5388000.0
5388,5388999,21.744222931792894,38.61461356222386,0.06295299578804558,931.7131028175354,356.3506805896759,1152.2872352600098,41618,5417,36201,36201,0,11,5389000.0
5389,5389999,21.742682665997197,38.61222175213364,0.06295941001181793,931.9422879219055,356.4163250923157,1152.4359855651855,41626,5418,36208,36208,0,11,5390000.0
5390,5390999,21.74144633242251,38.610074081794615,0.06295821465206364,932.0589935779572,356.4804890155792,1152.7843856811523,41631,5418,36213,36213,0,11,5391000.0
5391,5391999,21.740287429810227,38.607800789355785,0.06295975632354822,932.2717401981354,356.5427086353302,1152.951343536377,41633,5419,36214,36214,0,11,5392000.0
5392,5392999,21.73931335253187,38.60609625589567,0.06295415560308515,932.5025541782379,356.60799503326416,1153.0091552734375,41641,5420,36221,36221,0,11,5393000.0
5393,5393999,21.7383539561088,38.60399957040656,0.06295607808987436,932.8174700737,356.6719572544098,1153.1577262878418,41651,5422,36229,36229,0,11,5394000.0
5394,5394999,21.73732887935713,38.60187391397524,0.06295675233198728,932.9478845596313,356.7353253364563,1153.3279418945312,41651,5422,36229,36229,0,11,5395000.0
5395,5395999,21.736816027992866,38.60056906279005,0.06295202237649611,933.1611588001251,356.79822754859924,1153.3862419128418,41653,5423,36230,36230,0,11,5396000.0
5396,5396999,21.73624645337139,38.59966674226938,0.06294815722739155,933.2774815559387,356.8614797592163,1153.6992835998535,41657,5423,36234,36234,0,11,5397000.0
5397,5397999,21.735841098964286,38.59845222143092,0.06294762285969868,933.4892117977142,356.92302107810974,1153.8166007995605,41659,5424,36235,36235,0,11,5398000.0
5398,5398999,21.73563070634909,38.597258249082294,0.0629466473154715,933.7110414505005,356.9880793094635,1153.9505996704102,41661,5425,36236,36236,0,11,5399000.0
5399,5399999,21.736219687659787,38.59774246590936,0.06293780155576645,933.9383940696716,357.052885055542,1154.3813018798828,41675,5426,36249,36249,0,11,5400000.0
5400,5400999,21.737256782707608,38.601516223498976,0.06293119650836465,934.2454257011414,357.11596727371216,1154.5472946166992,41681,5428,36253,36253,0,11,5401000.0
5401,5401999,21.739613233069466,38.61209738868587,0.06293008180667359,934.4586653709412,357.17877078056335,1154.68208694458,41688,5429,36259,36259,0,11,5402000.0
5402,5402999,21.74174116684091,38.61572544916041,0.06293895009646344,934.5857319831848,357.24476051330566,1155.1497688293457,41696,5429,36267,36267,0,11,5403000.0
5403,5403999,21.74395193846867,38.619793446834294,0.06297075747016712,934.8145005702972,357.3102412223816,1155.3042678833008,41698,5430,36268,36268,0,11,5404000.0
5404,5404999,21.74577763581006,38.62173775839316,0.06299854467725319,935.0359842777252,357.3739573955536,1155.4416885375977,41702,5431,36271,36271,0,11,5405000.0
5405,5405999,21.74749881397477,38.623704546950506,0.06301621855826467,935.2662990093231,357.4395444393158,1155.7733192443848,41717,5432,36285,36285,0,11,5406000.0
5406,5406999,21.74787435885804,38.624640213998454,0.06300396463054014,935.4805920124054,357.50280499458313,1156.2496223449707,41733,5433,36300,36300,0,11,5407000.0
5407,5407999,21.746103422882374,38.62837193489354,0.06299620158881081,935.6944315433502,357.5665981769562,1156.5843963623047,41743,5434,36309,36309,0,11,5408000.0
5408,5408999,21.74440321119245,38.626867200440856,0.06300029566873455,935.8138208389282,357.6304774284363,1156.841709136963,41744,5434,36310,36310,0,11,5409000.0
5409,5409999,21.74263779605653,38.62438437515435,0.06301138569942566,935.9364221096039,357.69433188438416,1156.936767578125,41744,5434,36310,36310,0,11,5410000.0
5410,5410999,21.74106072703867,38.622224224946336,0.06301732203757071,936.1677567958832,357.75823950767517,1157.0377655029297,41746,5435,36311,36311,0,11,5411000.0
5411,5411999,21.739654428088386,38.619996424172726,0.06302001268910729,936.284770488739,357.82081413269043,1157.4403991699219,41753,5435,36318,36318,0,11,5412000.0
5412,5412999,21.738019114013237,38.61731822101502,0.06302537229112903,936.5034689903259,357.8834493160248,1157.5995864868164,41755,5436,36319,36319,0,11,5413000.0
5413,5413999,21.736822131009113,38.615755451743375,0.06302298633601122,936.7210550308228,357.94666361808777,1157.8989372253418,41763,5437,36326,36326,0,11,5414000.0
5414,5414999,21.735729960473254,38.61404643787457,0.06302003007163404,936.9550037384033,358.0119025707245,1158.1110572814941,41768,5438,36330,36330,0,11,5415000.0
5415,5415999,21.73442245070688,38.61175144646151,0.06302142059465077,937.1787388324738,358.0777897834778,1158.246425628662,41770,5439,36331,36331,0,11,5416000.0
5416,5416999,21.73338936619584,38.60999937131224,0.06302061656879632,937.4056577682495,358.1423101425171,1158.3593559265137,41773,5440,36333,36333,0,11,5417000.0
5417,5417999,21.73258134442502,38.60801370084307,0.0630110972200445,937.5276050567627,358.2091181278229,1159.143123626709,41795,5440,36355,36355,0,11,5418000.0
5418,5418999,21.731782589268004,38.60618848275151,0.06300767944070007,937.7433619499207,358.27469205856323,1159.4248504638672,41801,5441,36360,36360,0,11,5419000.0
5419,5419999,21.731188549447836,38.60525746576514,0.06300172666547976,938.1384897232056,358.33850049972534,1159.5601997375488,41847,5444,36403,36403,0,11,5420000.0
5420,5420999,21.730944577499724,38.60390031647863,0.06299128811140686,938.4496212005615,358.4028217792511,1160.1117324829102,41871,5446,36425,36425,0,11,5421000.0
5421,5421999,21.73095861823915,38.6035050130553,0.06299614557622579,938.8528850078583,358.4687578678131,1160.2682991027832,41882,5449,36433,36433,0,11,5422000.0
5422,5422999,21.731016232599888,38.60267509199207,0.06299553484651366,938.9682142734528,358.5321867465973,1160.4673042297363,41883,5449,36434,36434,0,11,5423000.0
5423,5423999,21.731275947835407,38.60211748955147,0.06299780047529469,939.1824159622192,358.596070766449,1160.9054565429688,41896,5450,36446,36446,0,11,5424000.0
5424,5424999,21.731544412432918,38.60121678333901,0.06299617531976853,939.3985323905945,358.6586937904358,1161.0598831176758,41905,5451,36454,36454,0,11,5425000.0
5425,5425999,21.731940904216465,38.6006314547496,0.06301216413577515,939.6239001750946,358.7217936515808,1161.1252670288086,41907,5452,36455,36455,0,11,5426000.0
5426,5426999,21.731877853590806,38.599289484260254,0.06300393332087884,939.7445592880249,358.78671526908875,1161.3995094299316,41911,5452,36459,36459,0,11,5427000.0
5427,5427999,21.731088361420117,38.59740193620668,0.06300591031914515,940.1544651985168,358.8496928215027,1161.8264656066895,41939,5455,36484,36484,0,11,5428000.0
5428,5428999,21.729659745559843,38.59584019589877,0.06301492241432172,940.2802612781525,358.9131557941437,1162.2825469970703,41947,5455,36492,36492,0,11,5429000.0
5429,5429999,21.728114116623562,38.593790346863415,0.06302816057519522,940.7902119159698,358.9784502983093,1162.335247039795,41975,5459,36516,36516,0,11,5430000.0
5430,5430999,21.726514701666837,38.59160807334928,0.06304268247716072,941.2926270961761,359.0428969860077,1162.338363647461,42005,5463,36542,36542,0,11,5431000.0
5431,5431999,21.724991826039524,38.5892047961351,0.06305159807890648,941.4165177345276,359.1053304672241,1162.898265838623,42019,5463,36556,36556,0,11,5432000.0
5432,5432999,21.723532745413205,38.586591036922634,0.06306036382588842,941.6250522136688,359.1694061756134,1163.164005279541,42023,5464,36559,36559,0,11,5433000.0
5433,5433999,21.722344120899237,38.58518669158469,0.0630581687909273,941.8390176296234,359.2329969406128,1163.5055503845215,42033,5465,36568,36568,0,11,5434000.0
5434,5434999,21.72124259574408,38.583048131414245,0.06305688703308199,941.9742290973663,359.3105101585388,1163.826015472412,42035,5465,36570,36570,0,11,5435000.0
5435,5435999,21.720437407910346,38.58504676515554,0.06304427042246619,942.384229183197,359.37404203414917,1163.894775390625,42048,5468,36580,36580,0,11,5436000.0
5436,5436999,21.719540188571877,38.583023493293794,0.06304253362527479,942.599457025528,359.43778443336487,1164.360927581787,42070,5469,36601,36601,0,11,5437000.0
5437,5437999,21.718774402180497,38.58126177291845,0.06303511162322595,942.7120678424835,359.50093817710876,1164.9072799682617,42075,5469,36606,36606,0,11,5438000.0
5438,5438999,21.71763565822834,38.57893200284869,0.0630388795776633,942.9176380634308,359.56412959098816,1165.180046081543,42084,5470,36614,36614,0,11,5439000.0
5439,5439999,21.716850422914213,38.577023990890844,0.06303419372689623,943.1365983486176,359.6286709308624,1165.7951202392578,42105,5471,36634,36634,0,11,5440000.0
5440,5440999,21.716259000864625,38.57514239699171,0.06302687748982416,943.3407783508301,359.6915352344513,1166.189540863037,42116,5472,36644,36644,0,11,5441000.0
5441,5441999,21.71557361720322,38.573023776748194,0.06302418194419657,943.5594143867493,359.75831723213196,1166.585117340088,42129,5473,36656,36656,0,11,5442000.0
5442,5442999,21.715080483689157,38.57101745889452,0.06301221466520524,943.870542049408,359.8214569091797,1167.0056037902832,42148,5475,36673,36673,0,11,5443000.0
5443,5443999,21.714639960924725,38.56915017468796,0.0629962358519629,944.1818780899048,359.88517475128174,1167.1919136047363,42167,5477,36690,36690,0,11,5444000.0
5444,5444999,21.71413219903439,38.567799267304316,0.06298336479360334,944.6068754196167,359.9499845504761,1167.5674743652344,42202,5480,36722,36722,0,11,5445000.0
5445,5445999,21.712570190293313,38.56532240263033,0.062995222337765,944.9351735115051,360.0144922733307,1167.899227142334,42224,5482,36742,36742,0,11,5446000.0
5446,5446999,21.71110711336538,38.563409121440614,0.0630117785789529,945.1513314247131,360.07917618751526,1168.0713157653809,42234,5483,36751,36751,0,11,5447000.0
5447,5447999,21.70999647983766,38.56729705004152,0.06300406793068813,945.3734571933746,360.1427640914917,1168.200397491455,42242,5484,36758,36758,0,11,5448000.0
5448,5448999,21.70886766912761,38.56676310359533,0.06300670630911509,945.4892995357513,360.2057988643646,1168.5740013122559,42248,5484,36764,36764,0,11,5449000.0
5449,5449999,21.707281482994365,38.5640817249166,0.06301747053991558,945.8994047641754,360.2700068950653,1168.7047996520996,42264,5487,36777,36777,0,11,5450000.0
5450,5450999,21.705896165968284,38.56185908523184,0.06302113464773595,946.1154677867889,360.33383417129517,1168.8819732666016,42275,5488,36787,36787,0,11,5451000.0
5451,5451999,21.704798003876665,38.560186103998106,0.06302020471282344,946.2405967712402,360.39793968200684,1169.0581245422363,42276,5488,36788,36788,0,11,5452000.0
5452,5452999,21.703693182136163,38.55797561081966,0.06301779941805807,946.5565993785858,360.46290922164917,1169.0733757019043,42282,5490,36792,36792,0,11,5453000.0
5453,5453999,21.70267362041579,38.55610682421964,0.06301312608437137,946.7839620113373,360.5269968509674,1169.186824798584,42284,5491,36793,36793,0,11,5454000.0
5454,5454999,21.70207815669114,38.55477508311367,0.06300103888102448,947.002516746521,360.59054470062256,1169.6863822937012,42298,5492,36806,36806,0,11,5455000.0
5455,5455999,21.70146078105456,38.55323696654872,0.06299473040881198,947.3144483566284,360.65548515319824,1169.9517364501953,42306,5494,36812,36812,0,11,5456000.0
5456,5456999,21.700803150351835,38.551589351365635,0.06299341420858928,947.6374001502991,360.71984243392944,1170.0595359802246,42316,5496,36820,36820,0,11,5457000.0
5457,5457999,21.70057023676464,38.55043072672401,0.06297584183909244,947.9534010887146,360.78374314308167,1170.5612716674805,42338,5498,36840,36840,0,11,5458000.0
5458,5458999,21.700913409635678,38.551692472588876,0.0629426863970658,948.2681324481964,360.84745931625366,1170.741024017334,42348,5500,36848,36848,0,11,5459000.0
5459,5459999,21.70111921832264,38.55241250533898,0.0629217830114519,948.4900531768799,360.91460847854614,1170.8546409606934,42356,5501,36855,36855,0,11,5460000.0
5460,5460999,21.701608114811624,38.55239046090834,0.06289868592065617,948.6199514865875,360.9795014858246,1171.3462181091309,42367,5501,36866,36866,0,11,5461000.0
5461,5461999,21.702063004751363,38.55199736210598,0.06287974394340268,948.7377455234528,361.04231810569763,1171.497974395752,42367,5501,36866,36866,0,11,5462000.0
5462,5462999,21.701985640884484,38.55093758128422,0.06286478044860022,949.035973072052,361.10318636894226,1171.5553894042969,42385,5503,36882,36882,0,11,5463000.0
5463,5463999,21.701966147061,38.54976941094658,0.062854515167173,949.2526564598083,361.16515946388245,1171.8304176330566,42397,5504,36893,36893,0,11,5464000.0
5464,5464999,21.701480659373793,38.55117665981329,0.06283970895743318,949.4783644676208,361.22702383995056,1172.3704872131348,42420,5505,36915,36915,0,11,5465000.0
5465,5465999,21.69972460453923,38.54894927980054,0.06284540112903336,949.6912071704865,361.29134368896484,1172.9319038391113,42441,5506,36935,36935,0,11,5466000.0
5466,5466999,21.698158504379652,38.54683635903158,0.06284825316710563,949.8051524162292,361.35505533218384,1173.3003311157227,42450,5506,36944,36944,0,11,5467000.0
5467,5467999,21.696741752684346,38.54539813749377,0.06285324004923643,949.9195420742035,361.4174768924713,1173.5574226379395,42456,5506,36950,36950,0,11,5468000.0
5468,5468999,21.695181102312276,38.54279119123823,0.06286163348273666,950.0583710670471,361.484876871109,1173.9389724731445,42470,5506,36964,36964,0,11,5469000.0
5469,5469999,21.69399114216768,38.540778733064904,0.06285985096362023,950.3732433319092,361.54806184768677,1174.2827987670898,42519,5508,37011,37011,0,11,5470000.0
5470,5470999,21.692740216257228,38.53879577409282,0.06286254722724127,950.776903629303,361.6118609905243,1174.3820762634277,42527,5511,37016,37016,0,11,5471000.0
5471,5471999,21.691571362709883,38.536658567599595,0.0628604393532135,950.9069681167603,361.6748218536377,1174.7283668518066,42534,5511,37023,37023,0,11,5472000.0
5472,5472999,21.690623305220743,38.53467783686652,0.06285702166225815,951.0234060287476,361.7372658252716,1175.0096130371094,42537,5511,37026,37026,0,11,5473000.0
5473,5473999,21.689802871234484,38.53301348289743,0.06285410182526496,951.2598853111267,361.80350518226624,1175.1608276367188,42540,5512,37028,37028,0,11,5474000.0
5474,5474999,21.688757392680238,38.530790488288645,0.062850661997913,951.3680765628815,361.86604022979736,1175.3019752502441,42540,5512,37028,37028,0,11,5475000.0
5475,5475999,21.688115836872317,38.52906642806806,0.0628445225881501,951.6945078372955,361.9422798156738,1175.7271766662598,42553,5514,37039,37039,0,11,5476000.0
5476,5476999,21.68699848497318,38.527044208007354,0.06284722590721914,951.9156610965729,362.0082552433014,1175.957576751709,42555,5515,37040,37040,0,11,5477000.0
5477,5477999,21.68610645029562,38.52607196599941,0.06284480558713101,952.1371469497681,362.0709137916565,1176.0906410217285,42557,5516,37041,37041,0,11,5478000.0
5478,5478999,21.685612627575388,38.52441637243319,0.06283146184467892,952.3533720970154,362.13578152656555,1176.6590576171875,42576,5517,37059,37059,0,11,5479000.0
5479,5479999,21.68503947692774,38.522878979036655,0.06282032817643934,952.4672396183014,362.19921231269836,1176.9215087890625,42577,5517,37060,37060,0,11,5480000.0
5480,5480999,21.6847718257244,38.521413034281224,0.06280210233045813,952.5785171985626,362.2611982822418,1177.0828094482422,42577,5517,37060,37060,0,11,5481000.0
5481,5481999,21.684856342770217,38.52002675168378,0.06277038704484605,952.7007179260254,362.32456398010254,1177.709831237793,42593,5517,37076,37076,0,11,5482000.0
5482,5482999,21.684710822430244,38.518804723361235,0.06274316887946674,953.0053105354309,362.3867461681366,1177.8702926635742,42611,5519,37092,37092,0,11,5483000.0
5483,5483999,21.684285332991955,38.517016286339015,0.06272156716528487,953.3130550384521,362.4491798877716,1178.0204391479492,42630,5521,37109,37109,0,11,5484000.0
5484,5484999,21.683840472558007,38.514992873025754,0.06270105283208705,953.7377789020538,362.51258397102356,1178.4337158203125,42659,5524,37135,37135,0,11,5485000.0
5485,5485999,21.68318347726739,38.51344321735481,0.0626952234888778,953.9618599414825,362.57596039772034,1179.0650215148926,42688,5525,37163,37163,0,11,5486000.0
5486,5486999,21.681311286459206,38.51066683244621,0.06270990518395225,954.0773437023163,362.6391818523407,1179.5135459899902,42700,5525,37175,37175,0,11,5487000.0
5487,5487999,21.680074946598243,38.51102468431462,0.06270832614742994,954.1934604644775,362.70265078544617,1179.7561492919922,42701,5525,37176,37176,0,11,5488000.0
5488,5488999,21.67859661040475,38.50867458984169,0.06271764203830532,954.5101373195648,362.7665150165558,1179.8708534240723,42713,5527,37186,37186,0,11,5489000.0
5489,5489999,21.6774695478402,38.50693936815812,0.06272075452911174,954.6368191242218,362.8336982727051,1180.1833839416504,42721,5527,37194,37194,0,11,5490000.0
5490,5490999,21.676754841782913,38.50599281864216,0.06271747628220459,954.9542121887207,362.8989562988281,1180.484359741211,42729,5529,37200,37200,0,11,5491000.0
5491,5491999,21.67558654836444,38.50381717524581,0.06272140308268381,955.1715941429138,362.9634048938751,1180.7302894592285,42732,5530,37202,37202,0,11,5492000.0
5492,5492999,21.674832136729723,38.50244093210034,0.06271878989786484,955.3950483798981,363.02718472480774,1180.9361457824707,42739,5531,37208,37208,0,11,5493000.0
5493,5493999,21.674071207961532,38.500603087428026,0.06272195083053445,955.8259196281433,363.0909345149994,1180.937801361084,42765,5534,37231,37231,0,11,5494000.0
5494,5494999,21.673530395600523,38.49891079408029,0.06272468055312552,956.0345058441162,363.1535267829895,1181.0572662353516,42773,5535,37238,37238,0,11,5495000.0
5495,5495999,21.67307510542473,38.4975996136806,0.06272124363352094,956.3496098518372,363.2181808948517,1181.4825973510742,42793,5537,37256,37256,0,11,5496000.0
5496,5496999,21.67276655998114,38.49660201281888,0.06272168693024571,956.4665863513947,363.2839574813843,1181.9697036743164,42798,5537,37261,37261,0,11,5497000.0
5497,5497999,21.67219872468765,38.495299331175104,0.06272154749023273,956.6797125339508,363.3469989299774,1182.2029151916504,42800,5538,37262,37262,0,11,5498000.0
5498,5498999,21.671905267250438,38.494169950463885,0.06271113063400036,956.8949022293091,363.41131830215454,1182.6103439331055,42820,5539,37281,37281,0,11,5499000.0
5499,5499999,21.671985868491205,38.49621535955243,0.06269105761124072,957.0127246379852,363.47394824028015,1182.9909553527832,42823,5539,37284,37284,0,11,5500000.0
5500,5500999,21.671908241375878,38.50246045107083,0.06266699028578449,957.1285936832428,363.53903317451477,1183.164665222168,42823,5539,37284,37284,0,11,5501000.0
5501,5501999,21.671636643981255,38.5013205141813,0.06265659823144432,957.4410600662231,363.6023428440094,1183.6999168395996,42846,5541,37305,37305,0,11,5502000.0
5502,5502999,21.671508547200446,38.49998643857894,0.06264480953494989,957.6521437168121,363.66617584228516,1183.9634399414062,42855,5542,37313,37313,0,11,5503000.0
5503,5503999,21.67080561831298,38.49811950665682,0.06264147959438593,957.7599594593048,363.7276430130005,1184.1362113952637,42855,5542,37313,37313,0,11,5504000.0
5504,5504999,21.670158641614126,38.496047898706564,0.06263653492795906,958.1724412441254,363.7903940677643,1184.4087142944336,42869,5545,37324,37324,0,11,5505000.0
5505,5505999,21.669177402224108,38.49391274613383,0.0626420190271113,958.3904452323914,363.85272908210754,1184.8231163024902,42880,5546,37334,37334,0,11,5506000.0
5506,5506999,21.66746150720823,38.49176629948322,0.06264926283214256,958.5118360519409,363.9152419567108,1185.1089324951172,42883,5546,37337,37337,0,11,5507000.0
5507,5507999,21.665893240410952,38.48992330198171,0.06265420054577853,958.6341128349304,363.97914600372314,1185.3822593688965,42887,5546,37341,37341,0,11,5508000.0
5508,5508999,21.66447305683073,38.48778869285353,0.06266290463807078,958.8619377613068,364.0428328514099,1185.4801025390625,42890,5547,37343,37343,0,11,5509000.0
5509,5509999,21.663067176539702,38.48556161366474,0.06267126833135228,958.9774105548859,364.10592913627625,1185.6099967956543,42890,5547,37343,37343,0,11,5510000.0
5510,5510999,21.66158727864258,38.482950224945654,0.06267612762779362,959.1887450218201,364.1704547405243,1186.0946235656738,42911,5548,37363,37363,0,11,5511000.0
5511,5511999,21.66003445395351,38.480302182928966,0.06268475709895904,959.602632522583,364.2336106300354,1186.1974296569824,42951,5551,37400,37400,0,11,5512000.0
5512,5512999,21.658598758617085,38.47811874637181,0.06269088499007824,959.8223893642426,364.29684805870056,1186.504508972168,42960,5552,37408,37408,0,11,5513000.0
5513,5513999,21.657161824480752,38.47558808563278,0.06269453462972707,960.0339376926422,364.3594343662262,1186.723346710205,42962,5553,37409,37409,0,11,5514000.0
5514,5514999,21.655907258728206,38.4730542514648,0.06269866608285146,960.5506978034973,364.423419713974,1186.7635688781738,42974,5557,37417,37417,0,11,5515000.0
5515,5515999,21.655446225215062,38.48705251103574,0.06265237563106263,960.7741148471832,364.4873628616333,1186.8840103149414,42976,5558,37418,37418,0,11,5516000.0
5516,5516999,21.654449567974474,38.484833986513586,0.06265090805645523,960.8934593200684,364.55484986305237,1187.438648223877,42990,5558,37432,37432,0,11,5517000.0
5517,5517999,21.65343128042432,38.482685813719264,0.06265546019016688,961.0052690505981,364.6176915168762,1187.675579071045,42990,5558,37432,37432,0,11,5518000.0
5518,5518999,21.652236555505244,38.48046523977475,0.06265757159801688,961.2352809906006,364.68346333503723,1187.796371459961,42992,5559,37433,37433,0,11,5519000.0
5519,5519999,21.651692159962252,38.480171163149855,0.0626477424022781,961.3587627410889,364.74720454216003,1188.3916320800781,43010,5559,37451,37451,0,11,5520000.0
5520,5520999,21.651296254117202,38.47891329833343,0.06264363544432539,961.480637550354,364.80990076065063,1188.6623992919922,43010,5559,37451,37451,0,11,5521000.0
5521,5521999,21.650987939822965,38.477859738048785,0.06264001195811586,961.7896642684937,364.87272453308105,1188.7317962646484,43014,5561,37453,37453,0,11,5522000.0
5522,5522999,21.65092556474427,38.476428762883565,0.06262708119022409,962.0203051567078,364.9361662864685,1189.1168251037598,43034,5562,37472,37472,0,11,5523000.0
5523,5523999,21.650885322992224,38.47515661587528,0.06261627503243583,962.1464886665344,364.9983820915222,1189.31245803833,43034,5562,37472,37472,0,11,5524000.0
5524,5524999,21.65069151759359,38.47359561869394,0.06260870715535005,962.2542359828949,365.0602333545685,1189.50630569458,43038,5562,37476,37476,0,11,5525000.0
5525,5525999,21.650196056120084,38.47159918978416,0.06260130613251924,962.466019153595,365.1221675872803,1189.7186889648438,43050,5563,37487,37487,0,11,5526000.0
5526,5526999,21.64927049495777,38.4697183505937,0.06260179734477411,962.6766748428345,365.1847059726715,1190.1533012390137,43064,5564,37500,37500,0,11,5527000.0
5527,5527999,21.647672189896525,38.467484136095266,0.06260636246030382,962.9010803699493,365.2481732368469,1190.5165176391602,43073,5565,37508,37508,0,11,5528000.0
5528,5528999,21.646237168238343,38.4655098897047,0.0626148124876712,963.225744009018,365.3122696876526,1190.683219909668,43088,5567,37521,37521,0,11,5529000.0
5529,5529999,21.644992912167208,38.46341798338958,0.06262281603766151,963.4594645500183,365.3762893676758,1190.772850036621,43097,5568,37529,37529,0,11,5530000.0
5530,5530999,21.643919369762077,38.46313052451219,0.06262150098080543,963.6762545108795,365.4394166469574,1190.8957443237305,43101,5569,37532,37532,0,11,5531000.0
5531,5531999,21.642694474638542,38.461067404868096,0.06262179013787228,963.7929949760437,365.50222086906433,1191.3254089355469,43108,5569,37539,37539,0,11,5532000.0
5532,5532999,21.641548945092982,38.4588284867675,0.06262148217755348,964.1020658016205,365.56437516212463,1191.4318313598633,43119,5571,37548,37548,0,11,5533000.0
5533,5533999,21.640610410629897,38.45706199776528,0.06261460791804285,964.3250348567963,365.62733578681946,1191.8102836608887,43132,5572,37560,37560,0,11,5534000.0
5534,5534999,21.639486244909246,38.45480573611233,0.06261507542738043,964.5401909351349,365.6909761428833,1192.0517578125,43138,5573,37565,37565,0,11,5535000.0
5535,5535999,21.63873859432721,38.4529909296078,0.0626124550044701,964.8670837879181,365.7541754245758,1192.218360900879,43149,5575,37574,37574,0,11,5536000.0
5536,5536999,21.638126782600796,38.451326644926134,0.0626076454655512,965.0813159942627,365.81643438339233,1192.3606452941895,43151,5576,37575,37575,0,11,5537000.0
5537,5537999,21.63753761845167,38.44957560183831,0.06259722304633386,965.2014336585999,365.87835812568665,1192.79927444458,43158,5576,37582,37582,0,11,5538000.0
5538,5538999,21.63693758649654,38.44807923464925,0.0625914917497209,965.5273585319519,365.9404571056366,1192.9331817626953,43162,5578,37584,37584,0,11,5539000.0
5539,5539999,21.63614483748611,38.44659588500213,0.06258954041023701,965.7511119842529,366.00336813926697,1193.10054397583,43167,5579,37588,37588,0,11,5540000.0
5540,5540999,21.635946145851364,38.44576713404388,0.06257437845495928,965.8678147792816,366.0673174858093,1193.6595344543457,43180,5579,37601,37601,0,11,5541000.0
5541,5541999,21.635479764159147,38.44432351182031,0.06256628552503252,966.0799462795258,366.1291868686676,1193.809310913086,43182,5580,37602,37602,0,11,5542000.0
5542,5542999,21.635147116635082,38.44281809674343,0.0625605288135882,966.2934048175812,366.19190549850464,1193.9546585083008,43186,5581,37605,37605,0,11,5543000.0
5543,5543999,21.635300487202276,38.441708028366634,0.06254980519766729,966.4207632541656,366.2545790672302,1194.4297637939453,43197,5581,37616,37616,0,11,5544000.0
5544,5544999,21.6351053987498,38.44041426870576,0.06254150415802628,966.7413201332092,366.31762957572937,1194.5073928833008,43215,5583,37632,37632,0,11,5545000.0
5545,5545999,21.634763817262503,38.43885589087377,0.06253332567752978,966.9544634819031,366.3796398639679,1194.6294021606445,43220,5584,37636,37636,0,11,5546000.0
5546,5546999,21.634164828089933,38.43710006303678,0.06252620419949317,967.0762212276459,366.44056034088135,1194.8719100952148,43223,5584,37639,37639,0,11,5547000.0
5547,5547999,21.633059408324456,38.435020082335875,0.0625285601514809,967.1918795108795,366.50217747688293,1195.217601776123,43233,5584,37649,37649,0,11,5548000.0
5548,5548999,21.631431717649033,38.43377026862944,0.06253227945671092,967.308046579361,366.5651488304138,1195.5192070007324,43238,5584,37654,37654,0,11,5549000.0
5549,5549999,21.629855309113395,38.43144651114843,0.06253802516771745,967.4278471469879,366.62758564949036,1195.7005805969238,43238,5584,37654,37654,0,11,5550000.0
5550,5550999,21.62836749454183,38.42904995573412,0.06254560911953322,967.5531332492828,366.69039726257324,1195.809196472168,43238,5584,37654,37654,0,11,5551000.0
5551,5551999,21.62696093000641,38.4269185073606,0.06254795719481465,967.7723231315613,366.7533576488495,1195.9050369262695,43242,5585,37657,37657,0,11,5552000.0
5552,5552999,21.625625534599344,38.42455174038685,0.06254980441920344,967.9783766269684,366.8158929347992,1196.3042945861816,43252,5586,37666,37666,0,11,5553000.0
5553,5553999,21.62444165838197,38.42240003927301,0.06254987343436069,968.1922986507416,366.8779182434082,1196.5097885131836,43254,5587,37667,37667,0,11,5554000.0
5554,5554999,21.623279998054873,38.42039451382215,0.06255090319743606,968.4059426784515,366.9403245449066,1196.6907501220703,43259,5588,37671,37671,0,11,5555000.0
5555,5555999,21.622217390389945,38.41826691874404,0.06254875322559739,968.6303613185883,367.0036585330963,1196.8015022277832,43262,5589,37673,37673,0,11,5556000.0
5556,5556999,21.621502121486984,38.416582725886954,0.06254576251492239,968.7532572746277,367.06577801704407,1196.9029998779297,43262,5589,37673,37673,0,11,5557000.0
5557,5557999,21.62094918401759,38.41522659176467,0.06254664468440363,968.9750950336456,367.1279242038727,1196.9587745666504,43264,5590,37674,37674,0,11,5558000.0
5558,5558999,21.62128804167295,38.4154389601718,0.06253188629592865,969.2004430294037,367.1938931941986,1197.7218055725098,43292,5591,37701,37701,0,11,5559000.0
5559,5559999,21.621338343333306,38.41431469655105,0.0625267303641287,969.3157534599304,367.2562520503998,1198.0266075134277,43293,5591,37702,37702,0,11,5560000.0
5560,5560999,21.62120162372307,38.41330988054421,0.0625220146875689,969.5254192352295,367.31822180747986,1198.232276916504,43322,5592,37730,37730,0,11,5561000.0
5561,5561999,21.621710929319992,38.41353072369801,0.06250270233517385,969.6472265720367,367.3812732696533,1198.8744430541992,43341,5592,37749,37749,0,11,5562000.0
5562,5562999,21.62239706384346,38.4138459368575,0.06250686427193841,969.7563602924347,367.44335436820984,1199.097339630127,43341,5592,37749,37749,0,11,5563000.0
5563,5563999,21.62272164194054,38.413289063882374,0.06250850341076686,969.9781258106232,367.50639033317566,1199.1905937194824,43350,5593,37757,37757,0,11,5564000.0
5564,5564999,21.62354197229421,38.41323252359047,0.06251178522554612,970.0976283550262,367.5684378147125,1199.6719589233398,43359,5593,37766,37766,0,11,5565000.0
5565,5565999,21.624137527100675,38.412710440415346,0.06250480069152042,970.2097916603088,367.6297113895416,1199.794979095459,43359,5593,37766,37766,0,11,5566000.0
5566,5566999,21.62450659324484,38.41192483306885,0.06250246257767023,970.5275597572327,367.69156861305237,1199.8736724853516,43371,5595,37776,37776,0,11,5567000.0
5567,5567999,21.624594538662038,38.410733545736484,0.06249678984028895,970.6437132358551,367.7530164718628,1200.0759544372559,43373,5595,37778,37778,0,11,5568000.0
5568,5568999,21.623744401973067,38.409014817088774,0.06249348835651902,970.8623597621918,367.81576204299927,1200.6701545715332,43410,5596,37814,37814,0,11,5569000.0
5569,5569999,21.622466727542008,38.407381343263815,0.062495591222657354,971.0886623859406,367.8821437358856,1201.0680885314941,43419,5597,37822,37822,0,11,5570000.0
5570,5570999,21.621001502460444,38.405228764488946,0.06250553481254617,971.2164497375488,367.94619965553284,1201.2964172363281,43422,5597,37825,37825,0,11,5571000.0
5571,5571999,21.620016554498903,38.40363666474184,0.06251125449034745,971.4393150806427,368.0094881057739,1201.4248962402344,43429,5598,37831,37831,0,11,5572000.0
5572,5572999,21.61912153303748,38.40184821746291,0.06251310572562152,971.5631399154663,368.0728950500488,1202.09956741333,43446,5598,37848,37848,0,11,5573000.0
5573,5573999,21.618198158314506,38.40015038861772,0.06251179466991197,971.6732366085052,368.1355731487274,1202.3762702941895,43447,5598,37849,37849,0,11,5574000.0
5574,5574999,21.617088945566298,38.398081897069936,0.06251954610942956,971.8868849277496,368.1988115310669,1202.7675895690918,43459,5599,37860,37860,0,11,5575000.0
5575,5575999,21.616149756858388,38.39617164028177,0.06251670441981727,972.1957721710205,368.2608766555786,1202.8887825012207,43470,5601,37869,37869,0,11,5576000.0
5576,5576999,21.615109901091397,38.39405927948974,0.06251796084632655,972.3108456134796,368.32385420799255,1203.1519088745117,43471,5601,37870,37870,0,11,5577000.0
5577,5577999,21.61418602056878,38.39226243484289,0.0625130451085365,972.5402927398682,368.3879780769348,1203.8144569396973,43498,5602,37896,37896,0,11,5578000.0
5578,5578999,21.613707307058533,38.392809092396334,0.06249778771669845,972.7553880214691,368.4514946937561,1204.2734451293945,43504,5603,37901,37901,0,11,5579000.0
5579,5579999,21.612638530305627,38.39055942251944,0.06249702810426838,972.8794057369232,368.5175635814667,1204.6028327941895,43505,5603,37902,37902,0,11,5580000.0
5580,5580999,21.612005459845,38.388997023226615,0.06248704511572967,972.9942252635956,368.5810241699219,1205.3233337402344,43525,5603,37922,37922,0,11,5581000.0
5581,5581999,21.611431573276676,38.387033961929205,0.0624834717503876,973.2077646255493,368.64449548721313,1205.6542892456055,43530,5604,37926,37926,0,11,5582000.0
5582,5582999,21.61123121144255,38.38602894216454,0.062477065367044005,973.335170507431,368.70860981941223,1206.2851066589355,43549,5604,37945,37945,0,11,5583000.0
5583,5583999,21.61054886226105,38.383944670050774,0.06247782498754684,973.4491631984711,368.7723391056061,1206.683879852295,43553,5604,37949,37949,0,11,5584000.0
5584,5584999,21.609806507200688,38.38184418461172,0.062477062341724454,973.5790150165558,368.84602975845337,1207.0543975830078,43559,5604,37955,37955,0,11,5585000.0
5585,5585999,21.608916035436827,38.38043617654898,0.06248006143472329,973.9021952152252,368.9089949131012,1207.4707412719727,43585,5606,37979,37979,0,11,5586000.0
5586,5586999,21.607775261199798,38.379435429033805,0.06248162180787864,974.0228521823883,368.9740340709686,1207.895351409912,43594,5606,37988,37988,0,11,5587000.0
5587,5587999,21.606585294307354,38.37744024621628,0.06249678949259363,974.1431941986084,369.0368721485138,1208.0723838806152,43594,5606,37988,37988,0,11,5588000.0
5588,5588999,21.60533340561013,38.37530908548445,0.06251082245564266,974.2665259838104,369.09967160224915,1208.2014808654785,43594,5606,37988,37988,0,11,5589000.0
5589,5589999,21.6042718353091,38.37365683398671,0.06251903191482888,974.3772461414337,369.16204857826233,1208.711254119873,43604,5606,37998,37998,0,11,5590000.0
5590,5590999,21.603090151176758,38.37194308805125,0.06252095517529721,974.604930639267,369.2250883579254,1208.8684158325195,43607,5607,38000,38000,0,11,5591000.0
5591,5591999,21.60205414934902,38.36989114468293,0.06252478963171826,974.7225866317749,369.2874205112457,1209.1922225952148,43614,5607,38007,38007,0,11,5592000.0
5592,5592999,21.60102497084754,38.367837029632604,0.06252666513090321,974.9486832618713,369.35036420822144,1209.3503074645996,43617,5608,38009,38009,0,11,5593000.0
5593,5593999,21.60001078014629,38.36582727320867,0.06252953289749907,975.1635987758636,369.41318678855896,1209.4777870178223,43623,5609,38014,38014,0,11,5594000.0
5594,5594999,21.599410780066837,38.3648983875278,0.06252117131388546,975.4125847816467,369.48613381385803,1209.8510475158691,43633,5610,38023,38023,0,11,5595000.0
5595,5595999,21.598892133060605,38.36316795803623,0.06251260481304188,975.6274433135986,369.54920744895935,1210.0945053100586,43636,5611,38025,38025,0,11,5596000.0
5596,5596999,21.59833721809254,38.361823716280234,0.06250670435203043,975.757129907608,369.6155285835266,1210.2673072814941,43636,5611,38025,38025,0,11,5597000.0
5597,5597999,21.597956043145704,38.36082532828317,0.06249568244132542,975.9835555553436,369.6775143146515,1210.3417205810547,43642,5612,38030,38030,0,11,5598000.0
5598,5598999,21.597765084536316,38.35948475287091,0.06248419611527667,976.0912237167358,369.7407524585724,1210.8513259887695,43653,5612,38041,38041,0,11,5599000.0
5599,5599999,21.597356960752222,38.35827512153643,0.06247482659541248,976.305261850357,369.80280900001526,1211.0088157653809,43656,5613,38043,38043,0,11,5600000.0
5600,5600999,21.59705395720465,38.3569167674075,0.062467289114116475,976.5285465717316,369.8651885986328,1211.3210372924805,43692,5614,38078,38078,0,11,5601000.0
5601,5601999,21.59717286226554,38.357336512606004,0.062454167288779616,976.7481956481934,369.9270975589752,1211.4844017028809,43696,5615,38081,38081,0,11,5602000.0
5602,5602999,21.596846576273432,38.35582749453372,0.06244348274275069,976.965612411499,369.9913663864136,1211.5884284973145,43706,5616,38090,38090,0,11,5603000.0
5603,5603999,21.59648002922616,38.35433064838119,0.06243473105877706,977.1807899475098,370.05339074134827,1211.837070465088,43713,5617,38096,38096,0,11,5604000.0
5604,5604999,21.59616084107297,38.353030179415875,0.06242485124679564,977.4097828865051,370.11570954322815,1212.0327987670898,43716,5618,38098,38098,0,11,5605000.0
5605,5605999,21.594882489240657,38.3524552496692,0.062432216021040654,977.622816324234,370.17718029022217,1212.5094566345215,43747,5619,38128,38128,0,11,5606000.0
5606,5606999,21.593324824118984,38.35073214036122,0.062435288173447345,977.8419055938721,370.2399888038635,1212.7553367614746,43752,5620,38132,38132,0,11,5607000.0
5607,5607999,21.592046508478816,38.34905709023026,0.06244394453297353,977.9657797813416,370.30453085899353,1212.8761024475098,43752,5620,38132,38132,0,11,5608000.0
5608,5608999,21.590850736740617,38.347097340391244,0.062451286663895544,978.197277545929,370.3676173686981,1212.9812812805176,43762,5621,38141,38141,0,11,5609000.0
5609,5609999,21.589867540243212,38.34535399806705,0.06245313175292733,978.4236333370209,370.43298721313477,1213.322208404541,43778,5622,38156,38156,0,11,5610000.0
5610,5610999,21.58902588611857,38.34377880844651,0.06245581358796615,978.652868270874,370.4980330467224,1213.5651969909668,43781,5623,38158,38158,0,11,5611000.0
5611,5611999,21.588275319884218,38.34218101334447,0.06245349216644491,978.8970651626587,370.56831336021423,1213.6943092346191,43783,5624,38159,38159,0,11,5612000.0
5612,5612999,21.587659370448495,38.3409216479503,0.06245101044793988,979.2136871814728,370.6312026977539,1214.0415306091309,43801,5626,38175,38175,0,11,5613000.0
5613,5613999,21.58733099394098,38.34012389114333,0.06244230113004423,979.3463613986969,370.70158338546753,1214.2107772827148,43801,5626,38175,38175,0,11,5614000.0
5614,5614999,21.58715848106632,38.33920555423746,0.06243815364922278,979.6590371131897,370.76399660110474,1214.2793197631836,43812,5628,38184,38184,0,11,5615000.0
5615,5615999,21.58679834380242,38.3379111780059,0.06243760425644074,979.882401227951,370.8269770145416,1214.5680465698242,43820,5629,38191,38191,0,11,5616000.0
5616,5616999,21.58653152701339,38.33751893660527,0.062435071301041534,980.2038938999176,370.88923716545105,1214.7593727111816,43839,5631,38208,38208,0,11,5617000.0
5617,5617999,21.58647404900082,38.33889547370534,0.062423707178345667,980.4403622150421,370.9542820453644,1214.810417175293,43848,5632,38216,38216,0,11,5618000.0
5618,5618999,21.58684115375899,38.33989363026681,0.062419495986430484,980.5646517276764,371.01666140556335,1214.980972290039,43851,5632,38219,38219,0,11,5619000.0
5619,5619999,21.587238584061584,38.33962676750092,0.0624105100391843,980.8937149047852,371.0827867984772,1215.3835144042969,43876,5634,38242,38242,0,11,5620000.0
5620,5620999,21.587680008172377,38.339018251560084,0.062413137440643474,981.1100189685822,371.1447467803955,1215.562973022461,43879,5635,38244,38244,0,11,5621000.0
5621,5621999,21.58844558190301,38.33901380502763,0.06241370998659623,981.4390227794647,371.20770382881165,1215.9205360412598,43902,5637,38265,38265,0,11,5622000.0
5622,5622999,21.589253356153378,38.33902933000731,0.06240977058400654,981.6559400558472,371.26983094215393,1216.1448249816895,43913,5638,38275,38275,0,11,5623000.0
5623,5623999,21.58964127729897,38.33852298823589,0.06240828501264273,981.7717683315277,371.3335771560669,1216.3098907470703,43913,5638,38275,38275,0,11,5624000.0
5624,5624999,21.590127416896124,38.33799836723987,0.062402990215321696,981.9939544200897,371.3956732749939,1216.4847679138184,43919,5639,38280,38280,0,11,5625000.0
5625,5625999,21.58968471029557,38.336154743955696,0.062396437375393465,982.2111382484436,371.4572923183441,1216.6418991088867,43929,5640,38289,38289,0,11,5626000.0
5626,5626999,21.58807491219197,38.33488877618412,0.06240601173646443,982.5330836772919,371.51966524124146,1217.081256866455,43958,5642,38316,38316,0,11,5627000.0
5627,5627999,21.58617543798777,38.332244241329384,0.06241956543506866,982.6488511562347,371.5856075286865,1217.4268684387207,43964,5642,38322,38322,0,11,5628000.0
5628,5628999,21.584595084821444,38.33053158644632,0.0624301426678705,982.7670311927795,371.6483736038208,1217.558437347412,43964,5642,38322,38322,0,11,5629000.0
5629,5629999,21.582869107577928,38.32792294461414,0.06244789689181374,983.0858793258667,371.7119634151459,1217.6254615783691,43976,5644,38332,38332,0,11,5630000.0
5630,5630999,21.58135834664146,38.3260651218341,0.06245531315331876,983.4111094474792,371.7753767967224,1217.9867630004883,43993,5646,38347,38347,0,11,5631000.0
5631,5631999,21.579811450180358,38.323663077269615,0.06246598381630197,983.629905462265,371.83871698379517,1218.1431770324707,43995,5647,38348,38348,0,11,5632000.0
5632,5632999,21.578162977691832,38.320984948957296,0.062476158653581915,983.7482531070709,371.90089678764343,1218.2664909362793,43995,5647,38348,38348,0,11,5633000.0
5633,5633999,21.576767009902408,38.318452520636086,0.06248093747671557,983.8612635135651,371.96432185173035,1218.5341453552246,43999,5647,38352,38352,0,11,5634000.0
5634,5634999,21.575786233510332,38.31661014169143,0.06248181637481831,983.9802904129028,372.02611351013184,1218.6223754882812,43999,5647,38352,38352,0,11,5635000.0
5635,5635999,21.575330823662302,38.31588863447542,0.0624817704591083,984.0909080505371,372.08755922317505,1218.7059516906738,44000,5647,38353,38353,0,11,5636000.0
5636,5636999,21.575418446578876,38.316541240328476,0.062488521878955705,984.4233856201172,372.1511516571045,1219.194164276123,44032,5649,38383,38383,0,11,5637000.0
5637,5637999,21.57566429084205,38.31672512362348,0.062496515840450906,984.5453758239746,372.2165741920471,1219.4950561523438,44032,5649,38383,38383,0,11,5638000.0
5638,5638999,21.576650326929666,38.321114745725474,0.062495073665563394,984.7653925418854,372.2794089317322,1219.6930961608887,44037,5650,38387,38387,0,11,5639000.0
5639,5639999,21.57858404008222,38.327663067132974,0.06248898587131435,984.9869666099548,372.3429696559906,1220.2526397705078,44052,5651,38401,38401,0,11,5640000.0
5640,5640999,21.58067376746048,38.334498335359434,0.06247816419506691,985.1071870326996,372.4063289165497,1220.5462226867676,44054,5651,38403,38403,0,11,5641000.0
5641,5641999,21.582481192231317,38.339259437406774,0.062487742419648384,985.4236249923706,372.4690237045288,1220.6178855895996,44065,5653,38412,38412,0,11,5642000.0
5642,5642999,21.585743287647592,38.348015371020765,0.06252146395376901,985.5421361923218,372.532511472702,1221.350082397461,44084,5653,38431,38431,0,11,5643000.0
5643,5643999,21.588317273529327,38.35438698109566,0.0625378542137397,985.7541205883026,372.5938470363617,1221.5115356445312,44093,5654,38439,38439,0,11,5644000.0
5644,5644999,21.59067799605168,38.35871902473495,0.06256403016513168,985.8673248291016,372.65640592575073,1221.8635520935059,44100,5654,38446,38446,0,11,5645000.0
5645,5645999,21.592203219685846,38.36103831211209,0.06255195880755982,986.0803694725037,372.71810579299927,1222.0685844421387,44103,5655,38448,38448,0,11,5646000.0
5646,5646999,21.591317983916156,38.36092161723784,0.06255306056691867,986.1975083351135,372.78122639656067,1222.6280975341797,44119,5655,38464,38464,0,11,5647000.0
5647,5647999,21.589740058629108,38.35976601458041,0.0625563601767678,986.4202284812927,372.84560918807983,1223.1870155334473,44136,5656,38480,38480,0,11,5648000.0
5648,5648999,21.588162620889452,38.35806266962466,0.06256472500497512,986.5412850379944,372.9121515750885,1223.4208526611328,44136,5656,38480,38480,0,11,5649000.0
5649,5649999,21.5865449269992,38.35576651041617,0.06257645848958382,986.7641036510468,372.97579407691956,1223.5423736572266,44139,5657,38482,38482,0,11,5650000.0
5650,5650999,21.58518300896143,38.354216320039846,0.06258047982227644,986.8787066936493,373.0390684604645,1223.927604675293,44146,5657,38489,38489,0,11,5651000.0
5651,5651999,21.583699779570342,38.35209624299358,0.06258629487319867,987.2001061439514,373.10410046577454,1224.078670501709,44158,5659,38499,38499,0,11,5652000.0
5652,5652999,21.582307877544622,38.3536598013819,0.06258388410614313,987.6231381893158,373.16906476020813,1224.0340156555176,44164,5662,38502,38502,0,11,5653000.0
5653,5653999,21.58100614523872,38.35139765143462,0.06259043047173929,987.7407319545746,373.2333273887634,1224.5299186706543,44172,5662,38510,38510,0,11,5654000.0
5654,5654999,21.57991520087382,38.3493182877786,0.06259422095820055,987.9633362293243,373.297434091568,1224.6994972229004,44175,5663,38512,38512,0,11,5655000.0
5655,5655999,21.578961030309515,38.347422633845014,0.06260106239110186,988.2856540679932,373.3606834411621,1224.8093566894531,44185,5665,38520,38520,0,11,5656000.0
5656,5656999,21.578206364526654,38.34610941555048,0.06261055270126648,988.504593372345,373.42440915107727,1225.3856086730957,44204,5666,38538,38538,0,11,5657000.0
5657,5657999,21.5773650197362,38.34424223008611,0.06261996953341509,988.6203353404999,373.4896557331085,1225.7416877746582,44205,5666,38539,38539,0,11,5658000.0
5658,5658999,21.576423631278708,38.34232679902033,0.06262396860663422,988.7300989627838,373.55167961120605,1225.9374351501465,44205,5666,38539,38539,0,11,5659000.0
5659,5659999,21.57605905341352,38.34128293213636,0.06261099687262095,988.8482854366302,373.6152780056,1226.4969291687012,44222,5666,38556,38556,0,11,5660000.0
5660,5660999,21.575963734674747,38.34017476187657,0.0626036902216679,989.1609964370728,373.6791627407074,1226.8113632202148,44232,5668,38564,38564,0,11,5661000.0
5661,5661999,21.575868925721718,38.33902868184064,0.06259959133221493,989.3734154701233,373.742751121521,1226.9849128723145,44234,5669,38565,38565,0,11,5662000.0
5662,5662999,21.576371060331546,38.34021574838103,0.06258155921379516,989.6102957725525,373.8095052242279,1227.6913604736328,44264,5670,38594,38594,0,11,5663000.0
5663,5663999,21.576840138492507,38.339834582046315,0.06258061634432477,989.9344255924225,373.8750886917114,1227.9314422607422,44269,5672,38597,38597,0,11,5664000.0
5664,5664999,21.576751920911605,38.33860965416597,0.06258249740587762,990.0493597984314,373.9371647834778,1228.180721282959,44269,5672,38597,38597,0,11,5665000.0
5665,5665999,21.57720159693161,38.33805563722977,0.0625689968352644,990.581805229187,374.0008964538574,1228.5788307189941,44310,5676,38634,38634,0,11,5666000.0
5666,5666999,21.57652183134758,38.33632603043761,0.06256648074746995,990.8052117824554,374.0659341812134,1229.0678253173828,44347,5677,38670,38670,0,11,5667000.0
5667,5667999,21.574777297175924,38.33410641406532,0.06257840630134404,990.9242942333221,374.12867760658264,1229.286849975586,44350,5677,38673,38673,0,11,5668000.0
5668,5668999,21.57292994809064,38.33126108928041,0.06259161542130054,991.1398682594299,374.1923372745514,1229.6984100341797,44368,5678,38690,38690,0,11,5669000.0
5669,5669999,21.57131219717946,38.32871613813631,0.06260394856147589,991.2600703239441,374.2554259300232,1229.8827781677246,44368,5678,38690,38690,0,11,5670000.0
5670,5670999,21.569772600398565,38.327142511647914,0.06261319427888756,991.3823499679565,374.32024908065796,1230.0119895935059,44368,5678,38690,38690,0,11,5671000.0
5671,5671999,21.56811624037702,38.32453357993071,0.0626225673187567,991.6043939590454,374.38322496414185,1230.3125305175781,44374,5679,38695,38695,0,11,5672000.0
5672,5672999,21.566583531815002,38.32201809216552,0.0626310802419151,992.0435400009155,374.4464726448059,1230.3544311523438,44415,5682,38733,38733,0,11,5673000.0
5673,5673999,21.565269623510524,38.320036572445154,0.06263888546800644,992.1707229614258,374.50924348831177,1230.5016899108887,44415,5682,38733,38733,0,11,5674000.0
5674,5674999,21.56441847413745,38.318925289228915,0.06263867890162889,992.2877955436707,374.57258582115173,1230.8578414916992,44421,5682,38739,38739,0,11,5675000.0
5675,5675999,21.564068011709114,38.31934545292521,0.06263360642385984,992.5200281143188,374.6350646018982,1230.963954925537,44423,5683,38740,38740,0,11,5676000.0
5676,5676999,21.564244551485732,38.32117629902245,0.06263711223327895,992.639986038208,374.6973526477814,1231.0528526306152,44423,5683,38740,38740,0,11,5677000.0
5677,5677999,21.5647524612102,38.32331733583909,0.06264554952827928,992.7562787532806,374.75991106033325,1231.3754081726074,44425,5683,38742,38742,0,11,5678000.0
5678,5678999,21.56546338779044,38.32511667156299,0.06265138546137416,992.8818061351776,374.8221366405487,1231.4885330200195,44425,5683,38742,38742,0,11,5679000.0
5679,5679999,21.566147166312536,38.327071261005024,0.06265692108017618,993.0030055046082,374.8833649158478,1231.5710830688477,44425,5683,38742,38742,0,11,5680000.0
5680,5680999,21.567403080666125,38.330359267019446,0.06264317833939792,993.1261167526245,374.94532656669617,1232.0403900146484,44436,5683,38753,38753,0,11,5681000.0
5681,5681999,21.568919123929767,38.33397558335359,0.06263762492655167,993.2513422966003,375.00787258148193,1232.3042259216309,44438,5683,38755,38755,0,11,5682000.0
5682,5682999,21.57005655554968,38.335815163752876,0.06265256048340984,993.4685895442963,375.0694069862366,1232.4175415039062,44447,5684,38763,38763,0,11,5683000.0
5683,5683999,21.57179612629297,38.338555426945476,0.06267432050896404,993.691376209259,375.1315703392029,1232.7758445739746,44457,5685,38772,38772,0,11,5684000.0
5684,5684999,21.57355636741996,38.34126037993824,0.0626984703467256,993.8003916740417,375.1930887699127,1232.9123573303223,44457,5685,38772,38772,0,11,5685000.0
5685,5685999,21.57527339781768,38.346092294763444,0.06269563086649499,993.9264869689941,375.2543807029724,1233.0105476379395,44457,5685,38772,38772,0,11,5686000.0
5686,5686999,21.57642889252494,38.347055092056074,0.06270004606357893,994.1484055519104,375.31656098365784,1233.2193908691406,44464,5686,38778,38778,0,11,5687000.0
5687,5687999,21.576303444520494,38.34709352939923,0.06270115648258912,994.3653838634491,375.3782739639282,1233.6375617980957,44482,5687,38795,38795,0,11,5688000.0
5688,5688999,21.57471119253258,38.34498055974179,0.06270401507920254,994.48854804039,375.4411926269531,1234.0948066711426,44494,5687,38807,38807,0,11,5689000.0
5689,5689999,21.57298776074327,38.34297141364716,0.0627098860745735,994.5990781784058,375.5040693283081,1234.4672927856445,44497,5687,38810,38810,0,11,5690000.0
5690,5690999,21.571535761681027,38.3411599942626,0.06271490859329676,994.7265756130219,375.5707094669342,1234.6286392211914,44497,5687,38810,38810,0,11,5691000.0
5691,5691999,21.5701996795155,38.33925388075578,0.06272033285547929,994.8476259708405,375.63383889198303,1234.779541015625,44497,5687,38810,38810,0,11,5692000.0
5692,5692999,21.56899169003229,38.33748300166642,0.06272139110633479,995.0630033016205,375.696252822876,1235.1952896118164,44508,5688,38820,38820,0,11,5693000.0
5693,5693999,21.567724326214066,38.33561596290205,0.06272121830079291,995.3792150020599,375.7594096660614,1235.3542861938477,44519,5690,38829,38829,0,11,5694000.0
5694,5694999,21.56696410776572,38.33438118098484,0.06271816803285257,995.6056625843048,375.8221712112427,1235.6439323425293,44528,5691,38837,38837,0,11,5695000.0
5695,5695999,21.56619271949396,38.33326410110561,0.06271378946631223,995.7177991867065,375.88454365730286,1235.9092102050781,44529,5691,38838,38838,0,11,5696000.0
5696,5696999,21.56587285272657,38.33250800773114,0.06271213519335972,996.0457298755646,375.9474461078644,1236.023006439209,44539,5693,38846,38846,0,11,5697000.0
5697,5697999,21.565523180365144,38.332260019817994,0.06270805902142618,996.3669548034668,376.01056432724,1236.1100044250488,44549,5695,38854,38854,0,11,5698000.0
5698,5698999,21.56538586117489,38.33156335964181,0.06269415995869576,996.5869631767273,376.07545924186707,1236.8534660339355,44572,5696,38876,38876,0,11,5699000.0
5699,5699999,21.565637811497947,38.33418167676519,0.06267936158234233,996.8009583950043,376.1375963687897,1237.0457496643066,44581,5697,38884,38884,0,11,5700000.0
5700,5700999,21.565598035424017,38.333846252702905,0.0626735866014656,997.0149810314178,376.2005681991577,1237.242099761963,44588,5698,38890,38890,0,11,5701000.0
5701,5701999,21.566077739785545,38.3339804786204,0.0626674504305641,997.1275358200073,376.26250314712524,1237.8920135498047,44607,5698,38909,38909,0,11,5702000.0
5702,5702999,21.56622910219186,38.333282389079564,0.06266627044058581,997.4465065002441,376.3255789279938,1238.089958190918,44637,5700,38937,38937,0,11,5703000.0
5703,5703999,21.566542659439552,38.332941296242964,0.06266414918093155,997.5699729919434,376.3885724544525,1238.2645454406738,44637,5700,38937,38937,0,11,5704000.0
5704,5704999,21.567215469708888,38.33264663550661,0.06265169584858621,997.697273015976,376.453989982605,1238.835060119629,44652,5700,38952,38952,0,11,5705000.0
5705,5705999,21.5675895473939,38.33355503598568,0.06263831162360034,997.8072617053986,376.51541781425476,1239.0161666870117,44652,5700,38952,38952,0,11,5706000.0
5706,5706999,21.56791611749336,38.33298302881213,0.06263506740695446,998.139479637146,376.57956314086914,1239.0357208251953,44656,5702,38954,38954,0,11,5707000.0
5707,5707999,21.568104593914843,38.33211718516245,0.06262782938191791,998.5709409713745,376.64040637016296,1239.2388725280762,44681,5705,38976,38976,0,11,5708000.0
5708,5708999,21.567407927485576,38.33043147934459,0.0626265058529406,998.791158914566,376.7526557445526,1239.8285064697266,44709,5706,39003,39003,0,11,5709000.0
5709,5709999,21.565892235227565,38.32872180132931,0.06263822271406405,998.9098637104034,376.8156123161316,1240.3060264587402,44719,5706,39013,39013,0,11,5710000.0
5710,5710999,21.56449546794428,38.3279729350836,0.06264423576964895,999.1294708251953,376.8792462348938,1240.517333984375,44722,5707,39015,39015,0,11,5711000.0
5711,5711999,21.563226806705032,38.32656061132367,0.06265062145229483,999.2525811195374,376.9438760280609,1240.681095123291,44723,5707,39016,39016,0,11,5712000.0
5712,5712999,21.562110903901083,38.32532428798145,0.06264389175499518,999.369348526001,377.00801491737366,1241.3128051757812,44740,5707,39033,39033,0,11,5713000.0
5713,5713999,21.560550832432565,38.32278237706508,0.06265347164887514,999.5873053073883,377.07085275650024,1241.5768966674805,44743,5708,39035,39035,0,11,5714000.0
5714,5714999,21.559194943756733,38.32061391476673,0.06266280124391044,999.7008118629456,377.13405418395996,1241.9634094238281,44752,5708,39044,39044,0,11,5715000.0
5715,5715999,21.558163625924713,38.319162362082494,0.0626637180053643,999.9218707084656,377.20015931129456,1242.18550491333,44760,5709,39051,39051,0,11,5716000.0
5716,5716999,21.556927306379563,38.31722034461273,0.06267042683027091,1000.1482028961182,377.2640657424927,1242.371078491211,44763,5710,39053,39053,0,11,5717000.0
5717,5717999,21.55568910947706,38.31490629164536,0.06268019825046489,1000.4732398986816,377.3298282623291,1242.8233184814453,44788,5712,39076,39076,0,11,5718000.0
5718,5718999,21.554405199636545,38.31260517939157,0.06268436868513161,1000.591472864151,377.39365887641907,1243.3900146484375,44796,5712,39084,39084,0,11,5719000.0
5719,5719999,21.5531433241286,38.31065887195044,0.06269531130255745,1000.8176217079163,377.4569673538208,1243.623779296875,44798,5713,39085,39085,0,11,5720000.0
5720,5720999,21.552159471636276,38.30877695558186,0.06270093872783156,1001.141942024231,377.5214936733246,1244.1998481750488,44829,5715,39114,39114,0,11,5721000.0
5721,5721999,21.55136342752833,38.30709174126989,0.06270566674828526,1001.2486054897308,377.58511090278625,1244.575351715088,44831,5715,39116,39116,0,11,5722000.0
5722,5722999,21.550701301803954,38.305317510853605,0.06270926177489211,1001.4762423038483,377.6490569114685,1245.1768112182617,44855,5716,39139,39139,0,11,5723000.0
5723,5723999,21.55024191223613,38.30374715730011,0.0627060264935082,1001.5877547264099,377.7115921974182,1245.6434516906738,44857,5716,39141,39141,0,11,5724000.0
5724,5724999,21.54913485816703,38.30140358117167,0.06271640412836565,1001.7035839557648,377.7742269039154,1246.0304870605469,44864,5716,39148,39148,0,11,5725000.0
5725,5725999,21.548296619865848,38.300439233419134,0.0627187316719433,1002.0365014076233,377.8372163772583,1246.6853332519531,44885,5718,39167,39167,0,11,5726000.0
5726,5726999,21.546945333763468,38.29841078698429,0.06272248246189505,1002.1519763469696,377.90111660957336,1247.4271545410156,44903,5718,39185,39185,0,11,5727000.0
5727,5727999,21.545912777628573,38.29779862867296,0.06272250988416639,1002.4852595329285,377.9674825668335,1247.6524620056152,44919,5720,39199,39199,0,11,5728000.0
5728,5728999,21.544772715852904,38.29747294447788,0.06272608073848607,1002.919912815094,378.0320942401886,1247.8356742858887,44941,5723,39218,39218,0,11,5729000.0
5729,5729999,21.543905610851983,38.296130404701266,0.06272699589361375,1003.0387103557587,378.096706867218,1248.3368492126465,44949,5723,39226,39226,0,11,5730000.0
5730,5730999,21.543374443092155,38.29565794358216,0.0627192614221801,1003.2536845207214,378.15948128700256,1248.4987754821777,44951,5724,39227,39227,0,11,5731000.0
5731,5731999,21.54268173649584,38.29428895756777,0.0627182515983502,1003.3698587417603,378.22219038009644,1248.8325233459473,44958,5724,39234,39234,0,11,5732000.0
5732,5732999,21.54167546518714,38.292431828618284,0.0627166939310767,1003.4757781028748,378.28493571281433,1249.0670356750488,44958,5724,39234,39234,0,11,5733000.0
5733,5733999,21.540835947223233,38.29059402097199,0.06271435157951666,1003.7048835754395,378.34765243530273,1249.1999206542969,44966,5725,39241,39241,0,11,5734000.0
5734,5734999,21.540460097215835,38.29028692725824,0.06270477523210005,1003.8222987651825,378.40978479385376,1249.3359336853027,44966,5725,39241,39241,0,11,5735000.0
5735,5735999,21.540121837551975,38.28903776090913,0.06269712516877735,1004.1620168685913,378.4732565879822,1249.7270774841309,44986,5727,39259,39259,0,11,5736000.0
5736,5736999,21.539507896191903,38.28763578463694,0.0626944472139006,1004.273354768753,378.5352575778961,1249.9340133666992,44986,5727,39259,39259,0,11,5737000.0
5737,5737999,21.538949456393404,38.28609535919629,0.06269018064108733,1004.5053062438965,378.59786772727966,1250.027488708496,44988,5728,39260,39260,0,11,5738000.0
5738,5738999,21.539027814639336,38.28598035828432,0.06267483908200311,1004.7264876365662,378.66432666778564,1250.5407981872559,45010,5729,39281,39281,0,11,5739000.0
5739,5739999,21.53920513842875,38.28612890040896,0.06265867092083999,1004.853353023529,378.7294645309448,1250.7140274047852,45010,5729,39281,39281,0,11,5740000.0
5740,5740999,21.538961240332643,38.28466833624555,0.06264871139284967,1005.1995522975922,378.7929790019989,1250.9038467407227,45019,5731,39288,39288,0,11,5741000.0
5741,5741999,21.53926783453268,38.28396872047669,0.06263252610522707,1005.309205532074,378.8540382385254,1251.2544136047363,45024,5731,39293,39293,0,11,5742000.0
5742,5742999,21.5396251417357,38.28354317225859,0.06262038744767218,1005.4202105998993,378.91767621040344,1251.3781623840332,45024,5731,39293,39293,0,11,5743000.0
5743,5743999,21.54001492045983,38.282948798606405,0.06261126748964518,1005.7542293071747,378.9796357154846,1251.4879570007324,45037,5733,39304,39304,0,11,5744000.0
5744,5744999,21.540972981777426,38.289061493430694,0.062380401300469845,1005.9773182868958,379.0414664745331,1251.6441078186035,45045,5734,39311,39311,0,11,5745000.0
5745,5745999,21.540246695372442,38.287367277474374,0.062366623788244424,1006.1111845970154,379.10626697540283,1252.1980590820312,45057,5734,39323,39323,0,11,5746000.0
5746,5746999,21.539899124624704,38.28775951446735,0.062380075026091886,1006.5462975502014,379.1713716983795,1252.3736610412598,45078,5737,39341,39341,0,11,5747000.0
5747,5747999,21.53984557510161,38.289077660041755,0.062380594603783535,1006.6717534065247,379.2348186969757,1252.6440391540527,45080,5737,39343,39343,0,11,5748000.0
5748,5748999,21.539740288954714,38.28903016369323,0.06238501455269729,1006.7839682102203,379.29795145988464,1252.7979583740234,45080,5737,39343,39343,0,11,5749000.0
5749,5749999,21.53973613400557,38.28907127988562,0.062392967850080194,1006.9038026332855,379.3615183830261,1253.2128677368164,45091,5737,39354,39354,0,11,5750000.0
5750,5750999,21.53969131473791,38.28846407694646,0.06238179679146161,1007.1203246116638,379.4244420528412,1253.5300559997559,45094,5738,39356,39356,0,11,5751000.0
5751,5751999,21.539623889806435,38.287939467782024,0.06238106378193242,1007.344343662262,379.48671531677246,1253.6557846069336,45096,5739,39357,39357,0,11,5752000.0
5752,5752999,21.54019742588341,38.28887166823163,0.062368773491686125,1007.4579477310181,379.5495376586914,1254.064338684082,45103,5739,39364,39364,0,11,5753000.0
5753,5753999,21.540528637423005,38.28857838909936,0.06235380129938761,1007.7848670482635,379.6156725883484,1254.140209197998,45112,5741,39371,39371,0,11,5754000.0
5754,5754999,21.541428770841318,38.28938619560482,0.06234409387302442,1008.1091029644012,379.6791410446167,1254.2381019592285,45121,5743,39378,39378,0,11,5755000.0
5755,5755999,21.542274797741793,38.29058169826366,0.06233536967285036,1008.2292520999908,379.7450692653656,1254.5380401611328,45127,5743,39384,39384,0,11,5756000.0
5756,5756999,21.54378658718084,38.291728351289244,0.062344253319511544,1008.4594440460205,379.8090453147888,1254.6291389465332,45136,5744,39392,39392,0,11,5757000.0
5757,5757999,21.54564945290694,38.29488014092184,0.06234117767687686,1008.5841727256775,379.8712275028229,1254.7414817810059,45136,5744,39392,39392,0,11,5758000.0
5758,5758999,21.547532155991068,38.297650693929555,0.06235737030566113,1008.7052519321442,379.93480467796326,1255.046573638916,45145,5744,39401,39401,0,11,5759000.0
5759,5759999,21.550044032516777,38.3026851942467,0.06236383567286896,1009.0360188484192,379.9971318244934,1255.1331253051758,45164,5746,39418,39418,0,11,5760000.0
5760,5760999,21.552123977752068,38.30618820971721,0.06238173402664815,1009.3719069957733,380.06068682670593,1255.2179946899414,45176,5748,39428,39428,0,11,5761000.0
5761,5761999,21.554812541443116,38.31310717950762,0.06239609511159783,1009.5995292663574,380.1243062019348,1255.85404586792,45200,5749,39451,39451,0,11,5762000.0
5762,5762999,21.557145494687013,38.31652263704736,0.062448326041850466,1009.708203792572,380.1868917942047,1256.0972938537598,45201,5749,39452,39452,0,11,5763000.0
5763,5763999,21.55882927058975,38.31835523348622,0.06247343574672359,1009.8322422504425,380.2493977546692,1256.240379333496,45201,5749,39452,39452,0,11,5764000.0
5764,5764999,21.56012891399599,38.31875938826841,0.062465739694492206,1010.0522685050964,380.3113942146301,1256.4632835388184,45212,5750,39462,39462,0,11,5765000.0
5765,5765999,21.560791388067063,38.31895006728098,0.06247193517427041,1010.281809091568,380.3739969730377,1256.8730697631836,45232,5751,39481,39481,0,11,5766000.0
5766,5766999,21.55968342627196,38.31840412108028,0.06247039251955666,1010.3952958583832,380.43737268447876,1257.1877517700195,45238,5751,39487,39487,0,11,5767000.0
5767,5767999,21.558682767214016,38.316957441320014,0.06247070795254195,1010.5160391330719,380.4989404678345,1257.5595893859863,45245,5751,39494,39494,0,11,5768000.0
5768,5768999,21.55750536584248,38.31496673585701,0.06247527601700664,1010.6310830116272,380.5619134902954,1257.720760345459,45246,5751,39495,39495,0,11,5769000.0
5769,5769999,21.556534051943927,38.31339369633673,0.06247759653573659,1010.8508002758026,380.6260747909546,1257.8234786987305,45250,5752,39498,39498,0,11,5770000.0
5770,5770999,21.555581738133743,38.311564697525704,0.062476961586682145,1010.9734129905701,380.6887831687927,1258.2226943969727,45254,5752,39502,39502,0,11,5771000.0
5771,5771999,21.55471619742106,38.309712376292865,0.06247620207078286,1011.104085445404,380.750937461853,1258.3757591247559,45254,5752,39502,39502,0,11,5772000.0
5772,5772999,21.553805868951073,38.30772893386547,0.062476998942471496,1011.2280509471893,380.81422448158264,1258.638957977295,45259,5752,39507,39507,0,11,5773000.0
5773,5773999,21.553084231587253,38.30584030608757,0.06246997701344448,1011.3565692901611,380.87787890434265,1258.8425636291504,45259,5752,39507,39507,0,11,5774000.0
5774,5774999,21.552359100730108,38.30400408651371,0.06246413008014906,1011.5985643863678,380.9437131881714,1258.9013290405273,45268,5753,39515,39515,0,11,5775000.0
5775,5775999,21.551737508801466,38.30216580658184,0.062453108327765516,1011.9398949146271,381.0073742866516,1259.017864227295,45278,5755,39523,39523,0,11,5776000.0
5776,5776999,21.551496730549047,38.3009230677721,0.06242681533111716,1012.1712944507599,381.07327580451965,1259.7245407104492,45304,5756,39548,39548,0,11,5777000.0
5777,5777999,21.551137680010427,38.29953457058418,0.06240997280693461,1012.2885763645172,381.1378014087677,1259.9918251037598,45304,5756,39548,39548,0,11,5778000.0
5778,5778999,21.550816633599595,38.298275114652796,0.06239818104068651,1012.4066774845123,381.20036935806274,1260.1887969970703,45304,5756,39548,39548,0,11,5779000.0
5779,5779999,21.551385977427792,38.29801667367168,0.0623584251225926,1012.6450159549713,381.26414370536804,1260.6426162719727,45314,5757,39557,39557,0,11,5780000.0
5780,5780999,21.551620637687883,38.297075464066026,0.06233141094610206,1012.7665672302246,381.32749462127686,1260.7993698120117,45314,5757,39557,39557,0,11,5781000.0
5781,5781999,21.552280345941384,38.29645387343207,0.06229131537417654,1012.893669128418,381.3910813331604,1261.2142066955566,45328,5757,39571,39571,0,11,5782000.0
5782,5782999,21.55335065033637,38.29646834548209,0.0622270284052292,1013.0040185451508,381.45302510261536,1261.5537414550781,45329,5757,39572,39572,0,11,5783000.0
5783,5783999,21.55385913946778,38.29588051703815,0.06218016143158922,1013.1150507926941,381.5152657032013,1261.711582183838,45329,5757,39572,39572,0,11,5784000.0
5784,5784999,21.55434314783912,38.295051739884485,0.0621333524746408,1013.2370097637177,381.5770015716553,1262.0058212280273,45334,5757,39577,39577,0,11,5785000.0
5785,5785999,21.554528658103177,38.294448140798245,0.062101115749071956,1013.3484709262848,381.63812708854675,1262.1869430541992,45336,5757,39579,39579,0,11,5786000.0
5786,5786999,21.553032090751135,38.29194408659644,0.062106723596307756,1013.5781562328339,381.7009675502777,1262.5367736816406,45355,5758,39597,39597,0,11,5787000.0
5787,5787999,21.55166143035694,38.289947927596174,0.06210662616556162,1013.7173023223877,381.7662572860718,1262.9307899475098,45362,5758,39604,39604,0,11,5788000.0
5788,5788999,21.550309386987003,38.28763509442946,0.062109775124497446,1013.9559996128082,381.83074140548706,1263.0747146606445,45374,5759,39615,39615,0,11,5789000.0
5789,5789999,21.549217027193436,38.28648984671034,0.0621063775329197,1014.1924293041229,381.8947627544403,1263.1826438903809,45378,5760,39618,39618,0,11,5790000.0
5790,5790999,21.54829370844616,38.28518369403165,0.06209694946356614,1014.5384089946747,381.95935702323914,1263.5456352233887,45388,5762,39626,39626,0,11,5791000.0
5791,5791999,21.54735733456775,38.283314315935655,0.06209075695489141,1014.6670877933502,382.02438020706177,1263.7626914978027,45388,5762,39626,39626,0,11,5792000.0
5792,5792999,21.546393371508486,38.281190646928806,0.06208776686945505,1014.7856914997101,382.08721351623535,1263.900619506836,45388,5762,39626,39626,0,11,5793000.0
5793,5793999,21.545709334649704,38.27989343561819,0.062078418356543597,1015.0158829689026,382.15264081954956,1264.23685836792,45410,5763,39647,39647,0,11,5794000.0
5794,5794999,21.545170054340062,38.27814614964631,0.06207452902586452,1015.3735044002533,382.21888756752014,1264.376262664795,45421,5765,39656,39656,0,11,5795000.0
5795,5795999,21.544643837461685,38.27717174475915,0.062065199633851265,1015.6152515411377,382.28261828422546,1264.4967613220215,45430,5766,39664,39664,0,11,5796000.0
5796,5796999,21.54399995227435,38.27538897089531,0.06206380472524686,1015.752819776535,382.3473401069641,1265.074909210205,45446,5766,39680,39680,0,11,5797000.0
5797,5797999,21.54379570531151,38.27467251763523,0.06206481308013212,1015.8783714771271,382.41407203674316,1265.3566856384277,45447,5766,39681,39681,0,11,5798000.0
5798,5798999,21.54342483411888,38.27340963204548,0.06206720789978615,1016.1057775020599,382.4765782356262,1265.5109176635742,45457,5767,39690,39690,0,11,5799000.0
5799,5799999,21.543462748638547,38.27272391878098,0.062060116213754846,1016.2216744422913,382.5414125919342,1266.0603828430176,45463,5767,39696,39696,0,11,5800000.0
5800,5800999,21.543150063281892,38.27139443015769,0.062047480152295775,1016.5663032531738,382.6068015098572,1266.3475379943848,45503,5769,39734,39734,0,11,5801000.0
5801,5801999,21.543082740941202,38.27037163542072,0.06204464714886715,1016.6932797431946,382.6701786518097,1266.5234184265137,45503,5769,39734,39734,0,11,5802000.0
5802,5802999,21.54307345641445,38.26927731479187,0.06203292808574068,1016.9304752349854,382.7370092868805,1267.1715621948242,45524,5770,39754,39754,0,11,5803000.0
5803,5803999,21.54323096429015,38.268517447330545,0.0620222824417932,1017.1610701084137,382.80114483833313,1267.399284362793,45526,5771,39755,39755,0,11,5804000.0
5804,5804999,21.542908765027413,38.267024129437544,0.06201769179969652,1017.5048689842224,382.865971326828,1267.5121116638184,45541,5773,39768,39768,0,11,5805000.0
5805,5805999,21.542584601996424,38.265209472149095,0.062004680621974284,1017.6294867992401,382.9293360710144,1267.9125518798828,45549,5773,39776,39776,0,11,5806000.0
5806,5806999,21.541686303957274,38.2630510747749,0.06200007817120057,1017.8624122142792,382.9923412799835,1268.2686614990234,45569,5774,39795,39795,0,11,5807000.0
5807,5807999,21.540375904351837,38.261763377674015,0.06199466841544132,1018.2056698799133,383.0585551261902,1268.5086135864258,45588,5776,39812,39812,0,11,5808000.0
5808,5808999,21.539328619304364,38.26062179318522,0.06199428524623107,1018.5546231269836,383.12351965904236,1268.7468528747559,45608,5778,39830,39830,0,11,5809000.0
5809,5809999,21.538376767838553,38.25901716225736,0.0619997080922009,1018.6820721626282,383.1872036457062,1268.9079856872559,45608,5778,39830,39830,0,11,5810000.0
5810,5810999,21.53739087823493,38.257423187218706,0.06200101504303224,1018.8020429611206,383.25256180763245,1269.0889320373535,45608,5778,39830,39830,0,11,5811000.0
5811,5811999,21.53657912674574,38.25631712940717,0.06199363859325924,1018.9154605865479,383.31407022476196,1269.4569664001465,45612,5778,39834,39834,0,11,5812000.0
5812,5812999,21.536018398007794,38.25540075634769,0.06198298726828744,1019.3612282276154,383.37865567207336,1269.5048217773438,45633,5781,39852,39852,0,11,5813000.0
5813,5813999,21.535372425907507,38.253992878575964,0.061976841872184996,1019.4873707294464,383.4420545101166,1269.7931747436523,45637,5781,39856,39856,0,11,5814000.0
5814,5814999,21.53508298087519,38.252943859491076,0.06196826059605698,1019.6137177944183,383.505806684494,1270.0209732055664,45637,5781,39856,39856,0,11,5815000.0
5815,5815999,21.534623630413034,38.25196510310564,0.061960808241377285,1019.8435072898865,383.5694282054901,1270.2003860473633,45640,5782,39858,39858,0,11,5816000.0
5816,5816999,21.534682183129256,38.25147691147421,0.06195522957537225,1019.9691617488861,383.63352632522583,1270.324535369873,45640,5782,39858,39858,0,11,5817000.0
5817,5817999,21.535266206712166,38.2520196301711,0.06195830108856604,1020.090790271759,383.6957857608795,1270.4814910888672,45640,5782,39858,39858,0,11,5818000.0
5818,5818999,21.535881438179757,38.252204682827745,0.06196458440903552,1020.2208774089813,383.7571406364441,1270.556972503662,45640,5782,39858,39858,0,11,5819000.0
5819,5819999,21.5368046503206,38.25335308176552,0.06196877450760785,1020.4603605270386,383.82138776779175,1270.5868339538574,45648,5783,39865,39865,0,11,5820000.0
5820,5820999,21.538130752496194,38.25559931166709,0.06197587289249773,1020.6843888759613,383.88474464416504,1271.1222457885742,45659,5784,39875,39875,0,11,5821000.0
5821,5821999,21.539909179927676,38.25821212850083,0.06199313553400709,1020.808794260025,383.94905138015747,1271.3697204589844,45659,5784,39875,39875,0,11,5822000.0
5822,5822999,21.541736969034616,38.26134385021737,0.06201159849647153,1020.9305126667023,384.0113787651062,1271.5260848999023,45659,5784,39875,39875,0,11,5823000.0
5823,5823999,21.544571531028872,38.26633218394609,0.0620574142477065,1021.2560784816742,384.07506942749023,1272.1303405761719,45690,5786,39904,39904,0,11,5824000.0
5824,5824999,21.54761518228859,38.273116579591886,0.062093891022832914,1021.4736669063568,384.1376221179962,1272.346965789795,45699,5787,39912,39912,0,11,5825000.0
5825,5825999,21.550706175744356,38.27959577159443,0.062124173202028565,1021.7044236660004,384.2003345489502,1272.6562995910645,45715,5788,39927,39927,0,11,5826000.0
5826,5826999,21.552986564874452,38.28285289147752,0.0621478775641483,1022.0331649780273,384.26490473747253,1272.8529434204102,45737,5790,39947,39947,0,11,5827000.0
5827,5827999,21.552518194978145,38.2820672808594,0.06213806403546274,1022.1520073413849,384.3299078941345,1273.382698059082,45749,5790,39959,39959,0,11,5828000.0
5828,5828999,21.551222213783234,38.280789222804806,0.062134005657534686,1022.2765617370605,384.39376854896545,1273.8092994689941,45758,5790,39968,39968,0,11,5829000.0
5829,5829999,21.550018844725006,38.27982204143453,0.06213395573475755,1022.4987726211548,384.457394361496,1274.0319061279297,45763,5791,39972,39972,0,11,5830000.0
5830,5830999,21.548883699539896,38.278124461751034,0.06213361806437079,1022.7239599227905,384.5213506221771,1274.186122894287,45771,5792,39979,39979,0,11,5831000.0
5831,5831999,21.547984020090166,38.276593462151816,0.06212995055271664,1022.8513960838318,384.5850908756256,1274.4297637939453,45772,5792,39980,39980,0,11,5832000.0
5832,5832999,21.54725754939598,38.27531718997009,0.062123961441048814,1023.080644607544,384.64953804016113,1274.6943092346191,45776,5793,39983,39983,0,11,5833000.0
5833,5833999,21.546559354937074,38.27372755574842,0.062119712685720696,1023.1948049068451,384.71250772476196,1274.8868865966797,45776,5793,39983,39983,0,11,5834000.0
5834,5834999,21.546207698583416,38.27269369200835,0.06211819835191079,1023.4223830699921,384.776531457901,1275.1903953552246,45790,5794,39996,39996,0,11,5835000.0
5835,5835999,21.54641705018529,38.27532907235238,0.06211481863236523,1023.5389630794525,384.83939003944397,1275.4172706604004,45790,5794,39996,39996,0,11,5836000.0
5836,5836999,21.54693014817948,38.275877018309224,0.06212862260836982,1023.8709383010864,384.9034535884857,1275.5452613830566,45796,5796,40000,40000,0,11,5837000.0
5837,5837999,21.54788765892174,38.27646224668173,0.06218437830075252,1024.101181268692,384.96719574928284,1275.8474769592285,45803,5797,40006,40006,0,11,5838000.0
5838,5838999,21.54944333092897,38.27840683613994,0.06221597225432951,1024.4385249614716,385.0342798233032,1276.5895347595215,45837,5799,40038,40038,0,11,5839000.0
5839,5839999,21.550713087013662,38.279245154917454,0.06225869858976951,1024.5480244159698,385.0969729423523,1276.9956588745117,45837,5799,40038,40038,0,11,5840000.0
5840,5840999,21.552296397107476,38.280804858916966,0.062285677401927475,1024.9788813591003,385.160409450531,1277.1182823181152,45866,5802,40064,40064,0,11,5841000.0
5841,5841999,21.554286026550308,38.28488133394884,0.06233073359103081,1025.2048485279083,385.2249917984009,1277.9658889770508,45887,5803,40084,40084,0,11,5842000.0
5842,5842999,21.556555108870118,38.28980055025057,0.06238586459773765,1025.4289872646332,385.28799986839294,1278.154857635498,45896,5804,40092,40092,0,11,5843000.0
5843,5843999,21.55863178171212,38.292170603795356,0.06243142684124425,1025.5538618564606,385.3534905910492,1278.932285308838,45918,5804,40114,40114,0,11,5844000.0
5844,5844999,21.561521705563234,38.29765505765297,0.06250654110585208,1025.6618022918701,385.41566729545593,1279.3580589294434,45920,5804,40116,40116,0,11,5845000.0
5845,5845999,21.56382054285043,38.30049729892998,0.06258739268238711,1025.7764797210693,385.4792015552521,1279.5811157226562,45920,5804,40116,40116,0,11,5846000.0
5846,5846999,21.566921822411935,38.30518764178529,0.06263989760615074,1025.9965362548828,385.5415234565735,1280.0206832885742,45935,5805,40130,40130,0,11,5847000.0
5847,5847999,21.568204093476652,38.30619311162255,0.06266374931279106,1026.3267538547516,385.6039664745331,1280.2750091552734,45950,5807,40143,40143,0,11,5848000.0
5848,5848999,21.567188966209677,38.30619176879613,0.06266031375081349,1026.4464211463928,385.66837430000305,1280.9272003173828,45966,5807,40159,40159,0,11,5849000.0
5849,5849999,21.566053158121438,38.30496673008196,0.06266691542248326,1026.5700964927673,385.73227310180664,1281.223731994629,45968,5807,40161,40161,0,11,5850000.0
5850,5850999,21.56492944860836,38.303176470967685,0.06267149102542258,1026.7962474822998,385.795818567276,1281.3619422912598,45977,5808,40169,40169,0,11,5851000.0
5851,5851999,21.563822098902225,38.30124669555499,0.06267511789438451,1027.2330069541931,385.860808134079,1281.7150917053223,46002,5811,40191,40191,0,11,5852000.0
5852,5852999,21.562724932263126,38.30271610428337,0.06266872217241781,1027.456866979599,385.9237575531006,1282.0207328796387,46006,5812,40194,40194,0,11,5853000.0
5853,5853999,21.561586235122665,38.30060127310249,0.06267169043148058,1027.5675356388092,385.9868929386139,1282.2654457092285,46007,5812,40195,40195,0,11,5854000.0
5854,5854999,21.56045393651723,38.29836586669823,0.06267545066456004,1027.7972238063812,386.05149149894714,1282.6530799865723,46022,5813,40209,40209,0,11,5855000.0
5855,5855999,21.55940780475263,38.29660930601432,0.06267545235249117,1028.0249121189117,386.11529541015625,1282.8049850463867,46024,5814,40210,40210,0,11,5856000.0
5856,5856999,21.558407006875075,38.29467405212159,0.06267645389462595,1028.145327091217,386.1780252456665,1282.9615097045898,46025,5814,40211,40211,0,11,5857000.0
5857,5857999,21.557566698324134,38.29301302416533,0.06267461386119899,1028.270919561386,386.2417027950287,1283.7228698730469,46038,5814,40224,40224,0,11,5858000.0
5858,5858999,21.55666505795014,38.29133962799172,0.06267639822053939,1028.3839182853699,386.30470609664917,1283.9915046691895,46038,5814,40224,40224,0,11,5859000.0
5859,5859999,21.555703154124238,38.289315253990786,0.06267852758749815,1028.4978024959564,386.36811566352844,1284.3358993530273,46044,5814,40230,40230,0,11,5860000.0
5860,5860999,21.554900222151236,38.28758059939239,0.06268076816976131,1028.6135921478271,386.4334943294525,1284.759609222412,46049,5814,40235,40235,0,11,5861000.0
5861,5861999,21.55417909189363,38.286170859196154,0.06268160474913431,1028.8343675136566,386.4961986541748,1284.8986320495605,46052,5815,40237,40237,0,11,5862000.0
5862,5862999,21.553723349385734,38.28442642071198,0.06267706005451701,1028.9602098464966,386.56007528305054,1285.4435577392578,46067,5815,40252,40252,0,11,5863000.0
5863,5863999,21.553162859221104,38.28277133720105,0.06267509578088615,1029.0798032283783,386.6221227645874,1285.643154144287,46067,5815,40252,40252,0,11,5864000.0
5864,5864999,21.552259339874038,38.28072720872714,0.06268010743801755,1029.3075959682465,386.68353962898254,1286.0455589294434,46085,5816,40269,40269,0,11,5865000.0
5865,5865999,21.55131627105913,38.279576922016595,0.06266874277819168,1029.4221839904785,386.7450957298279,1286.5469093322754,46096,5816,40280,40280,0,11,5866000.0
5866,5866999,21.550408061235125,38.279059300059046,0.06266522841556621,1029.6564478874207,386.80949211120605,1286.8293380737305,46107,5817,40290,40290,0,11,5867000.0
5867,5867999,21.549230008108985,38.276905394282615,0.06267070700935251,1029.879826784134,386.8727445602417,1286.9495086669922,46109,5818,40291,40291,0,11,5868000.0
5868,5868999,21.54866277567944,38.27677821589321,0.06266285197538235,1029.9976484775543,386.93570947647095,1287.3515892028809,46111,5818,40293,40293,0,11,5869000.0
5869,5869999,21.548198622355212,38.27596372586877,0.06265821261327076,1030.1162462234497,386.99849581718445,1287.517837524414,46111,5818,40293,40293,0,11,5870000.0
5870,5870999,21.547702322344076,38.27438979793417,0.06264970167254547,1030.2429854869843,387.06264567375183,1287.6172485351562,46111,5818,40293,40293,0,11,5871000.0
5871,5871999,21.54751880332717,38.27471369671669,0.06262780733557483,1030.4607727527618,387.1260962486267,1287.8423957824707,46120,5819,40301,40301,0,11,5872000.0
5872,5872999,21.54729439042237,38.27362363190284,0.06260502923354794,1030.5842244625092,387.1893208026886,1287.9784660339355,46120,5819,40301,40301,0,11,5873000.0
5873,5873999,21.546967347234762,38.27249068416403,0.06258906543268916,1030.7140567302704,387.2521276473999,1288.0652465820312,46120,5819,40301,40301,0,11,5874000.0
5874,5874999,21.547236313520685,38.27193079107011,0.06255703604449492,1030.9431171417236,387.3152894973755,1288.3852005004883,46131,5820,40311,40311,0,11,5875000.0
5875,5875999,21.547172685620094,38.27097627256663,0.06253900460501594,1031.0605292320251,387.3784408569336,1288.6259117126465,46131,5820,40311,40311,0,11,5876000.0
5876,5876999,21.547123628483405,38.27048447144805,0.06252250697101025,1031.1746118068695,387.44049549102783,1288.7544288635254,46131,5820,40311,40311,0,11,5877000.0
5877,5877999,21.547751256817318,38.27028687209087,0.06249139289630745,1031.4012775421143,387.50364899635315,1289.1057205200195,46139,5821,40318,40318,0,11,5878000.0
5878,5878999,21.548501356350144,38.27029311790843,0.06247031752383003,1031.517970085144,387.5660653114319,1289.2423973083496,46139,5821,40318,40318,0,11,5879000.0
5879,5879999,21.549124517657553,38.269989810939464,0.062449948805769484,1031.7583162784576,387.6284210681915,1289.3006286621094,46149,5822,40327,40327,0,11,5880000.0
5880,5880999,21.55008328843007,38.270399566949706,0.06243581208615823,1032.0935318470001,387.69072341918945,1289.3949546813965,46166,5824,40342,40342,0,11,5881000.0
5881,5881999,21.550567551858084,38.2697954813646,0.06242863014867028,1032.2115893363953,387.75155234336853,1289.4756317138672,46166,5824,40342,40342,0,11,5882000.0
5882,5882999,21.55091220501629,38.26905112446942,0.06242673203366467,1032.66122508049,387.8135895729065,1289.3572311401367,46196,5827,40369,40369,0,11,5883000.0
5883,5883999,21.551559046071667,38.26966287748385,0.06240506448022487,1032.773116827011,387.8750321865082,1289.5359840393066,46198,5827,40371,40371,0,11,5884000.0
5884,5884999,21.551395622022252,38.270308205585515,0.06239085193422411,1033.2086300849915,387.93677496910095,1289.756549835205,46233,5830,40403,40403,0,11,5885000.0
5885,5885999,21.549883472404854,38.26782417073425,0.06239348069166062,1033.3270061016083,388.002179145813,1290.0265655517578,46236,5830,40406,40406,0,11,5886000.0
5886,5886999,21.548554232659704,38.265770407725455,0.062395911686790484,1033.4604687690735,388.0681881904602,1290.191692352295,46236,5830,40406,40406,0,11,5887000.0
5887,5887999,21.547313147615952,38.26377787359584,0.0623987582279093,1033.5883264541626,388.1345064640045,1290.3255577087402,46237,5830,40407,40407,0,11,5888000.0
5888,5888999,21.54630989370309,38.26225895170006,0.06240027969222717,1033.711599111557,388.1976246833801,1290.417881011963,46237,5830,40407,40407,0,11,5889000.0
5889,5889999,21.545828079876582,38.26122335455477,0.06239145796967116,1033.8283250331879,388.2600541114807,1290.8187866210938,46240,5830,40410,40410,0,11,5890000.0
5890,5890999,21.545752130089166,38.2640954246014,0.06237459613393581,1034.0587542057037,388.32218647003174,1290.9457473754883,46242,5831,40411,40411,0,11,5891000.0
5891,5891999,21.54521855108945,38.26274682027826,0.06236925313265673,1034.2883303165436,388.3857214450836,1291.1155166625977,46255,5832,40423,40423,0,11,5892000.0
5892,5892999,21.544859225992404,38.26169275598681,0.06236007314719838,1034.4050998687744,388.44877219200134,1291.3683433532715,46256,5832,40424,40424,0,11,5893000.0
5893,5893999,21.544714730308737,38.26074852399127,0.06235306446620292,1034.64111328125,388.51196360588074,1291.4816055297852,46274,5833,40441,40441,0,11,5894000.0
5894,5894999,21.54457821344937,38.259697899594684,0.06234703433880662,1034.8722124099731,388.57535552978516,1291.5703353881836,46276,5834,40442,40442,0,11,5895000.0
5895,5895999,21.544310013990412,38.25823919449842,0.06233811619171603,1035.0920379161835,388.63815474510193,1291.8316116333008,46280,5835,40445,40445,0,11,5896000.0
5896,5896999,21.544633769827882,38.257979605989995,0.06233128397573939,1035.3214056491852,388.7010941505432,1291.9288520812988,46282,5836,40446,40446,0,11,5897000.0
5897,5897999,21.54502231062989,38.26049114012623,0.062323920778945885,1035.5583097934723,388.76412749290466,1292.020034790039,46289,5837,40452,40452,0,11,5898000.0
5898,5898999,21.545525471471187,38.260484678178955,0.062311180605870375,1035.794725894928,388.8280861377716,1292.3829612731934,46305,5838,40467,40467,0,11,5899000.0
5899,5899999,21.5458539455756,38.25976697867507,0.06231606592444505,1035.9109752178192,388.89056730270386,1292.548038482666,46305,5838,40467,40467,0,11,5900000.0
5900,5900999,21.54720051975422,38.26102774105058,0.062348021538337295,1036.0226352214813,388.9526734352112,1292.6820640563965,46305,5838,40467,40467,0,11,5901000.0
5901,5901999,21.54828230477175,38.26156574737584,0.06235091585684338,1036.2477021217346,389.0152654647827,1293.0505180358887,46320,5839,40481,40481,0,11,5902000.0
5902,5902999,21.549067521640197,38.261278554051145,0.06235981264031165,1036.4798839092255,389.0782787799835,1293.1835021972656,46322,5840,40482,40482,0,11,5903000.0
5903,5903999,21.54945815562709,38.260838973164894,0.06236630031858181,1036.5934851169586,389.13969016075134,1293.2845306396484,46322,5840,40482,40482,0,11,5904000.0
5904,5904999,21.55010363044358,38.26055516432462,0.06236792405099345,1036.8184068202972,389.204425573349,1293.7417755126953,46332,5841,40491,40491,0,11,5905000.0
5905,5905999,21.549439480155076,38.25897557839415,0.062369198441571405,1037.043327331543,389.2675211429596,1294.3180236816406,46369,5842,40527,40527,0,11,5906000.0
5906,5906999,21.5478021694506,38.25760033342757,0.062370234280405334,1037.2684750556946,389.33333468437195,1294.6753425598145,46383,5843,40540,40540,0,11,5907000.0
5907,5907999,21.546439217810967,38.25594076657036,0.06236746789832426,1037.3840119838715,389.39769077301025,1295.0105895996094,46386,5843,40543,40543,0,11,5908000.0
5908,5908999,21.545325200257643,38.254894772833566,0.06236974983649368,1037.498416185379,389.4596161842346,1295.1989860534668,46386,5843,40543,40543,0,11,5909000.0
5909,5909999,21.544038385956885,38.25285709680301,0.062371347849806025,1037.7421777248383,389.523814201355,1295.3523025512695,46391,5844,40547,40547,0,11,5910000.0
5910,5910999,21.542886476546784,38.25075367177396,0.06237401665367204,1037.8610072135925,389.585777759552,1295.6875381469727,46392,5844,40548,40548,0,11,5911000.0
5911,5911999,21.541679173457105,38.248601604754164,0.06237681199053413,1038.0929458141327,389.651193857193,1295.7924003601074,46394,5845,40549,40549,0,11,5912000.0
5912,5912999,21.54072831887721,38.247047904731524,0.0623779214720932,1038.3412539958954,389.7250220775604,1296.1016311645508,46408,5846,40562,40562,0,11,5913000.0
5913,5913999,21.53961502029519,38.24516307940504,0.06238326795777971,1038.5651535987854,389.78833079338074,1296.252773284912,46410,5847,40563,40563,0,11,5914000.0
5914,5914999,21.538903940047792,38.24614596627964,0.062377414391387664,1038.8995003700256,389.85192251205444,1296.3943786621094,46424,5849,40575,40575,0,11,5915000.0
5915,5915999,21.538062545328213,38.2447038812161,0.062390714495004995,1039.020010471344,389.9169874191284,1296.9049034118652,46431,5849,40582,40582,0,11,5916000.0
5916,5916999,21.537557620691274,38.24382374344763,0.06239750543775746,1039.3550038337708,389.98055696487427,1297.167911529541,46439,5851,40588,40588,0,11,5917000.0
5917,5917999,21.537183109270785,38.24270277331279,0.06239778022719633,1039.5810358524323,390.0435800552368,1297.3551292419434,46449,5852,40597,40597,0,11,5918000.0
5918,5918999,21.537133294681283,38.242553672952155,0.062396074332192186,1039.6999244689941,390.1069438457489,1297.8126373291016,46460,5852,40608,40608,0,11,5919000.0
5919,5919999,21.53760373132414,38.24428976402562,0.06237138949022569,1040.1441929340363,390.1733121871948,1298.0611305236816,46475,5855,40620,40620,0,11,5920000.0
5920,5920999,21.53807468568907,38.24433012256965,0.06237622059230241,1040.2572412490845,390.2378990650177,1298.2980690002441,46475,5855,40620,40620,0,11,5921000.0
5921,5921999,21.538733700536255,38.2446290529045,0.06237678698315696,1040.3757362365723,390.3036894798279,1298.8883323669434,46486,5855,40631,40631,0,11,5922000.0
5922,5922999,21.53916577647309,38.24451362574987,0.062382535223204694,1040.4928240776062,390.36657786369324,1299.1265335083008,46486,5855,40631,40631,0,11,5923000.0
5923,5923999,21.53930758033769,38.24423794896232,0.062388654516052355,1040.709229707718,390.4295246601105,1299.2349319458008,46488,5856,40632,40632,0,11,5924000.0
5924,5924999,21.539676956190096,38.24378622951049,0.062386940261137336,1040.822521686554,390.49325013160706,1299.6684379577637,46496,5856,40640,40640,0,11,5925000.0
5925,5925999,21.53914753632286,38.24232717045685,0.06239866074815792,1040.9471275806427,390.5572211742401,1300.151840209961,46506,5856,40650,40650,0,11,5926000.0
5926,5926999,21.537466070202324,38.239821366583335,0.0624067472263955,1041.058245420456,390.61976885795593,1300.436809539795,46510,5856,40654,40654,0,11,5927000.0
5927,5927999,21.536041334524214,38.23798313095432,0.06241039015610461,1041.311900138855,390.68508863449097,1300.664909362793,46516,5857,40659,40659,0,11,5928000.0
5928,5928999,21.534714550509673,38.236192927192135,0.06241396778341124,1041.540162563324,390.7496118545532,1300.7953987121582,46518,5858,40660,40660,0,11,5929000.0
5929,5929999,21.53360937254677,38.235429740977125,0.06241352535998934,1041.6784694194794,390.81601333618164,1300.925277709961,46518,5858,40660,40660,0,11,5930000.0
5930,5930999,21.532663699787662,38.23360878337165,0.06241078927918753,1041.7949604988098,390.87996315956116,1301.4139289855957,46523,5858,40665,40665,0,11,5931000.0
5931,5931999,21.531611228031522,38.231673158886295,0.06241004610332335,1042.0170500278473,390.9433169364929,1301.6113395690918,46525,5859,40666,40666,0,11,5932000.0
5932,5932999,21.530758886468895,38.23018896401618,0.06240596334931847,1042.1361153125763,391.00679993629456,1301.8546104431152,46528,5859,40669,40669,0,11,5933000.0
5933,5933999,21.529851487809637,38.22822746082402,0.06240598063177627,1042.2534205913544,391.07006335258484,1302.0199356079102,46528,5859,40669,40669,0,11,5934000.0
5934,5934999,21.529397332540476,38.22700360149396,0.062403476885342424,1042.6043977737427,391.13411688804626,1302.1923904418945,46533,5861,40672,40672,0,11,5935000.0
5935,5935999,21.52936630919687,38.22645193400464,0.06239865916252729,1042.7296681404114,391.19766569137573,1302.3139533996582,46533,5861,40672,40672,0,11,5936000.0
5936,5936999,21.529681782416315,38.22702405123343,0.06238760190674941,1043.0600500106812,391.2611184120178,1302.729476928711,46547,5863,40684,40684,0,11,5937000.0
5937,5937999,21.53022042931799,38.22744865440099,0.06238440132098633,1043.309002161026,391.33346819877625,1302.8960762023926,46549,5864,40685,40685,0,11,5938000.0
5938,5938999,21.530654682396516,38.22757810767247,0.06239152297119155,1043.427148103714,391.39932584762573,1303.0557594299316,46549,5864,40685,40685,0,11,5939000.0
5939,5939999,21.531357076932544,38.228015714413765,0.06238691672743801,1043.654286623001,391.4628233909607,1303.524787902832,46566,5865,40701,40701,0,11,5940000.0
5940,5940999,21.532114088331152,38.22854749799057,0.062396825138070544,1043.8875226974487,391.52755427360535,1303.7290802001953,46573,5866,40707,40707,0,11,5941000.0
5941,5941999,21.53342676755814,38.229738283862865,0.06239632230015446,1044.001085281372,391.59028244018555,1303.867073059082,46573,5866,40707,40707,0,11,5942000.0
5942,5942999,21.534503597972716,38.23034573069473,0.062394816147712695,1044.1315522193909,391.65335631370544,1304.4277954101562,46587,5866,40721,40721,0,11,5943000.0
5943,5943999,21.535239830232086,38.230470866368286,0.06239611537189016,1044.3558359146118,391.71887016296387,1304.5551528930664,46589,5867,40722,40722,0,11,5944000.0
5944,5944999,21.535861437165916,38.23049629924524,0.062392707672109915,1044.4846205711365,391.7838280200958,1304.8719520568848,46595,5867,40728,40728,0,11,5945000.0
5945,5945999,21.53628373817681,38.2299583782056,0.06239105093626407,1044.5981616973877,391.8454520702362,1305.1144676208496,46596,5867,40729,40729,0,11,5946000.0
5946,5946999,21.535111599281716,38.22820526360335,0.06239338928305749,1044.7166619300842,391.90828013420105,1305.7143020629883,46612,5867,40745,40745,0,11,5947000.0
5947,5947999,21.533864032682246,38.226465806296865,0.06239487550998868,1044.8356261253357,391.97245955467224,1306.0855560302734,46617,5867,40750,40750,0,11,5948000.0
5948,5948999,21.532876257004613,38.225388418097545,0.06239711850788754,1045.0678696632385,392.03822445869446,1306.2770690917969,46627,5868,40759,40759,0,11,5949000.0
5949,5949999,21.531844742756643,38.223566717988746,0.06240253988911115,1045.50275182724,392.10219383239746,1306.32080078125,46647,5871,40776,40776,0,11,5950000.0
5950,5950999,21.530868204685373,38.221680911876206,0.062407297513985105,1045.6219668388367,392.1656196117401,1306.6276893615723,46650,5871,40779,40779,0,11,5951000.0
5951,5951999,21.530279505014832,38.22111507005793,0.06240880896765755,1045.8450257778168,392.22815132141113,1306.8584480285645,46653,5872,40781,40781,0,11,5952000.0
5952,5952999,21.529211686449244,38.21933571246514,0.062409358849112695,1045.9610950946808,392.2902958393097,1307.020824432373,46653,5872,40781,40781,0,11,5953000.0
5953,5953999,21.52843338536803,38.21762547730117,0.06241257867571026,1046.407026052475,392.3541941642761,1307.3129386901855,46677,5875,40802,40802,0,11,5954000.0
5954,5954999,21.528058646074726,38.21686904992646,0.06241018513088625,1046.5287861824036,392.417195558548,1307.5271759033203,46678,5875,40803,40803,0,11,5955000.0
5955,5955999,21.52768650693811,38.21560670504952,0.06240949149515196,1046.8697261810303,392.4806318283081,1307.5921173095703,46689,5877,40812,40812,0,11,5956000.0
5956,5956999,21.527296916841355,38.214587370125166,0.062407734803650694,1047.1022624969482,392.5441982746124,1307.7948150634766,46694,5878,40816,40816,0,11,5957000.0
5957,5957999,21.527209629215992,38.213706512150125,0.06239914495304533,1047.4479916095734,392.60824060440063,1307.8927574157715,46709,5880,40829,40829,0,11,5958000.0
5958,5958999,21.527232023003247,38.21386627292324,0.06239056969970669,1047.6729350090027,392.670964717865,1307.9427032470703,46711,5881,40830,40830,0,11,5959000.0
5959,5959999,21.52749767058518,38.21406634357267,0.062389177687131925,1047.9108788967133,392.7336802482605,1308.0449180603027,46713,5882,40831,40831,0,11,5960000.0
5960,5960999,21.52759165612055,38.21347748957881,0.06238437246042783,1048.037733078003,392.7997934818268,1308.6985969543457,46722,5882,40840,40840,0,11,5961000.0
5961,5961999,21.52819780932585,38.214114711414815,0.06238232054405468,1048.150351524353,392.8628671169281,1308.9104461669922,46722,5882,40840,40840,0,11,5962000.0
5962,5962999,21.52872617684047,38.21385551709941,0.06237596952308233,1048.4841616153717,392.9261329174042,1309.2006530761719,46736,5884,40852,40852,0,11,5963000.0
5963,5963999,21.529232424824166,38.213391159452065,0.06237180189922076,1048.718073129654,392.98998498916626,1309.4046440124512,46740,5885,40855,40855,0,11,5964000.0
5964,5964999,21.529695305895167,38.21307180372704,0.06236432827718097,1048.8287315368652,393.05311465263367,1309.54252243042,46740,5885,40855,40855,0,11,5965000.0
5965,5965999,21.530476760161093,38.21294786040653,0.06235921198609007,1049.049949169159,393.11581540107727,1309.8781089782715,46771,5886,40885,40885,0,11,5966000.0
5966,5966999,21.53025062910296,38.21165746865787,0.062351790672041885,1049.1684687137604,393.177734375,1310.1116256713867,46771,5886,40885,40885,0,11,5967000.0
5967,5967999,21.529272443566622,38.21104796053931,0.06234658401146054,1049.288727760315,393.24084758758545,1310.531494140625,46782,5886,40896,40896,0,11,5968000.0
5968,5968999,21.527880538444727,38.2088293507423,0.062350329880998645,1049.4060270786285,393.3038020133972,1310.7832260131836,46786,5886,40900,40900,0,11,5969000.0
5969,5969999,21.52646725323329,38.20658565486678,0.062358212885131326,1049.7430474758148,393.367431640625,1310.8526725769043,46799,5888,40911,40911,0,11,5970000.0
5970,5970999,21.525549655544822,38.205002839727456,0.06236296973547806,1049.8694727420807,393.43104791641235,1310.9846687316895,46800,5888,40912,40912,0,11,5971000.0
5971,5971999,21.52464738065539,38.203719948275086,0.06236282674196936,1049.9894535541534,393.4947838783264,1311.297996520996,46802,5888,40914,40914,0,11,5972000.0
5972,5972999,21.524070848535295,38.20261895398739,0.062356804283888456,1050.3303866386414,393.5599262714386,1311.388744354248,46806,5890,40916,40916,0,11,5973000.0
5973,5973999,21.523578427032856,38.20438576124746,0.062340889878789496,1050.5568523406982,393.62256693840027,1311.5152397155762,46816,5891,40925,40925,0,11,5974000.0
5974,5974999,21.522974829048056,38.20280512190508,0.06233580608875666,1050.6732215881348,393.6854479312897,1311.9530906677246,46825,5891,40934,40934,0,11,5975000.0
5975,5975999,21.522676198223078,38.20162444261672,0.06233373806407072,1050.8939623832703,393.7482268810272,1312.1340675354004,46827,5892,40935,40935,0,11,5976000.0
5976,5976999,21.5227144794724,38.20143539949543,0.062332002879472936,1051.130853176117,393.81162214279175,1312.3664093017578,46829,5893,40936,40936,0,11,5977000.0
5977,5977999,21.52321616321779,38.202196661901816,0.06232810773833242,1051.4752268791199,393.87726879119873,1312.8708839416504,46852,5895,40957,40957,0,11,5978000.0
5978,5978999,21.524036219519257,38.20464630810169,0.06230521130912736,1051.58948969841,393.9402484893799,1313.4201354980469,46857,5895,40962,40962,0,11,5979000.0
5979,5979999,21.52464564410054,38.20517317252714,0.062305805151685933,1051.699269771576,394.0026683807373,1313.7006874084473,46857,5895,40962,40962,0,11,5980000.0
5980,5980999,21.52558559349931,38.20687680420452,0.06230322964594559,1051.8114531040192,394.0677297115326,1313.8854179382324,46857,5895,40962,40962,0,11,5981000.0
5981,5981999,21.526652497257956,38.20779763748908,0.062297039660580866,1051.923841714859,394.13098192214966,1314.6066856384277,46865,5895,40970,40970,0,11,5982000.0
5982,5982999,21.527776180454364,38.20893872465863,0.062316237382408435,1052.262542963028,394.1943986415863,1314.7579193115234,46898,5897,41001,41001,0,11,5983000.0
5983,5983999,21.529064824938157,38.210129171592065,0.062311257668518416,1052.3813602924347,394.2574498653412,1315.2233390808105,46910,5897,41013,41013,0,11,5984000.0
5984,5984999,21.53043529581076,38.21143228920745,0.0623142372055524,1052.4971334934235,394.3201208114624,1315.5156631469727,46912,5897,41015,41015,0,11,5985000.0
5985,5985999,21.531936302710182,38.21290097384341,0.06232007634222936,1052.6115293502808,394.38259077072144,1315.6767921447754,46912,5897,41015,41015,0,11,5986000.0
5986,5986999,21.533571016366135,38.21495764922713,0.06233999518450284,1052.846061706543,394.444616317749,1315.889720916748,46920,5898,41022,41022,0,11,5987000.0
5987,5987999,21.534116857535643,38.21485992216497,0.0623326087544106,1052.9589393138885,394.5088677406311,1316.0506057739258,46920,5898,41022,41022,0,11,5988000.0
5988,5988999,21.533009315441717,38.21334247157583,0.062327732643339906,1053.0793232917786,394.5722689628601,1316.6243476867676,46932,5898,41034,41034,0,11,5989000.0
5989,5989999,21.531583373092804,38.21155255873794,0.06233019611388757,1053.3032250404358,394.63636350631714,1317.0358200073242,46945,5899,41046,41046,0,11,5990000.0
5990,5990999,21.53036256102331,38.210292552575126,0.062333479930772207,1053.7674407958984,394.70144033432007,1317.188320159912,46969,5902,41067,41067,0,11,5991000.0
5991,5991999,21.529178617743565,38.208388351889894,0.062340927325789774,1053.9966611862183,394.76650166511536,1317.3819618225098,46973,5903,41070,41070,0,11,5992000.0
5992,5992999,21.528109490243818,38.20665112933387,0.06234244277514722,1054.11226272583,394.8294851779938,1317.9869842529297,46984,5903,41081,41081,0,11,5993000.0
5993,5993999,21.52700884980084,38.20468517492259,0.06234463777901533,1054.4429473876953,394.8933300971985,1318.1582679748535,46989,5905,41084,41084,0,11,5994000.0
5994,5994999,21.52595007338262,38.20251583898852,0.062348469560365105,1054.6804602146149,394.95685267448425,1318.3721809387207,47002,5906,41096,41096,0,11,5995000.0
5995,5995999,21.525435338161603,38.20159587078454,0.06234983558536489,1054.7972350120544,395.01979088783264,1318.5401611328125,47002,5906,41096,41096,0,11,5996000.0
5996,5996999,21.524786922886978,38.20033997669619,0.062350385220646065,1055.0413019657135,395.08437395095825,1318.6377029418945,47013,5907,41106,41106,0,11,5997000.0
5997,5997999,21.524314666120866,38.19925039121597,0.062356204294206075,1055.3898775577545,395.1483750343323,1319.1687202453613,47027,5909,41118,41118,0,11,5998000.0
5998,5998999,21.52375281699525,38.19796752992104,0.06237075038194906,1055.6154062747955,395.2123124599457,1319.5190315246582,47032,5910,41122,41122,0,11,5999000.0
5999,5999999,21.52323627221055,38.19689178010346,0.06237709521675949,1055.73166680336,395.27679443359375,1319.730381011963,47032,5910,41122,41122,0,11,6000000.0
6000,6000999,21.52335936052741,38.19645388933061,0.06236423105362099,1055.8571424484253,395.34344935417175,1320.286434173584,47042,5910,41132,41132,0,11,6001000.0
6001,6001999,21.523459119147823,38.1955986547634,0.06234731381916159,1056.0908150672913,395.406702041626,1320.425693511963,47053,5911,41142,41142,0,11,6002000.0
6002,6002999,21.5235040190451,38.19420593466257,0.06233154643673111,1056.3363666534424,395.47138833999634,1320.7975769042969,47071,5912,41159,41159,0,11,6003000.0
6003,6003999,21.523452100597233,38.19296956502907,0.06231493635275798,1056.5597126483917,395.5349578857422,1320.9768867492676,47075,5913,41162,41162,0,11,6004000.0
6004,6004999,21.52332758110266,38.191331156552955,0.062296953493959695,1056.8900032043457,395.59744906425476,1321.2179412841797,47082,5915,41167,41167,0,11,6005000.0
6005,6005999,21.52229298196057,38.1900233680284,0.06230172630346842,1057.0093581676483,395.65802359580994,1321.7223052978516,47091,5915,41176,41176,0,11,6006000.0
6006,6006999,21.520975580132642,38.18841356047437,0.06230755814119038,1057.3547310829163,395.7222671508789,1322.011074066162,47105,5917,41188,41188,0,11,6007000.0
6007,6007999,21.520105656768866,38.19479928876443,0.062282800261557636,1057.5919981002808,395.786657333374,1322.1054000854492,47107,5918,41189,41189,0,11,6008000.0
6008,6008999,21.51963209687193,38.19764799339515,0.0622610906428962,1057.9255304336548,395.85097646713257,1322.4891090393066,47122,5920,41202,41202,0,11,6009000.0
6009,6009999,21.51860128462249,38.19601856034651,0.06225747519144098,1058.2553675174713,395.91322898864746,1322.6575393676758,47133,5922,41211,41211,0,11,6010000.0
6010,6010999,21.51762719817534,38.19457110081167,0.06224716379860096,1058.5874454975128,395.9753680229187,1322.8531036376953,47153,5924,41229,41229,0,11,6011000.0
6011,6011999,21.516559705209254,38.19265595414611,0.06225022550721648,1058.8110160827637,396.0375168323517,1323.2313194274902,47167,5925,41242,41242,0,11,6012000.0
6012,6012999,21.51582026980095,38.19131494406312,0.0622455666249474,1059.035019159317,396.1004719734192,1323.405429840088,47169,5926,41243,41243,0,11,6013000.0
6013,6013999,21.515231676421845,38.19004123766804,0.062244135810871626,1059.2688574790955,396.16395020484924,1323.5317840576172,47171,5927,41244,41244,0,11,6014000.0
6014,6014999,21.51471366177,38.188776056894795,0.062241123212257055,1059.3982923030853,396.2277662754059,1323.9413223266602,47173,5927,41246,41246,0,11,6015000.0
6015,6015999,21.514075737886774,38.187451460447456,0.062239151638690426,1059.632657289505,396.29609847068787,1324.1026611328125,47183,5928,41255,41255,0,11,6016000.0
6016,6016999,21.513415636636775,38.18586063269516,0.062237641874808625,1059.8657929897308,396.35916662216187,1324.2273025512695,47186,5929,41257,41257,0,11,6017000.0
6017,6017999,21.513213160810484,38.18507943113702,0.062227767319992355,1060.2345921993256,396.43070793151855,1324.5583229064941,47202,5931,41271,41271,0,11,6018000.0
6018,6018999,21.513272338405304,38.18570917269346,0.06221328883247235,1060.371664762497,396.5008952617645,1324.7969436645508,47204,5931,41273,41273,0,11,6019000.0
6019,6019999,21.51323009224209,38.18463831558137,0.06220708042127898,1060.4944670200348,396.5632703304291,1324.9075965881348,47204,5931,41273,41273,0,11,6020000.0
6020,6020999,21.513612058629384,38.184428174798185,0.06219746821775318,1060.744086265564,396.6300084590912,1325.213176727295,47222,5932,41290,41290,0,11,6021000.0
6021,6021999,21.51368362680567,38.18371130202587,0.062191900467254535,1060.9674921035767,396.690660238266,1325.3100967407227,47229,5933,41296,41296,0,11,6022000.0
6022,6022999,21.51351660372236,38.18242133754746,0.062188809708863646,1061.3009705543518,396.75289130210876,1325.293041229248,47248,5935,41313,41313,0,11,6023000.0
6023,6023999,21.51328020369738,38.180869655976494,0.0621795745660072,1061.53253865242,396.8180477619171,1325.4947547912598,47252,5936,41316,41316,0,11,6024000.0
6024,6024999,21.512731499625804,38.17937326465428,0.06217399260353951,1061.9791679382324,396.8806777000427,1325.8095626831055,47278,5939,41339,41339,0,11,6025000.0
6025,6025999,21.511572827557558,38.17880843108568,0.06216959961408153,1062.0951933860779,396.9429886341095,1326.1154441833496,47281,5939,41342,41342,0,11,6026000.0
6026,6026999,21.51002839612071,38.17639540904736,0.06217652674057483,1062.3308379650116,397.00771260261536,1326.4179191589355,47288,5940,41348,41348,0,11,6027000.0
6027,6027999,21.508528537143462,38.1746827800304,0.06218130147698109,1062.6737568378448,397.07196950912476,1326.5324440002441,47298,5942,41356,41356,0,11,6028000.0
6028,6028999,21.507073818452717,38.172523094338494,0.062189387272189145,1062.8033111095428,397.1358835697174,1326.6717071533203,47299,5942,41357,41357,0,11,6029000.0
6029,6029999,21.50579978255066,38.17078563475459,0.0621902434660504,1062.9191660881042,397.20163083076477,1327.0200309753418,47302,5942,41360,41360,0,11,6030000.0
6030,6030999,21.50477112069246,38.169749125154254,0.06219367091292827,1063.1660540103912,397.2662298679352,1327.2825317382812,47309,5943,41366,41366,0,11,6031000.0
6031,6031999,21.503781253843073,38.1677671112471,0.06219470710603747,1063.496898651123,397.3292353153229,1327.3967590332031,47322,5945,41377,41377,0,11,6032000.0
6032,6032999,21.50268659578063,38.16565981527972,0.06219450710036023,1063.6138389110565,397.3925840854645,1327.8743896484375,47328,5945,41383,41383,0,11,6033000.0
6033,6033999,21.50189855707735,38.163940135494876,0.06219434170383331,1064.0641829967499,397.45743346214294,1327.9595565795898,47335,5948,41387,41387,0,11,6034000.0
6034,6034999,21.501153710443727,38.16250493805496,0.06219375291589857,1064.1867592334747,397.52058029174805,1328.1562232971191,47335,5948,41387,41387,0,11,6035000.0
6035,6035999,21.500579806819005,38.16090943043346,0.06218633192266532,1064.5228416919708,397.5836217403412,1328.3547439575195,47352,5950,41402,41402,0,11,6036000.0
6036,6036999,21.500192032225232,38.159683730614084,0.06217483858308315,1064.8649179935455,397.64655661582947,1328.3810081481934,47369,5952,41417,41417,0,11,6037000.0
6037,6037999,21.49965470625027,38.15859898839679,0.06217017548194381,1065.2132160663605,397.71087312698364,1328.453311920166,47386,5954,41432,41432,0,11,6038000.0
6038,6038999,21.49933452977991,38.157357215172524,0.06215952797745261,1065.445514202118,397.7739987373352,1328.9055671691895,47399,5955,41444,41444,0,11,6039000.0
6039,6039999,21.498903636445476,38.155937087788715,0.062153968361806644,1065.6670489311218,397.8371741771698,1329.1294136047363,47402,5956,41446,41446,0,11,6040000.0
6040,6040999,21.498400901696236,38.154365394750705,0.06214789276266708,1065.7817375659943,397.9007740020752,1329.3293838500977,47402,5956,41446,41446,0,11,6041000.0
6041,6041999,21.498433071632313,38.15346105123838,0.062128068387362845,1066.1325931549072,397.96419882774353,1329.8460502624512,47433,5958,41475,41475,0,11,6042000.0
6042,6042999,21.498097719214257,38.151994326783395,0.0621158648254404,1066.3533236980438,398.02743792533875,1330.1044082641602,47442,5959,41483,41483,0,11,6043000.0
6043,6043999,21.497611809610596,38.15046461641735,0.06211199850893345,1066.5754017829895,398.0901963710785,1330.2518997192383,47451,5960,41491,41491,0,11,6044000.0
6044,6044999,21.497450190813105,38.14913814249086,0.062099848243486355,1067.0290501117706,398.15417313575745,1330.5658798217773,47480,5963,41517,41517,0,11,6045000.0
6045,6045999,21.496611779696163,38.14708122707932,0.06210322773251009,1067.255532503128,398.2178738117218,1331.0058479309082,47491,5964,41527,41527,0,11,6046000.0
6046,6046999,21.495284657790833,38.146138101145645,0.06210965646823163,1067.5944497585297,398.2831542491913,1331.2243766784668,47504,5966,41538,41538,0,11,6047000.0
6047,6047999,21.493800131740862,38.14458528531427,0.06211733396101793,1067.7240614891052,398.3506615161896,1331.550796508789,47508,5966,41542,41542,0,11,6048000.0
6048,6048999,21.492304112062012,38.14221469086342,0.062130963865925426,1067.9560635089874,398.4161100387573,1331.669101715088,47515,5967,41548,41548,0,11,6049000.0
6049,6049999,21.490986177674472,38.14018853544411,0.06214124555434608,1068.1962583065033,398.4799370765686,1331.772315979004,47518,5968,41550,41550,0,11,6050000.0
6050,6050999,21.48955252130135,38.13776543562199,0.062153228923122916,1068.5414888858795,398.5429685115814,1331.9700927734375,47532,5970,41562,41562,0,11,6051000.0
6051,6051999,21.48814637042788,38.13553975456642,0.06216831262310507,1068.7712364196777,398.60661029815674,1332.0839004516602,47534,5971,41563,41563,0,11,6052000.0
6052,6052999,21.486854515745186,38.13319606434004,0.06218339945295004,1069.120801448822,398.67146396636963,1332.2662506103516,47542,5973,41569,41569,0,11,6053000.0
6053,6053999,21.485792133455238,38.13104826011881,0.06218950999416961,1069.2378387451172,398.7343075275421,1332.453239440918,47542,5973,41569,41569,0,11,6054000.0
6054,6054999,21.485088212647707,38.12925199366319,0.06218982090759717,1069.4701328277588,398.7978444099426,1332.5746307373047,47544,5974,41570,41570,0,11,6055000.0
6055,6055999,21.484356050315643,38.127331745167126,0.062192375431068814,1069.7041606903076,398.8613851070404,1332.6392784118652,47546,5975,41571,41571,0,11,6056000.0
6056,6056999,21.48343193829906,38.12542373594385,0.06219375264164717,1069.9400963783264,398.9281826019287,1333.329990386963,47566,5976,41590,41590,0,11,6057000.0
6057,6057999,21.4823998266873,38.12351341619898,0.06219804715955879,1070.1620888710022,398.9921877384186,1333.5270309448242,47568,5977,41591,41591,0,11,6058000.0
6058,6058999,21.481183531038518,38.12125326853138,0.062204970969370055,1070.4946324825287,399.0553665161133,1333.6889114379883,47599,5979,41620,41620,0,11,6059000.0
6059,6059999,21.48061427948813,38.11981848563392,0.062194280525850965,1070.6209089756012,399.12155532836914,1334.220272064209,47607,5979,41628,41628,0,11,6060000.0
6060,6060999,21.480173085005937,38.11852529314515,0.062186684739619746,1070.7405195236206,399.1853232383728,1334.3858795166016,47607,5979,41628,41628,0,11,6061000.0
6061,6061999,21.479802116950538,38.11698550492559,0.06217169358896302,1070.86088347435,399.2497205734253,1334.7303771972656,47617,5979,41638,41638,0,11,6062000.0
6062,6062999,21.47979418051485,38.11616744161823,0.06216196006877295,1071.0865423679352,399.3118324279785,1334.9921112060547,47626,5980,41646,41646,0,11,6063000.0
6063,6063999,21.479441806578578,38.1151784204215,0.062155613028510914,1071.3179371356964,399.3767433166504,1335.0984573364258,47635,5981,41654,41654,0,11,6064000.0
6064,6064999,21.479205931989103,38.11394178027382,0.062150050830639625,1071.4257850646973,399.43862414360046,1335.368019104004,47638,5981,41657,41657,0,11,6065000.0
6065,6065999,21.478894064812707,38.112207413940915,0.06213951884189983,1071.5452597141266,399.50025844573975,1335.5553665161133,47638,5981,41657,41657,0,11,6066000.0
6066,6066999,21.477572873535454,38.1099366557982,0.06215266181065249,1071.7773365974426,399.5630440711975,1335.8702507019043,47649,5982,41667,41667,0,11,6067000.0
6067,6067999,21.476075136172536,38.10756949480911,0.062163230588045515,1071.89981174469,399.6288938522339,1336.1582489013672,47653,5982,41671,41671,0,11,6068000.0
6068,6068999,21.47484271979599,38.10584194192327,0.062171793846148016,1072.1413969993591,399.6958713531494,1336.229133605957,47657,5983,41674,41674,0,11,6069000.0
6069,6069999,21.473574903423312,38.103714383862695,0.06218273769686389,1072.3770549297333,399.76030135154724,1336.3488388061523,47667,5984,41683,41683,0,11,6070000.0
6070,6070999,21.472619335029012,38.10204651946337,0.0621899351070323,1072.6125597953796,399.82408475875854,1336.564811706543,47674,5985,41689,41689,0,11,6071000.0
6071,6071999,21.47162004556749,38.100000771744725,0.062196924822570665,1072.8512547016144,399.8879933357239,1336.7383766174316,47677,5986,41691,41691,0,11,6072000.0
6072,6072999,21.47067157602832,38.09828741502028,0.06220297769090466,1073.083767414093,399.9509434700012,1336.8315963745117,47681,5987,41694,41694,0,11,6073000.0
6073,6073999,21.470008128384034,38.09665671130966,0.0622054463222359,1073.3102955818176,400.01476788520813,1337.1337432861328,47690,5988,41702,41702,0,11,6074000.0
6074,6074999,21.469695418687717,38.09535948931413,0.062204862253352644,1073.563737154007,400.0804398059845,1337.2563438415527,47692,5989,41703,41703,0,11,6075000.0
6075,6075999,21.469229678968365,38.094133665069485,0.06220463019059563,1073.7950382232666,400.1447606086731,1337.338150024414,47698,5990,41708,41708,0,11,6076000.0
6076,6076999,21.468887360354497,38.092699495404766,0.062196531362595175,1073.9171633720398,400.2075033187866,1337.8021926879883,47699,5990,41709,41709,0,11,6077000.0
6077,6077999,21.46837586330796,38.09108709390339,0.06219420971409528,1074.1446449756622,400.2685811519623,1337.953815460205,47704,5991,41713,41713,0,11,6078000.0
6078,6078999,21.467745963126806,38.08936457286359,0.06219454794242607,1074.575492143631,400.3311450481415,1337.9759826660156,47713,5994,41719,41719,0,11,6079000.0
6079,6079999,21.46753770534706,38.08785993303727,0.06218331361326168,1074.8085856437683,400.3943495750427,1338.3649253845215,47715,5995,41720,41720,0,11,6080000.0
6080,6080999,21.467688290859748,38.086595171484426,0.06216547568878994,1075.0273172855377,400.45721673965454,1338.5373229980469,47721,5996,41725,41725,0,11,6081000.0
6081,6081999,21.467577930777917,38.08502539925998,0.0621510650725392,1075.366037607193,400.5204322338104,1338.6239700317383,47732,5998,41734,41734,0,11,6082000.0
6082,6082999,21.468178303200666,38.08401888771213,0.06211762981891733,1075.6077377796173,400.5835163593292,1338.8533630371094,47742,5999,41743,41743,0,11,6083000.0
6083,6083999,21.468486729250948,38.08361520040696,0.06209422434284595,1076.0615558624268,400.64639830589294,1338.8791999816895,47752,6002,41750,41750,0,11,6084000.0
6084,6084999,21.46871691372548,38.08226419988875,0.062072656386130465,1076.2943646907806,400.7084996700287,1339.0693855285645,47761,6003,41758,41758,0,11,6085000.0
6085,6085999,21.468650502227668,38.08066901592939,0.06205597372186067,1076.4132776260376,400.76871967315674,1339.2466773986816,47762,6003,41759,41759,0,11,6086000.0
6086,6086999,21.467677334576976,38.078650423302754,0.06205726591025429,1076.6526782512665,400.8324146270752,1339.7682495117188,47790,6004,41786,41786,0,11,6087000.0
6087,6087999,21.466108337715927,38.07639460862052,0.062062640054204476,1076.7794637680054,400.8974440097809,1340.3380279541016,47811,6004,41807,41807,0,11,6088000.0
6088,6088999,21.464628039948153,38.074838147345716,0.06205964595980362,1077.0119438171387,400.96117424964905,1340.5317497253418,47825,6005,41820,41820,0,11,6089000.0
6089,6089999,21.463401481706327,38.07302758290415,0.06206415055460979,1077.2446119785309,401.0259790420532,1340.8830032348633,47846,6006,41840,41840,0,11,6090000.0
6090,6090999,21.46218800997624,38.07085910181563,0.062064951614598796,1077.5927064418793,401.0903582572937,1341.2333450317383,47861,6008,41853,41853,0,11,6091000.0
6091,6091999,21.461075158703085,38.068821645027256,0.062059410216849575,1077.9395303726196,401.1534242630005,1341.3903923034668,47881,6010,41871,41871,0,11,6092000.0
6092,6092999,21.45998202368914,38.068104913348606,0.06205308904341933,1078.293776512146,401.21846294403076,1341.5315895080566,47887,6012,41875,41875,0,11,6093000.0
6093,6093999,21.459239151582832,38.06639900469889,0.062047496208953334,1078.7558183670044,401.28268003463745,1341.74019241333,47916,6015,41901,41901,0,11,6094000.0
6094,6094999,21.458374063369686,38.064399032733995,0.06204223641123219,1078.8784337043762,401.3457760810852,1341.95698928833,47917,6015,41902,41902,0,11,6095000.0
6095,6095999,21.457689434645307,38.06265078289908,0.06203848969172665,1079.0058212280273,401.41066122055054,1342.1230163574219,47918,6015,41903,41903,0,11,6096000.0
6096,6096999,21.45725532901032,38.06098542360152,0.06202884712386669,1079.2426130771637,401.4739487171173,1342.295799255371,47929,6016,41913,41913,0,11,6097000.0
6097,6097999,21.457086822841287,38.059350113734595,0.06201352327159837,1079.4733381271362,401.5362317562103,1342.426357269287,47934,6017,41917,41917,0,11,6098000.0
6098,6098999,21.45611234360629,38.05764390541164,0.0620186423630964,1079.8154323101044,401.60052156448364,1342.4601669311523,47939,6019,41920,41920,0,11,6099000.0
6099,6099999,21.45543504452255,38.056168952121865,0.06201475338805762,1079.9431869983673,401.6635537147522,1342.6791610717773,47941,6019,41922,41922,0,11,6100000.0
6100,6100999,21.456293137015216,38.055676060858154,0.06194778772442111,1080.1742150783539,401.72721433639526,1343.0015182495117,47948,6020,41928,41928,0,11,6101000.0
6101,6101999,21.456305747874,38.05443677541645,0.0619235537027526,1080.4125077724457,401.7901463508606,1343.1542854309082,47950,6021,41929,41929,0,11,6102000.0
6102,6102999,21.456329323416497,38.05316714323133,0.06189421685796914,1080.5282018184662,401.8542721271515,1343.655616760254,47964,6021,41943,41943,0,11,6103000.0
6103,6103999,21.456519758256256,38.05227913341492,0.061870290346205836,1080.6464579105377,401.9164617061615,1343.9638328552246,47966,6021,41945,41945,0,11,6104000.0
6104,6104999,21.456259615518917,38.05167852353401,0.061858759142130015,1080.9822099208832,401.9797954559326,1344.0199356079102,47980,6023,41957,41957,0,11,6105000.0
6105,6105999,21.456111729987207,38.05013392307959,0.06183997326343926,1081.2057673931122,402.04267382621765,1344.4334831237793,47997,6024,41973,41973,0,11,6106000.0
6106,6106999,21.455891520544686,38.0486272333206,0.06182041210517142,1081.4430265426636,402.1079173088074,1344.677230834961,48001,6025,41976,41976,0,11,6107000.0
6107,6107999,21.455097211456387,38.047193580484134,0.0618146588713363,1081.5693368911743,402.1699466705322,1345.1359596252441,48014,6025,41989,41989,0,11,6108000.0
6108,6108999,21.453861049936158,38.04601874490338,0.06181181490655441,1081.9195392131805,402.2339632511139,1345.3468627929688,48021,6027,41994,41994,0,11,6109000.0
6109,6109999,21.45247288573024,38.043804977176485,0.06181502452959897,1082.1500024795532,402.2974970340729,1345.4545288085938,48030,6028,42002,42002,0,11,6110000.0
6110,6110999,21.451179903338232,38.04152795714267,0.06182316649772723,1082.602988243103,402.3622534275055,1345.4809074401855,48047,6031,42016,42016,0,11,6111000.0
6111,6111999,21.45042505045381,38.040032866151364,0.061816084281934414,1082.954375743866,402.4263696670532,1345.7456855773926,48064,6033,42031,42031,0,11,6112000.0
6112,6112999,21.44972473643473,38.03855778907726,0.06180863165634809,1083.2951030731201,402.49025225639343,1345.94136428833,48070,6035,42035,42035,0,11,6113000.0
6113,6113999,21.448868434806453,38.036880451247065,0.061809616561378955,1083.5234587192535,402.55337047576904,1346.146369934082,48081,6036,42045,42045,0,11,6114000.0
6114,6114999,21.44833994146722,38.035273056092784,0.061797370782829986,1083.7599413394928,402.6164810657501,1346.4745788574219,48097,6037,42060,42060,0,11,6115000.0
6115,6115999,21.44761178751771,38.03345836731082,0.06178977387065143,1084.0969080924988,402.67965292930603,1346.591552734375,48109,6039,42070,42070,0,11,6116000.0
6116,6116999,21.447098189677764,38.032173716862,0.06178370101110853,1084.4404242038727,402.74321246147156,1346.6658668518066,48128,6041,42087,42087,0,11,6117000.0
6117,6117999,21.446645389797563,38.03065077909544,0.06176918429822742,1084.7935583591461,402.8077609539032,1347.2361068725586,48154,6043,42111,42111,0,11,6118000.0
6118,6118999,21.446967148790694,38.02967444602897,0.06173772560918711,1085.0153007507324,402.86981225013733,1347.6173782348633,48163,6044,42119,42119,0,11,6119000.0
6119,6119999,21.44705581672016,38.02869069941673,0.0617145231749211,1085.2423191070557,402.9351336956024,1347.8260955810547,48165,6045,42120,42120,0,11,6120000.0
6120,6120999,21.447072398246057,38.02750493704177,0.061691412511104216,1085.3596634864807,402.9997901916504,1348.3285827636719,48171,6045,42126,42126,0,11,6121000.0
6121,6121999,21.447465343146153,38.02700762852887,0.06165030720773146,1085.476184129715,403.0633544921875,1348.9344329833984,48177,6045,42132,42132,0,11,6122000.0
6122,6122999,21.447596401549696,38.02622186885676,0.06162312318463592,1085.8163084983826,403.12714433670044,1349.1021461486816,48188,6047,42141,42141,0,11,6123000.0
6123,6123999,21.447644389246207,38.02519902250932,0.06160464576774205,1086.0435228347778,403.1906204223633,1349.6552543640137,48206,6048,42158,42158,0,11,6124000.0
6124,6124999,21.447575737383573,38.0240648769328,0.06158999839856716,1086.2677233219147,403.2529721260071,1349.9638710021973,48210,6049,42161,42161,0,11,6125000.0
6125,6125999,21.447290588351848,38.0225900237733,0.06158514573389873,1086.373476266861,403.314683675766,1350.156494140625,48210,6049,42161,42161,0,11,6126000.0
6126,6126999,21.447104169329506,38.02122826595755,0.061578099819234344,1086.6015725135803,403.37724113464355,1350.5212860107422,48219,6050,42169,42169,0,11,6127000.0
6127,6127999,21.44686677136136,38.02017663806723,0.061565409323646736,1086.830807209015,403.4394268989563,1350.7470588684082,48246,6051,42195,42195,0,11,6128000.0
6128,6128999,21.445761318397313,38.018331987187594,0.06157353532817311,1086.9422273635864,403.5013675689697,1351.1612396240234,48253,6051,42202,42202,0,11,6129000.0
6129,6129999,21.44460296017608,38.016571477942065,0.06157957472652964,1087.0748312473297,403.56476283073425,1351.4660873413086,48254,6051,42203,42203,0,11,6130000.0
6130,6130999,21.443411286918977,38.01436716384984,0.0615884374769744,1087.209529876709,403.62837052345276,1351.668399810791,48255,6051,42204,42204,0,11,6131000.0
6131,6131999,21.442525122587163,38.01317174074631,0.06159357085330819,1087.3321223258972,403.6918134689331,1351.8375663757324,48256,6051,42205,42205,0,11,6132000.0
6132,6132999,21.441590787172846,38.01176381422682,0.061596785102393636,1087.4488744735718,403.75559520721436,1352.5151557922363,48263,6051,42212,42212,0,11,6133000.0
6133,6133999,21.440499330232388,38.00971685274935,0.06160216275900643,1087.6843931674957,403.82079100608826,1352.6778450012207,48272,6052,42220,42220,0,11,6134000.0
6134,6134999,21.439534375097264,38.008157492714666,0.06160385023795578,1087.9162366390228,403.88501024246216,1353.0339965820312,48286,6053,42233,42233,0,11,6135000.0
6135,6135999,21.438562271130703,38.00603404932091,0.061606615684216326,1088.0474390983582,403.9482877254486,1353.2114944458008,48287,6053,42234,42234,0,11,6136000.0
6136,6136999,21.43761215189155,38.00391336369692,0.061609905564042,1088.2814300060272,404.01125288009644,1353.2784843444824,48289,6054,42235,42235,0,11,6137000.0
6137,6137999,21.43719505687433,38.002137737011964,0.061603073533170516,1088.3994045257568,404.07511591911316,1353.8859329223633,48291,6054,42237,42237,0,11,6138000.0
6138,6138999,21.436861072605858,38.000564247584244,0.06159926780776315,1088.5164778232574,404.1393210887909,1354.1476020812988,48291,6054,42237,42237,0,11,6139000.0
6139,6139999,21.43631197518025,37.9987031373164,0.0615978717992417,1088.7516016960144,404.203622341156,1354.2888221740723,48302,6055,42247,42247,0,11,6140000.0
6140,6140999,21.435997088935594,37.997081899844865,0.06158583944041873,1089.2226107120514,404.2682936191559,1354.6881217956543,48323,6058,42265,42265,0,11,6141000.0
6141,6141999,21.43565810248731,37.995577734774855,0.06157805065418398,1089.4812269210815,404.33502221107483,1354.9144325256348,48331,6059,42272,42272,0,11,6142000.0
6142,6142999,21.43546389852372,37.99397242136488,0.061565634501223765,1089.599695444107,404.3979468345642,1355.303409576416,48338,6059,42279,42279,0,11,6143000.0
6143,6143999,21.43520301285506,37.99220804652006,0.06155608596039919,1089.7199971675873,404.46218395233154,1355.488052368164,48338,6059,42279,42279,0,11,6144000.0
6144,6144999,21.435047018873018,37.99227089648534,0.06154261874257094,1089.950824022293,404.52447986602783,1355.7900695800781,48344,6060,42284,42284,0,11,6145000.0
6145,6145999,21.43388408273677,37.99053039535671,0.06155360767581319,1090.0738470554352,404.58690786361694,1356.241111755371,48354,6060,42294,42294,0,11,6146000.0
6146,6146999,21.432607333577234,37.988784419898046,0.061568525725317014,1090.200127363205,404.6510798931122,1356.660041809082,48361,6060,42301,42301,0,11,6147000.0
6147,6147999,21.431620642726216,37.98747609262464,0.06157679953719353,1090.8720679283142,404.71545815467834,1356.6864929199219,48395,6065,42330,42330,0,11,6148000.0
6148,6148999,21.43046356040124,37.98554206138961,0.06158812787014656,1090.9929795265198,404.7788701057434,1357.0933074951172,48399,6065,42334,42334,0,11,6149000.0
6149,6149999,21.429268213284722,37.98367153587636,0.06159885370717766,1091.338537454605,404.84203910827637,1357.4249572753906,48440,6067,42373,42373,0,11,6150000.0
6150,6150999,21.428131527570702,37.98166436358941,0.06160435862721936,1091.573443889618,404.90573620796204,1357.679832458496,48449,6068,42381,42381,0,11,6151000.0
6151,6151999,21.426868988241864,37.9795414610728,0.06161187220570363,1091.9126386642456,404.96915555000305,1358.073013305664,48470,6070,42400,42400,0,11,6152000.0
6152,6152999,21.425992461579696,37.97853456280809,0.06161117444732611,1092.1561541557312,405.03253746032715,1358.291576385498,48475,6071,42404,42404,0,11,6153000.0
6153,6153999,21.424936516450586,37.97651882072786,0.061615422681541854,1092.50101852417,405.0964901447296,1358.481876373291,48493,6073,42420,42420,0,11,6154000.0
6154,6154999,21.424485236597512,37.975583291095845,0.06160790446156639,1092.7337765693665,405.15942311286926,1358.908592224121,48508,6074,42434,42434,0,11,6155000.0
6155,6155999,21.423750659463945,37.97408689432536,0.06160629963236408,1092.9627137184143,405.22293615341187,1359.1414794921875,48518,6075,42443,42443,0,11,6156000.0
6156,6156999,21.422711835369455,37.97198909017503,0.061607616359539374,1093.188912153244,405.2850775718689,1359.226463317871,48520,6076,42444,42444,0,11,6157000.0
6157,6157999,21.422181934706714,37.97056947329634,0.06160555777118071,1093.3133726119995,405.3515799045563,1359.5952987670898,48526,6076,42450,42450,0,11,6158000.0
6158,6158999,21.421771730427796,37.96927810412057,0.061593552866066936,1093.6687707901,405.41802501678467,1359.8712615966797,48549,6078,42471,42471,0,11,6159000.0
6159,6159999,21.42118612968597,37.96771634255336,0.061590409788585876,1093.9029257297516,405.483273267746,1360.1050033569336,48557,6079,42478,42478,0,11,6160000.0
6160,6160999,21.420965112171878,37.96656167429104,0.061580066584749904,1094.0273733139038,405.5459203720093,1360.5841369628906,48568,6079,42489,42489,0,11,6161000.0
6161,6161999,21.42050982337198,37.96493221936363,0.061573436765674616,1094.1547119617462,405.61129093170166,1360.75492477417,48569,6079,42490,42490,0,11,6162000.0
6162,6162999,21.420070691594795,37.9634641385703,0.06156784366041046,1094.2682495117188,405.6728949546814,1360.8922271728516,48570,6079,42491,42491,0,11,6163000.0
6163,6163999,21.419517951825288,37.96183067517011,0.061563091255195546,1094.3942019939423,405.7343957424164,1361.1198463439941,48572,6079,42493,42493,0,11,6164000.0
6164,6164999,21.418687560117203,37.95975875981705,0.06156417236816536,1094.9647798538208,405.797500371933,1361.2433052062988,48610,6083,42527,42527,0,11,6165000.0
6165,6165999,21.41752691369262,37.95904967141358,0.061569044085267866,1095.0880680084229,405.8607449531555,1361.642147064209,48619,6083,42536,42536,0,11,6166000.0
6166,6166999,21.4162884223458,37.95714141750819,0.0615801590265973,1095.327656030655,405.92562651634216,1362.023265838623,48635,6084,42551,42551,0,11,6167000.0
6167,6167999,21.41499618540398,37.95504683622872,0.06158941665775364,1095.4688353538513,405.99274134635925,1362.1859970092773,48636,6084,42552,42552,0,11,6168000.0
6168,6168999,21.4140291660062,37.953408601849354,0.06159276761233723,1095.7035582065582,406.0563611984253,1362.3439140319824,48642,6085,42557,42557,0,11,6169000.0
6169,6169999,21.41305486783844,37.95213335820348,0.061592804834783244,1095.8274791240692,406.11886405944824,1362.6733016967773,48648,6085,42563,42563,0,11,6170000.0
6170,6170999,21.41191766586825,37.950047052789934,0.061599150716872275,1096.1816620826721,406.18349146842957,1363.0607109069824,48663,6087,42576,42576,0,11,6171000.0
6171,6171999,21.410737785888784,37.9481542471304,0.06160574394448837,1096.4187512397766,406.2459282875061,1363.2215538024902,48665,6088,42577,42577,0,11,6172000.0
6172,6172999,21.410020014625793,37.946391213146946,0.06160547864493848,1096.540005683899,406.3084182739258,1363.465892791748,48667,6088,42579,42579,0,11,6173000.0
6173,6173999,21.40916312209619,37.94435346982637,0.0616025731454386,1096.781381368637,406.3712213039398,1363.6215782165527,48676,6089,42587,42587,0,11,6174000.0
6174,6174999,21.408679609991292,37.94514212579253,0.061592150964535075,1096.9142851829529,406.43603348731995,1363.7523574829102,48677,6089,42588,42588,0,11,6175000.0
6175,6175999,21.40817048009054,37.94348599717265,0.06158523310762909,1097.4873566627502,406.50093698501587,1363.8716011047363,48730,6093,42637,42637,0,11,6176000.0
6176,6176999,21.40802050447279,37.94246005989605,0.061573578356371006,1097.7338762283325,406.5646708011627,1364.1499633789062,48741,6094,42647,42647,0,11,6177000.0
6177,6177999,21.407562352281502,37.94112705783819,0.06156586337678294,1097.8569068908691,406.62689542770386,1364.3085861206055,48742,6094,42648,42648,0,11,6178000.0
6178,6178999,21.4078386573672,37.94065800035147,0.0615576794245013,1097.9688239097595,406.6893661022186,1364.6714324951172,48748,6094,42654,42654,0,11,6179000.0
6179,6179999,21.40817488647828,37.94024521282503,0.06154243985944008,1098.2008519172668,406.75334763526917,1364.8621826171875,48751,6095,42656,42656,0,11,6180000.0
6180,6180999,21.408536568356574,37.939858655513085,0.06154081799897171,1098.4500782489777,406.8161482810974,1364.9252548217773,48758,6096,42662,42662,0,11,6181000.0
6181,6181999,21.409317080663058,37.940291126526084,0.06153216074069179,1098.708826303482,406.8879051208496,1365.088954925537,48769,6097,42672,42672,0,11,6182000.0
6182,6182999,21.41011126095503,37.94038832609147,0.06151910740978073,1098.95143699646,406.9514992237091,1365.1631813049316,48771,6098,42673,42673,0,11,6183000.0
6183,6183999,21.410340062511608,37.93948589884402,0.06151013241800263,1099.1835701465607,407.01600885391235,1365.2336158752441,48773,6099,42674,42674,0,11,6184000.0
6184,6184999,21.41043527027786,37.93842942330154,0.06149719053392433,1099.3043427467346,407.077898979187,1365.4676551818848,48773,6099,42674,42674,0,11,6185000.0
6185,6185999,21.410095373741008,37.936933728953555,0.061489198660209854,1099.427375793457,407.1432857513428,1365.7904968261719,48782,6099,42683,42683,0,11,6186000.0
6186,6186999,21.408497158122653,37.9345334334834,0.06149924077878233,1099.5481214523315,407.20522594451904,1366.0790328979492,48785,6099,42686,42686,0,11,6187000.0
6187,6187999,21.407138740570907,37.933045936679,0.0615051157342007,1099.671569108963,407.26904344558716,1366.3952560424805,48789,6099,42690,42690,0,11,6188000.0
6188,6188999,21.405882443346652,37.93161471198501,0.06150946600680085,1099.9401242733002,407.33972573280334,1366.4829902648926,48797,6100,42697,42697,0,11,6189000.0
6189,6189999,21.404624614969325,37.92936683399527,0.0615135131336485,1100.0662965774536,407.40641236305237,1366.6401596069336,48798,6100,42698,42698,0,11,6190000.0
6190,6190999,21.403452945466977,37.92734156627454,0.06151226882765515,1100.302425146103,407.469042301178,1366.8631973266602,48811,6101,42710,42710,0,11,6191000.0
6191,6191999,21.402420663622777,37.925402734176124,0.061509978714960445,1100.6714458465576,407.53530263900757,1367.2808113098145,48835,6103,42732,42732,0,11,6192000.0
6192,6192999,21.4014028252651,37.92344455485949,0.061513518133957334,1100.9142034053802,407.6011414527893,1367.6239280700684,48844,6104,42740,42740,0,11,6193000.0
6193,6193999,21.40034883232934,37.921404381490774,0.06151523700142203,1101.2521917819977,407.66406655311584,1367.8804054260254,48888,6106,42782,42782,0,11,6194000.0
6194,6194999,21.399444795472768,37.9196549538529,0.061516287520433144,1101.6052119731903,407.7283229827881,1368.0245895385742,48893,6108,42785,42785,0,11,6195000.0
6195,6195999,21.39863544843299,37.91790266940137,0.06152213133679174,1101.8449170589447,407.7913284301758,1368.1640129089355,48895,6109,42786,42786,0,11,6196000.0
6196,6196999,21.39827613197966,37.91653299056611,0.061521964601580215,1101.9705548286438,407.85540556907654,1368.7341766357422,48903,6109,42794,42794,0,11,6197000.0
6197,6197999,21.397702761687206,37.9148700096151,0.06152473228723554,1102.0977046489716,407.9209759235382,1368.9421348571777,48904,6109,42795,42795,0,11,6198000.0
6198,6198999,21.397023514088538,37.91309462730916,0.06152955142868788,1102.331618309021,407.98576164245605,1369.0763473510742,48907,6110,42797,42797,0,11,6199000.0
6199,6199999,21.39678276368502,37.91198689607834,0.06153090071179834,1102.4528250694275,408.05048656463623,1369.6640739440918,48915,6110,42805,42805,0,11,6200000.0
6200,6200999,21.396773646987505,37.910901782650306,0.06153269447072629,1102.5733888149261,408.117112159729,1369.9461288452148,48916,6110,42806,42806,0,11,6201000.0
6201,6201999,21.396806500065672,37.91091834763995,0.06153399716665664,1102.6925165653229,408.18290066719055,1370.2338905334473,48923,6110,42813,42813,0,11,6202000.0
6202,6202999,21.396908099322957,37.90991804167671,0.06152380746830999,1102.9394373893738,408.24844098091125,1370.685157775879,48936,6111,42825,42825,0,11,6203000.0
6203,6203999,21.39696165359995,37.9088374260076,0.06152352874753131,1103.1726915836334,408.31326150894165,1370.8334655761719,48946,6112,42834,42834,0,11,6204000.0
6204,6204999,21.39679669254966,37.90741519629058,0.061521693619003726,1103.409455537796,408.37733459472656,1370.9890670776367,48959,6113,42846,42846,0,11,6205000.0
6205,6205999,21.3963626490699,37.90563172743303,0.06151809564357624,1103.532696723938,408.43957567214966,1371.1236381530762,48959,6113,42846,42846,0,11,6206000.0
6206,6206999,21.395253627576732,37.90331749046771,0.061528031404647576,1103.6527948379517,408.5042552947998,1371.4188995361328,48963,6113,42850,42850,0,11,6207000.0
6207,6207999,21.393908742181477,37.901061606731716,0.06153600792189873,1104.0023300647736,408.56756949424744,1371.6250038146973,48987,6115,42872,42872,0,11,6208000.0
6208,6208999,21.39266137126156,37.899104362738456,0.061540196510906475,1104.2372126579285,408.6315836906433,1371.7358894348145,48991,6116,42875,42875,0,11,6209000.0
6209,6209999,21.391450316668838,37.8968551153025,0.061547041337459585,1104.4699959754944,408.69614720344543,1371.8750114440918,49003,6117,42886,42886,0,11,6210000.0
6210,6210999,21.390555049702943,37.89518518806473,0.06154583815611703,1104.610951423645,408.76679134368896,1372.1608619689941,49008,6117,42891,42891,0,11,6211000.0
6211,6211999,21.38968463587723,37.893436354553735,0.06154853360579482,1104.8562202453613,408.83130383491516,1372.320598602295,49010,6118,42892,42892,0,11,6212000.0
6212,6212999,21.38874342294406,37.89175553691573,0.06155162400413883,1105.2375693321228,408.90169048309326,1372.3447036743164,49031,6120,42911,42911,0,11,6213000.0
6213,6213999,21.387998102370297,37.89024656881072,0.06154956075390072,1105.3691368103027,408.9688091278076,1372.7395706176758,49036,6120,42916,42916,0,11,6214000.0
6214,6214999,21.387133713459885,37.888409816578104,0.06154932945205682,1105.601625919342,409.0318019390106,1372.9123764038086,49038,6121,42917,42917,0,11,6215000.0
6215,6215999,21.38624876995004,37.88664038165899,0.061552204601306504,1105.8320400714874,409.0952913761139,1372.9596252441406,49048,6122,42926,42926,0,11,6216000.0
6216,6216999,21.385696773356916,37.88576065723385,0.061548740985174155,1106.068635225296,409.15860247612,1373.3125381469727,49053,6123,42930,42930,0,11,6217000.0
6217,6217999,21.38514210950972,37.88402996700847,0.06154174822887182,1106.4171159267426,409.2217388153076,1373.3934745788574,49062,6125,42937,42937,0,11,6218000.0
6218,6218999,21.38432589852096,37.88219531433124,0.061540800659868666,1106.765145778656,409.2853605747223,1373.4458656311035,49081,6127,42954,42954,0,11,6219000.0
6219,6219999,21.38357449623975,37.880421570227234,0.061536433937270485,1106.995432138443,409.34891963005066,1373.7385292053223,49089,6128,42961,42961,0,11,6220000.0
6220,6220999,21.382997635826204,37.87879369359768,0.06152885461794033,1107.2464909553528,409.4122202396393,1373.952033996582,49093,6129,42964,42964,0,11,6221000.0
6221,6221999,21.382437210225945,37.877405449349624,0.061525049819495026,1107.3614947795868,409.47466683387756,1374.1232109069824,49093,6129,42964,42964,0,11,6222000.0
6222,6222999,21.38194249584497,37.876014791669625,0.06151694308986111,1107.4761700630188,409.53712248802185,1374.5187377929688,49099,6129,42970,42970,0,11,6223000.0
6223,6223999,21.381459965146657,37.874416464016726,0.06150779620161784,1107.8250489234924,409.60259222984314,1374.6196365356445,49137,6131,43006,43006,0,11,6224000.0
6224,6224999,21.380784835479524,37.87277793537285,0.06150532693181032,1107.9608969688416,409.6698019504547,1374.771713256836,49137,6131,43006,43006,0,11,6225000.0
6225,6225999,21.380020883828102,37.870858238342564,0.06150429563641824,1108.313150882721,409.7328214645386,1375.0036888122559,49151,6133,43018,43018,0,11,6226000.0
6226,6226999,21.37914126186874,37.86877134479925,0.06150374128522962,1108.437891960144,409.79469871520996,1375.3024940490723,49155,6133,43022,43022,0,11,6227000.0
6227,6227999,21.37800640771878,37.867629220832754,0.06151214846072239,1108.6813821792603,409.8574812412262,1375.62939453125,49169,6134,43035,43035,0,11,6228000.0
6228,6228999,21.37664512777044,37.86562228276633,0.061520197143272504,1109.062572002411,409.92519092559814,1375.8924026489258,49182,6136,43046,43046,0,11,6229000.0
6229,6229999,21.375217398890246,37.86330062876306,0.06152891300406149,1109.2934608459473,409.990051984787,1376.1107902526855,49190,6137,43053,43053,0,11,6230000.0
6230,6230999,21.374162410366623,37.86285195504134,0.06154180049094027,1109.4246599674225,410.0543315410614,1376.304615020752,49190,6137,43053,43053,0,11,6231000.0
6231,6231999,21.372830353498774,37.86065036566373,0.06154640631643804,1109.5566141605377,410.120267868042,1376.6454544067383,49197,6137,43060,43060,0,11,6232000.0
6232,6232999,21.371835398562222,37.85885848134769,0.06155063179768294,1109.7956809997559,410.18301606178284,1376.9157447814941,49214,6138,43076,43076,0,11,6233000.0
6233,6233999,21.370869338914275,37.8573221260592,0.061552197623435,1110.038004875183,410.2479336261749,1377.2327270507812,49222,6139,43083,43083,0,11,6234000.0
6234,6234999,21.37020595453049,37.85601373510729,0.06154789109871761,1110.1632857322693,410.31357860565186,1377.5875129699707,49227,6139,43088,43088,0,11,6235000.0
6235,6235999,21.369597008009848,37.85468094459233,0.061544964910068,1110.286503791809,410.3775179386139,1377.7641906738281,49227,6139,43088,43088,0,11,6236000.0
6236,6236999,21.369227800035524,37.85399438353803,0.061539773262949016,1110.524994134903,410.43850541114807,1377.8832550048828,49230,6140,43090,43090,0,11,6237000.0
6237,6237999,21.36894251734802,37.853224735828185,0.06153071843247482,1110.97691822052,410.4994914531708,1377.96187210083,49255,6143,43112,43112,0,11,6238000.0
6238,6238999,21.36870937328542,37.85292375734454,0.06151647865007848,1111.220367193222,410.566579580307,1378.4565162658691,49266,6144,43122,43122,0,11,6239000.0
6239,6239999,21.36835592625143,37.85187819357453,0.06150865475885248,1111.4529082775116,410.6280663013458,1378.769962310791,49275,6145,43130,43130,0,11,6240000.0
6240,6240999,21.368037919052036,37.850958822017844,0.06149518176887869,1111.568743944168,410.68930172920227,1379.172275543213,49280,6145,43135,43135,0,11,6241000.0
6241,6241999,21.367890931038794,37.849902077929414,0.06147808793940723,1111.7084329128265,410.76228523254395,1379.4597434997559,49282,6145,43137,43137,0,11,6242000.0
6242,6242999,21.367834193977572,37.84955461022628,0.06146101975359075,1111.95085811615,410.82493710517883,1379.566749572754,49291,6146,43145,43145,0,11,6243000.0
6243,6243999,21.3680379263497,37.8489581582878,0.06143395353675163,1112.068519115448,410.88711047172546,1379.9929733276367,49299,6146,43153,43153,0,11,6244000.0
6244,6244999,21.36823854559809,37.84845746099936,0.061409651988089786,1112.1791038513184,410.94838213920593,1380.1954231262207,49300,6146,43154,43154,0,11,6245000.0
6245,6245999,21.36809045087909,37.84721783572626,0.061392313488376815,1112.3995523452759,411.01001715660095,1380.2924613952637,49310,6147,43163,43163,0,11,6246000.0
6246,6246999,21.367989701601775,37.84613599768759,0.061377905551453615,1112.5175914764404,411.07173919677734,1380.5196151733398,49310,6147,43163,43163,0,11,6247000.0
6247,6247999,21.367593822045606,37.84479683503564,0.06136580346253384,1113.0056912899017,411.13679099082947,1380.5306358337402,49332,6150,43182,43182,0,11,6248000.0
6248,6248999,21.366235566695625,37.84268738219443,0.061377438772563075,1113.245048046112,411.2016656398773,1380.845329284668,49342,6151,43191,43191,0,11,6249000.0
6249,6249999,21.36462262056072,37.84062747746976,0.06138849954414538,1113.4886791706085,411.2668285369873,1381.1595191955566,49351,6152,43199,43199,0,11,6250000.0
6250,6250999,21.363385702111188,37.83913390330694,0.06139520524789388,1113.864046573639,411.33767104148865,1381.2909469604492,49364,6154,43210,43210,0,11,6251000.0
6251,6251999,21.36238593489705,37.837690221262264,0.06140154689055677,1114.0993418693542,411.4014070034027,1381.3845901489258,49372,6155,43217,43217,0,11,6252000.0
6252,6252999,21.361195915736804,37.83569183430355,0.06140504325533769,1114.2280004024506,411.4675016403198,1381.6698112487793,49376,6155,43221,43221,0,11,6253000.0
6253,6253999,21.35994793344079,37.83349407320944,0.06141180858245188,1114.5771260261536,411.53097009658813,1381.828842163086,49381,6157,43224,43224,0,11,6254000.0
6254,6254999,21.35870782879425,37.831794710757706,0.061415201227636884,1114.692479133606,411.59411430358887,1381.9973754882812,49381,6157,43224,43224,0,11,6255000.0
6255,6255999,21.357957368800854,37.83092236456285,0.061415443140582004,1114.816109418869,411.6552269458771,1382.3369903564453,49386,6157,43229,43229,0,11,6256000.0
6256,6256999,21.357084992271446,37.82931063400737,0.06141582692404279,1115.0671725273132,411.72438192367554,1382.4929389953613,49388,6158,43230,43230,0,11,6257000.0
6257,6257999,21.356434033438354,37.82795068314343,0.06141506239476702,1115.3035538196564,411.78703236579895,1382.640956878662,49390,6159,43231,43231,0,11,6258000.0
6258,6258999,21.355990876667057,37.82671981253601,0.06141874589976537,1115.55047082901,411.85407304763794,1383.2506141662598,49400,6160,43240,43240,0,11,6259000.0
6259,6259999,21.355955484374253,37.82636656383318,0.06141135782550944,1115.6664562225342,411.91806864738464,1383.6878242492676,49403,6160,43243,43243,0,11,6260000.0
6260,6260999,21.35565319522534,37.82519564016083,0.06141458902212504,1115.8038930892944,411.99092626571655,1383.949909210205,49403,6160,43243,43243,0,11,6261000.0
6261,6261999,21.355541515609165,37.824354455784025,0.06141522170150815,1115.9221773147583,412.0542187690735,1384.504795074463,49409,6160,43249,43249,0,11,6262000.0
6262,6262999,21.356014513089875,37.82451301440872,0.06140898293896235,1116.0455086231232,412.1202583312988,1385.0816078186035,49413,6160,43253,43253,0,11,6263000.0
6263,6263999,21.356344027507056,37.82433913710026,0.06142189473614923,1116.2728040218353,412.1838929653168,1385.4025039672852,49433,6161,43272,43272,0,11,6264000.0
6264,6264999,21.35664486231786,37.82391605302396,0.06141972549245356,1116.5161242485046,412.2513020038605,1386.1216583251953,49453,6162,43291,43291,0,11,6265000.0
6265,6265999,21.35711652404122,37.82378324515385,0.06142685239814305,1116.6213355064392,412.3133034706116,1386.491527557373,49454,6162,43292,43292,0,11,6266000.0
6266,6266999,21.357513254625065,37.82351468564769,0.06143238608970214,1116.7468619346619,412.38444447517395,1386.7131538391113,49455,6162,43293,43293,0,11,6267000.0
6267,6267999,21.357651492713583,37.82250406466675,0.06143465296807016,1116.8596680164337,412.44716143608093,1387.1095123291016,49460,6162,43298,43298,0,11,6268000.0
6268,6268999,21.357302977904332,37.821240296856914,0.06143853663885379,1117.0907979011536,412.50900053977966,1387.2675170898438,49470,6163,43307,43307,0,11,6269000.0
6269,6269999,21.356125482836976,37.81933405997587,0.061448648936295425,1117.3192055225372,412.57102155685425,1387.782283782959,49492,6164,43328,43328,0,11,6270000.0
6270,6270999,21.354793321615343,37.8172319893358,0.0614621241806268,1117.4501738548279,412.63502955436707,1388.2800102233887,49501,6164,43337,43337,0,11,6271000.0
6271,6271999,21.35357111593661,37.81579011965918,0.0614730178980587,1117.6835432052612,412.69937324523926,1388.5009498596191,49509,6165,43344,43344,0,11,6272000.0
6272,6272999,21.352160905893836,37.81361276165294,0.06148451093132834,1117.920960187912,412.763578414917,1388.771827697754,49522,6166,43356,43356,0,11,6273000.0
6273,6273999,21.35088113160765,37.811427172233685,0.06149855798849169,1118.0351431369781,412.8264846801758,1389.2398719787598,49522,6166,43356,43356,0,11,6274000.0
6274,6274999,21.349882125320978,37.810256127948236,0.06150424049987513,1118.2638266086578,412.88967084884644,1389.4668807983398,49524,6167,43357,43357,0,11,6275000.0
6275,6275999,21.34882644645203,37.80844348522587,0.061507594817300615,1118.3751788139343,412.95348930358887,1389.9113845825195,49530,6167,43363,43363,0,11,6276000.0
6276,6276999,21.347995487251932,37.80692706124741,0.06150806357207683,1118.6088774204254,413.0164544582367,1390.1094551086426,49533,6168,43365,43365,0,11,6277000.0
6277,6277999,21.34709958188324,37.80510877038636,0.06150876959584861,1118.730449438095,413.0809106826782,1390.3102416992188,49534,6168,43366,43366,0,11,6278000.0
6278,6278999,21.34646693098009,37.80370756493191,0.06150185751516235,1118.8479115962982,413.1427004337311,1390.9790992736816,49538,6168,43370,43370,0,11,6279000.0
6279,6279999,21.345772336875495,37.802358428813754,0.06149637019368859,1119.1920850276947,413.20766735076904,1391.214210510254,49549,6170,43379,43379,0,11,6280000.0
6280,6280999,21.345000664458205,37.800740751135635,0.06149505355383034,1119.308167219162,413.2706277370453,1391.461196899414,49549,6170,43379,43379,0,11,6281000.0
6281,6281999,21.344354586211903,37.799357022442884,0.061499154024039604,1119.4196088314056,413.3337757587433,1392.2049293518066,49558,6170,43388,43388,0,11,6282000.0
6282,6282999,21.343762358379816,37.797977953405024,0.061505182758588295,1119.5274662971497,413.3974287509918,1392.4543533325195,49559,6170,43389,43389,0,11,6283000.0
6283,6283999,21.343166795684592,37.79644648577854,0.061504869986977906,1119.7834334373474,413.468159198761,1393.2040519714355,49582,6171,43411,43411,0,11,6284000.0
6284,6284999,21.342306670792656,37.79448159418393,0.061508634263574447,1119.9066245555878,413.5341296195984,1393.525104522705,49582,6171,43411,43411,0,11,6285000.0
6285,6285999,21.34145528748796,37.792477104330494,0.061513022810128826,1120.018094778061,413.5969805717468,1393.9961776733398,49590,6171,43419,43419,0,11,6286000.0
6286,6286999,21.340575054410603,37.79098696710294,0.06151655301279524,1120.620332479477,413.6692531108856,1394.2414779663086,49629,6175,43454,43454,0,11,6287000.0
6287,6287999,21.339454306264507,37.78940769982782,0.061530799730279084,1120.751942396164,413.7366724014282,1394.6775856018066,49636,6175,43461,43461,0,11,6288000.0
6288,6288999,21.338462400536415,37.790515119680464,0.061537822891003735,1120.8716695308685,413.7999930381775,1394.8627281188965,49636,6175,43461,43461,0,11,6289000.0
6289,6289999,21.33734662807424,37.78918021481377,0.061551800167478854,1121.110053062439,413.86416578292847,1394.9815788269043,49638,6176,43462,43462,0,11,6290000.0
6290,6290999,21.33638448486655,37.787687821657215,0.06156132066022413,1121.2281486988068,413.92639350891113,1395.2848091125488,49640,6176,43464,43464,0,11,6291000.0
6291,6291999,21.335233487826933,37.7858071697276,0.06156891590133817,1121.5875248908997,413.9894423484802,1395.3652725219727,49651,6178,43473,43473,0,11,6292000.0
6292,6292999,21.33426838541352,37.78405897661775,0.06157389854362594,1122.0549745559692,414.0528738498688,1395.5702514648438,49697,6181,43516,43516,0,11,6293000.0
6293,6293999,21.333417561417665,37.78241309296583,0.06157209724166213,1122.6398255825043,414.11712074279785,1395.5297088623047,49712,6185,43527,43527,0,11,6294000.0
6294,6294999,21.332578310585536,37.78054920736348,0.061571731964907284,1122.7568714618683,414.17965483665466,1395.7184791564941,49712,6185,43527,43527,0,11,6295000.0
6295,6295999,21.331727614226587,37.77857865638926,0.061570908893274434,1123.1200284957886,414.2426509857178,1395.8772468566895,49723,6187,43536,43536,0,11,6296000.0
6296,6296999,21.331267849534868,37.77754366847693,0.061557862398836316,1123.3525621891022,414.306599855423,1396.3036842346191,49739,6188,43551,43551,0,11,6297000.0
6297,6297999,21.330709359772744,37.776021616486126,0.06155465911848923,1123.7065773010254,414.37197852134705,1396.5099143981934,49753,6190,43563,43563,0,11,6298000.0
6298,6298999,21.330385582716538,37.77500909420374,0.06154061708016101,1123.819164276123,414.4363524913788,1396.7324142456055,49753,6190,43563,43563,0,11,6299000.0
6299,6299999,21.329947542362916,37.77374778453119,0.061537613068931574,1123.9426209926605,414.5013451576233,1397.176326751709,49761,6190,43571,43571,0,11,6300000.0
6300,6300999,21.32946126634797,37.772310134796804,0.06153489731332307,1124.069040775299,414.5692186355591,1397.3335037231445,49761,6190,43571,43571,0,11,6301000.0
6301,6301999,21.32928208146263,37.77118521057201,0.061527034712374196,1124.4486570358276,414.6337661743164,1397.6875,49787,6192,43595,43595,0,11,6302000.0
6302,6302999,21.32952578831278,37.77034726615595,0.06150688261062309,1124.6867260932922,414.69613575935364,1397.855625152588,49792,6193,43599,43599,0,11,6303000.0
6303,6303999,21.32980246866291,37.770423074591534,0.06148544685738888,1124.9275407791138,414.7586464881897,1398.0541305541992,49801,6194,43607,43607,0,11,6304000.0
6304,6304999,21.32997286113729,37.76957088554408,0.061467870434771976,1125.4084968566895,414.8230788707733,1398.1955299377441,49825,6197,43628,43628,0,11,6305000.0
6305,6305999,21.329933808111093,37.76889975459459,0.06144979260857253,1125.5355796813965,414.88435530662537,1398.3674392700195,49825,6197,43628,43628,0,11,6306000.0
6306,6306999,21.329334277945165,37.76877798228197,0.06145070267673458,1125.771326303482,414.94968485832214,1398.8806533813477,49852,6198,43654,43654,0,11,6307000.0
6307,6307999,21.32813652648057,37.76766942271331,0.06145790120300332,1126.0035684108734,415.01354002952576,1399.258373260498,49862,6199,43663,43663,0,11,6308000.0
6308,6308999,21.32683206785964,37.76564730842073,0.06146667356010216,1126.233337879181,415.07653403282166,1399.5201263427734,49873,6200,43673,43673,0,11,6309000.0
6309,6309999,21.325858319750473,37.76471804649192,0.061470964227476,1126.699336528778,415.14054346084595,1399.6190376281738,49880,6203,43677,43677,0,11,6310000.0
6310,6310999,21.325007580969864,37.763225159717315,0.06147056296154141,1126.8099024295807,415.2023756504059,1399.9163436889648,49883,6203,43680,43680,0,11,6311000.0
6311,6311999,21.32389369010022,37.761145812421816,0.061474130982022035,1127.0458385944366,415.26721262931824,1400.1250610351562,49885,6204,43681,43681,0,11,6312000.0
6312,6312999,21.322800188294757,37.75914990101096,0.061477198440695435,1127.280333995819,415.3300311565399,1400.3390502929688,49887,6205,43682,43682,0,11,6313000.0
6313,6313999,21.322096703399826,37.757985334623605,0.061472677979305224,1127.8743765354156,415.39449977874756,1400.5321998596191,49921,6209,43712,43712,0,11,6314000.0
6314,6314999,21.32123344179323,37.75614520817616,0.06146903046055596,1128.2262864112854,415.4589293003082,1400.7098350524902,49933,6211,43722,43722,0,11,6315000.0
6315,6315999,21.32067519569072,37.75523048148458,0.061462593972560264,1128.343060016632,415.5225260257721,1400.9277076721191,49933,6211,43722,43722,0,11,6316000.0
6316,6316999,21.319902457989055,37.75395262904731,0.06145707537243916,1128.8030536174774,415.5857501029968,1401.079288482666,49950,6214,43736,43736,0,11,6317000.0
6317,6317999,21.31956496835606,37.75272416906843,0.06144607877813446,1129.1537692546844,415.6488766670227,1401.3520889282227,49966,6216,43750,43750,0,11,6318000.0
6318,6318999,21.31913006863332,37.752751349871396,0.06143963326358748,1129.497808456421,415.7120895385742,1401.4864387512207,49971,6218,43753,43753,0,11,6319000.0
6319,6319999,21.318628914326627,37.75142566416153,0.061434064336809424,1129.8566586971283,415.7759020328522,1401.6287803649902,49975,6220,43755,43755,0,11,6320000.0
6320,6320999,21.318461021463214,37.750073346319304,0.061417472094771663,1129.9780921936035,415.83881187438965,1402.152328491211,49981,6220,43761,43761,0,11,6321000.0
6321,6321999,21.31818998581911,37.74869881851377,0.061411938096941676,1130.20880484581,415.90416646003723,1402.2981300354004,49984,6221,43763,43763,0,11,6322000.0
6322,6322999,21.317955406126803,37.74749352621008,0.061399476259201946,1130.3290627002716,415.96660566329956,1402.6742324829102,49993,6221,43772,43772,0,11,6323000.0
6323,6323999,21.318044058556115,37.74645926935728,0.0613884419208961,1130.5585508346558,416.02912306785583,1402.8656005859375,49997,6222,43775,43775,0,11,6324000.0
6324,6324999,21.31773290060211,37.745012184249234,0.06137921411586034,1130.9150457382202,416.0945563316345,1402.9249572753906,50007,6224,43783,43783,0,11,6325000.0
6325,6325999,21.31727746968279,37.74334669159882,0.06137230916539571,1131.0257604122162,416.15628576278687,1403.1817779541016,50008,6224,43784,43784,0,11,6326000.0
6326,6326999,21.316761168757004,37.74221745021197,0.06136848386023108,1131.1443490982056,416.2174048423767,1403.3362007141113,50008,6224,43784,43784,0,11,6327000.0
6327,6327999,21.315583281743617,37.740310541655305,0.06137512892742203,1131.6258454322815,416.28189635276794,1403.758213043213,50047,6227,43820,43820,0,11,6328000.0
6328,6328999,21.314602489976263,37.73920203288703,0.061377487944541786,1131.9813318252563,416.3479745388031,1403.9729804992676,50060,6229,43831,43831,0,11,6329000.0
6329,6329999,21.31347411278323,37.738258049403896,0.06138153894534082,1132.1051394939423,416.4140212535858,1404.1901779174805,50060,6229,43831,43831,0,11,6330000.0
6330,6330999,21.31222405656341,37.73614133361518,0.0613931895573091,1132.237101316452,416.4794249534607,1404.3422088623047,50060,6229,43831,43831,0,11,6331000.0
6331,6331999,21.311010506709188,37.73401489510882,0.06139877007988659,1132.359546661377,416.54286456108093,1404.641040802002,50065,6229,43836,43836,0,11,6332000.0
6332,6332999,21.310178403390005,37.73237819959467,0.06139813955356499,1132.593868970871,416.60568046569824,1404.8729553222656,50067,6230,43837,43837,0,11,6333000.0
6333,6333999,21.309064932783436,37.730426734518836,0.06140131020397499,1132.832322359085,416.66990518569946,1405.0643615722656,50069,6231,43838,43838,0,11,6334000.0
6334,6334999,21.308203335557156,37.72876127066328,0.061399762665828694,1133.17795920372,416.7339470386505,1405.3386497497559,50085,6233,43852,43852,0,11,6335000.0
6335,6335999,21.307255388957802,37.72778957002785,0.06139871699975308,1133.5378713607788,416.7972357273102,1405.5525360107422,50105,6235,43870,43870,0,11,6336000.0
6336,6336999,21.30637001701717,37.7259784158578,0.06140361498326685,1133.7735123634338,416.8603456020355,1405.8095092773438,50109,6236,43873,43873,0,11,6337000.0
6337,6337999,21.30546297909884,37.72400641953004,0.061406847918133556,1134.11732339859,416.92381262779236,1406.2301063537598,50120,6238,43882,43882,0,11,6338000.0
6338,6338999,21.304993237478907,37.722394038041045,0.0613964426453506,1134.4684581756592,416.98768615722656,1406.421947479248,50135,6240,43895,43895,0,11,6339000.0
6339,6339999,21.3045983091479,37.72133175427441,0.061387303181734465,1134.5796484947205,417.05029344558716,1406.6328811645508,50136,6240,43896,43896,0,11,6340000.0
6340,6340999,21.304200603374095,37.71978357460058,0.061377153401472206,1134.9362230300903,417.11408257484436,1406.9473724365234,50151,6242,43909,43909,0,11,6341000.0
6341,6341999,21.303662978334554,37.71802540654475,0.06136832182821084,1135.0526945590973,417.1777482032776,1407.3083000183105,50153,6242,43911,43911,0,11,6342000.0
6342,6342999,21.30334586905664,37.71678992360803,0.06136086559951448,1135.5073292255402,417.2414186000824,1407.38765335083,50166,6245,43921,43921,0,11,6343000.0
6343,6343999,21.30302024055925,37.71526252582648,0.061350688448495005,1135.756624698639,417.3084807395935,1408.00972366333,50184,6246,43938,43938,0,11,6344000.0
6344,6344999,21.30275239684558,37.71386538514689,0.061338707054649944,1135.8722789287567,417.37073040008545,1408.2877883911133,50184,6246,43938,43938,0,11,6345000.0
6345,6345999,21.302249357541115,37.71223974779588,0.06133603413335997,1135.9957673549652,417.4331212043762,1408.4604530334473,50184,6246,43938,43938,0,11,6346000.0
6346,6346999,21.301728246980606,37.71053419216696,0.06132863309093883,1136.3384969234467,417.495481967926,1408.7499313354492,50199,6248,43951,43951,0,11,6347000.0
6347,6347999,21.300830240629075,37.70853438351053,0.06132910929268531,1136.4510190486908,417.5575633049011,1409.276611328125,50212,6248,43964,43964,0,11,6348000.0
6348,6348999,21.29996694347713,37.70861792633607,0.06131949429593253,1136.687573671341,417.62124371528625,1409.5125312805176,50222,6249,43973,43973,0,11,6349000.0
6349,6349999,21.29896882094397,37.70820010689916,0.061317323640408095,1136.9308080673218,417.68674993515015,1410.1297035217285,50236,6250,43986,43986,0,11,6350000.0
6350,6350999,21.29798441651782,37.706765499866925,0.06131410556154249,1137.2816619873047,417.75120067596436,1410.3174781799316,50272,6252,44020,44020,0,11,6351000.0
6351,6351999,21.297143115867474,37.705314256042584,0.06131104891917205,1137.4069163799286,417.8168034553528,1410.5375633239746,50272,6252,44020,44020,0,11,6352000.0
6352,6352999,21.296463279607465,37.70391204893338,0.061303626804941724,1137.5311284065247,417.8798806667328,1410.876262664795,50276,6252,44024,44024,0,11,6353000.0
6353,6353999,21.295722567883423,37.70215945774932,0.06130249979079749,1137.652216911316,417.94246792793274,1411.0485725402832,50276,6252,44024,44024,0,11,6354000.0
6354,6354999,21.294976180240578,37.700554365093446,0.06130657295226627,1138.0277292728424,418.0086598396301,1411.129867553711,50290,6254,44036,44036,0,11,6355000.0
6355,6355999,21.294660187620607,37.69964673855541,0.0612883022105325,1138.2589313983917,418.071839094162,1411.4621124267578,50305,6255,44050,44050,0,11,6356000.0
6356,6356999,21.29435394020897,37.69919804575549,0.06127660628890341,1138.4894771575928,418.13635778427124,1411.6371383666992,50307,6256,44051,44051,0,11,6357000.0
6357,6357999,21.293944268642598,37.69800409458009,0.06127256045644369,1138.8441560268402,418.19994139671326,1411.7544288635254,50313,6258,44055,44055,0,11,6358000.0
6358,6358999,21.294211496370544,37.697757041041356,0.06126489718979744,1139.0918138027191,418.26371026039124,1412.0325241088867,50319,6259,44060,44060,0,11,6359000.0
6359,6359999,21.295024023925365,37.69879312372884,0.06125717057852109,1139.20157289505,418.3280682563782,1412.2766418457031,50320,6259,44061,44061,0,11,6360000.0
6360,6360999,21.295500600798455,37.69928580971964,0.061249835363415994,1139.5736348628998,418.3916070461273,1412.3529319763184,50329,6261,44068,44068,0,11,6361000.0
6361,6361999,21.296283508988335,37.69978844431716,0.06124879722103427,1139.6859714984894,418.455201625824,1412.801685333252,50335,6261,44074,44074,0,11,6362000.0
6362,6362999,21.297205542011,37.70021892966348,0.06125044217002418,1139.8067145347595,418.5193350315094,1413.007553100586,50335,6261,44074,44074,0,11,6363000.0
6363,6363999,21.29852440955993,37.70228799211744,0.06124754336023175,1140.1574685573578,418.5833508968353,1413.069393157959,50339,6263,44076,44076,0,11,6364000.0
6364,6364999,21.299681500823187,37.70286781882339,0.06125274685965165,1140.2791583538055,418.6465735435486,1413.601547241211,50348,6263,44085,44085,0,11,6365000.0
6365,6365999,21.30096632301202,37.70341733214385,0.06126505352456879,1140.5170385837555,418.70922327041626,1413.7486038208008,50359,6264,44095,44095,0,11,6366000.0
6366,6366999,21.301880096450056,37.70337596282462,0.061274946669688135,1140.6320161819458,418.7711660861969,1413.972770690918,50360,6264,44096,44096,0,11,6367000.0
6367,6367999,21.30253545442028,37.70298724366885,0.06127041397358446,1140.8743121623993,418.83603620529175,1414.198932647705,50362,6265,44097,44097,0,11,6368000.0
6368,6368999,21.301977361956762,37.70150058757235,0.06126630997524185,1141.008691072464,418.9096796512604,1414.5955810546875,50370,6265,44105,44105,0,11,6369000.0
6369,6369999,21.301181696419924,37.703165731085676,0.061250096536912046,1141.3758261203766,418.9732859134674,1414.8082847595215,50380,6267,44113,44113,0,11,6370000.0
6370,6370999,21.300439769940436,37.703215821954984,0.061248954118636734,1141.4987897872925,419.03947949409485,1415.082592010498,50383,6267,44116,44116,0,11,6371000.0
6371,6371999,21.29960180734857,37.70167058679966,0.0612464789896916,1141.6223363876343,419.10284399986267,1415.3002281188965,50384,6267,44117,44117,0,11,6372000.0
6372,6372999,21.298832480126247,37.70001552748487,0.06125035102469445,1141.9865288734436,419.1670079231262,1415.3053588867188,50406,6269,44137,44137,0,11,6373000.0
6373,6373999,21.298413593178918,37.70022344796815,0.06122488724592945,1142.4560482501984,419.23035287857056,1415.6430473327637,50424,6272,44152,44152,0,11,6374000.0
6374,6374999,21.297809946342365,37.69881880657415,0.061214607119423725,1142.685702085495,419.2930746078491,1415.861141204834,50426,6273,44153,44153,0,11,6375000.0
6375,6375999,21.297361614182126,37.697633836913816,0.06120892000002798,1143.040242433548,419.35809898376465,1416.0988578796387,50441,6275,44166,44166,0,11,6376000.0
6376,6376999,21.297070676237198,37.69632178864933,0.06120096358484517,1143.398099899292,419.42196917533875,1416.2635955810547,50458,6277,44181,44181,0,11,6377000.0
6377,6377999,21.29672958683611,37.69490095250311,0.06120016941154327,1143.533099412918,419.4862177371979,1416.4140739440918,50459,6277,44182,44182,0,11,6378000.0
6378,6378999,21.29661467018847,37.694590290729465,0.06121289185103429,1143.7697222232819,419.549245595932,1416.5152473449707,50462,6278,44184,44184,0,11,6379000.0
6379,6379999,21.29696730615192,37.693960122457305,0.06120436946928254,1143.9980955123901,419.6123170852661,1416.797077178955,50469,6279,44190,44190,0,11,6380000.0
6380,6380999,21.297274145419042,37.693438649337395,0.06120864092523992,1144.3568115234375,419.67621636390686,1416.9000205993652,50474,6281,44193,44193,0,11,6381000.0
6381,6381999,21.297474395852053,37.69289653050112,0.061217330849100415,1144.6101517677307,419.7419743537903,1416.998706817627,50477,6282,44195,44195,0,11,6382000.0
6382,6382999,21.298037182277305,37.69314374835792,0.06121600525854398,1144.8533027172089,419.8055913448334,1417.5226211547852,50492,6283,44209,44209,0,11,6383000.0
6383,6383999,21.298974394132237,37.69377031111029,0.06122617102427663,1144.9739854335785,419.87083315849304,1417.7172164916992,50492,6283,44209,44209,0,11,6384000.0
6384,6384999,21.299709835643565,37.69381566304495,0.06122608264605078,1145.338828086853,419.93705320358276,1417.8995361328125,50507,6285,44222,44222,0,11,6385000.0
6385,6385999,21.300845082650017,37.69432483638659,0.061242690816216694,1145.5748674869537,419.99981355667114,1418.2628059387207,50514,6286,44228,44228,0,11,6386000.0
6386,6386999,21.30174996987486,37.69528113265299,0.061256983763078754,1145.8162491321564,420.0623414516449,1418.3961906433105,50521,6287,44234,44234,0,11,6387000.0
6387,6387999,21.302694536707858,37.695343619322195,0.06127169164754043,1145.9271750450134,420.12387323379517,1418.6383018493652,50524,6287,44237,44237,0,11,6388000.0
6388,6388999,21.30319256857615,37.69498409639545,0.06127047350704762,1146.1640346050262,420.1856167316437,1418.7789001464844,50531,6288,44243,44243,0,11,6389000.0
6389,6389999,21.30262742568603,37.693709294667386,0.06126163160043796,1146.390702009201,420.2478938102722,1419.1128044128418,50547,6289,44258,44258,0,11,6390000.0
6390,6390999,21.30160609180364,37.69246150866932,0.06126351774048522,1146.5090436935425,420.3136897087097,1419.4040489196777,50553,6289,44264,44264,0,11,6391000.0
6391,6391999,21.30047739861093,37.69040608319846,0.06126411252332431,1146.7581179141998,420.37713384628296,1419.5595321655273,50563,6290,44273,44273,0,11,6392000.0
6392,6392999,21.299557732279588,37.688846134044205,0.0612659933169879,1147.0067007541656,420.4407377243042,1419.656452178955,50574,6291,44283,44283,0,11,6393000.0
6393,6393999,21.299171708625288,37.688512868674984,0.061256672273902524,1147.3691787719727,420.50504660606384,1419.7034072875977,50578,6293,44285,44285,0,11,6394000.0
6394,6394999,21.298624502125218,37.687183338644274,0.0612523159133368,1147.6021268367767,420.56762623786926,1419.8936653137207,50589,6294,44295,44295,0,11,6395000.0
6395,6395999,21.298252676720363,37.68607687671386,0.06124868200909317,1147.8495154380798,420.6312041282654,1420.0246810913086,50596,6295,44301,44301,0,11,6396000.0
6396,6396999,21.29807728569644,37.685180710610396,0.06124392410540658,1148.0875146389008,420.69257283210754,1420.2538032531738,50605,6296,44309,44309,0,11,6397000.0
6397,6397999,21.29774482982346,37.684067392492814,0.06123626492310941,1148.3297281265259,420.75652980804443,1420.4293327331543,50609,6297,44312,44312,0,11,6398000.0
6398,6398999,21.297747024059618,37.6844603271468,0.061229413257916976,1148.5631983280182,420.82024240493774,1420.5339431762695,50620,6298,44322,44322,0,11,6399000.0
6399,6399999,21.297738797067673,37.68373900515016,0.061223607381810985,1148.8061106204987,420.8876624107361,1420.66109085083,50622,6299,44323,44323,0,11,6400000.0
6400,6400999,21.298149794533156,37.68318110092567,0.061213263290382014,1149.0408232212067,420.95215368270874,1421.457275390625,50634,6300,44334,44334,0,11,6401000.0
6401,6401999,21.29877036806043,37.68291158996999,0.06120460803150152,1149.155950307846,421.0150055885315,1421.759407043457,50635,6300,44335,44335,0,11,6402000.0
6402,6402999,21.299148159627592,37.68240278437483,0.061196387478750225,1149.3966753482819,421.08036518096924,1421.9469833374023,50638,6301,44337,44337,0,11,6403000.0
6403,6403999,21.299793602956637,37.68244880714521,0.06115854173854396,1149.629353761673,421.1441376209259,1422.6601791381836,50646,6302,44344,44344,0,11,6404000.0
6404,6404999,21.30044060650448,37.682293608214835,0.06113863898514149,1149.8582434654236,421.20758414268494,1422.8785018920898,50656,6303,44353,44353,0,11,6405000.0
6405,6405999,21.30095610391859,37.68167083813397,0.061126497898769894,1149.976313829422,421.2709484100342,1423.1788215637207,50660,6303,44357,44357,0,11,6406000.0
6406,6406999,21.301699046964593,37.68154841716501,0.061106814821274336,1150.0944528579712,421.3334016799927,1423.8108406066895,50672,6303,44369,44369,0,11,6407000.0
6407,6407999,21.3022187667549,37.68114511792838,0.061090582755007006,1150.2066679000854,421.3958671092987,1424.0106048583984,50672,6303,44369,44369,0,11,6408000.0
6408,6408999,21.302672365434564,37.68053706788376,0.06107372292869018,1150.5687308311462,421.46293449401855,1424.210952758789,50689,6305,44384,44384,0,11,6409000.0
6409,6409999,21.303153040310526,37.679999463298685,0.06104439424427699,1150.6809258460999,421.523006439209,1424.491413116455,50690,6305,44385,44385,0,11,6410000.0
6410,6410999,21.302558312201928,37.678387029754745,0.06103757712106439,1150.9192135334015,421.5861928462982,1424.910099029541,50704,6306,44398,44398,0,11,6411000.0
6411,6411999,21.301988102500832,37.678186046766655,0.06102830534042525,1151.0347423553467,421.6488654613495,1425.25834274292,50708,6306,44402,44402,0,11,6412000.0
6412,6412999,21.301031450239464,37.677284456233295,0.06103280533735089,1151.3081879615784,421.72526454925537,1425.5538368225098,50719,6307,44412,44412,0,11,6413000.0
6413,6413999,21.300183892800575,37.677299382232064,0.061028101237714405,1151.4405896663666,421.79163217544556,1425.7624473571777,50720,6307,44413,44413,0,11,6414000.0
6414,6414999,21.299879708799754,37.67592148550053,0.06100761987456904,1151.7057542800903,421.863165140152,1426.2639923095703,50733,6308,44425,44425,0,11,6415000.0
6415,6415999,21.299810568108224,37.67557935869685,0.06098231155753053,1151.940894126892,421.92631340026855,1426.5293502807617,50744,6309,44435,44435,0,11,6416000.0
6416,6416999,21.299408916393393,37.67419842830996,0.06096890142456435,1152.1735081672668,421.98970079421997,1426.905475616455,50757,6310,44447,44447,0,11,6417000.0
6417,6417999,21.299078884875435,37.67379949260674,0.06095599840209254,1152.5375056266785,422.05414605140686,1426.9013786315918,50778,6312,44466,44466,0,11,6418000.0
6418,6418999,21.298594564409278,37.672391428390725,0.060943068029251535,1152.9060635566711,422.1185681819916,1427.0093421936035,50789,6314,44475,44475,0,11,6419000.0
6419,6419999,21.298300931360483,37.671267987804455,0.060925984572416825,1153.0390355587006,422.1897258758545,1427.4645538330078,50792,6314,44478,44478,0,11,6420000.0
6420,6420999,21.29859619329609,37.670558600716326,0.06088725886711699,1153.1542460918427,422.2521073818207,1427.8250045776367,50793,6314,44479,44479,0,11,6421000.0
6421,6421999,21.29865175528468,37.66968915789031,0.06086067253021776,1153.385633468628,422.31509017944336,1428.005958557129,50804,6315,44489,44489,0,11,6422000.0
6422,6422999,21.298879418171495,37.66891568612786,0.06082816713461747,1153.5078465938568,422.37934255599976,1428.6078758239746,50812,6315,44497,44497,0,11,6423000.0
6423,6423999,21.29923574480222,37.66807556405483,0.06079221131152024,1153.8570144176483,422.4432725906372,1428.8098793029785,50836,6317,44519,44519,0,11,6424000.0
6424,6424999,21.299307456309737,37.66691047103573,0.06076823891759309,1154.223784685135,422.5075991153717,1429.2293434143066,50857,6319,44538,44538,0,11,6425000.0
6425,6425999,21.29917325515912,37.666553403266484,0.06075127182173112,1154.3382875919342,422.57080078125,1429.5683250427246,50857,6319,44538,44538,0,11,6426000.0
6426,6426999,21.298844643313764,37.666110454604535,0.06074211787520245,1154.4505441188812,422.6337254047394,1429.8398246765137,50859,6319,44540,44540,0,11,6427000.0
6427,6427999,21.298360893419044,37.66447117679892,0.060734675555445095,1154.7993578910828,422.69576263427734,1430.0572357177734,50873,6321,44552,44552,0,11,6428000.0
6428,6428999,21.297304776714892,37.662978687867856,0.0607421464156388,1155.0422801971436,422.7592439651489,1430.3723793029785,50883,6322,44561,44561,0,11,6429000.0
6429,6429999,21.29612684850769,37.66114256459819,0.06075532704991493,1155.524377822876,422.82426404953003,1430.4286575317383,50905,6325,44580,44580,0,11,6430000.0
6430,6430999,21.29526610672114,37.65991084865014,0.06075995455428951,1155.7698192596436,422.88813495635986,1430.5704727172852,50916,6326,44590,44590,0,11,6431000.0
6431,6431999,21.294341736907757,37.658307578782846,0.06076403661834895,1155.8908879756927,422.95213770866394,1430.9090690612793,50918,6326,44592,44592,0,11,6432000.0
6432,6432999,21.29374691464598,37.657581342530456,0.06076263944628346,1156.1354434490204,423.01616406440735,1431.03706741333,50920,6327,44593,44593,0,11,6433000.0
6433,6433999,21.293202291197055,37.65661772614755,0.06075928674283426,1156.4941153526306,423.0793523788452,1431.1751708984375,50935,6329,44606,44606,0,11,6434000.0
6434,6434999,21.292816971664788,37.655912256288346,0.06075322394168803,1156.631282567978,423.1429045200348,1431.437240600586,50938,6329,44609,44609,0,11,6435000.0
6435,6435999,21.292502692053432,37.65511468909865,0.06074989978282097,1156.8693933486938,423.20656299591064,1431.585620880127,50942,6330,44612,44612,0,11,6436000.0
6436,6436999,21.29228776520945,37.65433731978972,0.06075318541204677,1156.9774689674377,423.2679126262665,1431.704345703125,50942,6330,44612,44612,0,11,6437000.0
6437,6437999,21.29240766196211,37.653715442613596,0.06075188134087117,1157.222067117691,423.33477997779846,1431.9916152954102,50950,6331,44619,44619,0,11,6438000.0
6438,6438999,21.292313225104877,37.652741407932126,0.060751524677910895,1157.5724170207977,423.3982949256897,1432.1015853881836,50954,6333,44621,44621,0,11,6439000.0
6439,6439999,21.29246054276464,37.652270585498414,0.06074698638814835,1157.8260321617126,423.463579416275,1432.1806945800781,50957,6334,44623,44623,0,11,6440000.0
6440,6440999,21.293069000602788,37.65284712023648,0.060739149674734816,1157.9541580677032,423.52775406837463,1432.546070098877,50963,6334,44629,44629,0,11,6441000.0
6441,6441999,21.293377075627383,37.652181199845735,0.06073827007495758,1158.0851118564606,423.5933344364166,1432.7377853393555,50963,6334,44629,44629,0,11,6442000.0
6442,6442999,21.293950264839015,37.652095068062906,0.06074352199965394,1158.5590755939484,423.6583058834076,1432.8841857910156,50988,6337,44651,44651,0,11,6443000.0
6443,6443999,21.294778320436016,37.652645661067666,0.0607306099800079,1158.9075284004211,423.7223083972931,1433.5718955993652,51018,6339,44679,44679,0,11,6444000.0
6444,6444999,21.29515085555996,37.652322537009994,0.06072325029570158,1159.1382641792297,423.785165309906,1433.8027000427246,51029,6340,44689,44689,0,11,6445000.0
6445,6445999,21.29559796891473,37.65296901552858,0.060720281158754164,1159.3747799396515,423.84919118881226,1433.989028930664,51040,6341,44699,44699,0,11,6446000.0
6446,6446999,21.296072776023472,37.65262447502587,0.06070503332339905,1159.8446085453033,423.91212701797485,1434.2970657348633,51075,6344,44731,44731,0,11,6447000.0
6447,6447999,21.295744037452124,37.651325725385966,0.06069923775952801,1160.0860683918,423.97650480270386,1434.712085723877,51087,6345,44742,44742,0,11,6448000.0
6448,6448999,21.295207062440802,37.6511552499575,0.060695953823089344,1160.4426271915436,424.0391454696655,1435.0022354125977,51102,6347,44755,44755,0,11,6449000.0
6449,6449999,21.295320254753186,37.65174494407497,0.06069780944792513,1160.560992717743,424.1029198169708,1435.3361701965332,51106,6347,44759,44759,0,11,6450000.0
6450,6450999,21.29540287190542,37.651930520774556,0.06069079221563489,1160.8043024539948,424.1669268608093,1435.5886344909668,51112,6348,44764,44764,0,11,6451000.0
6451,6451999,21.295876625667855,37.65238048241739,0.060691322526178815,1161.041356086731,424.2306869029999,1435.7470588684082,51116,6349,44767,44767,0,11,6452000.0
6452,6452999,21.296832635546213,37.654488602585445,0.06067935760219545,1161.2771627902985,424.29691195487976,1436.0642051696777,51120,6350,44770,44770,0,11,6453000.0
6453,6453999,21.29761339933143,37.65493670847678,0.0606815957319321,1161.5099415779114,424.35975098609924,1436.2645988464355,51122,6351,44771,44771,0,11,6454000.0
6454,6454999,21.298813563714642,37.65637545087237,0.06068800485973025,1161.6340608596802,424.42589592933655,1436.6541175842285,51129,6351,44778,44778,0,11,6455000.0
6455,6455999,21.300193598788066,37.65783043866647,0.06070657946237723,1161.8646564483643,424.4904396533966,1436.86079788208,51138,6352,44786,44786,0,11,6456000.0
6456,6456999,21.30148036370892,37.65869282926727,0.06073211322979577,1162.2314603328705,424.55455803871155,1436.9296760559082,51151,6354,44797,44797,0,11,6457000.0
6457,6457999,21.30307145324913,37.660658809296514,0.06075589625374889,1162.576723575592,424.6168444156647,1437.1313400268555,51165,6356,44809,44809,0,11,6458000.0
6458,6458999,21.304623568440093,37.66212160023368,0.06078075624066037,1162.8153059482574,424.67944407463074,1437.2298774719238,51168,6357,44811,44811,0,11,6459000.0
6459,6459999,21.306276229131075,37.66326845862409,0.060800944033363225,1163.1668937206268,424.74276089668274,1437.2573776245117,51182,6359,44823,44823,0,11,6460000.0
6460,6460999,21.308062996536,37.6650123756652,0.060819450551734766,1163.418645143509,424.8071002960205,1437.62984085083,51194,6360,44834,44834,0,11,6461000.0
6461,6461999,21.30967693580242,37.666546265968975,0.0608396966606769,1163.662785768509,424.87262773513794,1437.8964462280273,51199,6361,44838,44838,0,11,6462000.0
6462,6462999,21.311124390381444,37.667433011961975,0.060864463955151216,1163.775306224823,424.9380633831024,1438.0687789916992,51199,6361,44838,44838,0,11,6463000.0
6463,6463999,21.312732952110547,37.66872941519037,0.06088128018868488,1164.0137474536896,425.0020990371704,1438.7346229553223,51221,6362,44859,44859,0,11,6464000.0
6464,6464999,21.31393758614882,37.66930366792847,0.060896881106716205,1164.4906585216522,425.06953716278076,1438.9699630737305,51245,6365,44880,44880,0,11,6465000.0
6465,6465999,21.3149879231633,37.669551077146146,0.06092465430255767,1164.6165091991425,425.14046478271484,1439.1823921203613,51245,6365,44880,44880,0,11,6466000.0
6466,6466999,21.315791758933347,37.6692914792447,0.06092453643609086,1164.9774236679077,425.2050070762634,1439.584083557129,51257,6367,44890,44890,0,11,6467000.0
6467,6467999,21.315509057280966,37.668237172414216,0.060922913006050794,1165.0981740951538,425.267795085907,1440.131721496582,51267,6367,44900,44900,0,11,6468000.0
6468,6468999,21.314306310936082,37.6665987448044,0.06092832758973399,1165.2117562294006,425.33035945892334,1440.44970703125,51269,6367,44902,44902,0,11,6469000.0
6469,6469999,21.31323009402705,37.665260076400656,0.060931387474716825,1165.459115743637,425.39304637908936,1440.6332893371582,51277,6368,44909,44909,0,11,6470000.0
6470,6470999,21.312154524428472,37.66381977930903,0.060939147418970774,1165.702715396881,425.4572422504425,1440.764980316162,51286,6369,44917,44917,0,11,6471000.0
6471,6471999,21.311306746456733,37.66265386011059,0.06093830643994469,1165.9362533092499,425.52077054977417,1440.8596305847168,51288,6370,44918,44918,0,11,6472000.0
6472,6472999,21.310276104882007,37.66117980963486,0.06093843511981978,1166.0568368434906,425.58367252349854,1441.1787605285645,51290,6370,44920,44920,0,11,6473000.0
6473,6473999,21.309644546409462,37.66057012088186,0.06093184418343911,1166.1776232719421,425.6460819244385,1441.3161506652832,51290,6370,44920,44920,0,11,6474000.0
6474,6474999,21.309066433240435,37.659674807852255,0.06092880708371462,1166.5386021137238,425.7104425430298,1441.4947128295898,51305,6372,44933,44933,0,11,6475000.0
6475,6475999,21.30864670316927,37.65872325660421,0.06092164056007465,1166.7798783779144,425.77484607696533,1441.727279663086,51314,6373,44941,44941,0,11,6476000.0
6476,6476999,21.308181146039203,37.65751396311079,0.06092361938636415,1167.2596361637115,425.840443611145,1441.7686500549316,51326,6376,44950,44950,0,11,6477000.0
6477,6477999,21.308334054497028,37.65747697025457,0.06092618979527831,1167.5044858455658,425.9055526256561,1441.8664665222168,51336,6377,44959,44959,0,11,6478000.0
6478,6478999,21.30866021768984,37.657562131813926,0.06093375325785544,1167.8696217536926,425.96975088119507,1442.2977409362793,51377,6379,44998,44998,0,11,6479000.0
6479,6479999,21.30916877295328,37.658179390990554,0.06093619021058627,1168.2345304489136,426.0333592891693,1442.4009590148926,51384,6381,45003,45003,0,11,6480000.0
6480,6480999,21.309782470755984,37.65903367691928,0.06093361747427495,1168.4822919368744,426.09679102897644,1442.5344619750977,51387,6382,45005,45005,0,11,6481000.0
6481,6481999,21.310643009976552,37.65976950929024,0.06094080108887445,1168.7258217334747,426.1631953716278,1443.0544929504395,51395,6383,45012,45012,0,11,6482000.0
6482,6482999,21.311557598309413,37.66085352686044,0.06095726527122047,1168.8427519798279,426.2260992527008,1443.3274040222168,51396,6383,45013,45013,0,11,6483000.0
6483,6483999,21.312616367574456,37.66194555776763,0.060960985089397624,1169.0762355327606,426.2877275943756,1443.4694747924805,51400,6384,45016,45016,0,11,6484000.0
6484,6484999,21.31389927639676,37.66400017261705,0.06096707755088493,1169.1981265544891,426.3503713607788,1443.8983726501465,51410,6384,45026,45026,0,11,6485000.0
6485,6485999,21.31493484102884,37.66496917864805,0.06097493570522827,1169.5582609176636,426.41313004493713,1443.991683959961,51423,6386,45037,45037,0,11,6486000.0
6486,6486999,21.315790284675067,37.66524941434239,0.06098939119671254,1169.79238820076,426.47617626190186,1444.147689819336,51429,6387,45042,45042,0,11,6487000.0
6487,6487999,21.31622447357036,37.66508585496846,0.06098522098566539,1170.140954732895,426.5386700630188,1444.232177734375,51435,6389,45046,45046,0,11,6488000.0
6488,6488999,21.315708337532673,37.66475702276783,0.06095874076769303,1170.376591682434,426.60183024406433,1444.5873985290527,51447,6390,45057,45057,0,11,6489000.0
6489,6489999,21.31450698374603,37.66332460356712,0.060959449507437036,1170.619127035141,426.6650881767273,1444.8787956237793,51454,6391,45063,45063,0,11,6490000.0
6490,6490999,21.313555300513176,37.66236166037286,0.060959119516184934,1170.9781169891357,426.7289123535156,1445.024070739746,51487,6393,45094,45094,0,11,6491000.0
6491,6491999,21.312565802104253,37.66103740743692,0.06096265749244334,1171.345633506775,426.79409623146057,1445.1704406738281,51520,6395,45125,45125,0,11,6492000.0
6492,6492999,21.31169323126739,37.65943496154124,0.06096404536547073,1171.591988325119,426.8585796356201,1445.2797660827637,51528,6396,45132,45132,0,11,6493000.0
6493,6493999,21.310755115121136,37.65788820675744,0.060961997482807284,1171.955905199051,426.92231011390686,1445.4329795837402,51548,6398,45150,45150,0,11,6494000.0
6494,6494999,21.30998487230967,37.656213160707324,0.06096122980888963,1172.0792036056519,426.9860870838165,1445.5926322937012,51548,6398,45150,45150,0,11,6495000.0
6495,6495999,21.309205796817697,37.657088089792865,0.060953119275788725,1172.4425296783447,427.04990434646606,1445.726432800293,51591,6400,45191,45191,0,11,6496000.0
6496,6496999,21.3083001101634,37.655320368147976,0.06095500460715264,1172.6834995746613,427.1132595539093,1445.9054679870605,51602,6401,45201,45201,0,11,6497000.0
6497,6497999,21.30773840025937,37.65400417424688,0.06094900791515723,1173.0476896762848,427.1776804924011,1446.0059394836426,51611,6403,45208,45208,0,11,6498000.0
6498,6498999,21.307388311118203,37.65342673817642,0.060946054641544234,1173.1680505275726,427.2407693862915,1446.1207389831543,51612,6403,45209,45209,0,11,6499000.0
6499,6499999,21.307301894359608,37.652734732498196,0.06094561918231045,1173.5342056751251,427.30727767944336,1446.399070739746,51630,6405,45225,45225,0,11,6500000.0
6500,6500999,21.30717690004054,37.65194561206035,0.06094763195672481,1174.020037651062,427.3722858428955,1446.4252166748047,51653,6408,45245,45245,0,11,6501000.0
6501,6501999,21.30708173064111,37.65105596661786,0.060950432758609785,1174.277691602707,427.43740367889404,1446.5425605773926,51655,6409,45246,45246,0,11,6502000.0
6502,6502999,21.30772863266844,37.65130328936632,0.060953576074116445,1174.405750989914,427.502977848053,1446.937084197998,51659,6409,45250,45250,0,11,6503000.0
6503,6503999,21.308448098344616,37.65240070690521,0.06094977172522209,1174.560382604599,427.57697558403015,1447.1055297851562,51659,6409,45250,45250,0,11,6504000.0
6504,6504999,21.309559240371346,37.653641539182644,0.06095798102151184,1174.6830863952637,427.64124941825867,1447.2506561279297,51661,6409,45252,45252,0,11,6505000.0
6505,6505999,21.311020000507668,37.655240966304966,0.06095904778469141,1175.047149181366,427.70534324645996,1447.5532341003418,51688,6411,45277,45277,0,11,6506000.0
6506,6506999,21.312658077958616,37.65839871607631,0.06095738959472796,1175.2855265140533,427.77217197418213,1447.737102508545,51699,6412,45287,45287,0,11,6507000.0
6507,6507999,21.314173790501783,37.66202702827566,0.06096592108790244,1175.7740714550018,427.8365957736969,1447.7328567504883,51731,6415,45316,45316,0,11,6508000.0
6508,6508999,21.31492348295671,37.66235724840586,0.06097567484778066,1176.0386204719543,427.90392208099365,1447.9729690551758,51742,6416,45326,45326,0,11,6509000.0
6509,6509999,21.315117311661837,37.66267319206055,0.060952902211844795,1176.5324401855469,427.967497587204,1448.235019683838,51765,6419,45346,45346,0,11,6510000.0
6510,6510999,21.314317343667366,37.661766702022476,0.06094754747276376,1176.7835631370544,428.0340132713318,1448.4483184814453,51770,6420,45350,45350,0,11,6511000.0
6511,6511999,21.313278957852646,37.66000319922213,0.06094675653139037,1177.0263011455536,428.09920144081116,1448.642822265625,51781,6421,45360,45360,0,11,6512000.0
6512,6512999,21.312405474179357,37.6586108520202,0.06094682427909148,1177.3965058326721,428.1636173725128,1448.7445983886719,51805,6423,45382,45382,0,11,6513000.0
6513,6513999,21.31169158821837,37.65715227188766,0.060945957885413016,1177.766880273819,428.228346824646,1448.7455749511719,51819,6425,45394,45394,0,11,6514000.0
6514,6514999,21.310748872717237,37.655205892182266,0.06094453194286242,1177.8863742351532,428.2931318283081,1449.030460357666,51821,6425,45396,45396,0,11,6515000.0
6515,6515999,21.310102403598165,37.65362596323137,0.06094483711762033,1178.382675409317,428.35728645324707,1449.033145904541,51830,6428,45402,45402,0,11,6516000.0
6516,6516999,21.309483109719938,37.652052494001445,0.06094033887863959,1178.7493484020233,428.4214367866516,1449.266830444336,51844,6430,45414,45414,0,11,6517000.0
6517,6517999,21.308988220923517,37.650533197781094,0.06093588378858883,1178.991506099701,428.48648023605347,1449.4088821411133,51846,6431,45415,45415,0,11,6518000.0
6518,6518999,21.30865663870037,37.64949368540319,0.06093106620544142,1179.2507965564728,428.551696062088,1449.5483131408691,51858,6432,45426,45426,0,11,6519000.0
6519,6519999,21.308335764849254,37.64817697359729,0.06092342363018077,1179.3760859966278,428.6164450645447,1449.8661727905273,51861,6432,45429,45429,0,11,6520000.0
6520,6520999,21.30801098849553,37.64700859243683,0.0609104025747208,1179.7471010684967,428.6851999759674,1449.990119934082,51865,6434,45431,45431,0,11,6521000.0
6521,6521999,21.307744676627113,37.645696098986214,0.060898570571759625,1179.8899011611938,428.7615191936493,1450.2392616271973,51868,6434,45434,45434,0,11,6522000.0
6522,6522999,21.308540234124045,37.64499697505563,0.06086406561734092,1180.1417071819305,428.8253083229065,1450.616985321045,51880,6435,45445,45445,0,11,6523000.0
6523,6523999,21.309388155627456,37.64442611661891,0.060830645531442684,1180.5118420124054,428.89001846313477,1450.9040603637695,51905,6437,45468,45468,0,11,6524000.0
6524,6524999,21.308841752895976,37.64282785833336,0.06082924624204589,1180.8920361995697,428.9544425010681,1451.4809226989746,51938,6439,45499,45499,0,11,6525000.0
6525,6525999,21.307912321744833,37.64186789942473,0.06083298840197637,1181.0297849178314,429.0203220844269,1451.92183303833,51944,6439,45505,45505,0,11,6526000.0
6526,6526999,21.306965504124634,37.640654739621496,0.060839019953399354,1181.1564145088196,429.08531165122986,1452.1130065917969,51944,6439,45505,45505,0,11,6527000.0
6527,6527999,21.305769623065792,37.63857853000441,0.06084949868872358,1181.7560296058655,429.14923667907715,1452.3087997436523,51966,6443,45523,45523,0,11,6528000.0
6528,6528999,21.304724070644323,37.636493138047896,0.0608628297275261,1182.0057425498962,429.2148082256317,1452.4201545715332,51969,6444,45525,45525,0,11,6529000.0
6529,6529999,21.303658927927867,37.63446590129181,0.060871217225168195,1182.368459701538,429.27927136421204,1452.6893348693848,51979,6446,45533,45533,0,11,6530000.0
6530,6530999,21.30267455789628,37.63260930702308,0.060879189653845645,1182.6014902591705,429.34387254714966,1452.8870849609375,51982,6447,45535,45535,0,11,6531000.0
6531,6531999,21.301722148175415,37.63071137248942,0.0608855732832817,1182.85218501091,429.41025280952454,1453.0902481079102,51985,6448,45537,45537,0,11,6532000.0
6532,6532999,21.30095898185719,37.628834020612274,0.06088280979936833,1183.2211453914642,429.4764070510864,1453.4983291625977,52006,6450,45556,45556,0,11,6533000.0
6533,6533999,21.300759368798985,37.62763808607566,0.06086942556828845,1183.328822851181,429.53755402565,1453.8619270324707,52007,6450,45557,45557,0,11,6534000.0
6534,6534999,21.30035591024722,37.6259597093117,0.0608606272728196,1183.444274187088,429.603387594223,1454.095371246338,52008,6450,45558,45558,0,11,6535000.0
6535,6535999,21.300482437715104,37.6249937441248,0.06083430186587546,1183.8309848308563,429.67383313179016,1454.8397254943848,52027,6452,45575,45575,0,11,6536000.0
6536,6536999,21.30047266732539,37.62409544902405,0.06081144501560387,1183.9458267688751,429.7409317493439,1455.2092666625977,52027,6452,45575,45575,0,11,6537000.0
6537,6537999,21.300119359987495,37.62250324771339,0.06079945276975107,1184.301156282425,429.804621219635,1455.6994094848633,52054,6454,45600,45600,0,11,6538000.0
6538,6538999,21.30003552114342,37.621282043566,0.060777696768873124,1184.6502199172974,429.8680565357208,1456.085823059082,52088,6456,45632,45632,0,11,6539000.0
6539,6539999,21.299630234070165,37.61968864115066,0.060766891343370766,1184.8869740962982,429.933758020401,1456.1971969604492,52091,6457,45634,45634,0,11,6540000.0
6540,6540999,21.29920838523818,37.618025162044475,0.06075946521838993,1185.35883975029,429.99779081344604,1456.6355247497559,52112,6460,45652,45652,0,11,6541000.0
6541,6541999,21.298447479996405,37.6178092685639,0.06075320910385107,1185.4862813949585,430.06255745887756,1457.2152709960938,52126,6460,45666,45666,0,11,6542000.0
6542,6542999,21.29741755511094,37.61601209691075,0.06075402831332832,1185.7307012081146,430.12701654434204,1457.516887664795,52131,6461,45670,45670,0,11,6543000.0
6543,6543999,21.29667651855049,37.61627926967611,0.060755549382820795,1186.332351922989,430.1923966407776,1457.5982513427734,52165,6465,45700,45700,0,11,6544000.0
6544,6544999,21.295707372309874,37.61461734687537,0.06076295799343223,1186.4679698944092,430.26071643829346,1457.8877220153809,52166,6465,45701,45701,0,11,6545000.0
6545,6545999,21.295085924262008,37.61344362428836,0.06076012603402192,1186.8243112564087,430.32432794570923,1458.3256454467773,52182,6467,45715,45715,0,11,6546000.0
6546,6546999,21.294536242975138,37.61210319763467,0.06075716456713176,1187.0740423202515,430.39024901390076,1458.5319519042969,52184,6468,45716,45716,0,11,6547000.0
6547,6547999,21.293893364202354,37.6108286559339,0.0607529334966157,1187.3071711063385,430.4545691013336,1458.8210144042969,52192,6469,45723,45723,0,11,6548000.0
6548,6548999,21.293407093279143,37.60937525573659,0.060747590295097464,1187.6928555965424,430.52044105529785,1458.847957611084,52205,6471,45734,45734,0,11,6549000.0
6549,6549999,21.29276398374846,37.60806682392905,0.06074265602708462,1187.8087222576141,430.5847632884979,1459.009132385254,52206,6471,45735,45735,0,11,6550000.0
6550,6550999,21.292541707394705,37.60705703808468,0.060726031511104894,1188.1790390014648,430.65037202835083,1459.2817611694336,52233,6473,45760,45760,0,11,6551000.0
6551,6551999,21.29271235120751,37.60700859199448,0.06070174899441316,1188.3008167743683,430.716157913208,1459.5945167541504,52233,6473,45760,45760,0,11,6552000.0
6552,6552999,21.292613126898253,37.606051349555706,0.06068024797199334,1188.537525177002,430.7827179431915,1459.7670402526855,52264,6474,45790,45790,0,11,6553000.0
6553,6553999,21.292586066288735,37.605541197003205,0.060665242125216734,1188.9113223552704,430.84793043136597,1460.1587562561035,52277,6476,45801,45801,0,11,6554000.0
6554,6554999,21.29261435012443,37.60457258226519,0.06064936680323385,1189.1525211334229,430.9121346473694,1460.4113578796387,52287,6477,45810,45810,0,11,6555000.0
6555,6555999,21.292639616411414,37.603529446779184,0.06063140409193035,1189.4019973278046,430.9770646095276,1460.537929534912,52294,6478,45816,45816,0,11,6556000.0
6556,6556999,21.292666770136766,37.60250454481525,0.060618382234149726,1189.6355607509613,431.0411698818207,1461.0131530761719,52307,6479,45828,45828,0,11,6557000.0
6557,6557999,21.29240766289032,37.6013050455659,0.06060270151956082,1189.7490208148956,431.1035830974579,1461.210693359375,52307,6479,45828,45828,0,11,6558000.0
6558,6558999,21.29217291926988,37.599911318706525,0.06059581095458866,1190.0138807296753,431.17586612701416,1461.4197578430176,52313,6480,45833,45833,0,11,6559000.0
6559,6559999,21.291581338365898,37.59878700938566,0.060587282105443396,1190.264622926712,431.2394802570343,1461.8349533081055,52326,6481,45845,45845,0,11,6560000.0
6560,6560999,21.291400328447907,37.603873760466314,0.0605404520654339,1190.3856563568115,431.3018128871918,1462.25834274292,52335,6481,45854,45854,0,11,6561000.0
6561,6561999,21.29050607887147,37.60243435198774,0.06053378855348046,1190.628643989563,431.36726689338684,1462.538860321045,52341,6482,45859,45859,0,11,6562000.0
6562,6562999,21.2896787633441,37.60170525043135,0.06053482696037471,1190.7617700099945,431.4315388202667,1462.7233924865723,52343,6482,45861,45861,0,11,6563000.0
6563,6563999,21.28877637771322,37.60009250441722,0.060538122580255926,1190.8887374401093,431.49647402763367,1462.960292816162,52346,6482,45864,45864,0,11,6564000.0
6564,6564999,21.287938273764496,37.598876891110876,0.060536730849523934,1191.1224324703217,431.56380105018616,1463.246021270752,52358,6483,45875,45875,0,11,6565000.0
6565,6565999,21.287006752046565,37.597637461511226,0.06053484718356106,1191.2391963005066,431.6278123855591,1463.441234588623,52359,6483,45876,45876,0,11,6566000.0
6566,6566999,21.286332975129085,37.59612926197715,0.06053119722593825,1191.723774433136,431.69279170036316,1463.5973434448242,52377,6486,45891,45891,0,11,6567000.0
6567,6567999,21.286111778293584,37.595582003852975,0.06052158806570229,1191.9707279205322,431.75886845588684,1463.7889862060547,52389,6487,45902,45902,0,11,6568000.0
6568,6568999,21.285796934567376,37.5946023079883,0.060516221365950584,1192.2091279029846,431.8221106529236,1463.8924751281738,52396,6488,45908,45908,0,11,6569000.0
6569,6569999,21.285410080758997,37.59339439793213,0.06050629422408682,1192.5841836929321,431.8870007991791,1464.11861038208,52404,6490,45914,45914,0,11,6570000.0
6570,6570999,21.285523377793975,37.592976241047076,0.06048607164148334,1192.953406572342,431.9518802165985,1464.3576126098633,52419,6492,45927,45927,0,11,6571000.0
6571,6571999,21.28570547853835,37.59269943427592,0.06047825866414902,1193.190355539322,432.0173354148865,1464.5074081420898,52421,6493,45928,45928,0,11,6572000.0
6572,6572999,21.285888345094314,37.59213466680647,0.06047687044173922,1193.4647009372711,432.08683490753174,1464.6489868164062,52425,6494,45931,45931,0,11,6573000.0
6573,6573999,21.286749559114174,37.592581936615105,0.060466643917548524,1193.6027572154999,432.1614933013916,1465.1065521240234,52433,6494,45939,45939,0,11,6574000.0
6574,6574999,21.28749959799276,37.59296075687107,0.06047109645359494,1193.8387670516968,432.2260220050812,1465.2064247131348,52439,6495,45944,45944,0,11,6575000.0
6575,6575999,21.289167828537444,37.595537309436764,0.06049567026674507,1194.210664510727,432.29120802879333,1465.4314079284668,52455,6497,45958,45958,0,11,6576000.0
6576,6576999,21.29029186585738,37.59628407353713,0.060513634650953274,1194.7279036045074,432.3642385005951,1465.5773658752441,52474,6500,45974,45974,0,11,6577000.0
6577,6577999,21.291812286692522,37.599682822036606,0.06053234657490514,1194.9668145179749,432.4291446208954,1465.7885055541992,52486,6501,45985,45985,0,11,6578000.0
6578,6578999,21.293334961375123,37.60125820935929,0.06056645947913708,1195.205603837967,432.49303936958313,1466.0543746948242,52502,6502,46000,46000,0,11,6579000.0
6579,6579999,21.294265451566062,37.60164719144063,0.06058396166939051,1195.4433181285858,432.5566520690918,1466.2339630126953,52512,6503,46009,46009,0,11,6580000.0
6580,6580999,21.294506184231704,37.60173494836981,0.060584750783094,1195.6864030361176,432.61989998817444,1466.7345428466797,52536,6504,46032,46032,0,11,6581000.0
6581,6581999,21.29359740221629,37.600662141960335,0.060579603526763726,1196.0488011837006,432.68412232398987,1466.9374885559082,52553,6506,46047,46047,0,11,6582000.0
6582,6582999,21.29307184536932,37.60030298517069,0.0605738684120396,1196.1813144683838,432.7486379146576,1467.1904067993164,52553,6506,46047,46047,0,11,6583000.0
6583,6583999,21.292937594243387,37.60235726732774,0.060559031764271576,1196.3029885292053,432.8134469985962,1467.3411293029785,52553,6506,46047,46047,0,11,6584000.0
6584,6584999,21.292450787433488,37.60130178768472,0.060560182660094775,1196.5476129055023,432.87800884246826,1467.4379043579102,52556,6507,46049,46049,0,11,6585000.0
6585,6585999,21.292437703296688,37.60128017220612,0.06054838806973317,1196.9089827537537,432.9419946670532,1467.7289810180664,52572,6509,46063,46063,0,11,6586000.0
6586,6586999,21.29243785699089,37.600510443221765,0.060544296952620535,1197.2886848449707,433.0071165561676,1467.8780708312988,52584,6511,46073,46073,0,11,6587000.0
6587,6587999,21.292541224272078,37.600620060132705,0.06053745986628156,1197.4126462936401,433.07170820236206,1468.2154350280762,52591,6511,46080,46080,0,11,6588000.0
6588,6588999,21.29297741828773,37.60104343728161,0.06053438559993196,1197.5407297611237,433.13724303245544,1468.5176582336426,52593,6511,46082,46082,0,11,6589000.0
6589,6589999,21.293397297997224,37.60126451656088,0.06053928821658927,1197.7839255332947,433.20180463790894,1468.6442680358887,52595,6512,46083,46083,0,11,6590000.0
6590,6590999,21.294120284677444,37.60209832614288,0.06054619837900377,1198.1540982723236,433.2664670944214,1468.6987991333008,52599,6514,46085,46085,0,11,6591000.0
6591,6591999,21.295265125247493,37.60346507902748,0.0605610244872552,1198.278088569641,433.3305993080139,1469.1027755737305,52604,6514,46090,46090,0,11,6592000.0
6592,6592999,21.296582080905466,37.605161707632206,0.06058620042288787,1199.036777973175,433.39520239830017,1468.992389678955,52637,6519,46118,46118,0,11,6593000.0
6593,6593999,21.298438487490262,37.60985668891095,0.06062478875387722,1199.273116827011,433.4595534801483,1469.1368370056152,52639,6520,46119,46119,0,11,6594000.0
6594,6594999,21.299954837082293,37.61134754812842,0.060635736011038,1199.5136137008667,433.52444100379944,1469.5097351074219,52655,6521,46134,46134,0,11,6595000.0
6595,6595999,21.30224216478591,37.61660717377643,0.06069269580964687,1199.8806257247925,433.59026765823364,1469.628589630127,52663,6523,46140,46140,0,11,6596000.0
6596,6596999,21.304731405158698,37.62328374196394,0.06072847739957077,1200.122528553009,433.6540365219116,1469.74365234375,52672,6524,46148,46148,0,11,6597000.0
6597,6597999,21.30707495479767,37.62701444729458,0.06077858482116116,1200.496612071991,433.71765065193176,1470.1666297912598,52696,6526,46170,46170,0,11,6598000.0
6598,6598999,21.309128198863384,37.63111380200117,0.06082815531909758,1200.6146380901337,433.78314232826233,1470.37939453125,52696,6526,46170,46170,0,11,6599000.0
6599,6599999,21.31127148690654,37.634383880154104,0.060904396104321856,1201.106454372406,433.846314907074,1470.4652366638184,52718,6529,46189,46189,0,11,6600000.0
6600,6600999,21.3130286114487,37.636827541753924,0.060921900486156755,1201.354968070984,433.90951800346375,1470.6528701782227,52728,6530,46198,46198,0,11,6601000.0
6601,6601999,21.312581785332355,37.6357195263979,0.060924670603477615,1201.7123491764069,433.9748373031616,1470.972080230713,52744,6532,46212,46212,0,11,6602000.0
6602,6602999,21.311314738231516,37.63420115753326,0.0609269055736994,1202.0906066894531,434.04172253608704,1471.2253379821777,52755,6534,46221,46221,0,11,6603000.0
6603,6603999,21.310364369457616,37.63305582389502,0.06092355606455213,1202.3326969146729,434.10634112358093,1471.452262878418,52764,6535,46229,46229,0,11,6604000.0
6604,6604999,21.309351448549396,37.63164148396098,0.060924811148479696,1202.701772928238,434.1713526248932,1471.5159721374512,52777,6537,46240,46240,0,11,6605000.0
6605,6605999,21.30855415850727,37.630518394797505,0.060922294523966025,1202.9505631923676,434.2383773326874,1471.7410888671875,52790,6538,46252,46252,0,11,6606000.0
6606,6606999,21.30759147061152,37.62896899477489,0.060919691173397794,1203.1853249073029,434.3012969493866,1471.9910278320312,52794,6539,46255,46255,0,11,6607000.0
6607,6607999,21.3066331186869,37.62719904522285,0.060919573368524604,1203.5684032440186,434.3658094406128,1472.1080894470215,52799,6541,46258,46258,0,11,6608000.0
6608,6608999,21.30571296453186,37.62550456729242,0.060918105755621954,1203.6933708190918,434.432843208313,1472.4278717041016,52803,6541,46262,46262,0,11,6609000.0
6609,6609999,21.304800623218714,37.62365485163752,0.06091862760502054,1203.9474093914032,434.49697160720825,1472.569911956787,52809,6542,46267,46267,0,11,6610000.0
6610,6610999,21.30411941352176,37.62233343675344,0.06091742094277175,1204.4405682086945,434.5611093044281,1472.6233291625977,52829,6545,46284,46284,0,11,6611000.0
6611,6611999,21.303440045843594,37.62081232419171,0.06091718991159589,1204.808319568634,434.6260597705841,1472.8993759155273,52835,6547,46288,46288,0,11,6612000.0
6612,6612999,21.302960218843598,37.62008341123292,0.060920497844395016,1205.0677316188812,434.69832015037537,1473.1411170959473,52846,6548,46298,46298,0,11,6613000.0
6613,6613999,21.30229126684132,37.61853408509322,0.06092216265209538,1205.3131079673767,434.7633616924286,1473.3327178955078,52849,6549,46300,46300,0,11,6614000.0
6614,6614999,21.301905064873775,37.61741537235261,0.06092110923531868,1205.556926727295,434.8277006149292,1473.5012168884277,52861,6550,46311,46311,0,11,6615000.0
6615,6615999,21.301725414215205,37.61617095981449,0.060908011785437366,1205.938632965088,434.89198899269104,1473.899314880371,52877,6552,46325,46325,0,11,6616000.0
6616,6616999,21.30184012293232,37.61554878066954,0.0609026683860191,1206.058179140091,434.9563400745392,1474.1338424682617,52877,6552,46325,46325,0,11,6617000.0
6617,6617999,21.3019893174455,37.61480755953401,0.06089806589850755,1206.5558898448944,435.02187037467957,1474.385051727295,52908,6555,46353,46353,0,11,6618000.0
6618,6618999,21.301979650264357,37.61372157417895,0.060887192318865746,1206.7933781147003,435.08455514907837,1474.6131858825684,52912,6556,46356,46356,0,11,6619000.0
6619,6619999,21.302035884886013,37.61270796057022,0.060877293802736765,1206.9293310642242,435.158793926239,1474.811279296875,52912,6556,46356,46356,0,11,6620000.0
6620,6620999,21.302004555782165,37.61153386482783,0.06086126400999892,1207.19579744339,435.23303413391113,1475.0502548217773,52917,6557,46360,46360,0,11,6621000.0
6621,6621999,21.301678195713055,37.610072478834255,0.0608555141469328,1207.5821948051453,435.30133748054504,1475.201805114746,52937,6559,46378,46378,0,11,6622000.0
6622,6622999,21.300611561984482,37.60915899168198,0.06086197232117785,1207.7076561450958,435.36800742149353,1475.560646057129,52946,6559,46387,46387,0,11,6623000.0
6623,6623999,21.299570607512337,37.60774676673118,0.06085992264186646,1208.2010169029236,435.43272614479065,1475.870777130127,52999,6562,46437,46437,0,11,6624000.0
6624,6624999,21.29823095621059,37.6056275877227,0.06086641580538277,1208.5787024497986,435.4985637664795,1475.947494506836,53011,6564,46447,46447,0,11,6625000.0
6625,6625999,21.297152484190363,37.60373267669439,0.06087186476540851,1208.9516308307648,435.5653004646301,1476.0680351257324,53025,6566,46459,46459,0,11,6626000.0
6626,6626999,21.296194033314524,37.60220157198451,0.0608720523202565,1209.2146632671356,435.64085364341736,1476.3514671325684,53033,6567,46466,46466,0,11,6627000.0
6627,6627999,21.295330583748648,37.60068741569518,0.06087299197391416,1209.4753668308258,435.713027715683,1476.5443649291992,53038,6568,46470,46470,0,11,6628000.0
6628,6628999,21.294365040891478,37.5989357712013,0.0608733643286129,1209.8470528125763,435.7798328399658,1476.6460189819336,53047,6570,46477,46477,0,11,6629000.0
6629,6629999,21.293442887020724,37.59728031736064,0.060874077109644875,1209.9728376865387,435.8443331718445,1477.0366744995117,53051,6570,46481,46481,0,11,6630000.0
6630,6630999,21.292562881365438,37.595595419486465,0.060875043990030075,1210.2153282165527,435.9079587459564,1477.1697425842285,53053,6571,46482,46482,0,11,6631000.0
6631,6631999,21.291656214366636,37.5936580316317,0.06087710602105678,1210.3441808223724,435.9753384590149,1477.3144874572754,53054,6571,46483,46483,0,11,6632000.0
6632,6632999,21.29081600889836,37.5918994733853,0.06087533380143584,1210.4730277061462,436.03996682167053,1477.6668891906738,53056,6571,46485,46485,0,11,6633000.0
6633,6633999,21.290076456933694,37.59035280129149,0.06086766601866467,1210.7162568569183,436.10424637794495,1477.7953567504883,53067,6572,46495,46495,0,11,6634000.0
6634,6634999,21.28939324039432,37.589289499463796,0.060863882938059666,1211.0749430656433,436.16864562034607,1477.9031066894531,53088,6574,46514,46514,0,11,6635000.0
6635,6635999,21.289016547945383,37.58796563242392,0.06085685600024382,1211.200740814209,436.23221731185913,1478.2171516418457,53092,6574,46518,46518,0,11,6636000.0
6636,6636999,21.28867806463379,37.586950577836134,0.06084456275332628,1211.44615316391,436.29650712013245,1478.3521003723145,53096,6575,46521,46521,0,11,6637000.0
6637,6637999,21.28828221796325,37.58551480507206,0.06083676423737072,1211.5703010559082,436.362247467041,1478.486961364746,53096,6575,46521,46521,0,11,6638000.0
6638,6638999,21.288169434355822,37.58427796397114,0.06081946452764464,1211.6969709396362,436.42626452445984,1478.9461364746094,53100,6575,46525,46525,0,11,6639000.0
6639,6639999,21.287966687582472,37.58302936698142,0.06080586199605753,1211.820161819458,436.48946833610535,1479.1300048828125,53100,6575,46525,46525,0,11,6640000.0
6640,6640999,21.287864587810557,37.583780149238,0.0607919424031772,1212.0613389015198,436.5546655654907,1479.231918334961,53103,6576,46527,46527,0,11,6641000.0
6641,6641999,21.287595543624846,37.58226760985042,0.060781957075422444,1212.314237833023,436.61971616744995,1479.458740234375,53106,6577,46529,46529,0,11,6642000.0
6642,6642999,21.287192653480616,37.58065546087812,0.06077949566135343,1212.5539264678955,436.68241357803345,1479.8286170959473,53124,6578,46546,46546,0,11,6643000.0
6643,6643999,21.28608759463153,37.57935306967614,0.06078435990584785,1212.6786251068115,436.7476029396057,1480.0746421813965,53128,6578,46550,46550,0,11,6644000.0
6644,6644999,21.28482841891418,37.57750137085882,0.06079033407549228,1212.926270723343,436.8113760948181,1480.2612838745117,53131,6579,46552,46552,0,11,6645000.0
6645,6645999,21.28366834089812,37.57575679217836,0.06079604722256804,1213.0495989322662,436.8750853538513,1480.439151763916,53133,6579,46554,46554,0,11,6646000.0
6646,6646999,21.28286234286938,37.57417206559629,0.06080071866647563,1213.5487697124481,436.9398102760315,1480.5061874389648,53159,6582,46577,46577,0,11,6647000.0
6647,6647999,21.281888268963613,37.57227774075533,0.06080510168757969,1213.678624868393,437.0049331188202,1480.8301162719727,53162,6582,46580,46580,0,11,6648000.0
6648,6648999,21.28100116236889,37.570382644477114,0.06081056771270121,1213.802330493927,437.0711352825165,1481.0065078735352,53163,6582,46581,46581,0,11,6649000.0
6649,6649999,21.2802211916195,37.568697596871715,0.06081462365688839,1214.299239397049,437.13551473617554,1481.1554641723633,53182,6585,46597,46597,0,11,6650000.0
6650,6650999,21.279431724542732,37.56707750064602,0.06082088796903051,1214.5359876155853,437.1996693611145,1481.3772430419922,53185,6586,46599,46599,0,11,6651000.0
6651,6651999,21.278707206297103,37.56573903777952,0.06082447271189384,1214.9025762081146,437.2648720741272,1481.5187377929688,53190,6588,46602,46602,0,11,6652000.0
6652,6652999,21.278257364679092,37.564437728214905,0.06083129856451286,1215.1478126049042,437.3284020423889,1481.6754989624023,53193,6589,46604,46604,0,11,6653000.0
6653,6653999,21.27806632805705,37.56339709826821,0.06082792954485883,1215.3908727169037,437.3913416862488,1481.8942337036133,53199,6590,46609,46609,0,11,6654000.0
6654,6654999,21.27761527250559,37.56228358157999,0.060828329626240074,1215.6443767547607,437.4564709663391,1482.007610321045,53201,6591,46610,46610,0,11,6655000.0
6655,6655999,21.27716063480692,37.5617602035423,0.06083005721279788,1215.8998081684113,437.52225947380066,1482.033779144287,53203,6592,46611,46611,0,11,6656000.0
6656,6656999,21.276882152000287,37.56056085160704,0.06082605117781237,1216.1483073234558,437.5859479904175,1482.5072975158691,53214,6593,46621,46621,0,11,6657000.0
6657,6657999,21.27702519376209,37.560457543521856,0.06082302897708769,1216.2659034729004,437.6497642993927,1482.738784790039,53214,6593,46621,46621,0,11,6658000.0
6658,6658999,21.276897787873327,37.55951111668154,0.06082411983102509,1216.5090548992157,437.71414828300476,1482.8435249328613,53220,6594,46626,46626,0,11,6659000.0
6659,6659999,21.276785089391794,37.5586664484457,0.060808061431702365,1216.62580037117,437.77877593040466,1483.5310859680176,53236,6594,46642,46642,0,11,6660000.0
6660,6660999,21.276623627576353,37.55750598943143,0.060805556012337836,1216.7429175376892,437.8407425880432,1483.7451934814453,53236,6594,46642,46642,0,11,6661000.0
6661,6661999,21.276416425250506,37.55617363326671,0.060806373613407905,1216.9809470176697,437.9038898944855,1483.977466583252,53246,6595,46651,46651,0,11,6662000.0
6662,6662999,21.276273971785734,37.55477610925493,0.06079658419167966,1217.0907361507416,437.96679759025574,1484.3148460388184,53249,6595,46654,46654,0,11,6663000.0
6663,6663999,21.276217184416417,37.55503224161931,0.060785910938065624,1217.5807490348816,438.0307354927063,1484.6275024414062,53290,6598,46692,46692,0,11,6664000.0
6664,6664999,21.275697964284987,37.55468844520086,0.06078528176418607,1217.8369364738464,438.0977039337158,1484.9342155456543,53298,6599,46699,46699,0,11,6665000.0
6665,6665999,21.274844341686528,37.5534663625354,0.06078647693953865,1217.9577219486237,438.1646330356598,1485.1678924560547,53298,6599,46699,46699,0,11,6666000.0
6666,6666999,21.274108951051172,37.55224462878508,0.06078881641270806,1218.3269293308258,438.2296299934387,1485.3005714416504,53313,6601,46712,46712,0,11,6667000.0
6667,6667999,21.27370043060789,37.55177290815395,0.06078779133836065,1218.5725905895233,438.2946500778198,1485.413501739502,53321,6602,46719,46719,0,11,6668000.0
6668,6668999,21.273245453014077,37.551012102027045,0.06078505416239266,1218.8099586963654,438.3576822280884,1485.68359375,53334,6603,46731,46731,0,11,6669000.0
6669,6669999,21.273218688476845,37.550788729510906,0.06077685215589801,1219.0537059307098,438.42189288139343,1485.8509063720703,53337,6604,46733,46733,0,11,6670000.0
6670,6670999,21.27313521467529,37.55062858658745,0.060765685904073274,1219.3019452095032,438.48622131347656,1486.1017570495605,53350,6605,46745,46745,0,11,6671000.0
6671,6671999,21.272910623844172,37.5498334368526,0.060757703253485285,1219.4169764518738,438.54983854293823,1486.276596069336,53351,6605,46746,46746,0,11,6672000.0
6672,6672999,21.27289357488215,37.54940682934319,0.06074770518816219,1219.7884466648102,438.6137464046478,1486.3664512634277,53360,6607,46753,46753,0,11,6673000.0
6673,6673999,21.272955090696716,37.549621445597666,0.060741277675474326,1220.174988746643,438.67831897735596,1486.5955085754395,53371,6609,46762,46762,0,11,6674000.0
6674,6674999,21.273661805724096,37.55001628699192,0.060708371444479714,1220.28964138031,438.7433533668518,1487.1310424804688,53377,6609,46768,46768,0,11,6675000.0
6675,6675999,21.27405096457867,37.54995445393691,0.06069473454241536,1220.5326154232025,438.80732679367065,1487.291904449463,53380,6610,46770,46770,0,11,6676000.0
6676,6676999,21.274844581197474,37.551044404449975,0.06069109284012508,1221.138126373291,438.8726074695587,1487.343002319336,53388,6614,46774,46774,0,11,6677000.0
6677,6677999,21.276197503795135,37.55321007317387,0.060663402003429345,1221.2525129318237,438.93645000457764,1488.0990829467773,53395,6614,46781,46781,0,11,6678000.0
6678,6678999,21.277195705332538,37.55414778311053,0.06065020158902579,1221.3655815124512,438.99977564811707,1488.3232307434082,53395,6614,46781,46781,0,11,6679000.0
6679,6679999,21.278589092681262,37.556732494630864,0.060632859190468125,1221.4890143871307,439.0639691352844,1488.7698364257812,53406,6614,46792,46792,0,11,6680000.0
6680,6680999,21.279969332896858,37.5591585789936,0.06061478695547762,1221.6029682159424,439.12750911712646,1489.1112785339355,53407,6614,46793,46793,0,11,6681000.0
6681,6681999,21.2813566883759,37.56141859728931,0.06061690618906601,1221.8427090644836,439.19102454185486,1489.2320518493652,53438,6615,46823,46823,0,11,6682000.0
6682,6682999,21.2831865305578,37.564810158112266,0.0606294564854567,1221.9580101966858,439.2543315887451,1489.5678482055664,53442,6615,46827,46827,0,11,6683000.0
6683,6683999,21.284737269166012,37.56775808789203,0.06062804345139072,1222.0689795017242,439.31556367874146,1489.7362060546875,53442,6615,46827,46827,0,11,6684000.0
6684,6684999,21.28501600922997,37.57005995334135,0.06061916831176106,1222.3205573558807,439.3798885345459,1490.2220039367676,53473,6616,46857,46857,0,11,6685000.0
6685,6685999,21.285060742005548,37.579970979921065,0.060584251837830005,1222.4560091495514,439.4464900493622,1490.8722801208496,53499,6616,46883,46883,0,11,6686000.0
6686,6686999,21.28468804815434,37.580411019577475,0.06058059011011896,1222.710869550705,439.5116083621979,1491.3215637207031,53519,6617,46902,46902,0,11,6687000.0
6687,6687999,21.28439899333534,37.58305369543386,0.060569219452633605,1222.968002319336,439.5780351161957,1491.698802947998,53535,6618,46917,46917,0,11,6688000.0
6688,6688999,21.28378849363156,37.58221692286692,0.06056851662413765,1223.3440990447998,439.6452877521515,1491.85933303833,53552,6620,46932,46932,0,11,6689000.0
6689,6689999,21.283569412761278,37.58455417302901,0.06056332848696733,1223.7092564105988,439.7103922367096,1492.1534385681152,53571,6622,46949,46949,0,11,6690000.0
6690,6690999,21.283726114558384,37.58508673946525,0.060550929766777006,1223.8317861557007,439.7743515968323,1492.6709327697754,53585,6622,46963,46963,0,11,6691000.0
6691,6691999,21.28349204122615,37.58418279766964,0.06054800380547731,1224.2040061950684,439.83860039711,1492.793571472168,53600,6624,46976,46976,0,11,6692000.0
6692,6692999,21.284224595531324,37.586139383127616,0.060538515684241956,1224.5669915676117,439.9026517868042,1492.9686660766602,53616,6626,46990,46990,0,11,6693000.0
6693,6693999,21.284389153920173,37.58680472240411,0.060535477403148796,1224.9355313777924,439.9661545753479,1493.2083358764648,53631,6628,47003,47003,0,11,6694000.0
6694,6694999,21.285223651999612,37.58910505628045,0.060541072312962685,1225.2963888645172,440.0307149887085,1493.374252319336,53651,6630,47021,47021,0,11,6695000.0
6695,6695999,21.28627358076343,37.59551791437688,0.06052149364410242,1225.6669409275055,440.09486722946167,1493.7838134765625,53673,6632,47041,47041,0,11,6696000.0
6696,6696999,21.28736531467631,37.59776925952409,0.060519278216085604,1225.7852656841278,440.16020607948303,1494.0708045959473,53676,6632,47044,47044,0,11,6697000.0
6697,6697999,21.288828395231455,37.60097697667735,0.06048322315599286,1226.0264389514923,440.2234265804291,1494.6202430725098,53692,6633,47059,47059,0,11,6698000.0
6698,6698999,21.290642287000136,37.60653407534591,0.06051601489512359,1226.2756831645966,440.2888822555542,1494.8577346801758,53704,6634,47070,47070,0,11,6699000.0
6699,6699999,21.291101283477456,37.60657081614624,0.060516607914687826,1226.758374929428,440.35419273376465,1495.3889083862305,53735,6637,47098,47098,0,11,6700000.0
6700,6700999,21.29090363328696,37.60804821556809,0.06050415750001337,1227.1434774398804,440.41815853118896,1495.8126182556152,53760,6639,47121,47121,0,11,6701000.0
6701,6701999,21.290402113004177,37.60745413802462,0.06051470863247521,1227.3957087993622,440.4833519458771,1496.0694999694824,53772,6640,47132,47132,0,11,6702000.0
6702,6702999,21.290296699857628,37.60785227340995,0.06052237735106525,1227.6470739841461,440.54872369766235,1496.2472457885742,53777,6641,47136,47136,0,11,6703000.0
6703,6703999,21.29016052134495,37.60772784323276,0.060507583298342604,1227.897164106369,440.6155126094818,1496.6699333190918,53792,6642,47150,47150,0,11,6704000.0
6704,6704999,21.290021083362877,37.60745973083309,0.06050757689044195,1228.3882772922516,440.67995834350586,1496.7897109985352,53802,6645,47157,47157,0,11,6705000.0
6705,6705999,21.290259207734064,37.607791772073966,0.060503417218482736,1228.7570915222168,440.74537420272827,1497.3695487976074,53838,6647,47191,47191,0,11,6706000.0
6706,6706999,21.290631622579852,37.60800675840466,0.06050241036684034,1229.1378004550934,440.8125352859497,1497.62601852417,53851,6649,47202,47202,0,11,6707000.0
6707,6707999,21.291369141267147,37.609365117400664,0.0605159115243179,1229.5020852088928,440.8778119087219,1498.0515632629395,53868,6651,47217,47217,0,11,6708000.0
6708,6708999,21.292082119343775,37.61039529199913,0.06051425175887226,1229.6208317279816,440.9413776397705,1498.4435920715332,53874,6651,47223,47223,0,11,6709000.0
6709,6709999,21.293144141705856,37.61178495748886,0.06050618231692606,1230.23668050766,441.00685119628906,1498.4612579345703,53888,6655,47233,47233,0,11,6710000.0
6710,6710999,21.293765809439446,37.612587582059085,0.060510458938490275,1230.475746870041,441.0728394985199,1498.706527709961,53892,6656,47236,47236,0,11,6711000.0
6711,6711999,21.29482646585863,37.614095140211,0.060509933322520304,1230.8461000919342,441.13640427589417,1498.9909210205078,53908,6658,47250,47250,0,11,6712000.0
6712,6712999,21.296252868942013,37.61710575205291,0.06049436564081012,1231.083601474762,441.19937777519226,1499.218276977539,53913,6659,47254,47254,0,11,6713000.0
6713,6713999,21.297445543618153,37.618444998063545,0.06050152158874644,1231.1944992542267,441.2629804611206,1499.4562759399414,53913,6659,47254,47254,0,11,6714000.0
6714,6714999,21.299102014564852,37.62141189458878,0.06049288509295181,1231.444852590561,441.3276262283325,1500.0074424743652,53940,6660,47280,47280,0,11,6715000.0
6715,6715999,21.300031258355393,37.62227526244911,0.06050264824020901,1232.1780695915222,441.3910632133484,1500.0493049621582,53961,6665,47296,47296,0,11,6716000.0
6716,6716999,21.301396808890697,37.62349082105701,0.06051294841245769,1232.4309148788452,441.45605301856995,1500.2750205993652,53971,6666,47305,47305,0,11,6717000.0
6717,6717999,21.30260975457134,37.62474935802879,0.06050190552562096,1232.6708543300629,441.5192458629608,1500.5845565795898,53987,6667,47320,47320,0,11,6718000.0
6718,6718999,21.30284855642582,37.62581374197269,0.06047791177710293,1233.0398890972137,441.58881163597107,1500.9423828125,54014,6669,47345,47345,0,11,6719000.0
6719,6719999,21.302256409854195,37.626940691677774,0.060469212794258875,1233.150910615921,441.65096950531006,1501.1285972595215,54015,6669,47346,47346,0,11,6720000.0
6720,6720999,21.30136596068604,37.62569833162513,0.0604706000840215,1233.2758285999298,441.7162461280823,1501.3491172790527,54017,6669,47348,47348,0,11,6721000.0
6721,6721999,21.300676081665507,37.62450349767999,0.06047070785121045,1233.6529095172882,441.7800028324127,1501.3910026550293,54021,6671,47350,47350,0,11,6722000.0
6722,6722999,21.300247161788754,37.62437576899178,0.0604645779589168,1233.7801361083984,441.84466004371643,1501.5297813415527,54021,6671,47350,47350,0,11,6723000.0
6723,6723999,21.300023059890385,37.623684836594045,0.06044780233557856,1234.0171468257904,441.9075951576233,1501.8428268432617,54030,6672,47358,47358,0,11,6724000.0
6724,6724999,21.299683168937648,37.622627717574495,0.06044461742246321,1234.6519916057587,441.9729242324829,1501.9586791992188,54046,6676,47370,47370,0,11,6725000.0
6725,6725999,21.29964564940423,37.622192563792545,0.06043946578580417,1235.2931146621704,442.03911900520325,1502.1002922058105,54070,6680,47390,47390,0,11,6726000.0
6726,6726999,21.299454027364174,37.621557889268644,0.060433348658221586,1235.5444881916046,442.10538697242737,1502.3068771362305,54081,6681,47400,47400,0,11,6727000.0
6727,6727999,21.29979634912653,37.6220114444513,0.0604253501549612,1235.796474456787,442.16866850852966,1502.4958419799805,54084,6682,47402,47402,0,11,6728000.0
6728,6728999,21.300004973713236,37.621883771216915,0.06042142158623387,1236.177238225937,442.232061624527,1502.5625343322754,54098,6684,47414,47414,0,11,6729000.0
6729,6729999,21.300222134496448,37.62162355878181,0.06041892740729038,1236.3068602085114,442.29636120796204,1502.6731643676758,54098,6684,47414,47414,0,11,6730000.0
6730,6730999,21.300605544743423,37.621923465588665,0.06041597573907176,1236.5575845241547,442.36241483688354,1502.7370643615723,54109,6685,47424,47424,0,11,6731000.0
6731,6731999,21.300875485603772,37.62178587737536,0.06041148861119727,1236.6831440925598,442.42836332321167,1502.8336296081543,54109,6685,47424,47424,0,11,6732000.0
6732,6732999,21.301123739948842,37.62149010624583,0.06040245314025461,1236.9308314323425,442.4927520751953,1503.153408050537,54127,6686,47441,47441,0,11,6733000.0
6733,6733999,21.301805230203605,37.62187574629331,0.060402776014042536,1237.294958114624,442.55595779418945,1503.244068145752,54149,6688,47461,47461,0,11,6734000.0
6734,6734999,21.302258915342353,37.62153346911423,0.06039153893741578,1237.7987411022186,442.62056732177734,1503.5025901794434,54180,6691,47489,47489,0,11,6735000.0
6735,6735999,21.302773189874323,37.621081503521694,0.06038465943350324,1238.048094511032,442.6837420463562,1503.656093597412,54184,6692,47492,47492,0,11,6736000.0
6736,6736999,21.303060188337955,37.620584295240945,0.060383138845083284,1238.5528717041016,442.7474887371063,1503.5935325622559,54205,6695,47510,47510,0,11,6737000.0
6737,6737999,21.30338824257209,37.619907822236314,0.06038099301548594,1238.806113243103,442.8102777004242,1503.7813453674316,54218,6696,47522,47522,0,11,6738000.0
6738,6738999,21.303104742443104,37.61858113369559,0.06038049400109724,1239.0564239025116,442.8731949329376,1503.9304656982422,54224,6697,47527,47527,0,11,6739000.0
6739,6739999,21.30203902586406,37.61689308877147,0.0603838289674552,1239.430494070053,442.93584752082825,1504.1324729919434,54241,6699,47542,47542,0,11,6740000.0
6740,6740999,21.300963363474178,37.615718003943,0.06038699954859217,1239.551075220108,443.0002076625824,1504.5454711914062,54250,6699,47551,47551,0,11,6741000.0
6741,6741999,21.29999646151045,37.614294547119556,0.06039130722000319,1239.9346594810486,443.06562781333923,1504.6707611083984,54263,6701,47562,47562,0,11,6742000.0
6742,6742999,21.29913802511192,37.61266780927424,0.060398160282139735,1240.051656961441,443.12903475761414,1504.816234588623,54263,6701,47562,47562,0,11,6743000.0
6743,6743999,21.298326230716643,37.61097814089765,0.06040237524402581,1240.2935099601746,443.19217109680176,1505.0897636413574,54269,6702,47567,47567,0,11,6744000.0
6744,6744999,21.297611596151466,37.60941324673135,0.06040398312705819,1240.6823997497559,443.2557590007782,1505.2323913574219,54274,6704,47570,47570,0,11,6745000.0
6745,6745999,21.297006382176573,37.608199095953246,0.06041026329991561,1241.1952304840088,443.32101345062256,1505.528133392334,54299,6707,47592,47592,0,11,6746000.0
6746,6746999,21.296521887644776,37.60732731293447,0.06040716771681465,1241.3056554794312,443.3833591938019,1505.7813301086426,54299,6707,47592,47592,0,11,6747000.0
6747,6747999,21.29607447650111,37.60624561047765,0.06040625827665802,1241.9360234737396,443.4498748779297,1505.8816108703613,54329,6711,47618,47618,0,11,6748000.0
6748,6748999,21.295782546586647,37.605838579285134,0.060407219319821626,1242.4510400295258,443.51493191719055,1506.0086517333984,54339,6714,47625,47625,0,11,6749000.0
6749,6749999,21.295448213698275,37.604743377564795,0.06040628438934992,1242.9620583057404,443.5792980194092,1506.2361068725586,54348,6717,47631,47631,0,11,6750000.0
6750,6750999,21.295235942215065,37.60394574112878,0.06040683561560656,1243.3376259803772,443.64458775520325,1506.341697692871,54352,6719,47633,47633,0,11,6751000.0
6751,6751999,21.295298077508328,37.605265671695555,0.06040369389949252,1243.580586194992,443.70778703689575,1506.5906448364258,54357,6720,47637,47637,0,11,6752000.0
6752,6752999,21.2955895593422,37.60525505705539,0.060392069445698304,1243.9631056785583,443.7710633277893,1506.7476959228516,54369,6722,47647,47647,0,11,6753000.0
6753,6753999,21.296122193035487,37.60560131066553,0.06039958600684181,1244.200604915619,443.83516216278076,1506.8809242248535,54371,6723,47648,47648,0,11,6754000.0
6754,6754999,21.296898170497066,37.607587935931264,0.06039298041591401,1244.571495771408,443.8987913131714,1507.2274894714355,54393,6725,47668,47668,0,11,6755000.0
6755,6755999,21.297821978256767,37.60838794059564,0.06040042942344093,1244.8216967582703,443.961323261261,1507.4723587036133,54406,6726,47680,47680,0,11,6756000.0
6756,6756999,21.298544739783214,37.608971574037305,0.060405380373731665,1245.3136649131775,444.0248408317566,1507.5236282348633,54429,6729,47700,47700,0,11,6757000.0
6757,6757999,21.29929608105366,37.60957510577726,0.060405789382528385,1245.434267282486,444.0883455276489,1507.8166809082031,54433,6729,47704,47704,0,11,6758000.0
6758,6758999,21.299156542248614,37.60878078036198,0.06040890609714511,1246.1959562301636,444.15161395072937,1507.8668518066406,54469,6734,47735,47735,0,11,6759000.0
6759,6759999,21.29861894499055,37.60839171764514,0.06041107302679194,1246.4451081752777,444.21466732025146,1508.157917022705,54483,6735,47748,47748,0,11,6760000.0
6760,6760999,21.298517979749263,37.60932318235394,0.060406530838665096,1246.5755710601807,444.28193712234497,1508.417797088623,54487,6735,47752,47752,0,11,6761000.0
6761,6761999,21.29857903812101,37.60991985602094,0.06041236736312616,1246.7045097351074,444.3458013534546,1508.5963287353516,54488,6735,47753,47753,0,11,6762000.0
6762,6762999,21.299207067709,37.610989203257226,0.06041035144620155,1246.9519913196564,444.4099235534668,1508.8818817138672,54500,6736,47764,47764,0,11,6763000.0
6763,6763999,21.30038263611629,37.61274999350062,0.06040581094642661,1247.3253252506256,444.4756817817688,1509.0524139404297,54513,6738,47775,47775,0,11,6764000.0
6764,6764999,21.301276603208407,37.613668763279954,0.06040211853557709,1247.568282365799,444.5390169620514,1509.2342948913574,54515,6739,47776,47776,0,11,6765000.0
6765,6765999,21.30249311562524,37.61593428591001,0.06039069049158119,1248.3387551307678,444.60403847694397,1509.1845474243164,54549,6744,47805,47805,0,11,6766000.0
6766,6766999,21.30328407280604,37.61706210299427,0.06039104165051412,1248.4551243782043,444.6665315628052,1509.3280601501465,54549,6744,47805,47805,0,11,6767000.0
6767,6767999,21.304231117777697,37.618081832715895,0.06039228115027784,1248.970132112503,444.7309682369232,1509.2546310424805,54574,6747,47827,47827,0,11,6768000.0
6768,6768999,21.305804855642368,37.62038395534272,0.060386455835646946,1249.2244911193848,444.79714035987854,1509.3940467834473,54586,6748,47838,47838,0,11,6769000.0
6769,6769999,21.307163276051575,37.62251641173067,0.06039669895528643,1249.720350265503,444.8600969314575,1509.3296546936035,54601,6751,47850,47850,0,11,6770000.0
6770,6770999,21.30837958089056,37.62409515937206,0.06040297516808901,1250.21648478508,444.9230945110321,1509.35791015625,54616,6754,47862,47862,0,11,6771000.0
6771,6771999,21.30955782713407,37.625685398535126,0.06039970802238592,1250.4617693424225,444.9858784675598,1509.7457962036133,54628,6755,47873,47873,0,11,6772000.0
6772,6772999,21.31102466619941,37.627892552422225,0.06040805565281626,1250.8501906394958,445.0502905845642,1509.8573570251465,54635,6757,47878,47878,0,11,6773000.0
6773,6773999,21.312274155576425,37.62943866458157,0.0604149380023985,1251.0886826515198,445.11407709121704,1509.9745979309082,54638,6758,47880,47880,0,11,6774000.0
6774,6774999,21.313817822042605,37.631112978905655,0.06041468166264563,1251.3404216766357,445.17686676979065,1510.209373474121,54652,6759,47893,47893,0,11,6775000.0
6775,6775999,21.3150368573918,37.632563264465354,0.06042306245603568,1251.7103519439697,445.2404987812042,1510.2501106262207,54656,6761,47895,47895,0,11,6776000.0
6776,6776999,21.316304353635005,37.633689699339854,0.06041876839090632,1251.954752922058,445.3040442466736,1510.414478302002,54685,6762,47923,47923,0,11,6777000.0
6777,6777999,21.316858325874147,37.633646277797936,0.06041260617861577,1252.202808380127,445.36691546440125,1510.5405349731445,54697,6763,47934,47934,0,11,6778000.0
6778,6778999,21.31590290456409,37.632643279151225,0.06041247748944978,1252.318409204483,445.4288809299469,1510.8849449157715,54711,6763,47948,47948,0,11,6779000.0
6779,6779999,21.314679614496587,37.63150693220815,0.06041588567297862,1252.6976311206818,445.49306869506836,1511.0739402770996,54724,6765,47959,47959,0,11,6780000.0
6780,6780999,21.313472458398326,37.629699669824674,0.0604201932779459,1253.0833094120026,445.5590703487396,1511.155746459961,54738,6767,47971,47971,0,11,6781000.0
6781,6781999,21.312532255090588,37.62946888934161,0.0604181185902003,1253.2100195884705,445.6225538253784,1511.2963829040527,54739,6767,47972,47972,0,11,6782000.0
6782,6782999,21.311509350509702,37.62770949506044,0.06041889908197995,1253.4672327041626,445.6862373352051,1511.5197525024414,54753,6768,47985,47985,0,11,6783000.0
6783,6783999,21.310503149239373,37.6258648300063,0.06042168620182198,1253.7148308753967,445.74858593940735,1511.6184463500977,54755,6769,47986,47986,0,11,6784000.0
6784,6784999,21.30964755249678,37.62448883021951,0.06042400114502289,1253.9645040035248,445.81131386756897,1511.754581451416,54766,6770,47996,47996,0,11,6785000.0
6785,6785999,21.308881244299766,37.623015298016064,0.06042145488621031,1254.2106575965881,445.8742206096649,1512.0924911499023,54776,6771,48005,48005,0,11,6786000.0
6786,6786999,21.308295287032763,37.62227939927386,0.060418055431078366,1254.4532341957092,445.9384346008301,1512.2752723693848,54778,6772,48006,48006,0,11,6787000.0
6787,6787999,21.30760057375665,37.62081168360932,0.06042146969040518,1254.712764263153,446.0031387805939,1512.4510307312012,54780,6773,48007,48007,0,11,6788000.0
6788,6788999,21.307103125718,37.61964201651006,0.06041749827518883,1254.8286187648773,446.06709480285645,1512.6611595153809,54783,6773,48010,48010,0,11,6789000.0
6789,6789999,21.306888097156502,37.6190313814746,0.060407455736454785,1255.0938613414764,446.130188703537,1512.714756011963,54785,6774,48011,48011,0,11,6790000.0
6790,6790999,21.306725321627454,37.618316492172035,0.06040298126809707,1255.4662799835205,446.1929786205292,1512.6946601867676,54789,6776,48013,48013,0,11,6791000.0
6791,6791999,21.306707905707448,37.61758322266316,0.06039734159493304,1255.7195889949799,446.2570595741272,1513.0150260925293,54801,6777,48024,48024,0,11,6792000.0
6792,6792999,21.306767381090324,37.61704884334947,0.060389815192738894,1255.847490787506,446.32297253608704,1513.2499656677246,54802,6777,48025,48025,0,11,6793000.0
6793,6793999,21.30710509472543,37.61713058455837,0.06038342864211976,1255.967341184616,446.3853249549866,1513.36674118042,54802,6777,48025,48025,0,11,6794000.0
6794,6794999,21.307582521195272,37.617146424655,0.06037942541414465,1256.0824902057648,446.449506521225,1513.952922821045,54817,6777,48040,48040,0,11,6795000.0
6795,6795999,21.308539299330025,37.617552654939686,0.060377530826488224,1256.4502646923065,446.51261734962463,1514.141242980957,54839,6779,48060,48060,0,11,6796000.0
6796,6796999,21.30913971699837,37.6174919188008,0.06037914183052073,1256.5672047138214,446.5759241580963,1514.35306930542,54839,6779,48060,48060,0,11,6797000.0
6797,6797999,21.309875098287332,37.617575870558966,0.060384331379821354,1256.9651288986206,446.64781618118286,1514.5138626098633,54862,6781,48081,48081,0,11,6798000.0
6798,6798999,21.310011659273385,37.61698382701593,0.06038171893784794,1257.6225492954254,446.712363243103,1514.6960830688477,54892,6785,48107,48107,0,11,6799000.0
6799,6799999,21.30897144090475,37.61574220689147,0.060379582664489284,1258.0477075576782,446.7843060493469,1514.8670501708984,54901,6787,48114,48114,0,11,6800000.0
6800,6800999,21.308110159311877,37.61445644846508,0.06038094520849979,1258.437661409378,446.85417556762695,1515.1527481079102,54928,6789,48139,48139,0,11,6801000.0
6801,6801999,21.30751620776126,37.61372380771888,0.0603799059469774,1258.5728740692139,446.92301893234253,1515.333137512207,54928,6789,48139,48139,0,11,6802000.0
6802,6802999,21.30737177168886,37.6133672077566,0.06037317714454071,1258.8340647220612,446.9908490180969,1515.3979873657227,54931,6790,48141,48141,0,11,6803000.0
6803,6803999,21.307256416803693,37.61292854611973,0.060360502504238744,1259.0948729515076,447.0577895641327,1515.639804840088,54935,6791,48144,48144,0,11,6804000.0
6804,6804999,21.307041418765873,37.61199923106733,0.0603623235539138,1259.494313955307,447.12474393844604,1515.727855682373,54946,6793,48153,48153,0,11,6805000.0
6805,6805999,21.306654107526423,37.61128648220673,0.06035730385853766,1259.6202697753906,447.1911268234253,1515.9269485473633,54949,6793,48156,48156,0,11,6806000.0
6806,6806999,21.306490356721167,37.61080026865788,0.060350126796565484,1260.0291891098022,452.0228250026703,1516.1921043395996,54965,6795,48170,48170,0,11,6807000.0
6807,6807999,21.30648562761374,37.610348701604934,0.060352838579683876,1260.2967574596405,452.0897879600525,1516.2860145568848,54968,6796,48172,48172,0,11,6808000.0
6808,6808999,21.306445241906708,37.609545751473036,0.06034817457454611,1260.719042301178,452.1566107273102,1516.412696838379,54974,6798,48176,48176,0,11,6809000.0
6809,6809999,21.306406164714076,37.60867855070887,0.06033929323028131,1260.9869389533997,452.2230861186981,1516.6894569396973,54979,6799,48180,48180,0,11,6810000.0
6810,6810999,21.306892796185338,37.60907043462055,0.06034075393935601,1261.3892750740051,452.2900233268738,1516.8143348693848,55002,6801,48201,48201,0,11,6811000.0
6811,6811999,21.30731904420122,37.60905991670964,0.0603313301620767,1262.5035817623138,452.358437538147,1516.7455978393555,55046,6808,48238,48238,0,11,6812000.0
6812,6812999,21.30821833845856,37.60968933770404,0.06032633925173292,1262.7750933170319,452.4262492656708,1517.1716232299805,55054,6809,48245,48245,0,11,6813000.0
6813,6813999,21.308836691116056,37.60978606737967,0.060349893034477464,1262.9165577888489,452.49272751808167,1517.3492431640625,55054,6809,48245,48245,0,11,6814000.0
6814,6814999,21.309553071926192,37.61000986298102,0.060358595663748904,1263.3225910663605,452.55932211875916,1517.4751281738281,55070,6811,48259,48259,0,11,6815000.0
6815,6815999,21.31047651124089,37.61016604875308,0.06035705556171711,1263.7271704673767,452.62598609924316,1517.7110557556152,55087,6813,48274,48274,0,11,6816000.0
6816,6816999,21.311537774991844,37.61054054206441,0.06036537166446665,1263.8490839004517,452.69264125823975,1517.8791961669922,55087,6813,48274,48274,0,11,6817000.0
6817,6817999,21.312584615534263,37.61086229104831,0.060365990808495806,1264.122405052185,452.75834345817566,1518.1146697998047,55103,6814,48289,48289,0,11,6818000.0
6818,6818999,21.313345861452984,37.61112914182977,0.06035907515811667,1264.2543694972992,452.82482504844666,1518.2882080078125,55103,6814,48289,48289,0,11,6819000.0
6819,6819999,21.31269140687359,37.61037861452173,0.06035451615265597,1264.3745703697205,452.8908772468567,1518.656566619873,55116,6814,48302,48302,0,11,6820000.0
6820,6820999,21.311719641031356,37.60935369553991,0.06035689778768327,1264.6574256420135,452.9592242240906,1518.866584777832,55129,6815,48314,48314,0,11,6821000.0
6821,6821999,21.310781946607108,37.60776454399123,0.060364529909876175,1265.069801568985,453.0292055606842,1518.9461975097656,55135,6817,48318,48318,0,11,6822000.0
6822,6822999,21.309860612100984,37.606155054007694,0.06037148531966341,1265.4797127246857,453.0966684818268,1519.0762214660645,55146,6819,48327,48327,0,11,6823000.0
6823,6823999,21.30907117723223,37.60492867005102,0.06036997061543614,1265.5983164310455,453.16263365745544,1519.338264465332,55147,6819,48328,48328,0,11,6824000.0
6824,6824999,21.308576525698836,37.6041608141414,0.06036828980791842,1266.2898466587067,453.2306909561157,1519.3493690490723,55174,6823,48351,48351,0,11,6825000.0
6825,6825999,21.30805972517015,37.60304426172523,0.06036979679725207,1266.699053287506,453.30137491226196,1519.5710411071777,55191,6825,48366,48366,0,11,6826000.0
6826,6826999,21.307564424995995,37.601865416724614,0.06036857337178492,1266.9682095050812,453.3687570095062,1519.717430114746,55193,6826,48367,48367,0,11,6827000.0
6827,6827999,21.30707944391319,37.60079349531901,0.06036869330914296,1267.247150182724,453.43602418899536,1519.8103981018066,55195,6827,48368,48368,0,11,6828000.0
6828,6828999,21.306773570836906,37.59995190813225,0.06036904255257658,1267.5228180885315,453.50261664390564,1520.0236206054688,55202,6828,48374,48374,0,11,6829000.0
6829,6829999,21.306657189881257,37.599540371153026,0.06036392709614913,1267.9397854804993,453.5724947452545,1520.09672164917,55215,6830,48385,48385,0,11,6830000.0
6830,6830999,21.30691179279418,37.601346457005135,0.0603716219042334,1268.3414068222046,453.64022159576416,1520.2421264648438,55227,6832,48395,48395,0,11,6831000.0
6831,6831999,21.30737833519145,37.60275659474096,0.060362560019109335,1268.6056821346283,453.70746660232544,1520.5092849731445,55233,6833,48400,48400,0,11,6832000.0
6832,6832999,21.30773051789823,37.603030065454895,0.06036215253608679,1268.8775660991669,453.7744171619415,1520.582447052002,55235,6834,48401,48401,0,11,6833000.0
6833,6833999,21.308155541956992,37.60263021411036,0.06035365294011996,1269.0053749084473,453.84330916404724,1520.978416442871,55243,6834,48409,48409,0,11,6834000.0
6834,6834999,21.308469385732934,37.60318584824096,0.06033986737872643,1269.1405465602875,453.9112048149109,1521.2070426940918,55245,6834,48411,48411,0,11,6835000.0
6835,6835999,21.308491289713114,37.60333803296995,0.060337445643863674,1269.5401923656464,453.97774600982666,1521.4636611938477,55264,6836,48428,48428,0,11,6836000.0
6836,6836999,21.30796809719821,37.602964966722205,0.060346160523759296,1269.6685252189636,454.0472671985626,1521.8513298034668,55269,6836,48433,48433,0,11,6837000.0
6837,6837999,21.308092428035348,37.6085508513215,0.06034810034138183,1269.9576590061188,454.1157703399658,1522.01416015625,55277,6837,48440,48440,0,11,6838000.0
6838,6838999,21.307793817611994,37.607909613670664,0.060353035730734805,1270.0810546875,454.18358540534973,1522.1708984375,55277,6837,48440,48440,0,11,6839000.0
6839,6839999,21.30791217612323,37.609150812591515,0.06036397981796482,1270.4972093105316,454.25417041778564,1522.4675788879395,55293,6839,48454,48454,0,11,6840000.0
6840,6840999,21.307920602071036,37.608645107693086,0.06036373489220914,1271.3344361782074,454.3217730522156,1522.4541244506836,55319,6844,48475,48475,0,11,6841000.0
6841,6841999,21.307997886382935,37.60828084931709,0.06035743539612071,1271.4641606807709,454.3903830051422,1522.7750511169434,55322,6844,48478,48478,0,11,6842000.0
6842,6842999,21.308229199563026,37.61056294668971,0.06035195648988756,1271.8802199363708,454.4573550224304,1523.0429801940918,55347,6846,48501,48501,0,11,6843000.0
6843,6843999,21.308642765299563,37.61041238866091,0.060348601146794745,1272.2934114933014,454.52531147003174,1523.17924118042,55365,6848,48517,48517,0,11,6844000.0
6844,6844999,21.309209587977367,37.61084879652701,0.060337287450056065,1272.4296774864197,454.59324884414673,1523.5146598815918,55369,6848,48521,48521,0,11,6845000.0
6845,6845999,21.31010138967196,37.61376842246296,0.06033009610667539,1272.5590076446533,454.6600408554077,1523.6712608337402,55369,6848,48521,48521,0,11,6846000.0
6846,6846999,21.31060244717639,37.61436512403103,0.06033384039009548,1272.8264074325562,454.7271056175232,1523.7409744262695,55371,6849,48522,48522,0,11,6847000.0
6847,6847999,21.311825894291125,37.61573059780078,0.06033460284183756,1273.244048833847,454.7946503162384,1524.0660820007324,55393,6851,48542,48542,0,11,6848000.0
6848,6848999,21.31294287027141,37.61705411506774,0.060336811146832425,1273.5156381130219,454.86197328567505,1524.2645721435547,55403,6852,48551,48551,0,11,6849000.0
6849,6849999,21.31421140744976,37.618852758705614,0.0603414309400927,1273.7890629768372,454.9322862625122,1524.4854202270508,55415,6853,48562,48562,0,11,6850000.0
6850,6850999,21.31536662359604,37.61969924486967,0.060338478707896104,1274.0593807697296,455.00036668777466,1525.1291618347168,55432,6854,48578,48578,0,11,6851000.0
6851,6851999,21.316772323893538,37.622238323462064,0.06034625901319279,1274.323808670044,455.06745195388794,1525.3149375915527,55436,6855,48581,48581,0,11,6852000.0
6852,6852999,21.31782731915839,37.62380503184145,0.060361943418872355,1274.5941648483276,455.1349301338196,1525.4876022338867,55450,6856,48594,48594,0,11,6853000.0
6853,6853999,21.318522624473434,37.6239446198599,0.060365648269537386,1274.7298364639282,455.20151448249817,1525.7664642333984,55452,6856,48596,48596,0,11,6854000.0
6854,6854999,21.318628419663877,37.624423846263696,0.06034797309998674,1275.0004255771637,455.27141976356506,1526.1832466125488,55467,6857,48610,48610,0,11,6855000.0
6855,6855999,21.318296771560316,37.624055956302904,0.06035071771396927,1275.1401116847992,455.3400104045868,1526.5857009887695,55476,6857,48619,48619,0,11,6856000.0
6856,6856999,21.318090065138634,37.62491089490916,0.06034950918465609,1275.5460844039917,455.4076256752014,1526.7843399047852,55499,6859,48640,48640,0,11,6857000.0
6857,6857999,21.317831264752318,37.62533051449195,0.060346285742044925,1275.6713676452637,455.47503757476807,1526.958553314209,55499,6859,48640,48640,0,11,6858000.0
6858,6858999,21.317765653023063,37.62543461102649,0.060335755968888294,1276.0730020999908,455.5433223247528,1527.15385055542,55516,6861,48655,48655,0,11,6859000.0
6859,6859999,21.318063587695033,37.62614961454431,0.060329038379168254,1276.1965618133545,455.6088421344757,1527.3283233642578,55516,6861,48655,48655,0,11,6860000.0
6860,6860999,21.31804814509822,37.6257218233804,0.060323256038710804,1276.4702875614166,455.6759738922119,1527.373950958252,55518,6862,48656,48656,0,11,6861000.0
6861,6861999,21.31826783210727,37.62601090015922,0.060318239752814806,1277.148877620697,455.743381023407,1527.5256729125977,55549,6866,48683,48683,0,11,6862000.0
6862,6862999,21.318576698040985,37.62606601457164,0.06033180496418844,1277.68559384346,455.8120062351227,1527.7549514770508,55576,6869,48707,48707,0,11,6863000.0
6863,6863999,21.318949175995094,37.62609782939591,0.060343735566810386,1278.0854275226593,455.8818693161011,1527.9374237060547,55584,6871,48713,48713,0,11,6864000.0
6864,6864999,21.31978091038131,37.6266223243068,0.06035354394264991,1278.3534262180328,455.94968819618225,1528.195686340332,55589,6872,48717,48717,0,11,6865000.0
6865,6865999,21.32067184489766,37.627480366719375,0.06036262857909358,1278.4769113063812,456.01555466651917,1528.3336029052734,55590,6872,48718,48718,0,11,6866000.0
6866,6866999,21.32128501314361,37.62770728581343,0.06037182285092413,1278.604171037674,456.0816476345062,1528.4360961914062,55590,6872,48718,48718,0,11,6867000.0
6867,6867999,21.322306622459966,37.62871319556829,0.06038560235038348,1278.872773885727,456.1501820087433,1528.7590370178223,55601,6873,48728,48728,0,11,6868000.0
6868,6868999,21.323372688177137,37.62967314463481,0.060404289878302264,1278.9979221820831,456.2168595790863,1528.9950828552246,55601,6873,48728,48728,0,11,6869000.0
6869,6869999,21.32427947884325,37.63004603591496,0.06042239197838062,1279.2609260082245,456.2836084365845,1529.0975303649902,55603,6874,48729,48729,0,11,6870000.0
6870,6870999,21.32518312808016,37.63137992597945,0.06043827426442583,1279.5180215835571,456.35145258903503,1529.8085403442383,55624,6875,48749,48749,0,11,6871000.0
6871,6871999,21.326016609545405,37.631689009762205,0.06045943298251688,1279.7713062763214,456.41801381111145,1530.01558303833,55626,6876,48750,48750,0,11,6872000.0
6872,6872999,21.326872830087975,37.632115687657276,0.06047786380872677,1280.0418636798859,456.48758459091187,1530.338710784912,55635,6877,48758,48758,0,11,6873000.0
6873,6873999,21.326873702970435,37.63110321448699,0.06047540921447947,1280.295441865921,456.55310916900635,1530.560043334961,55642,6878,48764,48764,0,11,6874000.0
6874,6874999,21.326904143210218,37.63292715699957,0.060467775058254736,1280.5551617145538,456.6193423271179,1530.9652481079102,55658,6879,48779,48779,0,11,6875000.0
6875,6875999,21.326526828982452,37.63374372736962,0.06047449928886672,1280.6854655742645,456.68602681159973,1531.3735542297363,55665,6879,48786,48786,0,11,6876000.0
6876,6876999,21.32578931055119,37.63265711311968,0.06048042051036473,1281.0871231555939,456.7539200782776,1531.5300941467285,55674,6881,48793,48793,0,11,6877000.0
6877,6877999,21.32534692231285,37.63157703502194,0.06047520562814779,1281.209382534027,456.8220000267029,1531.6908645629883,55674,6881,48793,48793,0,11,6878000.0
6878,6878999,21.324915122515165,37.63072915359129,0.06046605065156441,1281.464607477188,456.8901991844177,1531.8810119628906,55684,6882,48802,48802,0,11,6879000.0
6879,6879999,21.32462861165901,37.63009907437847,0.060466643824257815,1281.7381236553192,456.95712971687317,1531.9521369934082,55695,6883,48812,48812,0,11,6880000.0
6880,6880999,21.324372553482064,37.62912124329952,0.06046330519833554,1282.003229856491,457.02392649650574,1532.2665405273438,55702,6884,48818,48818,0,11,6881000.0
6881,6881999,21.324125376537985,37.628470413862516,0.060471568607251336,1282.4070127010345,457.0942885875702,1532.5256652832031,55721,6886,48835,48835,0,11,6882000.0
6882,6882999,21.32393018807091,37.627913045802906,0.06047456399550566,1282.8089232444763,457.16165709495544,1532.6075401306152,55738,6888,48850,48850,0,11,6883000.0
6883,6883999,21.323903722589126,37.627542727809,0.06047732006954931,1283.3347997665405,457.2281873226166,1532.709888458252,55747,6891,48856,48856,0,11,6884000.0
6884,6884999,21.32439291369175,37.62828210423414,0.060493351155132435,1283.732803106308,457.2972650527954,1532.8470001220703,55761,6893,48868,48868,0,11,6885000.0
6885,6885999,21.32541817956514,37.63011671819666,0.06050860349422249,1284.1244881153107,457.36630153656006,1533.0073509216309,55783,6895,48888,48888,0,11,6886000.0
6886,6886999,21.326401172998043,37.63117319714744,0.06051854169417259,1284.3812518119812,457.4341812133789,1533.3717308044434,55794,6896,48898,48898,0,11,6887000.0
6887,6887999,21.32765883386033,37.63352291213069,0.0605657974860393,1284.9144313335419,457.5013473033905,1533.4521560668945,55815,6899,48916,48916,0,11,6888000.0
6888,6888999,21.328979869681927,37.63513353696404,0.06059353434084658,1285.315571308136,457.5709433555603,1533.7166328430176,55840,6901,48939,48939,0,11,6889000.0
6889,6889999,21.330355462623153,37.636642640569264,0.060621279343791024,1285.5753636360168,457.63618516921997,1533.9192237854004,55842,6902,48940,48940,0,11,6890000.0
6890,6890999,21.33149355197422,37.63781018199529,0.060653318548236856,1285.6965029239655,457.7025468349457,1534.0927963256836,55843,6902,48941,48941,0,11,6891000.0
6891,6891999,21.3324249216043,37.63837353763368,0.06065153063239215,1285.9713668823242,457.77636075019836,1534.2499046325684,55856,6903,48953,48953,0,11,6892000.0
6892,6892999,21.332549748440258,37.63862783527188,0.06063930181176824,1286.1015429496765,457.8434133529663,1534.7112579345703,55872,6903,48969,48969,0,11,6893000.0
6893,6893999,21.331879598106326,37.63869017147556,0.06063381944809987,1286.2223799228668,457.9100618362427,1535.1091194152832,55880,6903,48977,48977,0,11,6894000.0
6894,6894999,21.330980536941922,37.637298070034994,0.06063824778920235,1286.3442769050598,457.9784288406372,1535.4782676696777,55881,6903,48978,48978,0,11,6895000.0
6895,6895999,21.3301630985466,37.63599482008578,0.06064285450985074,1286.4636249542236,458.0450429916382,1535.6960983276367,55882,6903,48979,48979,0,11,6896000.0
6896,6896999,21.329496638935375,37.6347711892762,0.060640049761153336,1286.8625662326813,458.11329674720764,1535.850112915039,55898,6905,48993,48993,0,11,6897000.0
6897,6897999,21.32912402555175,37.63345353317991,0.06063603609348023,1287.3808317184448,458.1804623603821,1535.9768867492676,55907,6908,48999,48999,0,11,6898000.0
6898,6898999,21.32853866554009,37.6320824813099,0.06064612503238265,1287.9134726524353,458.2473192214966,1536.081657409668,55937,6911,49026,49026,0,11,6899000.0
6899,6899999,21.327962725172064,37.630550390808516,0.06064308660662632,1288.441576719284,458.3166365623474,1536.3937225341797,55955,6914,49041,49041,0,11,6900000.0
6900,6900999,21.327399049126907,37.62915238326164,0.06063963536987216,1288.565396785736,458.38310074806213,1536.6737670898438,55956,6914,49042,49042,0,11,6901000.0
6901,6901999,21.32678109214559,37.62751970087218,0.06064227719431414,1288.8376815319061,458.4511318206787,1536.8066787719727,55968,6915,49053,49053,0,11,6902000.0
6902,6902999,21.326258124240432,37.62645585294984,0.0606397887280925,1289.5069086551666,458.5188293457031,1536.8389625549316,55993,6919,49074,49074,0,11,6903000.0
6903,6903999,21.325756074706025,37.62517958127853,0.060638276676624026,1289.7657577991486,458.5852930545807,1536.9466094970703,55995,6920,49075,49075,0,11,6904000.0
6904,6904999,21.32531017960926,37.62411776908383,0.060638935472372646,1289.88165640831,458.6506471633911,1537.051181793213,55995,6920,49075,49075,0,11,6905000.0
6905,6905999,21.32501873329952,37.62291165749052,0.06064604090573433,1290.8137481212616,458.7180302143097,1537.1126861572266,56049,6926,49123,49123,0,11,6906000.0
6906,6906999,21.324875449981576,37.6219746684469,0.06064541895210385,1290.9411854743958,458.7847898006439,1537.317138671875,56049,6926,49123,49123,0,11,6907000.0
6907,6907999,21.32487922440198,37.621216281113796,0.06064917716072815,1291.195951461792,458.8504602909088,1537.371166229248,56051,6927,49124,49124,0,11,6908000.0
6908,6908999,21.32473455751287,37.620084244232096,0.060647748618355424,1291.5953512191772,458.919230222702,1537.6898384094238,56073,6929,49144,49144,0,11,6909000.0
6909,6909999,21.324700747864107,37.61904549940564,0.06064571732732471,1291.9816179275513,458.98580718040466,1537.8078956604004,56095,6931,49164,49164,0,11,6910000.0
6910,6910999,21.324402960411163,37.617787226518374,0.060651507804632465,1292.244838476181,459.0513892173767,1537.9408149719238,56097,6932,49165,49165,0,11,6911000.0
6911,6911999,21.324001010072166,37.616268201224344,0.06064931847406263,1292.3667221069336,459.11720848083496,1538.1525802612305,56099,6932,49167,49167,0,11,6912000.0
6912,6912999,21.32329497928899,37.61481289350473,0.06065156982844455,1292.6301898956299,459.18416810035706,1538.4320182800293,56110,6933,49177,49177,0,11,6913000.0
6913,6913999,21.322105867136646,37.61320295143748,0.06065289558671494,1292.7586786746979,459.25036120414734,1538.6922492980957,56115,6933,49182,49182,0,11,6914000.0
6914,6914999,21.320940670564024,37.61191377042933,0.06065865700714179,1293.0226347446442,459.317364692688,1539.0303077697754,56124,6934,49190,49190,0,11,6915000.0
6915,6915999,21.31985304620206,37.61033547641913,0.06066449249880024,1293.1404359340668,459.3834619522095,1539.1638259887695,56124,6934,49190,49190,0,11,6916000.0
6916,6916999,21.318759060436726,37.60852452154202,0.06066782503213597,1293.4045832157135,459.45052456855774,1539.2747917175293,56136,6935,49201,49201,0,11,6917000.0
6917,6917999,21.31825259973064,37.60814993963093,0.06063903981312879,1293.6615779399872,459.51756143569946,1539.568214416504,56147,6936,49211,49211,0,11,6918000.0
6918,6918999,21.317726186807285,37.60734759681766,0.06063505576926653,1293.923425912857,459.5845410823822,1539.728645324707,56150,6937,49213,49213,0,11,6919000.0
6919,6919999,21.317144949085705,37.60664082348861,0.060630293599852836,1294.1819064617157,459.6525537967682,1540.0191955566406,56167,6938,49229,49229,0,11,6920000.0
6920,6920999,21.316629671289526,37.60624673280621,0.06062249890893601,1294.4371650218964,459.7189862728119,1540.1841316223145,56170,6939,49231,49231,0,11,6921000.0
6921,6921999,21.31678545381318,37.607597395519,0.06060892892996006,1294.6889381408691,459.78529500961304,1540.3763999938965,56174,6940,49234,49234,0,11,6922000.0
6922,6922999,21.317289579400278,37.611325713621866,0.060580125889439396,1295.0984382629395,459.8521659374237,1540.5171089172363,56181,6942,49239,49239,0,11,6923000.0
6923,6923999,21.3178651495563,37.61299627361005,0.060562903078744235,1295.4963269233704,459.9196879863739,1540.5649299621582,56194,6944,49250,49250,0,11,6924000.0
6924,6924999,21.31867191850715,37.61571247713787,0.06055364737282287,1295.6256380081177,459.98617219924927,1540.6940422058105,56194,6944,49250,49250,0,11,6925000.0
6925,6925999,21.319334331560295,37.616390294881505,0.06053911972484438,1295.8937728404999,460.05404782295227,1541.0605659484863,56206,6945,49261,49261,0,11,6926000.0
6926,6926999,21.32047242718261,37.61863904189695,0.06053637718069127,1296.010734319687,460.1205880641937,1541.2935066223145,56206,6945,49261,49261,0,11,6927000.0
6927,6927999,21.32163502344208,37.62072867900939,0.06053447859902461,1296.131121635437,460.18621730804443,1541.5200653076172,56209,6945,49264,49264,0,11,6928000.0
6928,6928999,21.32262937653225,37.62225984651795,0.0605421078509103,1296.3862252235413,460.2524673938751,1542.1528968811035,56226,6946,49280,49280,0,11,6929000.0
6929,6929999,21.32329247342424,37.62307514673107,0.06054606606841284,1296.6334600448608,460.31935954093933,1542.345386505127,56229,6947,49282,49282,0,11,6930000.0
6930,6930999,21.323728250405846,37.62313744001664,0.06055763217451804,1296.8861844539642,460.38573479652405,1542.6519737243652,56236,6948,49288,49288,0,11,6931000.0
6931,6931999,21.323939723999224,37.623088968961305,0.060560387562754725,1297.423446893692,460.4529809951782,1542.7902946472168,56252,6951,49301,49301,0,11,6932000.0
6932,6932999,21.323909931008092,37.623411664098825,0.060553794932553306,1297.6760594844818,460.5208396911621,1543.338035583496,56271,6952,49319,49319,0,11,6933000.0
6933,6933999,21.323322800287865,37.622584813287354,0.060543932216146734,1297.9407165050507,460.58984184265137,1543.94429397583,56291,6953,49338,49338,0,11,6934000.0
6934,6934999,21.322646412122836,37.62138184689582,0.06054444691608407,1298.0615491867065,460.65886783599854,1544.2303924560547,56293,6953,49340,49340,0,11,6935000.0
6935,6935999,21.322160844046067,37.62047152015052,0.060542165795664626,1298.3180475234985,460.72641110420227,1544.4133911132812,56303,6954,49349,49349,0,11,6936000.0
6936,6936999,21.32183345439266,37.619728097899504,0.06054019098858576,1298.588522195816,460.79465079307556,1544.6973686218262,56310,6955,49355,49355,0,11,6937000.0
6937,6937999,21.321284816010227,37.618303818058514,0.06053699354142339,1298.852199792862,460.8624107837677,1544.8569564819336,56312,6956,49356,49356,0,11,6938000.0
6938,6938999,21.320919366029557,37.617068652442036,0.06053667591597134,1299.104662656784,460.9284710884094,1545.0306358337402,56323,6957,49366,49366,0,11,6939000.0
6939,6939999,21.32071089559478,37.61629621491853,0.060532182373096766,1299.3616952896118,460.9961178302765,1545.4173164367676,56342,6958,49384,49384,0,11,6940000.0
6940,6940999,21.32046642134221,37.615361856793065,0.06053045426025738,1299.7483575344086,461.0634996891022,1545.7528038024902,56365,6960,49405,49405,0,11,6941000.0
6941,6941999,21.320392245724097,37.61700853295161,0.060518945228239196,1300.1458280086517,461.130934715271,1545.9772453308105,56372,6962,49410,49410,0,11,6942000.0
6942,6942999,21.320823541895045,37.6171091721003,0.06051070214270671,1300.3970215320587,461.19775390625,1546.2893409729004,56405,6963,49442,49442,0,11,6943000.0
6943,6943999,21.321181065246957,37.61682398666725,0.06049961108703672,1300.6497373580933,461.26360154151917,1546.3925971984863,56416,6964,49452,49452,0,11,6944000.0
6944,6944999,21.32158610836929,37.616918135506296,0.06049636351259613,1301.4450888633728,461.3310751914978,1546.269130706787,56426,6969,49457,49457,0,11,6945000.0
6945,6945999,21.32233013710702,37.61727587514208,0.06049111181794331,1301.8315711021423,461.3976924419403,1546.60791015625,56444,6971,49473,49473,0,11,6946000.0
6946,6946999,21.323256433633713,37.6177328424449,0.06047524508962121,1302.0894203186035,461.4642150402069,1546.8272895812988,56456,6972,49484,49484,0,11,6947000.0
6947,6947999,21.324087825921442,37.61815598814419,0.060475266372427616,1302.4783883094788,461.53137612342834,1546.8669662475586,56469,6974,49495,49495,0,11,6948000.0
6948,6948999,21.324824823813813,37.618174357113205,0.06048394576478211,1302.8930571079254,461.60743021965027,1547.3204727172852,56493,6976,49517,49517,0,11,6949000.0
6949,6949999,21.325530335844974,37.61806459391635,0.06049691986356598,1303.0105319023132,461.6733343601227,1547.5262603759766,56493,6976,49517,49517,0,11,6950000.0
6950,6950999,21.326041974552528,37.617783078470566,0.060517635696062944,1303.545993566513,461.74084997177124,1547.569938659668,56525,6979,49546,49546,0,11,6951000.0
6951,6951999,21.326333432196524,37.617137272386756,0.06052553831935337,1304.0749099254608,461.80764174461365,1547.7266845703125,56550,6982,49568,49568,0,11,6952000.0
6952,6952999,21.32636086460421,37.61736817896013,0.06051711141437277,1304.3391230106354,461.8748228549957,1548.0451011657715,56559,6983,49576,49576,0,11,6953000.0
6953,6953999,21.326201232332338,37.617441724307554,0.06050812602291111,1304.461294412613,461.9416227340698,1548.443531036377,56568,6983,49585,49585,0,11,6954000.0
6954,6954999,21.325876464438164,37.61699242891005,0.06050699193490283,1304.946691274643,462.02198815345764,1548.687572479248,56573,6985,49588,49588,0,11,6955000.0
6955,6955999,21.32567488518032,37.616711800292485,0.060508028094742095,1305.080557346344,462.0898745059967,1548.942642211914,56575,6985,49590,49590,0,11,6956000.0
6956,6956999,21.32571621925039,37.616612933607115,0.060505307497857874,1305.3454313278198,462.15935802459717,1549.2975006103516,56591,6986,49605,49605,0,11,6957000.0
6957,6957999,21.326229400003026,37.61722796571269,0.06050188603574658,1305.6011745929718,462.2276418209076,1549.519775390625,56602,6987,49615,49615,0,11,6958000.0
6958,6958999,21.326552244135954,37.61748605965632,0.060497373499474816,1306.0102844238281,462.29573345184326,1549.6923217773438,56610,6989,49621,49621,0,11,6959000.0
6959,6959999,21.3270290521515,37.61834528905912,0.060489897635610856,1306.2753949165344,462.3641929626465,1549.996437072754,56623,6990,49633,49633,0,11,6960000.0
6960,6960999,21.32824122657496,37.62201167971332,0.060492176544207577,1306.5368797779083,462.43306970596313,1550.160243988037,56627,6991,49636,49636,0,11,6961000.0
6961,6961999,21.329372160205146,37.62345040984878,0.060499290697406116,1306.9421746730804,462.50119805336,1550.3029556274414,56635,6993,49642,49642,0,11,6962000.0
6962,6962999,21.331125364927075,37.628861639944624,0.06052276193701134,1307.6148581504822,462.5693943500519,1550.250545501709,56671,6997,49674,49674,0,11,6963000.0
6963,6963999,21.332443782224754,37.63062747324653,0.06053646717701677,1307.873234987259,462.63706636428833,1550.3650550842285,56679,6998,49681,49681,0,11,6964000.0
6964,6964999,21.33396423295806,37.6336301942366,0.06056119615785027,1308.1328117847443,462.70683693885803,1550.7170486450195,56688,6999,49689,49689,0,11,6965000.0
6965,6965999,21.336210841089457,37.63786207557935,0.06059404933788326,1308.2461094856262,462.7727897167206,1550.9159622192383,56688,6999,49689,49689,0,11,6966000.0
6966,6966999,21.337695272097655,37.639768236403796,0.06064295187877988,1308.7786011695862,462.8411953449249,1551.2565155029297,56713,7002,49711,49711,0,11,6967000.0
6967,6967999,21.3398361117859,37.64302855482135,0.0606954587005234,1309.0447812080383,462.90926575660706,1551.4299774169922,56724,7003,49721,49721,0,11,6968000.0
6968,6968999,21.34190141645629,37.64771699857052,0.06072885343024825,1309.1612436771393,462.97564363479614,1551.6699829101562,56726,7003,49723,49723,0,11,6969000.0
6969,6969999,21.3426341758051,37.65123945409198,0.06072701780262757,1309.5503492355347,463.0423812866211,1552.0788688659668,56751,7005,49746,49746,0,11,6970000.0
6970,6970999,21.343304745389492,37.656248035944074,0.06073023226045482,1309.9405755996704,463.1104166507721,1552.425708770752,56785,7007,49778,49778,0,11,6971000.0
6971,6971999,21.343950656370108,37.66052374709469,0.06072999272887469,1310.0680191516876,463.17774629592896,1552.6562271118164,56786,7007,49779,49779,0,11,6972000.0
6972,6972999,21.344311944258195,37.66278482875095,0.06071961136110937,1310.1902449131012,463.24471139907837,1552.9998245239258,56790,7007,49783,49783,0,11,6973000.0
6973,6973999,21.345140667825138,37.66519767518969,0.06073612125206618,1310.727975845337,463.3120334148407,1553.1500129699707,56805,7010,49795,49795,0,11,6974000.0
6974,6974999,21.345841210149427,37.667889989081864,0.06074080582197694,1310.8577637672424,463.3789873123169,1553.326572418213,56806,7010,49796,49796,0,11,6975000.0
6975,6975999,21.346341590335385,37.66983203893541,0.060723843011618595,1310.9755382537842,463.4470453262329,1553.6570434570312,56810,7010,49800,49800,0,11,6976000.0
6976,6976999,21.347959491675347,37.67827593640612,0.06069986879422651,1311.2413864135742,463.5141797065735,1553.7918853759766,56812,7011,49801,49801,0,11,6977000.0
6977,6977999,21.349097321401093,37.680125176414684,0.060729412092168866,1311.632179260254,463.58105421066284,1553.9685859680176,56830,7013,49817,49817,0,11,6978000.0
6978,6978999,21.35012380316155,37.68143151259521,0.06072926891743258,1311.8907463550568,463.64730072021484,1554.129467010498,56833,7014,49819,49819,0,11,6979000.0
6979,6979999,21.351292424624656,37.6837544489452,0.06072228864163398,1312.1417005062103,463.714271068573,1554.2766952514648,56836,7015,49821,49821,0,11,6980000.0
6980,6980999,21.352523958182996,37.68697648944725,0.06071806314331818,1312.945687532425,463.78343510627747,1554.4395713806152,56878,7020,49858,49858,0,11,6981000.0
6981,6981999,21.35405264970582,37.689243626183895,0.06070559828316002,1313.2159941196442,463.85116696357727,1554.5610694885254,56882,7021,49861,49861,0,11,6982000.0
6982,6982999,21.356179288107143,37.69414763350152,0.06073034395164567,1313.8851935863495,463.9194416999817,1554.5676193237305,56903,7025,49878,49878,0,11,6983000.0
6983,6983999,21.35786446055415,37.69751171009962,0.060731961792845235,1314.431441783905,463.98768186569214,1555.0137519836426,56942,7028,49914,49914,0,11,6984000.0
6984,6984999,21.359587487811257,37.700791114136926,0.06075209560738215,1314.7048015594482,464.0595383644104,1555.2091064453125,56944,7029,49915,49915,0,11,6985000.0
6985,6985999,21.361064199507773,37.70229522834015,0.06077774755905285,1314.8228976726532,464.12682461738586,1555.4678916931152,56947,7029,49918,49918,0,11,6986000.0
6986,6986999,21.36209249287098,37.70306157345164,0.060793552517560356,1315.4940626621246,464.1936421394348,1555.5082893371582,56973,7033,49940,49940,0,11,6987000.0
6987,6987999,21.362124723394682,37.70359256630785,0.060788549941889536,1315.7592272758484,464.26019263267517,1555.9124374389648,56988,7034,49954,49954,0,11,6988000.0
6988,6988999,21.361277813037475,37.70286452384788,0.06078479615106247,1316.0394549369812,464.33718943595886,1556.115364074707,57002,7035,49967,49967,0,11,6989000.0
6989,6989999,21.36064624254594,37.702344384173045,0.060778839463330514,1316.3157637119293,464.40899682044983,1556.2970237731934,57009,7036,49973,49973,0,11,6990000.0
6990,6990999,21.359893314722004,37.701255770251706,0.060777617573701814,1316.5807406902313,464.47674918174744,1556.4011878967285,57019,7037,49982,49982,0,11,6991000.0
6991,6991999,21.359410276188854,37.7004738461934,0.060770118794334804,1316.7031066417694,464.54414677619934,1556.5400581359863,57021,7037,49984,49984,0,11,6992000.0
6992,6992999,21.359105018867975,37.69973300356714,0.06076416360842629,1317.1006813049316,464.61106967926025,1556.5994911193848,57030,7039,49991,49991,0,11,6993000.0
6993,6993999,21.35863009150709,37.69850619173886,0.06076131785913885,1317.5183260440826,464.67897510528564,1556.6102485656738,57039,7041,49998,49998,0,11,6994000.0
6994,6994999,21.35860044142311,37.69807375393719,0.060756018518775434,1317.6398358345032,464.7466320991516,1556.9164123535156,57045,7041,50004,50004,0,11,6995000.0
6995,6995999,21.358606362130804,37.69801709268623,0.06075764715784637,1318.0393130779266,464.8142855167389,1557.0401153564453,57058,7043,50015,50015,0,11,6996000.0
6996,6996999,21.358616262629905,37.6974790719497,0.060771915126134446,1318.3016922473907,464.8820366859436,1557.3051109313965,57073,7044,50029,50029,0,11,6997000.0
6997,6997999,21.35879652219313,37.69715297006859,0.06078277485302441,1318.850136756897,464.9500825405121,1557.436424255371,57093,7047,50046,50046,0,11,6998000.0
6998,6998999,21.358827363390986,37.696769185929455,0.06078559988002308,1319.119281053543,465.0161383152008,1557.4965133666992,57104,7048,50056,50056,0,11,6999000.0
6999,6999999,21.35918539516988,37.69716278711496,0.0607877822182199,1319.6776134967804,465.0873374938965,1557.5336685180664,57147,7051,50096,50096,0,11,7000000.0
7000,7000999,21.359447638606586,37.69711204154135,0.060781110254544135,1319.7990009784698,465.1560854911804,1557.8593063354492,57154,7051,50103,50103,0,11,7001000.0
7001,7001999,21.359871462586735,37.697129556280444,0.06077147435247798,1319.9246003627777,465.2236235141754,1558.093620300293,57155,7051,50104,50104,0,11,7002000.0
7002,7002999,21.360382748600603,37.69742339384071,0.06077406627634341,1320.0525035858154,465.2902352809906,1558.2243270874023,57155,7051,50104,50104,0,11,7003000.0
7003,7003999,21.36064269975091,37.697229601072316,0.06076069806060824,1320.466938495636,465.35816740989685,1558.689094543457,57183,7053,50130,50130,0,11,7004000.0
7004,7004999,21.36107182076426,37.697004584445715,0.06076529027078692,1320.732718706131,465.432781457901,1558.8682899475098,57185,7054,50131,50131,0,11,7005000.0
7005,7005999,21.361104780387166,37.69611352758118,0.06076787893800739,1320.9879009723663,465.499636888504,1558.9944343566895,57196,7055,50141,50141,0,11,7006000.0
7006,7006999,21.36081479374456,37.69499897975513,0.060766259573628356,1321.1050612926483,465.5653417110443,1559.2037925720215,57199,7055,50144,50144,0,11,7007000.0
7007,7007999,21.36017993936708,37.69359546077542,0.06076327247466551,1321.7822217941284,465.632390499115,1559.3233680725098,57227,7059,50168,50168,0,11,7008000.0
7008,7008999,21.359113960934888,37.69218270201076,0.060758417543977594,1321.9028179645538,465.6985945701599,1559.618995666504,57232,7059,50173,50173,0,11,7009000.0
7009,7009999,21.35791212658697,37.690455321808095,0.06075933553897406,1322.3076400756836,465.7664704322815,1559.7863655090332,57248,7061,50187,50187,0,11,7010000.0
7010,7010999,21.356968997775542,37.689307290386395,0.060757270762659354,1322.7114691734314,465.8345801830292,1559.951919555664,57269,7063,50206,50206,0,11,7011000.0
7011,7011999,21.3562117973389,37.68841190618408,0.060755067978832344,1323.2538974285126,465.9043674468994,1560.026424407959,57295,7066,50229,50229,0,11,7012000.0
7012,7012999,21.355647064788485,37.68745343196258,0.06075582093211551,1323.7921237945557,465.9717719554901,1560.207992553711,57338,7069,50269,50269,0,11,7013000.0
7013,7013999,21.35504818924202,37.686914531358596,0.06075358853220192,1324.3250629901886,466.0394606590271,1560.259365081787,57353,7072,50281,50281,0,11,7014000.0
7014,7014999,21.354551815162306,37.68589633892848,0.060750662890130425,1324.5975425243378,466.109228849411,1560.5260124206543,57370,7073,50297,50297,0,11,7015000.0
7015,7015999,21.35406893222177,37.68501631216035,0.060737311762957824,1324.8624243736267,466.17691826820374,1560.6533470153809,57373,7074,50299,50299,0,11,7016000.0
7016,7016999,21.35384409456126,37.68452204784036,0.06073079224029121,1325.2751731872559,466.2448220252991,1560.7697792053223,57383,7076,50307,50307,0,11,7017000.0
7017,7017999,21.35368833204903,37.68386556965132,0.06072185911880035,1325.4101824760437,466.311874628067,1560.9691123962402,57383,7076,50307,50307,0,11,7018000.0
7018,7018999,21.353471272022144,37.68352016585902,0.060710598169213426,1325.9564712047577,466.37880301475525,1560.958999633789,57399,7079,50320,50320,0,11,7019000.0
7019,7019999,21.35303960554861,37.682850571906144,0.06070151957233638,1326.2119317054749,466.4472382068634,1561.0786247253418,57402,7080,50322,50322,0,11,7020000.0
7020,7020999,21.35295665558751,37.682501085225354,0.06069352154923835,1326.3398048877716,466.51471042633057,1561.3328590393066,57407,7080,50327,50327,0,11,7021000.0
7021,7021999,21.352935896645242,37.683540921281576,0.06067859706055323,1326.4729490280151,466.582067489624,1561.6576385498047,57410,7080,50330,50330,0,11,7022000.0
7022,7022999,21.352674046843905,37.68271998856559,0.06067311759201499,1326.736858844757,466.64796137809753,1561.7688369750977,57422,7081,50341,50341,0,11,7023000.0
7023,7023999,21.35257980440735,37.681754787493844,0.060663755505439676,1327.1397054195404,466.71599531173706,1562.294906616211,57455,7083,50372,50372,0,11,7024000.0
7024,7024999,21.35269982334674,37.681237493029,0.06065387642721409,1327.6816039085388,466.7820682525635,1562.450050354004,57470,7086,50384,50384,0,11,7025000.0
7025,7025999,21.35252189646025,37.68036507688362,0.06064872081905337,1327.9445140361786,466.8487253189087,1562.6518020629883,57481,7087,50394,50394,0,11,7026000.0
7026,7026999,21.35236671700351,37.679508298529214,0.06064548702897821,1328.3479506969452,466.9157032966614,1562.9678497314453,57513,7089,50424,50424,0,11,7027000.0
7027,7027999,21.352305287429036,37.68004427864305,0.060636571966975805,1328.6222858428955,466.98277163505554,1563.196662902832,57517,7090,50427,50427,0,11,7028000.0
7028,7028999,21.351232519245116,37.67916900048198,0.06063362214205892,1329.1588470935822,467.05019903182983,1563.3848457336426,57544,7093,50451,50451,0,11,7029000.0
7029,7029999,21.35013455836671,37.67786750957089,0.06063254570176213,1329.4255867004395,467.1188266277313,1563.889030456543,57561,7094,50467,50467,0,11,7030000.0
7030,7030999,21.349359195076786,37.678542443463044,0.06062209257456852,1329.842536687851,467.1946556568146,1563.9763069152832,57574,7096,50478,50478,0,11,7031000.0
7031,7031999,21.348423121164625,37.67692854404304,0.06061997529562557,1330.3889510631561,467.26351594924927,1564.0006408691406,57595,7099,50496,50496,0,11,7032000.0
7032,7032999,21.347762988835466,37.67573169892706,0.060611982824441024,1330.5219485759735,467.3320369720459,1564.4046020507812,57597,7099,50498,50498,0,11,7033000.0
7033,7033999,21.347288992979568,37.674849867359974,0.06060435225161265,1331.3386430740356,467.40053939819336,1564.4238204956055,57616,7104,50512,50512,0,11,7034000.0
7034,7034999,21.346631736315874,37.673686067765885,0.060598775253255854,1331.8757717609406,467.4688229560852,1564.542148590088,57650,7107,50543,50543,0,11,7035000.0
7035,7035999,21.345980921152112,37.67232413958886,0.06059254124744873,1331.9988791942596,467.53777027130127,1564.9997177124023,57659,7107,50552,50552,0,11,7036000.0
7036,7036999,21.345571821678448,37.671535063490666,0.06058465756940423,1332.122192144394,467.60530710220337,1565.193618774414,57659,7107,50552,50552,0,11,7037000.0
7037,7037999,21.344901644663274,37.67008502420762,0.060576643648659,1332.678099155426,467.67399621009827,1565.332260131836,57675,7110,50565,50565,0,11,7038000.0
7038,7038999,21.34444570012167,37.66909670064902,0.060566914297701,1332.9467041492462,467.7415645122528,1565.5190734863281,57689,7111,50578,50578,0,11,7039000.0
7039,7039999,21.344051179923486,37.668213536857536,0.060559782996209344,1333.4914331436157,467.8098089694977,1565.5276107788086,57696,7114,50582,50582,0,11,7040000.0
7040,7040999,21.34361853348604,37.66711343190261,0.06055345771000853,1333.8864130973816,467.87731766700745,1565.6190032958984,57718,7116,50602,50602,0,11,7041000.0
7041,7041999,21.34348962530603,37.66777936344638,0.060537798703051426,1334.3046560287476,467.94573998451233,1566.0061378479004,57732,7118,50614,50614,0,11,7042000.0
7042,7042999,21.343452440539927,37.667351222045085,0.06052450938143561,1334.8431279659271,468.0157980918884,1566.108253479004,57767,7121,50646,50646,0,11,7043000.0
7043,7043999,21.343613970926075,37.66704991476538,0.060516203351647646,1335.245735168457,468.0848867893219,1566.2589416503906,57781,7123,50658,50658,0,11,7044000.0
7044,7044999,21.34365551460817,37.666230330785005,0.060499177198869436,1335.5087082386017,468.15303111076355,1567.0333557128906,57807,7124,50683,50683,0,11,7045000.0
7045,7045999,21.34403842640955,37.66586582142293,0.060490464252022313,1335.7675194740295,468.2202055454254,1567.273796081543,57809,7125,50684,50684,0,11,7046000.0
7046,7046999,21.344115645296927,37.66510024670541,0.06049182111900242,1335.88907289505,468.28828406333923,1567.4996147155762,57809,7125,50684,50684,0,11,7047000.0
7047,7047999,21.344296797516062,37.66438547505535,0.060486465422188274,1336.4252591133118,468.3557267189026,1567.8698654174805,57838,7128,50710,50710,0,11,7048000.0
7048,7048999,21.34407941169739,37.66360388793,0.06047769255242941,1336.6819097995758,468.4220287799835,1568.2307205200195,57849,7129,50720,50720,0,11,7049000.0
7049,7049999,21.343379715076065,37.66335151939253,0.060469286474497674,1336.8092424869537,468.4885313510895,1568.4384803771973,57852,7129,50723,50723,0,11,7050000.0
7050,7050999,21.34250217799748,37.662432127045676,0.06046550174890053,1337.0745549201965,468.5558891296387,1568.6565895080566,57859,7130,50729,50729,0,11,7051000.0
7051,7051999,21.341693186915894,37.66153144956801,0.06046826255789439,1337.488834142685,468.6241924762726,1568.7676315307617,57868,7132,50736,50736,0,11,7052000.0
7052,7052999,21.34104346217228,37.66113403465441,0.06046284360755605,1337.7642142772675,468.69290566444397,1568.8230285644531,57879,7133,50746,50746,0,11,7053000.0
7053,7053999,21.340797337185634,37.66159978931594,0.06044951579747926,1338.3061738014221,468.76077008247375,1568.9839515686035,57896,7136,50760,50760,0,11,7054000.0
7054,7054999,21.340512325230517,37.66076444451848,0.06044071823451147,1338.9931156635284,468.82885479927063,1568.9914093017578,57912,7140,50772,50772,0,11,7055000.0
7055,7055999,21.340482898046393,37.66163761333275,0.06043444822475508,1339.2629103660583,468.8967938423157,1569.1597518920898,57923,7141,50782,50782,0,11,7056000.0
7056,7056999,21.340230125911155,37.66142854001633,0.060421529010168396,1339.380763053894,468.9641282558441,1569.4603805541992,57927,7141,50786,50786,0,11,7057000.0
7057,7057999,21.340199010964607,37.66134301164128,0.060411026092949016,1340.2080483436584,469.0345540046692,1569.6030044555664,57958,7146,50812,50812,0,11,7058000.0
7058,7058999,21.340085618515737,37.6609127281652,0.060402183787938046,1340.3297772407532,469.10207056999207,1569.8199462890625,57959,7146,50813,50813,0,11,7059000.0
7059,7059999,21.340465493755165,37.66254501428425,0.060389668672675145,1340.4621424674988,469.1690857410431,1569.9875564575195,57960,7146,50814,50814,0,11,7060000.0
7060,7060999,21.34066713150746,37.66274729042026,0.060386956174652284,1340.8681237697601,469.2373549938202,1569.9933128356934,57965,7148,50817,50817,0,11,7061000.0
7061,7061999,21.341167761139214,37.664108984622715,0.06038425861386931,1341.5748813152313,469.3042414188385,1569.9553756713867,57991,7152,50839,50839,0,11,7062000.0
7062,7062999,21.34187310555944,37.665281916426544,0.06037668643826832,1341.6990022659302,469.371395111084,1570.215835571289,57994,7152,50842,50842,0,11,7063000.0
7063,7063999,21.343236131099843,37.668146566660184,0.06037016471381351,1342.2402555942535,469.4378695487976,1570.2529983520508,58018,7155,50863,50863,0,11,7064000.0
7064,7064999,21.344208422813562,37.670078495633845,0.06036933427067659,1343.0970346927643,469.50731587409973,1570.2094764709473,58053,7160,50893,50893,0,11,7065000.0
7065,7065999,21.34556132427058,37.672757714874855,0.06037131851984301,1343.3630332946777,469.5764615535736,1570.598201751709,58064,7161,50903,50903,0,11,7066000.0
7066,7066999,21.346929490950593,37.67523249350365,0.06038264679066352,1343.4958832263947,469.64272809028625,1570.7824745178223,58064,7161,50903,50903,0,11,7067000.0
7067,7067999,21.34852328805457,37.67918084160487,0.060404481946572774,1343.9027864933014,469.7095386981964,1570.8979225158691,58088,7163,50925,50925,0,11,7068000.0
7068,7068999,21.350066848231407,37.68161892619006,0.060405983255992446,1344.436475276947,469.7760684490204,1571.0197410583496,58119,7166,50953,50953,0,11,7069000.0
7069,7069999,21.35009600536344,37.68136723107598,0.06040150201073635,1344.7021307945251,469.8433620929718,1571.3207397460938,58141,7167,50974,50974,0,11,7070000.0
7070,7070999,21.34957174720299,37.68147442866252,0.06038822380909259,1345.1077654361725,469.9107630252838,1571.5186614990234,58165,7169,50996,50996,0,11,7071000.0
7071,7071999,21.34905706780947,37.68114352816989,0.06038065469778531,1345.2347095012665,469.9780795574188,1571.7234382629395,58165,7169,50996,50996,0,11,7072000.0
7072,7072999,21.34886181776668,37.68209865698412,0.06037368676095334,1345.7807693481445,470.0467460155487,1571.736873626709,58186,7172,51014,51014,0,11,7073000.0
7073,7073999,21.349160461316878,37.68389926789194,0.06036411813662956,1345.9126315116882,470.11440873146057,1571.88330078125,58186,7172,51014,51014,0,11,7074000.0
7074,7074999,21.349010967681494,37.68350233468103,0.06036697486867981,1346.613624572754,470.1825120449066,1571.9980773925781,58200,7176,51024,51024,0,11,7075000.0
7075,7075999,21.350007984415505,37.685798727816504,0.060364056667352006,1346.7480347156525,470.24985814094543,1572.1742630004883,58200,7176,51024,51024,0,11,7076000.0
7076,7076999,21.350844843769664,37.687751128972984,0.06036170342949476,1347.0050225257874,470.3182199001312,1572.4544563293457,58208,7177,51031,51031,0,11,7077000.0
7077,7077999,21.35158477992491,37.68865775820093,0.0603537991516957,1347.2743935585022,470.38540601730347,1572.5299987792969,58218,7178,51040,51040,0,11,7078000.0
7078,7078999,21.352514316501498,37.68996389825476,0.06036144143345579,1347.6849944591522,470.45352482795715,1572.642219543457,58223,7180,51043,51043,0,11,7079000.0
7079,7079999,21.354291076582058,37.69348165542387,0.0603724362807575,1348.2346465587616,470.521192073822,1572.7221641540527,58251,7183,51068,51068,0,11,7080000.0
7080,7080999,21.356003081996693,37.69639899322999,0.060386116129563794,1348.3548464775085,470.5874698162079,1572.9589538574219,58251,7183,51068,51068,0,11,7081000.0
7081,7081999,21.35776700618843,37.69983308442504,0.06040081799614916,1348.759373664856,470.65454173088074,1573.0169296264648,58265,7185,51080,51080,0,11,7082000.0
7082,7082999,21.359536147813913,37.70251311550639,0.06043792508907142,1349.4497725963593,470.723192691803,1573.1174774169922,58284,7189,51095,51095,0,11,7083000.0
7083,7083999,21.36179094669053,37.70688200053242,0.0604567940393409,1349.574946641922,470.78945899009705,1573.3679237365723,58285,7189,51096,51096,0,11,7084000.0
7084,7084999,21.364209621580095,37.71086287842329,0.06051701238027929,1349.9801354408264,470.856568813324,1573.428035736084,58308,7191,51117,51117,0,11,7085000.0
7085,7085999,21.366344318760937,37.71358692119529,0.06057541920390874,1350.6710793972015,470.9246561527252,1573.7516822814941,58353,7195,51158,51158,0,11,7086000.0
7086,7086999,21.36905567678349,37.71820999027075,0.060634354151386405,1351.2285676002502,470.99356412887573,1573.9138374328613,58379,7198,51181,51181,0,11,7087000.0
7087,7087999,21.37148976666492,37.72203389472788,0.06071836373592321,1351.3471231460571,471.0594952106476,1574.0933456420898,58379,7198,51181,51181,0,11,7088000.0
7088,7088999,21.373717602953732,37.725822582774605,0.06077920571257145,1351.8938298225403,471.12643480300903,1574.1596946716309,58405,7201,51204,51204,0,11,7089000.0
7089,7089999,21.375605460744065,37.730469411575214,0.060805095721674696,1352.2929248809814,471.192590713501,1574.2902450561523,58412,7203,51209,51209,0,11,7090000.0
7090,7090999,21.37504341450557,37.7304675030396,0.06079469215509148,1352.4214432239532,471.26109075546265,1574.62739944458,58418,7203,51215,51215,0,11,7091000.0
7091,7091999,21.37490685404513,37.73166912496844,0.0607808857602129,1352.9686529636383,471.3290593624115,1574.8713111877441,58444,7206,51238,51238,0,11,7092000.0
7092,7092999,21.37480938307589,37.734279082242445,0.06076978890741447,1353.2479062080383,471.39693236351013,1575.0070877075195,58457,7207,51250,51250,0,11,7093000.0
7093,7093999,21.374731079924487,37.73434302964845,0.06076369462772502,1353.369950056076,471.4638843536377,1575.1740798950195,58459,7207,51252,51252,0,11,7094000.0
7094,7094999,21.374951504303162,37.73473147095569,0.06074990094302246,1353.631786108017,471.53087043762207,1575.3694534301758,58463,7208,51255,51255,0,11,7095000.0
7095,7095999,21.375356424298417,37.73531822861968,0.060739956147398244,1354.1775388717651,471.5985178947449,1575.4084358215332,58469,7211,51258,51258,0,11,7096000.0
7096,7096999,21.376101194896084,37.73687248730744,0.060727557335898186,1354.3133115768433,471.66636061668396,1575.7643737792969,58475,7211,51264,51264,0,11,7097000.0
7097,7097999,21.377036355214713,37.73795756480306,0.06072555575074534,1354.8823471069336,471.734495639801,1575.8349151611328,58499,7214,51285,51285,0,11,7098000.0
7098,7098999,21.3783141377638,37.74034955513615,0.06073581318644117,1355.282601594925,471.80303716659546,1575.963134765625,58515,7216,51299,51299,0,11,7099000.0
7099,7099999,21.381072948564505,37.74906883390991,0.06073441784464029,1355.5528001785278,471.8702826499939,1576.1386528015137,58518,7217,51301,51301,0,11,7100000.0
7100,7100999,21.383471320526873,37.75405521412161,0.06074093390787272,1355.678582906723,471.93694710731506,1576.2715492248535,58518,7217,51301,51301,0,11,7101000.0
7101,7101999,21.3853845566439,37.75810480463042,0.06076978553967649,1356.3793098926544,472.0053005218506,1576.2297477722168,58549,7221,51328,51328,0,11,7102000.0
7102,7102999,21.38848676545901,37.76556008612121,0.06078082853873823,1356.7853307724,472.0726475715637,1576.3914642333984,58570,7223,51347,51347,0,11,7103000.0
7103,7103999,21.39118277734651,37.7725452301286,0.06081832473948112,1357.1882421970367,472.1418170928955,1576.5044059753418,58581,7225,51356,51356,0,11,7104000.0
7104,7104999,21.394079820760595,37.780389943119964,0.060847180715216886,1357.5897192955017,472.20874214172363,1576.7724685668945,58603,7227,51376,51376,0,11,7105000.0
7105,7105999,21.396864769289987,37.78524973463353,0.060887265856451656,1357.851461648941,472.2744069099426,1576.9351272583008,58615,7228,51387,51387,0,11,7106000.0
7106,7106999,21.399341699983953,37.78953896598398,0.06092443502221878,1358.4002346992493,472.3423879146576,1577.0005989074707,58640,7231,51409,51409,0,11,7107000.0
7107,7107999,21.401032047286915,37.79270016240351,0.06094559166986313,1358.8028922080994,472.4083125591278,1577.3190727233887,58651,7233,51418,51418,0,11,7108000.0
7108,7108999,21.40147960703078,37.79590883701934,0.060923261296999986,1359.0630764961243,472.47606325149536,1577.7688751220703,58668,7234,51434,51434,0,11,7109000.0
7109,7109999,21.401567373301514,37.801355188461535,0.060904672544218275,1359.3306229114532,472.5431215763092,1578.141227722168,58681,7235,51446,51446,0,11,7110000.0
7110,7110999,21.4016228434617,37.80196887834128,0.060903871962560086,1359.5988879203796,472.6104347705841,1578.323329925537,58685,7236,51449,51449,0,11,7111000.0
7111,7111999,21.401830620340167,37.803443426576614,0.060902130334585025,1360.1547436714172,472.6788058280945,1578.3927612304688,58711,7239,51472,51472,0,11,7112000.0
7112,7112999,21.402612917859617,37.80539219598549,0.06089109687024108,1360.441778421402,472.7514591217041,1578.7522506713867,58725,7240,51485,51485,0,11,7113000.0
7113,7113999,21.40373756123376,37.80746001541303,0.060906008060296446,1360.8508577346802,472.8198194503784,1578.8729820251465,58739,7242,51497,51497,0,11,7114000.0
7114,7114999,21.405186768572705,37.811503895636264,0.06092075909574579,1361.269590139389,472.88893461227417,1579.0862045288086,58759,7244,51515,51515,0,11,7115000.0
7115,7115999,21.406834386492644,37.81496257299157,0.06096824764026243,1361.8169009685516,472.9569003582001,1579.2864265441895,58787,7247,51540,51540,0,11,7116000.0
7116,7116999,21.40903286430087,37.82304657254119,0.06104261690032753,1362.3587419986725,473.0254442691803,1579.563190460205,58805,7250,51555,51555,0,11,7117000.0
7117,7117999,21.411612785745756,37.831297494856685,0.06115559960382688,1362.6335408687592,473.09412813186646,1579.864345550537,58816,7251,51565,51565,0,11,7118000.0
7118,7118999,21.41496481032542,37.84037549382,0.061224414369895785,1362.893994808197,473.1611678600311,1579.9860572814941,58819,7252,51567,51567,0,11,7119000.0
7119,7119999,21.418092273401907,37.84820223963994,0.06128627480242732,1363.4502577781677,473.2292137145996,1579.9739837646484,58833,7255,51578,51578,0,11,7120000.0
7120,7120999,21.421185755521776,37.85822661647959,0.06131261395536991,1364.005312204361,473.2990200519562,1580.2207374572754,58864,7258,51606,51606,0,11,7121000.0
7121,7121999,21.424931263702845,37.86949936347702,0.06137225274062841,1364.4154953956604,473.3670337200165,1580.420150756836,58868,7260,51608,51608,0,11,7122000.0
7122,7122999,21.42971057491622,37.88390208978934,0.061460983957413506,1364.8226516246796,473.43473386764526,1580.5645561218262,58873,7262,51611,51611,0,11,7123000.0
7123,7123999,21.43360434422956,37.89442081604257,0.06154984530557628,1365.5097393989563,473.5027508735657,1580.9311218261719,58904,7266,51638,51638,0,11,7124000.0
7124,7124999,21.437960564167216,37.904808142448275,0.061658806979897784,1365.6434292793274,473.5785484313965,1581.1534423828125,58904,7266,51638,51638,0,11,7125000.0
7125,7125999,21.44190440497443,37.913983244068,0.061785250965117,1366.0531785488129,473.64619421958923,1581.4140663146973,58932,7268,51664,51664,0,11,7126000.0
7126,7126999,21.445236232469032,37.92162344899495,0.06189989396999285,1366.4853944778442,473.71833872795105,1581.6145401000977,58945,7270,51675,51675,0,11,7127000.0
7127,7127999,21.446444547931744,37.924915168270445,0.061898289229251335,1367.1937651634216,473.78540229797363,1581.8865966796875,58966,7274,51692,51692,0,11,7128000.0
7128,7128999,21.44652775444022,37.92619752257481,0.06188310722327539,1367.4624755382538,473.85526299476624,1582.1884689331055,58976,7275,51701,51701,0,11,7129000.0
7129,7129999,21.44679498996619,37.92885070343311,0.06186276138913671,1367.7355818748474,473.9270374774933,1582.4086875915527,58981,7276,51705,51705,0,11,7130000.0
7130,7130999,21.44669780904882,37.92942421021198,0.06185461206934306,1367.8629925251007,473.9941420555115,1582.6182250976562,58985,7276,51709,51709,0,11,7131000.0
7131,7131999,21.44677583457933,37.930104171068585,0.0618412624715734,1367.9805629253387,474.06042218208313,1582.8878707885742,58988,7276,51712,51712,0,11,7132000.0
7132,7132999,21.446923212030853,37.93055303078879,0.06183481858690654,1368.8128480911255,474.12788581848145,1582.8699531555176,59024,7281,51743,51743,0,11,7133000.0
7133,7133999,21.446770155696022,37.93074212857244,0.06183297368409835,1369.380918264389,474.1986334323883,1582.9757919311523,59048,7284,51764,51764,0,11,7134000.0
7134,7134999,21.446921250136434,37.93150138881925,0.061831051320838104,1369.9601266384125,474.2706253528595,1582.9737854003906,59067,7287,51780,51780,0,11,7135000.0
7135,7135999,21.447085983543555,37.931467960256576,0.06182742773025407,1370.3842828273773,474.3389663696289,1583.280963897705,59093,7289,51804,51804,0,11,7136000.0
7136,7136999,21.447230501267335,37.931643411023686,0.06181987144300494,1370.6612010002136,474.4064111709595,1583.512336730957,59098,7290,51808,51808,0,11,7137000.0
7137,7137999,21.44730156579652,37.93148609181038,0.06181725765575086,1370.780385017395,474.4729928970337,1583.6686820983887,59098,7290,51808,51808,0,11,7138000.0
7138,7138999,21.447261597232938,37.93101212254018,0.061819764213526196,1371.0443148612976,474.53878831863403,1583.7347221374512,59109,7291,51818,51818,0,11,7139000.0
7139,7139999,21.447386396582342,37.93058572673454,0.061810403788488566,1371.3162789344788,474.6064488887787,1584.0284881591797,59126,7292,51834,51834,0,11,7140000.0
7140,7140999,21.447814285272916,37.93040683622657,0.06181615827431752,1371.4357120990753,474.67233967781067,1584.2357025146484,59127,7292,51835,51835,0,11,7141000.0
7141,7141999,21.448196480252363,37.931042531525954,0.06180169869813046,1371.8414125442505,474.7398188114166,1584.5145378112793,59148,7294,51854,51854,0,11,7142000.0
7142,7142999,21.448516777049843,37.93031742401566,0.06179413329214667,1371.9716665744781,474.8073489665985,1584.733211517334,59150,7294,51856,51856,0,11,7143000.0
7143,7143999,21.448491991957795,37.92917806369575,0.061787443083885174,1372.5188274383545,474.87394881248474,1584.933494567871,59168,7297,51871,51871,0,11,7144000.0
7144,7144999,21.44796524233915,37.92786230972153,0.06178701829066391,1372.6452684402466,474.9410264492035,1585.5698547363281,59186,7297,51889,51889,0,11,7145000.0
7145,7145999,21.447476081313955,37.92751304724746,0.06178533652854368,1373.049561738968,475.0096182823181,1585.8366661071777,59203,7299,51904,51904,0,11,7146000.0
7146,7146999,21.44714786647461,37.92748804056055,0.0617922615256411,1373.1796729564667,475.0782525539398,1586.0954284667969,59205,7299,51906,51906,0,11,7147000.0
7147,7147999,21.446380899515802,37.92593340353242,0.06179728530110906,1373.3194825649261,475.15558528900146,1586.422477722168,59210,7299,51911,51911,0,11,7148000.0
7148,7148999,21.446117810079972,37.92627328641906,0.06180663485879678,1373.455151796341,475.22129130363464,1586.570026397705,59210,7299,51911,51911,0,11,7149000.0
7149,7149999,21.446436756125923,37.92715040609891,0.061785003313599596,1373.7199556827545,475.28879499435425,1586.9113121032715,59221,7300,51921,51921,0,11,7150000.0
7150,7150999,21.44648123920854,37.92703913492057,0.06178250288719844,1373.9940502643585,475.3563275337219,1587.014934539795,59223,7301,51922,51922,0,11,7151000.0
7151,7151999,21.446677208668614,37.9274746533309,0.06177748164243679,1374.2562510967255,475.42312574386597,1587.1197547912598,59226,7302,51924,51924,0,11,7152000.0
7152,7152999,21.447146804585547,37.92787791086645,0.06176735245744891,1374.669387102127,475.4908537864685,1587.3760299682617,59235,7304,51931,51931,0,11,7153000.0
7153,7153999,21.448101874563562,37.93108149532386,0.061763891119502534,1374.9367334842682,475.5579721927643,1587.5596771240234,59237,7305,51932,51932,0,11,7154000.0
7154,7154999,21.448799007832402,37.9320640384383,0.06177369454980819,1375.3466713428497,475.62690472602844,1587.8547325134277,59264,7307,51957,51957,0,11,7155000.0
7155,7155999,21.449520132611482,37.93265808427018,0.061768065577359366,1375.619052886963,475.69458055496216,1588.1107330322266,59277,7308,51969,51969,0,11,7156000.0
7156,7156999,21.45025302561712,37.93316109394981,0.06175784289084896,1375.7421510219574,475.7609601020813,1588.2556495666504,59277,7308,51969,51969,0,11,7157000.0
7157,7157999,21.45121439759097,37.933719120629796,0.06173930443817954,1376.4447865486145,475.82889008522034,1588.5365829467773,59314,7312,52002,52002,0,11,7158000.0
7158,7158999,21.452555732226944,37.936915381330415,0.06173530782237813,1376.8501670360565,475.8952283859253,1588.6626319885254,59326,7314,52012,52012,0,11,7159000.0
7159,7159999,21.453242656422606,37.936840835210376,0.06173076726900051,1377.273452758789,475.9624800682068,1588.8971481323242,59342,7316,52026,52026,0,11,7160000.0
7160,7160999,21.45362892568026,37.93663884942754,0.061731372840321486,1377.3995649814606,476.0283668041229,1589.1758117675781,59344,7316,52028,52028,0,11,7161000.0
7161,7161999,21.454113874689632,37.9450268677353,0.06176891847332999,1377.8132066726685,476.09597635269165,1589.5433235168457,59377,7318,52059,52059,0,11,7162000.0
7162,7162999,21.453928509647003,37.94818878451469,0.06179449994378805,1378.3704798221588,476.1648337841034,1589.8552207946777,59400,7321,52079,52079,0,11,7163000.0
7163,7163999,21.453434991803732,37.9475839126403,0.061808041321348206,1378.506938457489,476.23284101486206,1590.061134338379,59400,7321,52079,52079,0,11,7164000.0
7164,7164999,21.45336756841362,37.94848426730791,0.06181112280213841,1379.0783796310425,476.3014919757843,1590.109962463379,59410,7324,52086,52086,0,11,7165000.0
7165,7165999,21.4536995643539,37.94950216018739,0.06179526929520651,1379.3539695739746,476.3696389198303,1590.4974975585938,59428,7325,52103,52103,0,11,7166000.0
7166,7166999,21.45409544951786,37.95018809556396,0.06177186111960031,1379.9080023765564,476.43666672706604,1590.5978393554688,59444,7328,52116,52116,0,11,7167000.0
7167,7167999,21.454494250228166,37.95080037076458,0.061768142781523094,1380.3183205127716,476.50343132019043,1590.7043724060059,59455,7330,52125,52125,0,11,7168000.0
7168,7168999,21.454970491226227,37.95130149240911,0.06175850022290297,1380.5871171951294,476.5719184875488,1591.112403869629,59466,7331,52135,52135,0,11,7169000.0
7169,7169999,21.455551458133847,37.951747523935175,0.06175527360226862,1381.0029010772705,476.6396369934082,1591.2448043823242,59480,7333,52147,52147,0,11,7170000.0
7170,7170999,21.45663218928521,37.95517375666983,0.06175272261894671,1381.2736022472382,476.70640778541565,1591.4634628295898,59493,7334,52159,52159,0,11,7171000.0
7171,7171999,21.457569773737237,37.95701105276252,0.06173275395357636,1381.6820073127747,476.77502512931824,1591.6948852539062,59512,7336,52176,52176,0,11,7172000.0
7172,7172999,21.458398627768144,37.957878959725655,0.06172279416617188,1381.9477396011353,476.8417127132416,1591.8404960632324,59515,7337,52178,52178,0,11,7173000.0
7173,7173999,21.459445728173698,37.95932885115212,0.06172130626304073,1382.3618702888489,476.90923976898193,1591.9479637145996,59529,7339,52190,52190,0,11,7174000.0
7174,7174999,21.460648675524936,37.96248425360772,0.061713370494439035,1382.6283600330353,476.9768624305725,1592.2498016357422,59541,7340,52201,52201,0,11,7175000.0
7175,7175999,21.461907774024382,37.96405700090076,0.061718964362833084,1383.1888654232025,477.0445728302002,1592.2982292175293,59561,7343,52218,52218,0,11,7176000.0
7176,7176999,21.46287838684099,37.964562504550884,0.061720691012869255,1383.7380542755127,477.1122872829437,1592.6284484863281,59580,7346,52234,52234,0,11,7177000.0
7177,7177999,21.463978681245404,37.965803089221346,0.061717058247366285,1383.8532891273499,477.1792631149292,1592.9126167297363,59580,7346,52234,52234,0,11,7178000.0
7178,7178999,21.46505509271345,37.966642397829055,0.06172184599347785,1384.117965221405,477.24601221084595,1593.096393585205,59582,7347,52235,52235,0,11,7179000.0
7179,7179999,21.46586345969625,37.96678518106435,0.06172326233455527,1384.667245388031,477.3121762275696,1593.2202606201172,59611,7350,52261,52261,0,11,7180000.0
7180,7180999,21.466900842264998,37.968257216158314,0.06173303316426959,1384.7947475910187,477.37882685661316,1593.413345336914,59611,7350,52261,52261,0,11,7181000.0
7181,7181999,21.466821819437822,37.96891099031431,0.06172330557283512,1385.055583000183,477.4461226463318,1593.6501579284668,59616,7351,52265,52265,0,11,7182000.0
7182,7182999,21.466199419283797,37.96872550890377,0.06171101719912231,1385.478558063507,477.5140085220337,1593.8438262939453,59636,7353,52283,52283,0,11,7183000.0
7183,7183999,21.465668743816817,37.968661163267825,0.061704120296731224,1385.6150131225586,477.58256125450134,1594.0400390625,59636,7353,52283,52283,0,11,7184000.0
7184,7184999,21.465412449101855,37.96815507760863,0.061699740857180885,1386.173644065857,477.6523084640503,1594.2656936645508,59668,7356,52312,52312,0,11,7185000.0
7185,7185999,21.465150622818534,37.96745142041631,0.06169842587416119,1386.5912432670593,477.71990275382996,1594.417854309082,59680,7358,52322,52322,0,11,7186000.0
7186,7186999,21.465008017728763,37.9678344042526,0.061685609611447534,1386.7136163711548,477.78629183769226,1594.5801696777344,59680,7358,52322,52322,0,11,7187000.0
7187,7187999,21.4654291486251,37.96804307149456,0.06168951873198758,1387.2907574176788,477.85423517227173,1594.5967597961426,59692,7361,52331,52331,0,11,7188000.0
7188,7188999,21.465989231637735,37.96877517196273,0.06168522043672253,1387.4142353534698,477.9218602180481,1594.8620262145996,59696,7361,52335,52335,0,11,7189000.0
7189,7189999,21.466573200292576,37.96926150336034,0.06169049128695758,1387.8278586864471,477.98856568336487,1594.9015045166016,59700,7363,52337,52337,0,11,7190000.0
7190,7190999,21.467503044865946,37.970547740608545,0.061695775057883595,1388.821566104889,478.0566842556,1594.801528930664,59752,7369,52383,52383,0,11,7191000.0
7191,7191999,21.468662249300685,37.97202684386133,0.06171726251711884,1389.0908393859863,478.1230854988098,1595.028549194336,59756,7370,52386,52386,0,11,7192000.0
7192,7192999,21.470044754447052,37.97465533051446,0.061726419018296896,1389.5074293613434,478.1889503002167,1595.0266227722168,59760,7372,52388,52388,0,11,7193000.0
7193,7193999,21.471767027364713,37.97833251880214,0.0617529261785742,1389.7726645469666,478.2562515735626,1595.132194519043,59762,7373,52389,52389,0,11,7194000.0
7194,7194999,21.473401061638324,37.98030399604082,0.061772037167667326,1389.9113698005676,478.32312393188477,1595.33935546875,59766,7373,52393,52393,0,11,7195000.0
7195,7195999,21.475412783860513,37.98354455340227,0.06178486885503898,1390.045598268509,478.3888883590698,1595.5033721923828,59766,7373,52393,52393,0,11,7196000.0
7196,7196999,21.477301252206843,37.98616756612312,0.06182253028815754,1390.3195989131927,478.4557912349701,1595.585521697998,59773,7374,52399,52399,0,11,7197000.0
7197,7197999,21.479119434974034,37.98860739360292,0.061863091888644695,1390.4455165863037,478.52165269851685,1595.9031600952148,59779,7374,52405,52405,0,11,7198000.0
7198,7198999,21.480901818838753,37.99096810483722,0.06191109405767936,1390.5734593868256,478.5886330604553,1596.0337219238281,59779,7374,52405,52405,0,11,7199000.0
7199,7199999,21.48288825485418,37.99459073817115,0.06196829525630754,1390.9950771331787,478.65594577789307,1596.0966415405273,59794,7376,52418,52418,0,11,7200000.0
7200,7200999,21.48495896940049,37.9974759492265,0.062022016911444156,1391.1235604286194,478.72170400619507,1596.381202697754,59799,7376,52423,52423,0,11,7201000.0
7201,7201999,21.486185895281444,38.000118532995124,0.062039270041299166,1391.3946998119354,478.7877731323242,1596.6001892089844,59805,7377,52428,52428,0,11,7202000.0
7202,7202999,21.486114803706904,38.000357915037384,0.06202247762374691,1391.8078727722168,478.85494327545166,1596.7454566955566,59825,7379,52446,52446,0,11,7203000.0
7203,7203999,21.485661748225827,37.99947329037048,0.06201748180947053,1391.943172454834,478.9227261543274,1597.0801620483398,59831,7379,52452,52452,0,11,7204000.0
7204,7204999,21.48544044168851,37.999255066857685,0.06201486289592495,1392.0738701820374,478.9906716346741,1597.2498931884766,59832,7379,52453,52453,0,11,7205000.0
7205,7205999,21.485887997829558,38.00039421031498,0.0620048332402755,1392.2049314975739,479.05869245529175,1597.3713340759277,59832,7379,52453,52453,0,11,7206000.0
7206,7206999,21.48673387444471,38.002218509767616,0.062003038543351985,1392.3319745063782,479.12568616867065,1597.6922187805176,59838,7379,52459,52459,0,11,7207000.0
7207,7207999,21.488230136438872,38.004698049912356,0.062018746619483256,1392.8825602531433,479.19233536720276,1597.7630653381348,59862,7382,52480,52480,0,11,7208000.0
7208,7208999,21.490312045629473,38.00898165327154,0.06204486332261383,1393.2998418807983,479.25949597358704,1598.0979804992676,59886,7384,52502,52502,0,11,7209000.0
7209,7209999,21.492289983546264,38.012579278136734,0.06206488531184129,1393.7023289203644,479.32662558555603,1598.1893348693848,59900,7386,52514,52514,0,11,7210000.0
7210,7210999,21.494621092872155,38.01691228090755,0.06211877119443365,1394.5729396343231,479.394912481308,1598.3734588623047,59940,7391,52549,52549,0,11,7211000.0
