,n_samples,MAE,RMSE,R2,time_learning,time_predicting,memory,n_nodes,n_branches,n_leaves,n_active_leaves,n_inactive_leaves,height,total_observed_weight
0,999,20.42384130879432,37.93610961097188,-0.014165771224336376,0.11903619766235352,0.05650448799133301,0.23662567138671875,3,1,2,2,0,2,1000.0
1,1999,21.39349941302081,42.9058567644078,-0.00588598290925213,0.27307653427124023,0.12142586708068848,0.29546356201171875,3,1,2,2,0,2,2000.0
2,2999,20.593286258525932,39.69219170642934,-0.005247901565484492,0.43914246559143066,0.1849524974822998,0.3261146545410156,3,1,2,2,0,2,3000.0
3,3999,20.82549615494678,44.73227210697414,-0.0032086478379347305,0.5784142017364502,0.2378220558166504,0.2000885009765625,4,2,2,2,0,3,4000.0
4,4999,20.311422137538244,42.21762568297813,-0.002974743012196024,0.6995468139648438,0.2924377918243408,0.28832244873046875,5,3,2,2,0,4,5000.0
5,5999,19.94113211303236,40.756110287898956,-0.0025969331102662085,0.8328707218170166,0.3461287021636963,0.347076416015625,5,3,2,2,0,4,6000.0
6,6999,19.878620702256608,39.67297543689953,-0.0020829389792309527,0.9749801158905029,0.4008622169494629,0.3808097839355469,5,3,2,2,0,4,7000.0
7,7999,20.039043540353592,39.13049879121926,-0.0007558928922763997,1.123016119003296,0.45595502853393555,0.2565879821777344,6,4,2,2,0,5,8000.0
8,8999,20.541821164195078,39.30299983703011,0.0022637565109762114,1.2490148544311523,0.512934684753418,0.3215751647949219,7,5,2,2,0,6,9000.0
9,9999,21.198661476319558,39.92320074163556,0.007377727031598669,1.393998384475708,0.5710573196411133,0.5607414245605469,20,6,14,14,0,6,10000.0
10,10999,21.500054161829993,39.66565218400852,0.0090009191836391,1.5385053157806396,0.6286411285400391,0.8585395812988281,39,7,32,32,0,7,11000.0
11,11999,21.69409762217472,39.33203164955743,0.014203146806677336,1.6363205909729004,0.6871051788330078,1.3531875610351562,39,7,32,32,0,7,12000.0
12,12999,22.24739223228625,40.618259553864576,0.018854181444745488,1.734992265701294,0.7440853118896484,1.6199874877929688,40,7,33,33,0,7,13000.0
13,13999,22.806304756272738,41.064974877958356,0.02847243796447063,1.8512327671051025,0.8013415336608887,1.8046493530273438,40,7,33,33,0,7,14000.0
14,14999,23.30589586934197,41.44522721030137,0.0354298732658852,1.9531326293945312,0.857567310333252,1.9561882019042969,40,7,33,33,0,7,15000.0
15,15999,23.518710038386867,41.323830611723544,0.03967061017908424,2.074127674102783,0.9140923023223877,2.0542259216308594,40,7,33,33,0,7,16000.0
16,16999,23.84174211415661,41.72423029661204,0.04498053248329592,2.197155237197876,0.97214674949646,2.0952835083007812,42,8,34,34,0,7,17000.0
17,17999,24.09196281259613,41.635319336745674,0.0473848154111145,2.3038392066955566,1.0298006534576416,2.1965789794921875,42,8,34,34,0,7,18000.0
18,18999,24.047580115702274,41.2428062186288,0.05005794160521371,2.4184393882751465,1.0870277881622314,2.308330535888672,42,8,34,34,0,7,19000.0
19,19999,24.13599219735054,41.000962863452735,0.0433292858041231,2.543830633163452,1.1443743705749512,2.5231056213378906,42,8,34,34,0,7,20000.0
20,20999,24.101786509038583,40.790833970144845,0.0363622096996844,2.652679204940796,1.2019307613372803,2.6222877502441406,42,8,34,34,0,7,21000.0
21,21999,24.013631043145953,40.37883170976094,0.03160035732020461,2.7777059078216553,1.2599430084228516,2.6690330505371094,42,8,34,34,0,7,22000.0
22,22999,23.916063481935232,40.176023734828185,0.027958717921751086,2.901428699493408,1.3175373077392578,2.7454452514648438,42,8,34,34,0,7,23000.0
23,23999,23.791397549583596,39.735175274143124,0.025390147761489734,3.029327630996704,1.3752174377441406,2.786205291748047,42,8,34,34,0,7,24000.0
24,24999,23.66345029555888,39.35496500519991,0.022852538793714516,3.162381172180176,1.4329118728637695,2.8288841247558594,42,8,34,34,0,7,25000.0
25,25999,23.52707231887422,39.05361103111463,0.020981577049927203,3.2815029621124268,1.4908509254455566,2.881000518798828,42,8,34,34,0,7,26000.0
26,26999,23.442841281927716,38.743051282557815,0.01847516406879557,3.3966712951660156,1.5473227500915527,2.914264678955078,42,8,34,34,0,7,27000.0
27,27999,23.31787827849578,38.467031606230236,0.017126458829641145,3.530149459838867,1.6047585010528564,2.9405479431152344,42,8,34,34,0,7,28000.0
28,28999,23.210536347873663,38.349751305125686,0.01568100728796129,3.6445069313049316,1.6642234325408936,2.9870948791503906,42,8,34,34,0,7,29000.0
29,29999,23.113159392190155,38.07802332234825,0.014928652615950888,3.788508415222168,1.7216920852661133,3.0141563415527344,42,8,34,34,0,7,30000.0
30,30999,23.036346456318764,38.211906862198894,0.014481675768647229,3.909395456314087,1.7792491912841797,3.0265350341796875,42,8,34,34,0,7,31000.0
31,31999,22.938151965818523,37.956327461285966,0.014173782138895863,4.026453256607056,1.8367109298706055,3.0593719482421875,42,8,34,34,0,7,32000.0
32,32999,22.879928861172022,37.82791598233796,0.014138535499166771,4.1678855419158936,1.8939323425292969,3.0634002685546875,42,8,34,34,0,7,33000.0
33,33999,22.81852564330887,37.648589112427764,0.014229226671976347,4.2703330516815186,1.9513916969299316,3.0070343017578125,44,9,35,35,0,8,34000.0
34,34999,22.75920781587746,37.51166990359482,0.014371112299689237,4.404566049575806,2.0096848011016846,3.0772972106933594,44,9,35,35,0,8,35000.0
35,35999,22.74204126657826,37.37659471858925,0.014510934185889224,4.544768810272217,2.0679738521575928,3.0860595703125,44,9,35,35,0,8,36000.0
36,36999,22.677463146340035,37.19891208986052,0.015155532464599886,4.665964365005493,2.1254053115844727,3.0908470153808594,44,9,35,35,0,8,37000.0
37,37999,22.62456781997001,37.00711978339467,0.014933802381258632,4.773345232009888,2.183217763900757,3.0956687927246094,44,9,35,35,0,8,38000.0
38,38999,22.547386425356436,36.829584698456905,0.015039705944885351,4.903002738952637,2.241379737854004,3.0990219116210938,44,9,35,35,0,8,39000.0
39,39999,22.442715751814717,36.626989420314736,0.01570041009650336,5.029156446456909,2.29876446723938,3.1131439208984375,44,9,35,35,0,8,40000.0
40,40999,22.39567722759097,36.50225921173482,0.014624568517363268,5.16511607170105,2.356390953063965,3.1906356811523438,45,9,36,36,0,8,41000.0
41,41999,22.27835482666071,36.256744336519674,0.014095679801823802,5.2813568115234375,2.414048433303833,3.1837501525878906,47,10,37,37,0,9,42000.0
42,42999,22.169649404458866,36.04312015023861,0.01369076330324126,5.409933090209961,2.4726359844207764,3.267200469970703,47,10,37,37,0,9,43000.0
43,43999,22.05270864269844,35.805711848481224,0.013175398827882767,5.524428367614746,2.530973196029663,3.287914276123047,47,10,37,37,0,9,44000.0
44,44999,21.957625427484306,35.614771604776415,0.012876319107840262,5.6562700271606445,2.5890302658081055,3.2956771850585938,47,10,37,37,0,9,45000.0
45,45999,21.845568439845962,35.37213505688711,0.012731929725490088,5.802520275115967,2.6497159004211426,3.306121826171875,47,10,37,37,0,9,46000.0
46,46999,21.741093008074856,35.16181391024223,0.012357402571527176,5.914443492889404,2.7075140476226807,3.314971923828125,47,10,37,37,0,9,47000.0
47,47999,21.65884008308191,35.045484486841644,0.011954692016022062,6.035712003707886,2.7646374702453613,3.3196258544921875,47,10,37,37,0,9,48000.0
48,48999,21.604244919029377,35.03045320747695,0.011469990349820436,6.167908668518066,2.8233933448791504,3.3233871459960938,47,10,37,37,0,9,49000.0
49,49999,21.535251635733275,34.9969687474287,0.010980752648093728,6.307423114776611,2.881037473678589,3.3310089111328125,47,10,37,37,0,9,50000.0
50,50999,21.49561046296097,34.95339249339013,0.010748455996873574,6.435792446136475,2.9388580322265625,3.308380126953125,49,11,38,38,0,10,51000.0
51,51999,21.45889207386864,34.86509646657948,0.010697865771201132,6.557611465454102,2.996525764465332,3.3343276977539062,49,11,38,38,0,10,52000.0
52,52999,21.396563118126828,34.745763280066264,0.010713056089342254,6.689425706863403,3.058133602142334,3.2424049377441406,52,12,40,40,0,10,53000.0
53,53999,21.36243900732305,34.70777895096827,0.010382777204473892,6.812577724456787,3.1166443824768066,3.2152862548828125,55,13,42,42,0,10,54000.0
54,54999,21.341117987734446,34.659621272174505,0.010325779928087364,6.939802169799805,3.174978494644165,3.258331298828125,55,13,42,42,0,10,55000.0
55,55999,21.325339952236213,34.63078425196552,0.010414775235964235,7.065595626831055,3.2336549758911133,3.202411651611328,58,14,44,44,0,10,56000.0
56,56999,21.310522485329965,34.58807019655926,0.010192506092697728,7.188054800033569,3.2928130626678467,3.2562904357910156,58,14,44,44,0,10,57000.0
57,57999,21.29641996833179,34.54190274324169,0.0103601260216164,7.316129207611084,3.3517801761627197,3.291057586669922,58,14,44,44,0,10,58000.0
58,58999,21.27244609977979,34.475171070277355,0.010297251646256278,7.449264049530029,3.4122471809387207,3.3116416931152344,58,14,44,44,0,10,59000.0
59,59999,21.266985565821432,34.42339462474016,0.010234126524079512,7.568896532058716,3.4711008071899414,3.332050323486328,58,14,44,44,0,10,60000.0
60,60999,21.270249806285324,34.53884190274739,0.010259408128605818,7.703280210494995,3.5295138359069824,3.2459754943847656,62,15,47,47,0,10,61000.0
61,61999,21.197565208171046,34.4205027403406,0.010476101188868103,7.864581346511841,3.5875439643859863,3.4650955200195312,68,16,52,52,0,10,62000.0
62,62999,21.10612716715923,34.322656564353494,0.010936244565988074,7.987550973892212,3.6462676525115967,3.5574111938476562,70,17,53,53,0,10,63000.0
63,63999,21.02235804249932,34.253351321262016,0.011276030353610356,8.134786367416382,3.7059805393218994,3.588420867919922,74,19,55,55,0,10,64000.0
64,64999,20.929035524463018,34.106536283489994,0.01131319318452273,8.24542784690857,3.764146327972412,3.703357696533203,74,19,55,55,0,10,65000.0
65,65999,20.885749557978457,34.082360724465126,0.011402071904235811,8.355796575546265,3.822251558303833,3.7652587890625,74,19,55,55,0,10,66000.0
66,66999,20.851256215102016,34.119491036358795,0.01139317975316445,8.492902517318726,3.88095760345459,3.6919174194335938,80,21,59,59,0,10,67000.0
67,67999,20.81096823824279,34.062448857293134,0.011553803429495302,8.625030755996704,3.9398579597473145,3.7283287048339844,82,22,60,60,0,10,68000.0
68,68999,20.83353923003826,34.132758912520146,0.012220646311156491,8.735188722610474,4.002100706100464,3.814228057861328,82,22,60,60,0,10,69000.0
69,69999,20.861151527899207,34.45362502247648,0.013201330447567439,8.890412330627441,4.063658714294434,3.8218841552734375,84,23,61,61,0,10,70000.0
70,70999,20.91630169072706,34.66198428582549,0.01603351853241297,9.000666618347168,4.1220948696136475,3.88800048828125,84,23,61,61,0,10,71000.0
71,71999,20.99332360951668,34.84945241397844,0.01986771168776802,9.116601943969727,4.181511402130127,3.9146461486816406,86,24,62,62,0,10,72000.0
72,72999,21.051300975148262,35.220891322260805,0.020636788798082728,9.25487494468689,4.240759611129761,3.8640098571777344,90,26,64,64,0,11,73000.0
73,73999,21.086079606595675,35.387813150553015,0.0295160771614712,9.385144710540771,4.301327705383301,3.8500404357910156,94,27,67,67,0,11,74000.0
74,74999,21.13680817999531,35.488525094675275,0.033054896695775215,9.512731552124023,4.362670183181763,3.879161834716797,96,28,68,68,0,11,75000.0
75,75999,21.187736400581827,35.57496940731162,0.03717268107976435,9.634726762771606,4.422892093658447,3.9583168029785156,96,28,68,68,0,11,76000.0
76,76999,21.29288284866437,35.97062770048423,0.040764690870242704,9.755860328674316,4.48314642906189,3.98651123046875,98,29,69,69,0,11,77000.0
77,77999,21.407201048896898,36.161298539947126,0.04212810268191447,9.89531683921814,4.543469429016113,4.068634033203125,98,29,69,69,0,11,78000.0
78,78999,21.49427138456364,36.291471020673804,0.043850719597648635,10.015410661697388,4.602842569351196,4.109718322753906,98,29,69,69,0,11,79000.0
79,79999,21.594276170846676,36.41960224364061,0.04414509620602247,10.145081758499146,4.6618876457214355,4.079654693603516,102,30,72,72,0,11,80000.0
80,80999,21.670630634428065,36.491955096855804,0.04428559283363864,10.272103309631348,4.721280336380005,4.011146545410156,104,31,73,73,0,11,81000.0
81,81999,21.684186954053143,36.53211240132954,0.04086193301633767,10.399691581726074,4.780294179916382,4.285236358642578,117,32,85,85,0,11,82000.0
82,82999,21.64484591484895,36.5113479858309,0.04076579267258118,10.512121677398682,4.839328289031982,4.477413177490234,117,32,85,85,0,11,83000.0
83,83999,21.592678646275225,36.398800038961824,0.04090815052619212,10.627561330795288,4.897930860519409,4.609165191650391,119,33,86,86,0,11,84000.0
84,84999,21.560599839345556,36.3294507143328,0.04022078929118966,10.74935269355774,4.956864833831787,4.6105499267578125,125,36,89,89,0,11,85000.0
85,85999,21.564500320903388,36.37607992704337,0.03992818259893638,10.881808996200562,5.016283750534058,4.71600341796875,129,38,91,91,0,11,86000.0
86,86999,21.535973342897154,36.31664106353609,0.0399681600635734,11.004811763763428,5.075258255004883,4.766162872314453,133,40,93,93,0,11,87000.0
87,87999,21.56748135247561,36.36769736954237,0.04051456221842298,11.12474536895752,5.138484477996826,4.894039154052734,133,40,93,93,0,11,88000.0
88,88999,21.60244385852961,36.42637210073062,0.040598016633502376,11.260357141494751,5.197917222976685,4.926490783691406,135,41,94,94,0,11,89000.0
89,89999,21.646552745439998,36.47864709823114,0.040925451843824345,11.378984689712524,5.257515907287598,5.0052642822265625,135,41,94,94,0,11,90000.0
90,90999,21.70032611965743,36.54888657870443,0.0413555612014016,11.513072967529297,5.316942453384399,4.916332244873047,142,43,99,99,0,11,91000.0
91,91999,21.777369462024247,36.67990677701306,0.04174823552322293,11.642756223678589,5.378580331802368,4.9977874755859375,142,43,99,99,0,11,92000.0
92,92999,21.878704441995115,36.90921140816174,0.04285940656226972,11.747915983200073,5.437780380249023,5.055355072021484,142,43,99,99,0,11,93000.0
93,93999,21.96491250099572,37.04820777468169,0.04298202214290503,11.856427431106567,5.498549222946167,5.09710693359375,142,43,99,99,0,11,94000.0
94,94999,22.038461728561433,37.13456313697322,0.04327766371037289,12.016151905059814,5.5594322681427,5.070720672607422,146,45,101,101,0,11,95000.0
95,95999,22.13478688596811,37.2946008107964,0.04442032447686328,12.138112306594849,5.620235443115234,5.1385498046875,146,45,101,101,0,11,96000.0
96,96999,22.24228463581861,37.43648606766296,0.04595398878879198,12.269160270690918,5.681076765060425,5.189434051513672,146,45,101,101,0,11,97000.0
97,97999,22.361455120220754,37.73895061071845,0.04688819293017954,12.387114763259888,5.742923021316528,5.251182556152344,146,45,101,101,0,11,98000.0
98,98999,22.464110678609472,37.89044686854162,0.047970832328232405,12.500305414199829,5.803874731063843,5.293247222900391,146,45,101,101,0,11,99000.0
99,99999,22.58132491263223,38.07406953382859,0.048731040808325465,12.650440454483032,5.864291667938232,5.1443328857421875,153,47,106,106,0,11,100000.0
100,100999,22.670056017203592,38.16625274181948,0.04934637558477095,12.780364274978638,5.92556095123291,5.173789978027344,158,48,110,110,0,11,101000.0
101,101999,22.710696413223985,38.196680081150845,0.04878602416519584,12.906780004501343,5.9859299659729,5.6427459716796875,170,48,122,122,0,11,102000.0
102,102999,22.66756227287696,38.12383168419071,0.04892141679786355,13.016119718551636,6.04601263999939,5.913700103759766,170,48,122,122,0,11,103000.0
103,103999,22.64178166690427,38.11662474888115,0.04872449042410831,13.128952980041504,6.105737686157227,6.049125671386719,172,49,123,123,0,11,104000.0
104,104999,22.602957948288093,38.08130837812909,0.048336881366218165,13.241969347000122,6.166057109832764,6.142551422119141,176,51,125,125,0,11,105000.0
105,105999,22.56145190704656,38.01567384249814,0.04837267267853951,13.369648218154907,6.226306200027466,6.228534698486328,182,54,128,128,0,11,106000.0
106,106999,22.509054712226344,37.934817171168355,0.0483911600418665,13.49449372291565,6.287030220031738,6.253177642822266,186,56,130,130,0,11,107000.0
107,107999,22.449348502669405,37.82551712827507,0.048677435795785096,13.628307819366455,6.348610877990723,6.2330322265625,194,58,136,136,0,11,108000.0
108,108999,22.413784646271026,37.90452098891412,0.04812832544577428,13.741148948669434,6.407724857330322,6.268459320068359,200,59,141,141,0,11,109000.0
109,109999,22.36424674096833,37.83247154302516,0.04820907028199062,13.875244617462158,6.467994451522827,6.397983551025391,200,59,141,141,0,11,110000.0
110,110999,22.325671771107213,37.754687506512546,0.04834135196142919,13.984526634216309,6.529414653778076,6.477424621582031,202,60,142,142,0,11,111000.0
111,111999,22.295270977765444,37.80999244072862,0.04839432401177346,14.121237993240356,6.589613676071167,6.5325775146484375,204,61,143,143,0,11,112000.0
112,112999,22.26159804038861,37.73691324347774,0.04834866279957528,14.240732192993164,6.650098085403442,6.570018768310547,206,62,144,144,0,11,113000.0
113,113999,22.231592463450536,37.67940856613661,0.04847882862839392,14.377753496170044,6.7118072509765625,6.689266204833984,206,62,144,144,0,11,114000.0
114,114999,22.20732703777212,37.632146498279276,0.04874717548442331,14.501548290252686,6.772692441940308,6.785022735595703,243,63,180,180,0,11,115000.0
115,115999,22.185870006220842,37.56881666830953,0.04867871053173667,14.627522230148315,6.834038019180298,6.902652740478516,286,64,222,222,0,11,116000.0
116,116999,22.159419575988366,37.49486164400277,0.048881993489202746,14.746120691299438,6.8946967124938965,7.0894622802734375,286,64,222,222,0,11,117000.0
117,117999,22.130613019099183,37.47220569119575,0.049075079618565276,14.886290073394775,6.9552154541015625,7.217517852783203,288,65,223,223,0,11,118000.0
118,118999,22.096042695729906,37.4086719124245,0.04886555569704043,15.00804352760315,7.016144037246704,7.42645263671875,288,65,223,223,0,11,119000.0
119,119999,22.053469104151954,37.342060954266465,0.0487984864056491,15.12018346786499,7.077113151550293,8.325447082519531,302,65,237,237,0,11,120000.0
120,120999,21.997910955955817,37.250372155608005,0.049355505526863075,15.22053337097168,7.135790586471558,8.68093490600586,302,65,237,237,0,11,121000.0
121,121999,21.937828772167837,37.153733910250516,0.04946445898214702,15.341136455535889,7.196982383728027,8.860595703125,308,68,240,240,0,11,122000.0
122,122999,21.88320186139884,37.078195242755484,0.04977306482296717,15.454121589660645,7.257364511489868,9.064380645751953,312,70,242,242,0,11,123000.0
123,123999,21.832402349555142,36.993950051994744,0.049959123005232864,15.597807884216309,7.3283538818359375,9.318187713623047,314,71,243,243,0,11,124000.0
124,124999,21.78387738730683,36.978609275913044,0.04988823829784106,15.735281229019165,7.389356851577759,9.359272003173828,320,74,246,246,0,11,125000.0
125,125999,21.73950560473869,36.912107058400274,0.04998327535370606,15.86152696609497,7.449624300003052,9.528888702392578,322,75,247,247,0,11,126000.0
126,126999,21.698210757198407,36.844549163083485,0.04996934468761083,15.999565124511719,7.511156320571899,9.620201110839844,324,76,248,248,0,11,127000.0
127,127999,21.661647976276846,36.78076057069976,0.04962315566183595,16.115903854370117,7.575032949447632,9.805892944335938,324,76,248,248,0,11,128000.0
128,128999,21.63246918583837,36.71686325793278,0.04955529864625219,16.236666679382324,7.63523006439209,9.888935089111328,326,77,249,249,0,11,129000.0
129,129999,21.60275688163821,36.66738754510954,0.04932980872306503,16.380722045898438,7.697746753692627,9.957794189453125,328,78,250,250,0,11,130000.0
130,130999,21.56824054026365,36.61821788174809,0.04941561594552002,16.50639843940735,7.761080741882324,10.083255767822266,328,78,250,250,0,11,131000.0
131,131999,21.55937405867041,36.677119341342895,0.04934464074635592,16.623695611953735,7.8230695724487305,10.188518524169922,328,78,250,250,0,11,132000.0
132,132999,21.546835368172736,36.652499656127056,0.04920116862070456,16.7602698802948,7.8849194049835205,10.275947570800781,328,78,250,250,0,11,133000.0
133,133999,21.550302750300656,36.663639141461545,0.04943500349684171,16.878745079040527,7.945351600646973,10.351245880126953,328,78,250,250,0,11,134000.0
134,134999,21.568394212174997,36.68913752351437,0.04963030470684926,17.008381366729736,8.005475044250488,10.36221694946289,335,79,256,256,0,11,135000.0
135,135999,21.583215164424676,36.69209463990537,0.04973182087134187,17.141947031021118,8.066317558288574,10.376895904541016,337,80,257,257,0,11,136000.0
136,136999,21.60259529594849,36.71017761876061,0.04965717238766787,17.275312662124634,8.129510164260864,10.448162078857422,337,80,257,257,0,11,137000.0
137,137999,21.62386174564651,36.783117682048854,0.050009012251632345,17.39978289604187,8.190722703933716,10.534721374511719,337,80,257,257,0,11,138000.0
138,138999,21.625197484707076,36.76857854897855,0.05001901183361401,17.516178846359253,8.251652956008911,11.011039733886719,351,80,271,271,0,11,139000.0
139,139999,21.58174941769408,36.74706202328885,0.050120770693202976,17.617965936660767,8.312686920166016,11.399101257324219,352,80,272,272,0,11,140000.0
140,140999,21.531957483440564,36.671687749746454,0.050327521209048376,17.72304344177246,8.373279094696045,11.613365173339844,352,80,272,272,0,11,141000.0
141,141999,21.494526541250703,36.608774331294946,0.05036489266663957,17.8519287109375,8.434090852737427,11.627140045166016,362,85,277,277,0,11,142000.0
142,142999,21.450344068186002,36.532606236459664,0.05039698235745371,17.984007358551025,8.507969379425049,11.81884765625,364,86,278,278,0,11,143000.0
143,143999,21.411473483949496,36.48597709186056,0.05050652920704268,18.099907398223877,8.569099187850952,11.921005249023438,368,88,280,280,0,11,144000.0
144,144999,21.37194544836899,36.412309822064984,0.050530579860332936,18.2421658039093,8.63050889968872,11.922645568847656,382,92,290,290,0,11,145000.0
145,145999,21.335868688272964,36.34862074501025,0.05054434565962351,18.363122940063477,8.692350149154663,12.090652465820312,384,93,291,291,0,11,146000.0
146,146999,21.30339865390772,36.29179073652874,0.05057461881504932,18.505449771881104,8.754393100738525,12.196853637695312,386,94,292,292,0,11,147000.0
147,147999,21.267080939701014,36.220499664660174,0.05071689662608636,18.614210605621338,8.815445899963379,12.351226806640625,386,94,292,292,0,11,148000.0
148,148999,21.236873772307813,36.179816889402886,0.05079558365376702,18.737418174743652,8.87651538848877,12.356208801269531,402,96,306,306,0,11,149000.0
149,149999,21.206787634819257,36.11938938647292,0.05089889677854664,18.86293935775757,8.937001943588257,12.416954040527344,410,97,313,313,0,11,150000.0
150,150999,21.18649171106413,36.09343974974036,0.05071806828537395,19.00224256515503,8.998732328414917,12.432872772216797,412,98,314,314,0,11,151000.0
151,151999,21.159570156630107,36.04536478825673,0.05088275769249362,19.121851205825806,9.062779664993286,12.530147552490234,412,98,314,314,0,11,152000.0
152,152999,21.1316684198537,35.999284426355004,0.050984366166809014,19.261898040771484,9.123713731765747,12.518047332763672,422,100,322,322,0,11,153000.0
153,153999,21.110658550737043,35.952350257256455,0.051130958105686464,19.37818431854248,9.185162544250488,12.611007690429688,422,100,322,322,0,11,154000.0
154,154999,21.086300717889777,35.89143164317163,0.05136710200983696,19.488125324249268,9.24609899520874,12.6298828125,424,101,323,323,0,11,155000.0
155,155999,21.0555741292719,35.82272753855096,0.05180206700992951,19.64507555961609,9.307941436767578,12.681594848632812,432,102,330,330,0,11,156000.0
156,156999,21.029325866626813,35.76844187286775,0.05204616675037843,19.78177261352539,9.368683099746704,12.710960388183594,440,103,337,337,0,11,157000.0
157,157999,21.002833812455084,35.72734053200163,0.05217145331135231,19.903167486190796,9.429736137390137,12.7427978515625,442,104,338,338,0,11,158000.0
158,158999,20.963829489980636,35.659843751702155,0.052446178062689586,20.021519660949707,9.490295648574829,12.840984344482422,442,104,338,338,0,11,159000.0
159,159999,20.924996873698028,35.595314795518895,0.052551774887058866,20.133442878723145,9.551995992660522,13.717269897460938,464,104,360,360,0,11,160000.0
160,160999,20.868262157931575,35.515382894672605,0.053042615886712774,20.258875370025635,9.624102592468262,13.974445343017578,466,105,361,361,0,11,161000.0
161,161999,20.80935304918774,35.43455192944024,0.05348397523042858,20.38287878036499,9.685113430023193,14.054229736328125,481,109,372,372,0,11,162000.0
162,162999,20.753569254855865,35.35873971705928,0.05388122018145303,20.506338119506836,9.747498989105225,14.16897964477539,496,113,383,383,0,11,163000.0
163,163999,20.704416085786914,35.30720570549145,0.05411833298315738,20.62298893928528,9.80847978591919,14.413043975830078,498,114,384,384,0,11,164000.0
164,164999,20.64617321645914,35.222236728014465,0.054653258671861105,20.739002227783203,9.869880437850952,14.636299133300781,498,114,384,384,0,11,165000.0
165,165999,20.602868092216823,35.16074318862385,0.05499721224081644,20.895880222320557,9.941517353057861,14.647071838378906,509,116,393,393,0,11,166000.0
166,166999,20.565777976950628,35.09378318338162,0.05521063135429349,21.10985279083252,10.004002809524536,14.793014526367188,511,117,394,394,0,11,167000.0
167,167999,20.523121953383022,35.0425783006552,0.05540313410204889,21.223132133483887,10.065643787384033,14.902671813964844,511,117,394,394,0,11,168000.0
168,168999,20.488915243325856,34.989791492171314,0.055613578232474814,21.342477083206177,10.127249956130981,15.023818969726562,511,117,394,394,0,11,169000.0
169,169999,20.466956845276204,35.02598864912478,0.05530644451725497,21.474674463272095,10.189216613769531,15.032238006591797,515,119,396,396,0,11,170000.0
170,170999,20.453803971914233,35.02188269945169,0.05522685909062952,21.604548931121826,10.249464750289917,14.961650848388672,521,122,399,399,0,11,171000.0
171,171999,20.43926990362654,35.01201693970119,0.05517652414762164,21.729923009872437,10.310104846954346,14.984237670898438,525,124,401,401,0,11,172000.0
172,172999,20.430347825275373,35.01357587899484,0.055110522027787434,21.86675524711609,10.377081871032715,15.102298736572266,529,126,403,403,0,11,173000.0
173,173999,20.424489603705677,35.00365598595276,0.05505575006203001,21.98989701271057,10.437751054763794,15.265090942382812,529,126,403,403,0,11,174000.0
174,174999,20.42299741499797,35.00049833243063,0.05513161047302917,22.10873508453369,10.49780559539795,15.302726745605469,531,127,404,404,0,11,175000.0
175,175999,20.42148741384439,34.99745880016132,0.055537679635419446,22.24457359313965,10.562527894973755,15.34560775756836,535,129,406,406,0,11,176000.0
176,176999,20.42208774120443,34.999400340055004,0.055663879108452274,22.371219396591187,10.62732982635498,15.432518005371094,537,130,407,407,0,11,177000.0
177,177999,20.416408660905798,34.98367185414185,0.05561903709243465,22.51085901260376,10.689377784729004,15.496044158935547,539,131,408,408,0,11,178000.0
178,178999,20.395040555943453,34.94141580062647,0.05563146734971969,22.636473655700684,10.750810146331787,15.625003814697266,539,131,408,408,0,11,179000.0
179,179999,20.354454292718202,34.90549867665187,0.0559502755086656,22.757121562957764,10.819913387298584,16.602951049804688,564,131,433,433,0,11,180000.0
180,180999,20.306913690531353,34.83816041534104,0.05636911016050883,22.86604356765747,10.88234543800354,16.92913055419922,564,131,433,433,0,11,181000.0
181,181999,20.250285039849654,34.76066925015075,0.05695225845611129,22.981608152389526,10.942824840545654,17.078704833984375,568,133,435,435,0,11,182000.0
182,182999,20.202516492853622,34.69524474744002,0.057333350087646284,23.111709356307983,11.005959749221802,17.108203887939453,576,137,439,439,0,11,183000.0
183,183999,20.160042425915126,34.64183796467864,0.05761172429980754,23.22343397140503,11.06740140914917,17.32396697998047,578,138,440,440,0,11,184000.0
184,184999,20.11302714050691,34.57242747014005,0.05802075639563442,23.359524726867676,11.128913402557373,17.360755920410156,586,142,444,444,0,11,185000.0
185,185999,20.0696383126157,34.503593535421636,0.058462057921435995,23.494712829589844,11.196213960647583,17.483963012695312,592,145,447,447,0,11,186000.0
186,186999,20.021092180213856,34.43199028141743,0.05898580461987257,23.608461380004883,11.257124423980713,17.731468200683594,592,145,447,447,0,11,187000.0
187,187999,19.975446347592893,34.36607181258415,0.05939102841547794,23.72678565979004,11.318660259246826,17.903057098388672,592,145,447,447,0,11,188000.0
188,188999,19.937692883524026,34.31316988032003,0.05966483262266231,23.858999967575073,11.385581254959106,17.967880249023438,594,146,448,448,0,11,189000.0
189,189999,19.8972429707356,34.276093546176064,0.059820375577973706,23.976380109786987,11.446733713150024,18.132736206054688,594,146,448,448,0,11,190000.0
190,190999,19.854417033127127,34.212840971848905,0.05999472200823197,24.113370895385742,11.510047435760498,18.220844268798828,594,146,448,448,0,11,191000.0
191,191999,19.82026080592106,34.177222415287524,0.06006383188136344,24.23203134536743,11.573590993881226,18.289077758789062,594,146,448,448,0,11,192000.0
192,192999,19.78807613524619,34.13451505636874,0.060123828814281244,24.353761672973633,11.634719610214233,18.389015197753906,594,146,448,448,0,11,193000.0
193,193999,19.763821502083527,34.098116952710996,0.06009535193542537,24.486019134521484,11.696820735931396,18.447158813476562,594,146,448,448,0,11,194000.0
194,194999,19.74008779505139,34.06034115093286,0.06003324237287655,24.615039110183716,11.75838589668274,18.49591064453125,594,146,448,448,0,11,195000.0
195,195999,19.732238375291452,34.04767445624357,0.05971457056815899,24.744210720062256,11.819765567779541,18.547637939453125,607,147,460,460,0,11,196000.0
196,196999,19.718520908041615,34.02177964650255,0.059490898383786295,24.86746907234192,11.879219055175781,18.573097229003906,609,148,461,461,0,11,197000.0
197,197999,19.707153955786946,34.00250172434452,0.059270493442389216,24.994903326034546,11.939283609390259,18.66910171508789,609,148,461,461,0,11,198000.0
198,198999,19.685946790603932,33.9685690872432,0.0593205782268188,25.118762254714966,11.999927520751953,18.736278533935547,609,148,461,461,0,11,199000.0
199,199999,19.65872726582716,33.924907109414285,0.05970417422850394,25.23550796508789,12.060706615447998,19.65435028076172,641,149,492,492,0,11,200000.0
200,200999,19.62489884535009,33.89282597905322,0.05989337146636087,25.342365026474,12.123332262039185,20.023059844970703,641,149,492,492,0,11,201000.0
201,201999,19.584549561113942,33.84117754644436,0.06030680790345799,25.4558367729187,12.182966947555542,20.21271514892578,643,150,493,493,0,11,202000.0
202,202999,19.556114962142868,33.8149024946292,0.06049740843340157,25.589659214019775,12.246290922164917,20.283676147460938,651,154,497,497,0,11,203000.0
203,203999,19.520631589622056,33.76079009018104,0.06093825567178146,25.71382975578308,12.311154127120972,20.439308166503906,657,157,500,500,0,11,204000.0
204,204999,19.48908217537453,33.71393749263841,0.06157938695855325,25.8507137298584,12.37426495552063,20.47049331665039,667,162,505,505,0,11,205000.0
205,205999,19.461717204286284,33.67030253989407,0.061959600759525446,25.975078582763672,12.435773849487305,20.671401977539062,671,164,507,507,0,11,206000.0
206,206999,19.432538838923527,33.62659569778257,0.06262700157287338,26.092552185058594,12.605904817581177,20.920127868652344,671,164,507,507,0,11,207000.0
207,207999,19.41232969214529,33.60667311113348,0.06332995057140633,26.221161127090454,12.666417121887207,21.047779083251953,673,165,508,508,0,11,208000.0
208,208999,19.384677750393102,33.56112813139517,0.06376925947620493,26.337676763534546,12.72720980644226,21.172908782958984,675,166,509,509,0,11,209000.0
209,209999,19.367917673659623,33.53265981684326,0.0648301155215113,26.4597749710083,12.789119958877563,21.39352035522461,675,166,509,509,0,11,210000.0
210,210999,19.355129760448868,33.54983285062267,0.06499101576549848,26.581757068634033,12.850999355316162,21.511817932128906,677,167,510,510,0,11,211000.0
211,211999,19.339724707184658,33.520458228235654,0.06570207381250193,26.703056573867798,12.911901950836182,21.63922119140625,677,167,510,510,0,11,212000.0
212,212999,19.335520817286014,33.533245632598195,0.06554101540844193,26.83922004699707,12.973894357681274,21.754249572753906,677,167,510,510,0,11,213000.0
213,213999,19.33430874681418,33.54936692775639,0.06550791171556403,26.95453405380249,13.035763263702393,21.850078582763672,677,167,510,510,0,11,214000.0
214,214999,19.350318841910976,33.59000233113348,0.06570032576023388,27.07198715209961,13.097442865371704,21.914779663085938,677,167,510,510,0,11,215000.0
215,215999,19.366527898143815,33.62608029630436,0.06566763444500767,27.207114219665527,13.159096956253052,21.93085479736328,679,168,511,511,0,11,216000.0
216,216999,19.383139154214476,33.66198870243641,0.06560389259189081,27.350592851638794,13.220919609069824,22.010574340820312,679,168,511,511,0,11,217000.0
217,217999,19.399229769730372,33.68824970926902,0.06568545310921636,27.471845865249634,13.284489870071411,22.011463165283203,692,170,522,522,0,11,218000.0
218,218999,19.424273823824603,33.73328801298541,0.06543126742734529,27.59853196144104,13.346286058425903,22.012996673583984,696,172,524,524,0,11,219000.0
219,219999,19.425505945121287,33.71937759758234,0.0649738684522313,27.74195170402527,13.408088207244873,22.518402099609375,720,174,546,546,0,11,220000.0
220,220999,19.404513426891537,33.6967367234692,0.06498940777510209,27.843481302261353,13.468872785568237,23.127376556396484,725,174,551,551,0,11,221000.0
221,221999,19.374648227583528,33.66077811707815,0.06516291023901111,27.948723077774048,13.529563903808594,23.41181182861328,727,175,552,552,0,11,222000.0
222,222999,19.347785394938846,33.61606964431186,0.06535199811998138,28.0740647315979,13.590281248092651,23.537860870361328,733,178,555,555,0,11,223000.0
223,223999,19.33020965256408,33.60118564103727,0.06540969959068854,28.196767807006836,13.651252508163452,23.672019958496094,752,182,570,570,0,11,224000.0
224,224999,19.314138137177967,33.57505235898377,0.06554051421203311,28.312347173690796,13.713058710098267,23.810077667236328,756,184,572,572,0,11,225000.0
225,225999,19.301030459226972,33.54499968110047,0.0656869350594117,28.444236040115356,13.773606777191162,23.906681060791016,762,187,575,575,0,11,226000.0
226,226999,19.28954422901462,33.530033939895596,0.06600203252408177,28.567760944366455,13.834969997406006,24.055152893066406,764,188,576,576,0,11,227000.0
227,227999,19.283670223950864,33.5188958198602,0.06623712411991678,28.685576677322388,13.896122932434082,24.246829986572266,764,188,576,576,0,11,228000.0
228,228999,19.285122375066607,33.532295983365216,0.0665194170947544,28.80193281173706,13.956727743148804,24.375682830810547,764,188,576,576,0,11,229000.0
229,229999,19.288397945953882,33.5460688760833,0.06682147350449852,28.9366717338562,14.019665479660034,24.39110565185547,768,190,578,578,0,11,230000.0
230,230999,19.301291125253336,33.582301298480324,0.06720367282817752,29.06273913383484,14.088963508605957,24.54180145263672,768,190,578,578,0,11,231000.0
231,231999,19.31592512800654,33.60253887383682,0.06782803364976486,29.188629865646362,14.148449420928955,24.589324951171875,772,192,580,580,0,11,232000.0
232,232999,19.339271119611222,33.66064260449253,0.0683089015734254,29.313167333602905,14.20915961265564,24.630451202392578,776,194,582,582,0,11,233000.0
233,233999,19.371339699362515,33.72740838009872,0.06988856711702529,29.447001457214355,14.27444052696228,24.726318359375,778,195,583,583,0,11,234000.0
234,234999,19.412502438140038,33.85610813979958,0.07063967674549465,29.574673175811768,14.336080074310303,24.779476165771484,782,197,585,585,0,11,235000.0
235,235999,19.454475984941386,33.9868115638021,0.07166564763798056,29.70272397994995,14.397372007369995,24.907203674316406,784,198,586,586,0,11,236000.0
236,236999,19.50649798672322,34.140268422219904,0.0728614958044389,29.830827713012695,14.45882797241211,25.022884368896484,784,198,586,586,0,11,237000.0
237,237999,19.541722398497356,34.19868107204751,0.07399276880006445,29.955132007598877,14.519753694534302,25.001750946044922,788,200,588,588,0,11,238000.0
238,238999,19.568956069065635,34.237357904117694,0.07546577116994557,30.08802628517151,14.584302425384521,25.078495025634766,790,201,589,589,0,11,239000.0
239,239999,19.577538532041324,34.257669393626045,0.07569361133351682,30.220287084579468,14.645668029785156,25.782318115234375,813,201,612,612,0,11,240000.0
240,240999,19.56529422678063,34.250769406316934,0.07553341629038546,30.326390981674194,14.709630250930786,26.349346160888672,816,201,615,615,0,11,241000.0
241,241999,19.551722996936398,34.22191483944639,0.0756082627408694,30.42324161529541,14.767140865325928,26.636474609375,816,201,615,615,0,11,242000.0
242,242999,19.539927626855803,34.21400798810678,0.0755663951287715,30.55414867401123,14.830461740493774,26.78512954711914,823,204,619,619,0,11,243000.0
243,243999,19.52802507920604,34.19288813826771,0.07558610798856402,30.67922568321228,14.893974781036377,26.964855194091797,827,206,621,621,0,11,244000.0
244,244999,19.5154717777498,34.165974207998836,0.07557001286273624,30.80487561225891,14.95776915550232,27.102764129638672,829,207,622,622,0,11,245000.0
245,245999,19.502742267427106,34.13962528598786,0.0756104558215186,30.944955348968506,15.023035764694214,27.112648010253906,837,211,626,626,0,11,246000.0
246,246999,19.49280014376304,34.129857628478774,0.07555510465512139,31.06090235710144,15.215074062347412,27.30963134765625,837,211,626,626,0,11,247000.0
247,247999,19.485491412029123,34.111921978896696,0.07552943660770017,31.179299354553223,15.275248050689697,27.386348724365234,839,212,627,627,0,11,248000.0
248,248999,19.481306676917733,34.10029776662938,0.0753860729322069,31.306137561798096,15.33930492401123,27.45010757446289,843,214,629,629,0,11,249000.0
249,249999,19.474608167364057,34.08385250826743,0.07529779028761541,31.45595073699951,15.400939226150513,27.445220947265625,849,217,632,632,0,11,250000.0
250,250999,19.470261308022355,34.069891739892334,0.0754029320154882,31.568146467208862,15.46195650100708,27.59593963623047,851,218,633,633,0,11,251000.0
251,251999,19.46472703629447,34.05263706384338,0.07549038230445504,31.699819087982178,15.525625467300415,27.73824691772461,851,218,633,633,0,11,252000.0
252,252999,19.4645328850083,34.03740200685903,0.0755844558732367,31.829550981521606,15.587164878845215,27.828838348388672,853,219,634,634,0,11,253000.0
253,253999,19.460007310758126,34.016990015507666,0.07569624192152102,31.946133852005005,15.649385213851929,27.96471405029297,853,219,634,634,0,11,254000.0
254,254999,19.456252070976,34.002613372482045,0.07579710967127995,32.07710242271423,15.710903406143188,28.052104949951172,857,221,636,636,0,11,255000.0
255,255999,19.44862653769712,33.97749255024812,0.0756456651322921,32.19775032997131,15.77545976638794,28.864521026611328,881,221,660,660,0,11,256000.0
256,256999,19.44187901059712,33.979008523388714,0.075423507581596,32.29908347129822,15.834486246109009,29.371753692626953,883,221,662,662,0,11,257000.0
257,257999,19.43944294192601,33.97693079442521,0.07536053747208138,32.40665888786316,15.89311170578003,29.541397094726562,887,223,664,664,0,11,258000.0
258,258999,19.438163930502892,33.96563395147333,0.07544493942274966,32.529359102249146,15.952679872512817,29.711956024169922,896,227,669,669,0,11,259000.0
259,259999,19.43556426139429,33.95073504985943,0.07557862847597452,32.65201544761658,16.01746940612793,29.91832733154297,900,229,671,671,0,11,260000.0
260,260999,19.44559640576941,33.98986327750575,0.07553794640332534,32.776238441467285,16.076704502105713,30.05392074584961,904,231,673,673,0,11,261000.0
261,261999,19.45330392084923,34.00990660446093,0.07555649451760815,32.89346528053284,16.137040853500366,30.207603454589844,906,232,674,674,0,11,262000.0
262,262999,19.46422430472224,34.0237368365756,0.07550230018346193,33.014787912368774,16.197511672973633,30.393375396728516,906,232,674,674,0,11,263000.0
263,263999,19.480420397586286,34.044096535114676,0.07552149293946409,33.125694274902344,16.258556127548218,30.54473876953125,906,232,674,674,0,11,264000.0
264,264999,19.505001940249343,34.07716588609377,0.0755404393979684,33.25785827636719,16.32252526283264,30.510173797607422,910,234,676,676,0,11,265000.0
265,265999,19.53074290013661,34.146151802215115,0.0755481914824998,33.3888258934021,16.384284019470215,30.568218231201172,914,236,678,678,0,11,266000.0
266,266999,19.55112977400728,34.17054895590382,0.07567699258202254,33.515368938446045,16.445299863815308,30.621543884277344,918,238,680,680,0,11,267000.0
267,267999,19.571677494745682,34.189300897005786,0.07590175192733917,33.647714614868164,16.50881004333496,30.733238220214844,922,240,682,682,0,11,268000.0
268,268999,19.59391389888144,34.21357867032904,0.0762656749323758,33.761773109436035,16.570115327835083,30.856670379638672,922,240,682,682,0,11,269000.0
269,269999,19.61516240729836,34.23355914781591,0.0767096825364264,33.908464670181274,16.632625818252563,30.879737854003906,926,242,684,684,0,11,270000.0
270,270999,19.65671931839102,34.311464834332206,0.07728691731601811,34.029826641082764,16.694717407226562,31.019573211669922,926,242,684,684,0,11,271000.0
271,271999,19.674825525509284,34.321873382658765,0.07789150473587636,34.16179633140564,16.75638699531555,31.07595443725586,928,243,685,685,0,11,272000.0
272,272999,19.692875287581163,34.32624142311029,0.0784436395541307,34.27428364753723,16.81759524345398,31.202064514160156,928,243,685,685,0,11,273000.0
273,273999,19.716915345092403,34.39444654038059,0.0774167908285367,34.38743567466736,16.88257884979248,32.16581726074219,954,243,711,711,0,11,274000.0
274,274999,19.73601315869286,34.44936076840089,0.07749414981593528,34.49336218833923,16.945128917694092,32.52925109863281,954,243,711,711,0,11,275000.0
275,275999,19.750545195764296,34.521481469765504,0.0773849916905055,34.59664249420166,17.006591081619263,32.747920989990234,954,243,711,711,0,11,276000.0
276,276999,19.76567224354257,34.54201353395482,0.07756387985698754,34.73906326293945,17.068181037902832,32.79078674316406,967,249,718,718,0,11,277000.0
277,277999,19.784973961348104,34.56825874460447,0.07758089920844291,34.85880136489868,17.12966799736023,33.02739334106445,971,251,720,720,0,11,278000.0
278,278999,19.809662433332377,34.609055916658995,0.07802725828701029,34.989023208618164,17.191641569137573,33.11591720581055,977,254,723,723,0,11,279000.0
279,279999,19.826853282623986,34.626684506976915,0.07890650777286345,35.10598421096802,17.25246834754944,33.272727966308594,979,255,724,724,0,11,280000.0
280,280999,19.85328714420838,34.65891148579234,0.07951641728408809,35.23280358314514,17.315205335617065,33.48201370239258,979,255,724,724,0,11,281000.0
281,281999,19.885698071997822,34.7270586001229,0.08037227504828093,35.346848011016846,17.37634539604187,33.584510803222656,981,256,725,725,0,11,282000.0
282,282999,19.9197041301762,34.79951558161622,0.08123124460550668,35.46609926223755,17.43955373764038,33.700443267822266,981,256,725,725,0,11,283000.0
283,283999,19.959270371646713,34.863916844693776,0.08273360361199067,35.60543370246887,17.503477811813354,33.75031661987305,983,257,726,726,0,11,284000.0
284,284999,20.00105196786625,34.93174790479184,0.08414548474155448,35.72238731384277,17.563193798065186,33.837120056152344,985,258,727,727,0,11,285000.0
285,285999,20.037037822045423,34.97019751734853,0.08571153044244262,35.851717948913574,17.625330686569214,33.846580505371094,987,259,728,728,0,11,286000.0
286,286999,20.08747813458094,35.0589184612392,0.08738914398673692,35.97492289543152,17.687114238739014,33.861061096191406,991,261,730,730,0,11,287000.0
287,287999,20.126847657648877,35.110286954950844,0.08935341456216594,36.10174798965454,17.74826145172119,33.960723876953125,993,262,731,731,0,11,288000.0
288,288999,20.17414079092695,35.20273523136891,0.09181554647157941,36.23546528816223,17.810686111450195,34.101051330566406,993,262,731,731,0,11,289000.0
289,289999,20.229630671062004,35.29106935507305,0.09477252192040653,36.51659274101257,17.8723783493042,34.18791580200195,993,262,731,731,0,11,290000.0
290,290999,20.285128679110358,35.38110762185531,0.0970467730037835,36.63063192367554,17.933465003967285,34.19834899902344,995,263,732,732,0,11,291000.0
291,291999,20.332172227489227,35.441623534538785,0.09975204597213061,36.75456762313843,17.994911432266235,34.30331039428711,995,263,732,732,0,11,292000.0
292,292999,20.361041264938724,35.471670807310744,0.10124792992382092,36.89527463912964,18.05714249610901,34.74558639526367,1015,264,751,751,0,11,293000.0
293,293999,20.378699707689833,35.513528572202546,0.10012395521993933,37.00104069709778,18.119719743728638,35.43395233154297,1023,264,759,759,0,11,294000.0
294,294999,20.37772643489736,35.518765289532205,0.09972368517919394,37.10992789268494,18.180139780044556,35.73088836669922,1025,265,760,760,0,11,295000.0
295,295999,20.37602498643545,35.51567910664001,0.09949126259371288,37.24072027206421,18.241800785064697,35.787330627441406,1033,269,764,764,0,11,296000.0
296,296999,20.37692861796008,35.508743637171364,0.09936731427601164,37.356024980545044,18.303908109664917,35.996585845947266,1038,271,767,767,0,11,297000.0
297,297999,20.37793752608839,35.49697592357809,0.09933583705873983,37.473228216171265,18.36475419998169,36.221920013427734,1040,272,768,768,0,11,298000.0
298,298999,20.380319880449456,35.491827282082205,0.09921201531349189,37.61557602882385,18.426889896392822,36.139347076416016,1059,276,783,783,0,11,299000.0
299,299999,20.383269255751884,35.48501574856849,0.0988064284295308,37.73751258850098,18.488247871398926,36.38249969482422,1059,276,783,783,0,11,300000.0
300,300999,20.386925224262367,35.47638977310464,0.09816891623200652,37.866941690444946,18.55141282081604,36.52840042114258,1059,276,783,783,0,11,301000.0
301,301999,20.38970719129387,35.46922865008987,0.0979115318233994,37.99066424369812,18.612584829330444,36.6502571105957,1059,276,783,783,0,11,302000.0
302,302999,20.39174501813235,35.45719715292423,0.09763608379913757,38.10857892036438,18.673353672027588,36.77273941040039,1059,276,783,783,0,11,303000.0
303,303999,20.39370238002696,35.44374015066968,0.09730553419795307,38.23149061203003,18.734824895858765,36.8210563659668,1061,277,784,784,0,11,304000.0
304,304999,20.39811146456444,35.43902331069208,0.09712959917792097,38.36137509346008,18.79837131500244,36.82532501220703,1063,278,785,785,0,11,305000.0
305,305999,20.400957973279315,35.4308360031314,0.09700806017360386,38.489362478256226,18.85983681678772,36.943572998046875,1063,278,785,785,0,11,306000.0
306,306999,20.403584928307602,35.4178241774298,0.09705002492001269,38.6176073551178,18.921456575393677,36.92403793334961,1067,280,787,787,0,11,307000.0
307,307999,20.409987006629503,35.4141712106727,0.09716750274975106,38.75737237930298,18.983972311019897,36.97846603393555,1069,281,788,788,0,11,308000.0
308,308999,20.42384691700546,35.4453260134068,0.09747345044721822,38.887816190719604,19.04541325569153,37.04755783081055,1071,282,789,789,0,11,309000.0
309,309999,20.44089198381146,35.500640438260476,0.09768784973207423,39.004756689071655,19.104862689971924,37.1419677734375,1071,282,789,789,0,11,310000.0
310,310999,20.44637503778312,35.51527539696021,0.09787529764606417,39.13779067993164,19.16554546356201,37.186317443847656,1075,284,791,791,0,11,311000.0
311,311999,20.450975048640668,35.537435967961436,0.09811446461749562,39.26565885543823,19.227434396743774,37.24740219116211,1079,286,793,793,0,11,312000.0
312,312999,20.44868043382895,35.58069933296302,0.09759216843477958,39.382309436798096,19.292176008224487,38.2934684753418,1106,286,820,820,0,11,313000.0
313,313999,20.44274118672432,35.58778360599891,0.09739570662116714,39.4881432056427,19.352781534194946,38.61866760253906,1108,287,821,821,0,11,314000.0
314,314999,20.450783040662376,35.621678684106115,0.0975602179779812,39.61029934883118,19.41338038444519,38.774505615234375,1114,290,824,824,0,11,315000.0
315,315999,20.44967754046923,35.637400269558796,0.09802516815605744,39.73211932182312,19.47355055809021,38.98634338378906,1121,293,828,828,0,11,316000.0
316,316999,20.448644440702292,35.63919045500173,0.09904656367974451,39.8535475730896,19.533832788467407,39.1849365234375,1125,295,830,830,0,11,317000.0
317,317999,20.446195394314657,35.635614881056455,0.09994497138728609,39.988409996032715,19.597569704055786,39.18750762939453,1133,299,834,834,0,11,318000.0
318,318999,20.44906052279206,35.645573954093756,0.10057606038444011,40.1179895401001,19.660884380340576,39.39094543457031,1135,300,835,835,0,11,319000.0
319,319999,20.450949813861303,35.65277618000831,0.10120917256354223,40.22232174873352,19.721781015396118,39.59672546386719,1135,300,835,835,0,11,320000.0
320,320999,20.457188591530787,35.6620920399312,0.1010738008134957,40.34494948387146,19.78591823577881,39.746925354003906,1135,300,835,835,0,11,321000.0
321,321999,20.45867352572719,35.655414303346305,0.10097417007798759,40.47715950012207,19.847436904907227,39.84363555908203,1137,301,836,836,0,11,322000.0
322,322999,20.465341470339247,35.65854895310112,0.10079839534971491,40.6145658493042,19.91152048110962,39.91545486450195,1143,304,839,839,0,11,323000.0
323,323999,20.469782377734855,35.69731633991304,0.10061781800575709,40.73587465286255,19.974191188812256,40.055904388427734,1143,304,839,839,0,11,324000.0
324,324999,20.467769603281138,35.68291416060548,0.10096808617496011,40.84920954704285,20.034286499023438,40.20089340209961,1143,304,839,839,0,11,325000.0
325,325999,20.46260962733652,35.66514373027674,0.10130634864883659,40.975239992141724,20.094672679901123,40.28517150878906,1143,304,839,839,0,11,326000.0
326,326999,20.466196961079905,35.66327636049963,0.1016161769474877,41.09660840034485,20.156070470809937,40.33988952636719,1145,305,840,840,0,11,327000.0
327,327999,20.466941680713052,35.65734526063242,0.10178289279539476,41.233213901519775,20.2207510471344,40.4160270690918,1147,306,841,841,0,11,328000.0
328,328999,20.465905559685915,35.646150391133354,0.10208493961776477,41.35891509056091,20.280658960342407,40.46342849731445,1149,307,842,842,0,11,329000.0
329,329999,20.453866213333367,35.617931611407556,0.10269980953145419,41.489506483078,20.344096899032593,40.537845611572266,1151,308,843,843,0,11,330000.0
330,330999,20.443528407842436,35.591975375425505,0.1029157574061117,41.62156438827515,20.405383586883545,40.59584426879883,1165,310,855,855,0,11,331000.0
331,331999,20.444505426255375,35.60623610278382,0.10248732584823539,41.732316732406616,20.467844247817993,41.6099967956543,1192,310,882,882,0,11,332000.0
332,332999,20.431423250327096,35.58423383047505,0.10240847293755106,41.836198806762695,20.526851415634155,41.92723846435547,1195,311,884,884,0,11,333000.0
333,333999,20.421293789275712,35.56515026410813,0.10236936550590447,41.957300424575806,20.586589097976685,42.08754348754883,1201,314,887,887,0,11,334000.0
334,334999,20.412404527808246,35.557319493804314,0.10232495999709224,42.08569002151489,20.650118350982666,42.23759460449219,1208,317,891,891,0,11,335000.0
335,335999,20.40588545885191,35.545969994915055,0.10222040692958412,42.19874596595764,20.71153450012207,42.480770111083984,1210,318,892,892,0,11,336000.0
336,336999,20.403846116628028,35.55150911738258,0.10225879159722628,42.32543706893921,20.772563457489014,42.64204406738281,1214,320,894,894,0,11,337000.0
337,337999,20.398720163881556,35.53558142846896,0.10236185848529,42.44990277290344,20.83434295654297,42.73719024658203,1218,322,896,896,0,11,338000.0
338,338999,20.39854126163592,35.52970868085438,0.10247946163943678,42.582693576812744,20.898125886917114,42.88773727416992,1220,323,897,897,0,11,339000.0
339,339999,20.3977230397324,35.51765143287983,0.10264310350948347,42.705392360687256,20.959790468215942,42.93754196166992,1224,325,899,899,0,11,340000.0
340,340999,20.40224455424659,35.51761878607289,0.10282429508609736,42.82557797431946,21.020941972732544,43.10310745239258,1224,325,899,899,0,11,341000.0
341,341999,20.40898445782435,35.521550333768324,0.10320412791608768,42.94215369224548,21.265615701675415,43.206787109375,1226,326,900,900,0,11,342000.0
342,342999,20.430467239147738,35.555994688548836,0.10367770437421298,43.07027983665466,21.330161333084106,43.30586624145508,1228,327,901,901,0,11,343000.0
343,343999,20.447745926273516,35.579668499800746,0.1040517948833325,43.20815134048462,21.394360065460205,43.39236068725586,1228,327,901,901,0,11,344000.0
344,344999,20.474854354710935,35.61885841947407,0.10460344301099755,43.3280930519104,21.455023765563965,43.517295837402344,1228,327,901,901,0,11,345000.0
345,345999,20.50127239711079,35.66123144279205,0.10514917352730035,43.45569682121277,21.5197331905365,43.563087463378906,1230,328,902,902,0,11,346000.0
346,346999,20.529828572618765,35.698050285164946,0.10580933016841121,43.58867025375366,21.58399486541748,43.54148483276367,1234,330,904,904,0,11,347000.0
347,347999,20.570682688337033,35.76769797980429,0.10687305853319173,43.71682691574097,21.64643907546997,43.66294479370117,1236,331,905,905,0,11,348000.0
348,348999,20.597575936515994,35.80022799269526,0.1076117600893951,43.8620388507843,21.71109366416931,43.70268249511719,1238,332,906,906,0,11,349000.0
349,349999,20.62951510684513,35.838132125294166,0.10858290443915108,44.005510330200195,21.776302576065063,43.73112869262695,1240,333,907,907,0,11,350000.0
350,350999,20.64784162514518,35.861991446928634,0.10906033713685892,44.128241777420044,21.84041714668274,43.786277770996094,1242,334,908,908,0,11,351000.0
351,351999,20.645423935077925,35.85465526786956,0.10878151121425972,44.238388538360596,21.905571460723877,44.76777267456055,1269,334,935,935,0,11,352000.0
352,352999,20.637244488331667,35.83820701038156,0.10864114582706175,44.34223747253418,21.964628219604492,45.14305877685547,1270,334,936,936,0,11,353000.0
353,353999,20.62709621586099,35.81881546260318,0.10850591811912802,44.47129225730896,22.031213760375977,45.29365158081055,1274,336,938,938,0,11,354000.0
354,354999,20.615413554266542,35.79362552760065,0.10848016787972203,44.612060546875,22.09554696083069,45.37453842163086,1285,341,944,944,0,11,355000.0
355,355999,20.61185556736488,35.784766746005154,0.10837687686826925,44.736980676651,22.15920877456665,45.606571197509766,1289,343,946,946,0,11,356000.0
356,356999,20.614235628071295,35.77830511939409,0.1082175143973878,44.87702751159668,22.223654747009277,45.708473205566406,1295,346,949,949,0,11,357000.0
357,357999,20.615024432167317,35.76751942045808,0.10810349682349185,45.0067412853241,22.288049697875977,45.88822555541992,1297,347,950,950,0,11,358000.0
358,358999,20.612985731175588,35.75376743997327,0.10801221402828942,45.12188243865967,22.349395036697388,46.104576110839844,1297,347,950,950,0,11,359000.0
359,359999,20.61274915632528,35.74258471399488,0.10795734595393525,45.25911998748779,22.413251161575317,46.18270492553711,1299,348,951,951,0,11,360000.0
360,360999,20.61534096207314,35.73765340518282,0.10788358498152584,45.37694334983826,22.476497650146484,46.31884765625,1299,348,951,951,0,11,361000.0
361,361999,20.61864869870287,35.73300212764548,0.10786281924786434,45.51230335235596,22.5410213470459,46.41244888305664,1301,349,952,952,0,11,362000.0
362,362999,20.619493369938862,35.723566157782834,0.10781459465356391,45.65328931808472,22.604893922805786,46.50758361816406,1303,350,953,953,0,11,363000.0
363,363999,20.62265151896959,35.71596155526047,0.10776618134698634,45.76680397987366,22.66860580444336,46.5861930847168,1303,350,953,953,0,11,364000.0
364,364999,20.625553053198733,35.70888085670113,0.1075765207840893,45.90778064727783,22.73236083984375,46.689727783203125,1303,350,953,953,0,11,365000.0
365,365999,20.631016310651386,35.70383076921367,0.10746082157796888,46.04574656486511,22.794071197509766,46.702728271484375,1305,351,954,954,0,11,366000.0
366,366999,20.63843957090145,35.702369411285375,0.10746459236543737,46.171427488327026,22.85653042793274,46.755210876464844,1307,352,955,955,0,11,367000.0
367,367999,20.644238832265884,35.701483793591535,0.1074019325067993,46.29823684692383,22.918163299560547,46.87177658081055,1307,352,955,955,0,11,368000.0
368,368999,20.65035471462994,35.69747546344932,0.1072781434291038,46.427868604660034,22.979719877243042,46.93770980834961,1307,352,955,955,0,11,369000.0
369,369999,20.653543255176956,35.68762924644165,0.10728439021092406,46.55354046821594,23.043628454208374,46.99894714355469,1307,352,955,955,0,11,370000.0
370,370999,20.659979861732083,35.679530014669545,0.10729710230528056,46.68629193305969,23.107885599136353,47.099056243896484,1307,352,955,955,0,11,371000.0
371,371999,20.658075163197097,35.67099667555663,0.10703328283308688,46.803263425827026,23.170250415802002,47.87065887451172,1331,352,979,979,0,11,372000.0
372,372999,20.647958736434923,35.67314439969171,0.10689730076721449,46.9022753238678,23.229334831237793,48.37294387817383,1335,352,983,983,0,11,373000.0
373,373999,20.63063760753362,35.648139772605475,0.10699265066939323,47.0109441280365,23.287155866622925,48.540611267089844,1339,354,985,985,0,11,374000.0
374,374999,20.612371506855755,35.61729459003209,0.1070631791622011,47.138343334198,23.345776796340942,48.684932708740234,1348,358,990,990,0,11,375000.0
375,375999,20.596356025342747,35.59230074566258,0.107077097570913,47.25228452682495,23.404990911483765,48.95708084106445,1350,359,991,991,0,11,376000.0
376,376999,20.581880950156105,35.57963935473762,0.10700768596770582,47.36893892288208,23.46794366836548,49.122982025146484,1352,360,992,992,0,11,377000.0
377,377999,20.568338798071508,35.56513228622121,0.10696673692974534,47.5103657245636,23.52956533432007,49.160606384277344,1358,363,995,995,0,11,378000.0
378,378999,20.551441607737157,35.534802122849015,0.10702885049379318,47.62311625480652,23.59345293045044,49.34426498413086,1358,363,995,995,0,11,379000.0
379,379999,20.53698516958122,35.50978270228326,0.10701288749915439,47.736006021499634,23.654426097869873,49.48542404174805,1358,363,995,995,0,11,380000.0
380,380999,20.528095898806825,35.50130391000383,0.10689832432253266,47.874656200408936,23.715542793273926,49.478599548339844,1362,365,997,997,0,11,381000.0
381,381999,20.51463841920884,35.47859481228891,0.10692736245380552,48.00209593772888,23.776187658309937,49.563758850097656,1366,367,999,999,0,11,382000.0
382,382999,20.506454492993008,35.4814020445577,0.1069167326190863,48.1280357837677,23.83864712715149,49.62347412109375,1368,368,1000,1000,0,11,383000.0
383,383999,20.495776655793435,35.46012981426337,0.1069506887846321,48.262195110321045,23.899232149124146,49.68730926513672,1372,370,1002,1002,0,11,384000.0
384,384999,20.48460428259567,35.43637259180665,0.10704771850311856,48.391449213027954,23.963939905166626,49.778385162353516,1374,371,1003,1003,0,11,385000.0
385,385999,20.472400520548366,35.41078839244274,0.10709046791016608,48.52531290054321,24.030909776687622,49.90546417236328,1376,372,1004,1004,0,11,386000.0
386,386999,20.458327848151683,35.386349251807594,0.10720656224002045,48.66266751289368,24.095865726470947,49.972084045410156,1378,373,1005,1005,0,11,387000.0
387,387999,20.442927798827505,35.35952431049931,0.10730354912755402,48.788368940353394,24.156018018722534,50.10067367553711,1378,373,1005,1005,0,11,388000.0
388,388999,20.445387023505685,35.398293822441865,0.10687702045363445,48.8978967666626,24.217381238937378,51.04720687866211,1404,373,1031,1031,0,11,389000.0
389,389999,20.44664056703993,35.40443435070332,0.10681928192230739,48.99748086929321,24.276585817337036,51.47208786010742,1406,373,1033,1033,0,11,390000.0
390,390999,20.446326443216165,35.39977811944189,0.10671458796625066,49.1274471282959,24.33599281311035,51.60566329956055,1414,377,1037,1037,0,11,391000.0
391,391999,20.45553649124373,35.41362475920766,0.10671770882750764,49.236796855926514,24.39612889289856,51.884944915771484,1417,378,1039,1039,0,11,392000.0
392,392999,20.470310483416547,35.44680506462509,0.10679067739535075,49.35199737548828,24.455401182174683,52.04372024536133,1421,380,1041,1041,0,11,393000.0
393,393999,20.493038402851212,35.49455293747257,0.10741279915159485,49.48304080963135,24.515803575515747,52.099239349365234,1427,383,1044,1044,0,11,394000.0
394,394999,20.521438062938753,35.55081385570723,0.10805252334492654,49.605573892593384,24.576916217803955,52.259849548339844,1431,385,1046,1046,0,11,395000.0
395,395999,20.550005340096188,35.60347845243042,0.10860533101956016,49.7242488861084,24.63769245147705,52.39680862426758,1433,386,1047,1047,0,11,396000.0
396,396999,20.58040965693115,35.65831687141931,0.10948035299789571,49.85210084915161,24.69907855987549,52.457454681396484,1442,388,1054,1054,0,11,397000.0
397,397999,20.6173156005585,35.732810320325235,0.110951468041249,49.97921323776245,24.76075792312622,52.59701156616211,1444,389,1055,1055,0,11,398000.0
398,398999,20.649322706714525,35.7874577721526,0.11207139892304097,50.117440938949585,24.823861837387085,52.69032669067383,1446,390,1056,1056,0,11,399000.0
399,399999,20.688270925540593,35.88763698461358,0.11254745846492065,50.23388409614563,24.88689875602722,52.800926208496094,1446,390,1056,1056,0,11,400000.0
400,400999,20.728049160723838,35.95992050434954,0.11301610484994762,50.34917449951172,24.94642949104309,52.88343811035156,1448,391,1057,1057,0,11,401000.0
401,401999,20.768319776387184,36.021917509001085,0.11424075414896118,50.48567461967468,25.008904695510864,52.93606948852539,1450,392,1058,1058,0,11,402000.0
402,402999,20.811128885814604,36.112096426747854,0.11508891057476334,50.60351300239563,25.068273067474365,53.01093673706055,1452,393,1059,1059,0,11,403000.0
403,403999,20.854073490346387,36.176941634053634,0.11649024332605717,50.745381593704224,25.132381677627563,53.01854705810547,1456,395,1061,1061,0,11,404000.0
404,404999,20.89758408004319,36.24922309421852,0.11786040766217476,50.872276306152344,25.193847179412842,53.07721710205078,1458,396,1062,1062,0,11,405000.0
405,405999,20.92966272715905,36.28653647031366,0.1188135729785692,51.003743410110474,25.473754167556763,53.194026947021484,1458,396,1062,1062,0,11,406000.0
406,406999,20.947982084396646,36.30383350201866,0.11911834617059303,51.16128993034363,25.54340434074402,53.82559585571289,1486,398,1088,1088,0,11,407000.0
407,407999,20.94979153072356,36.32157208364624,0.11859637995138228,51.2648491859436,25.604815244674683,54.36589050292969,1490,398,1092,1092,0,11,408000.0
408,408999,20.9515067404707,36.35039406502037,0.11835133358740602,51.38058876991272,25.6685528755188,54.65885925292969,1492,399,1093,1093,0,11,409000.0
409,409999,20.95276103987738,36.357844046692854,0.1181389105192715,51.51570677757263,25.731242656707764,54.80510711669922,1496,401,1095,1095,0,11,410000.0
410,410999,20.955448217096876,36.36389733858996,0.11796663665587936,51.634130001068115,25.79344892501831,54.9835090637207,1499,402,1097,1097,0,11,411000.0
411,411999,20.956172730152467,36.36301450615374,0.11778508570604396,51.7586190700531,25.854337692260742,55.11278533935547,1503,404,1099,1099,0,11,412000.0
412,412999,20.956689409915548,36.35612492677998,0.1177190116574015,51.90151500701904,25.918102264404297,55.14073181152344,1509,407,1102,1102,0,11,413000.0
413,413999,20.955035826284536,36.34380944279713,0.11770472910442542,52.03463077545166,25.98007297515869,55.30195617675781,1513,409,1104,1104,0,11,414000.0
414,414999,20.95785929824883,36.33356201669825,0.11756142655845947,52.1580753326416,26.042906284332275,55.417179107666016,1517,411,1106,1106,0,11,415000.0
415,415999,20.958079316557033,36.324721576347486,0.11755115821747453,52.292661905288696,26.10460329055786,55.493675231933594,1521,413,1108,1108,0,11,416000.0
416,416999,20.958410866801007,36.319940263197154,0.11741100057144227,52.42321467399597,26.166041135787964,55.59033966064453,1523,414,1109,1109,0,11,417000.0
417,417999,20.95779196788763,36.30739817213678,0.11735757142094028,52.538036584854126,26.229294300079346,55.765968322753906,1523,414,1109,1109,0,11,418000.0
418,418999,20.95770197108888,36.2934832243809,0.11723856014164546,52.69317269325256,26.301345109939575,55.85011291503906,1525,415,1110,1110,0,11,419000.0
419,419999,20.960160115383584,36.28646319350211,0.11714631217148652,52.819355726242065,26.363739728927612,55.94115447998047,1525,415,1110,1110,0,11,420000.0
420,420999,20.962880795173003,36.318693831674835,0.11680135371832734,52.9570107460022,26.428273677825928,55.98372268676758,1529,417,1112,1112,0,11,421000.0
421,421999,20.967809192286815,36.33812695184698,0.11653812852392431,53.086687326431274,26.492385864257812,56.094566345214844,1529,417,1112,1112,0,11,422000.0
422,422999,20.970693714555527,36.33109938794291,0.11647302218122613,53.223227977752686,26.55414366722107,56.13255310058594,1533,419,1114,1114,0,11,423000.0
423,423999,20.968647136830334,36.3143011506911,0.11641971992654243,53.34969472885132,26.61900544166565,56.24649429321289,1533,419,1114,1114,0,11,424000.0
424,424999,20.968785779243177,36.301869176616044,0.11634310983319829,53.48514747619629,26.68145751953125,56.32258605957031,1533,419,1114,1114,0,11,425000.0
425,425999,20.96834019937769,36.28865166001647,0.11626295317760693,53.611616373062134,26.743834495544434,56.42782974243164,1533,419,1114,1114,0,11,426000.0
426,426999,20.961724424636525,36.26566847811899,0.11616715165350777,53.750712156295776,26.806272745132446,56.425758361816406,1537,421,1116,1116,0,11,427000.0
427,427999,20.946155584754802,36.2433675191661,0.11614928685066661,53.85772943496704,26.87016463279724,57.441707611083984,1565,421,1144,1144,0,11,428000.0
428,428999,20.92609273546548,36.21480712895531,0.11627483189894483,53.96341109275818,26.930047750473022,57.74404525756836,1567,422,1145,1145,0,11,429000.0
429,429999,20.909582657799007,36.19322981304331,0.11631636026284753,54.081382513046265,26.989475965499878,57.92068862915039,1573,425,1148,1148,0,11,430000.0
430,430999,20.889714733786487,36.16514987588273,0.11642237349247841,54.21310758590698,27.05046844482422,58.04065704345703,1582,429,1153,1153,0,11,431000.0
431,431999,20.872503659159186,36.13724675996604,0.11648737168101264,54.33962416648865,27.1146821975708,58.283687591552734,1602,431,1171,1171,0,11,432000.0
432,432999,20.857388140308352,36.11958323730632,0.11645780546733797,54.466983795166016,27.17596459388733,58.38060760498047,1606,433,1173,1173,0,11,433000.0
433,433999,20.8381097183095,36.09015796931742,0.11655546963144015,54.60180902481079,27.23642063140869,58.47257995605469,1612,436,1176,1176,0,11,434000.0
434,434999,20.821601656175854,36.063198817275385,0.11662620771650156,54.70864677429199,27.296363830566406,58.673439025878906,1612,436,1176,1176,0,11,435000.0
435,435999,20.80451540474187,36.03554875636187,0.11671475002003817,54.830846071243286,27.35730767250061,58.78483963012695,1614,437,1177,1177,0,11,436000.0
436,436999,20.7872868426962,36.0086199407498,0.11682677288180576,54.96490788459778,27.418955087661743,58.88983917236328,1616,438,1178,1178,0,11,437000.0
437,437999,20.77063643848784,35.98360214430989,0.11689435931407821,55.091758251190186,27.48111629486084,59.055118560791016,1616,438,1178,1178,0,11,438000.0
438,438999,20.75598254601356,35.961588737361666,0.11692724746174332,55.21957612037659,27.545356273651123,59.136016845703125,1618,439,1179,1179,0,11,439000.0
439,439999,20.739339269852085,35.93486437711879,0.11703630312129143,55.34882068634033,27.60890531539917,59.17501449584961,1620,440,1180,1180,0,11,440000.0
440,440999,20.722565751535267,35.90639715553265,0.11717058714610151,55.47470021247864,27.67011570930481,59.33103561401367,1620,440,1180,1180,0,11,441000.0
441,441999,20.705728868609423,35.87623133977577,0.11730852081294318,55.5936496257782,27.732171535491943,59.406471252441406,1620,440,1180,1180,0,11,442000.0
442,442999,20.691671774853308,35.852439540996436,0.11738208507330006,55.73273038864136,27.792972803115845,59.51777648925781,1620,440,1180,1180,0,11,443000.0
443,443999,20.674811363566608,35.8240824992065,0.11750228142988284,55.879987955093384,27.8546040058136,59.50859069824219,1624,442,1182,1182,0,11,444000.0
444,444999,20.657690418207324,35.79596186383203,0.1176422787537088,56.002055406570435,27.916114807128906,59.55216979980469,1626,443,1183,1183,0,11,445000.0
445,445999,20.642619708807544,35.771617952297504,0.11776204139799273,56.11594271659851,27.977186918258667,59.657615661621094,1626,443,1183,1183,0,11,446000.0
446,446999,20.62540867401284,35.74392070445664,0.11790379702215192,56.26512861251831,28.038588523864746,60.11469268798828,1645,444,1201,1201,0,11,447000.0
447,447999,20.610464509155186,35.732107766679604,0.11783063712839636,56.377373695373535,28.10493755340576,60.862205505371094,1657,444,1213,1213,0,11,448000.0
448,448999,20.589721526303077,35.70174500158052,0.11801067433552115,56.48414921760559,28.165576934814453,61.16029357910156,1659,445,1214,1214,0,11,449000.0
449,449999,20.571131563465194,35.682894818545876,0.11808142651432874,56.60791277885437,28.225444555282593,61.333831787109375,1665,448,1217,1217,0,11,450000.0
450,450999,20.552801898670477,35.65837088542532,0.11822143307316191,56.73349952697754,28.286402940750122,61.46780776977539,1672,451,1221,1221,0,11,451000.0
451,451999,20.536336231465214,35.63158304883593,0.11834355927511653,56.85191488265991,28.348640203475952,61.70293045043945,1674,452,1222,1222,0,11,452000.0
452,452999,20.519400956907887,35.6089397464201,0.11843461905917074,56.985469579696655,28.4100661277771,61.74562454223633,1680,455,1225,1225,0,11,453000.0
453,453999,20.501368999213817,35.58284326053741,0.11855274250658265,57.12062120437622,28.47387456893921,61.90652847290039,1684,457,1227,1227,0,11,454000.0
454,454999,20.48533939624599,35.55812523552102,0.11866427263594548,57.24714636802673,28.538798332214355,62.06306076049805,1686,458,1228,1228,0,11,455000.0
455,455999,20.467390451921908,35.53303739320236,0.118805288084459,57.36798143386841,28.59838318824768,62.17176055908203,1688,459,1229,1229,0,11,456000.0
456,456999,20.44834995197417,35.50680366365994,0.11893742327664214,57.4807014465332,28.657756805419922,62.310508728027344,1688,459,1229,1229,0,11,457000.0
457,457999,20.43275697120757,35.49242030329288,0.11891847026774449,57.61713457107544,28.721471071243286,62.410945892333984,1707,460,1247,1247,0,11,458000.0
458,458999,20.414368297444742,35.46275060239718,0.11905211656790815,57.74533128738403,28.78256893157959,62.48790740966797,1709,461,1248,1248,0,11,459000.0
459,459999,20.39980850279605,35.442845783993825,0.11902043614133861,57.87286949157715,28.842146396636963,62.51101303100586,1711,462,1249,1249,0,11,460000.0
460,460999,20.385979940072716,35.41921704430256,0.11904964618397695,57.989540338516235,28.902187824249268,62.67525100708008,1711,462,1249,1249,0,11,461000.0
461,461999,20.37242701463943,35.394074651016524,0.11908401674258084,58.10468339920044,28.96537208557129,62.75074768066406,1711,462,1249,1249,0,11,462000.0
462,462999,20.35973966813069,35.37003180762381,0.11910227962611808,58.229060649871826,29.02517867088318,62.85136795043945,1711,462,1249,1249,0,11,463000.0
463,463999,20.348343734472266,35.349179260719026,0.11911697042241143,58.35619878768921,29.085294008255005,62.87958526611328,1713,463,1250,1250,0,11,464000.0
464,464999,20.336225542367675,35.32598228681666,0.11916443145396804,58.485830307006836,29.148070812225342,62.961639404296875,1713,463,1250,1250,0,11,465000.0
465,465999,20.326603839673734,35.30713685945055,0.11916360861688113,58.609947681427,29.208253622055054,63.00447463989258,1715,464,1251,1251,0,11,466000.0
466,466999,20.310614785249893,35.27982205008098,0.11924598863968727,58.73646807670593,29.2677800655365,63.12529754638672,1715,464,1251,1251,0,11,467000.0
467,467999,20.294249993913173,35.25441662656802,0.11927932133437036,58.840967655181885,29.32885217666626,64.17040252685547,1743,464,1279,1279,0,11,468000.0
468,468999,20.279804795854602,35.24405433099614,0.11924542459360143,58.947566509246826,29.388198137283325,64.5090446472168,1747,465,1282,1282,0,11,469000.0
469,469999,20.26681130701563,35.223072188557815,0.11924015974680668,59.0702760219574,29.44827127456665,64.71321487426758,1751,467,1284,1284,0,11,470000.0
470,470999,20.25355886809849,35.200205682038735,0.11929262527467399,59.196516036987305,29.507922410964966,64.81830215454102,1761,471,1290,1290,0,11,471000.0
471,471999,20.244599582757957,35.195305150676354,0.119168544847997,59.30200934410095,29.566808700561523,65.03202438354492,1763,472,1291,1291,0,11,472000.0
472,472999,20.23381665651022,35.175357540432,0.11916903324804917,59.452476978302,29.633955717086792,65.15874099731445,1769,475,1294,1294,0,11,473000.0
473,473999,20.22171367679193,35.15985088811826,0.11914034163161724,59.58097839355469,29.9428927898407,65.22068405151367,1773,477,1296,1296,0,11,474000.0
474,474999,20.21380795526048,35.16434667204586,0.11899444704696305,59.687779664993286,30.002435207366943,65.45575332641602,1773,477,1296,1296,0,11,475000.0
475,475999,20.20613851319577,35.155268373569925,0.11888756677545487,59.81133198738098,30.06199622154236,65.57262420654297,1775,478,1297,1297,0,11,476000.0
476,476999,20.198198591614723,35.14801842487321,0.11876412545063397,59.93248677253723,30.126248121261597,65.70151138305664,1775,478,1297,1297,0,11,477000.0
477,477999,20.1877448758535,35.12742273137378,0.11873621178048588,60.0733163356781,30.188382625579834,65.76269149780273,1779,480,1299,1299,0,11,478000.0
478,478999,20.179118591022394,35.11067669353376,0.11868192533560196,60.20640516281128,30.248537063598633,65.7646713256836,1783,482,1301,1301,0,11,479000.0
479,479999,20.171157996138703,35.093110384733535,0.11861837326376534,60.32631993293762,30.313223838806152,65.89318466186523,1783,482,1301,1301,0,11,480000.0
480,480999,20.161828743371725,35.072885387824705,0.11856964703802886,60.45988583564758,30.37316107749939,65.9931411743164,1785,483,1302,1302,0,11,481000.0
481,481999,20.15635539613963,35.061489728653555,0.1184481823475173,60.57320833206177,30.434533834457397,66.09529113769531,1785,483,1302,1302,0,11,482000.0
482,482999,20.151880097921264,35.04843358665388,0.11832940467123099,60.70818853378296,30.494029998779297,66.05235290527344,1791,486,1305,1305,0,11,483000.0
483,483999,20.14748255432849,35.03696423108814,0.11824744459035796,60.83232927322388,30.55368733406067,66.20330047607422,1791,486,1305,1305,0,11,484000.0
484,484999,20.142842480993544,35.024833879140104,0.11816580749140626,60.97067308425903,30.61482262611389,66.24109268188477,1793,487,1306,1306,0,11,485000.0
485,485999,20.138862593802074,35.01354114905647,0.11806802774245417,61.09848380088806,30.678337812423706,66.29955291748047,1795,488,1307,1307,0,11,486000.0
486,486999,20.134221146165178,35.0010449787169,0.11797051456994856,61.23344922065735,30.738689661026,66.32358932495117,1799,490,1309,1309,0,11,487000.0
487,487999,20.12246706776455,34.98331343293445,0.117922658167678,61.35408139228821,30.804804801940918,67.18760299682617,1826,490,1336,1336,0,11,488000.0
488,488999,20.113313386056134,34.981449344137914,0.11777825539835374,61.46731185913086,30.87303137779236,67.67481994628906,1829,490,1339,1339,0,11,489000.0
489,489999,20.10025210919426,34.97151226189809,0.11775647639181797,61.57361030578613,30.93165874481201,67.95734024047852,1831,491,1340,1340,0,11,490000.0
490,490999,20.086302748593663,34.948150882621235,0.11784534422053472,61.711581230163574,30.993171215057373,68.00127029418945,1841,496,1345,1345,0,11,491000.0
491,491999,20.078289999526895,34.94671171728724,0.11776742174285859,61.835954427719116,31.057208776474,68.24070739746094,1845,497,1348,1348,0,11,492000.0
492,492999,20.070343994702426,34.93241980651183,0.11776190987292723,61.95622277259827,31.118419647216797,68.37904357910156,1849,499,1350,1350,0,11,493000.0
493,493999,20.06253533987458,34.91841527899689,0.11772274170712183,62.09440875053406,31.18011999130249,68.54314041137695,1851,500,1351,1351,0,11,494000.0
494,494999,20.054575240452003,34.906211873005724,0.11767669002169479,62.20820140838623,31.240943431854248,68.73666763305664,1851,500,1351,1351,0,11,495000.0
495,495999,20.045643712637176,34.88674976078754,0.11764827108537745,62.3267285823822,31.30189085006714,68.77496719360352,1855,502,1353,1353,0,11,496000.0
496,496999,20.03927157013332,34.8759759090071,0.11754188448142622,62.45038318634033,31.36145281791687,68.88815689086914,1857,503,1354,1354,0,11,497000.0
497,497999,20.035200023282606,34.86738375320208,0.11743568533602777,62.58644962310791,31.423206329345703,68.94617080688477,1859,504,1355,1355,0,11,498000.0
498,498999,20.033569208453176,34.86052156300971,0.11731194266863376,62.724966526031494,31.48626971244812,68.94703674316406,1865,507,1358,1358,0,11,499000.0
499,499999,20.036238143321228,34.869485479749365,0.11713375451369246,62.853681325912476,31.548080444335938,69.0688705444336,1867,508,1359,1359,0,11,500000.0
500,500999,20.03587493965076,34.86524512762902,0.11700375244326588,62.97351884841919,31.61205244064331,69.18479537963867,1867,508,1359,1359,0,11,501000.0
501,501999,20.041007304348796,34.87558752352185,0.11684575119430218,63.10499548912048,31.676770210266113,69.27687072753906,1869,509,1360,1360,0,11,502000.0
502,502999,20.052721509435777,34.896013064231404,0.11685876492638914,63.23012590408325,31.73763871192932,69.31640243530273,1871,510,1361,1361,0,11,503000.0
503,503999,20.059445508663064,34.93283554833869,0.11671800309663949,63.3545298576355,31.80059289932251,69.4872817993164,1871,510,1361,1361,0,11,504000.0
504,504999,20.065528044634895,34.94052223803437,0.1166340466201995,63.48789739608765,31.862077236175537,69.50890731811523,1873,511,1362,1362,0,11,505000.0
505,505999,20.07240017412607,34.94961003785212,0.11675355422148159,63.61297798156738,31.922772645950317,69.61058044433594,1875,512,1363,1363,0,11,506000.0
506,506999,20.077988935272856,34.98608796912566,0.11648323757148005,63.75082039833069,31.986862897872925,69.67585754394531,1877,513,1364,1364,0,11,507000.0
507,507999,20.077001534176695,34.97982383254219,0.11671270897614394,63.8829607963562,32.04797101020813,69.76213455200195,1881,515,1366,1366,0,11,508000.0
508,508999,20.07354544533166,34.99240484296636,0.11643603831817784,63.989805698394775,32.11044454574585,70.81416320800781,1910,515,1395,1395,0,11,509000.0
509,509999,20.06610075811629,34.98323675308461,0.11653281125066761,64.08966374397278,32.170249700546265,71.20499038696289,1911,515,1396,1396,0,11,510000.0
510,510999,20.057051462089408,34.97497367328019,0.11661417427894138,64.21779751777649,32.23340678215027,71.39809036254883,1915,517,1398,1398,0,11,511000.0
511,511999,20.04766786145124,34.959994012140804,0.11677264498258677,64.34133815765381,32.29365801811218,71.61530685424805,1922,520,1402,1402,0,11,512000.0
512,512999,20.040711494471516,34.95491142707359,0.11693310551885361,64.47044038772583,32.354233503341675,71.7300796508789,1928,523,1405,1405,0,11,513000.0
513,513999,20.03064934592812,34.939572551789176,0.11713227020710748,64.60380935668945,32.41470384597778,71.8415641784668,1932,525,1407,1407,0,11,514000.0
514,514999,20.022123230738465,34.923459477262746,0.11729138396611427,64.72027516365051,32.47490310668945,72.0019302368164,1956,527,1429,1429,0,11,515000.0
515,515999,20.012630965660772,34.90661024195962,0.11729918491288005,64.85108947753906,32.53887438774109,72.07818603515625,1958,528,1430,1430,0,11,516000.0
516,516999,20.00539903789968,34.89289619809707,0.1174753387368731,64.96815848350525,32.599766969680786,72.27279663085938,1958,528,1430,1430,0,11,517000.0
517,517999,19.99773105198762,34.87836656708468,0.1175380020270832,65.11168336868286,32.663846492767334,72.36966323852539,1962,530,1432,1432,0,11,518000.0
518,518999,19.98875769505464,34.86331553439507,0.11773644579009901,65.24297547340393,32.72659397125244,72.40530014038086,1966,532,1434,1434,0,11,519000.0
519,519999,19.97886626995309,34.84451636473095,0.11785490833048518,65.37304091453552,32.788875341415405,72.47740936279297,1970,534,1436,1436,0,11,520000.0
520,520999,19.974721205043654,34.88840902250667,0.11751910455468861,65.48687601089478,32.84964919090271,72.66665267944336,1970,534,1436,1436,0,11,521000.0
521,521999,19.97067210390214,34.87657502543885,0.11761949583679221,65.61463618278503,32.91093158721924,72.76810455322266,1970,534,1436,1436,0,11,522000.0
522,522999,19.964564351483087,34.87756492273966,0.11753626714486942,65.73514413833618,32.973764181137085,72.90727996826172,1970,534,1436,1436,0,11,523000.0
523,523999,19.95417106676248,34.8587163148167,0.11764451794856212,65.88154339790344,33.03712725639343,72.95421981811523,1972,535,1437,1437,0,11,524000.0
524,524999,19.945611478493362,34.841080148530686,0.11763927704129218,65.99166059494019,33.09750318527222,73.09242630004883,1974,536,1438,1438,0,11,525000.0
525,525999,19.944087147216436,34.86838665768195,0.11711449884467351,66.10483407974243,33.1632559299469,74.18904113769531,2004,536,1468,1468,0,11,526000.0
526,526999,19.934987978637295,34.85130254566992,0.11714608959350226,66.20850539207458,33.22506332397461,74.55923461914062,2005,536,1469,1469,0,11,527000.0
527,527999,19.927956457864724,34.8385134086532,0.11716670003272833,66.34344625473022,33.285667181015015,74.6699447631836,2014,540,1474,1474,0,11,528000.0
528,528999,19.92017274023304,34.82575818655147,0.11713472127730407,66.45805025100708,33.347861528396606,74.92094802856445,2016,541,1475,1475,0,11,529000.0
529,529999,19.914767777452873,34.81515629083474,0.11713101526230263,66.59368681907654,33.41152906417847,75.00907897949219,2022,544,1478,1478,0,11,530000.0
530,530999,19.910877962346934,34.81674020947517,0.11697754709459685,66.71971035003662,33.47404456138611,75.21485137939453,2024,545,1479,1479,0,11,531000.0
531,531999,19.903625104399215,34.806837571884934,0.11694235309373202,66.84691786766052,33.53435754776001,75.39776229858398,2026,546,1480,1480,0,11,532000.0
532,532999,19.897434135161834,34.82981729542514,0.11667358951453066,66.9602198600769,33.59737420082092,75.55321884155273,2026,546,1480,1480,0,11,533000.0
533,533999,19.893319238326207,34.82862562985778,0.11647251979556739,67.09404563903809,33.65865206718445,75.6282844543457,2028,547,1481,1481,0,11,534000.0
534,534999,19.888799901639047,34.815263563895336,0.11638219524246851,67.21887540817261,33.719613790512085,75.6905288696289,2030,548,1482,1482,0,11,535000.0
535,535999,19.885743706882725,34.813035303909324,0.11626581154910831,67.33585524559021,33.78040623664856,75.79269409179688,2032,549,1483,1483,0,11,536000.0
536,536999,19.885442763128367,34.8170848659443,0.11608531199467553,67.47072625160217,33.841668128967285,75.84218215942383,2035,550,1485,1485,0,11,537000.0
537,537999,19.890461470166986,34.82592693826504,0.11590208966502047,67.61350989341736,33.904951095581055,75.89968490600586,2039,552,1487,1487,0,11,538000.0
538,538999,19.89590527076884,34.83256983242221,0.11575459031220858,67.73072791099548,33.965580463409424,76.01763153076172,2039,552,1487,1487,0,11,539000.0
539,539999,19.898139578494906,34.83402631735689,0.11562932231020495,67.85822248458862,34.02867341041565,76.09132385253906,2039,552,1487,1487,0,11,540000.0
540,540999,19.903882814556948,34.8596179709103,0.11538722427915993,68.00353956222534,34.092225790023804,76.08214569091797,2043,554,1489,1489,0,11,541000.0
541,541999,19.905963764697564,34.85570473192705,0.11527499449172962,68.1078245639801,34.15374708175659,76.1981430053711,2043,554,1489,1489,0,11,542000.0
542,542999,19.907648242845944,34.852942787897405,0.11520000380584028,68.25548052787781,34.214940547943115,76.17756271362305,2047,556,1491,1491,0,11,543000.0
543,543999,19.90434129457557,34.84181602842623,0.11509679361800684,68.38353157043457,34.27799916267395,76.2392349243164,2049,557,1492,1492,0,11,544000.0
544,544999,19.900799122923992,34.835391808355006,0.11491417123215353,68.49349761009216,34.34287643432617,77.18983459472656,2077,557,1520,1520,0,11,545000.0
545,545999,19.891551815153505,34.83372431054678,0.11475979145831927,68.59482884407043,34.40328621864319,77.62837982177734,2080,557,1523,1523,0,11,546000.0
546,546999,19.88145485745129,34.815701459749995,0.11474860140806686,68.71016144752502,34.46409034729004,77.84185409545898,2084,559,1525,1525,0,11,547000.0
547,547999,19.87339899585007,34.81241671447939,0.11461972911665674,68.84431457519531,34.52442240715027,77.96244049072266,2092,563,1529,1529,0,11,548000.0
548,548999,19.86498246582184,34.79668230850274,0.11457763565683532,68.96113419532776,34.58598256111145,78.2271728515625,2095,564,1531,1531,0,11,549000.0
549,549999,19.857713252934936,34.782953683525314,0.11451689875917825,69.0992591381073,34.64945673942566,78.31068420410156,2101,567,1534,1534,0,11,550000.0
550,550999,19.85180796420457,34.76791051399899,0.11450294389932825,69.23947596549988,34.71241736412048,78.40729522705078,2107,570,1537,1537,0,11,551000.0
551,551999,19.850322131803306,34.761158107803254,0.1144549884948326,69.35445618629456,34.77283072471619,78.63314437866211,2107,570,1537,1537,0,11,552000.0
552,552999,19.84563504210899,34.74847407949122,0.11440340189719411,69.47661113739014,34.83450198173523,78.71459197998047,2109,571,1538,1538,0,11,553000.0
553,553999,19.844303354481816,34.73907111959655,0.11433411870218468,69.89713859558105,34.896472454071045,78.88845443725586,2109,571,1538,1538,0,11,554000.0
554,554999,19.843403038264956,34.73420669095403,0.11424716004022772,70.02400207519531,34.95781636238098,79.00262832641602,2111,572,1539,1539,0,11,555000.0
555,555999,19.84139257438511,34.7254686323404,0.11422253202306065,70.15994453430176,35.02276873588562,79.04479217529297,2115,574,1541,1541,0,11,556000.0
556,556999,19.839090367495984,34.71655970444016,0.11416035828866888,70.2904691696167,35.0870623588562,79.12931823730469,2117,575,1542,1542,0,11,557000.0
557,557999,19.835279011098876,34.705100867650394,0.11417295238756009,70.42094397544861,35.14589238166809,79.20817947387695,2119,576,1543,1543,0,11,558000.0
558,558999,19.834194073877036,34.69866777633877,0.11415841071527633,70.54380965232849,35.20601773262024,79.30309677124023,2121,577,1544,1544,0,11,559000.0
559,559999,19.831661686682967,34.69013005717259,0.1141763793379662,70.67747807502747,35.26626467704773,79.22381973266602,2127,580,1547,1547,0,11,560000.0
560,560999,19.82845266392848,34.67952460894504,0.11430601366550597,70.80889892578125,35.32867741584778,79.3704719543457,2129,581,1548,1548,0,11,561000.0
561,561999,19.827868288126968,34.67519858242221,0.11444041411008099,70.95296597480774,35.390538692474365,79.43920135498047,2131,582,1549,1549,0,11,562000.0
562,562999,19.827649103426033,34.668831579949156,0.1144778370015963,71.07247400283813,35.45125770568848,79.53914642333984,2131,582,1549,1549,0,11,563000.0
563,563999,19.827129940429586,34.66279659806406,0.11451109425587891,71.19208025932312,35.51203203201294,79.64703369140625,2131,582,1549,1549,0,11,564000.0
564,564999,19.82298100774418,34.65631219332274,0.11422785407745961,71.33203148841858,35.57830595970154,80.28915786743164,2155,582,1573,1573,0,11,565000.0
565,565999,19.81422735078997,34.64647560848763,0.11401576844400574,71.44075918197632,35.64139127731323,80.87798309326172,2160,582,1578,1578,0,11,566000.0
566,566999,19.803472979130515,34.6303816933906,0.11403432308545325,71.55096888542175,35.70195436477661,81.21464920043945,2164,583,1581,1581,0,11,567000.0
567,567999,19.793384632840677,34.619704056433605,0.11402629017758936,71.6834146976471,35.76178312301636,81.34989166259766,2170,586,1584,1584,0,11,568000.0
568,568999,19.782034202640954,34.600554367865485,0.11403974095177427,71.80824613571167,35.822113275527954,81.48347473144531,2177,589,1588,1588,0,11,569000.0
569,569999,19.772779226891338,34.58465789166004,0.11407614387561038,71.93241953849792,35.88279676437378,81.66647720336914,2181,591,1590,1590,0,11,570000.0
570,570999,19.76097011601757,34.56440316836445,0.11413276281663765,72.071040391922,35.9457631111145,81.78092193603516,2185,593,1592,1592,0,11,571000.0
571,571999,19.751106964168834,34.54690590143882,0.11418147336285489,72.19054055213928,36.006868839263916,81.95370101928711,2187,594,1593,1593,0,11,572000.0
572,572999,19.739869375574834,34.52783054446879,0.11421810880220296,72.32685804367065,36.06743240356445,81.99317169189453,2191,596,1595,1595,0,11,573000.0
573,573999,19.731311534665643,34.511535949442994,0.11423306823556567,72.4437882900238,36.127822399139404,82.17768096923828,2191,596,1595,1595,0,11,574000.0
574,574999,19.7212001917081,34.49237506391798,0.11425173942936784,72.57631206512451,36.189098596572876,82.24479675292969,2195,598,1597,1597,0,11,575000.0
575,575999,19.71392273869895,34.5115887004405,0.11401675159157132,72.69775056838989,36.249231815338135,82.34490966796875,2197,599,1598,1598,0,11,576000.0
576,576999,19.7029118880836,34.491376555431444,0.1140452789415568,72.824636220932,36.310033082962036,82.4842758178711,2197,599,1598,1598,0,11,577000.0
577,577999,19.695237328818934,34.47551587882851,0.114041249981089,72.95271754264832,36.37050986289978,82.5028190612793,2201,601,1600,1600,0,11,578000.0
578,578999,19.686302099664168,34.4585266265914,0.1140275118022881,73.08504438400269,36.432727575302124,82.65592575073242,2201,601,1600,1600,0,11,579000.0
579,579999,19.6798508485542,34.44555083220813,0.11398442551578059,73.21080422401428,36.492687702178955,82.72330474853516,2203,602,1601,1601,0,11,580000.0
580,580999,19.67463029752579,34.452297351256995,0.11382939743772302,73.34048771858215,36.55359101295471,82.83671569824219,2203,602,1601,1601,0,11,581000.0
581,581999,19.665664412369466,34.43446833210147,0.11388670872010753,73.47345161437988,36.617615699768066,82.87897491455078,2205,603,1602,1602,0,11,582000.0
582,582999,19.658732786484908,34.41898890774935,0.11390532179624269,73.60441446304321,36.681164026260376,82.95602035522461,2205,603,1602,1602,0,11,583000.0
583,583999,19.648662750742552,34.401698569340155,0.11395846848832902,73.74009943008423,36.74311804771423,83.02691650390625,2209,605,1604,1604,0,11,584000.0
584,584999,19.642727638181707,34.404706806153214,0.11384230876529855,73.88655924797058,36.80911183357239,83.80301284790039,2245,606,1639,1639,0,11,585000.0
585,585999,19.630635216432548,34.383864461742505,0.11388103662108473,73.98657083511353,36.87002491950989,84.33637237548828,2249,606,1643,1643,0,11,586000.0
586,586999,19.621107202147446,34.380262144017046,0.11383056433575212,74.0945394039154,36.93033266067505,84.61791610717773,2251,607,1644,1644,0,11,587000.0
587,587999,19.612748908556313,34.367742765890796,0.11372122505713833,74.22706198692322,36.9923050403595,84.80551147460938,2257,610,1647,1647,0,11,588000.0
588,588999,19.60620793280808,34.35646205142934,0.1136470481459173,74.3559935092926,37.05618596076965,84.96541213989258,2264,613,1651,1651,0,11,589000.0
589,589999,19.599828807624636,34.34483199074888,0.1135998095614299,74.47263598442078,37.116028785705566,85.20043563842773,2266,614,1652,1652,0,11,590000.0
590,590999,19.5937451811277,34.33861683658628,0.11352440332561786,74.6281168460846,37.17882442474365,85.14064025878906,2276,619,1657,1657,0,11,591000.0
591,591999,19.587527490421927,34.32424527222423,0.11348388694211642,74.73917579650879,37.23837685585022,85.37886810302734,2278,620,1658,1658,0,11,592000.0
592,592999,19.582259950516136,34.31223302222239,0.11342486037889088,74.87436699867249,37.297693967819214,85.51078033447266,2280,621,1659,1659,0,11,593000.0
593,593999,19.575420772617115,34.29966192440406,0.11343067159894071,74.99015784263611,37.360793113708496,85.67902374267578,2280,621,1659,1659,0,11,594000.0
594,594999,19.57225950663619,34.29855902112737,0.11336768437135536,75.11488437652588,37.426315784454346,85.84478378295898,2282,622,1660,1660,0,11,595000.0
595,595999,19.56767810303086,34.29372778039331,0.11332393195524615,75.25271105766296,37.490729570388794,85.94828033447266,2284,623,1661,1661,0,11,596000.0
596,596999,19.563877161378585,34.28289486527048,0.11334785675382542,75.38346934318542,37.55469727516174,86.01478576660156,2286,624,1662,1662,0,11,597000.0
597,597999,19.559256716559986,34.27341589469146,0.11333406214672692,75.50512051582336,37.618852376937866,86.16154861450195,2286,624,1662,1662,0,11,598000.0
598,598999,19.554462621612995,34.26139061562665,0.1133727394893369,75.6411521434784,37.682926177978516,86.27103042602539,2286,624,1662,1662,0,11,599000.0
599,599999,19.553045919435924,34.2545727562584,0.11335503133901492,75.7719829082489,37.747318267822266,86.32767105102539,2288,625,1663,1663,0,11,600000.0
600,600999,19.54939384166755,34.24422964374046,0.11340668231311823,75.91142201423645,37.81166338920593,86.4461898803711,2288,625,1663,1663,0,11,601000.0
601,601999,19.54767990276534,34.23478789876274,0.1133736138342819,76.04116559028625,37.87595295906067,86.47163009643555,2290,626,1664,1664,0,11,602000.0
602,602999,19.543137382872818,34.2221447498857,0.11337748807142334,76.17209196090698,37.940242767333984,86.52750396728516,2290,626,1664,1664,0,11,603000.0
603,603999,19.538833799004745,34.21789474309706,0.11329492253661944,76.31186962127686,38.00401759147644,86.53925704956055,2294,628,1666,1666,0,11,604000.0
604,604999,19.537573520055645,34.20750905612181,0.11312381850554443,76.44172310829163,38.068150758743286,87.44226837158203,2296,628,1668,1668,0,11,605000.0
605,605999,19.545362352240932,34.20399842378336,0.11253880275388162,76.54613971710205,38.13117861747742,87.94327545166016,2300,628,1672,1672,0,11,606000.0
606,606999,19.551767359493784,34.1992954268854,0.11205852901186963,76.65370774269104,38.19345021247864,88.21783828735352,2300,628,1672,1672,0,11,607000.0
607,607999,19.55499926339067,34.19289050311541,0.11171186373675401,76.77767276763916,38.25547218322754,88.4218635559082,2300,628,1672,1672,0,11,608000.0
608,608999,19.55825748936078,34.18577003989437,0.11146042950729618,76.89716029167175,38.31791019439697,88.60269927978516,2300,628,1672,1672,0,11,609000.0
609,609999,19.56002145357731,34.17716202476034,0.11128330729170477,77.02888679504395,38.379672050476074,88.75212097167969,2300,628,1672,1672,0,11,610000.0
610,610999,19.561944218220162,34.17570240548074,0.11111293169057124,77.15171003341675,38.44214940071106,88.85004806518555,2300,628,1672,1672,0,11,611000.0
611,611999,19.561132668703895,34.165280143002384,0.11095458088572852,77.26131176948547,38.50407290458679,88.95569610595703,2300,628,1672,1672,0,11,612000.0
612,612999,19.562217074403897,34.16056179652024,0.11075829030578921,77.40113520622253,38.566665172576904,89.02933120727539,2300,628,1672,1672,0,11,613000.0
613,613999,19.562076241909804,34.151237380940195,0.11061790941641214,77.5265588760376,38.62968635559082,89.0997085571289,2300,628,1672,1672,0,11,614000.0
614,614999,19.56440604005609,34.148562957587345,0.11049042746792703,77.66212916374207,38.693649768829346,89.19353866577148,2300,628,1672,1672,0,11,615000.0
615,615999,19.56884378226285,34.14797673254237,0.11038714754695222,77.78102040290833,38.756786584854126,89.2553939819336,2300,628,1672,1672,0,11,616000.0
616,616999,19.577200330151218,34.155648288630694,0.11031330339045331,77.92666840553284,38.823365688323975,89.29329299926758,2300,628,1672,1672,0,11,617000.0
617,617999,19.592487818173133,34.203305093623065,0.11010609210496025,78.06678342819214,38.88930368423462,89.36410140991211,2300,628,1672,1672,0,11,618000.0
618,618999,19.605911246338767,34.222079813069016,0.11006766986158434,78.17733073234558,38.95202088356018,89.39628219604492,2300,628,1672,1672,0,11,619000.0
619,619999,19.62249754143945,34.24629519253118,0.1100998879453442,78.33154678344727,39.017051696777344,89.42948913574219,2300,628,1672,1672,0,11,620000.0
620,620999,19.637320281852123,34.262682171879405,0.11017946663127576,78.46453475952148,39.07878875732422,89.48625183105469,2300,628,1672,1672,0,11,621000.0
621,621999,19.647999544907027,34.270780292957475,0.11020500656331278,78.61293840408325,39.14181876182556,89.48971557617188,2301,629,1672,1672,0,11,622000.0
622,622999,19.661790742502856,34.28527315124864,0.11025221774110205,78.73407196998596,39.20549178123474,89.55040740966797,2301,629,1672,1672,0,11,623000.0
623,623999,19.670047016547496,34.28506796374082,0.11032756336976224,78.8720691204071,39.26464486122131,89.59664916992188,2301,629,1672,1672,0,11,624000.0
624,624999,19.669769868161897,34.277133376496835,0.11020975315882642,78.98486948013306,39.3254234790802,90.56204223632812,2304,629,1675,1675,0,11,625000.0
625,625999,19.667406079429156,34.26898721954625,0.11007059067450664,79.094646692276,39.388023853302,90.95077896118164,2307,629,1678,1678,0,11,626000.0
626,626999,19.666345760971147,34.26680258833116,0.10990322639405459,79.20319414138794,39.44794487953186,91.19766616821289,2307,629,1678,1678,0,11,627000.0
627,627999,19.66372650156677,34.25945421035595,0.10978310378676925,79.32136249542236,39.50682330131531,91.38882827758789,2307,629,1678,1678,0,11,628000.0
628,628999,19.663084160450207,34.259670385590105,0.10963424535112887,79.43934655189514,39.56694030761719,91.52619934082031,2309,630,1679,1679,0,11,629000.0
629,629999,19.660978929006603,34.25000929369513,0.10954916954871574,79.56834101676941,39.62737488746643,91.66646194458008,2316,631,1685,1685,0,11,630000.0
630,630999,19.658869830436597,34.2417747721922,0.10946926561148895,79.6908061504364,39.68672204017639,91.76028823852539,2316,631,1685,1685,0,11,631000.0
631,631999,19.659449995940523,34.26610558671519,0.10919924393769176,79.81117844581604,39.746497631073,91.87197494506836,2316,631,1685,1685,0,11,632000.0
632,632999,19.659570248752008,34.26135563399244,0.10907468772800633,79.92979335784912,39.807178020477295,91.94114685058594,2316,631,1685,1685,0,11,633000.0
633,633999,19.65967440186285,34.26108391002975,0.10892757893394278,80.0468635559082,39.86714553833008,92.00774765014648,2316,631,1685,1685,0,11,634000.0
634,634999,19.660924771600023,34.255616332424566,0.10883711510660166,80.17886233329773,39.92731738090515,92.08904647827148,2316,631,1685,1685,0,11,635000.0
635,635999,19.663678782519206,34.254145399379595,0.10872265035957929,80.30604362487793,39.986950635910034,92.14155197143555,2316,631,1685,1685,0,11,636000.0
636,636999,19.668807584670695,34.28005239201621,0.1084946471940309,80.42991852760315,40.04667067527771,92.17042541503906,2316,631,1685,1685,0,11,637000.0
637,637999,19.671670008760323,34.278234912706736,0.10836227174317536,80.56306576728821,40.10594367980957,92.23393249511719,2316,631,1685,1685,0,11,638000.0
638,638999,19.6784780599076,34.282223782212895,0.10823666093691764,80.66868495941162,40.16489791870117,92.2587776184082,2316,631,1685,1685,0,11,639000.0
639,639999,19.687481418604108,34.29335281947854,0.10809285225835874,80.79532623291016,40.22386288642883,92.28679656982422,2316,631,1685,1685,0,11,640000.0
640,640999,19.6946371794821,34.29981725057457,0.10796557140934837,80.92735958099365,40.2825653553009,92.34403228759766,2316,631,1685,1685,0,11,641000.0
641,641999,19.70109467746153,34.30268912983129,0.10783979561689983,81.06531620025635,40.34200477600098,92.37544250488281,2316,631,1685,1685,0,11,642000.0
642,642999,19.710818911271335,34.31139495967316,0.10772636950384418,81.1806013584137,40.402127504348755,92.39908599853516,2316,631,1685,1685,0,11,643000.0
643,643999,19.715855890358238,34.30959327574027,0.10765725548974237,81.30419659614563,40.462268352508545,92.45155715942383,2316,631,1685,1685,0,11,644000.0
644,644999,19.71698823920701,34.30440886560096,0.10752596664384273,81.43155550956726,40.522045850753784,93.13216018676758,2318,631,1687,1687,0,11,645000.0
645,645999,19.716673364078243,34.314841591910344,0.10728918938118848,81.5375611782074,40.58163595199585,93.56135177612305,2321,631,1690,1690,0,11,646000.0
646,646999,19.716345230927473,34.30973548396399,0.10718204938002684,81.64115762710571,40.64243268966675,93.78100204467773,2321,631,1690,1690,0,11,647000.0
647,647999,19.71484970921146,34.308384394812705,0.10705515290630685,81.76745414733887,40.701722860336304,93.97314071655273,2321,631,1690,1690,0,11,648000.0
648,648999,19.71301639618532,34.29826555786962,0.1069645118877971,81.89107155799866,40.76382660865784,94.13957595825195,2321,631,1690,1690,0,11,649000.0
649,649999,19.71230692755347,34.29133600144012,0.10687736227376676,82.02617716789246,40.826518058776855,94.25261688232422,2321,631,1690,1690,0,11,650000.0
650,650999,19.712356094140326,34.28491123767805,0.10678526405801692,82.1510808467865,40.88727116584778,94.36949157714844,2321,631,1690,1690,0,11,651000.0
651,651999,19.712137488689955,34.28309900191972,0.10663637765702805,82.27006149291992,40.95013427734375,94.45572280883789,2321,631,1690,1690,0,11,652000.0
652,652999,19.713124951069425,34.28967599392588,0.10646944094758115,82.40776038169861,41.01315903663635,94.51947402954102,2321,631,1690,1690,0,11,653000.0
653,653999,19.71777258626043,34.292311110510255,0.10632670044362935,82.53425478935242,41.075188875198364,94.59866714477539,2321,631,1690,1690,0,11,654000.0
654,654999,19.7225865327156,34.29655680928522,0.10615310126074262,82.65927481651306,41.13800406455994,94.64847946166992,2321,631,1690,1690,0,11,655000.0
655,655999,19.724926269077677,34.293595041536115,0.10603156452434381,82.78763437271118,41.19708299636841,94.67952346801758,2321,631,1690,1690,0,11,656000.0
656,656999,19.730927071265647,34.30013473821785,0.10586037793249536,82.9095287322998,41.25524973869324,94.74505615234375,2321,631,1690,1690,0,11,657000.0
657,657999,19.73985415516648,34.31540159529288,0.1056511907279355,83.03922533988953,41.31838250160217,94.77311706542969,2321,631,1690,1690,0,11,658000.0
658,658999,19.75095589731856,34.34769606486258,0.10535025110480356,83.17975354194641,41.37844944000244,94.82986450195312,2321,631,1690,1690,0,11,659000.0
659,659999,19.757452493546456,34.368649667032564,0.10512158767672852,83.29844760894775,41.440370321273804,94.87929916381836,2321,631,1690,1690,0,11,660000.0
660,660999,19.76104176196343,34.36736343408137,0.10500849891540154,83.42024207115173,41.50023174285889,94.94210815429688,2321,631,1690,1690,0,11,661000.0
661,661999,19.766869936274382,34.3811029027518,0.10427446565762888,83.55962061882019,41.56439995765686,95.67342758178711,2323,631,1692,1692,0,11,662000.0
662,662999,19.77568936357883,34.40053771029039,0.10349544318507076,83.67028188705444,41.6287055015564,96.05323028564453,2326,631,1695,1695,0,11,663000.0
663,663999,19.782070651029326,34.41453469052278,0.10274221305422826,83.79152822494507,41.68907809257507,96.25231552124023,2326,631,1695,1695,0,11,664000.0
664,664999,19.787083654636216,34.41680955289594,0.10230277920024988,83.89810276031494,41.74841380119324,96.44550323486328,2326,631,1695,1695,0,11,665000.0
665,665999,19.79102589227059,34.41475121455793,0.1018827549812954,84.018057346344,41.807859659194946,96.58604049682617,2326,631,1695,1695,0,11,666000.0
666,666999,19.795160332266526,34.414365181460354,0.10151835652833019,84.15085697174072,41.86735248565674,96.67512512207031,2326,631,1695,1695,0,11,667000.0
667,667999,19.7997258951572,34.41887857481968,0.10114190654262212,84.27389407157898,41.93172860145569,96.78824996948242,2326,631,1695,1695,0,11,668000.0
668,668999,19.803947612755156,34.41803905148965,0.10079846823426153,84.38235592842102,41.99048614501953,96.8665885925293,2326,631,1695,1695,0,11,669000.0
669,669999,19.80943836613643,34.428316966619505,0.10036778582664874,84.5195665359497,42.05281209945679,96.91737365722656,2326,631,1695,1695,0,11,670000.0
670,670999,19.8154747819985,34.45004860992223,0.09992874114222772,84.64468002319336,42.11316514015198,97.00019073486328,2326,631,1695,1695,0,11,671000.0
671,671999,19.818300672604785,34.447459847333356,0.09970423082490054,84.77516150474548,42.17641639709473,97.05803298950195,2326,631,1695,1695,0,11,672000.0
672,672999,19.822734427714128,34.44730396640606,0.09939113409760614,84.89735198020935,42.23699712753296,97.09006881713867,2326,631,1695,1695,0,11,673000.0
673,673999,19.82409156557694,34.44296239116472,0.09918588134753303,85.03711032867432,42.298064947128296,97.15035247802734,2326,631,1695,1695,0,11,674000.0
674,674999,19.829075355379295,34.46882175993424,0.09883928113061258,85.15533328056335,42.35902237892151,97.1778793334961,2326,631,1695,1695,0,11,675000.0
675,675999,19.834264728924577,34.47093593116902,0.09858547944768525,85.28601002693176,42.42014122009277,97.20881271362305,2326,631,1695,1695,0,11,676000.0
676,676999,19.838626057604035,34.46772773581748,0.09843008371151041,85.42084836959839,42.48739194869995,97.25894165039062,2326,631,1695,1695,0,11,677000.0
677,677999,19.845732831810224,34.48133898883881,0.0981548519695149,85.54496169090271,42.54821419715881,97.29008102416992,2326,631,1695,1695,0,11,678000.0
678,678999,19.847651230383523,34.476327364307664,0.09806877053394292,85.68290901184082,42.60949468612671,97.32254409790039,2326,631,1695,1695,0,11,679000.0
679,679999,19.850903807020426,34.472421188320965,0.09788716262048802,85.81061625480652,42.673054933547974,97.36054611206055,2326,631,1695,1695,0,11,680000.0
680,680999,19.855661423301758,34.47321141908158,0.09760597469699883,85.94413423538208,42.733609199523926,97.90771102905273,2327,631,1696,1696,0,11,681000.0
681,681999,19.86321708438563,34.48282595548743,0.09696509429672329,86.0837733745575,42.800293922424316,98.17251205444336,2332,632,1700,1700,0,11,682000.0
682,682999,19.87165858791777,34.48735886915312,0.09638440493793732,86.20472383499146,42.867592334747314,98.36888885498047,2332,632,1700,1700,0,11,683000.0
683,683999,19.88010131699126,34.49076047400711,0.09591533524866647,86.35139322280884,42.93381452560425,98.4977912902832,2332,632,1700,1700,0,11,684000.0
684,684999,19.889751417859134,34.497921590517684,0.09531819015392595,86.81914401054382,42.99537801742554,98.64946365356445,2332,632,1700,1700,0,11,685000.0
685,685999,19.89744157660956,34.499843330761216,0.09499146899675348,86.93849539756775,43.05708932876587,98.71343994140625,2334,633,1701,1701,0,11,686000.0
686,686999,19.90369921079675,34.49770990705906,0.09457886980359731,87.07056832313538,43.120532274246216,98.79981994628906,2334,633,1701,1701,0,11,687000.0
687,687999,19.91214125613132,34.50774230091661,0.09427193054164995,87.19597578048706,43.17979049682617,98.89834213256836,2334,633,1701,1701,0,11,688000.0
688,688999,19.921447325991657,34.5164579417516,0.0940092269399403,87.32128596305847,43.24249482154846,98.95629501342773,2334,633,1701,1701,0,11,689000.0
689,689999,19.927234493821555,34.51380789923846,0.0938008748811413,87.4532299041748,43.30544948577881,98.96527862548828,2336,634,1702,1702,0,11,690000.0
690,690999,19.936074160854826,34.51812245289912,0.09365592552809299,87.59706234931946,43.37011957168579,99.05531692504883,2336,634,1702,1702,0,11,691000.0
691,691999,19.941928577148083,34.51910034187901,0.09353431316051175,87.73218584060669,43.43491530418396,99.10614013671875,2336,634,1702,1702,0,11,692000.0
692,692999,19.948742714940963,34.51980109396823,0.09341420553109636,87.87768864631653,43.49932503700256,99.1421890258789,2336,634,1702,1702,0,11,693000.0
693,693999,19.955584081020977,34.52206721041651,0.09330096792400144,87.99798965454102,43.5609974861145,99.19524765014648,2336,634,1702,1702,0,11,694000.0
694,694999,19.962803156807233,34.525816288177474,0.09327279349120976,88.13460779190063,43.62979745864868,99.1885986328125,2338,635,1703,1703,0,11,695000.0
695,695999,19.973718941396136,34.53169709793453,0.09323972616101373,88.28662419319153,43.69437575340271,99.21708679199219,2338,635,1703,1703,0,11,696000.0
696,696999,19.982913571573896,34.53647069216451,0.09320379470192985,88.40930724143982,43.75403332710266,99.2779769897461,2338,635,1703,1703,0,11,697000.0
697,697999,19.989818171046085,34.53616743659773,0.09308424342829591,88.54289317131042,43.81598734855652,99.3080940246582,2338,635,1703,1703,0,11,698000.0
698,698999,19.99682440206153,34.53527824934217,0.09304218248628615,88.68104815483093,43.87756633758545,99.32757568359375,2338,635,1703,1703,0,11,699000.0
699,699999,20.002109985226795,34.532219212444986,0.09294436342565382,88.80545973777771,43.94172286987305,99.37221908569336,2338,635,1703,1703,0,11,700000.0
700,700999,20.005639404941537,34.5302516120307,0.09272789734937281,88.94188165664673,44.00659441947937,99.80572128295898,2338,635,1703,1703,0,11,701000.0
701,701999,20.000668010301183,34.52273039997904,0.09264930754192491,89.08209824562073,44.06642436981201,100.04388046264648,2340,636,1704,1704,0,11,702000.0
702,702999,19.99499168690039,34.51616280762382,0.09257965054707773,89.1978268623352,44.12988471984863,100.20911407470703,2340,636,1704,1704,0,11,703000.0
703,703999,19.989699628099117,34.51449755970999,0.09247983621901501,89.32753825187683,44.190109968185425,100.33705139160156,2340,636,1704,1704,0,11,704000.0
704,704999,19.992644816015236,34.560383600876506,0.09210025714356851,89.44533944129944,44.251115798950195,100.46498489379883,2340,636,1704,1704,0,11,705000.0
705,705999,19.997495468133174,34.57646717639466,0.09189751224118237,89.57600331306458,44.31466865539551,100.55039596557617,2340,636,1704,1704,0,11,706000.0
706,706999,20.008414872925155,34.61104147823949,0.09155399061767622,89.70328950881958,44.37552285194397,100.59992980957031,2340,636,1704,1704,0,11,707000.0
707,707999,20.021630942002457,34.65528448750191,0.09123754805779871,89.83565473556519,44.43610382080078,100.67262268066406,2340,636,1704,1704,0,11,708000.0
708,708999,20.03481118299532,34.695362357665644,0.09097014042622231,89.97064065933228,44.49762773513794,100.6370964050293,2342,637,1705,1705,0,11,709000.0
709,709999,20.047774029529986,34.74155814132438,0.09067730938978658,90.07869815826416,44.55787801742554,100.73341369628906,2342,637,1705,1705,0,11,710000.0
710,710999,20.06426639032328,34.793129304382106,0.09040893155706753,90.21232199668884,44.61933517456055,100.70368576049805,2344,638,1706,1706,0,11,711000.0
711,711999,20.07636926652668,34.82820767362538,0.09041790721434317,90.36347556114197,44.6836040019989,100.77964782714844,2344,638,1706,1706,0,11,712000.0
712,712999,20.089417732077113,34.85528350775971,0.09034368277709504,90.49904084205627,44.74784851074219,100.8250846862793,2344,638,1706,1706,0,11,713000.0
713,713999,20.101545199404878,34.883051822990204,0.0903005141236477,90.62120413780212,44.80698895454407,100.87210464477539,2375,639,1736,1736,0,11,714000.0
714,714999,20.11362687464218,34.90452862655734,0.09025161957120553,90.75413084030151,44.86779808998108,100.9107780456543,2375,639,1736,1736,0,11,715000.0
715,715999,20.127523506677615,34.93032483945847,0.0901577269700019,90.87153434753418,44.92885708808899,100.95952606201172,2375,639,1736,1736,0,11,716000.0
716,716999,20.142023502209298,34.95446474910396,0.09001500003295748,91.0017204284668,44.990047454833984,101.00845718383789,2375,639,1736,1736,0,11,717000.0
717,717999,20.15602901783981,34.97446676450834,0.08992353761093896,91.13765835762024,45.051026582717896,101.03203201293945,2375,639,1736,1736,0,11,718000.0
718,718999,20.168780743805645,34.989611018917515,0.08983918958522596,91.26767897605896,45.11281752586365,101.07654571533203,2375,639,1736,1736,0,11,719000.0
719,719999,20.17115118640456,34.98825904841277,0.08970042159197134,91.39411926269531,45.17311882972717,101.52988052368164,2375,639,1736,1736,0,11,720000.0
720,720999,20.171764600480696,34.998956386497994,0.089513453388681,91.52059197425842,45.234161376953125,101.75396347045898,2375,639,1736,1736,0,11,721000.0
721,721999,20.173971676656762,34.99758329669728,0.08929796951071756,91.63425469398499,45.29580593109131,101.89561462402344,2375,639,1736,1736,0,11,722000.0
722,722999,20.176299669541038,35.00113797347887,0.08908896053848492,91.7542998790741,45.35607290267944,102.0052719116211,2375,639,1736,1736,0,11,723000.0
723,723999,20.179217070179128,35.00239186389659,0.0888863224149452,91.8890368938446,45.417181730270386,102.11709594726562,2375,639,1736,1736,0,11,724000.0
724,724999,20.17981737083897,34.99904667457683,0.08877134778685292,92.01424503326416,45.477842807769775,102.19643020629883,2375,639,1736,1736,0,11,725000.0
725,725999,20.18260900683731,34.99695348703904,0.0885795030974339,92.14224815368652,45.53860354423523,102.23954010009766,2375,639,1736,1736,0,11,726000.0
726,726999,20.183507036201725,34.99148694878912,0.08846181413755572,92.27849650382996,45.59936308860779,102.26289749145508,2377,640,1737,1737,0,11,727000.0
727,727999,20.183596169119525,34.98556589780032,0.08831499199792203,92.3978168964386,45.659733057022095,102.3072395324707,2377,640,1737,1737,0,11,728000.0
728,728999,20.183654860443976,34.98193836342388,0.08821317641314663,92.52380108833313,45.72046208381653,102.30076217651367,2379,641,1738,1738,0,11,729000.0
729,729999,20.18319930482674,34.97731395660397,0.08809940076182587,92.65604400634766,45.781522035598755,102.3613395690918,2379,641,1738,1738,0,11,730000.0
730,730999,20.181291849297306,34.968873167549674,0.08800999898748463,92.7983980178833,45.84523844718933,102.39761734008789,2379,641,1738,1738,0,11,731000.0
731,731999,20.182768003747825,34.990539978264344,0.08779109381662109,92.92504954338074,45.90687847137451,102.36108016967773,2381,642,1739,1739,0,11,732000.0
732,732999,20.181303986810164,34.98434645990284,0.08769896759382356,93.06757593154907,45.967960357666016,102.41477966308594,2381,642,1739,1739,0,11,733000.0
733,733999,20.181934077771142,34.97775012129541,0.0875874260790257,93.18868255615234,46.029666900634766,102.45040893554688,2381,642,1739,1739,0,11,734000.0
734,734999,20.18125121441036,34.96909742627266,0.08748867616452372,93.31306958198547,46.091017723083496,102.48441314697266,2381,642,1739,1739,0,11,735000.0
735,735999,20.183702989964072,34.966773466507654,0.08738856175804599,93.45003581047058,46.15150332450867,102.52595138549805,2381,642,1739,1739,0,11,736000.0
736,736999,20.185005096463577,34.961817699800946,0.0872878418859172,93.57342386245728,46.21124982833862,102.54792022705078,2381,642,1739,1739,0,11,737000.0
737,737999,20.183788173188205,34.95381809758467,0.08724756274452905,93.71084547042847,46.27323293685913,102.57989120483398,2381,642,1739,1739,0,11,738000.0
738,738999,20.18223431291828,34.94533073060862,0.08717253440125539,93.82195687294006,46.332324504852295,102.61639022827148,2381,642,1739,1739,0,11,739000.0
739,739999,20.182324471775587,34.96946397339508,0.08695932302516496,93.94838118553162,46.39193630218506,102.94640350341797,2382,642,1740,1740,0,11,740000.0
740,740999,20.177743310493863,35.00053058615584,0.08677636330318406,94.06651663780212,46.45088481903076,103.1124153137207,2382,642,1740,1740,0,11,741000.0
741,741999,20.17156692684167,35.004760864062725,0.08677405824187445,94.20720505714417,46.51486349105835,103.21712112426758,2382,642,1740,1740,0,11,742000.0
742,742999,20.16774312217829,35.01451862345312,0.08672586741926325,94.32631015777588,46.57402753829956,103.28984451293945,2382,642,1740,1740,0,11,743000.0
743,743999,20.162250814209795,35.00894129418934,0.08672139448681604,94.4520492553711,46.63262438774109,103.37256240844727,2382,642,1740,1740,0,11,744000.0
744,744999,20.15465282852371,34.99660789251924,0.08671370466274675,94.58547353744507,46.6956889629364,103.4450569152832,2382,642,1740,1740,0,11,745000.0
745,745999,20.152568641721448,35.00366858369361,0.0865796954161705,94.70362448692322,46.75882077217102,103.50054550170898,2382,642,1740,1740,0,11,746000.0
746,746999,20.146926499345515,34.99408915649784,0.08655602743537427,94.84709072113037,46.822914600372314,103.5192642211914,2384,643,1741,1741,0,11,747000.0
747,747999,20.143418278755924,34.992068934289875,0.08657290240779514,94.9949221611023,46.88687086105347,103.39659118652344,2388,645,1743,1743,0,11,748000.0
748,748999,20.13763238312772,34.98568256737012,0.08654593814679246,95.10977816581726,46.95058345794678,103.46741485595703,2388,645,1743,1743,0,11,749000.0
749,749999,20.13530222125186,34.98447230769707,0.08655159038955917,95.2612521648407,47.014538049697876,103.54683303833008,2388,645,1743,1743,0,11,750000.0
750,750999,20.133648477100778,34.98561503488898,0.08655844569315396,95.40057849884033,47.07791590690613,103.61251449584961,2388,645,1743,1743,0,11,751000.0
751,751999,20.129122848750768,34.976230638390504,0.08653368180536747,95.51806616783142,47.14188504219055,103.64921569824219,2388,645,1743,1743,0,11,752000.0
752,752999,20.124999242724925,34.968697071875695,0.08651503240286629,95.65054488182068,47.2060124874115,103.70838928222656,2388,645,1743,1743,0,11,753000.0
753,753999,20.12407154704589,34.96837249493455,0.08648921096251583,95.79062724113464,47.269935846328735,103.74322509765625,2388,645,1743,1743,0,11,754000.0
754,754999,20.12326242311803,34.96635886212458,0.08643710395303761,95.92214179039001,47.33330488204956,103.78194427490234,2388,645,1743,1743,0,11,755000.0
755,755999,20.124181656247238,34.96634464890274,0.08634397527327375,96.04783129692078,47.39665937423706,103.82182693481445,2388,645,1743,1743,0,11,756000.0
756,756999,20.12605434624833,34.96600995403097,0.08622604801814604,96.1830632686615,47.460318088531494,103.85403823852539,2388,645,1743,1743,0,11,757000.0
757,757999,20.12619296464256,34.964727970819794,0.08615756064397528,96.32852101325989,47.52410626411438,103.87095642089844,2388,645,1743,1743,0,11,758000.0
758,758999,20.12513571640642,34.96075361770233,0.08604644198199718,96.45339941978455,47.588380098342896,103.89656066894531,2388,645,1743,1743,0,11,759000.0
759,759999,20.123292520480724,34.95891865803094,0.08589906130731895,96.58604955673218,47.65349984169006,104.18163299560547,2389,645,1744,1744,0,11,760000.0
760,760999,20.116659110220713,34.95402173358827,0.08578887146908065,96.71351742744446,47.718268394470215,104.33401489257812,2391,646,1745,1745,0,11,761000.0
761,761999,20.109065341748703,34.94268701136261,0.08570725143166869,96.84934687614441,47.7825493812561,104.43024826049805,2393,647,1746,1746,0,11,762000.0
762,762999,20.103409626711066,34.94865834965934,0.08557562246617234,96.97976183891296,47.846320390701294,104.54607391357422,2393,647,1746,1746,0,11,763000.0
763,763999,20.098530807905682,34.94544728091436,0.08544749947851604,97.1150860786438,47.91047954559326,104.65505599975586,2393,647,1746,1746,0,11,764000.0
764,764999,20.092855541109625,34.938930235750355,0.08535040435119556,97.25670576095581,47.974387407302856,104.69840621948242,2395,648,1747,1747,0,11,765000.0
765,765999,20.08983191934025,34.93708358704606,0.08523388627454231,97.38003325462341,48.038309812545776,104.81459045410156,2395,648,1747,1747,0,11,766000.0
766,766999,20.0862843141953,34.93508152023222,0.0851178672488141,97.50335645675659,48.102813482284546,104.8956413269043,2395,648,1747,1747,0,11,767000.0
767,767999,20.08293501391947,34.932021295763406,0.08500325603224945,97.65667057037354,48.16734004020691,104.91276931762695,2397,649,1748,1748,0,11,768000.0
768,768999,20.079606038865467,34.92644219027707,0.0848874444133918,97.7910463809967,48.23173904418945,104.96566772460938,2397,649,1748,1748,0,11,769000.0
769,769999,20.07898497806923,34.92646328609516,0.08475090469051494,97.90816044807434,48.29575300216675,105.03129577636719,2397,649,1748,1748,0,11,770000.0
770,770999,20.079345097955358,34.92516771149562,0.08463260571526221,98.0375063419342,48.36002850532532,105.07759475708008,2397,649,1748,1748,0,11,771000.0
771,771999,20.077961620739444,34.92834778460366,0.08451453399806497,98.17717814445496,48.424577713012695,105.12006759643555,2397,649,1748,1748,0,11,772000.0
772,772999,20.076810341586924,34.926088737094204,0.08442179479863221,98.30535435676575,48.488686323165894,105.14548873901367,2397,649,1748,1748,0,11,773000.0
773,773999,20.07769634571381,34.925143238610985,0.08431576859777634,98.44743156433105,48.5535249710083,105.15054702758789,2399,650,1749,1749,0,11,774000.0
774,774999,20.07904965061374,34.92890697788925,0.08422183422859086,98.5995421409607,48.617770195007324,105.15123748779297,2401,651,1750,1750,0,11,775000.0
775,775999,20.080699334890426,34.928265371180814,0.0841677302278887,98.75098061561584,48.68212699890137,105.18352508544922,2432,652,1780,1780,0,11,776000.0
776,776999,20.084098801457326,34.95747025306775,0.08397599006515122,98.88627099990845,48.74725079536438,105.16878509521484,2434,653,1781,1781,0,11,777000.0
777,777999,20.08656420824101,34.95765184784834,0.08388415853620568,99.01543045043945,48.81157946586609,105.22197341918945,2434,653,1781,1781,0,11,778000.0
778,778999,20.08961956642773,34.96087529262917,0.08378459852915676,99.15597128868103,48.87591910362244,105.2723159790039,2434,653,1781,1781,0,11,779000.0
779,779999,20.08907079448122,34.964117625463246,0.08366657065022876,99.29308605194092,48.94001626968384,105.31396484375,2465,654,1811,1811,0,11,780000.0
780,780999,20.083265186674996,34.973017953677825,0.0835699065538249,99.43300414085388,49.00415873527527,105.53957748413086,2496,655,1841,1841,0,11,781000.0
781,781999,20.075251696944843,34.96098682777778,0.0835947977770416,99.55867314338684,49.067901611328125,105.6679916381836,2496,655,1841,1841,0,11,782000.0
782,782999,20.067111842352364,34.9533178735369,0.08360715534307972,99.67557096481323,49.13158893585205,105.73929214477539,2496,655,1841,1841,0,11,783000.0
783,783999,20.05943248496037,34.94493855151758,0.08360374454410191,99.83120727539062,49.194939613342285,105.8139419555664,2496,655,1841,1841,0,11,784000.0
784,784999,20.053909271847413,34.95128019572886,0.08353027367274046,99.97971749305725,49.25895547866821,105.81158447265625,2500,657,1843,1843,0,11,785000.0
785,785999,20.047534009552432,34.941669576747735,0.08354036194686554,100.10482501983643,49.3227756023407,105.85044860839844,2500,657,1843,1843,0,11,786000.0
786,786999,20.041993507548327,34.9331390982396,0.08351991365722455,100.24666118621826,49.386337757110596,105.88720321655273,2502,658,1844,1844,0,11,787000.0
787,787999,20.037379296296248,34.94212493857511,0.08343487012124695,100.36282658576965,49.4493567943573,105.93240356445312,2502,658,1844,1844,0,11,788000.0
788,788999,20.031750542074576,34.95342211412889,0.08335108438532324,100.49762296676636,49.51355791091919,105.96338653564453,2502,658,1844,1844,0,11,789000.0
789,789999,20.024982808322452,34.94429375837717,0.0833537340993471,100.64889359474182,49.577603340148926,105.94221878051758,2504,659,1845,1845,0,11,790000.0
790,790999,20.019117757535405,34.93590185942035,0.0833555813750192,100.78295969963074,49.64154124259949,105.97838973999023,2504,659,1845,1845,0,11,791000.0
791,791999,20.014724868629052,34.93223215086873,0.08333973800397754,100.91356420516968,49.705448150634766,106.0074348449707,2504,659,1845,1845,0,11,792000.0
792,792999,20.009483564480487,34.926604853801926,0.08332796454384905,101.03342723846436,49.76919865608215,106.06599807739258,2504,659,1845,1845,0,11,793000.0
793,793999,20.00594740531643,34.920565408157834,0.08329985608712731,101.18769335746765,49.83367443084717,106.04855346679688,2506,660,1846,1846,0,11,794000.0
794,794999,20.000397119805385,34.90880928159256,0.08328468037564662,101.33244204521179,49.897406816482544,106.09961700439453,2506,660,1846,1846,0,11,795000.0
795,795999,19.996088429934264,34.900126951761244,0.08328161313193849,101.47265768051147,49.96160173416138,106.13023376464844,2506,660,1846,1846,0,11,796000.0
796,796999,19.99017524162878,34.88751971765198,0.08328677945625707,101.59835314750671,50.025749921798706,106.12467956542969,2508,661,1847,1847,0,11,797000.0
797,797999,19.98772296286636,34.87921027988107,0.08310608837524813,101.73443746566772,50.09014868736267,106.4350357055664,2511,662,1849,1849,0,11,798000.0
798,798999,19.981965409100084,34.86601278815317,0.08301874865250491,101.85914397239685,50.154659271240234,106.63652420043945,2511,662,1849,1849,0,11,799000.0
799,799999,19.979034614443712,34.872152637423355,0.08279744817019974,101.99271202087402,50.218894720077515,106.75794982910156,2511,662,1849,1849,0,11,800000.0
800,800999,19.97423431611216,34.86654168123022,0.08272926280097548,102.11599087715149,50.283103227615356,106.8418083190918,2511,662,1849,1849,0,11,801000.0
801,801999,19.970764135245595,34.86615018298582,0.08260784559090839,102.2708568572998,50.34704518318176,106.91002655029297,2513,663,1850,1850,0,11,802000.0
802,802999,19.964667570709327,34.85434152609145,0.08259031602941369,102.39418387413025,50.411834955215454,106.96379470825195,2513,663,1850,1850,0,11,803000.0
803,803999,19.95902770879331,34.84299656034505,0.08250149271400387,102.53286290168762,50.47617149353027,106.9951171875,2515,664,1851,1851,0,11,804000.0
804,804999,19.954158587611495,34.83607192063543,0.08242452780535214,102.66909265518188,50.540398359298706,107.07540893554688,2515,664,1851,1851,0,11,805000.0
805,805999,19.951057610169116,34.82917632705604,0.08229803092663446,102.80401229858398,50.604899406433105,107.06210708618164,2517,665,1852,1852,0,11,806000.0
806,806999,19.94783695956959,34.82421948600984,0.08219949553590722,102.93216443061829,50.66973853111267,107.08831024169922,2519,666,1853,1853,0,11,807000.0
807,807999,19.945356561551822,34.833470894029645,0.08208416374524041,103.08538675308228,50.73444485664368,107.15249633789062,2519,666,1853,1853,0,11,808000.0
808,808999,19.94195885514051,34.82782137357332,0.08196474173041846,103.21745991706848,50.798832416534424,107.19295883178711,2519,666,1853,1853,0,11,809000.0
809,809999,19.93881013613358,34.82215921376659,0.0818779536529447,103.3555896282196,50.863924503326416,107.24437713623047,2519,666,1853,1853,0,11,810000.0
810,810999,19.9359493504159,34.81922104547004,0.0817389496456874,103.47855877876282,50.92831611633301,107.2729377746582,2519,666,1853,1853,0,11,811000.0
811,811999,19.934576216843002,34.81550496565436,0.08164047294263743,103.5982358455658,50.99236607551575,107.31317901611328,2519,666,1853,1853,0,11,812000.0
812,812999,19.93086293464641,34.80762345907371,0.08159740531933324,103.74511957168579,51.05646109580994,107.36796188354492,2519,666,1853,1853,0,11,813000.0
813,813999,19.92995330545375,34.80396142392016,0.08149375723370422,103.87842082977295,51.12132239341736,107.36812973022461,2521,667,1854,1854,0,11,814000.0
814,814999,19.9269060276086,34.796112821051395,0.08143593052555564,104.01716041564941,51.186017751693726,107.3952751159668,2521,667,1854,1854,0,11,815000.0
815,815999,19.923072142771247,34.78594373474414,0.08135885183258096,104.14954662322998,51.25018358230591,107.45254898071289,2521,667,1854,1854,0,11,816000.0
816,816999,19.929261222889814,34.80646781231946,0.08080804904848549,104.28915548324585,51.314560413360596,107.74632263183594,2521,667,1854,1854,0,11,817000.0
817,817999,19.926664760558772,34.79762116557311,0.08060202125922,104.4228208065033,51.382994413375854,107.90721130371094,2521,667,1854,1854,0,11,818000.0
818,818999,19.924252492419146,34.7903165040344,0.08046654371323769,104.55505537986755,51.44706845283508,108.03253936767578,2521,667,1854,1854,0,11,819000.0
819,819999,19.92229157148737,34.78040595804414,0.08041211576707519,104.69259858131409,51.510794162750244,108.10145568847656,2521,667,1854,1854,0,11,820000.0
820,820999,19.9210356333751,34.7750618552351,0.08048923225885052,104.8154366016388,51.57448673248291,108.18350601196289,2521,667,1854,1854,0,11,821000.0
821,821999,19.920243109758207,34.76871491878266,0.08052824311539397,104.94409227371216,51.639209508895874,108.25414657592773,2521,667,1854,1854,0,11,822000.0
822,822999,19.919367440625457,34.76260823764042,0.08063134459394639,105.09383368492126,51.7036714553833,108.30452728271484,2521,667,1854,1854,0,11,823000.0
823,823999,19.918045002614537,34.75608055044537,0.08099111336605613,105.2285509109497,51.76756048202515,108.35323333740234,2521,667,1854,1854,0,11,824000.0
824,824999,19.9195792405413,34.764651997468185,0.08108377158604363,105.34778761863708,51.83200216293335,108.35160827636719,2526,668,1858,1858,0,11,825000.0
825,825999,19.921755751073512,34.764382706937106,0.08133568284282544,105.48463273048401,51.896486043930054,108.38997268676758,2526,668,1858,1858,0,11,826000.0
826,826999,19.92565654219231,34.771587093738546,0.08158918650005187,105.61545920372009,51.9609317779541,108.44175720214844,2526,668,1858,1858,0,11,827000.0
827,827999,19.92774052794187,34.772057051887955,0.08175334275339141,105.76594281196594,52.02548575401306,108.42465209960938,2528,669,1859,1859,0,11,828000.0
828,828999,19.930963937198502,34.77169253179739,0.08194925633447303,105.90157294273376,52.08994269371033,108.46390151977539,2528,669,1859,1859,0,11,829000.0
829,829999,19.93556156615269,34.77645219425257,0.08213163345717989,106.04713368415833,52.154032707214355,108.44912719726562,2530,670,1860,1860,0,11,830000.0
830,830999,19.939960430278514,34.779891981155025,0.08247751481398369,106.1902825832367,52.218520402908325,108.48913192749023,2530,670,1860,1860,0,11,831000.0
831,831999,19.945357125382884,34.78408410628752,0.08257251107216712,106.30861449241638,52.282731771469116,108.51807022094727,2530,670,1860,1860,0,11,832000.0
832,832999,19.952366274612945,34.79203958405189,0.08271915868649504,106.44589447975159,52.34675574302673,108.5613021850586,2530,670,1860,1860,0,11,833000.0
833,833999,19.959543606410406,34.798839205701036,0.08289350728882361,106.58175373077393,52.411782026290894,108.58290100097656,2530,670,1860,1860,0,11,834000.0
834,834999,19.962684694992745,34.798356553355305,0.08302687109555629,106.70368123054504,52.476200580596924,108.60643768310547,2530,670,1860,1860,0,11,835000.0
835,835999,19.96453709920972,34.79397800194505,0.08306094388716889,106.84242033958435,52.54043984413147,108.58502960205078,2532,671,1861,1861,0,11,836000.0
836,836999,19.963191752295305,34.79041023015661,0.08297092794009187,106.98355412483215,52.603840589523315,108.86942291259766,2532,671,1861,1861,0,11,837000.0
837,837999,19.961678242727103,34.79639892694291,0.08285191756342125,107.11960768699646,52.66818594932556,109.07650756835938,2532,671,1861,1861,0,11,838000.0
838,838999,19.96062782099472,34.80000126035375,0.08272568139575265,107.23958992958069,52.732972145080566,109.1990737915039,2532,671,1861,1861,0,11,839000.0
839,839999,19.96171183070982,34.80254152651856,0.08260089999856424,107.37385511398315,52.797231674194336,109.22816467285156,2534,672,1862,1862,0,11,840000.0
840,840999,19.96468559536602,34.80365537161404,0.08247053177420116,107.51525449752808,52.86119365692139,109.33124542236328,2534,672,1862,1862,0,11,841000.0
841,841999,19.967819949400994,34.813217590355876,0.08233656445700532,107.66240811347961,52.92496919631958,109.38186645507812,2536,673,1863,1863,0,11,842000.0
842,842999,19.971093406237312,34.82389943697569,0.08219864828003565,107.79390954971313,52.989035844802856,109.46432876586914,2538,674,1864,1864,0,11,843000.0
843,843999,19.979711994524152,34.86113058503629,0.08187029243483268,107.9210102558136,53.052478551864624,109.51769256591797,2538,674,1864,1864,0,11,844000.0
844,844999,19.988420394089392,34.8976422618328,0.08159057060107144,108.0506865978241,53.116328954696655,109.57357025146484,2538,674,1864,1864,0,11,845000.0
845,845999,20.00436902831536,34.96043337247222,0.0811737770788189,108.17574906349182,53.18024945259094,109.62033081054688,2538,674,1864,1864,0,11,846000.0
846,846999,20.018443685944845,35.017928883736545,0.08085235572392646,108.32672452926636,53.24398159980774,109.62500762939453,2543,675,1868,1868,0,11,847000.0
847,847999,20.035868355996868,35.07913110347446,0.0805581970169037,108.46426725387573,53.30781269073486,109.66894149780273,2543,675,1868,1868,0,11,848000.0
848,848999,20.051449585831055,35.12596265782122,0.08033691964197331,108.60869979858398,53.372512102127075,109.65633392333984,2545,676,1869,1869,0,11,849000.0
849,849999,20.07193265971518,35.18718736874116,0.08008666674065223,108.75407099723816,53.43734908103943,109.63812637329102,2547,677,1870,1870,0,11,850000.0
850,850999,20.091320265761816,35.24984678891715,0.07987086715909553,108.88963389396667,53.501505851745605,109.6901741027832,2547,677,1870,1870,0,11,851000.0
851,851999,20.11414201301111,35.30784235631787,0.07972706620060488,109.02504992485046,53.565372467041016,109.67193222045898,2549,678,1871,1871,0,11,852000.0
852,852999,20.12392114358425,35.326158254067494,0.07971565046270235,109.1638412475586,53.62995195388794,109.85796737670898,2549,678,1871,1871,0,11,853000.0
853,853999,20.141867014332444,35.4161441178204,0.07942615863236524,109.3033709526062,53.69372367858887,110.05051803588867,2549,678,1871,1871,0,11,854000.0
854,854999,20.16761418850856,35.529877927901815,0.07907936616265399,109.44219756126404,53.7576744556427,110.16011047363281,2551,679,1872,1872,0,11,855000.0
855,855999,20.186922489686562,35.61070977893114,0.07886330031849631,109.57517981529236,53.821269273757935,110.26356506347656,2551,679,1872,1872,0,11,856000.0
856,856999,20.2072448879831,35.68582960927888,0.07885434229747501,109.72576332092285,53.88612675666809,110.33673477172852,2553,680,1873,1873,0,11,857000.0
857,857999,20.225461109662355,35.740482654605536,0.07868109557422265,109.85038685798645,53.950568437576294,110.4025650024414,2553,680,1873,1873,0,11,858000.0
858,858999,20.243881513291125,35.79106545047417,0.07867523556019751,109.99028849601746,54.01495862007141,110.48101425170898,2553,680,1873,1873,0,11,859000.0
859,859999,20.262480603805866,35.83746531745035,0.0786138629135209,110.1188530921936,54.07865238189697,110.52117538452148,2553,680,1873,1873,0,11,860000.0
860,860999,20.280426246472505,35.87619135923454,0.07873937917913676,110.24466848373413,54.14253854751587,110.57513809204102,2553,680,1873,1873,0,11,861000.0
861,861999,20.291992861291742,35.89454476695381,0.07873673386316371,110.39316439628601,54.20693922042847,110.51317596435547,2557,682,1875,1875,0,11,862000.0
862,862999,20.30764380288938,35.92698832201243,0.07892770097508295,110.52441787719727,54.27164006233215,110.57516860961914,2557,682,1875,1875,0,11,863000.0
863,863999,20.32335544096221,35.97949037196639,0.07899665514561682,110.665611743927,54.33614730834961,110.63388061523438,2557,682,1875,1875,0,11,864000.0
864,864999,20.343885779135377,36.04622907129094,0.07912988361574669,110.78614163398743,54.4000608921051,110.670654296875,2557,682,1875,1875,0,11,865000.0
865,865999,20.360710055578416,36.07020707095821,0.07936764121669193,110.92479085922241,54.46387457847595,110.7159309387207,2557,682,1875,1875,0,11,866000.0
866,866999,20.378720524757103,36.113651476537385,0.07967941346492757,111.06578183174133,54.52785038948059,110.64967346191406,2559,683,1876,1876,0,11,867000.0
867,867999,20.396099483687724,36.13648428455991,0.07999459079369498,111.20161199569702,54.592655658721924,110.68841934204102,2559,683,1876,1876,0,11,868000.0
868,868999,20.411513569225907,36.1607082145703,0.07998546616717839,111.31649899482727,54.656829595565796,110.9024543762207,2560,683,1877,1877,0,11,869000.0
869,869999,20.433424373772183,36.22339393063978,0.07954598355986375,111.43539261817932,54.72174000740051,111.03029251098633,2562,684,1878,1878,0,11,870000.0
870,870999,20.45045214918339,36.270350464497035,0.07934054424925008,111.57372045516968,54.785603284835815,111.17123794555664,2562,684,1878,1878,0,11,871000.0
871,871999,20.467827417242137,36.30131532412959,0.07928788385335361,111.7221212387085,54.8497052192688,111.1978759765625,2566,686,1880,1880,0,11,872000.0
872,872999,20.487379295150696,36.34063794254511,0.07929347344945581,111.85059571266174,54.91334342956543,111.28325653076172,2566,686,1880,1880,0,11,873000.0
873,873999,20.50662274460507,36.39693187464817,0.07960692808505732,111.97375845909119,54.97762870788574,111.38007736206055,2566,686,1880,1880,0,11,874000.0
874,874999,20.522508258561267,36.425456995409014,0.07978311351798728,112.14537644386292,55.042630195617676,112.09899139404297,2628,687,1941,1941,0,11,875000.0
875,875999,20.540043051153642,36.474928242127326,0.0804779172753114,112.2781572341919,55.10758948326111,112.52978515625,2628,687,1941,1941,0,11,876000.0
876,876999,20.558798695316188,36.51158776771978,0.08094749515340338,112.40505599975586,55.171714782714844,112.73288345336914,2628,687,1941,1941,0,11,877000.0
877,877999,20.579742618505232,36.575046555257906,0.08175471978853155,112.5472571849823,55.23659324645996,112.88822937011719,2628,687,1941,1941,0,11,878000.0
878,878999,20.600985384345286,36.61781301588333,0.08246106220293381,112.66974711418152,55.30064368247986,113.0632209777832,2628,687,1941,1941,0,11,879000.0
879,879999,20.619114103818895,36.64978526959211,0.08310054474504347,112.79321932792664,55.364919900894165,113.11305236816406,2630,688,1942,1942,0,11,880000.0
880,880999,20.639248676844336,36.69120763320618,0.08413168734882392,112.91580390930176,55.42871069908142,113.20867919921875,2630,688,1942,1942,0,11,881000.0
881,881999,20.658179963252667,36.72683908115685,0.08460820495163701,113.06232118606567,55.493672609329224,113.331298828125,2630,688,1942,1942,0,11,882000.0
882,882999,20.68008109317983,36.7787504557502,0.0856701954991973,113.20394778251648,55.55869698524475,113.38424682617188,2632,689,1943,1943,0,11,883000.0
883,883999,20.698233493636938,36.81055642484215,0.08648810573599242,113.32550525665283,55.622846364974976,113.49896240234375,2632,689,1943,1943,0,11,884000.0
884,884999,20.714989008217515,36.83393631249661,0.08708602182749592,113.46645545959473,55.689542293548584,113.6238784790039,2632,689,1943,1943,0,11,885000.0
885,885999,20.73181198529452,36.85922925380236,0.08782385241747293,113.58949613571167,55.75392723083496,113.69417953491211,2632,689,1943,1943,0,11,886000.0
886,886999,20.752712188512444,36.906316348132925,0.08846807008501278,113.72533583641052,55.81853199005127,113.77227020263672,2632,689,1943,1943,0,11,887000.0
887,887999,20.766737813065006,36.920569475281866,0.08894607917787034,113.87051129341125,55.889301776885986,113.87678909301758,2632,689,1943,1943,0,11,888000.0
888,888999,20.77948192113507,36.942785409231384,0.08899842078270037,114.01097083091736,55.95413279533386,114.1224365234375,2633,689,1944,1944,0,11,889000.0
889,889999,20.781795294596726,36.947172741844916,0.08881736988557398,114.14996886253357,56.01797676086426,114.27405166625977,2635,690,1945,1945,0,11,890000.0
890,890999,20.787317371595403,36.97159603036433,0.08860707564316883,114.2848551273346,56.08200550079346,114.39893341064453,2635,690,1945,1945,0,11,891000.0
891,891999,20.792909812390157,36.98436225860508,0.08845611852902746,114.4130642414093,56.145941734313965,114.47439575195312,2635,690,1945,1945,0,11,892000.0
892,892999,20.797492762258937,36.99276030838112,0.08829949922844316,114.57214260101318,56.210453033447266,114.53591537475586,2637,691,1946,1946,0,11,893000.0
893,893999,20.802067965482323,37.001570475901744,0.08819281671918844,114.70068979263306,56.27446436882019,114.56030654907227,2639,692,1947,1947,0,11,894000.0
894,894999,20.805819144685646,37.00643085735307,0.08806760820584603,114.83796286582947,56.33986163139343,114.6108283996582,2641,693,1948,1948,0,11,895000.0
895,895999,20.811842936434374,37.01567110388681,0.08799660798042952,114.97275757789612,56.40405797958374,114.65739822387695,2643,694,1949,1949,0,11,896000.0
896,896999,20.81778626792407,37.02431922942023,0.08791516656751619,115.11522555351257,56.468860387802124,114.72000122070312,2643,694,1949,1949,0,11,897000.0
897,897999,20.826874825419054,37.04345501815621,0.08787854667008821,115.23417472839355,56.532782316207886,114.78374099731445,2643,694,1949,1949,0,11,898000.0
898,898999,20.836780419640416,37.06135225498543,0.08795521322975641,115.37622380256653,56.597267150878906,114.83707427978516,2643,694,1949,1949,0,11,899000.0
899,899999,20.843588045783335,37.07095224291293,0.08797187498412329,115.5052011013031,56.66116404533386,114.87796020507812,2643,694,1949,1949,0,11,900000.0
900,900999,20.853590320571147,37.084737957071404,0.08806159837424654,115.6386308670044,56.725099325180054,114.90555191040039,2643,694,1949,1949,0,11,901000.0
901,901999,20.863582613702256,37.10009538018096,0.08812413652142692,115.7754807472229,56.789833307266235,114.93206024169922,2643,694,1949,1949,0,11,902000.0
902,902999,20.876681723325092,37.122217381464345,0.08828769407272397,115.93029117584229,56.85418963432312,114.96146011352539,2674,695,1979,1979,0,11,903000.0
903,903999,20.890936187922716,37.14947978844585,0.08856109416405533,116.0710141658783,56.91839671134949,114.98549270629883,2674,695,1979,1979,0,11,904000.0
904,904999,20.905661277739014,37.17064674209522,0.08875695545040818,116.20153212547302,56.982422828674316,115.03168869018555,2674,695,1979,1979,0,11,905000.0
905,905999,20.919312865753355,37.189047016371696,0.088965730510705,116.33341121673584,57.04629445075989,115.0645866394043,2674,695,1979,1979,0,11,906000.0
906,906999,20.93417487263763,37.21567204581363,0.08925193705898471,116.4638159275055,57.11005091667175,115.08165740966797,2674,695,1979,1979,0,11,907000.0
907,907999,20.9514800119019,37.24359168957753,0.08961512324030385,116.59085512161255,57.17396402359009,115.11175155639648,2674,695,1979,1979,0,11,908000.0
908,908999,20.95943323097813,37.250567574745666,0.08983775444415254,116.74303698539734,57.23908281326294,115.17396926879883,2674,695,1979,1979,0,11,909000.0
909,909999,20.965396554969853,37.27677573914148,0.08936530145350352,116.8805193901062,57.30355930328369,115.33628845214844,2676,696,1980,1980,0,11,910000.0
910,910999,20.968889570267272,37.28439324803481,0.08895573951910596,117.0319311618805,57.370824575424194,115.53423309326172,2676,696,1980,1980,0,11,911000.0
911,911999,20.976348647889548,37.2965057843719,0.08849843508946553,117.15401792526245,57.434786796569824,115.63926696777344,2676,696,1980,1980,0,11,912000.0
912,912999,20.984723337839522,37.31410015466171,0.08807243708637769,117.29033637046814,57.49930191040039,115.674560546875,2678,697,1981,1981,0,11,913000.0
913,913999,20.989955081340476,37.319844534522595,0.08773439851342635,117.44843411445618,57.56361675262451,115.73668670654297,2680,698,1982,1982,0,11,914000.0
914,914999,20.995572930602822,37.32642604214662,0.08744233217134034,117.57233309745789,57.62759184837341,115.78277206420898,2680,698,1982,1982,0,11,915000.0
915,915999,21.000671490303844,37.332420463533715,0.08716693557971034,117.69857025146484,57.69157290458679,115.80369186401367,2682,699,1983,1983,0,11,916000.0
916,916999,21.00710188963229,37.34448792272,0.08690814601479813,117.84114718437195,57.756168603897095,115.87446212768555,2682,699,1983,1983,0,11,917000.0
917,917999,21.013007035620358,37.351518666309936,0.08667427232339853,117.98213076591492,57.82043218612671,115.91509246826172,2682,699,1983,1983,0,11,918000.0
918,918999,21.023979715101742,37.39577116760806,0.08633050878801019,118.10790419578552,57.88452982902527,115.9586181640625,2682,699,1983,1983,0,11,919000.0
919,919999,21.028539723254752,37.399098278425306,0.08621930181838922,118.24565696716309,57.94883728027344,115.95367431640625,2684,700,1984,1984,0,11,920000.0
920,920999,21.035879731429862,37.40642494856916,0.08604982480214307,118.38585615158081,58.0139422416687,115.99716567993164,2684,700,1984,1984,0,11,921000.0
921,921999,21.04220481607651,37.41211657513372,0.08592429776506472,118.52147507667542,58.078712701797485,116.05060958862305,2684,700,1984,1984,0,11,922000.0
922,922999,21.050952166816188,37.42949321984843,0.08578808669880766,118.65272045135498,58.14312028884888,116.08077621459961,2684,700,1984,1984,0,11,923000.0
923,923999,21.057218447229637,37.43436165500191,0.08570462342183238,118.79545140266418,58.207433223724365,116.13121795654297,2684,700,1984,1984,0,11,924000.0
924,924999,21.063278118656697,37.440532896175085,0.08564598779531152,118.91467356681824,58.27123475074768,116.16131973266602,2684,700,1984,1984,0,11,925000.0
925,925999,21.071061594912617,37.44797441829826,0.08557490631066822,119.04632639884949,58.33495378494263,116.19709014892578,2684,700,1984,1984,0,11,926000.0
926,926999,21.07820440789483,37.4515850319162,0.08501199237238699,119.17906022071838,58.39847707748413,116.54656219482422,2685,700,1985,1985,0,11,927000.0
927,927999,21.083795886895548,37.455157805015624,0.08463114829340612,119.31392478942871,58.462963342666626,116.7242660522461,2688,701,1987,1987,0,11,928000.0
928,928999,21.090033860631323,37.455797585072794,0.084334361828027,119.44580507278442,58.527199506759644,116.82004928588867,2690,702,1988,1988,0,11,929000.0
929,929999,21.093418515665498,37.451019664822404,0.0840840563758809,119.5726432800293,58.59173274040222,116.82180786132812,2692,703,1989,1989,0,11,930000.0
930,930999,21.099992671081683,37.450880731657286,0.08373541604272794,119.70842003822327,58.655597448349,116.96654510498047,2692,703,1989,1989,0,11,931000.0
931,931999,21.10315089339349,37.447356010616126,0.08350424528092959,119.84744763374329,58.71985912322998,117.04408645629883,2692,703,1989,1989,0,11,932000.0
932,932999,21.105812742164765,37.44300453939184,0.08325055194532927,119.97172999382019,58.784053325653076,117.10272216796875,2692,703,1989,1989,0,11,933000.0
933,933999,21.109804164641655,37.46003162100814,0.0830018699783528,120.12272548675537,58.848904609680176,117.11307144165039,2694,704,1990,1990,0,11,934000.0
934,934999,21.111141914322776,37.452544763571524,0.08286000172654717,120.24353814125061,58.91348886489868,117.17050552368164,2694,704,1990,1990,0,11,935000.0
935,935999,21.114287297956043,37.45295745997491,0.08264129921123553,120.37393021583557,58.97792434692383,117.14263153076172,2696,705,1991,1991,0,11,936000.0
936,936999,21.116553040322838,37.44814475943402,0.08246442572231338,120.52279376983643,59.04267477989197,117.20360946655273,2696,705,1991,1991,0,11,937000.0
937,937999,21.120671107040828,37.44912570469511,0.08235403493346782,120.65378093719482,59.10713529586792,117.24824905395508,2696,705,1991,1991,0,11,938000.0
938,938999,21.12439237447998,37.455202702118285,0.08221159483577578,120.78035187721252,59.17125082015991,117.30998611450195,2696,705,1991,1991,0,11,939000.0
939,939999,21.129816859363395,37.45787786081812,0.08210750281739232,120.92393589019775,59.23576021194458,117.27281951904297,2698,706,1992,1992,0,11,940000.0
940,940999,21.135467042570035,37.463249626799005,0.08200958193585905,121.04404497146606,59.29991102218628,117.33495330810547,2698,706,1992,1992,0,11,941000.0
941,941999,21.139297120907194,37.46226004665715,0.08188174876215437,121.17802691459656,59.36435055732727,117.3912467956543,2698,706,1992,1992,0,11,942000.0
942,942999,21.14425920004052,37.464032587076,0.08176723404443631,121.30352997779846,59.42857551574707,117.42123031616211,2698,706,1992,1992,0,11,943000.0
943,943999,21.146219144800973,37.461703332384005,0.08167565607170035,121.46849274635315,59.4935998916626,117.4049072265625,2700,707,1993,1993,0,11,944000.0
944,944999,21.148596118523052,37.46522336447016,0.08158638816366393,121.59571170806885,59.55834746360779,117.44085311889648,2700,707,1993,1993,0,11,945000.0
945,945999,21.150750569399754,37.462978444051316,0.08150077420365753,121.72973012924194,59.62205910682678,117.62565994262695,2700,707,1993,1993,0,11,946000.0
946,946999,21.152778903621282,37.47149387225138,0.0813108209437946,121.86592650413513,59.68637824058533,117.74091720581055,2701,707,1994,1994,0,11,947000.0
947,947999,21.151820527276445,37.46486669579713,0.08118300321138694,121.98851299285889,59.7503445148468,117.86643600463867,2701,707,1994,1994,0,11,948000.0
948,948999,21.14938227319566,37.455847734537734,0.08110033483689583,122.1258716583252,59.814064741134644,117.91096115112305,2701,707,1994,1994,0,11,949000.0
949,949999,21.148658702190446,37.454710967891366,0.08102787124161814,122.30017685890198,59.87852334976196,118.27128982543945,2766,710,2056,2056,0,11,950000.0
950,950999,21.14778356834657,37.44798802209231,0.08092950485501249,122.42665672302246,59.94361090660095,118.81583404541016,2766,710,2056,2056,0,11,951000.0
951,951999,21.146098901915888,37.43925508806677,0.08086520602124403,122.56031608581543,60.008264780044556,119.09247207641602,2766,710,2056,2056,0,11,952000.0
952,952999,21.14425568468401,37.43156554365517,0.08080251469233235,122.70416307449341,60.07262992858887,119.27997207641602,2766,710,2056,2056,0,11,953000.0
953,953999,21.142128287855105,37.42312125558703,0.08075091659722433,122.837726354599,60.13667321205139,119.4329605102539,2766,710,2056,2056,0,11,954000.0
954,954999,21.141353510354136,37.41977343175434,0.0806587630076272,122.95682072639465,60.20035243034363,119.56175994873047,2766,710,2056,2056,0,11,955000.0
955,955999,21.140413484233,37.413245604601265,0.08062879492636421,123.09232759475708,60.26438093185425,119.65451049804688,2766,710,2056,2056,0,11,956000.0
956,956999,21.139566680766666,37.407988597134356,0.08057858710148247,123.23391509056091,60.32851839065552,119.77503204345703,2766,710,2056,2056,0,11,957000.0
957,957999,21.140284857638793,37.4046002982994,0.08053440319727634,123.37622594833374,60.39249658584595,119.84924697875977,2766,710,2056,2056,0,11,958000.0
958,958999,21.140049051646994,37.39875089180641,0.08049693335184593,123.50188612937927,60.45633625984192,119.88865661621094,2766,710,2056,2056,0,11,959000.0
959,959999,21.142986862733927,37.39917729403602,0.08043735572189925,123.6222722530365,60.52024793624878,120.01018905639648,2766,710,2056,2056,0,11,960000.0
960,960999,21.146805167891426,37.40396082785367,0.08039202818040125,123.76370406150818,60.585204124450684,120.06084442138672,2766,710,2056,2056,0,11,961000.0
961,961999,21.149579788827925,37.404605623815826,0.0803387297812489,123.89903116226196,60.64948773384094,120.11006164550781,2766,710,2056,2056,0,11,962000.0
962,962999,21.15161841749146,37.40292259881501,0.08031806139685471,124.02572298049927,60.71334719657898,120.21026992797852,2766,710,2056,2056,0,11,963000.0
963,963999,21.154897715124225,37.40291810988716,0.08029587531130788,124.18538093566895,60.777416944503784,120.21806716918945,2768,711,2057,2057,0,11,964000.0
964,964999,21.157920623748602,37.401460850545895,0.08028516404242803,124.31566095352173,60.841230392456055,120.27359008789062,2768,711,2057,2057,0,11,965000.0
965,965999,21.158140193013,37.39529314232695,0.08027071165857558,124.4495325088501,60.90582823753357,120.36406707763672,2768,711,2057,2057,0,11,966000.0
966,966999,21.15725050680418,37.39573664520225,0.08022863824538462,124.57830929756165,60.969908475875854,120.61413955688477,2769,711,2058,2058,0,11,967000.0
967,967999,21.15011873512716,37.385708555496166,0.08022092551939297,124.72257018089294,61.033945083618164,120.74414825439453,2771,712,2059,2059,0,11,968000.0
968,968999,21.14211538096971,37.37322039325163,0.08025789607772094,124.8476333618164,61.09793138504028,120.86228942871094,2771,712,2059,2059,0,11,969000.0
969,969999,21.134951045702888,37.3636746706669,0.08026762063806825,124.99305748939514,61.161837577819824,120.92992782592773,2771,712,2059,2059,0,11,970000.0
970,970999,21.127689113523225,37.35210068758906,0.08027009157692433,125.11688756942749,61.226725339889526,121.01495742797852,2771,712,2059,2059,0,11,971000.0
971,971999,21.11979919798768,37.338386753244116,0.08030244976290835,125.25540590286255,61.29070687294006,121.04718017578125,2773,713,2060,2060,0,11,972000.0
972,972999,21.111930671066972,37.32567498308843,0.0803256295657877,125.82380366325378,61.35537576675415,121.11661911010742,2773,713,2060,2060,0,11,973000.0
973,973999,21.104496027350194,37.314178220710204,0.0803318246958229,125.94662022590637,61.41965079307556,121.18774795532227,2773,713,2060,2060,0,11,974000.0
974,974999,21.096954809303522,37.301692387245694,0.08033317474944912,126.07440495491028,61.484046459198,121.22868347167969,2773,713,2060,2060,0,11,975000.0
975,975999,21.08991487083933,37.289538871951684,0.08034121055468424,126.21700620651245,61.54900860786438,121.26813125610352,2773,713,2060,2060,0,11,976000.0
976,976999,21.08389451843569,37.2829201406133,0.08033443653502548,126.34441208839417,61.6138219833374,121.30734252929688,2773,713,2060,2060,0,11,977000.0
977,977999,21.07701163399519,37.27037644910016,0.08035102746962097,126.48086667060852,61.67842245101929,121.3402328491211,2773,713,2060,2060,0,11,978000.0
978,978999,21.07260635597903,37.28508154585951,0.08023410077440585,126.6494550704956,61.74328398704529,121.32940292358398,2775,714,2061,2061,0,11,979000.0
979,979999,21.066699685286732,37.2753888333193,0.0802187867483457,126.7716064453125,61.80723762512207,121.32538604736328,2777,715,2062,2062,0,11,980000.0
980,980999,21.060327223153212,37.2639826944988,0.08022087545948797,126.90509867668152,61.87181854248047,121.36967086791992,2777,715,2062,2062,0,11,981000.0
981,981999,21.0571815247013,37.25854991755077,0.08017592668837425,127.03259539604187,61.93608832359314,121.39261245727539,2777,715,2062,2062,0,11,982000.0
982,982999,21.053014849904716,37.25048438107995,0.08015686584108739,127.17472457885742,62.000351905822754,121.42041015625,2777,715,2062,2062,0,11,983000.0
983,983999,21.04767704894262,37.24042526744368,0.0801452306786854,127.33219289779663,62.06500959396362,121.40840148925781,2779,716,2063,2063,0,11,984000.0
984,984999,21.043539463189063,37.23178069802423,0.08012156875196907,127.45922613143921,62.1293249130249,121.42772674560547,2779,716,2063,2063,0,11,985000.0
985,985999,21.038216327049078,37.2215721055156,0.08010432349310614,127.60474634170532,62.193487882614136,121.41144561767578,2781,717,2064,2064,0,11,986000.0
986,986999,21.03218395901154,37.21061964936166,0.08009036470150399,127.74808192253113,62.25764441490173,121.45451736450195,2781,717,2064,2064,0,11,987000.0
987,987999,21.046590302881217,37.24470120563425,0.07910265575429554,127.88287925720215,62.32196879386902,121.7431526184082,2783,718,2065,2065,0,11,988000.0
988,988999,21.063861823603418,37.28459465546934,0.07854927234234765,128.00163888931274,62.38677620887756,121.99563217163086,2783,718,2065,2065,0,11,989000.0
989,989999,21.084378960575986,37.34932853440563,0.0780546791088047,128.1403956413269,62.451595306396484,122.05904769897461,2785,719,2066,2066,0,11,990000.0
990,990999,21.097400809504915,37.36311586106926,0.0775942780068064,128.27883911132812,62.51576375961304,122.16922378540039,2785,719,2066,2066,0,11,991000.0
991,991999,21.11051815838734,37.37330419745458,0.07714662870801559,128.42055130004883,62.58013343811035,122.26064682006836,2785,719,2066,2066,0,11,992000.0
992,992999,21.125459960486815,37.39201083428656,0.07665318091615159,128.55415272712708,62.644596576690674,122.33199691772461,2787,720,2067,2067,0,11,993000.0
993,993999,21.139111705869567,37.404442591661606,0.07613014545700247,128.68115258216858,62.70983004570007,122.396484375,2787,720,2067,2067,0,11,994000.0
994,994999,21.150759320806433,37.41610817822401,0.07575811999419435,128.82120037078857,62.77444815635681,122.40524291992188,2789,721,2068,2068,0,11,995000.0
995,995999,21.16144656015323,37.423799492482715,0.07542490701581239,128.9634358882904,62.83904981613159,122.4271125793457,2791,722,2069,2069,0,11,996000.0
996,996999,21.169562345442984,37.42916451259608,0.07517886810654884,129.0995900630951,62.904972076416016,122.49069595336914,2791,722,2069,2069,0,11,997000.0
997,997999,21.177675199082458,37.4316936930852,0.0748812443924689,129.2586545944214,62.96987295150757,122.54899597167969,2791,722,2069,2069,0,11,998000.0
998,998999,21.18533443726909,37.43745287327717,0.0746005522409644,129.3935263156891,63.03612780570984,122.59387969970703,2791,722,2069,2069,0,11,999000.0
999,999999,21.192664938665025,37.44331810164028,0.07442856132358977,129.51006174087524,63.10217523574829,122.63768005371094,2791,722,2069,2069,0,11,1000000.0
1000,1000999,21.197917251518135,37.442763865427686,0.07422180970904102,129.64876770973206,63.16651630401611,122.68230819702148,2791,722,2069,2069,0,11,1001000.0
1001,1001999,21.205097343559494,37.45482205831993,0.07400368538807445,129.79068207740784,63.23121476173401,122.70166397094727,2791,722,2069,2069,0,11,1002000.0
1002,1002999,21.212403679354157,37.45749425703183,0.07378735078289911,129.92841458320618,63.2958779335022,122.7348747253418,2791,722,2069,2069,0,11,1003000.0
1003,1003999,21.21759442995282,37.456965643145,0.07361476550628898,130.0702428817749,63.361446380615234,122.7675552368164,2791,722,2069,2069,0,11,1004000.0
1004,1004999,21.223701253580344,37.455772325849644,0.07345231121498019,130.20117712020874,63.426695823669434,122.76002502441406,2796,723,2073,2073,0,11,1005000.0
1005,1005999,21.22846076123137,37.454422078373725,0.07326584742488096,130.3526005744934,63.49145555496216,122.77616882324219,2798,724,2074,2074,0,11,1006000.0
1006,1006999,21.233593050182186,37.459069520744585,0.07313360940507319,130.4865643978119,63.556084871292114,122.81367874145508,2798,724,2074,2074,0,11,1007000.0
1007,1007999,21.23602733545615,37.45481540706373,0.07298598285432156,130.60648393630981,63.61991095542908,123.06465530395508,2799,724,2075,2075,0,11,1008000.0
1008,1008999,21.23488193041956,37.45256025784966,0.07288304534746903,130.73684000968933,63.68445920944214,123.23484802246094,2799,724,2075,2075,0,11,1009000.0
1009,1009999,21.232518012922473,37.446570524954524,0.0728232777519171,130.87616848945618,63.748793840408325,123.32201385498047,2799,724,2075,2075,0,11,1010000.0
1010,1010999,21.230444153482786,37.44191910150483,0.07276485081610129,131.00178742408752,63.81424403190613,123.38265609741211,2799,724,2075,2075,0,11,1011000.0
1011,1011999,21.228994204343277,37.436436674697326,0.07271184940107389,131.14781427383423,63.87849283218384,123.45527267456055,2799,724,2075,2075,0,11,1012000.0
1012,1012999,21.22699367091492,37.42969080809175,0.07264582494021798,131.27353286743164,63.94198727607727,123.51891708374023,2799,724,2075,2075,0,11,1013000.0
1013,1013999,21.22568195035062,37.42277868891817,0.07260456112883362,131.42423701286316,64.00694751739502,123.56274032592773,2799,724,2075,2075,0,11,1014000.0
1014,1014999,21.223709334905173,37.41829949432684,0.07255720659292308,131.55239844322205,64.07090711593628,123.5995864868164,2799,724,2075,2075,0,11,1015000.0
1015,1015999,21.22171194257196,37.41188573938988,0.07251085631187726,131.69029998779297,64.1353030204773,123.65526962280273,2799,724,2075,2075,0,11,1016000.0
1016,1016999,21.221001888970495,37.407567981295664,0.07248284287116091,131.8206503391266,64.19931197166443,123.68186950683594,2799,724,2075,2075,0,11,1017000.0
1017,1017999,21.22471703676455,37.410330272064925,0.0724253406600085,131.9463288784027,64.26374101638794,123.64809036254883,2801,725,2076,2076,0,11,1018000.0
1018,1018999,21.228805313093158,37.41604753817025,0.07242368593253856,132.10924077033997,64.32800507545471,123.6070556640625,2803,726,2077,2077,0,11,1019000.0
1019,1019999,21.231987976318326,37.418177655432245,0.07243415336011427,132.2446312904358,64.39220571517944,123.65626525878906,2803,726,2077,2077,0,11,1020000.0
1020,1020999,21.234538362016423,37.418947853551636,0.07246883588713482,132.37186884880066,64.45624279975891,123.6967887878418,2803,726,2077,2077,0,11,1021000.0
1021,1021999,21.23983291018325,37.42381396381866,0.07247434612589576,132.5145788192749,64.52050566673279,123.7329216003418,2803,726,2077,2077,0,11,1022000.0
1022,1022999,21.244962905215118,37.42836117023178,0.07246963297847442,132.65326714515686,64.58464360237122,123.69664764404297,2805,727,2078,2078,0,11,1023000.0
1023,1023999,21.24969694430234,37.429677819530326,0.07245638217755146,132.78180050849915,64.64909553527832,123.75628280639648,2805,727,2078,2078,0,11,1024000.0
1024,1024999,21.253898602559666,37.43017231318583,0.07243220297140884,132.92936325073242,64.7131552696228,123.78507995605469,2805,727,2078,2078,0,11,1025000.0
1025,1025999,21.25964031287988,37.43483472156308,0.07241236668038953,133.04320335388184,64.77692770957947,123.80755996704102,2805,727,2078,2078,0,11,1026000.0
1026,1026999,21.263344672650934,37.43519696092088,0.07235179047709428,133.19290232658386,64.84132218360901,123.8310661315918,2805,727,2078,2078,0,11,1027000.0
1027,1027999,21.264067983004722,37.43120888680996,0.07231013587879587,133.33434510231018,64.90514755249023,123.86740493774414,2805,727,2078,2078,0,11,1028000.0
1028,1028999,21.25753486821548,37.42236833501748,0.07231754062309947,133.4591462612152,64.96869540214539,124.0884780883789,2806,727,2079,2079,0,11,1029000.0
1029,1029999,21.251080904777343,37.41568752742561,0.07230717367930761,133.59403085708618,65.03247380256653,124.2236328125,2806,727,2079,2079,0,11,1030000.0
1030,1030999,21.245061356774364,37.4072723248212,0.07230883988585846,133.7261519432068,65.09665012359619,124.35264205932617,2868,728,2140,2140,0,11,1031000.0
1031,1031999,21.238939928302226,37.397649459695224,0.07229651936878811,133.8641812801361,65.16214847564697,125.09272766113281,2868,728,2140,2140,0,11,1032000.0
1032,1032999,21.232570064669645,37.38852407062906,0.07229198654964653,134.0042085647583,65.22678875923157,125.43400955200195,2868,728,2140,2140,0,11,1033000.0
1033,1033999,21.227703637835646,37.38123277938855,0.07226128577042867,134.15302419662476,65.29073333740234,125.67668914794922,2881,729,2152,2152,0,11,1034000.0
1034,1034999,21.22238129288279,37.374055527237175,0.07223531168469799,134.27109336853027,65.35486364364624,125.84407806396484,2881,729,2152,2152,0,11,1035000.0
1035,1035999,21.21709366904711,37.36896931131367,0.07219313895171664,134.40720772743225,65.41886520385742,125.98342895507812,2881,729,2152,2152,0,11,1036000.0
1036,1036999,21.2131867055186,37.36529416663532,0.0721341809201308,134.54237174987793,65.48300766944885,126.09519577026367,2881,729,2152,2152,0,11,1037000.0
1037,1037999,21.21010593526508,37.3599129672729,0.07206241321461493,134.66936564445496,65.54746460914612,126.1734390258789,2881,729,2152,2152,0,11,1038000.0
1038,1038999,21.207969420547645,37.35459781881765,0.07197708604597763,134.81615591049194,65.61171054840088,126.26995468139648,2881,729,2152,2152,0,11,1039000.0
1039,1039999,21.20592788661327,37.35052667884622,0.07188633309827397,134.95846223831177,65.67627024650574,126.34139633178711,2881,729,2152,2152,0,11,1040000.0
1040,1040999,21.205462766783103,37.35036099404069,0.07177891640299705,135.07994771003723,65.7402515411377,126.40264511108398,2881,729,2152,2152,0,11,1041000.0
1041,1041999,21.20444376483719,37.34689867483992,0.07166957885390657,135.21485137939453,65.80458092689514,126.45758056640625,2881,729,2152,2152,0,11,1042000.0
1042,1042999,21.206264882213926,37.347370951553,0.07152591912127193,135.3570520877838,65.8689661026001,126.57305526733398,2881,729,2152,2152,0,11,1043000.0
1043,1043999,21.209035946265544,37.35127114131846,0.07138331213216143,135.4893810749054,65.93344378471375,126.634765625,2881,729,2152,2152,0,11,1044000.0
1044,1044999,21.21042352406279,37.35292556397529,0.07123999910423429,135.61595726013184,65.99797368049622,126.71993637084961,2881,729,2152,2152,0,11,1045000.0
1045,1045999,21.212316755928672,37.35419200738499,0.07109790519113679,135.75067830085754,66.06240057945251,126.72412109375,2883,730,2153,2153,0,11,1046000.0
1046,1046999,21.215948860618624,37.35863509586371,0.07094913824939686,135.89308309555054,66.12662625312805,126.79621505737305,2883,730,2153,2153,0,11,1047000.0
1047,1047999,21.21898041211812,37.36002751169982,0.07081881004961166,136.03345227241516,66.19109034538269,126.88072204589844,2883,730,2153,2153,0,11,1048000.0
1048,1048999,21.217556993712822,37.353767815152686,0.07074390462064861,136.15203166007996,66.2542769908905,126.95563125610352,2883,730,2153,2153,0,11,1049000.0
1049,1049999,21.213543416994856,37.35016492111959,0.07071209148165158,136.29820203781128,66.31821250915527,127.1234130859375,2885,731,2154,2154,0,11,1050000.0
1050,1050999,21.208742181600478,37.34321611671176,0.07070469857388839,136.40685772895813,66.38140606880188,127.24417495727539,2885,731,2154,2154,0,11,1051000.0
1051,1051999,21.201568890209842,37.33229797857912,0.07072893809794034,136.55388283729553,66.44527959823608,127.33110046386719,2885,731,2154,2154,0,11,1052000.0
1052,1052999,21.19832643113046,37.32563919176742,0.0706767581938702,136.6822485923767,66.50902509689331,127.45197677612305,2885,731,2154,2154,0,11,1053000.0
1053,1053999,21.193511540930256,37.3166885143874,0.07065862805915468,136.80870985984802,66.57257151603699,127.51519775390625,2887,732,2155,2155,0,11,1054000.0
1054,1054999,21.192104778447803,37.319550985103945,0.07056354223132699,136.953222990036,66.6364848613739,127.58403778076172,2887,732,2155,2155,0,11,1055000.0
1055,1055999,21.192457226448422,37.33009383295996,0.0704201430567063,137.07031559944153,66.70069599151611,127.6475715637207,2887,732,2155,2155,0,11,1056000.0
1056,1056999,21.19326118096372,37.34400367715468,0.07029194123562787,137.2370572090149,66.76658821105957,128.35886001586914,2949,733,2216,2216,0,11,1057000.0
1057,1057999,21.20094020721767,37.402355803559445,0.07001511067188415,137.38387870788574,66.83173060417175,128.70099639892578,2951,734,2217,2217,0,11,1058000.0
1058,1058999,21.205979411245384,37.41738222760054,0.0699261782574625,137.5089602470398,66.89681148529053,128.93994522094727,2951,734,2217,2217,0,11,1059000.0
1059,1059999,21.21060171507482,37.4471626557522,0.06977738923355292,137.64672756195068,66.96094632148743,129.08868408203125,2951,734,2217,2217,0,11,1060000.0
1060,1060999,21.21613546042187,37.474331233476995,0.06963286027807247,137.78438472747803,67.0258526802063,129.30664443969727,2952,734,2218,2218,0,11,1061000.0
1061,1061999,21.226424173030242,37.51781567975203,0.06948526194620763,137.9114954471588,67.08957505226135,129.41376113891602,2952,734,2218,2218,0,11,1062000.0
1062,1062999,21.235813176960818,37.548951531840856,0.06938590453064708,138.0509808063507,67.15351152420044,129.54986190795898,2952,734,2218,2218,0,11,1063000.0
1063,1063999,21.245413473592194,37.58247556619874,0.06924235695463943,138.17230105400085,67.21675896644592,129.65415573120117,2952,734,2218,2218,0,11,1064000.0
1064,1064999,21.24801593095796,37.59294559703528,0.06915732891399484,138.2946789264679,67.28030967712402,129.85880279541016,2953,734,2219,2219,0,11,1065000.0
1065,1065999,21.250340240970434,37.60854859471949,0.06900567238614252,138.4263141155243,67.34457731246948,130.09891891479492,2953,734,2219,2219,0,11,1066000.0
1066,1066999,21.252919455249536,37.62495502934594,0.06888290212195924,138.56801581382751,67.40920829772949,130.1447525024414,2955,735,2220,2220,0,11,1067000.0
1067,1067999,21.25548501518643,37.64477013093099,0.06875675990395269,138.70490169525146,67.47302508354187,130.25858688354492,2955,735,2220,2220,0,11,1068000.0
1068,1068999,21.257207850126047,37.65014271334343,0.06865385845192395,138.84526658058167,67.53708148002625,130.27051162719727,2957,736,2221,2221,0,11,1069000.0
1069,1069999,21.263979581417,37.6765802738676,0.0684676395896322,138.98985934257507,67.60107898712158,130.22151947021484,2961,738,2223,2223,0,11,1070000.0
1070,1070999,21.26868217832741,37.69343072205219,0.06835667140635615,139.1282660961151,67.66506600379944,130.34847259521484,2961,738,2223,2223,0,11,1071000.0
1071,1071999,21.273161401843097,37.70552793899588,0.0682927581167061,139.27006125450134,67.7289502620697,130.41278457641602,2961,738,2223,2223,0,11,1072000.0
1072,1072999,21.278688271132655,37.71664378619073,0.06820996012675007,139.39758586883545,67.79335355758667,130.41387939453125,2963,739,2224,2224,0,11,1073000.0
1073,1073999,21.287085465003234,37.74612798941584,0.0680736434610939,139.52974939346313,67.8573739528656,130.47078704833984,2963,739,2224,2224,0,11,1074000.0
1074,1074999,21.299123145196585,37.79294023016991,0.06789134293328436,139.6622211933136,67.92128276824951,130.51335525512695,2963,739,2224,2224,0,11,1075000.0
1075,1075999,21.309647382701268,37.813232905901884,0.06779871117286507,139.79134225845337,67.98522782325745,130.55060577392578,2963,739,2224,2224,0,11,1076000.0
1076,1076999,21.32435818120581,37.84504653789409,0.06767141068407356,139.9377956390381,68.0494749546051,130.54505157470703,2965,740,2225,2225,0,11,1077000.0
1077,1077999,21.339679772517947,37.8804658430073,0.06761490382036017,140.09040451049805,68.11431074142456,130.6001205444336,2965,740,2225,2225,0,11,1078000.0
1078,1078999,21.35656180119175,37.92920673760301,0.06749186080059022,140.21112203598022,68.1781439781189,130.65459060668945,2965,740,2225,2225,0,11,1079000.0
1079,1079999,21.374370611614953,37.974492830934864,0.06746380260101603,140.35260772705078,68.24252271652222,130.68096923828125,2965,740,2225,2225,0,11,1080000.0
1080,1080999,21.395855464890857,38.030483956147584,0.06735444271802782,140.4848279953003,68.30631351470947,130.6412467956543,2969,742,2227,2227,0,11,1081000.0
1081,1081999,21.416352257838366,38.09757384772134,0.06732105158639623,140.62683248519897,68.37063384056091,130.70122146606445,2969,742,2227,2227,0,11,1082000.0
1082,1082999,21.421395640024322,38.109423254870194,0.06724685796521512,140.74373364448547,68.43426060676575,131.0004653930664,2970,742,2228,2228,0,11,1083000.0
1083,1083999,21.42168191457929,38.11237427656418,0.06713283935538494,140.8776204586029,68.49921560287476,131.17729949951172,2970,742,2228,2228,0,11,1084000.0
1084,1084999,21.423116495845164,38.127274694700965,0.06700871498773053,141.01341152191162,68.56352114677429,131.23136520385742,2972,743,2229,2229,0,11,1085000.0
1085,1085999,21.424913104366933,38.134380846753395,0.06687564740392316,141.15847754478455,68.62726950645447,131.28372192382812,2974,744,2230,2230,0,11,1086000.0
1086,1086999,21.425365692597396,38.13585304763532,0.06685084378946249,141.28376698493958,68.690908908844,131.36260223388672,2974,744,2230,2230,0,11,1087000.0
1087,1087999,21.427877816809914,38.15704018967635,0.06673715398701119,141.42236423492432,68.7552101612091,131.40569686889648,2976,745,2231,2231,0,11,1088000.0
1088,1088999,21.431709643398822,38.16314832490203,0.06670220174615904,141.55049395561218,68.81950068473816,131.4665641784668,2976,745,2231,2231,0,11,1089000.0
1089,1089999,21.435028108908114,38.167390816948085,0.0666677211727057,141.68739485740662,68.88359260559082,131.54014587402344,2976,745,2231,2231,0,11,1090000.0
1090,1090999,21.440017378842565,38.17790073279104,0.066646955095638,141.81362748146057,68.94755172729492,131.5890007019043,2976,745,2231,2231,0,11,1091000.0
1091,1091999,21.447277793475656,38.19177697533227,0.06664074619766003,141.94217681884766,69.01163506507874,131.61853790283203,2976,745,2231,2231,0,11,1092000.0
1092,1092999,21.455153184591055,38.20274732140636,0.06669562518945482,142.09335589408875,69.07581400871277,131.6766128540039,2976,745,2231,2231,0,11,1093000.0
1093,1093999,21.462367629199303,38.2160413815499,0.0667826169553064,142.23213815689087,69.13993072509766,131.65297317504883,2978,746,2232,2232,0,11,1094000.0
1094,1094999,21.47033905373181,38.226928482049324,0.06680130306533671,142.36773490905762,69.20411682128906,131.69619369506836,2978,746,2232,2232,0,11,1095000.0
1095,1095999,21.479986332747142,38.25534220955254,0.06686462950704886,142.49982070922852,69.26853775978088,131.68401718139648,2980,747,2233,2233,0,11,1096000.0
1096,1096999,21.490972464594794,38.273926741572915,0.06697656953297015,142.6478567123413,69.33287930488586,131.71810913085938,2980,747,2233,2233,0,11,1097000.0
1097,1097999,21.500626315272108,38.28675255078465,0.06707399580082896,142.77134251594543,69.39714741706848,131.76675415039062,2980,747,2233,2233,0,11,1098000.0
1098,1098999,21.508710497489464,38.296171130053885,0.0671934432881397,142.89635396003723,69.46114325523376,131.8133316040039,2980,747,2233,2233,0,11,1099000.0
1099,1099999,21.518085992389015,38.30724293066524,0.06725782022170945,143.03273463249207,69.52583384513855,131.8095245361328,2982,748,2234,2234,0,11,1100000.0
1100,1100999,21.524869731750908,38.3132347819403,0.06731124220224749,143.17491221427917,69.59001731872559,131.85056686401367,2982,748,2234,2234,0,11,1101000.0
1101,1101999,21.52987462306233,38.31581807105727,0.06736548633055672,143.30453252792358,69.65418839454651,131.9027557373047,2982,748,2234,2234,0,11,1102000.0
1102,1102999,21.528148194759737,38.312693898642266,0.0673351856817399,143.44746804237366,69.7188048362732,132.09680557250977,2985,749,2236,2236,0,11,1103000.0
1103,1103999,21.52378700020016,38.311100039879335,0.06729248360679807,143.58019256591797,69.78234910964966,132.18840789794922,2985,749,2236,2236,0,11,1104000.0
1104,1104999,21.51907929233473,38.304450624324986,0.06726177246336862,143.7260148525238,69.84607362747192,132.2148094177246,2987,750,2237,2237,0,11,1105000.0
1105,1105999,21.51598208067839,38.30020828816895,0.0673177540877038,143.85491585731506,69.90946578979492,132.2890396118164,2987,750,2237,2237,0,11,1106000.0
1106,1106999,21.514507500223424,38.29891329294946,0.06734115313950972,143.98137784004211,69.9741849899292,132.3583106994629,2987,750,2237,2237,0,11,1107000.0
1107,1107999,21.51156104534067,38.29321599074398,0.06740851166949446,144.11666321754456,70.03795218467712,132.47085571289062,2987,750,2237,2237,0,11,1108000.0
1108,1108999,21.509515830255868,38.29048487034391,0.0673815134208009,144.24861478805542,70.10160803794861,132.50671768188477,2987,750,2237,2237,0,11,1109000.0
1109,1109999,21.506067057595295,38.28385351175038,0.06742433473000942,144.38336944580078,70.16539740562439,132.54402542114258,2987,750,2237,2237,0,11,1110000.0
1110,1110999,21.502087832969973,38.27576451367848,0.06743045474011444,144.5218539237976,70.22915434837341,132.58023834228516,2987,750,2237,2237,0,11,1111000.0
1111,1111999,21.50043284325576,38.27108976250994,0.0674386442762751,144.6448574066162,70.29265999794006,132.60633087158203,2987,750,2237,2237,0,11,1112000.0
1112,1112999,21.500496213050564,38.26991399868267,0.06745888973533076,144.7887578010559,70.35647058486938,132.63399124145508,2987,750,2237,2237,0,11,1113000.0
1113,1113999,21.496690301623527,38.26273173377629,0.06748079790721206,144.91701555252075,70.42039585113525,132.65855026245117,2987,750,2237,2237,0,11,1114000.0
1114,1114999,21.4964886325619,38.2628697376342,0.0674553351920959,145.03777384757996,70.4845175743103,132.67755889892578,2987,750,2237,2237,0,11,1115000.0
1115,1115999,21.49455471002127,38.256171732905436,0.06741327005761533,145.19018244743347,70.54906916618347,132.65408325195312,2989,751,2238,2238,0,11,1116000.0
1116,1116999,21.49294896064681,38.25289167037694,0.06737428123182287,145.33040046691895,70.61356115341187,132.67074584960938,2989,751,2238,2238,0,11,1117000.0
1117,1117999,21.491372416763234,38.246725478334405,0.06731117823160049,145.46984338760376,70.67775416374207,132.69140243530273,2989,751,2238,2238,0,11,1118000.0
1118,1118999,21.48927669256385,38.240300346566464,0.06726195279329827,145.60726356506348,70.74153280258179,132.72532272338867,2989,751,2238,2238,0,11,1119000.0
1119,1119999,21.48632339646756,38.23314496233062,0.06721562842088147,145.7345051765442,70.80553936958313,132.73288345336914,2991,752,2239,2239,0,11,1120000.0
1120,1120999,21.483945048180153,38.2267359356632,0.06718399448479961,145.86789679527283,70.86940813064575,132.7471160888672,2991,752,2239,2239,0,11,1121000.0
1121,1121999,21.480057969417807,38.21763073418327,0.06713880012302453,145.9968123435974,70.9331865310669,132.76544189453125,2991,752,2239,2239,0,11,1122000.0
1122,1122999,21.478140987914028,38.21042809460709,0.06706684679402486,146.1574306488037,70.99715614318848,132.80076599121094,2995,754,2241,2241,0,11,1123000.0
1123,1123999,21.476653324335096,38.21035069234526,0.06693453889033485,146.3073799610138,71.06175565719604,132.89685821533203,2997,755,2242,2242,0,11,1124000.0
1124,1124999,21.471624606085232,38.204078962884935,0.06691750235710392,146.44424533843994,71.12600803375244,133.04938507080078,2997,755,2242,2242,0,11,1125000.0
1125,1125999,21.46826710890177,38.19797602627737,0.06689257854244579,146.56994652748108,71.19034719467163,133.09359741210938,2999,756,2243,2243,0,11,1126000.0
1126,1126999,21.463843392988952,38.1926110887292,0.06688014467101655,146.72027397155762,71.25464677810669,133.4018898010254,3063,758,2305,2305,0,11,1127000.0
1127,1127999,21.458790172008403,38.18319261044135,0.06686100597540989,146.86756443977356,71.31956577301025,134.0631217956543,3065,759,2306,2306,0,11,1128000.0
1128,1128999,21.45460358565207,38.173355000791105,0.06684354728152586,147.00535559654236,71.38401508331299,134.37075805664062,3065,759,2306,2306,0,11,1129000.0
1129,1129999,21.450261396935502,38.165685551617386,0.06682730775391599,147.13948822021484,71.44856476783752,134.57497787475586,3065,759,2306,2306,0,11,1130000.0
1130,1130999,21.44699934800749,38.162971295004326,0.0667702741589924,147.27047109603882,71.51280641555786,134.7538185119629,3065,759,2306,2306,0,11,1131000.0
1131,1131999,21.442254544575245,38.153452375999485,0.06675480464133787,147.3984067440033,71.57696628570557,134.88165283203125,3065,759,2306,2306,0,11,1132000.0
1132,1132999,21.437713998590667,38.143824257768976,0.06676349014942773,147.5214729309082,71.64075994491577,134.9791488647461,3065,759,2306,2306,0,11,1133000.0
1133,1133999,21.434390912161952,38.13570700080453,0.06674213932053985,147.66764330863953,71.7053747177124,135.02990341186523,3067,760,2307,2307,0,11,1134000.0
1134,1134999,21.430458270089755,38.12739389124693,0.0667269074832385,147.81386303901672,71.76961064338684,135.12595748901367,3067,760,2307,2307,0,11,1135000.0
1135,1135999,21.427958923721082,38.12283471307846,0.06667380057841588,147.93119263648987,71.83365964889526,135.1877670288086,3067,760,2307,2307,0,11,1136000.0
1136,1136999,21.425388514855747,38.11897109909568,0.06661820926441109,148.06251049041748,71.8976719379425,135.33340454101562,3067,760,2307,2307,0,11,1137000.0
1137,1137999,21.421355428949646,38.10890677385667,0.06660063573124064,148.1993124485016,71.96194648742676,135.3938102722168,3067,760,2307,2307,0,11,1138000.0
1138,1138999,21.420050986850555,38.105674734565554,0.06656908684316831,148.33495783805847,72.02573990821838,135.44911575317383,3067,760,2307,2307,0,11,1139000.0
1139,1139999,21.41781248702579,38.09844209474418,0.06655263028798009,148.45673513412476,72.08962845802307,135.55475616455078,3067,760,2307,2307,0,11,1140000.0
1140,1140999,21.417378528759336,38.09401884345081,0.06651771840320553,148.59958052635193,72.15380525588989,135.6185531616211,3067,760,2307,2307,0,11,1141000.0
1141,1141999,21.415042296698754,38.086746909090365,0.06652994803694456,148.7502956390381,72.21877837181091,135.67535781860352,3067,760,2307,2307,0,11,1142000.0
1142,1142999,21.413251500814265,38.08056107668051,0.06649979258549821,148.86575174331665,72.28295350074768,135.76494979858398,3067,760,2307,2307,0,11,1143000.0
1143,1143999,21.415229922824956,38.08409052314571,0.06642517857954366,148.98830437660217,72.3456335067749,135.84362411499023,3067,760,2307,2307,0,11,1144000.0
1144,1144999,21.418254582023884,38.08797361361399,0.06634812523950406,149.10887169837952,72.40786004066467,135.85984420776367,3067,760,2307,2307,0,11,1145000.0
1145,1145999,21.420552245680707,38.08874022261462,0.06631974297858012,149.2492778301239,72.47025632858276,135.83025741577148,3070,761,2309,2309,0,11,1146000.0
1146,1146999,21.425693457570915,38.09907110284089,0.06625218965820945,149.38561081886292,72.53339147567749,135.90623092651367,3071,761,2310,2310,0,11,1147000.0
1147,1147999,21.42786678565224,38.10477289749615,0.06619954549954998,149.52405977249146,72.59630036354065,135.85089111328125,3104,763,2341,2341,0,11,1148000.0
1148,1148999,21.432519505037128,38.114220390055635,0.06618807004954874,149.66784834861755,72.65955543518066,135.94127655029297,3105,763,2342,2342,0,11,1149000.0
1149,1149999,21.43942197527663,38.128797219090536,0.06621287137929277,149.79331016540527,72.72211408615112,135.96067428588867,3105,763,2342,2342,0,11,1150000.0
1150,1150999,21.448652747896062,38.15275080176524,0.06621504085675844,149.92878603935242,72.78528571128845,135.88280487060547,3107,764,2343,2343,0,11,1151000.0
1151,1151999,21.455640679320357,38.16167100863269,0.06630453420649829,150.0669400691986,72.84861946105957,135.93353271484375,3107,764,2343,2343,0,11,1152000.0
1152,1152999,21.466009549962248,38.186345828390344,0.06635632605004516,150.1972141265869,72.9119701385498,135.9612922668457,3107,764,2343,2343,0,11,1153000.0
1153,1153999,21.479217129274218,38.21201170240456,0.06652199410277326,150.35705256462097,72.97515201568604,135.78007125854492,3113,767,2346,2346,0,11,1154000.0
1154,1154999,21.490355385733803,38.23084445883126,0.06667933435063322,150.4890501499176,73.03971600532532,135.7684326171875,3115,768,2347,2347,0,11,1155000.0
1155,1155999,21.499586782371672,38.24375956810269,0.06688191816326527,150.65119194984436,73.1035225391388,135.5458641052246,3121,771,2350,2350,0,11,1156000.0
1156,1156999,21.51103158258722,38.26068292223705,0.06709151148845205,150.77922821044922,73.16679644584656,135.65879821777344,3121,771,2350,2350,0,11,1157000.0
1157,1157999,21.5251446108831,38.29147384307085,0.0674110208877845,150.91285371780396,73.23067450523376,135.74129104614258,3121,771,2350,2350,0,11,1158000.0
1158,1158999,21.540141319499526,38.32280612276569,0.06767856975124764,151.04784536361694,73.294269323349,135.80677032470703,3121,771,2350,2350,0,11,1159000.0
1159,1159999,21.55596764986462,38.35155202099797,0.068099251927484,151.16552448272705,73.35756993293762,135.8617820739746,3121,771,2350,2350,0,11,1160000.0
1160,1160999,21.569846741962447,38.371346984271945,0.0684100464999925,151.29873919487,73.42098140716553,135.89624786376953,3121,771,2350,2350,0,11,1161000.0
1161,1161999,21.58449135980656,38.39050485935534,0.06885418697819579,151.44719552993774,73.48478293418884,135.87196350097656,3123,772,2351,2351,0,11,1162000.0
1162,1162999,21.596369044637555,38.40830856074039,0.06923660123554265,151.56406164169312,73.54829931259155,135.93133544921875,3123,772,2351,2351,0,11,1163000.0
1163,1163999,21.59868476158293,38.41590654691206,0.06916938314665844,151.6960883140564,73.61145210266113,135.98595809936523,3123,772,2351,2351,0,11,1164000.0
1164,1164999,21.599706018443406,38.42320853499676,0.06909479574702504,151.8167495727539,73.67385983467102,136.00830078125,3123,772,2351,2351,0,11,1165000.0
1165,1165999,21.602049872330625,38.42796921580916,0.06904512790394057,151.98444485664368,73.73847317695618,135.88967895507812,3127,774,2353,2353,0,11,1166000.0
1166,1166999,21.605289497081564,38.43531092923274,0.06900607509976331,152.11530447006226,73.80159711837769,135.95949172973633,3127,774,2353,2353,0,11,1167000.0
1167,1167999,21.608005998384314,38.454957066942576,0.06889801385882832,152.26531982421875,73.86557650566101,135.87635040283203,3131,776,2355,2355,0,11,1168000.0
1168,1168999,21.610824056866218,38.4581487897445,0.06887403561240102,152.39086771011353,73.92874312400818,135.96728134155273,3131,776,2355,2355,0,11,1169000.0
1169,1169999,21.616587513890167,38.46941576356587,0.06883052651326527,152.52920365333557,73.99201846122742,135.91156005859375,3132,777,2355,2355,0,11,1170000.0
1170,1170999,21.622642175137972,38.480471750008384,0.06880487896406595,152.66365718841553,74.05523920059204,135.80340194702148,3136,779,2357,2357,0,11,1171000.0
1171,1171999,21.6271568218614,38.48755402437946,0.06883372560145828,152.79695510864258,74.11870312690735,135.84441757202148,3139,780,2359,2359,0,11,1172000.0
1172,1172999,21.63598572725832,38.504610765655514,0.06904884342923912,152.9671494960785,74.18244624137878,135.85515594482422,3141,781,2360,2360,0,11,1173000.0
1173,1173999,21.647938395849796,38.52900376902309,0.06923562892294544,153.0948736667633,74.24600386619568,135.86040115356445,3143,782,2361,2361,0,11,1174000.0
1174,1174999,21.655536109409645,38.53788041722662,0.06959564177855726,153.2167363166809,74.30958461761475,135.91901779174805,3143,782,2361,2361,0,11,1175000.0
1175,1175999,21.665772755642184,38.55683482955903,0.0698300421474004,153.35958313941956,74.37279272079468,135.88098526000977,3145,783,2362,2362,0,11,1176000.0
1176,1176999,21.676806790601827,38.578890984978194,0.06989895182948502,153.49446773529053,74.43687677383423,135.86376953125,3146,784,2362,2362,0,11,1177000.0
1177,1177999,21.690897472456474,38.60983377501622,0.07014963863685275,153.64799571037292,74.50083470344543,135.72571563720703,3150,786,2364,2364,0,11,1178000.0
1178,1178999,21.700338759858543,38.62200473494241,0.07028101006740106,153.79003381729126,74.56489300727844,135.71769332885742,3152,787,2365,2365,0,11,1179000.0
1179,1179999,21.71163637312979,38.64294919723655,0.07049028413045977,153.92474579811096,74.62892532348633,135.7581787109375,3154,788,2366,2366,0,11,1180000.0
1180,1180999,21.725309702293178,38.66401321499358,0.07084155791109215,154.05754017829895,74.69332337379456,135.79197692871094,3156,789,2367,2367,0,11,1181000.0
1181,1181999,21.735689043117624,38.67468764969132,0.07103449160201403,154.17410039901733,74.75699138641357,135.86646270751953,3156,789,2367,2367,0,11,1182000.0
1182,1182999,21.742319412627936,38.68199150186316,0.07116925147956221,154.3234362602234,74.8206000328064,135.9532814025879,3156,789,2367,2367,0,11,1183000.0
1183,1183999,21.743039294624275,38.68626570685825,0.0710815339887767,154.47148966789246,74.88305521011353,135.93838119506836,3158,790,2368,2368,0,11,1184000.0
1184,1184999,21.743064623208312,38.68494504571242,0.07104986941273728,154.6053111553192,74.94570016860962,135.96449661254883,3159,790,2369,2369,0,11,1185000.0
1185,1185999,21.742824153882417,38.684779117811146,0.07102497491745241,154.74386024475098,75.00834012031555,135.98434448242188,3159,790,2369,2369,0,11,1186000.0
1186,1186999,21.742740835662506,38.68306428765716,0.07099509242798296,154.89390969276428,75.0719268321991,135.9679298400879,3162,791,2371,2371,0,11,1187000.0
1187,1187999,21.741746371874957,38.67885646588283,0.07098866483245736,155.01166081428528,75.13468074798584,135.97157287597656,3165,792,2373,2373,0,11,1188000.0
1188,1188999,21.73993519271748,38.67317084347191,0.07097414580655137,155.17424607276917,75.1984224319458,135.9288330078125,3168,793,2375,2375,0,11,1189000.0
1189,1189999,21.73856029664686,38.66977359748782,0.07095411448517686,155.30286931991577,75.26201677322388,135.98269653320312,3168,793,2375,2375,0,11,1190000.0
1190,1190999,21.737987458623795,38.66825303798054,0.0709204678799833,155.4311444759369,75.3251097202301,136.0215721130371,3168,793,2375,2375,0,11,1191000.0
1191,1191999,21.737825282779596,38.674377117353266,0.0708675532064249,155.5650613307953,75.38811898231506,135.9426040649414,3171,794,2377,2377,0,11,1192000.0
1192,1192999,21.737291666184728,38.669901186437926,0.0708434250019796,155.70110058784485,75.45155167579651,135.9947853088379,3171,794,2377,2377,0,11,1193000.0
1193,1193999,21.73724982309119,38.66614328038736,0.07081742516045197,155.84451937675476,75.51505088806152,136.03039932250977,3171,794,2377,2377,0,11,1194000.0
1194,1194999,21.737201891256444,38.66241791352006,0.07079492474161087,155.9727020263672,75.57872915267944,136.04990768432617,3171,794,2377,2377,0,11,1195000.0
1195,1195999,21.73665208780497,38.65699331020386,0.07079346810380571,156.11919713020325,75.64213037490845,136.35960006713867,3232,795,2437,2437,0,11,1196000.0
1196,1196999,21.73754587939835,38.65362587589755,0.07078277814139655,156.2566113471985,75.70582342147827,136.66425704956055,3232,795,2437,2437,0,11,1197000.0
1197,1197999,21.73719238382854,38.64707801607979,0.0707761409766593,156.3862965106964,75.77103185653687,136.8679542541504,3232,795,2437,2437,0,11,1198000.0
1198,1198999,21.736528414119835,38.641363507657,0.07078201395636008,156.5362479686737,75.83446025848389,136.96699142456055,3234,796,2438,2438,0,11,1199000.0
1199,1199999,21.736637040987812,38.63710261794828,0.07077603987026881,156.6715166568756,75.89757061004639,136.97693634033203,3241,797,2444,2444,0,11,1200000.0
1200,1200999,21.735170404245192,38.63718395624803,0.07072172299246104,156.8326699733734,75.96061491966248,136.9282569885254,3245,799,2446,2446,0,11,1201000.0
1201,1201999,21.735191035120575,38.64469831762784,0.07063130041149712,156.96204328536987,76.02408075332642,136.96636962890625,3245,799,2446,2446,0,11,1202000.0
1202,1202999,21.73420267183316,38.641435041379005,0.07058909893799914,157.1030821800232,76.08817267417908,136.95531845092773,3248,800,2448,2448,0,11,1203000.0
1203,1203999,21.73213670033856,38.63422183665533,0.0705507257503285,157.2254912853241,76.15154695510864,136.98962020874023,3248,800,2448,2448,0,11,1204000.0
1204,1204999,21.729309110615496,38.6298764994286,0.07053899485333137,157.3580720424652,76.21480178833008,137.02561950683594,3248,800,2448,2448,0,11,1205000.0
1205,1205999,21.727587274212276,38.623989208841046,0.0704996663893076,157.5229640007019,76.27900624275208,136.88624572753906,3254,802,2452,2452,0,11,1206000.0
1206,1206999,21.723449038015996,38.615544605207454,0.07048939240899033,157.64558339118958,76.34277606010437,136.94486236572266,3254,802,2452,2452,0,11,1207000.0
1207,1207999,21.71999090494975,38.60617164783183,0.07045115007935365,157.77656984329224,76.40696406364441,136.91741943359375,3257,803,2454,2454,0,11,1208000.0
1208,1208999,21.716598120357276,38.597331441018625,0.070434501130476,157.9364356994629,76.47154712677002,136.88930892944336,3260,804,2456,2456,0,11,1209000.0
1209,1209999,21.713072290069046,38.58775898702477,0.07041725807852561,158.08100008964539,76.53644490242004,136.89714431762695,3262,805,2457,2457,0,11,1210000.0
1210,1210999,21.70921510674536,38.57930958793333,0.07040260470873683,158.20617175102234,76.60037422180176,136.94091415405273,3262,805,2457,2457,0,11,1211000.0
1211,1211999,21.705902676007817,38.57214585389416,0.07038146463983286,158.34017181396484,76.66460919380188,136.92024993896484,3264,806,2458,2458,0,11,1212000.0
1212,1212999,21.70380473224737,38.56682833903019,0.07035017146230715,158.46561527252197,76.72859597206116,136.94695281982422,3264,806,2458,2458,0,11,1213000.0
1213,1213999,21.701474476784767,38.56226498865333,0.07033917234068487,158.61329436302185,76.79239273071289,136.9862823486328,3264,806,2458,2458,0,11,1214000.0
1214,1214999,21.700773101597708,38.558337313968444,0.07028386051635871,158.75260424613953,76.856529712677,136.9349594116211,3266,807,2459,2459,0,11,1215000.0
1215,1215999,21.699084238228355,38.552344648314694,0.0702796748261233,158.88128995895386,76.92030072212219,136.98232650756836,3266,807,2459,2459,0,11,1216000.0
1216,1216999,21.69824265193257,38.548559583360735,0.07026503811734042,158.9994819164276,76.98447251319885,137.0114974975586,3266,807,2459,2459,0,11,1217000.0
1217,1217999,21.69641388997268,38.54275054209612,0.07025078680398844,159.15553784370422,77.04870367050171,137.02931213378906,3266,807,2459,2459,0,11,1218000.0
1218,1218999,21.694561776386923,38.53685896177993,0.07025120953459618,159.28624963760376,77.11299753189087,136.96781539916992,3269,808,2461,2461,0,11,1219000.0
1219,1219999,21.69287017927042,38.53112528458067,0.07025440972693164,159.42551708221436,77.17739367485046,137.0086898803711,3269,808,2461,2461,0,11,1220000.0
1220,1220999,21.692712714334814,38.52943468033025,0.07017235412402223,159.5498309135437,77.24033379554749,137.1308364868164,3270,808,2462,2462,0,11,1221000.0
1221,1221999,21.691445289583726,38.523994549286606,0.07005159746691747,159.7005684375763,77.304607629776,137.1277732849121,3273,809,2464,2464,0,11,1222000.0
1222,1222999,21.68987404545057,38.51910633477891,0.06996621079096865,159.8403172492981,77.36874389648438,137.10507583618164,3276,810,2466,2466,0,11,1223000.0
1223,1223999,21.68725107815682,38.51055371205685,0.06991377190882508,159.96997165679932,77.4328019618988,137.19646453857422,3276,810,2466,2466,0,11,1224000.0
1224,1224999,21.684933601088197,38.502738145011406,0.06985280305782404,160.12274050712585,77.49751734733582,137.14263153076172,3281,812,2469,2469,0,12,1225000.0
1225,1225999,21.682262089423087,38.49403720158247,0.06979918647163408,160.25433206558228,77.56147789955139,137.23319244384766,3281,812,2469,2469,0,12,1226000.0
1226,1226999,21.680792269503957,38.48745385384059,0.06975140505191113,160.39094471931458,77.62636137008667,137.28793716430664,3281,812,2469,2469,0,12,1227000.0
1227,1227999,21.677432974938757,38.478177075496646,0.0697314864210562,160.53280186653137,77.69096255302429,137.22250366210938,3284,813,2471,2471,0,12,1228000.0
1228,1228999,21.674946814942995,38.473440190278396,0.06970005054364614,160.6793086528778,77.75540685653687,137.18461227416992,3287,814,2473,2473,0,12,1229000.0
1229,1229999,21.671546287840457,38.4645607226476,0.06968712292724344,160.8004231452942,77.82018780708313,137.24855041503906,3287,814,2473,2473,0,12,1230000.0
1230,1230999,21.670705012703603,38.46128094692368,0.06968308272994406,160.95119905471802,77.88497519493103,137.304931640625,3287,814,2473,2473,0,12,1231000.0
1231,1231999,21.669059266341986,38.45771534102068,0.06973150405782125,161.08945274353027,77.94945454597473,137.34301376342773,3287,814,2473,2473,0,12,1232000.0
1232,1232999,21.667712190960472,38.452620755457225,0.06972057981977509,161.21230006217957,78.01362085342407,137.3743019104004,3287,814,2473,2473,0,12,1233000.0
1233,1233999,21.666197113085847,38.44826285688164,0.06973382299903108,161.36589121818542,78.0786144733429,137.39039993286133,3287,814,2473,2473,0,12,1234000.0
1234,1234999,21.665311672551667,38.44610123030736,0.06975386460297728,161.49094700813293,78.14332604408264,137.33509063720703,3290,815,2475,2475,0,12,1235000.0
1235,1235999,21.666059820010553,38.44663250809312,0.06977824443654768,161.6258029937744,78.20785403251648,137.3695411682129,3290,815,2475,2475,0,12,1236000.0
1236,1236999,21.66582252916162,38.44388650938227,0.06981022790580493,161.77090668678284,78.27227258682251,137.40615844726562,3290,815,2475,2475,0,12,1237000.0
1237,1237999,21.66562145070609,38.44053104568312,0.0698327334703146,161.89124131202698,78.3367121219635,137.42862701416016,3290,815,2475,2475,0,12,1238000.0
1238,1238999,21.66613907898741,38.43861208374257,0.06987561852297741,162.06611251831055,78.40228176116943,137.40897369384766,3292,816,2476,2476,0,12,1239000.0
1239,1239999,21.665824827408727,38.435219959240385,0.06990177065209835,162.17892026901245,78.46730637550354,137.4629249572754,3292,816,2476,2476,0,12,1240000.0
1240,1240999,21.66478018614781,38.437021646491075,0.0699456140994481,162.32893133163452,78.53188753128052,137.42124938964844,3295,817,2478,2478,0,12,1241000.0
1241,1241999,21.665125274080747,38.433483682752154,0.06973063110565492,162.4672384262085,78.59533405303955,137.53578186035156,3295,817,2478,2478,0,12,1242000.0
1242,1242999,21.661352248700144,38.4255996289268,0.06972685549049318,162.60812401771545,78.65970492362976,137.49203491210938,3298,818,2480,2480,0,12,1243000.0
1243,1243999,21.657334862326728,38.41690193146749,0.06970438778597476,162.73278069496155,78.72349691390991,137.55113983154297,3298,818,2480,2480,0,12,1244000.0
1244,1244999,21.653600318080663,38.40884873576624,0.06969729546971648,162.86672830581665,78.78728675842285,137.51226425170898,3301,819,2482,2482,0,12,1245000.0
1245,1245999,21.649852964184397,38.399614815897046,0.06968535681302068,163.02643013000488,78.85110402107239,137.3886947631836,3307,821,2486,2486,0,12,1246000.0
1246,1246999,21.645553809445385,38.39139426395259,0.0696622326198193,163.1788787841797,78.91577744483948,137.31999588012695,3313,823,2490,2490,0,12,1247000.0
1247,1247999,21.64194422235062,38.38350143733488,0.06964693972859404,163.31171798706055,78.98039317131042,137.32154083251953,3316,824,2492,2492,0,12,1248000.0
1248,1248999,21.63835589503599,38.3759458503724,0.06962175869410714,163.43087935447693,79.04482316970825,137.41175842285156,3316,824,2492,2492,0,12,1249000.0
1249,1249999,21.63445663347291,38.36763704239844,0.06962073813274994,163.57861709594727,79.10930371284485,137.42471313476562,3319,825,2494,2494,0,12,1250000.0
1250,1250999,21.631449480803326,38.36300201258605,0.06960316054783344,163.729261636734,79.17416191101074,137.49602127075195,3319,825,2494,2494,0,12,1251000.0
1251,1251999,21.629085421095567,38.35643718921986,0.06958241443760482,163.8694338798523,79.23873543739319,137.43958282470703,3323,827,2496,2496,0,12,1252000.0
1252,1252999,21.62620756050513,38.35071202937118,0.06956923712304608,164.018901348114,79.3035671710968,137.39525985717773,3327,829,2498,2498,0,12,1253000.0
1253,1253999,21.622749819445122,38.3454644667981,0.06956020036225541,164.16183185577393,79.36810088157654,137.30999755859375,3332,831,2501,2501,0,12,1254000.0
1254,1254999,21.61999169718599,38.33931164989504,0.06955895731089223,164.31281900405884,79.43520998954773,137.34906005859375,3336,833,2503,2503,0,12,1255000.0
1255,1255999,21.617486663754335,38.334179349549835,0.06960929718197262,164.46428656578064,79.50007724761963,137.32465362548828,3370,835,2535,2535,0,12,1256000.0
1256,1256999,21.616279253173136,38.34245272315735,0.069571503421899,164.5886309146881,79.56484603881836,137.42190170288086,3370,835,2535,2535,0,12,1257000.0
1257,1257999,21.614656130381636,38.337866573512805,0.06956955534619691,164.74244952201843,79.62957191467285,137.4804916381836,3372,836,2536,2536,0,12,1258000.0
1258,1258999,21.612891883235786,38.333567109061846,0.06956272231388405,164.85785388946533,79.69404077529907,137.53338241577148,3372,836,2536,2536,0,12,1259000.0
1259,1259999,21.610903349328364,38.32842431838707,0.06957378438789319,164.98436641693115,79.75854849815369,137.5741081237793,3372,836,2536,2536,0,12,1260000.0
1260,1260999,21.609307067946997,38.32279845205622,0.06957112011983546,165.13710951805115,79.82373237609863,137.5108642578125,3374,837,2537,2537,0,12,1261000.0
1261,1261999,21.60625370967251,38.315624955633076,0.0695892806864934,165.2734775543213,79.88860654830933,137.63466262817383,3374,837,2537,2537,0,12,1262000.0
1262,1262999,21.603362731363724,38.30854687204719,0.06958835618664716,165.42579221725464,79.95254731178284,137.64830017089844,3378,838,2540,2540,0,12,1263000.0
1263,1263999,21.600878852307083,38.30197206345555,0.06958178557987926,165.5589475631714,80.0163266658783,137.7209243774414,3380,839,2541,2541,0,12,1264000.0
1264,1264999,21.600207024088366,38.29658355454642,0.06955312177586292,165.67459988594055,80.08016228675842,137.79886627197266,3380,839,2541,2541,0,12,1265000.0
1265,1265999,21.601585196104292,38.29654537182398,0.06952973133333817,165.84745693206787,80.14464664459229,137.72189712524414,3386,841,2545,2545,0,12,1266000.0
1266,1266999,21.60436776838481,38.29846749323397,0.06952545033405921,165.9975869655609,80.20898222923279,137.7117156982422,3388,842,2546,2546,0,12,1267000.0
1267,1267999,21.607047858306455,38.30064505126143,0.06948673482138623,166.11373090744019,80.27267408370972,137.80995178222656,3388,842,2546,2546,0,12,1268000.0
1268,1268999,21.609446137750183,38.30253072229457,0.06947427031921638,166.26042294502258,80.33739495277405,137.76687240600586,3393,844,2549,2549,0,12,1269000.0
1269,1269999,21.612236418425933,38.30479771229491,0.06946640425308781,166.42082118988037,80.40234112739563,137.67026138305664,3399,846,2553,2553,0,12,1270000.0
1270,1270999,21.614891459463966,38.30718390910303,0.06945895116925471,166.5724184513092,80.4674289226532,137.67538452148438,3403,848,2555,2555,0,12,1271000.0
1271,1271999,21.61923536495011,38.31164605676401,0.06942461721062465,166.71459364891052,80.53233003616333,137.67333602905273,3407,850,2557,2557,0,12,1272000.0
1272,1272999,21.622870356850655,38.315463250357396,0.0694565289074126,166.8582203388214,80.59688186645508,137.68259811401367,3410,851,2559,2559,0,12,1273000.0
1273,1273999,21.626019125285556,38.316006995137826,0.06949804819096628,167.0106132030487,80.66373109817505,137.66067504882812,3413,852,2561,2561,0,12,1274000.0
1274,1274999,21.629307856801724,38.31707355672649,0.06953639966122271,167.1426136493683,80.72858190536499,137.73608016967773,3413,852,2561,2561,0,12,1275000.0
1275,1275999,21.632725959910054,38.319375217875546,0.06957286461662993,167.27036690711975,80.79300212860107,137.8217887878418,3413,852,2561,2561,0,12,1276000.0
1276,1276999,21.636991499154973,38.322395673411044,0.06958486590260249,167.4039580821991,80.85783219337463,137.7849998474121,3415,853,2562,2562,0,12,1277000.0
1277,1277999,21.641045702380694,38.32936078869325,0.06962731305312109,167.54042434692383,80.92265510559082,137.8502311706543,3415,853,2562,2562,0,12,1278000.0
1278,1278999,21.645060622732498,38.335949360548355,0.06967053553529734,167.66640448570251,80.98844385147095,137.91411590576172,3415,853,2562,2562,0,12,1279000.0
1279,1279999,21.648338205199405,38.337207141497835,0.06970384081705872,167.80801486968994,81.05316972732544,137.8989028930664,3417,854,2563,2563,0,12,1280000.0
1280,1280999,21.65128171318429,38.33693325875422,0.06981213187869073,167.95742273330688,81.11820411682129,137.94577407836914,3417,854,2563,2563,0,12,1281000.0
1281,1281999,21.652170686864725,38.33378471554412,0.06985479527628513,168.07970452308655,81.18280363082886,138.0060920715332,3417,854,2563,2563,0,12,1282000.0
1282,1282999,21.650404807750068,38.3267714719854,0.06986965198728134,168.22006225585938,81.24766063690186,138.11491775512695,3417,854,2563,2563,0,12,1283000.0
1283,1283999,21.64621653189501,38.319713870001515,0.06984928429373838,168.3832187652588,81.31177377700806,137.9560775756836,3425,857,2568,2568,0,12,1284000.0
1284,1284999,21.640274246124562,38.3111008734139,0.06987699778198253,168.52931547164917,81.3765184879303,137.96914291381836,3428,858,2570,2570,0,12,1285000.0
1285,1285999,21.635996178528952,38.3073316875324,0.06989321524082026,168.66540694236755,81.4407856464386,137.96697235107422,3433,860,2573,2573,0,12,1286000.0
1286,1286999,21.630515460592566,38.29702133124536,0.0699161731224035,168.81186532974243,81.50547623634338,137.94790649414062,3435,861,2574,2574,0,12,1287000.0
1287,1287999,21.624223305339367,38.285913480574585,0.06997396406544998,168.9386384487152,81.56933331489563,138.03940200805664,3435,861,2574,2574,0,12,1288000.0
1288,1288999,21.619184838865117,38.27647890448379,0.06999394182629892,169.076908826828,81.6339340209961,138.1123504638672,3435,861,2574,2574,0,12,1289000.0
1289,1289999,21.614159477559276,38.27349085974068,0.07000401383496391,169.2037582397461,81.69886255264282,138.1504669189453,3435,861,2574,2574,0,12,1290000.0
1290,1290999,21.609164757755906,38.26469042843449,0.07001451884713095,169.34027457237244,81.7635428905487,138.19946670532227,3435,861,2574,2574,0,12,1291000.0
1291,1291999,21.604292315380537,38.25805001862019,0.0700397069949843,169.45975613594055,81.82780885696411,138.22975540161133,3435,861,2574,2574,0,12,1292000.0
1292,1292999,21.60064950714222,38.25623852849136,0.0700423110207985,169.63764548301697,81.89362788200378,138.0939483642578,3443,864,2579,2579,0,12,1293000.0
1293,1293999,21.595758199065138,38.24772680225107,0.07008394086595127,169.76169872283936,81.95826435089111,138.15088272094727,3443,864,2579,2579,0,12,1294000.0
1294,1294999,21.591360433464367,38.24045833673546,0.07010638527299917,169.90685606002808,82.0228943824768,138.19333267211914,3443,864,2579,2579,0,12,1295000.0
1295,1295999,21.58792334077568,38.23603956944418,0.07010358357267543,170.04507780075073,82.08802652359009,138.21807479858398,3443,864,2579,2579,0,12,1296000.0
1296,1296999,21.58434419267136,38.22958174737568,0.07010525280080016,170.19181990623474,82.15282773971558,138.18304443359375,3446,865,2581,2581,0,12,1297000.0
1297,1297999,21.581723304151627,38.22480097081357,0.07011187194331425,170.3166790008545,82.21774697303772,138.21537017822266,3446,865,2581,2581,0,12,1298000.0
1298,1298999,21.579116038103585,38.218869802908735,0.07010498465708304,170.4678406715393,82.2827045917511,138.24755859375,3446,865,2581,2581,0,12,1299000.0
1299,1299999,21.57712820415602,38.21469664401016,0.0700801361977097,170.59030032157898,82.35170817375183,138.28342056274414,3446,865,2581,2581,0,12,1300000.0
1300,1300999,21.574071116495613,38.20895202686066,0.07006780732943485,170.736070394516,82.41628837585449,138.26733779907227,3448,866,2582,2582,0,12,1301000.0
1301,1301999,21.57265128202681,38.206006789769404,0.07004079335740254,170.90053057670593,82.4810483455658,138.16093063354492,3454,868,2586,2586,0,12,1302000.0
1302,1302999,21.57005944376882,38.20074548206254,0.0700232308621539,171.02185440063477,82.54763078689575,138.22053909301758,3454,868,2586,2586,0,12,1303000.0
1303,1303999,21.56609231926788,38.19254599429486,0.0700181051419273,171.1465208530426,82.6120126247406,138.34235382080078,3454,868,2586,2586,0,12,1304000.0
1304,1304999,21.562907442785054,38.18576047302158,0.06998441187916005,171.27649521827698,82.67612266540527,138.3382453918457,3456,869,2587,2587,0,12,1305000.0
1305,1305999,21.558948892437687,38.18099741776441,0.0699788427367195,171.43064951896667,82.74042177200317,138.30041885375977,3462,871,2591,2591,0,12,1306000.0
1306,1306999,21.554228486948553,38.17408085888039,0.07000281215222481,171.5825970172882,82.80510759353638,138.29174041748047,3465,872,2593,2593,0,12,1307000.0
1307,1307999,21.548779151836825,38.1648675716168,0.07002455459508716,171.71647667884827,82.87005829811096,138.32602310180664,3468,873,2595,2595,0,12,1308000.0
1308,1308999,21.543457875301545,38.155572634522755,0.07004777708117349,171.88779067993164,82.94380903244019,138.29920196533203,3474,875,2599,2599,0,12,1309000.0
1309,1309999,21.5384222633347,38.145781198441846,0.07007054984368066,172.01781511306763,83.00846767425537,138.3836898803711,3474,875,2599,2599,0,12,1310000.0
1310,1310999,21.53268389608224,38.13547378079318,0.07008313081666873,172.1667022705078,83.0732855796814,138.36273193359375,3477,876,2601,2601,0,12,1311000.0
1311,1311999,21.528194997838312,38.12889684647929,0.07007351990750699,172.30285954475403,83.13837432861328,138.3517189025879,3479,877,2602,2602,0,12,1312000.0
1312,1312999,21.52335454064136,38.12220681485465,0.07006833592669504,172.44592690467834,83.20329594612122,138.33636093139648,3482,878,2604,2604,0,12,1313000.0
1313,1313999,21.518694009984124,38.11474426780284,0.07006677973273612,172.596595287323,83.27379584312439,138.40447235107422,3482,878,2604,2604,0,12,1314000.0
1314,1314999,21.51395025507493,38.10643271804478,0.0700455569642725,172.7308325767517,83.33856725692749,138.47166061401367,3482,878,2604,2604,0,12,1315000.0
1315,1315999,21.50908579054947,38.09825084005587,0.07005475908850767,172.866929769516,83.40367150306702,138.50967407226562,3482,878,2604,2604,0,12,1316000.0
1316,1316999,21.504492576684,38.08989337312468,0.0700434213470863,172.9900619983673,83.46869230270386,138.53936004638672,3482,878,2604,2604,0,12,1317000.0
1317,1317999,21.50086304564083,38.08273508048728,0.070035337693518,173.14816761016846,83.53867030143738,138.52280807495117,3485,879,2606,2606,0,12,1318000.0
1318,1318999,21.49780581281093,38.08197497261962,0.07001181521930278,173.29197192192078,83.60409688949585,138.45427322387695,3490,881,2609,2609,0,12,1319000.0
1319,1319999,21.49568793890554,38.077180258308296,0.06998172877295894,173.42792057991028,83.66997957229614,138.47618103027344,3493,882,2611,2611,0,12,1320000.0
1320,1320999,21.49452125795052,38.075476909391064,0.06998168575612862,173.5930323600769,83.7353892326355,138.47179794311523,3496,883,2613,2613,0,12,1321000.0
1321,1321999,21.49300790431059,38.07211820223921,0.0699610688786454,173.73176884651184,83.80037951469421,138.5285530090332,3496,883,2613,2613,0,12,1322000.0
1322,1322999,21.49290589988484,38.070521362960484,0.06991177713192631,173.8575954437256,83.86520576477051,138.56298446655273,3496,883,2613,2613,0,12,1323000.0
1323,1323999,21.491141775793015,38.067706965565044,0.06987187974088882,174.02310585975647,83.93076944351196,138.4081153869629,3504,886,2618,2618,0,12,1324000.0
1324,1324999,21.486593262089457,38.05927451746887,0.06988526207465018,174.14565515518188,83.99511909484863,138.57211303710938,3506,887,2619,2619,0,12,1325000.0
1325,1325999,21.482306680569035,38.06028377148004,0.06987035644544715,174.2884442806244,84.05892181396484,138.55172729492188,3509,888,2621,2621,0,12,1326000.0
1326,1326999,21.477134926291352,38.061298005136095,0.06986059102952025,174.43922543525696,84.12478399276733,138.4658546447754,3515,890,2625,2625,0,12,1327000.0
1327,1327999,21.470960459056776,38.05393459386386,0.06988660574727024,174.5670292377472,84.18855118751526,138.56561660766602,3515,890,2625,2625,0,12,1328000.0
1328,1328999,21.465505114219905,38.04899419665099,0.06988712371575789,174.72249937057495,84.25268888473511,138.48299407958984,3521,892,2629,2629,0,12,1329000.0
1329,1329999,21.45913549978455,38.03941705173647,0.06991514914595909,174.84776401519775,84.31726503372192,138.55734252929688,3521,892,2629,2629,0,12,1330000.0
1330,1330999,21.453054939137424,38.03005699799984,0.06994628749570964,175.00448203086853,84.38138103485107,138.4778289794922,3525,894,2631,2631,0,12,1331000.0
1331,1331999,21.446628572283217,38.02094024409809,0.0699672443280216,175.14206266403198,84.44543218612671,138.58644104003906,3525,894,2631,2631,0,12,1332000.0
1332,1332999,21.44054629702072,38.010815659822725,0.06999508770629947,175.29313492774963,84.50983619689941,138.4779930114746,3531,896,2635,2635,0,12,1333000.0
1333,1333999,21.434667221218827,38.00191921914251,0.07002036138001388,175.42185473442078,84.57419753074646,138.54885482788086,3531,896,2635,2635,0,12,1334000.0
1334,1334999,21.430510959333414,37.99651805140372,0.0700181819343978,175.5488405227661,84.63851523399353,138.61101913452148,3531,896,2635,2635,0,12,1335000.0
1335,1335999,21.427459642337347,37.99502951703399,0.0699930442286345,175.68497824668884,84.70277142524719,138.65768432617188,3531,896,2635,2635,0,12,1336000.0
1336,1336999,21.42453758358957,37.99060599872903,0.06998783071855141,175.817400932312,84.76662087440491,138.6989974975586,3531,896,2635,2635,0,12,1337000.0
1337,1337999,21.4212461200697,37.98512366329549,0.06999012644868707,175.93310284614563,84.83028292655945,138.74921798706055,3531,896,2635,2635,0,12,1338000.0
1338,1338999,21.42051283064571,37.98444690872317,0.0699756128146749,176.08577466011047,84.89421200752258,138.72647857666016,3533,897,2636,2636,0,12,1339000.0
1339,1339999,21.41909487462319,37.98532403922253,0.06996135741731846,176.2456431388855,84.95884990692139,138.6559181213379,3539,900,2639,2639,0,12,1340000.0
1340,1340999,21.416815510180086,37.98204970993399,0.06995893888281879,176.38587975502014,85.02361035346985,138.64917755126953,3541,901,2640,2640,0,12,1341000.0
1341,1341999,21.41350118472167,37.975034298742905,0.06998100264357499,176.5288541316986,85.08849143981934,138.6068229675293,3545,903,2642,2642,0,12,1342000.0
1342,1342999,21.410386324977438,37.96825911195255,0.06995572587997656,176.6694986820221,85.1528172492981,138.77146911621094,3545,903,2642,2642,0,12,1343000.0
1343,1343999,21.40680148664714,37.96246640117759,0.06992760831671108,176.79417419433594,85.21752262115479,138.82538604736328,3545,903,2642,2642,0,12,1344000.0
1344,1344999,21.403016621983053,37.955296310125526,0.06992037361753989,176.94060254096985,85.28228688240051,138.7752571105957,3550,905,2645,2645,0,12,1345000.0
1345,1345999,21.400294703575575,37.95566188949531,0.06986688485738812,177.08340573310852,85.34716463088989,138.7225112915039,3553,906,2647,2647,0,12,1346000.0
1346,1346999,21.39695688369816,37.94869148619833,0.0698720102708067,177.2077398300171,85.4120237827301,138.8083152770996,3553,906,2647,2647,0,12,1347000.0
1347,1347999,21.39427790443027,37.941854096903334,0.06986786920615107,177.35474824905396,85.47714281082153,138.70783615112305,3558,908,2650,2650,0,12,1348000.0
1348,1348999,21.391090752216137,37.934787750180405,0.06986025914955529,177.50585412979126,85.54243898391724,138.7880744934082,3558,908,2650,2650,0,12,1349000.0
1349,1349999,21.38922038362544,37.93252325952004,0.06983876991589,177.64705681800842,85.60718607902527,138.81156539916992,3560,909,2651,2651,0,12,1350000.0
1350,1350999,21.387705793278965,37.93240483233893,0.06981475727711273,177.77819919586182,85.67213129997253,138.85857391357422,3560,909,2651,2651,0,12,1351000.0
1351,1351999,21.385394190844096,37.92647012044129,0.06980379267671688,177.9024691581726,85.73683595657349,138.90059280395508,3560,909,2651,2651,0,12,1352000.0
1352,1352999,21.38254858239367,37.91934535001352,0.06978355817950865,178.06110000610352,85.80171632766724,138.8069190979004,3565,911,2654,2654,0,12,1353000.0
1353,1353999,21.38060229636825,37.91554249014942,0.06976823023396794,178.19898772239685,85.8668737411499,138.8614730834961,3565,911,2654,2654,0,12,1354000.0
1354,1354999,21.379793745012233,37.92211877903095,0.069724100059667,178.34806871414185,85.93194484710693,138.90042114257812,3565,911,2654,2654,0,12,1355000.0
1355,1355999,21.378573862660662,37.917594659490085,0.06970519320832369,178.48424625396729,86.00472950935364,138.93817901611328,3565,911,2654,2654,0,12,1356000.0
1356,1356999,21.376801339255636,37.91302733367526,0.06969565641963904,178.64062452316284,86.06961393356323,138.90928268432617,3568,912,2656,2656,0,12,1357000.0
1357,1357999,21.377588501321746,37.9199035481114,0.06964652108329183,178.77017641067505,86.13452124595642,138.95647430419922,3568,912,2656,2656,0,12,1358000.0
1358,1358999,21.377267838439607,37.917185463348794,0.06960558355820634,178.8923270702362,86.1994116306305,139.00400161743164,3568,912,2656,2656,0,12,1359000.0
1359,1359999,21.37676594949395,37.91405653509416,0.06958620904899071,179.04786229133606,86.26460886001587,139.02230072021484,3568,912,2656,2656,0,12,1360000.0
1360,1360999,21.37607692784557,37.90983835334524,0.06956834097686826,179.17343187332153,86.32955384254456,139.04522323608398,3568,912,2656,2656,0,12,1361000.0
1361,1361999,21.37464193892774,37.90419599618415,0.06954033386989034,179.30939626693726,86.39468145370483,139.07520294189453,3568,912,2656,2656,0,12,1362000.0
1362,1362999,21.376848384564397,37.90514588022767,0.06934927566264582,179.44432640075684,86.45968532562256,139.1692657470703,3568,912,2656,2656,0,12,1363000.0
1363,1363999,21.378137653217344,37.90420557901132,0.06914252001222021,179.5742552280426,86.52388405799866,139.227294921875,3568,912,2656,2656,0,12,1364000.0
1364,1364999,21.380321278816638,37.9065910581287,0.06895161511958303,179.69544291496277,86.5880856513977,139.26657104492188,3568,912,2656,2656,0,12,1365000.0
1365,1365999,21.38266577632261,37.90719380844676,0.06876551621863392,179.85953164100647,86.65271520614624,139.05940628051758,3577,915,2662,2662,0,12,1366000.0
1366,1366999,21.384122544007457,37.90618511831808,0.06864345269121508,180.0157926082611,86.71789932250977,138.89902877807617,3585,918,2667,2667,0,12,1367000.0
1367,1367999,21.38798122965013,37.909538679872455,0.06853831767471008,180.14946341514587,86.78282117843628,138.94137573242188,3588,919,2669,2669,0,12,1368000.0
1368,1368999,21.38951998027692,37.909287661923806,0.06842471689085017,180.29822897911072,86.84857606887817,138.98220825195312,3590,920,2670,2670,0,12,1369000.0
1369,1369999,21.391402045369357,37.909946425900486,0.06835324027092093,180.47269105911255,86.9139518737793,138.80010223388672,3599,923,2676,2676,0,12,1370000.0
1370,1370999,21.392118448317728,37.90723289179328,0.06833196703655686,180.6094708442688,86.97934007644653,138.85963821411133,3602,924,2678,2678,0,12,1371000.0
1371,1371999,21.392250873695136,37.904003514120106,0.06826197102310039,180.77080130577087,87.06289863586426,138.96295547485352,3602,924,2678,2678,0,12,1372000.0
1372,1372999,21.393135033436355,37.903016865017705,0.06823079283273625,180.91933178901672,87.12824392318726,139.00095748901367,3605,925,2680,2680,0,12,1373000.0
1373,1373999,21.393328851187366,37.90039407679602,0.06816093820105962,181.05912518501282,87.1933662891388,139.06756210327148,3608,926,2682,2682,0,12,1374000.0
1374,1374999,21.393623436115323,37.899138689907744,0.06814613752350929,181.19303560256958,87.25893187522888,139.08087158203125,3611,927,2684,2684,0,12,1375000.0
1375,1375999,21.392680774277043,37.893490225517,0.06809374256714962,181.33103919029236,87.32425928115845,139.0966911315918,3614,928,2686,2686,0,12,1376000.0
1376,1376999,21.39136314716288,37.88904562043811,0.06808716007045745,181.50903177261353,87.39028573036194,139.3957290649414,3673,931,2742,2742,0,12,1377000.0
1377,1377999,21.390725302687265,37.885042141703465,0.06809626630091836,181.6743564605713,87.45625114440918,139.50628662109375,3679,933,2746,2746,0,12,1378000.0
1378,1378999,21.39045616414676,37.88346905457973,0.06808473296146245,181.81399655342102,87.52214121818542,139.7821922302246,3679,933,2746,2746,0,12,1379000.0
1379,1379999,21.38954985052622,37.87808640913187,0.06807951960548708,181.96186470985413,87.587717294693,139.89861297607422,3682,934,2748,2748,0,12,1380000.0
1380,1380999,21.388403028710343,37.87233323888214,0.0681093002135239,182.0920581817627,87.65336084365845,140.05070114135742,3682,934,2748,2748,0,12,1381000.0
1381,1381999,21.386263700002377,37.86521773821814,0.06809362356593229,182.211829662323,87.71872758865356,140.13846969604492,3682,934,2748,2748,0,12,1382000.0
1382,1382999,21.383692050011632,37.857771178211024,0.06807482833937062,182.35968351364136,87.78415846824646,140.2298927307129,3685,935,2750,2750,0,12,1383000.0
1383,1383999,21.381356638530853,37.852681842161324,0.06804897786482322,182.50433540344238,87.84973239898682,140.36037063598633,3685,935,2750,2750,0,12,1384000.0
1384,1384999,21.38065857128956,37.84719698988872,0.06792227107084858,182.63338232040405,87.91390299797058,140.3240737915039,3688,936,2752,2752,0,12,1385000.0
1385,1385999,21.37892622878451,37.841830775845004,0.06785200463421903,182.8069474697113,87.97882533073425,140.05791091918945,3700,940,2760,2760,0,12,1386000.0
1386,1386999,21.37703503250015,37.837941973346496,0.06777798235230703,182.93290829658508,88.04762077331543,140.21448135375977,3700,940,2760,2760,0,12,1387000.0
1387,1387999,21.374053781216134,37.830416632693364,0.06772430386193717,183.09199333190918,88.11317014694214,140.10808944702148,3708,943,2765,2765,0,12,1388000.0
1388,1388999,21.371722436426737,37.82413412468626,0.06769061838050994,183.24406385421753,88.17821455001831,140.1061248779297,3714,945,2769,2769,0,12,1389000.0
1389,1389999,21.3673788939656,37.81547123030189,0.0677008830639021,183.3888862133026,88.24365162849426,140.15735626220703,3719,947,2772,2772,0,12,1390000.0
1390,1390999,21.3632757854277,37.80699900562599,0.06771036073095238,183.51863527297974,88.30852699279785,140.27066802978516,3719,947,2772,2772,0,12,1391000.0
1391,1391999,21.359408924677936,37.79984107457401,0.06771230054375599,183.65257334709167,88.37362623214722,140.36959838867188,3719,947,2772,2772,0,12,1392000.0
1392,1392999,21.355891836320385,37.7921327921866,0.06770553590909023,183.79481315612793,88.43885803222656,140.34266662597656,3722,948,2774,2774,0,12,1393000.0
1393,1393999,21.352226020816953,37.78516479653476,0.06770510493749005,183.95873165130615,88.50422835350037,140.2766990661621,3726,950,2776,2776,0,12,1394000.0
1394,1394999,21.349862068560835,37.78213227662639,0.06766618659422674,184.09537982940674,88.56980466842651,140.33646392822266,3729,951,2778,2778,0,12,1395000.0
1395,1395999,21.34947570255936,37.785696407077104,0.06758115747905657,184.23033237457275,88.63543748855591,140.4041976928711,3729,951,2778,2778,0,12,1396000.0
1396,1396999,21.35204051098567,37.79448056956013,0.06748820349206763,184.37809467315674,88.70062708854675,140.43277740478516,3731,952,2779,2779,0,12,1397000.0
1397,1397999,21.355370755459884,37.80514005772942,0.06738718281660505,184.50213766098022,88.76598191261292,140.52421188354492,3731,952,2779,2779,0,12,1398000.0
1398,1398999,21.359098050716664,37.81526636865694,0.06732784382260304,184.65080213546753,88.8315577507019,140.52260208129883,3733,953,2780,2780,0,12,1399000.0
1399,1399999,21.361300186598385,37.817527140875946,0.06735139731639461,184.78859663009644,88.89658808708191,140.5121955871582,3737,955,2782,2782,0,12,1400000.0
1400,1400999,21.365731220371146,37.82661080318693,0.06734894947514247,184.93835258483887,88.96197962760925,140.5272331237793,3740,956,2784,2784,0,12,1401000.0
1401,1401999,21.367367618415322,37.82807020603183,0.06734815397189331,185.11051726341248,89.0284149646759,140.44004440307617,3746,959,2787,2787,0,13,1402000.0
1402,1402999,21.369407168363495,37.82977307204204,0.067383672033975,185.24506974220276,89.09452795982361,140.51219940185547,3748,960,2788,2788,0,13,1403000.0
1403,1403999,21.37012437815688,37.83231469696872,0.06738873553849412,185.418030500412,89.16013360023499,140.36486053466797,3760,964,2796,2796,0,13,1404000.0
1404,1404999,21.372732440867146,37.82897869911684,0.06717677470754668,185.54345417022705,89.22401165962219,140.5091896057129,3760,964,2796,2796,0,13,1405000.0
1405,1405999,21.37805173324137,37.82679924132105,0.06687548583786351,185.7038860321045,89.28860020637512,140.50153732299805,3763,965,2798,2798,0,13,1406000.0
1406,1406999,21.38097377184774,37.82275774626836,0.06664832148843447,185.85157465934753,89.35344552993774,140.3965835571289,3771,968,2803,2803,0,13,1407000.0
1407,1407999,21.382603279612482,37.81936475682799,0.06645160720771015,185.9804561138153,89.4183874130249,140.41959762573242,3774,969,2805,2805,0,13,1408000.0
1408,1408999,21.382218458836142,37.81374107324751,0.06632320114243262,186.18469166755676,89.48384714126587,139.99755477905273,3795,976,2819,2819,0,13,1409000.0
1409,1409999,21.3808053109308,37.809167892699485,0.06618017767040085,186.3316457271576,89.54884886741638,140.1392822265625,3798,977,2821,2821,0,13,1410000.0
1410,1410999,21.378661434397806,37.802316313181805,0.06609848790917527,186.452246427536,89.61400032043457,140.2431182861328,3798,977,2821,2821,0,13,1411000.0
1411,1411999,21.37734694662766,37.79742566404956,0.06599733871004998,186.58476972579956,89.67879438400269,140.32812881469727,3798,977,2821,2821,0,13,1412000.0
1412,1412999,21.375164690012923,37.794214722712596,0.06589106981372583,186.7480435371399,89.74471306800842,140.20863342285156,3806,980,2826,2826,0,13,1413000.0
1413,1413999,21.373639352807135,37.79127319393009,0.06580925015542083,186.88949131965637,89.81006598472595,140.15432357788086,3812,982,2830,2830,0,13,1414000.0
1414,1414999,21.374729829172974,37.80038103981846,0.06577877426695677,187.0545425415039,89.87616467475891,140.18479919433594,3818,984,2834,2834,0,13,1415000.0
1415,1415999,21.376376066658132,37.815557833759286,0.06567776016050253,187.18882751464844,89.94164371490479,140.27830505371094,3821,985,2836,2836,0,13,1416000.0
1416,1416999,21.377005768875307,37.81880126280663,0.06567572304044722,187.35884928703308,90.00811243057251,140.16826629638672,3831,989,2842,2842,0,13,1417000.0
1417,1417999,21.379590324967445,37.82910847479027,0.06568583621591306,187.49568676948547,90.07392430305481,140.32574462890625,3831,989,2842,2842,0,13,1418000.0
1418,1418999,21.38211382653109,37.838602319649475,0.0656892847644982,187.6335256099701,90.14023566246033,140.39385223388672,3834,990,2844,2844,0,13,1419000.0
1419,1419999,21.38359986235916,37.841989579893855,0.0657027950729967,187.80276036262512,90.20619106292725,140.29759216308594,3841,993,2848,2848,0,13,1420000.0
1420,1420999,21.388880572109276,37.859236931296415,0.06570538526720016,187.94165468215942,90.27187037467957,140.35336685180664,3843,994,2849,2849,0,13,1421000.0
1421,1421999,21.39372941278604,37.86847143900444,0.06573412042977023,188.0682852268219,90.33741497993469,140.42897033691406,3843,994,2849,2849,0,13,1422000.0
1422,1422999,21.398239119560017,37.87634584830392,0.06573430945755865,188.2176582813263,90.40393018722534,140.42438888549805,3846,995,2851,2851,0,13,1423000.0
1423,1423999,21.403402649230383,37.88564735925035,0.06572398899743115,188.35836935043335,90.47011637687683,140.49388122558594,3846,995,2851,2851,0,13,1424000.0
1424,1424999,21.403904332265682,37.88415263254998,0.06572664784393667,188.49911093711853,90.535635471344,140.52460098266602,3848,996,2852,2852,0,13,1425000.0
1425,1425999,21.414412593603448,37.89697353732096,0.0651179124037311,188.63666462898254,90.6003303527832,140.6796646118164,3848,996,2852,2852,0,13,1426000.0
1426,1426999,21.424006365298062,37.90439887801608,0.06463051212884308,188.75905966758728,90.66485404968262,140.81050872802734,3848,996,2852,2852,0,13,1427000.0
1427,1427999,21.43170264304401,37.906914402311244,0.06423613610982903,188.88400983810425,90.72929286956787,140.8978614807129,3848,996,2852,2852,0,13,1428000.0
1428,1428999,21.438310491012025,37.91080492305615,0.06387534366604353,189.07065534591675,90.79404902458191,140.5753402709961,3866,1002,2864,2864,0,13,1429000.0
1429,1429999,21.442006373209168,37.91165072343389,0.06361889351354977,189.24479174613953,90.85899472236633,140.42033004760742,3878,1006,2872,2872,0,13,1430000.0
1430,1430999,21.444879380980574,37.91146898174909,0.06333079979115375,189.3616979122162,90.9239501953125,140.57036972045898,3878,1006,2872,2872,0,13,1431000.0
1431,1431999,21.447226175603912,37.910600182413155,0.06312908584516397,189.49209356307983,90.98856329917908,140.59698104858398,3881,1007,2874,2874,0,13,1432000.0
1432,1432999,21.449663496295184,37.91202138434885,0.06280409695142608,189.66844129562378,91.05411219596863,140.45546340942383,3890,1010,2880,2880,0,13,1433000.0
1433,1433999,21.451380275209818,37.91064493441311,0.06260602225970624,189.7895724773407,91.11916589736938,140.5504608154297,3890,1010,2880,2880,0,13,1434000.0
1434,1434999,21.452236484245176,37.90835509619486,0.06248138580018603,189.9326102733612,91.18484377861023,140.5698585510254,3893,1011,2882,2882,0,13,1435000.0
1435,1435999,21.453810072553857,37.90679286251764,0.06231748621224287,190.08045768737793,91.25031447410583,140.56218719482422,3896,1012,2884,2884,0,13,1436000.0
1436,1436999,21.454393922527686,37.9056440377369,0.06222601587518639,190.2135739326477,91.31549024581909,140.5928955078125,3899,1013,2886,2886,0,13,1437000.0
1437,1437999,21.45520129101282,37.90420321985614,0.06209995203900587,190.35230946540833,91.38055109977722,140.55245971679688,3905,1015,2890,2890,0,13,1438000.0
1438,1438999,21.45594123326089,37.90353934766062,0.06206723643302203,190.5118384361267,91.44565963745117,140.5688934326172,3911,1017,2894,2894,0,13,1439000.0
1439,1439999,21.457286355868874,37.902098203761966,0.062067464716239584,190.63864731788635,91.5113308429718,140.66498184204102,3911,1017,2894,2894,0,13,1440000.0
1440,1440999,21.45912087190139,37.90313515601144,0.062091014080009166,190.78678917884827,91.57679581642151,140.6808090209961,3913,1018,2895,2895,0,13,1441000.0
1441,1441999,21.461971882880036,37.905263226516254,0.06209698329409685,190.92741465568542,91.64282608032227,140.78856658935547,3913,1018,2895,2895,0,13,1442000.0
1442,1442999,21.463300408447893,37.90435957548793,0.062098129196175855,191.05947375297546,91.70810961723328,140.8140640258789,3920,1019,2901,2901,0,13,1443000.0
1443,1443999,21.465795443161106,37.90605090717783,0.06210182405248632,191.18748331069946,91.7736406326294,140.86421966552734,3920,1019,2901,2901,0,13,1444000.0
1444,1444999,21.469357351306737,37.91271696045711,0.06211315442076404,191.3297836780548,91.8394365310669,140.88441467285156,3922,1020,2902,2902,0,13,1445000.0
1445,1445999,21.47029321614221,37.91048149751859,0.06210963552841264,191.50911855697632,91.9051160812378,140.80360412597656,3930,1023,2907,2907,0,13,1446000.0
1446,1446999,21.47204239755119,37.909034184981174,0.06197033582168854,191.68138098716736,91.97967767715454,140.79347610473633,3932,1024,2908,2908,0,13,1447000.0
1447,1447999,21.474405307150526,37.91439007876334,0.06183208043165611,191.7965326309204,92.04394698143005,140.8196029663086,3932,1024,2908,2908,0,13,1448000.0
1448,1448999,21.474940944811564,37.910082749644836,0.06172295199592159,191.9240927696228,92.10806560516357,140.80999755859375,3934,1025,2909,2909,0,13,1449000.0
1449,1449999,21.4746693468193,37.909758232600396,0.06167369440389592,192.16217398643494,92.17649054527283,140.26272583007812,3958,1033,2925,2925,0,13,1450000.0
1450,1450999,21.474124669459798,37.90872449203126,0.06163711249043202,192.30141186714172,92.24163484573364,140.34106063842773,3961,1034,2927,2927,0,13,1451000.0
1451,1451999,21.472951906705724,37.908229398617294,0.061589319163126044,192.4440474510193,92.30699300765991,140.40692138671875,3963,1035,2928,2928,0,13,1452000.0
1452,1452999,21.472516305126213,37.90581906700212,0.061543064112735246,192.58705401420593,92.37231421470642,140.38000106811523,3968,1037,2931,2931,0,13,1453000.0
1453,1453999,21.47206557906417,37.92323307432746,0.061445616227831734,192.73892855644226,92.43778824806213,140.3910255432129,3973,1039,2934,2934,0,13,1454000.0
1454,1454999,21.471826037682916,37.92360132436468,0.061418929192233906,192.88359475135803,92.50299096107483,140.4024772644043,3976,1040,2936,2936,0,13,1455000.0
1455,1455999,21.47203547561408,37.92347620177628,0.0613602858597555,193.01005339622498,92.56845998764038,140.4611473083496,3978,1041,2937,2937,0,13,1456000.0
1456,1456999,21.472762629550086,37.93684040052054,0.061313196358483646,193.15736746788025,92.63388752937317,140.52242279052734,3980,1042,2938,2938,0,13,1457000.0
1457,1457999,21.472899782937645,37.93786526817711,0.06129759457718187,193.29821968078613,92.69998860359192,140.6036491394043,3980,1042,2938,2938,0,13,1458000.0
1458,1458999,21.474758856939875,37.95383071271702,0.06122641343565116,193.43071055412292,92.76526856422424,140.67140579223633,3980,1042,2938,2938,0,13,1459000.0
1459,1459999,21.47875944454984,37.97664416059909,0.06114471105295205,193.5576183795929,92.83062648773193,140.7159881591797,3980,1042,2938,2938,0,13,1460000.0
1460,1460999,21.481287171111937,37.99649835827261,0.06105717068337613,193.7095046043396,92.89644527435303,140.7823143005371,3980,1042,2938,2938,0,13,1461000.0
1461,1461999,21.483053003757128,38.001086775656646,0.06100805642482221,193.84906578063965,92.96230697631836,140.7782859802246,3983,1043,2940,2940,0,13,1462000.0
1462,1462999,21.486351977588093,38.0130634619327,0.060909406695174195,193.9943835735321,93.02763271331787,140.78603744506836,3985,1044,2941,2941,0,13,1463000.0
1463,1463999,21.48839739995253,38.01401074843819,0.060848597409504435,194.1358995437622,93.09178519248962,140.87862014770508,3987,1045,2942,2942,0,13,1464000.0
1464,1464999,21.491994941400026,38.02287603929898,0.06072078395800773,194.28339791297913,93.15863823890686,140.80429077148438,3990,1046,2944,2944,0,13,1465000.0
1465,1465999,21.497831830257596,38.038527471629195,0.06055570305940172,194.43011116981506,93.2230179309845,140.8200454711914,3993,1047,2946,2946,0,13,1466000.0
1466,1466999,21.50322393923111,38.050628013767195,0.06043278978698097,194.57387232780457,93.28716826438904,140.74396133422852,3999,1049,2950,2950,0,13,1467000.0
1467,1467999,21.510822941616087,38.068102566490744,0.06040643050997596,194.72327280044556,93.35204696655273,140.74739837646484,4005,1051,2954,2954,0,13,1468000.0
1468,1468999,21.514997063615688,38.07466701704277,0.060384756032125786,194.84668445587158,93.41681742668152,140.801025390625,4005,1051,2954,2954,0,13,1469000.0
1469,1469999,21.520207033878194,38.08278370118104,0.06036287927839057,195.03388333320618,93.48254680633545,140.54785919189453,4016,1055,2961,2961,0,13,1470000.0
1470,1470999,21.526450206522448,38.092892269236266,0.06036878704576254,195.15682411193848,93.54691100120544,140.646484375,4016,1055,2961,2961,0,13,1471000.0
1471,1471999,21.534102089528428,38.10624673067851,0.060429233730235454,195.29413676261902,93.61141443252563,140.71509170532227,4016,1055,2961,2961,0,13,1472000.0
1472,1472999,21.54081096068551,38.12857154714163,0.060476382990347854,195.417893409729,93.67574715614319,140.78266525268555,4016,1055,2961,2961,0,13,1473000.0
1473,1473999,21.5461370095942,38.13571468592567,0.06051091275557641,195.54951333999634,93.7404899597168,140.76825714111328,4018,1056,2962,2962,0,13,1474000.0
1474,1474999,21.55366695275977,38.1503669238146,0.06059395594797534,195.71717500686646,93.80585193634033,140.57818603515625,4024,1058,2966,2966,0,13,1475000.0
1475,1475999,21.561640563232036,38.16665558775453,0.06067929374003056,195.87539267539978,93.87121200561523,140.54936599731445,4030,1060,2970,2970,0,13,1476000.0
1476,1476999,21.569074928721545,38.17851445553604,0.060843934183370196,196.00545620918274,93.9360408782959,140.62926864624023,4030,1060,2970,2970,0,13,1477000.0
1477,1477999,21.57700141032291,38.18799753137867,0.060925647933454785,196.16393733024597,94.00149917602539,140.63214111328125,4036,1062,2974,2974,0,13,1478000.0
1478,1478999,21.582948075558242,38.20507395298051,0.06103119834347881,196.299471616745,94.06610012054443,140.6865692138672,4036,1062,2974,2974,0,13,1479000.0
1479,1479999,21.59143110764002,38.21932185154619,0.06120049843051012,196.42475414276123,94.1311571598053,140.7633514404297,4036,1062,2974,2974,0,13,1480000.0
1480,1480999,21.593472162550825,38.22071634740559,0.061213410876563845,196.54696941375732,94.19486379623413,140.89835739135742,4036,1062,2974,2974,0,13,1481000.0
1481,1481999,21.594087461371164,38.222758574022556,0.0611535505629206,196.6648199558258,94.25881028175354,140.9593963623047,4036,1062,2974,2974,0,13,1482000.0
1482,1482999,21.594274551398577,38.22235753922562,0.06106707626779151,196.79011726379395,94.32270956039429,141.00941467285156,4036,1062,2974,2974,0,13,1483000.0
1483,1483999,21.59300384363179,38.22024295900317,0.061013710882092176,196.94535565376282,94.38733577728271,140.9097671508789,4042,1064,2978,2978,0,13,1484000.0
1484,1484999,21.59329277691377,38.218574398994804,0.06095787641607586,197.0792498588562,94.45217108726501,140.9755630493164,4044,1065,2979,2979,0,13,1485000.0
1485,1485999,21.593139346953233,38.21663189528565,0.06091840803436133,197.20391654968262,94.51648116111755,141.01250457763672,4044,1065,2979,2979,0,13,1486000.0
1486,1486999,21.592475592766,38.21134562628384,0.06086236814749746,197.34936952590942,94.5824966430664,141.04938888549805,4044,1065,2979,2979,0,13,1487000.0
1487,1487999,21.59222640399816,38.208257572395254,0.06082376583408522,197.50478839874268,94.64748120307922,140.93927001953125,4050,1067,2983,2983,0,13,1488000.0
1488,1488999,21.593555903778945,38.209735129603,0.06081048561963276,197.65593647956848,94.71230125427246,140.83892059326172,4058,1070,2988,2988,0,13,1489000.0
1489,1489999,21.594688429851495,38.21514588985341,0.06083940165630286,197.83288431167603,94.77804374694824,140.69893264770508,4066,1073,2993,2993,0,13,1490000.0
1490,1490999,21.595917498692394,38.21706148800135,0.06081397515158238,197.98335814476013,94.84331750869751,140.7033462524414,4069,1074,2995,2995,0,13,1491000.0
1491,1491999,21.5964367441283,38.21597035251728,0.06082252500854646,198.10752773284912,94.90836453437805,140.77615356445312,4069,1074,2995,2995,0,13,1492000.0
1492,1492999,21.597818234996875,38.21726314793331,0.06083788483986341,198.24363470077515,94.97335910797119,140.77616119384766,4072,1075,2997,2997,0,13,1493000.0
1493,1493999,21.599549103345495,38.21831425157907,0.06090648948455202,198.38208961486816,95.03854179382324,140.84643173217773,4072,1075,2997,2997,0,13,1494000.0
1494,1494999,21.602612296782002,38.22160610300266,0.06094749910840391,198.51319932937622,95.10329699516296,140.89752578735352,4072,1075,2997,2997,0,13,1495000.0
1495,1495999,21.606235584218094,38.22644465573038,0.06100592711441333,198.65495347976685,95.16824436187744,140.94297409057617,4072,1075,2997,2997,0,13,1496000.0
1496,1496999,21.608780761696504,38.22648784857357,0.06102494584767526,198.78974509239197,95.2333767414093,140.97961044311523,4072,1075,2997,2997,0,13,1497000.0
1497,1497999,21.61334513048297,38.236328875898536,0.06103121641328535,198.91488432884216,95.29815483093262,140.92678451538086,4075,1076,2999,2999,0,13,1498000.0
1498,1498999,21.61804020687405,38.24094308433914,0.06115252289945905,199.08273935317993,95.36413764953613,140.76404571533203,4083,1079,3004,3004,0,13,1499000.0
1499,1499999,21.62052849685123,38.241889619241924,0.06118711885893657,199.22554540634155,95.42996335029602,140.8624382019043,4083,1079,3004,3004,0,13,1500000.0
1500,1500999,21.62222446788151,38.24977842912358,0.06117723113660356,199.33633828163147,95.49387335777283,140.98060607910156,4083,1079,3004,3004,0,13,1501000.0
1501,1501999,21.622099477111284,38.25536045380734,0.061091638892331934,199.47534441947937,95.55792784690857,141.07451629638672,4083,1079,3004,3004,0,13,1502000.0
1502,1502999,21.62010669355242,38.250797637904434,0.061049924647613496,199.59170532226562,95.62180924415588,141.11824417114258,4083,1079,3004,3004,0,13,1503000.0
1503,1503999,21.61711901401423,38.243957770116616,0.06103556800305143,199.76880431175232,95.68649387359619,140.9069366455078,4092,1082,3010,3010,0,13,1504000.0
1504,1504999,21.614292815007207,38.237848339069295,0.061028929658583086,199.90077018737793,95.75080132484436,140.95378494262695,4094,1083,3011,3011,0,13,1505000.0
1505,1505999,21.612642000941126,38.23796928532133,0.06099312808164059,200.0518615245819,95.81525182723999,140.97289657592773,4097,1084,3013,3013,0,13,1506000.0
1506,1506999,21.610060776665534,38.232711961387146,0.0609869393692144,200.19022178649902,95.88013458251953,141.03561401367188,4097,1084,3013,3013,0,13,1507000.0
1507,1507999,21.60767668134127,38.22828063206332,0.060974726482545094,200.3186662197113,95.9443211555481,141.02793502807617,4100,1085,3015,3015,0,13,1508000.0
1508,1508999,21.605472792057533,38.2228412649825,0.0609572145688021,200.46922993659973,96.00893497467041,141.0300750732422,4103,1086,3017,3017,0,13,1509000.0
1509,1509999,21.602797582695324,38.21719627831999,0.0609532561027073,200.62328243255615,96.07414889335632,140.94088745117188,4107,1088,3019,3019,0,13,1510000.0
1510,1510999,21.600359527372824,38.21114616266584,0.06095770258757749,200.7717764377594,96.13914942741394,140.98043060302734,4110,1089,3021,3021,0,13,1511000.0
1511,1511999,21.598779636777532,38.20891862086988,0.06095363970649126,200.9069902896881,96.2036292552948,141.05558013916016,4110,1089,3021,3021,0,13,1512000.0
1512,1512999,21.59694201239457,38.20591028012775,0.060957621496582126,201.043283700943,96.26848244667053,141.10093307495117,4110,1089,3021,3021,0,13,1513000.0
1513,1513999,21.595906330119142,38.2025473409891,0.06095629558534288,201.18241167068481,96.33346915245056,141.1326675415039,4110,1089,3021,3021,0,13,1514000.0
1514,1514999,21.59516009808736,38.20282208045682,0.060961223250518226,201.32157969474792,96.39818716049194,141.1681251525879,4110,1089,3021,3021,0,13,1515000.0
1515,1515999,21.594732742351948,38.20007011224338,0.06097077564905817,201.4571270942688,96.4630138874054,141.1969451904297,4110,1089,3021,3021,0,13,1516000.0
1516,1516999,21.594367537268422,38.19750558427508,0.06099479298698496,201.61576581001282,96.52758646011353,141.05571365356445,4116,1092,3024,3024,0,13,1517000.0
1517,1517999,21.59530032698569,38.19682607888795,0.06102074837864402,201.74198198318481,96.59395051002502,141.13951110839844,4116,1092,3024,3024,0,13,1518000.0
1518,1518999,21.59722566385383,38.197208694899714,0.061034697603640886,201.91021347045898,96.65877723693848,140.9336395263672,4122,1095,3027,3027,0,13,1519000.0
1519,1519999,21.59886267287872,38.19786117082228,0.06107396931280107,202.07694220542908,96.72439789772034,140.9647445678711,4127,1097,3030,3030,0,13,1520000.0
1520,1520999,21.599375005695943,38.19676668871752,0.0610987977501104,202.19703650474548,96.78908491134644,141.0874252319336,4127,1097,3030,3030,0,13,1521000.0
1521,1521999,21.597728671137254,38.192395427055615,0.061118724896557786,202.32465720176697,96.85297799110413,141.20007705688477,4127,1097,3030,3030,0,13,1522000.0
1522,1522999,21.593594801628537,38.194919039394534,0.061107319988061626,202.44149327278137,96.91679739952087,141.23503494262695,4127,1097,3030,3030,0,13,1523000.0
1523,1523999,21.588347294765533,38.19097774454752,0.061126930684133995,202.58872509002686,96.98136448860168,141.26079177856445,4127,1097,3030,3030,0,13,1524000.0
1524,1524999,21.582344130873974,38.18243939917238,0.0611605826605951,202.72916102409363,97.04568672180176,141.2929573059082,4127,1097,3030,3030,0,13,1525000.0
1525,1525999,21.577019021866064,38.173995836736346,0.061188046028376464,202.85068321228027,97.10935115814209,141.32038116455078,4127,1097,3030,3030,0,13,1526000.0
1526,1526999,21.572325234746856,38.16714705151564,0.06120987896401009,202.99553894996643,97.17336177825928,141.28846740722656,4130,1098,3032,3032,0,13,1527000.0
1527,1527999,21.567511758566468,38.15954057173761,0.061238068980573934,203.1425838470459,97.23734331130981,141.30833053588867,4130,1098,3032,3032,0,13,1528000.0
1528,1528999,21.562805970973113,38.1515490227118,0.06126233104015644,203.269460439682,97.30147457122803,141.24662017822266,4132,1099,3033,3033,0,13,1529000.0
1529,1529999,21.558351226649457,38.14421800765085,0.06128655757507673,203.44393634796143,97.36687064170837,141.14213943481445,4137,1101,3036,3036,0,13,1530000.0
1530,1530999,21.5541174046679,38.138847333850144,0.06129437015709582,203.58713483810425,97.43168354034424,141.17069244384766,4140,1102,3038,3038,0,13,1531000.0
1531,1531999,21.550458637638663,38.132694780882375,0.061313784668264204,203.73943710327148,97.49682974815369,141.18783569335938,4143,1103,3040,3040,0,13,1532000.0
1532,1532999,21.54603016947744,38.125109149580176,0.0613414856483907,203.85642910003662,97.56081748008728,141.22844696044922,4143,1103,3040,3040,0,13,1533000.0
1533,1533999,21.54209735231384,38.11755448548088,0.061363350073515566,204.0060088634491,97.62616872787476,141.25912857055664,4143,1103,3040,3040,0,13,1534000.0
1534,1534999,21.53823420235474,38.111936569609455,0.061367161027080175,204.14285159111023,97.69063973426819,141.28995895385742,4143,1103,3040,3040,0,13,1535000.0
1535,1535999,21.53565825370097,38.10746420245117,0.061363567472218605,204.28730964660645,97.75533747673035,141.23620986938477,4149,1105,3044,3044,0,13,1536000.0
1536,1536999,21.534251705037732,38.10496884027039,0.06136629814681771,204.4374487400055,97.82020473480225,141.21725463867188,4151,1106,3045,3045,0,13,1537000.0
1537,1537999,21.532164577385778,38.10060640476901,0.06137282825170687,204.5697751045227,97.88475799560547,141.25714874267578,4151,1106,3045,3045,0,13,1538000.0
1538,1538999,21.530508455832646,38.095862838986804,0.06137677330278257,204.71648836135864,97.9490876197815,141.29169082641602,4151,1106,3045,3045,0,13,1539000.0
1539,1539999,21.528879358135857,38.091881707576405,0.06136880113713039,204.86977434158325,98.01397109031677,141.1260528564453,4156,1108,3048,3048,0,13,1540000.0
1540,1540999,21.527187668162906,38.08802859964217,0.061388730305388606,205.00167989730835,98.07864332199097,141.2123680114746,4156,1108,3048,3048,0,13,1541000.0
1541,1541999,21.524591146448895,38.08217689001731,0.06139997394685115,205.14067363739014,98.14386558532715,141.19842529296875,4159,1109,3050,3050,0,13,1542000.0
1542,1542999,21.523580162530266,38.076485988952946,0.06128424136721511,205.2737262248993,98.20813345909119,141.34833145141602,4159,1109,3050,3050,0,13,1543000.0
1543,1543999,21.52625518917896,38.077800918664565,0.06103717014957899,205.40028715133667,98.27222514152527,141.44720077514648,4159,1109,3050,3050,0,13,1544000.0
1544,1544999,21.52717888395644,38.073159760593065,0.060906947584074334,205.573890209198,98.34623050689697,141.38307571411133,4162,1110,3052,3052,0,13,1545000.0
1545,1545999,21.526852661491596,38.06794135639695,0.060823392122684505,205.734028339386,98.41146993637085,141.25193786621094,4168,1112,3056,3056,0,13,1546000.0
1546,1546999,21.52697592773003,38.063854142150525,0.06077324318382493,205.87294673919678,98.47580218315125,141.21557235717773,4171,1113,3058,3058,0,13,1547000.0
1547,1547999,21.526417362443297,38.06125857301211,0.06079432171155208,206.00347542762756,98.54046511650085,141.3165397644043,4173,1114,3059,3059,0,13,1548000.0
1548,1548999,21.527115763232477,38.05987462177853,0.06082364363425263,206.16248178482056,98.60562348365784,141.28500747680664,4176,1115,3061,3061,0,13,1549000.0
1549,1549999,21.528694788747362,38.0638117918325,0.06083843192041116,206.29497838020325,98.67004370689392,141.3018913269043,4178,1116,3062,3062,0,13,1550000.0
1550,1550999,21.529170944363027,38.0643751011637,0.060907730998975285,206.44162321090698,98.73501062393188,141.32554626464844,4181,1117,3064,3064,0,13,1551000.0
1551,1551999,21.532110239208848,38.07317376400927,0.06099288026437921,206.59459829330444,98.80017733573914,141.39654159545898,4181,1117,3064,3064,0,13,1552000.0
1552,1552999,21.53370250316451,38.07615353213861,0.06108199398091596,206.71777749061584,98.8648579120636,141.45054626464844,4181,1117,3064,3064,0,13,1553000.0
1553,1553999,21.53819338386739,38.09327291862734,0.06115783491521842,206.87757182121277,98.9296886920929,141.34417724609375,4186,1119,3067,3067,0,13,1554000.0
1554,1554999,21.542945638996727,38.10829492067905,0.061298792955388315,207.00329542160034,98.99470138549805,141.41403198242188,4186,1119,3067,3067,0,13,1555000.0
1555,1555999,21.54657769246334,38.12074434195336,0.06133017987793343,207.1654601097107,99.05997252464294,141.32292556762695,4194,1122,3072,3072,0,13,1556000.0
1556,1556999,21.549837208493688,38.12979367433367,0.06135276992943384,207.3158462047577,99.12498950958252,141.39176559448242,4194,1122,3072,3072,0,13,1557000.0
1557,1557999,21.553504902399826,38.13909258565003,0.0614066331428883,207.46544694900513,99.19091534614563,141.2921600341797,4199,1124,3075,3075,0,13,1558000.0
1558,1558999,21.556298828455994,38.14256252085955,0.06139425761728323,207.63229894638062,99.2587480545044,141.27616119384766,4205,1126,3079,3079,0,13,1559000.0
1559,1559999,21.55973975517465,38.14690011179386,0.06145650602161412,207.76305317878723,99.32360172271729,141.34925079345703,4205,1126,3079,3079,0,13,1560000.0
1560,1560999,21.56275247926607,38.15352160683037,0.06148617602392381,207.90173292160034,99.38910388946533,141.3479766845703,4210,1128,3082,3082,0,13,1561000.0
1561,1561999,21.56528496827947,38.1550408952655,0.061603265571304466,208.02682304382324,99.45423436164856,141.43060684204102,4210,1128,3082,3082,0,13,1562000.0
1562,1562999,21.56491802590821,38.151322914634285,0.06160221021368195,208.19310474395752,99.51968955993652,141.51604461669922,4210,1128,3082,3082,0,13,1563000.0
1563,1563999,21.565195083978836,38.15013647694046,0.06157966486852007,208.3226764202118,99.58367443084717,141.61669540405273,4210,1128,3082,3082,0,13,1564000.0
1564,1564999,21.565828203051957,38.1508249612878,0.061558548309694316,208.45489978790283,99.6472716331482,141.64987182617188,4210,1128,3082,3082,0,13,1565000.0
1565,1565999,21.56710637731487,38.15101211669158,0.061528445084529704,208.58389925956726,99.71133327484131,141.6467399597168,4213,1129,3084,3084,0,13,1566000.0
1566,1566999,21.569726854318827,38.153326817270006,0.061517998156732756,208.71710729599,99.77577209472656,141.67979431152344,4213,1129,3084,3084,0,13,1567000.0
1567,1567999,21.57235724296455,38.15378327306412,0.06150937114379407,208.87534046173096,99.84002757072449,141.65422439575195,4218,1131,3087,3087,0,13,1568000.0
1568,1568999,21.574499833231535,38.15467421876748,0.06152298952510182,209.04947686195374,99.90532565116882,141.62416076660156,4223,1133,3090,3090,0,13,1569000.0
1569,1569999,21.577450539648066,38.157291681649,0.061524546475677955,209.19531846046448,99.97006702423096,141.61394500732422,4226,1134,3092,3092,0,13,1570000.0
1570,1570999,21.579518987795293,38.15900571035918,0.06152948809430281,209.34154391288757,100.0348768234253,141.60477447509766,4229,1136,3093,3093,0,13,1571000.0
1571,1571999,21.582362564446278,38.16068616344366,0.061549736714269554,209.50891041755676,100.09953618049622,141.46125030517578,4237,1139,3098,3098,0,13,1572000.0
1572,1572999,21.58703919422759,38.16668901919022,0.06155024311114421,209.64142203330994,100.16395092010498,141.5541877746582,4237,1139,3098,3098,0,13,1573000.0
1573,1573999,21.59360093236488,38.18557526468423,0.06156773679135874,209.7771008014679,100.2279155254364,141.6189079284668,4237,1139,3098,3098,0,13,1574000.0
1574,1574999,21.599679953189753,38.19487976840433,0.06160996324590562,209.90494394302368,100.2923276424408,141.65745162963867,4237,1139,3098,3098,0,13,1575000.0
1575,1575999,21.607273488783562,38.212775828291065,0.06164399063177317,210.04325342178345,100.35685515403748,141.69022369384766,4237,1139,3098,3098,0,13,1576000.0
1576,1576999,21.616611755058152,38.236037249988016,0.06165920605325714,210.19508910179138,100.42130208015442,141.60668182373047,4243,1141,3102,3102,0,13,1577000.0
1577,1577999,21.623397668661497,38.244848137003075,0.06172142112649226,210.32220578193665,100.48588395118713,141.6641616821289,4243,1141,3102,3102,0,13,1578000.0
1578,1578999,21.629429640305265,38.25177903670394,0.06181535407618599,210.46806478500366,100.55016326904297,141.710693359375,4243,1141,3102,3102,0,13,1579000.0
1579,1579999,21.63799477079815,38.26339285326456,0.06193453714152031,210.62087082862854,100.61511874198914,141.6856803894043,4246,1142,3104,3104,0,13,1580000.0
1580,1580999,21.645824811166964,38.272668279678186,0.06201991349219793,210.75530195236206,100.67994999885559,141.7301902770996,4246,1142,3104,3104,0,13,1581000.0
1581,1581999,21.654330200838206,38.282444226865834,0.0621757051672408,210.89808344841003,100.74452829360962,141.65108489990234,4247,1143,3104,3104,0,13,1582000.0
1582,1582999,21.662772645805237,38.29260928019449,0.062329641277085845,211.0286157131195,100.80975317955017,141.71448135375977,4247,1143,3104,3104,0,13,1583000.0
1583,1583999,21.665023008673252,38.29343547812662,0.06238785186650786,211.16733074188232,100.8742196559906,141.74243927001953,4250,1144,3106,3106,0,13,1584000.0
1584,1584999,21.660380720116173,38.285036807623825,0.06241025677961587,211.2962999343872,100.94022536277771,141.85612869262695,4250,1144,3106,3106,0,13,1585000.0
1585,1585999,21.65520350093625,38.27623449770402,0.062435438435668345,211.44752836227417,101.00453209877014,141.8025016784668,4253,1145,3108,3108,0,13,1586000.0
1586,1586999,21.651415245363555,38.2704171377164,0.062445717176087046,211.57482028007507,101.06857132911682,141.86999130249023,4253,1145,3108,3108,0,13,1587000.0
1587,1587999,21.647661960084726,38.26680224554127,0.06246021387870504,211.7000081539154,101.13273477554321,141.91086196899414,4253,1145,3108,3108,0,13,1588000.0
1588,1588999,21.644846281688633,38.262536563673585,0.06246473998716806,211.8699095249176,101.19740653038025,141.7064971923828,4261,1148,3113,3113,0,13,1589000.0
1589,1589999,21.641200170242097,38.25616760189795,0.06247796490084556,212.02754878997803,101.26241517066956,141.62376022338867,4270,1151,3119,3119,0,13,1590000.0
1590,1590999,21.63695903745477,38.24851154963703,0.06249129846964774,212.1898753643036,101.32755017280579,141.54174041748047,4279,1154,3125,3125,0,13,1591000.0
1591,1591999,21.633739221456235,38.24300836105053,0.06249216002679503,212.37496709823608,101.39287114143372,141.38894653320312,4291,1158,3133,3133,0,13,1592000.0
1592,1592999,21.631096030552076,38.239725860745224,0.06247753637013187,212.50951600074768,101.45825910568237,141.47206497192383,4293,1159,3134,3134,0,13,1593000.0
1593,1593999,21.629421630565158,38.23723347960046,0.062436702181947856,212.65916228294373,101.52331686019897,141.53425979614258,4296,1160,3136,3136,0,13,1594000.0
1594,1594999,21.628957555348958,38.23609708214859,0.06238360588791725,212.78849816322327,101.58957624435425,141.56757354736328,4299,1161,3138,3138,0,13,1595000.0
1595,1595999,21.629671987446933,38.23670230287679,0.06232424669180314,212.91663336753845,101.65421938896179,141.63474655151367,4299,1161,3138,3138,0,13,1596000.0
1596,1596999,21.63095751330993,38.24388485271867,0.06229566400882092,213.08746075630188,101.71969652175903,141.5700798034668,4306,1164,3142,3142,0,13,1597000.0
1597,1597999,21.63285748061937,38.2463750655507,0.0622743435857297,213.2377905845642,101.78520464897156,141.5388641357422,4312,1166,3146,3146,0,13,1598000.0
1598,1598999,21.637515504814196,38.25448009982904,0.062227216065958935,213.39029264450073,101.85087847709656,141.55165100097656,4315,1167,3148,3148,0,13,1599000.0
1599,1599999,21.64244817001694,38.26333615253108,0.06218871178045593,213.51626133918762,101.9156141281128,141.6498031616211,4315,1167,3148,3148,0,13,1600000.0
1600,1600999,21.647931176765255,38.270516346623225,0.06221794529214608,213.67462754249573,101.98027992248535,141.59241485595703,4322,1170,3152,3152,0,13,1601000.0
1601,1601999,21.65459744547555,38.282287391865,0.06219243361121374,213.8076765537262,102.04615926742554,141.68305587768555,4322,1170,3152,3152,0,13,1602000.0
1602,1602999,21.664492463035103,38.316486978127664,0.06214215812037582,213.96658778190613,102.111811876297,141.60670852661133,4328,1172,3156,3156,0,13,1603000.0
1603,1603999,21.6692936922995,38.32265586426872,0.062124453329596374,214.09155130386353,102.17755126953125,141.70556640625,4328,1172,3156,3156,0,13,1604000.0
1604,1604999,21.670301094145266,38.323050810254905,0.06210954229473342,214.21815609931946,102.24192547798157,141.83931732177734,4328,1172,3156,3156,0,13,1605000.0
1605,1605999,21.67011080465827,38.334618512221056,0.062037091018812274,214.36302709579468,102.30603623390198,141.9499053955078,4328,1172,3156,3156,0,13,1606000.0
1606,1606999,21.66897213027961,38.34073334953598,0.06202026598740196,214.53109288215637,102.37045431137085,141.82173538208008,4337,1175,3162,3162,0,13,1607000.0
1607,1607999,21.667778111988135,38.343745464096955,0.06198976416148616,214.6603982448578,102.43426585197449,141.87099075317383,4340,1176,3164,3164,0,13,1608000.0
1608,1608999,21.666413411636313,38.34063219225048,0.06197902917753939,214.8218584060669,102.49925446510315,141.85693740844727,4346,1178,3168,3168,0,13,1609000.0
1609,1609999,21.66579207099922,38.340594806988086,0.06195796346299698,214.97530555725098,102.56350207328796,141.86706161499023,4352,1180,3172,3172,0,13,1610000.0
1610,1610999,21.666105323245805,38.343555918503235,0.06194633515230652,215.1065685749054,102.62816905975342,141.91557693481445,4355,1181,3174,3174,0,13,1611000.0
1611,1611999,21.666117442304902,38.34384165637633,0.06195371646704839,215.2504472732544,102.69302320480347,141.90800857543945,4361,1183,3178,3178,0,13,1612000.0
1612,1612999,21.66546766710016,38.341218637436214,0.061963794446110554,215.40698528289795,102.75769543647766,141.96397018432617,4363,1184,3179,3179,0,13,1613000.0
1613,1613999,21.66607038311363,38.3421730365078,0.061968321211572586,215.53767895698547,102.82237815856934,142.05488204956055,4363,1184,3179,3179,0,13,1614000.0
1614,1614999,21.667089808288594,38.34288621070082,0.06197656629048354,215.66082549095154,102.88672208786011,142.12570571899414,4363,1184,3179,3179,0,13,1615000.0
1615,1615999,21.668532252467728,38.35236742634763,0.061956391310849734,215.80550503730774,102.95159554481506,142.07092666625977,4369,1186,3183,3183,0,13,1616000.0
1616,1616999,21.66837875221647,38.34994822763774,0.06197355299573848,215.95720076560974,103.01712346076965,142.07567977905273,4372,1187,3185,3185,0,13,1617000.0
1617,1617999,21.669450684601983,38.34990788067801,0.06199114741341549,216.08233952522278,103.08176016807556,142.1446075439453,4372,1187,3185,3185,0,13,1618000.0
1618,1618999,21.669492471406585,38.34693409195472,0.06199709751436733,216.24859833717346,103.14668536186218,142.04381942749023,4379,1190,3189,3189,0,13,1619000.0
1619,1619999,21.669766353453976,38.34451512838962,0.062013688637683306,216.39188623428345,103.21145701408386,142.1577033996582,4379,1190,3189,3189,0,13,1620000.0
1620,1620999,21.670838146607224,38.350767164219306,0.0619872784924832,216.5156922340393,103.27709698677063,142.2286834716797,4379,1190,3189,3189,0,13,1621000.0
1621,1621999,21.670392697537512,38.34701205072296,0.06199765892185005,216.64292287826538,103.3417444229126,142.25090789794922,4382,1191,3191,3191,0,13,1622000.0
1622,1622999,21.669320008819703,38.341221230916226,0.06196080429103712,216.79923295974731,103.40627264976501,142.27480697631836,4385,1192,3193,3193,0,13,1623000.0
1623,1623999,21.670624169867377,38.3407899919911,0.06188108680819748,216.96092128753662,103.47084498405457,142.3159408569336,4388,1193,3195,3195,0,13,1624000.0
1624,1624999,21.670791848003052,38.3352834225468,0.06181005889322544,217.10555577278137,103.53588652610779,142.30882263183594,4391,1194,3197,3197,0,13,1625000.0
1625,1625999,21.670407585974104,38.332557446256494,0.06174315292746679,217.25186324119568,103.60057377815247,142.26665496826172,4396,1196,3200,3200,0,13,1626000.0
1626,1626999,21.669767986907452,38.32975076745961,0.06169046384689658,217.41776418685913,103.66535353660583,142.10649490356445,4407,1200,3207,3207,0,13,1627000.0
1627,1627999,21.666995499470225,38.323469947873605,0.06169231917323004,217.60044264793396,103.73081040382385,141.90724563598633,4421,1205,3216,3216,0,13,1628000.0
1628,1628999,21.66370050641673,38.317040883324765,0.061681891606896855,217.75675988197327,103.79685974121094,141.9292449951172,4427,1207,3220,3220,0,13,1629000.0
1629,1629999,21.660543869326233,38.31032897356547,0.06167679895946476,217.87283635139465,103.86222720146179,142.08592224121094,4427,1207,3220,3220,0,13,1630000.0
1630,1630999,21.65737398392625,38.30760031309693,0.06164284082244886,218.04145908355713,103.9282455444336,141.98267364501953,4434,1210,3224,3224,0,13,1631000.0
1631,1631999,21.65416709748636,38.301279632284924,0.06161706688990343,218.21564054489136,103.99433469772339,141.85857009887695,4441,1213,3228,3228,0,13,1632000.0
1632,1632999,21.650877680782973,38.29728671548907,0.06159766952902801,218.35553693771362,104.0600073337555,141.9549446105957,4444,1214,3230,3230,0,13,1633000.0
1633,1633999,21.64732934789562,38.29252158221742,0.06159253523778718,218.48863005638123,104.12598609924316,142.08653259277344,4444,1214,3230,3230,0,13,1634000.0
1634,1634999,21.644146300828552,38.28692769676019,0.061579086373208525,218.6468551158905,104.19203233718872,142.04463577270508,4450,1216,3234,3234,0,13,1635000.0
1635,1635999,21.640602743417467,38.28150903550407,0.06157541263144528,218.77513599395752,104.25794267654419,142.1732063293457,4450,1216,3234,3234,0,13,1636000.0
1636,1636999,21.63791551298035,38.27991304474972,0.06154285432406248,218.9057002067566,104.3235170841217,142.26024627685547,4450,1216,3234,3234,0,13,1637000.0
1637,1637999,21.637322291392213,38.2895307875598,0.0614646133844865,219.03931713104248,104.38918089866638,142.3294563293457,4450,1216,3234,3234,0,13,1638000.0
1638,1638999,21.635137227324446,38.284968320015764,0.06144415226073652,219.19754219055176,104.45513772964478,142.32353591918945,4455,1218,3237,3237,0,13,1639000.0
1639,1639999,21.633577168027486,38.281260535811086,0.06143575122790468,219.338800907135,104.52042865753174,142.38521194458008,4455,1218,3237,3237,0,13,1640000.0
1640,1640999,21.631233747153672,38.27564028862703,0.06141992241416361,219.45922374725342,104.58539319038391,142.44368362426758,4455,1218,3237,3237,0,13,1641000.0
1641,1641999,21.628924225152637,38.275447297337436,0.06138148629044393,219.6038782596588,104.65486693382263,142.51765823364258,4455,1218,3237,3237,0,13,1642000.0
1642,1642999,21.628030067909915,38.27276222515513,0.06130352388747917,219.73725843429565,104.72002053260803,142.6368865966797,4455,1218,3237,3237,0,13,1643000.0
1643,1643999,21.629116984418967,38.26982368427105,0.06117462013628994,219.87121295928955,104.78426480293274,142.58011627197266,4458,1219,3239,3239,0,13,1644000.0
1644,1644999,21.62857690237173,38.267880685225244,0.06110486664095338,220.01682496070862,104.84934520721436,142.53154754638672,4461,1220,3241,3241,0,13,1645000.0
1645,1645999,21.627225309336733,38.2650296149415,0.06103174225649344,220.18326044082642,104.91384530067444,142.34772109985352,4470,1223,3247,3247,0,13,1646000.0
1646,1646999,21.62636995304906,38.2779406340156,0.06092484685979016,220.32808685302734,104.97995948791504,142.33580780029297,4476,1225,3251,3251,0,13,1647000.0
1647,1647999,21.624194910470347,38.27293189077878,0.06088549276796107,220.48891377449036,105.04494714736938,142.2841033935547,4485,1228,3257,3257,0,13,1648000.0
1648,1648999,21.62149098186762,38.26613116482203,0.060844482220953844,220.6400978565216,105.11015558242798,142.21938705444336,4490,1230,3260,3260,0,13,1649000.0
1649,1649999,21.618349090256125,38.25950933415642,0.06081391634596556,220.79816317558289,105.17923855781555,142.2309455871582,4496,1232,3264,3264,0,13,1650000.0
1650,1650999,21.615507588129343,38.2527635312123,0.06079416265848758,220.9381582736969,105.24474024772644,142.262451171875,4499,1233,3266,3266,0,13,1651000.0
1651,1651999,21.61245771472024,38.246401653945014,0.060769603190327204,221.10902428627014,105.31074810028076,142.2339973449707,4506,1236,3270,3270,0,13,1652000.0
1652,1652999,21.609607986175604,38.23999477036117,0.060748360831827775,221.2740523815155,105.37660527229309,142.10618209838867,4515,1239,3276,3276,0,13,1653000.0
1653,1653999,21.606739973047613,38.23406240710089,0.060738772330008906,221.43153071403503,105.44371914863586,142.13429260253906,4520,1241,3279,3279,0,13,1654000.0
1654,1654999,21.603734561097593,38.2275630264523,0.06072026160567212,221.55882954597473,105.50876641273499,142.2295036315918,4520,1241,3279,3279,0,13,1655000.0
1655,1655999,21.601699733446463,38.22261082223282,0.06069721692621677,221.68674230575562,105.57420039176941,142.22421264648438,4522,1242,3280,3280,0,13,1656000.0
1656,1656999,21.601044266318986,38.2196709759844,0.06065840896372676,221.82713508605957,105.63961100578308,142.31274795532227,4522,1242,3280,3280,0,13,1657000.0
1657,1657999,21.601631670931546,38.2178524409512,0.06060191896362577,221.96416401863098,105.70489621162415,142.3874969482422,4522,1242,3280,3280,0,13,1658000.0
1658,1658999,21.60254822969061,38.21672209999743,0.060551911536809166,222.09161758422852,105.76999974250793,142.44544982910156,4522,1242,3280,3280,0,13,1659000.0
1659,1659999,21.604522476304222,38.21834616190731,0.0604938817030346,222.22664785385132,105.83535289764404,142.5122528076172,4522,1242,3280,3280,0,13,1660000.0
1660,1660999,21.605034594025913,38.215988648809784,0.060463775126928354,222.39618468284607,105.90181946754456,142.36528778076172,4529,1245,3284,3284,0,13,1661000.0
1661,1661999,21.605209341430577,38.21375026073781,0.06042720522357137,222.5297417640686,105.96758365631104,142.43540954589844,4529,1245,3284,3284,0,13,1662000.0
1662,1662999,21.60538666379935,38.21119795638956,0.06039364481745324,222.65593600273132,106.03306531906128,142.50625228881836,4529,1245,3284,3284,0,13,1663000.0
1663,1663999,21.60312031118913,38.20582367145326,0.060368407866827956,222.8028860092163,106.0978331565857,142.49317169189453,4532,1246,3286,3286,0,13,1664000.0
1664,1664999,21.600035592192388,38.20140516265754,0.06035093849625117,222.96114087104797,106.16187953948975,142.51472854614258,4535,1247,3288,3288,0,13,1665000.0
1665,1665999,21.595420586107984,38.194176494949424,0.060378486175912016,223.09017705917358,106.22577977180481,142.46653366088867,4538,1248,3290,3290,0,13,1666000.0
1666,1666999,21.59075049473216,38.190309285134916,0.060406209408717104,223.2288839817047,106.29002499580383,142.44474029541016,4543,1250,3293,3293,0,13,1667000.0
1667,1667999,21.586059579179675,38.183257593170865,0.06042108179802097,223.38905715942383,106.35459518432617,142.34357452392578,4549,1252,3297,3297,0,13,1668000.0
1668,1668999,21.581230329654574,38.17614779722013,0.060456873916920784,223.5704414844513,106.41934561729431,142.19192123413086,4558,1255,3303,3303,0,13,1669000.0
1669,1669999,21.57572737347777,38.16862753367926,0.06050945079409853,223.71909260749817,106.48385810852051,142.0898666381836,4564,1257,3307,3307,0,13,1670000.0
1670,1670999,21.570251293839092,38.161140077539876,0.06055391066559568,223.85005950927734,106.54881596565247,142.23234176635742,4564,1257,3307,3307,0,13,1671000.0
1671,1671999,21.56490537844833,38.15329145681271,0.06059371028484184,223.99049162864685,106.61339855194092,142.27442932128906,4567,1258,3309,3309,0,13,1672000.0
1672,1672999,21.559956982930025,38.145476382063706,0.060630136346427,224.1302604675293,106.67779779434204,142.29729461669922,4570,1259,3311,3311,0,13,1673000.0
1673,1673999,21.555241946384612,38.13899948266162,0.06064384239501741,224.28516960144043,106.74267840385437,142.23487854003906,4576,1261,3315,3315,0,13,1674000.0
1674,1674999,21.55075047146167,38.131800368654474,0.060656214960046695,224.41819953918457,106.80821347236633,142.2356414794922,4579,1262,3317,3317,0,13,1675000.0
1675,1675999,21.546747163826012,38.12523731044513,0.06066754303021327,224.57170796394348,106.87347626686096,142.25642013549805,4581,1263,3318,3318,0,13,1676000.0
1676,1676999,21.542696975809047,38.118384133092114,0.0606680196893985,224.71692204475403,106.93790817260742,142.26733016967773,4583,1264,3319,3319,0,13,1677000.0
1677,1677999,21.53974610991852,38.113369348780424,0.060654414766613485,224.86994171142578,107.00290417671204,142.22128295898438,4589,1266,3323,3323,0,13,1678000.0
1678,1678999,21.538768500555353,38.11158069736394,0.06061358994042498,225.02083683013916,107.07736396789551,142.32931518554688,4589,1266,3323,3323,0,13,1679000.0
1679,1679999,21.538867201185273,38.11492881659381,0.06056223579493092,225.1458659172058,107.14228653907776,142.40127563476562,4589,1266,3323,3323,0,13,1680000.0
1680,1680999,21.53898936423265,38.1179941922074,0.06050397120459805,225.27069735527039,107.20673656463623,142.4806671142578,4589,1266,3323,3323,0,13,1681000.0
1681,1681999,21.539122630045263,38.120074956507665,0.06046882731407577,225.4102647304535,107.27130770683289,142.51869583129883,4589,1266,3323,3323,0,13,1682000.0
1682,1682999,21.538053730349116,38.11634523930164,0.06044923871849939,225.56234073638916,107.33647465705872,142.44549942016602,4591,1267,3324,3324,0,13,1683000.0
1683,1683999,21.536054420496868,38.111163075322885,0.06044397817306468,225.6939127445221,107.40175342559814,142.53261947631836,4591,1267,3324,3324,0,13,1684000.0
1684,1684999,21.532900836361108,38.10454476687263,0.060441589224462966,225.8404939174652,107.46592259407043,142.6335220336914,4593,1268,3325,3325,0,13,1685000.0
1685,1685999,21.528768691453376,38.09712040546974,0.06046559399856488,225.97726702690125,107.53031754493713,142.7573356628418,4593,1268,3325,3325,0,13,1686000.0
1686,1686999,21.52508393702916,38.09021757222075,0.060510388474352084,226.10781264305115,107.59418368339539,142.74472427368164,4596,1269,3327,3327,0,13,1687000.0
1687,1687999,21.52197230192487,38.08364456193873,0.06054398676490358,226.25698399543762,107.65853261947632,142.81459426879883,4596,1269,3327,3327,0,13,1688000.0
1688,1688999,21.518992406992446,38.07774905555249,0.06057978186223101,226.3980164527893,107.72268557548523,142.78630828857422,4599,1270,3329,3329,0,13,1689000.0
1689,1689999,21.51709295148198,38.07552426314573,0.06060189138172134,226.5227677822113,107.78649950027466,142.86361694335938,4599,1270,3329,3329,0,13,1690000.0
1690,1690999,21.515555890181503,38.07248648424627,0.06066443430161461,226.6618447303772,107.85084962844849,142.90318298339844,4599,1270,3329,3329,0,13,1691000.0
1691,1691999,21.514280705508835,38.0706030680338,0.06073764776436297,226.7933042049408,107.91565084457397,142.90163803100586,4601,1271,3330,3330,0,13,1692000.0
1692,1692999,21.513301976635365,38.07293010361759,0.06079686862756217,226.94432377815247,107.98025631904602,142.8701171875,4603,1272,3331,3331,0,13,1693000.0
1693,1693999,21.514698557849858,38.0873354394003,0.06081903356601459,227.0767343044281,108.04431939125061,142.91186141967773,4603,1272,3331,3331,0,13,1694000.0
1694,1694999,21.51534172701079,38.091306136537895,0.06089713588269663,227.2238929271698,108.10898900032043,142.8432388305664,4609,1274,3335,3335,0,13,1695000.0
1695,1695999,21.518227700494204,38.102976578043034,0.06105415881438925,227.37446522712708,108.17347812652588,142.8255729675293,4611,1275,3336,3336,0,13,1696000.0
1696,1696999,21.519626944651314,38.10994490952297,0.06118928436410631,227.523512840271,108.23803067207336,142.75583267211914,4616,1277,3339,3339,0,13,1697000.0
1697,1697999,21.520544749691666,38.11483581272801,0.06125540898470694,227.66559100151062,108.30293941497803,142.83323287963867,4616,1277,3339,3339,0,13,1698000.0
1698,1698999,21.522542751742705,38.12200995448757,0.061324696506211196,227.8105616569519,108.36748671531677,142.786376953125,4619,1278,3341,3341,0,13,1699000.0
1699,1699999,21.525491066986124,38.13387738371573,0.06133657422371319,227.94263195991516,108.43188858032227,142.80441284179688,4621,1279,3342,3342,0,13,1700000.0
1700,1700999,21.52754066637397,38.13939924026439,0.061388105218320166,228.10075402259827,108.49712896347046,142.7946434020996,4624,1280,3344,3344,0,13,1701000.0
1701,1701999,21.530620814279004,38.14619210922949,0.06141520985745741,228.25611281394958,108.56210494041443,142.76141738891602,4629,1282,3347,3347,0,13,1702000.0
1702,1702999,21.534359435323353,38.153093087717316,0.061420875686997056,228.3824896812439,108.62649631500244,142.83841705322266,4629,1282,3347,3347,0,13,1703000.0
1703,1703999,21.53679287431184,38.155726852896215,0.06141311667240523,228.53955459594727,108.6914005279541,142.79931259155273,4633,1284,3349,3349,0,13,1704000.0
1704,1704999,21.538888402485675,38.16871814582058,0.06136477051339417,228.67812967300415,108.75618243217468,142.82633590698242,4635,1285,3350,3350,0,13,1705000.0
1705,1705999,21.53828141975634,38.17092923378009,0.06128264699464869,228.81575846672058,108.82028818130493,143.11867904663086,4636,1285,3351,3351,0,13,1706000.0
1706,1706999,21.534971789411248,38.164254675071795,0.061274263296206666,228.93656635284424,108.88427114486694,143.23455429077148,4636,1285,3351,3351,0,13,1707000.0
1707,1707999,21.531503197470737,38.15728756415642,0.06128213406387606,229.07242059707642,108.94778680801392,143.28042602539062,4638,1286,3352,3352,0,13,1708000.0
1708,1708999,21.529057426272164,38.15647705107786,0.06124343381184316,229.87514448165894,109.01290893554688,143.83446502685547,4700,1287,3413,3413,0,13,1709000.0
1709,1709999,21.52662969370496,38.15185616335812,0.06123703490710497,230.00670719146729,109.078200340271,144.30596542358398,4700,1287,3413,3413,0,13,1710000.0
1710,1710999,21.524169117489702,38.14697042342429,0.06122141326430508,230.1405656337738,109.1421947479248,144.60942840576172,4700,1287,3413,3413,0,13,1711000.0
1711,1711999,21.522764437482667,38.14319391721286,0.0611902756412005,230.26832008361816,109.20726776123047,144.76580047607422,4700,1287,3413,3413,0,13,1712000.0
1712,1712999,21.521555067158484,38.13982077215211,0.061156109817514404,230.41256999969482,109.27214670181274,144.91093063354492,4700,1287,3413,3413,0,13,1713000.0
1713,1713999,21.520229150232343,38.13591013169304,0.06114066622003622,230.52768325805664,109.33657169342041,145.06156158447266,4700,1287,3413,3413,0,13,1714000.0
1714,1714999,21.519629231653262,38.14766334727734,0.06106365832076144,230.67084741592407,109.40106201171875,145.137939453125,4700,1287,3413,3413,0,13,1715000.0
1715,1715999,21.519990851939887,38.1473109879453,0.06102935473326376,230.81285524368286,109.46537828445435,145.2097625732422,4700,1287,3413,3413,0,13,1716000.0
1716,1716999,21.519726860773233,38.146554446122074,0.061005897538060405,230.96642398834229,109.53003549575806,145.29854202270508,4700,1287,3413,3413,0,13,1717000.0
1717,1717999,21.520983402984427,38.15482810559844,0.06096488820376855,231.09902811050415,109.59466671943665,145.33059692382812,4731,1288,3443,3443,0,13,1718000.0
1718,1718999,21.522989454400772,38.1595367310071,0.06091549331396051,231.24082899093628,109.65874862670898,145.38468170166016,4731,1288,3443,3443,0,13,1719000.0
1719,1719999,21.52505594127407,38.1633711842795,0.060879927454097316,231.38379502296448,109.7247428894043,145.43791961669922,4733,1289,3444,3444,0,13,1720000.0
1720,1720999,21.529429033020502,38.17174455342006,0.060840928981765297,231.53113198280334,109.78924036026001,145.5105857849121,4733,1289,3444,3444,0,13,1721000.0
1721,1721999,21.534518569258687,38.18698215710593,0.06079252072778196,231.67104482650757,109.85371899604797,145.56660842895508,4735,1290,3445,3445,0,13,1722000.0
1722,1722999,21.539343617871936,38.202142261452,0.060729207455452516,231.80344414710999,109.91800689697266,145.6041145324707,4737,1291,3446,3446,0,13,1723000.0
1723,1723999,21.543154686439273,38.20982726619999,0.06067120414843474,231.93556666374207,109.98323106765747,145.7015037536621,4737,1291,3446,3446,0,13,1724000.0
1724,1724999,21.547415153924497,38.218643817022425,0.06062678771449259,232.09305500984192,110.04805278778076,145.7584686279297,4739,1292,3447,3447,0,13,1725000.0
1725,1725999,21.54799837072514,38.21876550548509,0.060603194982508435,232.24370884895325,110.11249232292175,145.92231369018555,4741,1293,3448,3448,0,13,1726000.0
1726,1726999,21.54394375991876,38.21232076341641,0.06061821301994619,232.37222480773926,110.17848992347717,146.06780242919922,4742,1293,3449,3449,0,13,1727000.0
1727,1727999,21.539937064802732,38.207070763568325,0.06063203520546345,232.52470993995667,110.2495276927948,146.18371200561523,4742,1293,3449,3449,0,13,1728000.0
1728,1728999,21.53675600010088,38.206389900788906,0.06061887121994025,232.6589663028717,110.31419157981873,146.27239990234375,4742,1293,3449,3449,0,13,1729000.0
1729,1729999,21.53376540854242,38.20282752964092,0.06061012984600567,232.7896614074707,110.37799119949341,146.29200744628906,4744,1294,3450,3450,0,13,1730000.0
1730,1730999,21.532124084471317,38.19941888543564,0.060580680677189136,232.92057514190674,110.44266653060913,146.40799713134766,4744,1294,3450,3450,0,13,1731000.0
1731,1731999,21.52920770418725,38.194264716175546,0.06057391835317094,233.08489847183228,110.51256966590881,146.46673965454102,4744,1294,3450,3450,0,13,1732000.0
1732,1732999,21.526318933033036,38.18942608449447,0.06056125589888739,233.22104287147522,110.5766954421997,146.50447463989258,4744,1294,3450,3450,0,13,1733000.0
1733,1733999,21.52415537582038,38.185378756994155,0.060528271478463624,233.35641288757324,110.6407744884491,146.55899810791016,4744,1294,3450,3450,0,13,1734000.0
1734,1734999,21.523723331104712,38.18561534857371,0.060481527326609164,233.47913765907288,110.70481204986572,146.5978240966797,4744,1294,3450,3450,0,13,1735000.0
1735,1735999,21.5236370302732,38.186723627428115,0.0604161863285253,233.60084104537964,110.76856780052185,146.61841201782227,4744,1294,3450,3450,0,13,1736000.0
1736,1736999,21.524284652372835,38.2008227872368,0.06032872439375059,233.76989150047302,110.83305764198303,146.6119041442871,4746,1295,3451,3451,0,13,1737000.0
1737,1737999,21.524451223329372,38.2018514848635,0.06026820180805892,233.91245079040527,110.89704990386963,146.64049530029297,4746,1295,3451,3451,0,13,1738000.0
1738,1738999,21.525401202644456,38.20355735422567,0.060205075891451854,234.05253267288208,110.96156907081604,146.66759490966797,4746,1295,3451,3451,0,13,1739000.0
1739,1739999,21.525980448992865,38.20441189352069,0.06015589912263364,234.17788553237915,111.02539420127869,146.70688247680664,4746,1295,3451,3451,0,13,1740000.0
1740,1740999,21.52801480064605,38.208331667546766,0.06008753697375868,234.3174114227295,111.09048223495483,146.72417068481445,4746,1295,3451,3451,0,13,1741000.0
1741,1741999,21.530301068736343,38.21357615170841,0.060031198656669615,234.4625165462494,111.15435147285461,146.74405670166016,4746,1295,3451,3451,0,13,1742000.0
1742,1742999,21.534223612912093,38.223523398043014,0.0599773213706879,234.60192489624023,111.21857070922852,146.77523803710938,4746,1295,3451,3451,0,13,1743000.0
1743,1743999,21.53930783346119,38.2448298746583,0.05988198589645122,234.74183464050293,111.28288125991821,146.73947143554688,4748,1296,3452,3452,0,13,1744000.0
1744,1744999,21.542827066993578,38.253979774940134,0.05981096896455307,234.87730264663696,111.34657573699951,146.7770538330078,4748,1296,3452,3452,0,13,1745000.0
1745,1745999,21.544870870594654,38.25783182106853,0.059774909545712296,235.0249433517456,111.41090726852417,146.7680549621582,4750,1297,3453,3453,0,13,1746000.0
1746,1746999,21.54421110376972,38.25753831965231,0.05974664388731765,235.17071104049683,111.47886514663696,147.0311737060547,4751,1297,3454,3454,0,13,1747000.0
1747,1747999,21.544762087498206,38.2597723205508,0.05969507736754698,235.30175852775574,111.542653799057,147.1685905456543,4751,1297,3454,3454,0,13,1748000.0
1748,1748999,21.54289302741823,38.25663251000771,0.059692226265703585,235.42466163635254,111.60633206367493,147.2542839050293,4751,1297,3454,3454,0,13,1749000.0
1749,1749999,21.541300090679226,38.256064525452736,0.05969586047413755,235.5689492225647,111.67029881477356,147.31605911254883,4751,1297,3454,3454,0,13,1750000.0
1750,1750999,21.540131058973586,38.25513181581154,0.059690357791960746,235.69446682929993,111.73467874526978,147.42165756225586,4751,1297,3454,3454,0,13,1751000.0
1751,1751999,21.539445534111596,38.25732199549688,0.05965529774922873,235.82592844963074,111.79844546318054,147.4724006652832,4751,1297,3454,3454,0,13,1752000.0
1752,1752999,21.539106156169264,38.25726322046054,0.059648360737308614,235.98381304740906,111.86281847953796,147.4582290649414,4753,1298,3455,3455,0,13,1753000.0
1753,1753999,21.538319539482323,38.25506638255467,0.05964211671352149,236.12469577789307,111.92699313163757,147.4861831665039,4755,1299,3456,3456,0,13,1754000.0
1754,1754999,21.5376747842275,38.25366386360891,0.05965117809222231,236.26191592216492,111.99195599555969,147.55783462524414,4755,1299,3456,3456,0,13,1755000.0
1755,1755999,21.53745261454092,38.25251755952008,0.05966960613199612,236.39488244056702,112.05648231506348,147.59064102172852,4755,1299,3456,3456,0,13,1756000.0
1756,1756999,21.536619541497824,38.251778605827454,0.05966112576607652,236.5308427810669,112.12384557723999,147.6187858581543,4755,1299,3456,3456,0,13,1757000.0
1757,1757999,21.537825224268683,38.259778312571996,0.059656135335725335,236.68738102912903,112.18882036209106,147.56724548339844,4757,1300,3457,3457,0,13,1758000.0
1758,1758999,21.53749676829477,38.25783286734384,0.05966839821118053,236.81443166732788,112.25336718559265,147.62444686889648,4757,1300,3457,3457,0,13,1759000.0
1759,1759999,21.538637510008073,38.257581498899164,0.05965713550415397,236.955828666687,112.31989073753357,147.65901565551758,4757,1300,3457,3457,0,13,1760000.0
1760,1760999,21.539415124896966,38.256787007236625,0.059660584270247674,237.09426283836365,112.38442730903625,147.6964454650879,4757,1300,3457,3457,0,13,1761000.0
1761,1761999,21.541837082645145,38.25916020589241,0.059663544697317605,237.22569966316223,112.44852137565613,147.74255752563477,4757,1300,3457,3457,0,13,1762000.0
1762,1762999,21.543036261642577,38.25928318701455,0.0596505030432799,237.35281562805176,112.51278471946716,147.77093887329102,4757,1300,3457,3457,0,13,1763000.0
1763,1763999,21.545090755971458,38.26415172776746,0.05964109098993042,237.48661613464355,112.57672119140625,147.79854202270508,4757,1300,3457,3457,0,13,1764000.0
1764,1764999,21.5441187597522,38.259904629099225,0.05959241779044688,237.64512515068054,112.6524384021759,148.23077011108398,4768,1300,3468,3468,0,13,1765000.0
1765,1765999,21.54226951602162,38.25623018537322,0.05956333497164146,237.79124236106873,112.71638035774231,148.31371688842773,4773,1302,3471,3471,0,13,1766000.0
1766,1766999,21.540052527283667,38.253589484603175,0.05954468181053696,237.9420187473297,112.78115177154541,148.49562454223633,4780,1304,3476,3476,0,13,1767000.0
1767,1767999,21.538980085419087,38.25142113535983,0.059486206240812134,238.0771427154541,112.84547424316406,148.5883674621582,4784,1306,3478,3478,0,13,1768000.0
1768,1768999,21.537567738017202,38.248537390498875,0.059444193973897996,238.20452785491943,112.9105372428894,148.78961181640625,4790,1307,3483,3483,0,13,1769000.0
1769,1769999,21.535341009526764,38.24386490434908,0.05941753763149171,238.41494417190552,112.97657012939453,148.6836280822754,4802,1313,3489,3489,0,13,1770000.0
1770,1770999,21.533277950916016,38.238723728249305,0.05939487033378066,238.54629683494568,113.0411639213562,148.82135772705078,4805,1314,3491,3491,0,13,1771000.0
1771,1771999,21.531739015082017,38.23733080408824,0.05935060197933251,238.6809422969818,113.1062068939209,149.0057830810547,4805,1314,3491,3491,0,13,1772000.0
1772,1772999,21.530444350993623,38.234287982676996,0.05930390141753861,238.82072639465332,113.17158889770508,149.0186882019043,4807,1315,3492,3492,0,13,1773000.0
1773,1773999,21.528626589605462,38.23168310790102,0.05927939467660093,238.97000789642334,113.23637461662292,149.05579376220703,4810,1316,3494,3494,0,13,1774000.0
1774,1774999,21.52744922834638,38.228740747927496,0.05924361679358725,239.13368940353394,113.3013904094696,149.08460235595703,4815,1318,3497,3497,0,13,1775000.0
1775,1775999,21.52697366823574,38.22893823895246,0.05921873693147872,239.2770745754242,113.36632061004639,149.02096939086914,4820,1320,3500,3500,0,13,1776000.0
1776,1776999,21.528041820187962,38.23283747815462,0.05917645305490149,239.4199149608612,113.43142032623291,149.17096328735352,4820,1320,3500,3500,0,13,1777000.0
1777,1777999,21.52862942391177,38.23300342270871,0.059148647632530915,239.5751554965973,113.49685788154602,149.1585693359375,4826,1322,3504,3504,0,13,1778000.0
1778,1778999,21.53104597463085,38.238648957269014,0.05911616917255824,239.70267152786255,113.56171298027039,149.17980194091797,4828,1323,3505,3505,0,13,1779000.0
1779,1779999,21.53383455842021,38.243677324563265,0.05907918769784115,239.88272094726562,113.63485622406006,149.25669860839844,4828,1323,3505,3505,0,13,1780000.0
1780,1780999,21.53858014969014,38.254071927637035,0.05903309940084511,240.00757431983948,113.69953727722168,149.37334060668945,4828,1323,3505,3505,0,13,1781000.0
1781,1781999,21.543679433297346,38.26531476004159,0.05904169346623189,240.14461135864258,113.7651035785675,149.34284210205078,4830,1324,3506,3506,0,13,1782000.0
1782,1782999,21.548976644845112,38.27645232196516,0.059044925431985695,240.31310868263245,113.83092856407166,149.35018920898438,4832,1325,3507,3507,0,13,1783000.0
1783,1783999,21.55167220793308,38.279374062863496,0.059067716445848184,240.43302845954895,113.8960657119751,149.44927215576172,4832,1325,3507,3507,0,13,1784000.0
1784,1784999,21.551540495347936,38.27607198129205,0.05904041768502,240.57160806655884,113.96088480949402,149.98622131347656,4850,1326,3524,3524,0,13,1785000.0
1785,1785999,21.549640284178963,38.27296077009356,0.059025426492588906,240.68124222755432,114.02518343925476,150.24028778076172,4850,1326,3524,3524,0,13,1786000.0
1786,1786999,21.54674801172121,38.26774861080723,0.059026938680116325,240.80497932434082,114.0921277999878,150.42746353149414,4851,1326,3525,3525,0,13,1787000.0
1787,1787999,21.544668628799467,38.2647525593628,0.05902094059296836,240.97737526893616,114.15721869468689,150.43514251708984,4859,1330,3529,3529,0,13,1788000.0
1788,1788999,21.543100155672523,38.26211580998851,0.05901590062766038,241.1064920425415,114.22155785560608,150.6134147644043,4861,1331,3530,3530,0,13,1789000.0
1789,1789999,21.54168034219245,38.25893469212402,0.05901106002914336,241.27985882759094,114.28615236282349,150.6517562866211,4867,1334,3533,3533,0,13,1790000.0
1790,1790999,21.53937044691496,38.252987939809735,0.05900187419681091,241.4349160194397,114.3545606136322,150.7585792541504,4869,1335,3534,3534,0,13,1791000.0
1791,1791999,21.53766201161578,38.249253626125046,0.05898873155665363,241.57562828063965,114.41926741600037,150.8045310974121,4872,1336,3536,3536,0,13,1792000.0
1792,1792999,21.535297385837364,38.24341880422275,0.05898273244857222,241.71733713150024,114.4882435798645,150.9419822692871,4872,1336,3536,3536,0,13,1793000.0
1793,1793999,21.534519547026797,38.25018097281601,0.05892401246357193,241.84121131896973,114.55278182029724,151.0264892578125,4872,1336,3536,3536,0,13,1794000.0
1794,1794999,21.53419626623917,38.24770963259718,0.05891385099888302,241.98874235153198,114.61744832992554,151.05047225952148,4874,1337,3537,3537,0,13,1795000.0
1795,1795999,21.53271765486508,38.242873646684146,0.058897753675205444,242.1415514945984,114.68244338035583,151.0500602722168,4876,1338,3538,3538,0,13,1796000.0
1796,1796999,21.53199392617983,38.23955928171908,0.05889801814338025,242.30171751976013,114.74759125709534,151.06415176391602,4880,1340,3540,3540,0,13,1797000.0
1797,1797999,21.53065562819838,38.234994907492144,0.05889977847513139,242.45689821243286,114.82267236709595,151.15857315063477,4880,1340,3540,3540,0,13,1798000.0
1798,1798999,21.529404928645313,38.23107740357759,0.05889847166569129,242.61334347724915,114.88770270347595,151.19720840454102,4884,1342,3542,3542,0,13,1799000.0
1799,1799999,21.528808021913093,38.22805584521033,0.0589065606012944,242.732328414917,114.95384120941162,151.29679107666016,4884,1342,3542,3542,0,13,1800000.0
1800,1800999,21.528538216475425,38.23407779885507,0.058888925556486504,242.8720109462738,115.018315076828,151.3748893737793,4884,1342,3542,3542,0,13,1801000.0
1801,1801999,21.527784030838838,38.23087379234916,0.0588982001675058,243.03028869628906,115.08316779136658,151.35624313354492,4886,1343,3543,3543,0,13,1802000.0
1802,1802999,21.5277737913834,38.22768097073862,0.058895935073719374,243.1651873588562,115.14864349365234,151.41864395141602,4886,1343,3543,3543,0,13,1803000.0
1803,1803999,21.526369407292353,38.22334496480957,0.05890347076235236,243.30856823921204,115.21401381492615,151.41849899291992,4888,1344,3544,3544,0,13,1804000.0
1804,1804999,21.524288261428353,38.21803867338399,0.058919214413359566,243.45819807052612,115.27929496765137,151.46297454833984,4890,1345,3545,3545,0,13,1805000.0
1805,1805999,21.522127501350248,38.213986434541496,0.058905883910702284,243.5746603012085,115.34428596496582,151.84975814819336,4897,1345,3552,3552,0,13,1806000.0
1806,1806999,21.51882686896432,38.20861763779793,0.05891115350490694,243.69078373908997,115.40753149986267,152.12575912475586,4897,1345,3552,3552,0,13,1807000.0
1807,1807999,21.51753542344842,38.20760601077865,0.05888880752005943,243.82046461105347,115.47110986709595,152.28776168823242,4897,1345,3552,3552,0,13,1808000.0
1808,1808999,21.51757699265681,38.20947817042557,0.058923423249377715,244.00010657310486,115.53507685661316,152.3465805053711,4903,1348,3555,3555,0,13,1809000.0
1809,1809999,21.516231865761977,38.210141476386816,0.05893799212237982,244.12682032585144,115.60043907165527,152.49688720703125,4903,1348,3555,3555,0,13,1810000.0
1810,1810999,21.516233819586503,38.211404783634514,0.05899179843613134,244.24443173408508,115.66404986381531,152.63712310791016,4903,1348,3555,3555,0,13,1811000.0
1811,1811999,21.517481820332126,38.21455882329556,0.05900654165933039,244.43392610549927,115.728280544281,152.5640869140625,4911,1352,3559,3559,0,13,1812000.0
1812,1812999,21.51780568957166,38.21331985762669,0.059094330237060566,244.5629506111145,115.79214382171631,152.74351501464844,4911,1352,3559,3559,0,13,1813000.0
1813,1813999,21.517301499400716,38.21168397941616,0.05911413398750154,244.7095353603363,115.85634541511536,152.7033805847168,4914,1354,3560,3560,0,13,1814000.0
1814,1814999,21.517144624969813,38.212162138094556,0.05912702078049614,244.83500981330872,115.92110681533813,152.85224151611328,4914,1354,3560,3560,0,13,1815000.0
1815,1815999,21.518266413844472,38.21514074661471,0.05919359372319932,244.98849487304688,115.98689246177673,152.8782501220703,4917,1355,3562,3562,0,13,1816000.0
1816,1816999,21.51832653093655,38.213429717239606,0.05922878686615585,245.11476516723633,116.05115604400635,153.00994873046875,4917,1355,3562,3562,0,13,1817000.0
1817,1817999,21.518444463119703,38.21173912083449,0.05922153186722934,245.2571451663971,116.11526560783386,153.09518814086914,4917,1355,3562,3562,0,13,1818000.0
1818,1818999,21.520418499050976,38.21886166892321,0.059226576217115245,245.39830112457275,116.1802659034729,153.12329483032227,4919,1356,3563,3563,0,13,1819000.0
1819,1819999,21.52156415915229,38.21831786192849,0.05921313667872852,245.53604197502136,116.24727463722229,153.1863250732422,4919,1356,3563,3563,0,13,1820000.0
1820,1820999,21.522855184614464,38.21773539886749,0.05921491640550902,245.66767978668213,116.31188726425171,153.22998428344727,4919,1356,3563,3563,0,13,1821000.0
1821,1821999,21.525443701819604,38.22004522261116,0.05923001090019109,245.82018113136292,116.37628531455994,153.2140769958496,4922,1357,3565,3565,0,13,1822000.0
1822,1822999,21.527290714661568,38.21990848969247,0.05923429141327674,245.96370673179626,116.44068837165833,153.17885208129883,4924,1358,3566,3566,0,13,1823000.0
1823,1823999,21.53168838548122,38.2252541239649,0.059253180169645536,246.1183545589447,116.50598335266113,153.04727935791016,4929,1360,3569,3569,0,13,1824000.0
1824,1824999,21.5339909198543,38.22590400492008,0.05926316759366568,246.24689602851868,116.5710985660553,153.16727828979492,4929,1360,3569,3569,0,13,1825000.0
1825,1825999,21.533598953830587,38.222645630022285,0.05924204678798606,246.3645589351654,116.63664221763611,153.49566650390625,4938,1360,3578,3578,0,13,1826000.0
1826,1826999,21.53113591574075,38.21902647731177,0.05922400161293273,246.50699281692505,116.70146203041077,153.60918045043945,4940,1361,3579,3579,0,13,1827000.0
1827,1827999,21.528409478926395,38.21449610369802,0.059218056778724604,246.63569498062134,116.76568818092346,153.76216506958008,4940,1361,3579,3579,0,13,1828000.0
1828,1828999,21.527277838464325,38.21438355164113,0.059193546569933586,246.7619640827179,116.82986354827881,153.81932067871094,4942,1362,3580,3580,0,13,1829000.0
1829,1829999,21.524525105370763,38.208052001029706,0.0591782149583836,246.94417929649353,116.8949761390686,153.85003662109375,4950,1366,3584,3584,0,13,1830000.0
1830,1830999,21.52325764543652,38.21569621048222,0.0591253957669573,247.081955909729,116.96313381195068,154.00845336914062,4950,1366,3584,3584,0,13,1831000.0
1831,1831999,21.52219191456306,38.211736634423715,0.059104386689668664,247.23176264762878,117.02800559997559,153.9951400756836,4954,1367,3587,3587,0,13,1832000.0
1832,1832999,21.521316862597466,38.21071217313438,0.05908532384232479,247.37581777572632,117.09298324584961,154.02650833129883,4958,1369,3589,3589,0,13,1833000.0
1833,1833999,21.520853552229696,38.208018531600715,0.059067712428816366,247.5072147846222,117.15796566009521,154.1294174194336,4958,1369,3589,3589,0,13,1834000.0
1834,1834999,21.52085910610046,38.20717286854607,0.059054464298993414,247.63735365867615,117.22243928909302,154.19144439697266,4958,1369,3589,3589,0,13,1835000.0
1835,1835999,21.52290554769838,38.20935466689666,0.05903284140566356,247.79340028762817,117.28691363334656,154.16472625732422,4962,1370,3592,3592,0,13,1836000.0
1836,1836999,21.524613650326813,38.212451882354515,0.059027736847349965,247.94461917877197,117.3518922328949,154.22422409057617,4964,1371,3593,3593,0,13,1837000.0
1837,1837999,21.527036921943097,38.21607057596688,0.05902354356119177,248.06849694252014,117.41688942909241,154.2808074951172,4964,1371,3593,3593,0,13,1838000.0
1838,1838999,21.529622070842773,38.219170338293054,0.059024163163672094,248.18798542022705,117.48120665550232,154.31938552856445,4964,1371,3593,3593,0,13,1839000.0
1839,1839999,21.53338710385533,38.224735739520575,0.059039273221430655,248.34616589546204,117.5463330745697,154.2278823852539,4967,1372,3595,3595,0,13,1840000.0
1840,1840999,21.537903044468013,38.233280210747594,0.0590484908021891,248.492919921875,117.61141014099121,154.29966735839844,4967,1372,3595,3595,0,13,1841000.0
1841,1841999,21.543850440938957,38.24175199140129,0.05911050123771611,248.62165069580078,117.67614722251892,154.3576889038086,4967,1372,3595,3595,0,13,1842000.0
1842,1842999,21.549354541943718,38.24848430446445,0.05917122149563303,248.77815222740173,117.74105763435364,154.24676513671875,4973,1375,3598,3598,0,13,1843000.0
1843,1843999,21.556008118470793,38.258454943778936,0.05925135008984461,248.93469166755676,117.80649924278259,154.2715835571289,4977,1377,3600,3600,0,13,1844000.0
1844,1844999,21.562413607925528,38.27726398294028,0.05933249285323039,249.06890964508057,117.87161612510681,154.38245010375977,4979,1378,3601,3601,0,13,1845000.0
1845,1845999,21.566128128122703,38.28178761333897,0.05939656705837171,249.20323848724365,117.93691897392273,154.46884155273438,4979,1378,3601,3601,0,13,1846000.0
1846,1846999,21.56604984234781,38.27912281702177,0.059386898592806325,249.32516241073608,118.00087571144104,154.84941482543945,4988,1378,3610,3610,0,13,1847000.0
1847,1847999,21.56311790456512,38.27449872537936,0.059363853485989604,249.4467158317566,118.06484031677246,155.00251388549805,4988,1378,3610,3610,0,13,1848000.0
1848,1848999,21.560711083413306,38.268935975092404,0.05932434678829379,249.59916400909424,118.13783383369446,155.06037521362305,4990,1379,3611,3611,0,13,1849000.0
1849,1849999,21.557897132483948,38.26541833791646,0.059306719138814024,249.78515553474426,118.20288586616516,154.9898452758789,5002,1384,3618,3618,0,13,1850000.0
1850,1850999,21.555087462021085,38.26019110671835,0.05930331624352769,249.92192840576172,118.26792454719543,155.15081024169922,5004,1385,3619,3619,0,13,1851000.0
1851,1851999,21.552981753563287,38.25476572027919,0.059284050463700555,250.05565762519836,118.33270311355591,155.27203369140625,5006,1386,3620,3620,0,13,1852000.0
1852,1852999,21.55033354360475,38.24932700547209,0.05927617431579524,250.21129035949707,118.39802742004395,155.31647872924805,5008,1387,3621,3621,0,13,1853000.0
1853,1853999,21.54809651733874,38.24430536227268,0.0592677735408248,250.34008121490479,118.46312928199768,155.41221618652344,5008,1387,3621,3621,0,13,1854000.0
1854,1854999,21.54596221690718,38.23917224537257,0.05926847785975653,250.4717390537262,118.52813982963562,155.47922134399414,5008,1387,3621,3621,0,13,1855000.0
1855,1855999,21.545074447651434,38.2359970580638,0.059273547817913386,250.59815192222595,118.59297704696655,155.53533554077148,5008,1387,3621,3621,0,13,1856000.0
1856,1856999,21.543279623474994,38.231373672459505,0.05930914198472492,250.74261331558228,118.65822577476501,155.50186920166016,5010,1388,3622,3622,0,13,1857000.0
1857,1857999,21.542457894844198,38.22918306250157,0.05936565596740295,250.87531566619873,118.72377634048462,155.59270858764648,5010,1388,3622,3622,0,13,1858000.0
1858,1858999,21.542041999890152,38.22673422137056,0.05944180117309583,251.02397322654724,118.78948998451233,155.5908660888672,5012,1389,3623,3623,0,13,1859000.0
1859,1859999,21.54327208690012,38.22874228846845,0.05947809020864092,251.16361165046692,118.85482907295227,155.64105606079102,5012,1389,3623,3623,0,13,1860000.0
1860,1860999,21.544291083527778,38.22848992830431,0.05951450798483182,251.2876842021942,118.91999101638794,155.7075958251953,5012,1389,3623,3623,0,13,1861000.0
1861,1861999,21.546948607662895,38.231855574004,0.0595590573670407,251.43696665763855,118.98573446273804,155.6312370300293,5016,1390,3626,3626,0,13,1862000.0
1862,1862999,21.548964642991976,38.233092003407045,0.05964166276840377,251.60188913345337,119.05173325538635,155.6707878112793,5018,1391,3627,3627,0,13,1863000.0
1863,1863999,21.55154084258874,38.23435552857379,0.059711953178183674,251.75797867774963,119.11755180358887,155.61257553100586,5022,1393,3629,3629,0,13,1864000.0
1864,1864999,21.554635517443167,38.23726366010286,0.05975320400400563,251.88231325149536,119.18280863761902,155.70130920410156,5022,1393,3629,3629,0,13,1865000.0
1865,1865999,21.55744432327336,38.23857260155418,0.05980259079419892,252.03275513648987,119.24904823303223,155.6656150817871,5024,1394,3630,3630,0,13,1866000.0
1866,1866999,21.55807258607509,38.236911027920115,0.059834206346412566,252.1560287475586,119.31437849998474,155.75365829467773,5024,1394,3630,3630,0,13,1867000.0
1867,1867999,21.55662539183808,38.237742098637504,0.05980178362673294,252.29458785057068,119.3799946308136,156.3190803527832,5041,1394,3647,3647,0,13,1868000.0
1868,1868999,21.551421449829878,38.22991650741395,0.05982653965886775,252.4146430492401,119.44402384757996,156.57532119750977,5041,1394,3647,3647,0,13,1869000.0
1869,1869999,21.54776067884476,38.227871550335216,0.05983062961301788,252.55108857154846,119.50872445106506,156.68878936767578,5044,1395,3649,3649,0,13,1870000.0
1870,1870999,21.543839160105502,38.22180024641253,0.05984890669920295,252.69696474075317,119.57350850105286,156.77525329589844,5049,1397,3652,3652,0,13,1871000.0
1871,1871999,21.539894629785096,38.21517123820104,0.05986129569481724,252.84307670593262,119.63863897323608,156.92787170410156,5053,1399,3654,3654,0,13,1872000.0
1872,1872999,21.535884200579424,38.208772339806075,0.05987578269863958,252.99849915504456,119.7037901878357,157.029296875,5065,1402,3663,3663,0,13,1873000.0
1873,1873999,21.53241057669638,38.20199141705345,0.05990087080171702,253.15737199783325,119.76961708068848,157.07096099853516,5071,1405,3666,3666,0,13,1874000.0
1874,1874999,21.529511154838758,38.19745458082759,0.059903373418372485,253.3070023059845,119.8354001045227,157.16022872924805,5075,1407,3668,3668,0,13,1875000.0
1875,1875999,21.526863369000825,38.19207161069646,0.0599181991886264,253.4447648525238,119.90496349334717,157.30710220336914,5075,1407,3668,3668,0,13,1876000.0
1876,1876999,21.524738919470927,38.188574146630216,0.059913672780618654,253.57159304618835,119.96986985206604,157.41301727294922,5075,1407,3668,3668,0,13,1877000.0
1877,1877999,21.522812985081433,38.186512458986606,0.059913302170902405,253.71348214149475,120.03562378883362,157.49879455566406,5075,1407,3668,3668,0,13,1878000.0
1878,1878999,21.521730503053174,38.1845692101338,0.05991539209645236,253.84557604789734,120.10412955284119,157.5785255432129,5075,1407,3668,3668,0,13,1879000.0
1879,1879999,21.520880792168068,38.18222265584009,0.059936514260210294,254.00381660461426,120.1701307296753,157.55896377563477,5079,1409,3670,3670,0,13,1880000.0
1880,1880999,21.520615378357657,38.18591249409196,0.059944432877136244,254.12320232391357,120.23540234565735,157.6612434387207,5079,1409,3670,3670,0,13,1881000.0
1881,1881999,21.52039717134695,38.18437666176164,0.0599469607183164,254.24693822860718,120.30184030532837,157.75541305541992,5079,1409,3670,3670,0,13,1882000.0
1882,1882999,21.521179673981273,38.183967713888045,0.05996530766210806,254.45192098617554,120.36874127388,157.57412719726562,5088,1413,3675,3675,0,13,1883000.0
1883,1883999,21.521192512882717,38.1822024082817,0.060016445661877915,254.57883763313293,120.43498659133911,157.70941162109375,5088,1413,3675,3675,0,13,1884000.0
1884,1884999,21.52264281248308,38.18333550243369,0.06007902410767363,254.73952054977417,120.50225186347961,157.72889709472656,5092,1415,3677,3677,0,13,1885000.0
1885,1885999,21.523819088687713,38.18315758446942,0.06010684083316964,254.87966346740723,120.56856298446655,157.78133010864258,5094,1416,3678,3678,0,13,1886000.0
1886,1886999,21.524048795082706,38.18122133516355,0.06014093603797854,255.0005006790161,120.63452339172363,157.8930206298828,5094,1416,3678,3678,0,13,1887000.0
1887,1887999,21.52453883697542,38.1794546511738,0.06015362184515871,255.13738250732422,120.7009162902832,157.96967697143555,5094,1416,3678,3678,0,13,1888000.0
1888,1888999,21.522342756561088,38.17391628299268,0.06014310808454082,255.29869270324707,120.76610612869263,158.38983917236328,5113,1418,3695,3695,0,13,1889000.0
1889,1889999,21.518636958462025,38.16737923977765,0.06015251342298167,255.4122531414032,120.83102893829346,158.68465423583984,5114,1418,3696,3696,0,13,1890000.0
1890,1890999,21.51648794989724,38.16385505534182,0.06015853345936417,255.53377842903137,120.8950207233429,158.7867317199707,5116,1419,3697,3697,0,13,1891000.0
1891,1891999,21.513246708889668,38.157761658261514,0.06017493216553904,255.69814157485962,120.96073174476624,158.8472671508789,5122,1422,3700,3700,0,13,1892000.0
1892,1892999,21.51019748626642,38.15158323664959,0.060177688620009606,255.8333077430725,121.02527213096619,159.03168106079102,5124,1423,3701,3701,0,13,1893000.0
1893,1893999,21.507946459482536,38.14704379792158,0.06019001671022639,255.99120163917542,121.09101438522339,159.08872985839844,5130,1426,3704,3704,0,13,1894000.0
1894,1894999,21.50574895475997,38.144853367718454,0.06017522653250329,256.14780282974243,121.1566092967987,159.19814682006836,5132,1427,3705,3705,0,13,1895000.0
1895,1895999,21.503696112981476,38.142279069468266,0.060162535711530074,256.32310485839844,121.22747039794922,159.14867401123047,5138,1430,3708,3708,0,13,1896000.0
1896,1896999,21.50142559788779,38.1370765207947,0.06017073569889653,256.45171308517456,121.29271197319031,159.33488082885742,5138,1430,3708,3708,0,13,1897000.0
1897,1897999,21.498667964454505,38.131725937945774,0.06016928865492177,256.5986828804016,121.35851311683655,159.35601425170898,5142,1431,3711,3711,0,13,1898000.0
1898,1898999,21.497040931247582,38.12833484807137,0.060155388739415505,256.75466132164,121.43271851539612,159.4602394104004,5142,1431,3711,3711,0,13,1899000.0
1899,1899999,21.49504661164391,38.12626913321199,0.06013736996855967,256.89024019241333,121.5020523071289,159.5428924560547,5142,1431,3711,3711,0,13,1900000.0
1900,1900999,21.492199052602686,38.12007158557338,0.0601448333582032,257.0284991264343,121.56738781929016,159.60188674926758,5142,1431,3711,3711,0,13,1901000.0
1901,1901999,21.49005806994791,38.114931683977005,0.060147380568437825,257.172180891037,121.63276481628418,159.6371078491211,5144,1432,3712,3712,0,13,1902000.0
1902,1902999,21.488419387066678,38.11053553111042,0.06014735856028797,257.3035457134247,121.69809079170227,159.7015609741211,5144,1432,3712,3712,0,13,1903000.0
1903,1903999,21.48759430247573,38.10688744446749,0.060152712072091497,257.42646074295044,121.76349997520447,159.7775535583496,5144,1432,3712,3712,0,13,1904000.0
1904,1904999,21.485959820339463,38.10197637749888,0.060152912444679796,257.57106375694275,121.82885694503784,159.82378768920898,5144,1432,3712,3712,0,13,1905000.0
1905,1905999,21.484111507436978,38.09701911194591,0.06015875202809673,257.6962397098541,121.8942358493805,159.8647804260254,5146,1433,3713,3713,0,13,1906000.0
1906,1906999,21.481400643806623,38.09196921701257,0.06015271197508276,257.8504571914673,121.96504521369934,160.33575057983398,5158,1433,3725,3725,0,13,1907000.0
1907,1907999,21.477602469392323,38.086890870493924,0.060162616851152095,257.9719023704529,122.02927684783936,160.58397674560547,5159,1433,3726,3726,0,13,1908000.0
1908,1908999,21.47364846090281,38.08184517338765,0.060186133385324414,258.13593339920044,122.09489226341248,160.61754608154297,5166,1436,3730,3730,0,13,1909000.0
1909,1909999,21.469404046240207,38.07613209701612,0.060221077405627765,258.3042025566101,122.16115975379944,160.76348114013672,5170,1438,3732,3732,0,13,1910000.0
1910,1910999,21.465509963950076,38.070057222432936,0.060252060891470616,258.42941331863403,122.22570538520813,160.916748046875,5170,1438,3732,3732,0,13,1911000.0
1911,1911999,21.4615907120446,38.063358626443666,0.060291067651097374,258.55124521255493,122.29144835472107,161.0343475341797,5170,1438,3732,3732,0,13,1912000.0
1912,1912999,21.457291999326134,38.05609484741801,0.060318212222646994,258.6824107170105,122.35615682601929,161.1245574951172,5170,1438,3732,3732,0,13,1913000.0
1913,1913999,21.45386163500435,38.05001931554345,0.06033823002763361,258.84066009521484,122.4218237400055,161.14825439453125,5174,1439,3735,3735,0,13,1914000.0
1914,1914999,21.4504869643361,38.04889338181812,0.06034941704435892,258.97945261001587,122.48719358444214,161.13390350341797,5176,1440,3736,3736,0,13,1915000.0
1915,1915999,21.447450872389982,38.045002746128844,0.06036313396108828,259.11575055122375,122.55262017250061,161.18607330322266,5176,1440,3736,3736,0,13,1916000.0
1916,1916999,21.44393030218569,38.03919701757881,0.06039450646739741,259.26669335365295,122.61770820617676,161.22884368896484,5178,1441,3737,3737,0,13,1917000.0
1917,1917999,21.441052658321702,38.034619967362936,0.06041394862178906,259.40147256851196,122.68299746513367,161.27948379516602,5178,1441,3737,3737,0,13,1918000.0
1918,1918999,21.438618242181203,38.042657610093784,0.0603812669936431,259.5283365249634,122.74751710891724,161.3232765197754,5178,1441,3737,3737,0,13,1919000.0
1919,1919999,21.43661911570276,38.03956311831476,0.06038730046675278,259.686683177948,122.81292676925659,161.27455139160156,5180,1442,3738,3738,0,13,1920000.0
1920,1920999,21.435235690418043,38.03809066254635,0.06039371884068401,259.8111298084259,122.87804937362671,161.34459686279297,5180,1442,3738,3738,0,13,1921000.0
1921,1921999,21.433530805005628,38.03730885532642,0.06038675880275213,259.9645481109619,122.94379234313965,161.2894172668457,5183,1443,3740,3740,0,13,1922000.0
1922,1922999,21.431104308268434,38.03205531858241,0.0604015568363615,260.0952184200287,123.00886058807373,161.35436248779297,5183,1443,3740,3740,0,13,1923000.0
1923,1923999,21.42962154644901,38.0287184135985,0.06040623881916074,260.2334234714508,123.07438349723816,161.33215713500977,5185,1444,3741,3741,0,13,1924000.0
1924,1924999,21.42705062776886,38.023816904902695,0.060410718673449604,260.3709626197815,123.13971328735352,161.3437042236328,5187,1445,3742,3742,0,13,1925000.0
1925,1925999,21.42440590324304,38.018856470747174,0.060416111581402254,260.5218679904938,123.20509648323059,161.39129638671875,5189,1446,3743,3743,0,13,1926000.0
1926,1926999,21.421554468440892,38.01615691476561,0.060396745395203344,260.65190076828003,123.26988458633423,161.90610122680664,5202,1446,3756,3756,0,13,1927000.0
1927,1927999,21.416936315370656,38.01163162627999,0.060405260151105145,260.78038477897644,123.33472490310669,162.11182022094727,5207,1447,3760,3760,0,13,1928000.0
1928,1928999,21.41229151918775,38.00510232583943,0.06042014836089238,260.9131910800934,123.40048289299011,162.22545623779297,5210,1448,3762,3762,0,13,1929000.0
1929,1929999,21.408481760505158,38.00116393332073,0.060428062837223906,261.08210134506226,123.4661192893982,162.25293731689453,5218,1452,3766,3766,0,13,1930000.0
1930,1930999,21.404391836281327,37.994800599698294,0.060430671023534166,261.24914836883545,123.53238320350647,162.39104843139648,5222,1454,3768,3768,0,13,1931000.0
1931,1931999,21.400027276816427,37.98776933141855,0.06044990667262118,261.40328335762024,123.59831833839417,162.4644889831543,5226,1456,3770,3770,0,13,1932000.0
1932,1932999,21.39598771578397,37.98086865723214,0.06046360542249907,261.5431170463562,123.6642656326294,162.56933975219727,5229,1457,3772,3772,0,13,1933000.0
1933,1933999,21.392101965389866,37.974701356515006,0.06047732780339765,261.66814970970154,123.72975158691406,162.6852149963379,5229,1457,3772,3772,0,13,1934000.0
1934,1934999,21.388555732457597,37.969263170826046,0.06048030212957145,261.8011255264282,123.79610919952393,162.7637710571289,5229,1457,3772,3772,0,13,1935000.0
1935,1935999,21.384662056345594,37.96286449284148,0.06049628736600565,261.94160437583923,123.8617856502533,162.832763671875,5229,1457,3772,3772,0,13,1936000.0
1936,1936999,21.381239857792604,37.956984635290475,0.06051046155812867,262.10551929473877,123.92772054672241,162.77888870239258,5235,1460,3775,3775,0,13,1937000.0
1937,1937999,21.37879663395701,37.95437641603098,0.06050046441583501,262.2640860080719,123.99398016929626,162.8207893371582,5241,1462,3779,3779,0,13,1938000.0
1938,1938999,21.375077282945483,37.94881547084372,0.06051499158122653,262.40519547462463,124.06056761741638,162.89772415161133,5241,1462,3779,3779,0,13,1939000.0
1939,1939999,21.372164226500832,37.94322693517665,0.060519373938007215,262.5366780757904,124.12644910812378,162.94873046875,5241,1462,3779,3779,0,13,1940000.0
1940,1940999,21.36919193273135,37.93884540448387,0.060524696750817286,262.68706464767456,124.19265031814575,163.0113525390625,5243,1463,3780,3780,0,13,1941000.0
1941,1941999,21.366745804509474,37.93488108063668,0.06053574735462086,262.81060910224915,124.25813603401184,163.05802154541016,5243,1463,3780,3780,0,13,1942000.0
1942,1942999,21.364137064124325,37.92946547379588,0.0605434422342519,262.93264722824097,124.32353472709656,163.11956787109375,5243,1463,3780,3780,0,13,1943000.0
1943,1943999,21.362276563488262,37.9288000326571,0.06052732706063291,263.06745314598083,124.38949036598206,163.1710433959961,5243,1463,3780,3780,0,13,1944000.0
1944,1944999,21.359702826606945,37.923185052885266,0.06054975985235633,263.23200726509094,124.46051359176636,163.10388565063477,5244,1464,3780,3780,0,13,1945000.0
1945,1945999,21.357091635298747,37.91772020412946,0.060556700621177684,263.3702356815338,124.52876305580139,163.1760368347168,5244,1464,3780,3780,0,13,1946000.0
1946,1946999,21.353698456022514,37.911763218747765,0.06056240680287406,263.5095932483673,124.59448838233948,163.24072265625,5244,1464,3780,3780,0,13,1947000.0
1947,1947999,21.35024660112755,37.905919379136236,0.0605797830377488,263.64643454551697,124.65932416915894,163.7072525024414,5255,1464,3791,3791,0,13,1948000.0
1948,1948999,21.345046519162647,37.899397573630225,0.060607777068251156,263.7573652267456,124.72390842437744,163.9117774963379,5255,1464,3791,3791,0,13,1949000.0
1949,1949999,21.340174366720884,37.892891581196686,0.060633737037144364,263.8795304298401,124.78889584541321,164.01740646362305,5255,1464,3791,3791,0,13,1950000.0
1950,1950999,21.336290826088106,37.88867025162169,0.06064063127682395,264.0774531364441,124.8539891242981,163.96868133544922,5263,1468,3795,3795,0,13,1951000.0
1951,1951999,21.33202802102381,37.88182129274433,0.060656283771576947,264.21296644210815,124.91882872581482,164.09063339233398,5265,1469,3796,3796,0,13,1952000.0
1952,1952999,21.327797102555447,37.875227834333145,0.060672472820651246,264.33260846138,124.98364615440369,164.26302337646484,5265,1469,3796,3796,0,13,1953000.0
1953,1953999,21.32342655037151,37.86873710979178,0.06069389818105719,264.46922039985657,125.04839968681335,164.27022552490234,5267,1470,3797,3797,0,13,1954000.0
1954,1954999,21.319076165484148,37.86151553360777,0.06071103597196259,264.63606214523315,125.11357951164246,164.25693893432617,5275,1473,3802,3802,0,13,1955000.0
1955,1955999,21.315000137382615,37.85657601402388,0.06070979507022778,264.7763514518738,125.17903208732605,164.34587478637695,5275,1473,3802,3802,0,13,1956000.0
1956,1956999,21.311183699503214,37.85107329369633,0.06072518750038791,264.9033851623535,125.2465603351593,164.42098999023438,5275,1473,3802,3802,0,13,1957000.0
1957,1957999,21.308166795824818,37.847992434828036,0.06072419109537519,265.0636348724365,125.31224632263184,164.40505981445312,5281,1475,3806,3806,0,13,1958000.0
1958,1958999,21.304722208927046,37.84488143128219,0.06072097556629019,265.19404697418213,125.37747192382812,164.50665283203125,5281,1475,3806,3806,0,13,1959000.0
1959,1959999,21.301702029583844,37.840880903977975,0.060715231172938866,265.33096051216125,125.44263219833374,164.56550979614258,5281,1475,3806,3806,0,13,1960000.0
1960,1960999,21.298730862732167,37.83545629249544,0.060714187317981394,265.47541427612305,125.50775623321533,164.60655212402344,5281,1475,3806,3806,0,13,1961000.0
1961,1961999,21.296056505067213,37.82989919899669,0.06070845263485625,265.6014506816864,125.57333779335022,164.65636825561523,5281,1475,3806,3806,0,13,1962000.0
1962,1962999,21.294000267047057,37.826382712583495,0.060694760415279214,265.72193026542664,125.63833618164062,164.68656158447266,5281,1475,3806,3806,0,13,1963000.0
1963,1963999,21.29229819377409,37.82286706792067,0.06067363459668196,265.88022685050964,125.70358300209045,164.68795776367188,5283,1476,3807,3807,0,13,1964000.0
1964,1964999,21.289810191021132,37.81758355210037,0.06066815872625231,266.00739216804504,125.76902961730957,164.72792434692383,5283,1476,3807,3807,0,13,1965000.0
1965,1965999,21.288379691641065,37.81725686724882,0.06065222639656964,266.1590745449066,125.83402371406555,164.78274154663086,5283,1476,3807,3807,0,13,1966000.0
1966,1966999,21.285629360604172,37.81163507959007,0.06065497298116951,266.2917482852936,125.89970207214355,164.83566284179688,5283,1476,3807,3807,0,13,1967000.0
1967,1967999,21.2836037035111,37.80711777295753,0.060660066648626,266.4168744087219,125.96423316001892,164.89213180541992,5283,1476,3807,3807,0,13,1968000.0
1968,1968999,21.282844923829863,37.80965403404756,0.06063509439080983,266.53920459747314,126.02949285507202,165.2234764099121,5289,1476,3813,3813,0,13,1969000.0
1969,1969999,21.2833276582855,37.81784289591817,0.060597893951271464,266.6829001903534,126.09414553642273,165.2521629333496,5292,1477,3815,3815,0,13,1970000.0
1970,1970999,21.283925972774327,37.82020544646768,0.060585546027086656,266.8075578212738,126.15878558158875,165.36056900024414,5292,1477,3815,3815,0,13,1971000.0
1971,1971999,21.28582617712481,37.82609193354505,0.06057841048132817,266.9726724624634,126.2240686416626,165.32462692260742,5298,1480,3818,3818,0,13,1972000.0
1972,1972999,21.286890624052045,37.83020369556488,0.060667866645789936,267.10346698760986,126.28900456428528,165.4471206665039,5300,1481,3819,3819,0,13,1973000.0
1973,1973999,21.29104111195045,37.84465847537977,0.06072525314274768,267.2486503124237,126.35460472106934,165.54874801635742,5300,1481,3819,3819,0,13,1974000.0
1974,1974999,21.294677819141526,37.856744683108445,0.06078097431779739,267.3930251598358,126.41997003555298,165.5625991821289,5302,1482,3820,3820,0,13,1975000.0
1975,1975999,21.29777818529164,37.86690662838156,0.060854890981990484,267.5469801425934,126.4855728149414,165.5946502685547,5304,1483,3821,3821,0,13,1976000.0
1976,1976999,21.300553287231306,37.875462821271284,0.06090310434482171,267.6883635520935,126.55113983154297,165.66894149780273,5304,1483,3821,3821,0,13,1977000.0
1977,1977999,21.304404231397804,37.886069614473364,0.06096473442187611,267.80752968788147,126.61627674102783,165.7192497253418,5304,1483,3821,3821,0,13,1978000.0
1978,1978999,21.308463461132888,37.89652375772847,0.06105214819860838,267.9511902332306,126.68146276473999,165.7292022705078,5306,1484,3822,3822,0,13,1979000.0
1979,1979999,21.312846182449718,37.91208315435824,0.061065680077579065,268.10571122169495,126.74759674072266,165.74830627441406,5308,1485,3823,3823,0,13,1980000.0
1980,1980999,21.316519541856405,37.92005085377132,0.06106583745396754,268.2544746398926,126.8131206035614,165.75236892700195,5312,1486,3826,3826,0,13,1981000.0
1981,1981999,21.32024146435308,37.92547146336919,0.06104294856022774,268.4006335735321,126.87868285179138,165.8064308166504,5312,1486,3826,3826,0,13,1982000.0
1982,1982999,21.325138812977638,37.93484122638046,0.06107586214208549,268.5166747570038,126.94384598731995,165.84453201293945,5312,1486,3826,3826,0,13,1983000.0
1983,1983999,21.32976637151268,37.94462182804903,0.06103501320552751,268.66259503364563,127.00938582420349,165.80575561523438,5314,1487,3827,3827,0,13,1984000.0
1984,1984999,21.333694398640844,37.952378096935995,0.061042116603708396,268.8157229423523,127.07501220703125,165.79373168945312,5320,1489,3831,3831,0,13,1985000.0
1985,1985999,21.33873167469781,37.96359442666212,0.061052412122672206,268.9492816925049,127.14207625389099,165.87856674194336,5320,1489,3831,3831,0,13,1986000.0
1986,1986999,21.342617486874165,37.96746840134878,0.061099655718896084,269.1086914539337,127.20834302902222,165.89841079711914,5322,1490,3832,3832,0,13,1987000.0
1987,1987999,21.34476429295791,37.96767451015106,0.06109291316965881,269.25429224967957,127.27369260787964,165.88828659057617,5324,1491,3833,3833,0,13,1988000.0
1988,1988999,21.34198622731851,37.96591840717752,0.061073460909672916,269.3779807090759,127.339519739151,166.69979095458984,5344,1491,3853,3853,0,13,1989000.0
1989,1989999,21.339294256369925,37.96115520149186,0.06107829652453978,269.49784779548645,127.40463995933533,166.99468994140625,5344,1491,3853,3853,0,13,1990000.0
1990,1990999,21.33862826625445,37.96120361378753,0.06106472694763698,269.644362449646,127.47008752822876,167.12574005126953,5348,1493,3855,3855,0,13,1991000.0
1991,1991999,21.33699888353781,37.957770707902355,0.06105332956404197,269.8246865272522,127.5373067855835,167.16253662109375,5362,1498,3864,3864,0,13,1992000.0
1992,1992999,21.337676491922686,37.958877678077,0.06101119708281422,269.9652397632599,127.60362577438354,167.37500762939453,5364,1499,3865,3865,0,13,1993000.0
1993,1993999,21.33841624249393,37.95965167950093,0.060999395530342726,270.1020438671112,127.66962051391602,167.57118225097656,5366,1500,3866,3866,0,13,1994000.0
1994,1994999,21.340032542970402,37.96218199394009,0.06099118608294707,270.24995827674866,127.73652935028076,167.66830444335938,5369,1501,3868,3868,0,13,1995000.0
1995,1995999,21.342364956026454,37.96450352844875,0.06099281592895878,270.40087032318115,127.80268239974976,167.77956008911133,5373,1503,3870,3870,0,13,1996000.0
1996,1996999,21.346374509316085,37.97140272473962,0.06098161857926798,270.5215799808502,127.86882543563843,167.9059066772461,5373,1503,3870,3870,0,13,1997000.0
1997,1997999,21.349790220005577,37.97751035078429,0.06097216222426627,270.67492389678955,127.93522882461548,167.93384552001953,5377,1505,3872,3872,0,13,1998000.0
1998,1998999,21.35445644147488,37.98698337508531,0.06103335636881846,270.84391593933105,128.00149059295654,167.97738647460938,5381,1507,3874,3874,0,13,1999000.0
1999,1999999,21.359250390284238,37.99522305225875,0.061104557473685595,270.95843505859375,128.06783485412598,168.13716888427734,5381,1507,3874,3874,0,13,2000000.0
2000,2000999,21.36517645093746,38.00654943136055,0.061193798948096956,271.1177339553833,128.1343743801117,168.1544189453125,5385,1509,3876,3876,0,13,2001000.0
2001,2001999,21.371056265316334,38.016935340889496,0.061319131592173726,271.92577743530273,128.2010588645935,168.30686950683594,5385,1509,3876,3876,0,13,2002000.0
2002,2002999,21.37617104875939,38.02502020058629,0.06142969655677999,272.07334089279175,128.26776480674744,168.36211395263672,5416,1510,3906,3906,0,13,2003000.0
2003,2003999,21.38228537786347,38.04163643248132,0.06146106377805105,272.21985125541687,128.33409881591797,168.36949157714844,5420,1511,3909,3909,0,13,2004000.0
2004,2004999,21.38809801909136,38.04894525850224,0.0615278049404,272.3599851131439,128.4005777835846,168.46496200561523,5420,1511,3909,3909,0,13,2005000.0
2005,2005999,21.394529225877935,38.05825140125517,0.061591974646868164,272.49100732803345,128.46704196929932,168.5321044921875,5420,1511,3909,3909,0,13,2006000.0
2006,2006999,21.40241020699916,38.07023999108365,0.06164790898002459,272.638236284256,128.5336902141571,168.5114974975586,5422,1512,3910,3910,0,13,2007000.0
2007,2007999,21.40732436889767,38.075843032466025,0.06167615124400316,272.76627588272095,128.60065364837646,168.63652801513672,5422,1512,3910,3910,0,13,2008000.0
2008,2008999,21.408574772769143,38.07953413160165,0.061619555308778606,272.90165162086487,128.66648817062378,169.23511123657227,5440,1512,3928,3928,0,13,2009000.0
2009,2009999,21.405673064305486,38.078254527404845,0.06157608911479673,273.04391145706177,128.73154091835022,169.50433349609375,5472,1513,3959,3959,0,13,2010000.0
2010,2010999,21.402613351606995,38.07331167405859,0.06157915548735848,273.164142370224,128.79645490646362,169.67419815063477,5472,1513,3959,3959,0,13,2011000.0
2011,2011999,21.39997820181126,38.06903808893833,0.061571646120556545,273.3278634548187,128.86216259002686,169.7407112121582,5478,1516,3962,3962,0,13,2012000.0
2012,2012999,21.3973616184404,38.07628232885179,0.06152404870726991,273.47735500335693,128.92819952964783,169.82293319702148,5482,1518,3964,3964,0,13,2013000.0
2013,2013999,21.39407025328197,38.069822349023795,0.06152508825811909,273.61351108551025,128.99370574951172,170.01348876953125,5484,1519,3965,3965,0,13,2014000.0
2014,2014999,21.391361152221187,38.06478826879418,0.06151922605575222,273.7468011379242,129.05977201461792,170.18203735351562,5484,1519,3965,3965,0,13,2015000.0
2015,2015999,21.388737250990335,38.05959865363529,0.061513913246872165,273.9139988422394,129.12585639953613,170.2029571533203,5493,1522,3971,3971,0,13,2016000.0
2016,2016999,21.38576410794117,38.05411062504402,0.06151962306266123,274.0500500202179,129.1924388408661,170.32579803466797,5493,1522,3971,3971,0,13,2017000.0
2017,2017999,21.38406774075239,38.052594259408274,0.061505263592947834,274.18704056739807,129.2583565711975,170.3692741394043,5496,1523,3973,3973,0,13,2018000.0
2018,2018999,21.382888170530887,38.04940065735579,0.06148375616907731,274.3408215045929,129.32480001449585,170.4168357849121,5498,1524,3974,3974,0,13,2019000.0
2019,2019999,21.382335296673254,38.04743688770428,0.061471054909829514,274.49826288223267,129.39122867584229,170.48512268066406,5502,1525,3977,3977,0,13,2020000.0
2020,2020999,21.382270505664163,38.04548785452842,0.061465204858621614,274.6503276824951,129.4573097229004,170.47808837890625,5505,1526,3979,3979,0,13,2021000.0
2021,2021999,21.382718870492475,38.04593598223385,0.0614651956993465,274.7874958515167,129.5233817100525,170.55213928222656,5505,1526,3979,3979,0,13,2022000.0
2022,2022999,21.384039215702604,38.04751400225757,0.06146941090304725,274.9423997402191,129.59031653404236,170.59032440185547,5510,1528,3982,3982,0,13,2023000.0
2023,2023999,21.38731015173757,38.05475808110675,0.06149195607849889,275.0807075500488,129.65662336349487,170.66230392456055,5510,1528,3982,3982,0,13,2024000.0
2024,2024999,21.392723225892315,38.0679089968513,0.061544203696458855,275.2221851348877,129.7228696346283,170.76122283935547,5510,1528,3982,3982,0,13,2025000.0
2025,2025999,21.39930884036321,38.08046603800582,0.06160981057576487,275.3575222492218,129.7891983985901,170.82619094848633,5510,1528,3982,3982,0,13,2026000.0
2026,2026999,21.40498382577543,38.093866352777404,0.06165595441851979,275.50563383102417,129.85611844062805,170.8421859741211,5512,1529,3983,3983,0,13,2027000.0
2027,2027999,21.40848861466355,38.09835529561932,0.06171715072437867,275.6428806781769,129.92282605171204,170.94411087036133,5512,1529,3983,3983,0,13,2028000.0
2028,2028999,21.40934279873852,38.09812031044856,0.06178400392324379,275.78304719924927,129.98897099494934,171.0048942565918,5514,1530,3984,3984,0,13,2029000.0
2029,2029999,21.408367495808005,38.09773719465289,0.06175110033944997,275.9169659614563,130.05595421791077,171.90870666503906,5541,1530,4011,4011,0,13,2030000.0
2030,2030999,21.40644182392146,38.09438898880277,0.061745101274676695,276.0354392528534,130.12146401405334,172.24903869628906,5541,1530,4011,4011,0,13,2031000.0
2031,2031999,21.4039263523564,38.09052222201559,0.061737612038147316,276.1903598308563,130.1879529953003,172.3960418701172,5545,1532,4013,4013,0,13,2032000.0
2032,2032999,21.402957202431065,38.09134447878842,0.0617167028547867,276.3531913757324,130.25391483306885,172.51040267944336,5551,1535,4016,4016,0,13,2033000.0
2033,2033999,21.401008940406488,38.08688325550267,0.06170461290991269,276.47440910339355,130.3197066783905,172.7799301147461,5551,1535,4016,4016,0,13,2034000.0
2034,2034999,21.39930215734875,38.082838889302366,0.06168710547443634,276.6243362426758,130.38587951660156,172.88146591186523,5553,1536,4017,4017,0,13,2035000.0
2035,2035999,21.39811654352499,38.07938001099282,0.06167622482093915,276.80537462234497,130.452392578125,172.8035545349121,5561,1540,4021,4021,0,13,2036000.0
2036,2036999,21.39697146713148,38.07947830286453,0.061672478803153075,276.9417634010315,130.5186984539032,172.96004104614258,5563,1541,4022,4022,0,13,2037000.0
2037,2037999,21.3955764954234,38.07734550372579,0.0616516562563012,277.119087934494,130.5856602191925,172.8897476196289,5573,1544,4029,4029,0,13,2038000.0
2038,2038999,21.394505315659742,38.07937855149221,0.06164008926477804,277.2398443222046,130.65171194076538,173.07268905639648,5573,1544,4029,4029,0,13,2039000.0
2039,2039999,21.393512001070533,38.08152770136679,0.0616244898597641,277.37704157829285,130.71784329414368,173.18630981445312,5573,1544,4029,4029,0,13,2040000.0
2040,2040999,21.39152064534127,38.076458670361916,0.06161836970125789,277.53365445137024,130.78496956825256,173.22282028198242,5575,1545,4030,4030,0,13,2041000.0
2041,2041999,21.390620261325317,38.073361435169616,0.061592901628581775,277.66679978370667,130.85127973556519,173.31580352783203,5577,1546,4031,4031,0,13,2042000.0
2042,2042999,21.389689301615817,38.069849393414415,0.061590028445200895,277.8045024871826,130.91779088974,173.4036979675293,5577,1546,4031,4031,0,13,2043000.0
2043,2043999,21.3890495413408,38.06940944284176,0.06158371524930972,277.97513341903687,130.98923754692078,173.457763671875,5579,1547,4032,4032,0,13,2044000.0
2044,2044999,21.387931609540804,38.0685319999419,0.06159054101789052,278.14702916145325,131.061518907547,173.50276947021484,5585,1549,4036,4036,0,13,2045000.0
2045,2045999,21.38654787935578,38.063854007080614,0.06159227055995531,278.28173089027405,131.12779259681702,173.5744285583496,5585,1549,4036,4036,0,13,2046000.0
2046,2046999,21.384645160332063,38.05837033505075,0.061590764444299895,278.4427890777588,131.1939082145691,173.5432357788086,5591,1551,4040,4040,0,13,2047000.0
2047,2047999,21.382969341691634,38.05394591204619,0.06153081374673719,278.5805768966675,131.26157307624817,174.36385345458984,5618,1552,4066,4066,0,13,2048000.0
2048,2048999,21.382603393675357,38.05443517749016,0.06147196086156337,278.69686102867126,131.32640767097473,174.68821334838867,5618,1552,4066,4066,0,13,2049000.0
2049,2049999,21.381678653473706,38.05084279122249,0.06145763057399145,278.8443341255188,131.40267634391785,174.82740020751953,5620,1553,4067,4067,0,13,2050000.0
2050,2050999,21.380816354497217,38.04833481614982,0.06143286807603232,278.9748423099518,131.46776866912842,174.99706268310547,5623,1554,4069,4069,0,13,2051000.0
2051,2051999,21.38013051908264,38.045097115318605,0.06138413562641043,279.0874559879303,131.53286576271057,175.23601150512695,5623,1554,4069,4069,0,13,2052000.0
2052,2052999,21.37950556393995,38.04605029957185,0.0613334119530512,279.2326533794403,131.5983922481537,175.33181381225586,5625,1555,4070,4070,0,13,2053000.0
2053,2053999,21.38051855935713,38.04852235563562,0.06134442678133578,279.4091591835022,131.66414642333984,175.32057571411133,5634,1559,4075,4075,0,13,2054000.0
2054,2054999,21.38115953827544,38.05110941689544,0.06135590834943094,279.55306029319763,131.73681902885437,175.47143936157227,5634,1559,4075,4075,0,13,2055000.0
2055,2055999,21.381947747100952,38.05139574743894,0.06134088962822959,279.72193360328674,131.80320024490356,175.4447364807129,5641,1562,4079,4079,0,13,2056000.0
2056,2056999,21.384052516935157,38.05703132027064,0.0613951934344541,279.86867904663086,131.87696242332458,175.58728790283203,5643,1563,4080,4080,0,13,2057000.0
2057,2057999,21.386453963590828,38.065148600296304,0.06141163659698601,280.00109481811523,131.9460699558258,175.6979217529297,5643,1563,4080,4080,0,13,2058000.0
2058,2058999,21.39040877676778,38.073601047509605,0.06145351990943426,280.14846897125244,132.0152666568756,175.73455429077148,5645,1564,4081,4081,0,13,2059000.0
2059,2059999,21.394725581455727,38.085235546576904,0.061499039954807655,280.2838671207428,132.0812749862671,175.83890533447266,5645,1564,4081,4081,0,13,2060000.0
2060,2060999,21.39855939979893,38.09226641548267,0.06155718456921666,280.45826029777527,132.1475124359131,175.7576560974121,5654,1568,4086,4086,0,13,2061000.0
2061,2061999,21.401456741074366,38.095591242223925,0.0615991857096595,280.6070194244385,132.21355938911438,175.8201675415039,5658,1569,4089,4089,0,13,2062000.0
2062,2062999,21.406740707939733,38.10570832705936,0.06167742126185871,280.7440423965454,132.27950358390808,175.9081802368164,5661,1570,4091,4091,0,13,2063000.0
2063,2063999,21.411346459630764,38.118900223615086,0.06174239932580716,280.8973140716553,132.3455581665039,175.83895874023438,5665,1572,4093,4093,0,13,2064000.0
2064,2064999,21.41598802907907,38.12605583796142,0.06183551079725458,281.04769563674927,132.41202878952026,175.94362258911133,5667,1573,4094,4094,0,13,2065000.0
2065,2065999,21.418199080911894,38.13076745170945,0.06186531290287456,281.19137597084045,132.47766399383545,175.99958419799805,5669,1574,4095,4095,0,13,2066000.0
2066,2066999,21.419684512154312,38.14069667670092,0.06179262187497736,281.30997681617737,132.54292607307434,176.68173599243164,5686,1574,4112,4112,0,13,2067000.0
2067,2067999,21.419482321959734,38.140645584640794,0.06173846470219091,281.44587564468384,132.60840344429016,176.92285537719727,5689,1575,4114,4114,0,13,2068000.0
2068,2068999,21.419134498202656,38.13811878692853,0.06173751562540519,281.55882143974304,132.6742560863495,177.12594604492188,5689,1575,4114,4114,0,13,2069000.0
2069,2069999,21.41904904687941,38.13769988214862,0.061719162365112545,281.73971128463745,132.74008202552795,177.12299346923828,5697,1579,4118,4118,0,13,2070000.0
2070,2070999,21.419767890671825,38.142128844568056,0.06167705434802462,281.8700671195984,132.80523419380188,177.30186462402344,5699,1580,4119,4119,0,13,2071000.0
2071,2071999,21.419780349860687,38.14121811859472,0.06167119334769944,282.0066397190094,132.87094449996948,177.40286254882812,5703,1581,4122,4122,0,13,2072000.0
2072,2072999,21.420274738744254,38.14039420094999,0.06167657250913838,282.16490864753723,132.93668794631958,177.43898010253906,5707,1583,4124,4124,0,13,2073000.0
2073,2073999,21.421666510647057,38.14173671308339,0.061700263156147184,282.2959747314453,133.00380039215088,177.60470962524414,5707,1583,4124,4124,0,13,2074000.0
2074,2074999,21.422483008610044,38.14139762496476,0.06172464071450512,282.4685571193695,133.06962871551514,177.5723876953125,5715,1585,4130,4130,0,13,2075000.0
2075,2075999,21.42508570861319,38.14529775264385,0.061780065974191944,282.62122797966003,133.13532829284668,177.5354118347168,5719,1587,4132,4132,0,13,2076000.0
2076,2076999,21.428456724519798,38.15146756093128,0.06186085912229411,282.75136375427246,133.20148396492004,177.66558456420898,5719,1587,4132,4132,0,13,2077000.0
2077,2077999,21.430649471285534,38.15372541084262,0.06194790825593466,282.9049241542816,133.26747679710388,177.63251495361328,5723,1589,4134,4134,0,13,2078000.0
2078,2078999,21.43289920859518,38.155945035044205,0.062047097359837156,283.035071849823,133.3336102962494,177.73735809326172,5723,1589,4134,4134,0,13,2079000.0
2079,2079999,21.435762021604102,38.162761273344614,0.062097808200341054,283.1884355545044,133.39979696273804,177.74308013916016,5725,1590,4135,4135,0,13,2080000.0
2080,2080999,21.43749321589207,38.16331032112503,0.06216562885558585,283.31873536109924,133.465980052948,177.8254737854004,5729,1591,4138,4138,0,13,2081000.0
2081,2081999,21.44001483143252,38.16535523559567,0.06221940520981861,283.4568371772766,133.53183007240295,177.861328125,5733,1592,4141,4141,0,13,2082000.0
2082,2082999,21.442460785873095,38.17225332447578,0.06223353378393082,283.6183910369873,133.59805059432983,177.84117126464844,5742,1594,4148,4148,0,13,2083000.0
2083,2083999,21.44444347800813,38.17320757237559,0.0622758865813563,283.77455735206604,133.66439962387085,177.83407592773438,5746,1595,4151,4151,0,13,2084000.0
2084,2084999,21.446723191352838,38.17380192171962,0.062298809174340164,283.91946244239807,133.73065280914307,177.8545684814453,5748,1596,4152,4152,0,13,2085000.0
2085,2085999,21.447897421169152,38.1767561964043,0.06237480411731455,284.05366134643555,133.79763746261597,177.96370315551758,5779,1597,4182,4182,0,13,2086000.0
2086,2086999,21.447184567143545,38.17423202954838,0.06234055036706232,284.1985127925873,133.862726688385,178.53423309326172,5795,1597,4198,4198,0,13,2087000.0
2087,2087999,21.444428712721326,38.16978591059837,0.062307544547077987,284.33823132514954,133.9274435043335,178.6884536743164,5800,1598,4202,4202,0,13,2088000.0
2088,2088999,21.44199748364109,38.16389505170592,0.0622900645231268,284.48495507240295,133.99241280555725,178.81445693969727,5806,1600,4206,4206,0,13,2089000.0
2089,2089999,21.44025792071313,38.16074528053258,0.06224680923113579,284.61812233924866,134.05725240707397,178.82797241210938,5810,1601,4209,4209,0,13,2090000.0
2090,2090999,21.437604163226876,38.155929259905804,0.06221980685251338,284.7619254589081,134.12236618995667,178.9247703552246,5814,1603,4211,4211,0,13,2091000.0
2091,2091999,21.434387807071015,38.14985945971205,0.06220834846640155,284.9027044773102,134.1876003742218,179.00567626953125,5818,1604,4214,4214,0,13,2092000.0
2092,2092999,21.43157065801484,38.144457134816065,0.06220358400228598,285.08259439468384,134.25334668159485,178.95594787597656,5826,1608,4218,4218,0,13,2093000.0
2093,2093999,21.429058167992633,38.13906847697868,0.06219032486346299,285.2243432998657,134.3188087940216,179.08716201782227,5828,1609,4219,4219,0,13,2094000.0
2094,2094999,21.426881789538555,38.13431716172913,0.06218457596209204,285.36137557029724,134.38402390480042,179.17525100708008,5830,1610,4220,4220,0,13,2095000.0
2095,2095999,21.424575858240388,38.129396561723304,0.06218294875408936,285.50542640686035,134.44983386993408,179.25745391845703,5833,1611,4222,4222,0,13,2096000.0
2096,2096999,21.423334445479657,38.12661510494299,0.062176384645170835,285.6488811969757,134.51621103286743,179.3467254638672,5835,1612,4223,4223,0,13,2097000.0
2097,2097999,21.422285626164427,38.12372999305387,0.06218469390621295,285.7787263393402,134.58137726783752,179.44144821166992,5835,1612,4223,4223,0,13,2098000.0
2098,2098999,21.421629615121645,38.12240611096188,0.062184002304716435,285.9354884624481,134.64715790748596,179.4134521484375,5839,1614,4225,4225,0,13,2099000.0
2099,2099999,21.421381862498855,38.121346949157974,0.06219480433995739,286.0725862979889,134.71275758743286,179.52040481567383,5839,1614,4225,4225,0,13,2100000.0
2100,2100999,21.42116167409415,38.119851815312906,0.062232544934426204,286.2253556251526,134.7787206172943,179.57404327392578,5843,1616,4227,4227,0,13,2101000.0
2101,2101999,21.422122154030454,38.1201858214341,0.06231269805306472,286.38031339645386,134.84437346458435,179.64243698120117,5847,1617,4230,4230,0,13,2102000.0
2102,2102999,21.424962489962958,38.12369489489299,0.06235261775167911,286.4963974952698,134.9101963043213,179.76340866088867,5847,1617,4230,4230,0,13,2103000.0
2103,2103999,21.42780551803064,38.12717142027714,0.062413446979205034,286.6194806098938,134.97629189491272,179.8347396850586,5847,1617,4230,4230,0,13,2104000.0
2104,2104999,21.42948596329453,38.12900621787568,0.06249396929394968,286.77497696876526,135.04281568527222,179.80169677734375,5849,1618,4231,4231,0,13,2105000.0
2105,2105999,21.430145579521756,38.12842355224909,0.06256936048151052,286.9150900840759,135.10882329940796,179.89843368530273,5849,1618,4231,4231,0,13,2106000.0
2106,2106999,21.429279777689235,38.12454462347154,0.06255262212690904,287.04426622390747,135.17370867729187,180.3095474243164,5861,1618,4243,4243,0,13,2107000.0
2107,2107999,21.42653539102482,38.12007052876144,0.06254469736637613,287.1699333190918,135.23911666870117,180.53775787353516,5862,1618,4244,4244,0,13,2108000.0
2108,2108999,21.42457974917527,38.116111560645436,0.06252014003169137,287.3267855644226,135.30452346801758,180.59685897827148,5872,1621,4251,4251,0,13,2109000.0
2109,2109999,21.423457818042383,38.117483643945505,0.06248700936919893,287.4551978111267,135.36977410316467,180.72530364990234,5872,1621,4251,4251,0,13,2110000.0
2110,2110999,21.4205509548799,38.11153616753339,0.06248254249769125,287.6222743988037,135.43541169166565,180.76705932617188,5878,1624,4254,4254,0,13,2111000.0
2111,2111999,21.419169255124068,38.109362960654224,0.062460943328900176,287.76901030540466,135.50140595436096,180.8943748474121,5880,1625,4255,4255,0,13,2112000.0
2112,2112999,21.416848517540625,38.103924073309585,0.06243583724088042,287.899423122406,135.567875623703,180.9961700439453,5880,1625,4255,4255,0,13,2113000.0
2113,2113999,21.41509887351007,38.09927082723942,0.06241314564142819,288.03211092948914,135.63326287269592,181.0537872314453,5882,1626,4256,4256,0,13,2114000.0
2114,2114999,21.41310798788928,38.0944658512579,0.06238771445072777,288.1799669265747,135.69960284233093,181.0686492919922,5886,1627,4259,4259,0,13,2115000.0
2115,2115999,21.411630168613666,38.090223827513405,0.06236834778277123,288.37331795692444,135.76628017425537,180.9757957458496,5892,1630,4262,4262,0,13,2116000.0
2116,2116999,21.41021995938506,38.08579822823264,0.06234078308993529,288.5088322162628,135.83208894729614,181.11358642578125,5894,1631,4263,4263,0,13,2117000.0
2117,2117999,21.409329791868927,38.082394932995115,0.062305629307095156,288.6425132751465,135.89745688438416,181.19073867797852,5894,1631,4263,4263,0,13,2118000.0
2118,2118999,21.40899448125964,38.08066368248901,0.06228066166622115,288.80250668525696,135.9630947113037,181.15529251098633,5901,1633,4268,4268,0,13,2119000.0
2119,2119999,21.408378853947664,38.077950453330914,0.062246890849424474,288.93095350265503,136.0285029411316,181.22767639160156,5901,1633,4268,4268,0,13,2120000.0
2120,2120999,21.40773345456171,38.074992056508464,0.06222651610664376,289.09062027931213,136.0944426059723,181.2683448791504,5903,1634,4269,4269,0,13,2121000.0
2121,2121999,21.407639237434207,38.073772747445354,0.062201104037483135,289.2205991744995,136.16031551361084,181.32562637329102,5903,1634,4269,4269,0,13,2122000.0
2122,2122999,21.40796421545509,38.07147626002682,0.06217954887645438,289.36928725242615,136.22678232192993,181.3645896911621,5905,1635,4270,4270,0,13,2123000.0
2123,2123999,21.408320083821327,38.06988193113508,0.06216809347962993,289.5024924278259,136.29247283935547,181.37979125976562,5907,1636,4271,4271,0,13,2124000.0
2124,2124999,21.40913641551315,38.069239926936994,0.06216875709234715,289.6346848011017,136.35797953605652,181.43355178833008,5907,1636,4271,4271,0,13,2125000.0
2125,2125999,21.40982054274934,38.06789534753129,0.06215850219780916,289.78445744514465,136.4240860939026,181.46200942993164,5909,1637,4272,4272,0,13,2126000.0
2126,2126999,21.408768760664564,38.0642377531482,0.06215596644164911,289.9311492443085,136.48956513404846,181.57059478759766,5909,1637,4272,4272,0,13,2127000.0
2127,2127999,21.40624105281375,38.05800993515984,0.06215497771865208,290.0815591812134,136.55511116981506,181.99765014648438,5926,1639,4287,4287,0,13,2128000.0
2128,2128999,21.403474183224002,38.051988717326736,0.06214329588415313,290.2145459651947,136.6288983821869,182.23598098754883,5926,1639,4287,4287,0,13,2129000.0
2129,2129999,21.400516284129775,38.04670617314242,0.06214725308946045,290.36363697052,136.69366192817688,182.24969482421875,5930,1641,4289,4289,0,13,2130000.0
2130,2130999,21.397890245907806,38.0426874373493,0.062149543136361896,290.502765417099,136.75889587402344,182.3736114501953,5932,1642,4290,4290,0,13,2131000.0
2131,2131999,21.39532838831373,38.037702651930054,0.062147405014225665,290.68206119537354,136.82461714744568,182.38259506225586,5941,1646,4295,4295,0,13,2132000.0
2132,2132999,21.392442032324706,38.03179844989355,0.06215418747588264,290.836306810379,136.88992023468018,182.49298095703125,5943,1647,4296,4296,0,13,2133000.0
2133,2133999,21.389411605720664,38.02663201169203,0.062158565382446795,290.97642517089844,136.95534944534302,182.58575439453125,5945,1648,4297,4297,0,13,2134000.0
2134,2134999,21.385860285846135,38.02030177285851,0.06216414799794734,291.1238360404968,137.02122855186462,182.65082168579102,5949,1649,4300,4300,0,13,2135000.0
2135,2135999,21.382630235225697,38.01452293343005,0.06217430853854089,291.25382947921753,137.08667635917664,182.74387741088867,5949,1649,4300,4300,0,13,2136000.0
2136,2136999,21.379391645909834,38.008401812349625,0.062183507493390855,291.37554144859314,137.1522741317749,182.81118392944336,5949,1649,4300,4300,0,13,2137000.0
2137,2137999,21.376095328014227,38.00213643971076,0.06218823194926437,291.554274559021,137.21796250343323,182.77816772460938,5955,1651,4304,4304,0,13,2138000.0
2138,2138999,21.37253178129342,37.99608379725188,0.06219431205104364,291.6851179599762,137.28339552879333,182.87116241455078,5955,1651,4304,4304,0,13,2139000.0
2139,2139999,21.370060877681134,37.99149661640753,0.062191796890261886,291.8455104827881,137.34894824028015,182.82088088989258,5962,1653,4309,4309,0,13,2140000.0
2140,2140999,21.367053141041126,37.98611591312955,0.062184606924644004,291.9856712818146,137.41462874412537,182.82645416259766,5966,1654,4312,4312,0,13,2141000.0
2141,2141999,21.364698670829643,37.98156893071043,0.06218562170787245,292.12772011756897,137.4809877872467,182.92248153686523,5968,1655,4313,4313,0,13,2142000.0
2142,2142999,21.362574785662932,37.97710369092982,0.062168770596859435,292.2510542869568,137.5469651222229,183.00349044799805,5968,1655,4313,4313,0,13,2143000.0
2143,2143999,21.360894763105566,37.97324052404499,0.062161228561904536,292.37760734558105,137.61230206489563,183.0928840637207,5968,1655,4313,4313,0,13,2144000.0
2144,2144999,21.358826143440467,37.96834381048632,0.06216038859836648,292.5209844112396,137.67783427238464,183.16238403320312,5968,1655,4313,4313,0,13,2145000.0
2145,2145999,21.35749385050556,37.965020322716235,0.06215043203092452,292.6616909503937,137.74344182014465,183.20156478881836,5968,1655,4313,4313,0,13,2146000.0
2146,2146999,21.35585096147103,37.96079428481276,0.06214425114176436,292.79548692703247,137.81526613235474,183.26935195922852,5968,1655,4313,4313,0,13,2147000.0
2147,2147999,21.352876286149982,37.955384450285585,0.062137834992916474,292.9603981971741,137.88943362236023,183.26788330078125,5970,1656,4314,4314,0,13,2148000.0
2148,2148999,21.34863799387662,37.9486370050226,0.06216785222489407,293.08776664733887,137.95406365394592,183.7191047668457,5980,1656,4324,4324,0,13,2149000.0
2149,2149999,21.344477989799046,37.94212538035795,0.06218816014481754,293.20871019363403,138.01874160766602,183.87701416015625,5980,1656,4324,4324,0,13,2150000.0
2150,2150999,21.340266293811315,37.936084832887715,0.062222690760429744,293.3477957248688,138.0831756591797,183.8930549621582,5984,1657,4327,4327,0,13,2151000.0
2151,2151999,21.336341208958682,37.93160517020538,0.06224895915426054,293.509779214859,138.1483187675476,183.9036407470703,5990,1660,4330,4330,0,13,2152000.0
2152,2152999,21.332563456038137,37.92872546139539,0.062259321634125064,293.6494040489197,138.2136390209198,184.04469680786133,5992,1661,4331,4331,0,13,2153000.0
2153,2153999,21.32904388056381,37.92409607057429,0.062270401664271335,293.80699372291565,138.2787947654724,184.1099395751953,5996,1662,4334,4334,0,13,2154000.0
2154,2154999,21.325061115896407,37.91836398052111,0.06228576715605938,293.98310565948486,138.34502387046814,184.02878189086914,6002,1665,4337,4337,0,13,2155000.0
2155,2155999,21.321574005625028,37.914264232562324,0.06229087297521996,294.1150653362274,138.41016173362732,184.19152069091797,6002,1665,4337,4337,0,13,2156000.0
2156,2156999,21.31799034762293,37.90873400635163,0.06230418312821984,294.2422127723694,138.475346326828,184.29678344726562,6002,1665,4337,4337,0,13,2157000.0
2157,2157999,21.31458539321369,37.90286432729353,0.062309801001375176,294.3702518939972,138.5408594608307,184.36217498779297,6002,1665,4337,4337,0,13,2158000.0
2158,2158999,21.310948316260582,37.89666707658368,0.062318539143582985,294.5186252593994,138.6058111190796,184.39539337158203,6004,1666,4338,4338,0,13,2159000.0
2159,2159999,21.308126598789254,37.8920570920044,0.06231685882626847,294.64901518821716,138.67114806175232,184.4400177001953,6004,1666,4338,4338,0,13,2160000.0
2160,2160999,21.305283689739806,37.88752747363006,0.06231654801844311,294.7818593978882,138.73637628555298,184.4953384399414,6004,1666,4338,4338,0,13,2161000.0
2161,2161999,21.302715782548717,37.88358506529477,0.06231514312399633,294.93217301368713,138.80177092552185,184.53286361694336,6004,1666,4338,4338,0,13,2162000.0
2162,2162999,21.30090355407593,37.89031091575166,0.06228179081610885,295.0566215515137,138.86658215522766,184.5792007446289,6004,1666,4338,4338,0,13,2163000.0
2163,2163999,21.299059518638646,37.886976228518265,0.06228411306099302,295.18915724754333,138.93200063705444,184.6013641357422,6004,1666,4338,4338,0,13,2164000.0
2164,2164999,21.296877586970144,37.88236306455917,0.062285899500666875,295.34530234336853,138.99720978736877,184.62492752075195,6008,1667,4341,4341,0,13,2165000.0
2165,2165999,21.29479497697956,37.878683099338524,0.062282121697292636,295.4821581840515,139.06250596046448,184.66421508789062,6008,1667,4341,4341,0,13,2166000.0
2166,2166999,21.29276286233051,37.87434015156824,0.062284787078730086,295.6201102733612,139.12768173217773,184.62838745117188,6012,1668,4344,4344,0,13,2167000.0
2167,2167999,21.29065879055104,37.86981242060356,0.06227962333435899,295.7642967700958,139.1933889389038,184.62297439575195,6016,1669,4347,4347,0,13,2168000.0
2168,2168999,21.287514241983413,37.86425840935074,0.06228306611093515,295.9196789264679,139.2583191394806,184.6123275756836,6020,1670,4350,4350,0,13,2169000.0
2169,2169999,21.287393097855894,37.861957197719356,0.062184084899153835,296.0572488307953,139.32322788238525,185.10027313232422,6065,1671,4394,4394,0,13,2170000.0
2170,2170999,21.285856166344256,37.85780470062869,0.06214169271871406,296.1929581165314,139.38819932937622,185.25608825683594,6068,1672,4396,4396,0,13,2171000.0
2171,2171999,21.284328657372775,37.85346890857739,0.06211370516827841,296.32636880874634,139.45676374435425,185.40755462646484,6068,1672,4396,4396,0,13,2172000.0
2172,2172999,21.28375239436024,37.85109287864105,0.06206620701289922,296.4780418872833,139.52218222618103,185.44198989868164,6072,1674,4398,4398,0,13,2173000.0
2173,2173999,21.28248538419543,37.84796588659164,0.06204587369414882,296.63037729263306,139.58746767044067,185.52284622192383,6079,1676,4403,4403,0,13,2174000.0
2174,2174999,21.280501282110038,37.84464620666407,0.062047075511354244,296.775595664978,139.65837907791138,185.68612670898438,6079,1676,4403,4403,0,13,2175000.0
2175,2175999,21.278407584550223,37.84146956654157,0.06203522117318638,296.9381363391876,139.73295211791992,185.80669403076172,6082,1677,4405,4405,0,13,2176000.0
2176,2176999,21.276183870485966,37.83717170530254,0.062038341510135875,297.0937192440033,139.79843282699585,185.81301879882812,6086,1679,4407,4407,0,13,2177000.0
2177,2177999,21.274369971544427,37.8331124950176,0.06202939735585056,297.2529673576355,139.86437463760376,185.9030876159668,6088,1680,4408,4408,0,13,2178000.0
2178,2178999,21.27246125919434,37.829032637441536,0.062009504680167304,297.40221762657166,139.9300365447998,185.94220733642578,6092,1682,4410,4410,0,13,2179000.0
2179,2179999,21.270675831199057,37.82519492735671,0.06200440502750304,297.53633093833923,139.99575853347778,186.09020614624023,6092,1682,4410,4410,0,13,2180000.0
2180,2180999,21.268395108320266,37.82049066853058,0.06201161293368196,297.66522192955017,140.06121468544006,186.17543411254883,6092,1682,4410,4410,0,13,2181000.0
2181,2181999,21.266575164366053,37.815953884612675,0.06201454432402953,297.8091342449188,140.12706208229065,186.21575546264648,6094,1683,4411,4411,0,13,2182000.0
2182,2182999,21.264310362212957,37.81089334737018,0.06202680654307524,297.96995759010315,140.19316172599792,186.19141387939453,6098,1685,4413,4413,0,13,2183000.0
2183,2183999,21.262813462351023,37.80658668680808,0.06203837609069829,298.1373908519745,140.2594940662384,186.18346405029297,6105,1687,4418,4418,0,13,2184000.0
2184,2184999,21.261168418749183,37.802121359971636,0.06204189486689393,298.2888855934143,140.33584237098694,186.2860221862793,6105,1687,4418,4418,0,13,2185000.0
2185,2185999,21.258566753796075,37.79680819169524,0.06205563703547101,298.45438408851624,140.4018692970276,186.2915496826172,6107,1688,4419,4419,0,13,2186000.0
2186,2186999,21.25652537985104,37.7919774592484,0.06204166491181129,298.58375883102417,140.47151923179626,186.5285758972168,6111,1688,4423,4423,0,13,2187000.0
2187,2187999,21.2571446322503,37.791344866158774,0.06195564439364698,298.7285795211792,140.53676533699036,186.80420303344727,6119,1689,4430,4430,0,13,2188000.0
2188,2188999,21.256359571397326,37.79069599748907,0.06189762084767103,298.8723158836365,140.6026632785797,186.9528579711914,6122,1690,4432,4432,0,13,2189000.0
2189,2189999,21.254880452827653,37.78757032037567,0.06187174711332133,298.9992220401764,140.66730403900146,187.05451202392578,6122,1690,4432,4432,0,13,2190000.0
2190,2190999,21.25275681666637,37.78266515600356,0.06186846532756385,299.1614456176758,140.73288249969482,187.01276397705078,6130,1693,4437,4437,0,13,2191000.0
2191,2191999,21.250965885812228,37.777721068671724,0.06183929276366673,299.3255705833435,140.79814171791077,187.05292510986328,6134,1695,4439,4439,0,13,2192000.0
2192,2192999,21.24929406118542,37.77593628098783,0.06179675925895123,299.46941018104553,140.86333751678467,187.13888931274414,6136,1696,4440,4440,0,13,2193000.0
2193,2193999,21.247225336140463,37.77053328369622,0.06177015327374158,299.6001591682434,140.9286766052246,187.26804733276367,6136,1696,4440,4440,0,13,2194000.0
2194,2194999,21.245626812868224,37.76616067153061,0.061743373936984924,299.76229095458984,140.99471354484558,187.29873275756836,6138,1697,4441,4441,0,13,2195000.0
2195,2195999,21.24383738423378,37.761277563656435,0.06171161734573449,299.8912105560303,141.05968189239502,187.35393905639648,6138,1697,4441,4441,0,13,2196000.0
2196,2196999,21.242469132648427,37.75713136748255,0.06167596210993087,300.05648732185364,141.1252419948578,187.28565979003906,6145,1699,4446,4446,0,13,2197000.0
2197,2197999,21.24197806323317,37.75961635269442,0.06160966865420614,300.1986837387085,141.1915888786316,187.36155319213867,6145,1699,4446,4446,0,13,2198000.0
2198,2198999,21.240995236423473,37.75599823696671,0.061576476857600926,300.3331775665283,141.25680136680603,187.40682220458984,6147,1700,4447,4447,0,13,2199000.0
2199,2199999,21.24030018423022,37.753866295501226,0.061544143835290055,300.5060336589813,141.32286024093628,187.2773323059082,6153,1703,4450,4450,0,13,2200000.0
2200,2200999,21.23945816217969,37.75175120507327,0.06151327708861998,300.68772315979004,141.39402556419373,187.42074584960938,6153,1703,4450,4450,0,13,2201000.0
2201,2201999,21.238924212906806,37.752893483957784,0.061504123597908245,300.80620765686035,141.4594383239746,187.4997787475586,6153,1703,4450,4450,0,13,2202000.0
2202,2202999,21.23901396747279,37.75275641103003,0.06148297831843441,300.94173407554626,141.5252070426941,187.60923385620117,6153,1703,4450,4450,0,13,2203000.0
2203,2203999,21.238169043840966,37.74979458840623,0.06146798825319466,301.0993137359619,141.5916211605072,187.65664291381836,6157,1704,4453,4453,0,13,2204000.0
2204,2204999,21.237524029782104,37.750749845362684,0.06143266950831505,301.237411737442,141.6576793193817,187.69765853881836,6157,1704,4453,4453,0,13,2205000.0
2205,2205999,21.23644212071097,37.7470780678362,0.061407782081410844,301.3779330253601,141.72368359565735,187.67337799072266,6159,1705,4454,4454,0,13,2206000.0
2206,2206999,21.23480119746311,37.743223355146924,0.06138825479305576,301.506050825119,141.79073810577393,188.2415542602539,6177,1705,4472,4472,0,13,2207000.0
2207,2207999,21.230379376493918,37.73965310622959,0.06141899755112723,301.6315450668335,141.85571265220642,188.67534637451172,6186,1706,4480,4480,0,13,2208000.0
2208,2208999,21.226086696039204,37.73437146702423,0.06144916752951424,301.75640392303467,141.9203336238861,188.96049118041992,6187,1706,4481,4481,0,13,2209000.0
2209,2209999,21.22173186639565,37.728447438919474,0.06148376478679096,301.9445765018463,142.01118540763855,189.052490234375,6191,1708,4483,4483,0,13,2210000.0
2210,2210999,21.217725588912046,37.72548298840988,0.06150134068730284,302.1137475967407,142.0774064064026,189.11646270751953,6197,1711,4486,4486,0,13,2211000.0
2211,2211999,21.213415573467408,37.71893416436927,0.06153767521076514,302.2583038806915,142.14257645606995,189.28322982788086,6201,1713,4488,4488,0,13,2212000.0
2212,2212999,21.20911970465774,37.712988614124036,0.06156214875323407,302.3919982910156,142.20867443084717,189.43494033813477,6203,1714,4489,4489,0,13,2213000.0
2213,2213999,21.204797354550493,37.70628322071099,0.06159284513507801,302.5347328186035,142.27526378631592,189.52621459960938,6205,1715,4490,4490,0,13,2214000.0
2214,2214999,21.20090037784446,37.700483676889334,0.06161636042293994,302.69583773612976,142.3413200378418,189.60503768920898,6209,1717,4492,4492,0,13,2215000.0
2215,2215999,21.19695134457798,37.69434851201561,0.061641795650922204,302.85393357276917,142.40729522705078,189.64315795898438,6215,1719,4496,4496,0,13,2216000.0
2216,2216999,21.193541810591533,37.68859871124921,0.06165737442189845,302.9926006793976,142.47305560112,189.71150970458984,6217,1720,4497,4497,0,13,2217000.0
2217,2217999,21.19024202087849,37.68305321264187,0.06166437558955851,303.11592292785645,142.53879714012146,189.8533058166504,6217,1720,4497,4497,0,13,2218000.0
2218,2218999,21.187043924617942,37.67839092911534,0.06167106093364627,303.267635345459,142.60500693321228,189.8796272277832,6219,1721,4498,4498,0,13,2219000.0
2219,2219999,21.18412978822408,37.67477520208523,0.06166699069024317,303.3979489803314,142.67074918746948,189.98820114135742,6219,1721,4498,4498,0,13,2220000.0
2220,2220999,21.181206883636776,37.66988593032733,0.06167691948468512,303.551913022995,142.73669934272766,190.04946899414062,6223,1722,4501,4501,0,13,2221000.0
2221,2221999,21.178571670352284,37.666558719061,0.06167692492971377,303.6828525066376,142.80216574668884,190.13379669189453,6223,1722,4501,4501,0,13,2222000.0
2222,2222999,21.176070684878265,37.66220892855759,0.06168236811611327,303.8127598762512,142.8683636188507,190.20216369628906,6223,1722,4501,4501,0,13,2223000.0
2223,2223999,21.17318004757732,37.65692882554223,0.06169408257621112,303.95856189727783,142.93451833724976,190.28915786743164,6225,1723,4502,4502,0,13,2224000.0
2224,2224999,21.17147921513877,37.65788055306151,0.06167598739533875,304.10050225257874,143.00040555000305,190.30162048339844,6227,1724,4503,4503,0,13,2225000.0
2225,2225999,21.169074228026343,37.65376981963454,0.06167978838438959,304.25839591026306,143.0663571357727,190.29066467285156,6231,1726,4505,4505,0,13,2226000.0
2226,2226999,21.166156489286337,37.64847365372746,0.061685872902585315,304.37620854377747,143.1322944164276,190.43732452392578,6231,1726,4505,4505,0,13,2227000.0
2227,2227999,21.16312574574044,37.643167469891544,0.06169257622843394,304.52982568740845,143.19852828979492,190.8277816772461,6250,1727,4523,4523,0,13,2228000.0
2228,2228999,21.159339800512356,37.63933836369326,0.06171030372302966,304.640558719635,143.2629201412201,191.1949119567871,6252,1727,4525,4525,0,13,2229000.0
2229,2229999,21.15560092653462,37.63477395924515,0.061737323193896576,304.75188517570496,143.32692193984985,191.40984344482422,6252,1727,4525,4525,0,13,2230000.0
2230,2230999,21.15158305366888,37.6289831755538,0.06176389397898907,304.90667486190796,143.39237761497498,191.46367645263672,6258,1729,4529,4529,0,13,2231000.0
2231,2231999,21.148207651942165,37.62548030979232,0.061777447465581226,305.06932258605957,143.4582440853119,191.53028106689453,6262,1731,4531,4531,0,13,2232000.0
2232,2232999,21.144080263995914,37.61920804807861,0.06180256935298656,305.2130432128906,143.5231282711029,191.67461776733398,6264,1732,4532,4532,0,13,2233000.0
2233,2233999,21.140210458091687,37.61310882920147,0.06182458759379528,305.3634498119354,143.58869290351868,191.74073791503906,6268,1734,4534,4534,0,13,2234000.0
2234,2234999,21.1369775240077,37.60820321275117,0.061842442609476356,305.50231671333313,143.6537482738495,191.8233642578125,6270,1735,4535,4535,0,13,2235000.0
2235,2235999,21.13382976575124,37.60258459335016,0.061852436260417476,305.658762216568,143.7194344997406,191.90910720825195,6274,1737,4537,4537,0,13,2236000.0
2236,2236999,21.131044116591802,37.59764481551221,0.06186254989139095,305.81143140792847,143.78452348709106,191.9329719543457,6286,1739,4547,4547,0,13,2237000.0
2237,2237999,21.129126356224088,37.594342766916846,0.061869864564229604,305.9412889480591,143.84959888458252,192.10762786865234,6288,1740,4548,4548,0,13,2238000.0
2238,2238999,21.12817316857637,37.593181615354226,0.06187203085497217,306.09374237060547,143.91562938690186,192.1932716369629,6290,1741,4549,4549,0,13,2239000.0
2239,2239999,21.128628173698605,37.6014396360308,0.06184377662260476,306.26056385040283,143.98133969306946,192.28569793701172,6294,1742,4552,4552,0,13,2240000.0
2240,2240999,21.12899010662734,37.61256215130469,0.06182908922892527,306.40678334236145,144.0472593307495,192.34149932861328,6296,1743,4553,4553,0,13,2241000.0
2241,2241999,21.129349946114566,37.625853438770186,0.061802628862126396,306.5388307571411,144.11266779899597,192.45647811889648,6296,1743,4553,4553,0,13,2242000.0
2242,2242999,21.13146321288173,37.64231022848166,0.061736637183329,306.69807028770447,144.17865562438965,192.41067504882812,6300,1745,4555,4555,0,13,2243000.0
2243,2243999,21.1330510626434,37.647252786734725,0.06169295591487689,306.8507876396179,144.24491095542908,192.47955322265625,6302,1746,4556,4556,0,13,2244000.0
2244,2244999,21.13359174863691,37.65238538717861,0.06168524932737496,306.9880516529083,144.31423020362854,192.59835815429688,6302,1746,4556,4556,0,13,2245000.0
2245,2245999,21.133546716216124,37.65253165680201,0.06168184503332097,307.12085008621216,144.38026523590088,192.68844604492188,6302,1746,4556,4556,0,13,2246000.0
2246,2246999,21.13281313455541,37.65141904084791,0.061704425516255434,307.25930738449097,144.44620823860168,192.79718399047852,6302,1746,4556,4556,0,13,2247000.0
2247,2247999,21.132136771523378,37.650643577497945,0.0616549499622725,307.3958830833435,144.51173186302185,193.57040405273438,6329,1747,4582,4582,0,13,2248000.0
2248,2248999,21.131282030713205,37.651069659753674,0.0616641540193168,307.53746223449707,144.57705688476562,193.86713409423828,6337,1749,4588,4588,0,13,2249000.0
2249,2249999,21.13094282646303,37.652441451720335,0.061685084850284455,307.66262793540955,144.6422986984253,194.09037017822266,6339,1750,4589,4589,0,13,2250000.0
2250,2250999,21.130195193583763,37.65175773610954,0.061693807343808804,307.825453042984,144.70803713798523,194.2016258239746,6345,1753,4592,4592,0,13,2251000.0
2251,2251999,21.131157672740624,37.65357249340777,0.0617499790663153,307.98956990242004,144.77406311035156,194.32933807373047,6353,1756,4597,4597,0,13,2252000.0
2252,2252999,21.132683405981577,37.656457541221705,0.06181403494929261,308.1654951572418,144.84034299850464,194.44280242919922,6361,1760,4601,4601,0,13,2253000.0
2253,2253999,21.133689584892164,37.65818838062233,0.061914595954139284,308.35946822166443,144.9071569442749,194.4644432067871,6371,1765,4606,4606,0,13,2254000.0
2254,2254999,21.135693432886033,37.66324704162854,0.06208420580458207,308.4990417957306,144.9736819267273,194.70774841308594,6373,1766,4607,4607,0,13,2255000.0
2255,2255999,21.136868356445795,37.663870367777754,0.06225255109987682,308.6380021572113,145.04019045829773,194.86529541015625,6375,1767,4608,4608,0,13,2256000.0
2256,2256999,21.139533544871366,37.669762141557996,0.06247061544768928,308.8005449771881,145.1068308353424,194.8880271911621,6381,1770,4611,4611,0,13,2257000.0
2257,2257999,21.14264175808569,37.67603642188785,0.06273895661763051,308.9483232498169,145.17541551589966,195.03436660766602,6385,1771,4614,4614,0,13,2258000.0
2258,2258999,21.145219131789943,37.67980950431494,0.06295473582339917,309.0966329574585,145.24210500717163,195.0883026123047,6391,1773,4618,4618,0,13,2259000.0
2259,2259999,21.1470347709111,37.681797472080085,0.06315510676159553,309.23840951919556,145.30921864509583,195.11669921875,6393,1774,4619,4619,0,13,2260000.0
2260,2260999,21.14880732034193,37.68478888966608,0.0633105411557684,309.4237627983093,145.37668251991272,195.2004051208496,6399,1777,4622,4622,0,13,2261000.0
2261,2261999,21.15106268089912,37.687552595751114,0.0634904360769375,309.59707045555115,145.44420433044434,195.27809524536133,6405,1779,4626,4626,0,13,2262000.0
2262,2262999,21.153368350679976,37.690633079753,0.06363741669980383,309.7328939437866,145.5108563899994,195.36727142333984,6409,1780,4629,4629,0,13,2263000.0
2263,2263999,21.15569890806303,37.69203076156861,0.06371554689903225,309.87555408477783,145.57770824432373,195.51668167114258,6440,1781,4659,4659,0,13,2264000.0
2264,2264999,21.157205374449465,37.69208332894314,0.06376822707283936,310.00648975372314,145.64456605911255,195.61437606811523,6440,1781,4659,4659,0,13,2265000.0
2265,2265999,21.159259674206748,37.69265444537952,0.06378695803182677,310.14627027511597,145.71115112304688,195.6747283935547,6442,1782,4660,4660,0,13,2266000.0
2266,2266999,21.15917309056089,37.68969031062416,0.0637954766429295,310.29277634620667,145.77803993225098,195.7253646850586,6444,1783,4661,4661,0,13,2267000.0
2267,2267999,21.157773931682584,37.68824699848743,0.0637400648531189,311.21344685554504,145.8445143699646,196.44865036010742,6468,1784,4684,4684,0,13,2268000.0
2268,2268999,21.155050402722132,37.68382270658103,0.06372891789975277,311.3288495540619,145.91082167625427,196.8148422241211,6470,1784,4686,4686,0,13,2269000.0
2269,2269999,21.152430331302565,37.67942547156107,0.06372080944815972,311.4601192474365,145.97680926322937,197.04040145874023,6472,1785,4687,4687,0,13,2270000.0
2270,2270999,21.150131420917273,37.675928659515975,0.06371842446655218,311.6386203765869,146.04321360588074,197.0810890197754,6478,1788,4690,4690,0,13,2271000.0
2271,2271999,21.147673064653144,37.67126108572188,0.06371531800814445,311.8136451244354,146.10992193222046,197.24691772460938,6484,1791,4693,4693,0,13,2272000.0
2272,2272999,21.145772088259648,37.66738277342909,0.06370671689110097,311.94703698158264,146.17582035064697,197.4205551147461,6486,1792,4694,4694,0,13,2273000.0
2273,2273999,21.14385291536388,37.66423057664513,0.06370015787106509,312.10015058517456,146.2423632144928,197.49075317382812,6490,1794,4696,4696,0,13,2274000.0
2274,2274999,21.1430019220878,37.663444566798894,0.06370243402455378,312.2672255039215,146.3089518547058,197.5743637084961,6494,1796,4698,4698,0,13,2275000.0
2275,2275999,21.142468966527257,37.670228270650206,0.06368840147799104,312.43552255630493,146.3753697872162,197.59917831420898,6502,1799,4703,4703,0,13,2276000.0
2276,2276999,21.14256036611822,37.67258093284057,0.06368967390797053,312.6069567203522,146.44290351867676,197.61663436889648,6506,1801,4705,4705,0,13,2277000.0
2277,2277999,21.14347860872511,37.67632724192847,0.06374923243503816,312.77835512161255,146.50991415977478,197.7843246459961,6510,1803,4707,4707,0,13,2278000.0
2278,2278999,21.145390207898377,37.68414976992022,0.06380955722792103,312.90335392951965,146.57678246498108,197.91654586791992,6510,1803,4707,4707,0,13,2279000.0
2279,2279999,21.14692992146833,37.689577211093976,0.0638861463153867,313.0814428329468,146.6439504623413,197.8948097229004,6516,1806,4710,4710,0,13,2280000.0
2280,2280999,21.1484681152188,37.69239655693478,0.06402050308318064,313.238671541214,146.71279096603394,198.01018524169922,6520,1808,4712,4712,0,13,2281000.0
2281,2281999,21.15105648506977,37.70142910452174,0.06410316678068384,313.39367842674255,146.77999210357666,198.11682510375977,6522,1809,4713,4713,0,13,2282000.0
2282,2282999,21.15407376282863,37.70722639107177,0.06422766614748199,313.53459215164185,146.8471541404724,198.24010467529297,6522,1809,4713,4713,0,13,2283000.0
2283,2283999,21.155664092834378,37.70905558828186,0.06432444610669907,313.67681670188904,146.91407704353333,198.37501907348633,6524,1810,4714,4714,0,14,2284000.0
2284,2284999,21.159280426864854,37.714679266500966,0.06444079789491663,313.8512761592865,146.9816873073578,198.37834930419922,6530,1813,4717,4717,0,14,2285000.0
2285,2285999,21.162553340026022,37.719071596362696,0.06448957274894251,313.9866898059845,147.05107879638672,198.51050186157227,6530,1813,4717,4717,0,14,2286000.0
2286,2286999,21.164372809581543,37.71978607160349,0.06450656437741298,314.1394724845886,147.11787605285645,198.50760650634766,6534,1815,4719,4719,0,14,2287000.0
2287,2287999,21.163725337838272,37.71734570886195,0.0644806967689674,314.33111548423767,147.18481492996216,198.99024963378906,6564,1819,4745,4745,0,14,2288000.0
2288,2288999,21.159923459727953,37.71162958398913,0.06449438487847159,314.4461030960083,147.24982166290283,199.33621215820312,6564,1819,4745,4745,0,14,2289000.0
2289,2289999,21.157328123581493,37.70708726988675,0.06450383828352879,314.575119972229,147.31496453285217,199.5458106994629,6566,1820,4746,4746,0,14,2290000.0
2290,2290999,21.1559948933587,37.70456665492142,0.06450371548642597,314.6966712474823,147.3798952102661,199.72369384765625,6566,1820,4746,4746,0,14,2291000.0
2291,2291999,21.155252469308707,37.7044273905035,0.06448499711110867,314.86756348609924,147.4473078250885,199.7609748840332,6572,1823,4749,4749,0,14,2292000.0
2292,2292999,21.155201615736722,37.70448016943542,0.0644609803864522,315.0567247867584,147.51328229904175,199.8169937133789,6580,1827,4753,4753,0,14,2293000.0
2293,2293999,21.15396406401302,37.701383071852554,0.06446182295237135,315.21757888793945,147.57957887649536,199.97685623168945,6582,1828,4754,4754,0,14,2294000.0
2294,2294999,21.153746694506026,37.700072232631946,0.06445290064793274,315.3970527648926,147.64622831344604,200.02761459350586,6588,1831,4757,4757,0,14,2295000.0
2295,2295999,21.154171562457286,37.70032111301215,0.06444709727083064,315.54063057899475,147.71218538284302,200.0795021057129,6590,1832,4758,4758,0,14,2296000.0
2296,2296999,21.154512877300622,37.700865510226144,0.06443079081323655,315.6702916622162,147.77816581726074,200.23865127563477,6590,1832,4758,4758,0,14,2297000.0
2297,2297999,21.154892664552467,37.70141093736578,0.06442860006426787,315.80729055404663,147.84481835365295,200.34391403198242,6590,1832,4758,4758,0,14,2298000.0
2298,2298999,21.155009687994937,37.70048475847666,0.06445748191556566,315.9858067035675,147.91160035133362,200.4062614440918,6594,1834,4760,4760,0,14,2299000.0
2299,2299999,21.156153678856906,37.700880743160305,0.06444803730607751,316.1321077346802,147.97782683372498,200.45741653442383,6596,1835,4761,4761,0,14,2300000.0
2300,2300999,21.15776302921878,37.70416991168112,0.06444403454275105,316.2705376148224,148.04436445236206,200.49843215942383,6598,1836,4762,4762,0,14,2301000.0
2301,2301999,21.159019064236045,37.705074601624254,0.06446994612688994,316.44825530052185,148.11751866340637,200.55344772338867,6604,1838,4766,4766,0,14,2302000.0
2302,2302999,21.160878068252398,37.70829534909694,0.06450982989033172,316.5933322906494,148.18513441085815,200.67779922485352,6604,1838,4766,4766,0,14,2303000.0
2303,2303999,21.162897539612327,37.71100694209259,0.06450138122997895,316.72518014907837,148.25165367126465,200.7667007446289,6604,1838,4766,4766,0,14,2304000.0
2304,2304999,21.165176483173358,37.719629418935384,0.06452565734650884,316.89662504196167,148.31815814971924,200.7896499633789,6608,1840,4768,4768,0,14,2305000.0
2305,2305999,21.16692249835497,37.7213174603409,0.06455442305297843,317.0848786830902,148.3914761543274,200.8440284729004,6613,1842,4771,4771,0,14,2306000.0
2306,2306999,21.169520818080326,37.72719272131554,0.06453019557243178,317.2255861759186,148.4579095840454,200.89179229736328,6615,1843,4772,4772,0,14,2307000.0
2307,2307999,21.170262255921134,37.72656328105498,0.06451546199963176,317.36454677581787,148.52441668510437,200.98442840576172,6615,1843,4772,4772,0,14,2308000.0
2308,2308999,21.17014931906085,37.72522597877919,0.06446984360538122,317.5026412010193,148.59197354316711,201.36767578125,6628,1844,4784,4784,0,14,2309000.0
2309,2309999,21.168653013101363,37.72407262808072,0.06444887644110231,317.681067943573,148.6613564491272,201.45238876342773,6637,1846,4791,4791,0,14,2310000.0
2310,2310999,21.166873788553914,37.71968246621612,0.06444033648941672,317.79830956459045,148.7262167930603,201.63152313232422,6637,1846,4791,4791,0,14,2311000.0
2311,2311999,21.164625425937437,37.714856708770526,0.0644481201071363,317.9757471084595,148.79114413261414,201.62554550170898,6645,1849,4796,4796,0,14,2312000.0
2312,2312999,21.162545999362823,37.71007438286594,0.0644489403330355,318.11743664741516,148.8561246395111,201.77754592895508,6647,1850,4797,4797,0,14,2313000.0
2313,2313999,21.160481051997877,37.70523444038255,0.06444201226992174,318.30570888519287,148.9222333431244,201.84252166748047,6655,1853,4802,4802,0,14,2314000.0
2314,2314999,21.15767856115865,37.69974277369035,0.06445791612853169,318.4319396018982,148.9875135421753,201.98816299438477,6655,1853,4802,4802,0,14,2315000.0
2315,2315999,21.15540250469155,37.69474388831756,0.06446657667981093,318.5599594116211,149.0532581806183,202.0974884033203,6655,1853,4802,4802,0,14,2316000.0
2316,2316999,21.153080370531107,37.68960847158118,0.06447483354788897,318.69503378868103,149.1183636188507,202.14080810546875,6657,1854,4803,4803,0,14,2317000.0
2317,2317999,21.150698526431768,37.68445263430521,0.0644795789948025,318.8525948524475,149.18415355682373,202.20402145385742,6659,1855,4804,4804,0,14,2318000.0
2318,2318999,21.14837822753431,37.67975915032348,0.06448470521112659,319.00179147720337,149.24934482574463,202.26430892944336,6659,1855,4804,4804,0,14,2319000.0
2319,2319999,21.14651550887666,37.675765837748536,0.0644861908496801,319.12240171432495,149.31426644325256,202.30973434448242,6659,1855,4804,4804,0,14,2320000.0
2320,2320999,21.145040063277772,37.671767156888656,0.0644963163611082,319.248574256897,149.37995958328247,202.3887825012207,6659,1855,4804,4804,0,14,2321000.0
2321,2321999,21.14338534260365,37.6683487065683,0.0644984503306758,319.4022846221924,149.44495344161987,202.3394317626953,6663,1856,4807,4807,0,14,2322000.0
2322,2322999,21.141625301821534,37.66397839989657,0.06451651529297175,319.558717250824,149.51444101333618,202.41125106811523,6667,1857,4810,4810,0,14,2323000.0
2323,2323999,21.139833920645458,37.65945938306733,0.06452921962063873,319.7456941604614,149.5857605934143,202.46714782714844,6669,1858,4811,4811,0,14,2324000.0
2324,2324999,21.13776726173396,37.65440481425327,0.06456234855966014,319.86590051651,149.65080571174622,202.51414108276367,6669,1858,4811,4811,0,14,2325000.0
2325,2325999,21.135405140038877,37.649568740705895,0.06458134977061147,319.9868869781494,149.71595883369446,202.60363388061523,6669,1858,4811,4811,0,14,2326000.0
2326,2326999,21.135053551169726,37.649476723720404,0.06454222228477802,320.12249064445496,149.7815260887146,202.8004035949707,6670,1858,4812,4812,0,14,2327000.0
2327,2327999,21.134877839253505,37.64885553848988,0.06451569777467459,320.2520625591278,149.84571313858032,202.92306518554688,6670,1858,4812,4812,0,14,2328000.0
2328,2328999,21.134280656413484,37.644593898002576,0.06450065499690061,320.3991799354553,149.90991616249084,202.97554779052734,6670,1858,4812,4812,0,14,2329000.0
2329,2329999,21.13328476899024,37.64010825421891,0.0644952839460895,320.5192542076111,149.97414374351501,203.02706146240234,6670,1858,4812,4812,0,14,2330000.0
2330,2330999,21.131872386892134,37.635333502304555,0.06449641076340884,320.66585993766785,150.03842997550964,203.01112365722656,6672,1859,4813,4813,0,14,2331000.0
2331,2331999,21.130335526718365,37.630800023854825,0.06448778828701995,320.8093001842499,150.10298252105713,203.08329010009766,6672,1859,4813,4813,0,14,2332000.0
2332,2332999,21.12854835893788,37.62642366922902,0.06448199049063807,320.959862947464,150.16730189323425,203.1337127685547,6672,1859,4813,4813,0,14,2333000.0
2333,2333999,21.126800817995463,37.62167257146118,0.06447874883208149,321.08946537971497,150.23142337799072,203.16458892822266,6672,1859,4813,4813,0,14,2334000.0
2334,2334999,21.125572566162298,37.619877235669016,0.06445978315939616,321.2193856239319,150.2958915233612,203.18529510498047,6672,1859,4813,4813,0,14,2335000.0
2335,2335999,21.124319213628503,37.61680258098043,0.06444981032443031,321.35333347320557,150.3600468635559,203.20430374145508,6672,1859,4813,4813,0,14,2336000.0
2336,2336999,21.12299475875827,37.61291903705332,0.06444258847577633,321.5024938583374,150.42446994781494,203.22705841064453,6672,1859,4813,4813,0,14,2337000.0
2337,2337999,21.122308820751208,37.61673658736452,0.06440478373906489,321.65489888191223,150.48937821388245,203.24727630615234,6672,1859,4813,4813,0,14,2338000.0
2338,2338999,21.12109121210165,37.613335543004446,0.06439252707986776,321.79906582832336,150.55418872833252,203.2634506225586,6672,1859,4813,4813,0,14,2339000.0
2339,2339999,21.119257201565606,37.60874813753587,0.0643925898531954,321.932603597641,150.6186020374298,203.29369354248047,6672,1859,4813,4813,0,14,2340000.0
2340,2340999,21.118336905507956,37.60595797038916,0.06438384669381769,322.07951402664185,150.68368315696716,203.30796432495117,6672,1859,4813,4813,0,14,2341000.0
2341,2341999,21.117063857303123,37.60165903819235,0.06437442278643324,322.2132167816162,150.7483217716217,203.32196044921875,6672,1859,4813,4813,0,14,2342000.0
2342,2342999,21.116360596778087,37.60335523524987,0.06434881962685512,322.3326168060303,150.81369519233704,203.3509750366211,6672,1859,4813,4813,0,14,2343000.0
2343,2343999,21.11510417549746,37.59935198968633,0.06434006791560032,322.4859583377838,150.87837719917297,203.27884674072266,6675,1860,4815,4815,0,14,2344000.0
2344,2344999,21.11345012350082,37.59555090618759,0.064327924183056,322.63647055625916,150.94295072555542,203.23377227783203,6678,1861,4817,4817,0,14,2345000.0
2345,2345999,21.110929508571356,37.59009900839123,0.06431981543377518,322.77013540267944,151.00698852539062,203.28130722045898,6678,1861,4817,4817,0,14,2346000.0
2346,2346999,21.109125301757746,37.590761101275945,0.06431570409268217,322.9128019809723,151.07112216949463,203.40994262695312,6680,1861,4819,4819,0,14,2347000.0
2347,2347999,21.106262925945213,37.585735952586134,0.06432884584167775,323.06193494796753,151.13529253005981,203.44647979736328,6682,1862,4820,4820,0,14,2348000.0
2348,2348999,21.10329071146622,37.57967830690927,0.06434627580926133,323.19607877731323,151.19957041740417,203.49389266967773,6682,1862,4820,4820,0,14,2349000.0
2349,2349999,21.100839096874562,37.5750149550089,0.06436191615484965,323.3376121520996,151.26387882232666,203.52152633666992,6682,1862,4820,4820,0,14,2350000.0
2350,2350999,21.09802501646197,37.569363900194375,0.06437444682226345,323.48500180244446,151.32798838615417,203.5455436706543,6713,1863,4850,4850,0,14,2351000.0
2351,2351999,21.095556812872136,37.56432664651248,0.06438391423169298,323.6214339733124,151.39185047149658,203.5241928100586,6715,1864,4851,4851,0,14,2352000.0
2352,2352999,21.092700189922773,37.558501726345234,0.06439103038775496,323.7670226097107,151.45634055137634,203.43475341796875,6718,1865,4853,4853,0,14,2353000.0
2353,2353999,21.090011440881256,37.553524356257434,0.06439857805336224,323.9376449584961,151.52129983901978,203.45388412475586,6720,1866,4854,4854,0,14,2354000.0
2354,2354999,21.08786591074036,37.54905838692254,0.06440501520238873,324.0679907798767,151.58546614646912,203.5369110107422,6720,1866,4854,4854,0,14,2355000.0
2355,2355999,21.085455579294315,37.54411075070142,0.06440837552747214,324.2081995010376,151.65021872520447,203.5723114013672,6720,1866,4854,4854,0,14,2356000.0
2356,2356999,21.083575495915937,37.53988569508741,0.0644086864174438,324.336847782135,151.71419072151184,203.62128067016602,6720,1866,4854,4854,0,14,2357000.0
2357,2357999,21.08221264817748,37.53623690740354,0.06440198231488603,324.47914695739746,151.7783920764923,203.63668823242188,6720,1866,4854,4854,0,14,2358000.0
2358,2358999,21.081104217274312,37.533977205268904,0.06438664052902698,324.6080729961395,151.84263062477112,203.6561164855957,6720,1866,4854,4854,0,14,2359000.0
2359,2359999,21.079712298756327,37.53091030023044,0.06437586540583018,324.7420015335083,151.90666007995605,203.68060302734375,6720,1866,4854,4854,0,14,2360000.0
2360,2360999,21.079183607559035,37.529397975291864,0.06435481871327331,324.89113664627075,151.97096180915833,203.71570205688477,6720,1866,4854,4854,0,14,2361000.0
2361,2361999,21.079136110609227,37.52842027422836,0.06433514932277373,325.04354524612427,152.03539490699768,203.67173767089844,6722,1867,4855,4855,0,14,2362000.0
2362,2362999,21.078960124552644,37.52695129454204,0.06431559349544491,325.20088028907776,152.10399961471558,203.69634628295898,6722,1867,4855,4855,0,14,2363000.0
2363,2363999,21.079661235760916,37.52679819828401,0.06429999675202203,325.3937110900879,152.1699070930481,203.54241943359375,6730,1870,4860,4860,0,14,2364000.0
2364,2364999,21.079249286269043,37.52551829318154,0.06428887841687358,325.5206480026245,152.2345175743103,203.60608291625977,6730,1870,4860,4860,0,14,2365000.0
2365,2365999,21.078013581526438,37.52179045306031,0.0642822349276948,325.65614461898804,152.29988646507263,203.66259002685547,6730,1870,4860,4860,0,14,2366000.0
2366,2366999,21.07652957991317,37.51897207042277,0.06426002250733398,325.78476119041443,152.36448335647583,204.1075325012207,6746,1870,4876,4876,0,14,2367000.0
2367,2367999,21.073079081937834,37.513645637102755,0.06427995286648325,325.89123582839966,152.42901802062988,204.61588287353516,6750,1870,4880,4880,0,14,2368000.0
2368,2368999,21.07023702565554,37.51158815394534,0.06428102755792986,326.0209059715271,152.500093460083,204.90098571777344,6753,1870,4883,4883,0,14,2369000.0
2369,2369999,21.066391470935496,37.5053566403146,0.06430879186203997,326.2193388938904,152.56472063064575,204.89323043823242,6763,1875,4888,4888,0,14,2370000.0
2370,2370999,21.063121797139413,37.50027088161991,0.06431813568122213,326.3646516799927,152.62933039665222,205.13039779663086,6767,1877,4890,4890,0,14,2371000.0
2371,2371999,21.060015998814873,37.495373125564896,0.06432787903332626,326.48368072509766,152.6937129497528,205.4411392211914,6770,1877,4893,4893,0,14,2372000.0
2372,2372999,21.05703889052173,37.49243876577153,0.06433307925856802,326.6275634765625,152.7586772441864,205.5443458557129,6772,1878,4894,4894,0,14,2373000.0
2373,2373999,21.053740716747626,37.486759344938434,0.06435398509985191,326.7805161476135,152.82415413856506,205.56924057006836,6776,1880,4896,4896,0,14,2374000.0
2374,2374999,21.050662899266314,37.48136616116775,0.06437149039981926,326.896511554718,152.88847851753235,205.7303352355957,6776,1880,4896,4896,0,14,2375000.0
2375,2375999,21.04760658265979,37.4760766517438,0.06438297821699623,327.05595993995667,152.95328497886658,205.7729721069336,6780,1882,4898,4898,0,14,2376000.0
2376,2376999,21.04465474935104,37.47108629748724,0.0643868524357819,327.2230386734009,153.01839113235474,205.77397537231445,6784,1884,4900,4900,0,14,2377000.0
2377,2377999,21.04247567641934,37.467174394238235,0.06437912099424348,327.37026047706604,153.08350443840027,205.9041748046875,6786,1885,4901,4901,0,14,2378000.0
2378,2378999,21.04000132878206,37.46303200332835,0.0643761074508391,327.49633169174194,153.1481921672821,206.0547332763672,6787,1885,4902,4902,0,14,2379000.0
2379,2379999,21.038686917840955,37.461346445760256,0.06435861383578967,327.61988377571106,153.2125747203827,206.1423683166504,6787,1885,4902,4902,0,14,2380000.0
2380,2380999,21.03947311541042,37.469284436054544,0.06428327851988336,327.75194334983826,153.27737259864807,206.26475143432617,6788,1885,4903,4903,0,14,2381000.0
2381,2381999,21.040516309085618,37.47189794529981,0.06423565875857351,327.8849632740021,153.3420569896698,206.3387451171875,6788,1885,4903,4903,0,14,2382000.0
2382,2382999,21.04186876740988,37.47431124597811,0.06418884267674951,328.03040528297424,153.40737771987915,206.41463470458984,6788,1885,4903,4903,0,14,2383000.0
2383,2383999,21.04393307258793,37.478967387867684,0.06413554944590394,328.1501295566559,153.4718463420868,206.4901123046875,6788,1885,4903,4903,0,14,2384000.0
2384,2384999,21.0455425730161,37.48074727566749,0.06411953260342718,328.3089838027954,153.5370819568634,206.4881362915039,6790,1886,4904,4904,0,14,2385000.0
2385,2385999,21.046924359200176,37.48257556322767,0.06408473531693082,328.4303021430969,153.60182785987854,206.55001068115234,6790,1886,4904,4904,0,14,2386000.0
2386,2386999,21.047650412097955,37.482762529775435,0.06406810637804805,328.5768711566925,153.66672229766846,206.6360740661621,6790,1886,4904,4904,0,14,2387000.0
2387,2387999,21.044686206456248,37.4777822159611,0.06407130067035305,328.6958749294281,153.73141050338745,207.43297576904297,6809,1886,4923,4923,0,14,2388000.0
2388,2388999,21.04124667221822,37.47312686962298,0.0640853363483399,328.82566356658936,153.7954065799713,207.73186492919922,6811,1887,4924,4924,0,14,2389000.0
2389,2389999,21.03868410952157,37.47072885058025,0.06408159926774659,328.9573132991791,153.85897850990295,207.89361953735352,6813,1888,4925,4925,0,14,2390000.0
2390,2390999,21.035861981762906,37.466481472058206,0.0640875655468669,329.1177759170532,153.92304921150208,207.98232650756836,6819,1891,4928,4928,0,14,2391000.0
2391,2391999,21.03306984123983,37.46156213607646,0.06408845432965116,329.2649972438812,153.98824095726013,208.173828125,6823,1893,4930,4930,0,14,2392000.0
2392,2392999,21.030335879212338,37.45639079237243,0.06410024561033212,329.4395046234131,154.05286121368408,208.18664169311523,6829,1896,4933,4933,0,14,2393000.0
2393,2393999,21.027985485940892,37.451515705452174,0.06409996623943426,329.5926249027252,154.1174557209015,208.2729606628418,6833,1898,4935,4935,0,14,2394000.0
2394,2394999,21.025281863121297,37.44622655078491,0.06411141664724662,329.72285413742065,154.18203973770142,208.46841430664062,6833,1898,4935,4935,0,14,2395000.0
2395,2395999,21.022942360195287,37.442065621889874,0.0641108633220836,329.8435685634613,154.24648594856262,208.60051345825195,6833,1898,4935,4935,0,14,2396000.0
2396,2396999,21.020449548836798,37.43869246184645,0.06410893277500662,329.9664685726166,154.31155061721802,208.70162963867188,6833,1898,4935,4935,0,14,2397000.0
2397,2397999,21.018074109644882,37.434034825149205,0.06411822983837612,330.1516377925873,154.3766794204712,208.64543533325195,6838,1900,4938,4938,0,14,2398000.0
2398,2398999,21.016095740847256,37.43045080364368,0.06411807733861241,330.2675862312317,154.44152736663818,208.74800872802734,6838,1900,4938,4938,0,14,2399000.0
2399,2399999,21.014814492450338,37.42847845268343,0.06409930797503427,330.43260955810547,154.50678253173828,208.71549224853516,6844,1902,4942,4942,0,14,2400000.0
2400,2400999,21.01493369989799,37.42861663188047,0.06406487931078941,330.5658097267151,154.57180213928223,208.86517715454102,6844,1902,4942,4942,0,14,2401000.0
2401,2401999,21.014532709927337,37.42711204769582,0.06404539616375804,330.71763467788696,154.63709950447083,208.90779876708984,6848,1904,4944,4944,0,14,2402000.0
2402,2402999,21.01481242213808,37.42657792656621,0.06401903501527828,330.8460760116577,154.7015345096588,209.02264022827148,6848,1904,4944,4944,0,14,2403000.0
2403,2403999,21.018023568558043,37.43317434823386,0.06396561158979841,331.00210547447205,154.7676877975464,209.08403778076172,6850,1905,4945,4945,0,14,2404000.0
2404,2404999,21.020790921449386,37.44015526977615,0.06392222012941096,331.1398229598999,154.83269548416138,209.15310668945312,6852,1906,4946,4946,0,14,2405000.0
2405,2405999,21.02376193034005,37.445600540420294,0.06388020200574329,331.2850363254547,154.89764094352722,209.21586227416992,6852,1906,4946,4946,0,14,2406000.0
2406,2406999,21.02585149443005,37.44803274172731,0.06384477624208706,331.401319026947,154.9622082710266,209.32090377807617,6852,1906,4946,4946,0,14,2407000.0
2407,2407999,21.024915152197014,37.44838431251631,0.06380802033961852,331.526780128479,155.02687549591064,209.7788848876953,6863,1906,4957,4957,0,14,2408000.0
2408,2408999,21.023027172730938,37.45747771293389,0.06375602424875326,331.64771842956543,155.09060287475586,210.07406616210938,6864,1906,4958,4958,0,14,2409000.0
2409,2409999,21.020476695360777,37.453855443141265,0.06375868817795982,331.77476596832275,155.15397572517395,210.2430076599121,6864,1906,4958,4958,0,14,2410000.0
2410,2410999,21.01819537796816,37.44998513962389,0.06376060053973343,331.96984672546387,155.21821188926697,210.2375259399414,6874,1911,4963,4963,0,14,2411000.0
2411,2411999,21.015754171982223,37.445896307928514,0.0637556596608323,332.1184301376343,155.28271293640137,210.37702560424805,6878,1913,4965,4965,0,14,2412000.0
2412,2412999,21.01381942396857,37.44227232451496,0.06374985217416529,332.2683708667755,155.346994638443,210.53733444213867,6880,1914,4966,4966,0,14,2413000.0
2413,2413999,21.01150713117586,37.43764677576265,0.06373613431563185,332.414183139801,155.41221952438354,210.6137809753418,6882,1915,4967,4967,0,14,2414000.0
2414,2414999,21.009821914981867,37.433739720681146,0.06372985766293304,332.5423197746277,155.47671627998352,210.7459373474121,6882,1915,4967,4967,0,14,2415000.0
2415,2415999,21.007807070340885,37.430165769060274,0.06371796213925962,332.6914019584656,155.54146933555603,210.75052642822266,6884,1916,4968,4968,0,14,2416000.0
2416,2416999,21.00569205868783,37.425825278156616,0.06371476999969672,332.8267192840576,155.605712890625,210.83090591430664,6884,1916,4968,4968,0,14,2417000.0
2417,2417999,21.00407286110733,37.42287823699545,0.0636945901447048,332.9473023414612,155.66978454589844,210.89886093139648,6884,1916,4968,4968,0,14,2418000.0
2418,2418999,21.00183038649231,37.41864727304232,0.0636864862384201,333.0790045261383,155.7342188358307,210.9697265625,6884,1916,4968,4968,0,14,2419000.0
2419,2419999,21.000834920884675,37.41740999999757,0.06365751870670422,333.2347593307495,155.7989375591278,210.97264099121094,6886,1917,4969,4969,0,14,2420000.0
2420,2420999,20.99996738148153,37.416047495895775,0.06364531176781141,333.4085075855255,155.8637776374817,210.90187072753906,6890,1919,4971,4971,0,14,2421000.0
2421,2421999,21.000837469457018,37.41828801282132,0.06361942992424108,333.57161021232605,155.92886638641357,210.9091339111328,6894,1921,4973,4973,0,14,2422000.0
2422,2422999,21.00116836802866,37.42056031335746,0.06361095370374226,333.68974351882935,155.99325513839722,211.02827072143555,6894,1921,4973,4973,0,14,2423000.0
2423,2423999,21.003524047559388,37.424642557740846,0.06360195158444604,333.8160240650177,156.05748915672302,211.1032943725586,6894,1921,4973,4973,0,14,2424000.0
2424,2424999,21.005714046302312,37.429268857013184,0.06359596409963253,333.9772424697876,156.12243103981018,211.07191467285156,6897,1922,4975,4975,0,14,2425000.0
2425,2425999,21.008206576922703,37.43501920631202,0.0635784519799153,334.1111743450165,156.18750834465027,211.1252555847168,6897,1922,4975,4975,0,14,2426000.0
2426,2426999,21.008671042440973,37.43567864230857,0.06358827546555801,334.269873380661,156.25245118141174,211.0799674987793,6901,1924,4977,4977,0,14,2427000.0
2427,2427999,21.009900472191507,37.440120107594105,0.06356211196537909,334.40994691848755,156.31754398345947,211.07716751098633,6905,1925,4980,4980,0,14,2428000.0
2428,2428999,21.009017764185227,37.43872064002536,0.0635244111380151,334.5388910770416,156.38205909729004,211.5896224975586,6918,1925,4993,4993,0,14,2429000.0
2429,2429999,21.007470562954317,37.43832853947227,0.06348728023094286,334.65768337249756,156.4463403224945,211.82275772094727,6918,1925,4993,4993,0,14,2430000.0
2430,2430999,21.00585758188676,37.43596874737472,0.063474617850939,334.78796887397766,156.5103099346161,211.86298370361328,6922,1926,4996,4996,0,14,2431000.0
2431,2431999,21.003496225004618,37.431930529741045,0.0634727518723941,334.96291041374207,156.57530188560486,211.8685531616211,6928,1929,4999,4999,0,14,2432000.0
2432,2432999,21.00152612225226,37.42827650268068,0.06345661924073864,335.15272998809814,156.64045000076294,211.91918182373047,6936,1933,5003,5003,0,14,2433000.0
2433,2433999,21.000485448438283,37.427024408406204,0.06342986575948295,335.2694208621979,156.7051341533661,212.16730117797852,6936,1933,5003,5003,0,14,2434000.0
2434,2434999,20.998901207177433,37.42491570412295,0.0634109582281035,335.4301450252533,156.77053451538086,212.21735382080078,6940,1935,5005,5005,0,14,2435000.0
2435,2435999,20.997096329560218,37.42094123296058,0.0633968564699321,335.5575940608978,156.8364839553833,212.3627052307129,6940,1935,5005,5005,0,14,2436000.0
2436,2436999,20.99551496504605,37.416780591842674,0.06337787579561882,335.71410512924194,156.90157747268677,212.40978240966797,6942,1936,5006,5006,0,14,2437000.0
2437,2437999,20.99387165839413,37.41261427392864,0.06336690428347447,335.850590467453,156.9666678905487,212.45510864257812,6944,1937,5007,5007,0,14,2438000.0
2438,2438999,20.99224673416452,37.408756089210705,0.06335255555205976,335.9908266067505,157.03176832199097,212.5234260559082,6946,1938,5008,5008,0,14,2439000.0
2439,2439999,20.9907853093463,37.4050816649128,0.06333527474835887,336.13848304748535,157.0973858833313,212.50438690185547,6949,1939,5010,5010,0,14,2440000.0
2440,2440999,20.98961786527852,37.40243515343263,0.06330626282384699,336.28861570358276,157.1630322933197,212.59703826904297,6949,1939,5010,5010,0,14,2441000.0
2441,2441999,20.988772946922168,37.40023264310544,0.06328190505959841,336.4312644004822,157.22824120521545,212.62207794189453,6951,1940,5011,5011,0,14,2442000.0
2442,2442999,20.98746860454913,37.39640320333807,0.06326174182101618,336.5510399341583,157.29362869262695,212.72002410888672,6951,1940,5011,5011,0,14,2443000.0
2443,2443999,20.9869152386633,37.393871968507405,0.06324781577282301,336.67846751213074,157.35858941078186,212.79306411743164,6951,1940,5011,5011,0,14,2444000.0
2444,2444999,20.986279441675542,37.39070819306732,0.06323044822278723,336.8322842121124,157.42377734184265,212.76296615600586,6955,1941,5014,5014,0,14,2445000.0
2445,2445999,20.986029219989152,37.38827041206571,0.06320357439459545,336.9751932621002,157.48908853530884,212.8621063232422,6955,1941,5014,5014,0,14,2446000.0
2446,2446999,20.985416716205112,37.38569057393863,0.06317428168222838,337.12172627449036,157.55478882789612,212.8223991394043,6958,1942,5016,5016,0,14,2447000.0
2447,2447999,20.98493336504861,37.382665465666655,0.0631579386569775,337.2403013706207,157.6203556060791,212.88648223876953,6958,1942,5016,5016,0,14,2448000.0
2448,2448999,20.984326156340437,37.382345049103485,0.06314062780355933,337.3664472103119,157.68596196174622,212.96259689331055,6958,1942,5016,5016,0,14,2449000.0
2449,2449999,20.983728325095747,37.38328156924858,0.0630984453600959,337.4977867603302,157.7519223690033,213.43568420410156,6969,1942,5027,5027,0,14,2450000.0
2450,2450999,20.98229513065927,37.379990437262364,0.0630725457268343,337.61249256134033,157.81657791137695,213.68634033203125,6970,1942,5028,5028,0,14,2451000.0
2451,2451999,20.981171219701103,37.37661846777335,0.06306175284211657,337.75064396858215,157.8813190460205,213.8095359802246,6972,1943,5029,5029,0,14,2452000.0
2452,2452999,20.97989188780454,37.37326632218561,0.06304947384365645,337.8964581489563,157.94585943222046,213.96481323242188,6974,1944,5030,5030,0,14,2453000.0
2453,2453999,20.97879626831355,37.37127788889332,0.06302729822212971,338.05643796920776,158.01052141189575,214.04345321655273,6978,1946,5032,5032,0,14,2454000.0
2454,2454999,20.977664283410114,37.36994194460672,0.06303660196215244,338.22936248779297,158.07613158226013,214.0725555419922,6984,1949,5035,5035,0,14,2455000.0
2455,2455999,20.976317024292566,37.36662821575338,0.06302405232691488,338.36878848075867,158.14077281951904,214.1696319580078,6986,1950,5036,5036,0,14,2456000.0
2456,2456999,20.975564239981885,37.36532830905773,0.06300289683277649,338.5480489730835,158.20653986930847,214.15796661376953,6992,1953,5039,5039,0,14,2457000.0
2457,2457999,20.974219624198724,37.36243460955145,0.06300306691225421,338.6778130531311,158.27179789543152,214.30416107177734,6992,1953,5039,5039,0,14,2458000.0
2458,2458999,20.972720571215955,37.35862426519012,0.06299617126119927,338.8376235961914,158.3369836807251,214.3396987915039,6994,1954,5040,5040,0,14,2459000.0
2459,2459999,20.971985792154097,37.35636893389103,0.06298362429100068,338.9758470058441,158.4023358821869,214.42807006835938,6994,1954,5040,5040,0,14,2460000.0
2460,2460999,20.9712774024899,37.35816826504755,0.06295898502327957,339.1175425052643,158.46767020225525,214.4280662536621,6996,1955,5041,5041,0,14,2461000.0
2461,2461999,20.97081510499378,37.35621877917426,0.06296440977343987,339.24802350997925,158.53306317329407,214.53906631469727,6996,1955,5041,5041,0,14,2462000.0
2462,2462999,20.969887084331944,37.352649168955324,0.06297000762826388,339.38969111442566,158.59869837760925,214.52498245239258,7000,1956,5044,5044,0,14,2463000.0
2463,2463999,20.96873217756634,37.349182908956166,0.06298133508137282,339.5782368183136,158.66441822052002,214.32825469970703,7010,1959,5051,5051,0,14,2464000.0
2464,2464999,20.968218750002272,37.3464028688831,0.062979478020045,339.708788394928,158.7301332950592,214.47695541381836,7010,1959,5051,5051,0,14,2465000.0
2465,2465999,20.966555088582435,37.342142075886834,0.06298416751795899,339.8386936187744,158.7956759929657,214.55474853515625,7010,1959,5051,5051,0,14,2466000.0
2466,2466999,20.965213119108213,37.338240569451656,0.06297312876720373,339.96631956100464,158.86066722869873,214.66748809814453,7010,1959,5051,5051,0,14,2467000.0
2467,2467999,20.963762256029103,37.338083003591876,0.06295290535411557,340.0937867164612,158.92589354515076,215.3994903564453,7030,1959,5071,5071,0,14,2468000.0
2468,2468999,20.9620559226549,37.33648978881444,0.06294884269301859,340.2138030529022,158.98988604545593,215.67466735839844,7030,1959,5071,5071,0,14,2469000.0
2469,2469999,20.96044523800293,37.334571700176866,0.06294388577281829,340.34184741973877,159.05436396598816,215.82232284545898,7033,1960,5073,5073,0,14,2470000.0
2470,2470999,20.958905421570698,37.331885845529904,0.06294076226729561,340.50603771209717,159.11984539031982,215.98510360717773,7037,1962,5075,5075,0,14,2471000.0
2471,2471999,20.95782103914652,37.32948174351088,0.06292863071264199,340.6490387916565,159.18454146385193,216.09669876098633,7041,1964,5077,5077,0,14,2472000.0
2472,2472999,20.955809926879134,37.32525403427625,0.06293175621902092,340.7808413505554,159.25060629844666,216.27512741088867,7041,1964,5077,5077,0,14,2473000.0
2473,2473999,20.955409801837824,37.32458676878856,0.0629095257131912,340.943660736084,159.3161289691925,216.34324645996094,7045,1966,5079,5079,0,14,2474000.0
2474,2474999,20.954190069666318,37.32158675971989,0.0628977168901339,341.0953116416931,159.3817913532257,216.3993148803711,7049,1968,5081,5081,0,14,2475000.0
2475,2475999,20.95358215216427,37.32698888884823,0.06286198445062885,341.2344961166382,159.44725584983826,216.4986686706543,7051,1969,5082,5082,0,14,2476000.0
2476,2476999,20.952847836638405,37.324733082613164,0.06284514770945493,341.4123680591583,159.5130639076233,216.47952270507812,7057,1972,5085,5085,0,14,2477000.0
2477,2477999,20.9529957708505,37.327342461031286,0.06280553792858834,341.5748860836029,159.57878518104553,216.5697364807129,7059,1973,5086,5086,0,14,2478000.0
2478,2478999,20.953165860088408,37.32592323243721,0.06278633758783403,341.715633392334,159.64452600479126,216.64816665649414,7061,1974,5087,5087,0,14,2479000.0
2479,2479999,20.954452985875303,37.32643951602807,0.06275208296674029,341.8525664806366,159.7105016708374,216.73122024536133,7063,1975,5088,5088,0,14,2480000.0
2480,2480999,20.95529492911797,37.326170578553494,0.06273305273224616,341.9816873073578,159.77609586715698,216.8399314880371,7063,1975,5088,5088,0,14,2481000.0
2481,2481999,20.957441569918107,37.327961836440195,0.06271526929233207,342.1211357116699,159.84517812728882,216.90576934814453,7063,1975,5088,5088,0,14,2482000.0
2482,2482999,20.959588694316444,37.335483251390016,0.06268060416772303,342.2699544429779,159.91122102737427,216.8779067993164,7068,1976,5092,5092,0,14,2483000.0
2483,2483999,20.961703739744507,37.338230475173674,0.06266113745930357,342.3962321281433,159.9770803451538,216.9654426574707,7068,1976,5092,5092,0,14,2484000.0
2484,2484999,20.963028844151584,37.33778308489495,0.06265631044529862,342.56388545036316,160.04318380355835,216.92218399047852,7072,1978,5094,5094,0,14,2485000.0
2485,2485999,20.96491236088255,37.34054502155354,0.0626428105851683,342.71609330177307,160.1094491481781,217.0264663696289,7072,1978,5094,5094,0,14,2486000.0
2486,2486999,20.964585060576947,37.33775037369207,0.06263897096090876,342.8405861854553,160.1745047569275,217.14641952514648,7072,1978,5094,5094,0,14,2487000.0
2487,2487999,20.962808576542855,37.33566834838867,0.0626237113473812,342.95547556877136,160.23944926261902,217.8097038269043,7088,1978,5110,5110,0,14,2488000.0
2488,2488999,20.961019063771932,37.33402851226574,0.06261822818609453,343.0862166881561,160.30351042747498,218.02013778686523,7090,1979,5111,5111,0,14,2489000.0
2489,2489999,20.95942584266618,37.33192581359338,0.06262182685368078,343.20181369781494,160.36815309524536,218.23283004760742,7090,1979,5111,5111,0,14,2490000.0
2490,2490999,20.958324118893806,37.330481226727436,0.06261812488376006,343.3924014568329,160.43367671966553,218.23148345947266,7098,1983,5115,5115,0,14,2491000.0
2491,2491999,20.956471832225088,37.32900181850946,0.0626133156427312,343.53670597076416,160.49921679496765,218.3686637878418,7102,1985,5117,5117,0,14,2492000.0
2492,2492999,20.954945106506415,37.32609900033508,0.06260919455009362,343.68254113197327,160.5646481513977,218.48244094848633,7104,1986,5118,5118,0,14,2493000.0
2493,2493999,20.953341449121748,37.32330773298424,0.06260043856734387,343.862256526947,160.63449907302856,218.52655410766602,7108,1988,5120,5120,0,14,2494000.0
2494,2494999,20.951620651452266,37.3196111826803,0.06259267470502416,344.01742792129517,160.70031929016113,218.64947509765625,7110,1989,5121,5121,0,14,2495000.0
2495,2495999,20.95046817500569,37.31872507284538,0.06258113901030071,344.14764428138733,160.76674342155457,218.75801849365234,7110,1989,5121,5121,0,14,2496000.0
2496,2496999,20.948311594812473,37.31373530898059,0.06258273693747651,344.2795705795288,160.8330581188202,218.83363723754883,7110,1989,5121,5121,0,14,2497000.0
2497,2497999,20.947047039179566,37.3145820062461,0.06256137330137335,344.43047976493835,160.89856505393982,218.85389709472656,7112,1990,5122,5122,0,14,2498000.0
2498,2498999,20.945647353707024,37.31123261250664,0.06256162462791626,344.5601234436035,160.96394395828247,218.91838455200195,7112,1990,5122,5122,0,14,2499000.0
2499,2499999,20.944252528076184,37.30734845554249,0.06256003958964318,344.6910262107849,161.02918934822083,218.98596572875977,7112,1990,5122,5122,0,14,2500000.0
2500,2500999,20.94340661668134,37.305864645084206,0.06254508806716663,344.82708501815796,161.09516549110413,219.06181716918945,7112,1990,5122,5122,0,14,2501000.0
2501,2501999,20.94218389673756,37.30188479650167,0.06254312813137619,344.96584272384644,161.16054487228394,219.11304473876953,7112,1990,5122,5122,0,14,2502000.0
2502,2502999,20.94102973206367,37.29809649770379,0.06253971113085388,345.0969862937927,161.22569727897644,219.1488800048828,7112,1990,5122,5122,0,14,2503000.0
2503,2503999,20.940197094260725,37.294599827346346,0.06253523899728353,345.21911549568176,161.29070520401,219.2010154724121,7112,1990,5122,5122,0,14,2504000.0
2504,2504999,20.938774793221963,37.29019116617868,0.06254422335579357,345.3710677623749,161.3560836315155,219.20800018310547,7114,1991,5123,5123,0,14,2505000.0
2505,2505999,20.9374619719679,37.28625703776769,0.06254349270470982,345.53394770622253,161.42211484909058,219.2105484008789,7116,1992,5124,5124,0,14,2506000.0
2506,2506999,20.936093905596728,37.28201062709597,0.06255246298610773,345.67482352256775,161.4874725341797,219.2431869506836,7118,1993,5125,5125,0,14,2507000.0
2507,2507999,20.933692918272225,37.27753094006996,0.06255755510058758,345.82646465301514,161.55440521240234,219.50152969360352,7127,1994,5133,5133,0,14,2508000.0
2508,2508999,20.930212895752167,37.27157282509459,0.06258355441537722,345.9461336135864,161.61957049369812,219.99084091186523,7135,1994,5141,5141,0,14,2509000.0
2509,2509999,20.9278202103194,37.268012011363126,0.06259179063927267,346.0796525478363,161.68503284454346,220.17293167114258,7135,1994,5141,5141,0,14,2510000.0
2510,2510999,20.924912589676776,37.26374489687985,0.06262394124219861,346.2342803478241,161.7505238056183,220.24957656860352,7140,1996,5144,5144,0,14,2511000.0
2511,2511999,20.922453687778113,37.26308675806899,0.062637164725588,346.4037432670593,161.81636548042297,220.37741088867188,7146,1999,5147,5147,0,14,2512000.0
2512,2512999,20.91936320610386,37.25794447965486,0.06265933588755446,346.5676460266113,161.88146448135376,220.48526000976562,7150,2001,5149,5149,0,14,2513000.0
2513,2513999,20.916770256956326,37.25396516676719,0.0626801662041494,346.6886305809021,161.94699883460999,220.61685943603516,7150,2001,5149,5149,0,14,2514000.0
2514,2514999,20.913549753155227,37.24849151409035,0.0626996158470049,346.82946705818176,162.01200008392334,220.72193145751953,7150,2001,5149,5149,0,14,2515000.0
2515,2515999,20.91048800795298,37.24483476151998,0.06271398717735799,346.9477117061615,162.07738280296326,220.79800415039062,7150,2001,5149,5149,0,14,2516000.0
2516,2516999,20.90761186456228,37.239534137202526,0.06272918145167972,347.11047196388245,162.14286375045776,220.7924690246582,7154,2003,5151,5151,0,14,2517000.0
2517,2517999,20.90534640700026,37.23503164837549,0.06274476502576787,347.2562825679779,162.21575140953064,220.86839294433594,7154,2003,5151,5151,0,14,2518000.0
2518,2518999,20.902863498000734,37.23086155369089,0.06275641662471387,347.40932393074036,162.28095722198486,220.89481353759766,7156,2004,5152,5152,0,14,2519000.0
2519,2519999,20.900311961721158,37.225732210992234,0.06277167572511766,347.55819272994995,162.35434770584106,220.93833541870117,7156,2004,5152,5152,0,14,2520000.0
2520,2520999,20.89740318679596,37.22028754899659,0.0627927088900525,347.74470376968384,162.42240023612976,220.8631248474121,7161,2006,5155,5155,0,14,2521000.0
2521,2521999,20.894943847365738,37.21571611279268,0.06280393674515738,347.8765459060669,162.48821806907654,220.9598617553711,7161,2006,5155,5155,0,14,2522000.0
2522,2522999,20.89256174272376,37.21133840644916,0.06281822208711874,348.0008542537689,162.55326294898987,221.02831268310547,7161,2006,5155,5155,0,14,2523000.0
2523,2523999,20.890668069860826,37.20770882382841,0.0628307087594756,348.133912563324,162.61887311935425,221.0694351196289,7161,2006,5155,5155,0,14,2524000.0
2524,2524999,20.889004317716637,37.203494929358236,0.06283986515524065,348.2877519130707,162.6843991279602,221.06615829467773,7165,2007,5158,5158,0,14,2525000.0
2525,2525999,20.887183009038075,37.19938450818006,0.06284439004771292,348.4119417667389,162.74982404708862,221.1310043334961,7165,2007,5158,5158,0,14,2526000.0
2526,2526999,20.884916763164572,37.194842874744815,0.06285580070277252,348.5435974597931,162.81506729125977,221.1758155822754,7165,2007,5158,5158,0,14,2527000.0
2527,2527999,20.88273614702091,37.19051820860912,0.06286724095131246,348.67639327049255,162.88041186332703,221.24656295776367,7165,2007,5158,5158,0,14,2528000.0
2528,2528999,20.88016103143127,37.18585667662488,0.0628844855220585,348.82294392585754,162.95610761642456,221.81409454345703,7180,2007,5173,5173,0,14,2529000.0
2529,2529999,20.877156380314393,37.182294573919826,0.0629027608248971,348.9426271915436,163.0213143825531,222.07626724243164,7181,2007,5174,5174,0,14,2530000.0
2530,2530999,20.8742397399315,37.17763996098198,0.06292465429000516,349.072785615921,163.08712315559387,222.2436637878418,7182,2007,5175,5175,0,14,2531000.0
2531,2531999,20.871918014510854,37.17692914773479,0.0629223795246383,349.25744915008545,163.15239572525024,222.19809341430664,7190,2011,5179,5179,0,14,2532000.0
2532,2532999,20.86903174032529,37.17250295557594,0.06293019597315075,349.4197280406952,163.2183701992035,222.39241409301758,7194,2013,5181,5181,0,14,2533000.0
2533,2533999,20.86721546163773,37.16899111884007,0.06293589559459778,349.58356857299805,163.28971886634827,222.4045524597168,7200,2015,5185,5185,0,14,2534000.0
2534,2534999,20.864768097257567,37.164124559982504,0.06294915968232684,349.72938418388367,163.36014199256897,222.4844970703125,7202,2016,5186,5186,0,14,2535000.0
2535,2535999,20.8619332342341,37.159129809670006,0.0629635351857959,349.8922381401062,163.4260892868042,222.58473205566406,7204,2017,5187,5187,0,14,2536000.0
2536,2536999,20.85976208098353,37.155261960290055,0.06297474368586553,350.02780532836914,163.49181294441223,222.67691040039062,7206,2018,5188,5188,0,14,2537000.0
2537,2537999,20.857123507355176,37.15011131640752,0.06298823613012228,350.18224477767944,163.5577552318573,222.6872787475586,7213,2020,5193,5193,0,14,2538000.0
2538,2538999,20.854902722441647,37.14607598056741,0.06298908065322084,350.3464140892029,163.62697768211365,222.71552276611328,7215,2021,5194,5194,0,14,2539000.0
2539,2539999,20.852721357877375,37.14148629594369,0.06298462638917046,350.5082106590271,163.6934413909912,222.75519561767578,7217,2022,5195,5195,0,14,2540000.0
2540,2540999,20.85072180671228,37.13740158783303,0.06298426919147349,350.646142244339,163.75962662696838,222.85012817382812,7217,2022,5195,5195,0,14,2541000.0
2541,2541999,20.849116491041375,37.134202083333065,0.06297762019190112,350.78232169151306,163.83161544799805,222.9287567138672,7217,2022,5195,5195,0,14,2542000.0
2542,2542999,20.84923160658084,37.13757779266802,0.0629392954141641,350.9118173122406,163.8975224494934,223.03253555297852,7217,2022,5195,5195,0,14,2543000.0
2543,2543999,20.849758424369227,37.13830880416363,0.06292618700021702,351.0814411640167,163.96870970726013,222.97230911254883,7222,2024,5198,5198,0,14,2544000.0
2544,2544999,20.85018744747982,37.13872611814289,0.06293201137523452,351.21680331230164,164.03837156295776,223.0727195739746,7222,2024,5198,5198,0,14,2545000.0
2545,2545999,20.85129899105672,37.14236217756554,0.06293802425544681,351.3734652996063,164.10472679138184,223.1528434753418,7222,2024,5198,5198,0,14,2546000.0
2546,2546999,20.852302404266116,37.14313046610372,0.06294460868524299,351.4996135234833,164.1707558631897,223.20208740234375,7222,2024,5198,5198,0,14,2547000.0
2547,2547999,20.85188222934302,37.14051233694654,0.06294620721696409,351.6306335926056,164.24055314064026,223.2825698852539,7222,2024,5198,5198,0,14,2548000.0
2548,2548999,20.850686084231114,37.13743992745367,0.0629607077643386,351.7716910839081,164.3146471977234,223.4282989501953,7224,2024,5200,5200,0,14,2549000.0
2549,2549999,20.8479496265084,37.13449486239552,0.0629724034583532,351.8829369544983,164.37896585464478,223.94024658203125,7235,2024,5211,5211,0,14,2550000.0
2550,2550999,20.84574461692363,37.13178826614689,0.06297794934852252,352.0160143375397,164.4435613155365,224.1445655822754,7235,2024,5211,5211,0,14,2551000.0
2551,2551999,20.843131772775397,37.12703039795289,0.06299893091324138,352.1765763759613,164.50794744491577,224.2119255065918,7239,2026,5213,5213,0,14,2552000.0
2552,2552999,20.840588173185466,37.122352446997986,0.06300999309215993,352.3848075866699,164.57410526275635,224.2401351928711,7249,2031,5218,5218,0,14,2553000.0
2553,2553999,20.839081033611123,37.12054048768598,0.06300171730428572,352.5265657901764,164.63954710960388,224.3826675415039,7251,2032,5219,5219,0,14,2554000.0
2554,2554999,20.83724352022746,37.11707393139534,0.06300734170320654,352.64656138420105,164.70409989356995,224.5194206237793,7251,2032,5219,5219,0,14,2555000.0
2555,2555999,20.8357927866049,37.116227351063436,0.06300370866478022,352.8293921947479,164.77345848083496,224.3957290649414,7259,2035,5224,5224,0,14,2556000.0
2556,2556999,20.834903620556112,37.12213793126532,0.06296753839074576,352.9811816215515,164.83947253227234,224.47837829589844,7263,2036,5227,5227,0,14,2557000.0
2557,2557999,20.834244225334032,37.12114019230162,0.06295861028000593,353.1365749835968,164.90512371063232,224.6153907775879,7265,2037,5228,5228,0,14,2558000.0
2558,2558999,20.833121723580152,37.11872535558644,0.06295951357204488,353.29726338386536,164.97085857391357,224.62856674194336,7269,2039,5230,5230,0,14,2559000.0
2559,2559999,20.833179478758183,37.119615679113274,0.0629447306588744,353.44753980636597,165.03855848312378,224.70632553100586,7271,2040,5231,5231,0,14,2560000.0
2560,2560999,20.83287081702549,37.11892576985725,0.06293825758380878,353.5668852329254,165.10381937026978,224.80279159545898,7271,2040,5231,5231,0,14,2561000.0
2561,2561999,20.834080077285957,37.12146269576215,0.06292164602122707,353.7021219730377,165.1690514087677,224.8837432861328,7271,2040,5231,5231,0,14,2562000.0
2562,2562999,20.836474797035844,37.12708850844002,0.06290065743210671,353.90809416770935,165.235689163208,224.71353149414062,7287,2044,5243,5243,0,14,2563000.0
2563,2563999,20.83844269087759,37.12954054670527,0.06290953157479506,354.04884338378906,165.30155539512634,224.80387115478516,7289,2045,5244,5244,0,14,2564000.0
2564,2564999,20.841532127783708,37.135268389947726,0.06290326744458186,354.1877601146698,165.36690855026245,224.8958969116211,7289,2045,5244,5244,0,14,2565000.0
2565,2565999,20.845558078348034,37.14164086144065,0.06290230778619976,354.3200032711029,165.43229031562805,225.00784301757812,7289,2045,5244,5244,0,14,2566000.0
2566,2566999,20.850762618619186,37.15175331962846,0.06289953795067138,354.4646852016449,165.497887134552,225.00697326660156,7291,2046,5245,5245,0,14,2567000.0
2567,2567999,20.854450559992287,37.16014937926326,0.06290038551035415,354.587593793869,165.5632016658783,225.09183883666992,7291,2046,5245,5245,0,14,2568000.0
2568,2568999,20.859934074366684,37.170439915176786,0.06286830880055372,354.73609495162964,165.62930965423584,225.18695449829102,7291,2046,5245,5245,0,14,2569000.0
2569,2569999,20.861640928614168,37.17674558593344,0.06281854661885822,354.8805377483368,165.6944396495819,225.50576782226562,7301,2047,5254,5254,0,14,2570000.0
2570,2570999,20.85962134795823,37.1734886548161,0.06280713781748526,354.99521946907043,165.75878858566284,225.74677276611328,7302,2047,5255,5255,0,14,2571000.0
2571,2571999,20.857594841343737,37.17090507595224,0.06279835791842114,355.15113067626953,165.82488584518433,225.81825256347656,7308,2049,5259,5259,0,14,2572000.0
2572,2572999,20.85671688174966,37.17162138499304,0.06276277030933697,355.28521180152893,165.8895399570465,225.90485763549805,7310,2050,5260,5260,0,14,2573000.0
2573,2573999,20.855319581935987,37.16826070117051,0.06276039868671701,355.4996418952942,165.95582127571106,225.83307647705078,7325,2055,5270,5270,0,14,2574000.0
2574,2574999,20.854073626926347,37.1654524388146,0.06274880212528056,355.6223819255829,166.02061367034912,226.02747344970703,7325,2055,5270,5270,0,14,2575000.0
2575,2575999,20.852885292122714,37.1624452100961,0.06273267758347334,355.75681233406067,166.08581447601318,226.13973236083984,7325,2055,5270,5270,0,14,2576000.0
2576,2576999,20.851527693181936,37.15886831406535,0.06272701631395927,355.91645097732544,166.15382051467896,226.18303680419922,7327,2056,5271,5271,0,14,2577000.0
2577,2577999,20.850701150832993,37.1559785402076,0.06272123432934662,356.03530716896057,166.2192358970642,226.28158569335938,7328,2056,5272,5272,0,14,2578000.0
2578,2578999,20.850443174213037,37.154908959604974,0.06269525191912795,356.19395756721497,166.28502202033997,226.28416061401367,7333,2057,5276,5276,0,14,2579000.0
2579,2579999,20.849019383813587,37.15139759535893,0.06270185844961274,356.33617401123047,166.35418319702148,226.35669326782227,7333,2057,5276,5276,0,14,2580000.0
2580,2580999,20.84855160612324,37.14953465023037,0.06271650449844801,356.4680368900299,166.41960072517395,226.42092514038086,7333,2057,5276,5276,0,14,2581000.0
2581,2581999,20.84829362508627,37.14818640961592,0.0627184434667053,356.60290145874023,166.48468470573425,226.46590042114258,7333,2057,5276,5276,0,14,2582000.0
2582,2582999,20.84851937832168,37.14783921815939,0.06269839108561426,356.7443335056305,166.55031561851501,226.50045776367188,7333,2057,5276,5276,0,14,2583000.0
2583,2583999,20.84908877656922,37.148231118850795,0.06269552659523947,356.9157180786133,166.6216778755188,226.52111053466797,7338,2058,5280,5280,0,14,2584000.0
2584,2584999,20.84960802878242,37.14847000556334,0.06271071670305772,357.0463013648987,166.6895236968994,226.56975936889648,7338,2058,5280,5280,0,14,2585000.0
2585,2585999,20.8506021314932,37.148416165549285,0.06270954838454035,357.1744816303253,166.75534749031067,226.59828186035156,7338,2058,5280,5280,0,14,2586000.0
2586,2586999,20.85249703190593,37.149865205837784,0.06268457945832595,357.3273711204529,166.82080245018005,226.6108627319336,7343,2059,5284,5284,0,14,2587000.0
2587,2587999,20.853976991431978,37.15105759127386,0.06265247804605889,357.4599425792694,166.88603854179382,226.6481475830078,7343,2059,5284,5284,0,14,2588000.0
2588,2588999,20.856129699236376,37.15330670419065,0.06264285062096275,357.61001563072205,166.95173859596252,226.6677017211914,7343,2059,5284,5284,0,14,2589000.0
2589,2589999,20.859096144057688,37.15879450912052,0.06260456911478152,357.7424292564392,167.01738476753235,226.72352981567383,7343,2059,5284,5284,0,14,2590000.0
2590,2590999,20.85862432725136,37.15674568877745,0.06260014373248524,357.87565875053406,167.08304524421692,227.3926239013672,7364,2059,5305,5305,0,14,2591000.0
2591,2591999,20.855983202600463,37.15425720086027,0.06260444064658233,357.9942207336426,167.14895343780518,227.77831649780273,7365,2059,5306,5306,0,14,2592000.0
2592,2592999,20.853815727448755,37.15138664207829,0.06261321565802025,358.13069128990173,167.2139847278595,227.95839309692383,7367,2060,5307,5307,0,14,2593000.0
2593,2593999,20.851272896551887,37.14687785004994,0.06262905007577846,358.29157185554504,167.27980875968933,228.07382202148438,7371,2062,5309,5309,0,14,2594000.0
2594,2594999,20.84869375029676,37.14212098451807,0.06264128022116577,358.43884110450745,167.34629011154175,228.24089431762695,7373,2063,5310,5310,0,14,2595000.0
2595,2595999,20.846217673749095,37.13771582053177,0.06265070878829249,358.57777857780457,167.41210269927979,228.37527465820312,7375,2064,5311,5311,0,14,2596000.0
2596,2596999,20.843551122662916,37.13287354664045,0.06265768385904269,358.7454605102539,167.47935104370117,228.39585876464844,7379,2066,5313,5313,0,14,2597000.0
2597,2597999,20.840946335778327,37.12852883134576,0.06267270679370662,358.8984577655792,167.5452663898468,228.43603897094727,7385,2068,5317,5317,0,14,2598000.0
2598,2598999,20.838953613530595,37.12491958115105,0.06267161178500114,359.0608103275299,167.61155223846436,228.51239013671875,7389,2070,5319,5319,0,14,2599000.0
2599,2599999,20.836541548990308,37.120358424406035,0.0626826470806029,359.25506591796875,167.67846298217773,228.51926040649414,7395,2073,5322,5322,0,14,2600000.0
2600,2600999,20.83481572124524,37.1171530759885,0.06268196902704226,359.386105298996,167.74419045448303,228.69611740112305,7395,2073,5322,5322,0,14,2601000.0
2601,2601999,20.833578824250502,37.11408190950152,0.06267385773615197,359.5045065879822,167.81012439727783,228.80353927612305,7395,2073,5322,5322,0,14,2602000.0
2602,2602999,20.832796769396197,37.112146379831884,0.06265464596018966,359.6316912174225,167.87625408172607,228.91046524047852,7395,2073,5322,5322,0,14,2603000.0
2603,2603999,20.832052114244238,37.1096315462045,0.06265016553252478,359.77065682411194,167.94215273857117,229.00425720214844,7395,2073,5322,5322,0,14,2604000.0
2604,2604999,20.832138817520594,37.108507902636454,0.06262467308717601,359.91124534606934,168.00788187980652,229.04599380493164,7397,2074,5323,5323,0,14,2605000.0
2605,2605999,20.832809875795004,37.10810172641126,0.06260886439246383,360.0337200164795,168.07373094558716,229.16735076904297,7397,2074,5323,5323,0,14,2606000.0
2606,2606999,20.832696850222685,37.107159898598766,0.06259961937300262,360.17125821113586,168.14000487327576,229.22310638427734,7397,2074,5323,5323,0,14,2607000.0
2607,2607999,20.833181639774438,37.105912836045626,0.06259459316810234,360.3046295642853,168.20621013641357,229.32596969604492,7397,2074,5323,5323,0,14,2608000.0
2608,2608999,20.83128616082533,37.102651747746705,0.06257767373444167,361.3426682949066,168.2721860408783,229.9492645263672,7418,2074,5344,5344,0,14,2609000.0
2609,2609999,20.82864091298081,37.0981319349817,0.06259423684609688,361.45889544487,168.33703804016113,230.30406188964844,7420,2074,5346,5346,0,14,2610000.0
2610,2610999,20.825781435031104,37.09417405835882,0.06261955603531277,361.6032269001007,168.40249800682068,230.44009017944336,7422,2075,5347,5347,0,14,2611000.0
2611,2611999,20.82246240492642,37.08873811106793,0.06265094093992685,361.75324010849,168.46861863136292,230.65544509887695,7425,2076,5349,5349,0,14,2612000.0
2612,2612999,20.819666720718157,37.084223177315366,0.06267468085319361,361.9151382446289,168.53533363342285,230.74058532714844,7429,2078,5351,5351,0,14,2613000.0
2613,2613999,20.816728561476424,37.079024910562104,0.06269734998033605,362.09446930885315,168.60204005241394,230.8472023010254,7435,2081,5354,5354,0,14,2614000.0
2614,2614999,20.813844041439292,37.074629795275754,0.06271334579742627,362.2460799217224,168.67204976081848,231.0102653503418,7438,2082,5356,5356,0,14,2615000.0
2615,2615999,20.810731791054994,37.069729892232786,0.06273458307128321,362.3954110145569,168.73828601837158,231.08998107910156,7440,2083,5357,5357,0,14,2616000.0
2616,2616999,20.807818577682795,37.064416723328556,0.06275218666577831,362.5645260810852,168.81103348731995,231.17360305786133,7442,2084,5358,5358,0,14,2617000.0
2617,2617999,20.80498469849358,37.05996750741323,0.06276602797169772,362.6907343864441,168.8769543170929,231.31813430786133,7442,2084,5358,5358,0,14,2618000.0
2618,2618999,20.802154189794994,37.05536469302909,0.0627731548116961,362.857803106308,168.94334483146667,231.32968139648438,7449,2086,5363,5363,0,14,2619000.0
2619,2619999,20.800177281045528,37.05251435695397,0.06277592392322207,362.98826456069946,169.00955724716187,231.4123191833496,7449,2086,5363,5363,0,14,2620000.0
2620,2620999,20.798634236184082,37.05048702555297,0.06276942472091751,363.1131842136383,169.07595348358154,231.48332977294922,7449,2086,5363,5363,0,14,2621000.0
2621,2621999,20.797452399187062,37.04871320766919,0.06277176492924597,363.30212330818176,169.14311528205872,231.53858184814453,7451,2087,5364,5364,0,14,2622000.0
2622,2622999,20.7983203349178,37.05408196504178,0.06274685904932231,363.43557572364807,169.2147741317749,231.61828231811523,7451,2087,5364,5364,0,14,2623000.0
2623,2623999,20.798339534926804,37.053720229659,0.06274075714403549,363.5782437324524,169.2812283039093,231.67392349243164,7481,2088,5393,5393,0,14,2624000.0
2624,2624999,20.798566565015857,37.05326393137204,0.06276575802351747,363.7435441017151,169.34770917892456,231.73698806762695,7483,2089,5394,5394,0,14,2625000.0
2625,2625999,20.798317135072352,37.05202589950796,0.06280012097711907,363.8695693016052,169.41443634033203,231.80290603637695,7483,2089,5394,5394,0,14,2626000.0
2626,2626999,20.797537890770567,37.04934449460063,0.0628155381363662,364.01709604263306,169.481303691864,231.87248992919922,7483,2089,5394,5394,0,14,2627000.0
2627,2627999,20.7957920226018,37.0456186322804,0.0628210466042558,364.2074382305145,169.54763412475586,231.6884994506836,7495,2092,5403,5403,0,14,2628000.0
2628,2628999,20.792678020369937,37.04040515633084,0.0628273999402491,364.3271601200104,169.6160008907318,232.59234619140625,7522,2092,5430,5430,0,14,2629000.0
2629,2629999,20.78917947157717,37.03716514626423,0.06283297997030801,364.4638524055481,169.68226432800293,232.95623016357422,7530,2093,5437,5437,0,14,2630000.0
2630,2630999,20.785645843315816,37.03202645116729,0.06284401578856846,364.62387108802795,169.7502851486206,233.15613555908203,7534,2095,5439,5439,0,14,2631000.0
2631,2631999,20.782768177544686,37.02768955681402,0.06284756711739292,364.77321910858154,169.81702733039856,233.3495330810547,7536,2096,5440,5440,0,14,2632000.0
2632,2632999,20.7795853593401,37.022788116257935,0.06285563817531781,365.0639052391052,169.93251633644104,233.4611053466797,7545,2099,5446,5446,0,14,2633000.0
2633,2633999,20.77640257822983,37.01851687570669,0.06287121609004687,365.1880829334259,169.99926352500916,233.68964385986328,7545,2099,5446,5446,0,14,2634000.0
2634,2634999,20.773079747469538,37.01392223506566,0.06287724715814269,365.4223299026489,170.0694580078125,233.6290168762207,7555,2104,5451,5451,0,14,2635000.0
2635,2635999,20.769739964944115,37.0086871319635,0.06288924606708779,365.59036135673523,170.1372630596161,233.79284286499023,7559,2106,5453,5453,0,14,2636000.0
2636,2636999,20.766880464558074,37.00642458610257,0.06288131386705842,365.7171850204468,170.20397448539734,233.94955444335938,7559,2106,5453,5453,0,14,2637000.0
2637,2637999,20.764224345620633,37.00222607434255,0.06288051148529161,365.85580945014954,170.2707314491272,234.07263946533203,7559,2106,5453,5453,0,14,2638000.0
2638,2638999,20.761220999888835,36.99750626985609,0.06288238262888524,366.0132291316986,170.3397181034088,234.1886749267578,7561,2107,5454,5454,0,14,2639000.0
2639,2639999,20.75852122320741,36.99447259564087,0.06287722493531123,366.15209794044495,170.4062464237213,234.25163650512695,7566,2108,5458,5458,0,14,2640000.0
2640,2640999,20.756120937438705,36.990279084469115,0.06287650648901966,366.33264207839966,170.47378373146057,234.27230072021484,7572,2110,5462,5462,0,14,2641000.0
2641,2641999,20.75422165685206,36.9871296503632,0.06286214164488424,366.4723768234253,170.540629863739,234.3199005126953,7574,2111,5463,5463,0,14,2642000.0
2642,2642999,20.75293691652772,36.98489678480717,0.06283960788364373,366.6138050556183,170.6076352596283,234.4657745361328,7574,2111,5463,5463,0,14,2643000.0
2643,2643999,20.751832347907772,36.98225650882672,0.06282592169452494,366.77234506607056,170.67445373535156,234.49639511108398,7576,2112,5464,5464,0,14,2644000.0
2644,2644999,20.75126043494861,36.980488546955115,0.06280233352088627,366.9097650051117,170.74105143547058,234.59932327270508,7576,2112,5464,5464,0,14,2645000.0
2645,2645999,20.75252500301072,36.98161435851475,0.0627770870923614,367.0499920845032,170.8077700138092,234.6741485595703,7578,2113,5465,5465,0,14,2646000.0
2646,2646999,20.7529336747324,36.980573956153606,0.06277431404143019,367.21096897125244,170.87489223480225,234.74884414672852,7578,2113,5465,5465,0,14,2647000.0
2647,2647999,20.75393779856608,36.98150445971326,0.06278354086220272,367.3429138660431,170.94174528121948,234.8408203125,7578,2113,5465,5465,0,14,2648000.0
2648,2648999,20.753410039463443,36.98086858222072,0.06279501617754024,367.4880015850067,171.0083954334259,234.87963485717773,7580,2114,5466,5466,0,14,2649000.0
2649,2649999,20.75183395964237,36.97814312957749,0.06274163650224196,367.61261200904846,171.076251745224,235.799560546875,7609,2114,5495,5495,0,14,2650000.0
2650,2650999,20.750765784403846,36.97537826534068,0.06266385557609278,367.7349760532379,171.14178895950317,236.18984985351562,7610,2114,5496,5496,0,14,2651000.0
2651,2651999,20.74899432505205,36.971559729589856,0.06262302112856044,367.84899711608887,171.20751667022705,236.40753936767578,7610,2114,5496,5496,0,14,2652000.0
2652,2652999,20.747353171707896,36.96833031072467,0.06259119181557715,368.0060713291168,171.2729983329773,236.51046752929688,7614,2116,5498,5498,0,14,2653000.0
2653,2653999,20.745878167274796,36.96553052766026,0.06255801485944434,368.151490688324,171.33820915222168,236.66550064086914,7617,2117,5500,5500,0,14,2654000.0
2654,2654999,20.74461681430483,36.962973547304664,0.06253104595258052,368.29093503952026,171.40700268745422,236.89619064331055,7617,2117,5500,5500,0,14,2655000.0
2655,2655999,20.74316399688008,36.9596400758253,0.06251434478510676,368.4517946243286,171.47371315956116,236.9565773010254,7621,2119,5502,5502,0,14,2656000.0
2656,2656999,20.7418514660725,36.95604540852372,0.06250150843854307,368.66423320770264,171.54002952575684,236.94326400756836,7635,2124,5511,5511,0,14,2657000.0
2657,2657999,20.741018566986035,36.95335139002,0.06250314692665859,368.8076386451721,171.6060652732849,237.07736587524414,7637,2125,5512,5512,0,14,2658000.0
2658,2658999,20.740513284984875,36.95175976057326,0.06250349189741389,368.9407765865326,171.67200899124146,237.17970275878906,7639,2126,5513,5513,0,14,2659000.0
2659,2659999,20.741730060483935,36.953168421169046,0.06253145428328821,369.10601472854614,171.7383794784546,237.2598876953125,7643,2128,5515,5515,0,14,2660000.0
2660,2660999,20.744134343533084,36.95661466839466,0.06252958007780152,369.2686200141907,171.80604672431946,237.32151794433594,7647,2130,5517,5517,0,14,2661000.0
2661,2661999,20.746789827027115,36.96086480501572,0.062548908145174,369.42527747154236,171.87239837646484,237.3489875793457,7653,2132,5521,5521,0,14,2662000.0
2662,2662999,20.751115614149835,36.97265618541489,0.06254567335079653,369.56848216056824,171.9385507106781,237.4265251159668,7655,2133,5522,5522,0,14,2663000.0
2663,2663999,20.755954962693718,36.98720303614523,0.06259121734015816,369.74046421051025,172.01060461997986,237.51539611816406,7659,2135,5524,5524,0,14,2664000.0
2664,2664999,20.76094374651015,36.99895322491845,0.06263203943068452,369.9073317050934,172.0768802165985,237.47683334350586,7665,2137,5528,5528,0,14,2665000.0
2665,2665999,20.765229294798047,37.00428564895751,0.06267002020800205,370.0571217536926,172.14379715919495,237.70478439331055,7669,2138,5531,5531,0,14,2666000.0
2666,2666999,20.771516563805363,37.015451509830314,0.06273323937128172,370.183650970459,172.21009707450867,237.82871627807617,7669,2138,5531,5531,0,14,2667000.0
2667,2667999,20.775225767057773,37.01954446700252,0.06277956245186034,370.31390285491943,172.27652668952942,237.9457778930664,7669,2138,5531,5531,0,14,2668000.0
2668,2668999,20.778338160713954,37.02466580576486,0.06278805030188717,370.4763493537903,172.34301686286926,237.97882461547852,7675,2140,5535,5535,0,14,2669000.0
2669,2669999,20.77727906004856,37.02479677770588,0.06274243475251806,370.59952116012573,172.40839338302612,238.7700958251953,7697,2140,5557,5557,0,14,2670000.0
2670,2670999,20.775681321305367,37.02466029048786,0.0627361102976367,370.71172428131104,172.47321248054504,239.1197624206543,7698,2140,5558,5558,0,14,2671000.0
2671,2671999,20.77331052719128,37.02093022359846,0.06273256813595929,370.85101103782654,172.53823065757751,239.2569580078125,7700,2141,5559,5559,0,14,2672000.0
2672,2672999,20.77081540968112,37.01755852461632,0.06273233334949246,371.0144431591034,172.60382866859436,239.37322616577148,7704,2143,5561,5561,0,14,2673000.0
2673,2673999,20.768672990888522,37.01411888226252,0.062732009201659,371.21251153945923,172.66984581947327,239.43878173828125,7712,2147,5565,5565,0,14,2674000.0
2674,2674999,20.76622200230221,37.009866665428945,0.06273200399664836,371.346848487854,172.73636960983276,239.67116165161133,7714,2148,5566,5566,0,14,2675000.0
2675,2675999,20.763663738912392,37.00526574679534,0.06273006044133644,371.537677526474,172.80340194702148,239.71686935424805,7720,2151,5569,5569,0,14,2676000.0
2676,2676999,20.761859470360676,37.00264849002622,0.06273753100589363,371.6711812019348,172.86879563331604,239.83635330200195,7722,2152,5570,5570,0,14,2677000.0
2677,2677999,20.759926697373235,36.999763177725015,0.06273550608670253,371.8141028881073,172.93472933769226,239.9284324645996,7724,2153,5571,5571,0,14,2678000.0
2678,2678999,20.758543490136876,36.99917873844113,0.06273980379951949,371.96556401252747,173.00084614753723,239.98480987548828,7726,2154,5572,5572,0,14,2679000.0
2679,2679999,20.759340602850713,37.00595936146981,0.06270853496842876,372.1153337955475,173.06707334518433,240.10311126708984,7728,2155,5573,5573,0,14,2680000.0
2680,2680999,20.762113581382664,37.015258609717065,0.06269139187365069,372.27946972846985,173.13372683525085,240.0912208557129,7732,2157,5575,5575,0,14,2681000.0
2681,2681999,20.765081709107925,37.023655925078685,0.06269104788019175,372.4144649505615,173.1999156475067,240.2318000793457,7732,2157,5575,5575,0,14,2682000.0
2682,2682999,20.770600250138024,37.041668420157464,0.06269333629445228,372.5736598968506,173.2665560245514,240.32879257202148,7736,2159,5577,5577,0,14,2683000.0
2683,2683999,20.775230986336602,37.054986835867304,0.06274088138881928,372.73468041419983,173.33266949653625,240.33839416503906,7740,2161,5579,5579,0,14,2684000.0
2684,2684999,20.7810838538483,37.06892033197259,0.0628357922486279,372.8578872680664,173.39900064468384,240.48339462280273,7740,2161,5579,5579,0,14,2685000.0
2685,2685999,20.788178583697793,37.08583390388333,0.0628980282027064,373.00303888320923,173.46543264389038,240.57988739013672,7742,2162,5580,5580,0,14,2686000.0
2686,2686999,20.79586485866937,37.102291556818415,0.06298810183453873,373.15011262893677,173.5320041179657,240.60800552368164,7744,2163,5581,5581,0,14,2687000.0
2687,2687999,20.80245341294293,37.117445038171354,0.06303133075994061,373.32360196113586,173.59963035583496,240.59675979614258,7748,2165,5583,5583,0,14,2688000.0
2688,2688999,20.808054579735934,37.12977470648079,0.06308121901287089,373.49129986763,173.66685104370117,240.70282745361328,7750,2166,5584,5584,0,14,2689000.0
2689,2689999,20.808725448793716,37.129569091014055,0.06309390659074876,373.6117641925812,173.73244762420654,241.36235427856445,7771,2166,5605,5605,0,14,2690000.0
2690,2690999,20.806995309293402,37.13090627452598,0.06305459877953257,373.72063422203064,173.79707860946655,241.7581024169922,7773,2166,5607,5607,0,14,2691000.0
2691,2691999,20.80496643286756,37.12720029409424,0.0630375994790946,373.8493809700012,173.86196517944336,241.9920196533203,7775,2167,5608,5608,0,14,2692000.0
2692,2692999,20.803432561330375,37.124639167666714,0.06300865769554775,373.99021911621094,173.92723321914673,242.11065673828125,7777,2168,5609,5609,0,14,2693000.0
2693,2693999,20.801243719934163,37.12099872014515,0.06299546957387991,374.13245272636414,173.99202728271484,242.22089767456055,7779,2169,5610,5610,0,14,2694000.0
2694,2694999,20.79905324467559,37.117339783718435,0.06297174609636991,374.26364374160767,174.0572018623352,242.3568229675293,7781,2170,5611,5611,0,14,2695000.0
2695,2695999,20.797388463606477,37.11555135066895,0.06295135257194784,374.44874691963196,174.123033285141,242.3617935180664,7787,2173,5614,5614,0,14,2696000.0
2696,2696999,20.795481061820308,37.11194248316228,0.06293025817870723,374.66524863243103,174.18937730789185,242.30642318725586,7795,2177,5618,5618,0,14,2697000.0
2697,2697999,20.793093506627514,37.107521938440485,0.06292177392832576,374.79871344566345,174.25511527061462,242.4932403564453,7826,2178,5648,5648,0,14,2698000.0
2698,2698999,20.791070837075836,37.10348388266332,0.06290419868332064,374.92584896087646,174.3206021785736,242.6222686767578,7826,2178,5648,5648,0,14,2699000.0
2699,2699999,20.789443245032356,37.10137564836169,0.06287983090248306,375.06828713417053,174.38679909706116,242.64970016479492,7828,2179,5649,5649,0,14,2700000.0
2700,2700999,20.787985405494688,37.0983388030233,0.06285374477077454,375.2017147541046,174.4524426460266,242.83205795288086,7828,2179,5649,5649,0,14,2701000.0
2701,2701999,20.786452130057718,37.094975286726104,0.06283494873548079,375.3602149486542,174.51852941513062,242.82041549682617,7830,2180,5650,5650,0,14,2702000.0
2702,2702999,20.785057416027445,37.091739317754445,0.06281776736737144,375.4884650707245,174.58435988426208,242.93313217163086,7830,2180,5650,5650,0,14,2703000.0
2703,2703999,20.784369359330917,37.093886256369565,0.06278723142764364,375.6596565246582,174.65081477165222,242.96967315673828,7834,2182,5652,5652,0,14,2704000.0
2704,2704999,20.783516144981267,37.09154958868736,0.06276466779246026,375.78657817840576,174.71668410301208,243.0810089111328,7834,2182,5652,5652,0,14,2705000.0
2705,2705999,20.782381529881697,37.08829308004515,0.06274829496300915,375.93300199508667,174.7828550338745,243.14158630371094,7836,2183,5653,5653,0,14,2706000.0
2706,2706999,20.782020708911986,37.0857915970453,0.06272715184159283,376.06464409828186,174.85426568984985,243.23722076416016,7836,2183,5653,5653,0,14,2707000.0
2707,2707999,20.78152469779552,37.08418134038249,0.06270829753802387,376.24091267585754,174.9202859401703,243.1918067932129,7843,2185,5658,5658,0,14,2708000.0
2708,2708999,20.780592835290626,37.08105140857687,0.06269349733640928,376.39665818214417,174.9867742061615,243.22898864746094,7845,2186,5659,5659,0,14,2709000.0
2709,2709999,20.77919533015384,37.07767414440732,0.06267266975541042,376.5348515510559,175.0537884235382,243.34473037719727,7845,2186,5659,5659,0,14,2710000.0
2710,2710999,20.77720371789714,37.07332058283078,0.06266341237254514,376.65568470954895,175.11909675598145,243.82664489746094,7860,2186,5674,5674,0,14,2711000.0
2711,2711999,20.774781244258946,37.06916908529278,0.06265601464015802,376.7684226036072,175.18389749526978,244.1351547241211,7861,2186,5675,5675,0,14,2712000.0
2712,2712999,20.771968184911405,37.06411030846597,0.06265424598415337,376.90382075309753,175.24976539611816,244.35528564453125,7864,2187,5677,5677,0,14,2713000.0
2713,2713999,20.76960782909438,37.05973104287999,0.06265370968682205,377.03409934043884,175.31449723243713,244.51202774047852,7864,2187,5677,5677,0,14,2714000.0
2714,2714999,20.76739455321145,37.05577592097439,0.06265723839966808,377.207186460495,175.3798270225525,244.5497817993164,7870,2190,5680,5680,0,14,2715000.0
2715,2715999,20.765007560162893,37.05135391717195,0.06264944629797609,377.3706042766571,175.44513249397278,244.66231536865234,7874,2192,5682,5682,0,14,2716000.0
2716,2716999,20.76306094238558,37.048983587572245,0.06264618466917116,377.4905686378479,175.51029253005981,244.8245620727539,7874,2192,5682,5682,0,14,2717000.0
2717,2717999,20.76158978233588,37.045666611280815,0.06263069016487233,377.6165289878845,175.57553720474243,244.94634628295898,7875,2192,5683,5683,0,14,2718000.0
2718,2718999,20.76022811972193,37.04269646378175,0.06262055953048995,377.7722554206848,175.64149451255798,245.01959609985352,7877,2193,5684,5684,0,14,2719000.0
2719,2719999,20.75862934082797,37.03935469559837,0.06261018470262958,377.91061425209045,175.70698046684265,245.03890991210938,7879,2194,5685,5685,0,14,2720000.0
2720,2720999,20.75713619229374,37.03575248412596,0.06261051780871374,378.1008276939392,175.77296137809753,245.01573944091797,7890,2197,5693,5693,0,14,2721000.0
2721,2721999,20.75667901678762,37.0334359654294,0.06261183817640903,378.2401809692383,175.8385455608368,245.14380645751953,7890,2197,5693,5693,0,14,2722000.0
2722,2722999,20.756434011746073,37.03254903050237,0.06261105041498805,378.3868191242218,175.90785002708435,245.16203689575195,7892,2198,5694,5694,0,14,2723000.0
2723,2723999,20.756560686356384,37.03140043141399,0.0626038949206098,378.566707611084,175.98208451271057,245.14158248901367,7896,2200,5696,5696,0,14,2724000.0
2724,2724999,20.756771979490082,37.030396752108274,0.06261153682061704,378.69399762153625,176.04786896705627,245.25506210327148,7896,2200,5696,5696,0,14,2725000.0
2725,2725999,20.757200276320024,37.02942605714882,0.06262432875674939,378.84035301208496,176.11342310905457,245.28002548217773,7898,2201,5697,5697,0,14,2726000.0
2726,2726999,20.757670302876978,37.028917142432356,0.06264010321220259,379.0084340572357,176.1900703907013,245.35768508911133,7898,2201,5697,5697,0,14,2727000.0
2727,2727999,20.758364238683747,37.02879577634584,0.06264424011920033,379.1416997909546,176.25569987297058,245.42913436889648,7898,2201,5697,5697,0,14,2728000.0
2728,2728999,20.759390404408656,37.02919895866025,0.06267993358190116,379.292964220047,176.32134795188904,245.4503517150879,7900,2202,5698,5698,0,14,2729000.0
2729,2729999,20.760475568179213,37.029043701890146,0.06268757199881714,379.41955947875977,176.38698554039001,245.4977264404297,7900,2202,5698,5698,0,14,2730000.0
2730,2730999,20.76054092730378,37.02782752461456,0.06269752066092105,379.556679725647,176.45340299606323,245.56323623657227,7900,2202,5698,5698,0,14,2731000.0
2731,2731999,20.759542301007986,37.02590348500384,0.06267019935220364,379.69640135765076,176.5187427997589,246.00396728515625,7916,2203,5713,5713,0,14,2732000.0
2732,2732999,20.757256324673673,37.022429627855914,0.0626732556341193,379.82530665397644,176.58480143547058,246.44697952270508,7922,2203,5719,5719,0,14,2733000.0
2733,2733999,20.755289006437234,37.02083948398863,0.06267833800335254,379.9429349899292,176.64958667755127,246.7021026611328,7922,2203,5719,5719,0,14,2734000.0
2734,2734999,20.752487004297738,37.01606452412899,0.06270045906693789,380.150728225708,176.71537971496582,246.6865463256836,7932,2207,5725,5725,0,14,2735000.0
2735,2735999,20.75039568179718,37.01216005197725,0.06270582359772947,380.3172137737274,176.78182339668274,246.83550643920898,7938,2209,5729,5729,0,14,2736000.0
2736,2736999,20.748233283326186,37.008662776136404,0.06272310608965759,380.4564800262451,176.84768533706665,246.94545364379883,7940,2210,5730,5730,0,14,2737000.0
2737,2737999,20.746374649408292,37.00549007368723,0.06272784553838517,380.6236913204193,176.9135890007019,246.97764205932617,7944,2212,5732,5732,0,14,2738000.0
2738,2738999,20.744173136766012,37.00201450740725,0.06273407692305066,380.74817085266113,176.97904419898987,247.1406707763672,7944,2212,5732,5732,0,14,2739000.0
2739,2739999,20.742470451882724,36.99893305547206,0.06273528215670476,380.8934555053711,177.04440236091614,247.20606994628906,7946,2213,5733,5733,0,14,2740000.0
2740,2740999,20.740425562115743,36.99510571938135,0.06275070016477113,381.06790924072266,177.1103060245514,247.18439483642578,7955,2216,5739,5739,0,14,2741000.0
2741,2741999,20.73886997661734,36.99179040290795,0.06275313282334816,381.20378589630127,177.17595314979553,247.33299255371094,7956,2216,5740,5740,0,14,2742000.0
2742,2742999,20.7369951091986,36.9889864441973,0.06276648246559868,381.3305904865265,177.24198055267334,247.40015411376953,7956,2216,5740,5740,0,14,2743000.0
2743,2743999,20.735699628912762,36.98714116821803,0.06276823263914888,381.49644470214844,177.3076946735382,247.4030876159668,7958,2217,5741,5741,0,14,2744000.0
2744,2744999,20.73418194517925,36.9838024254392,0.0627769083874713,381.6274974346161,177.3736321926117,247.50889587402344,7958,2217,5741,5741,0,14,2745000.0
2745,2745999,20.7337204878706,36.982372452567986,0.06276194484888875,381.7802629470825,177.43950843811035,247.50029754638672,7960,2218,5742,5742,0,14,2746000.0
2746,2746999,20.732152825808004,36.97875508781342,0.0627749182371733,381.9020619392395,177.5055296421051,247.61760330200195,7960,2218,5742,5742,0,14,2747000.0
2747,2747999,20.730638937016188,36.975184717980106,0.06278004739423793,382.037038564682,177.57114720344543,247.6881980895996,7960,2218,5742,5742,0,14,2748000.0
2748,2748999,20.72907743389066,36.97166547263971,0.06278286196091498,382.2252035140991,177.63745546340942,247.7537727355957,7966,2220,5746,5746,0,14,2749000.0
2749,2749999,20.726556202954146,36.967852824890215,0.0627928667106149,382.34351563453674,177.7028419971466,248.30722045898438,7982,2220,5762,5762,0,14,2750000.0
2750,2750999,20.72324314004429,36.96314173114239,0.06282591545851324,382.484228849411,177.76740622520447,248.6332244873047,7987,2221,5766,5766,0,14,2751000.0
2751,2751999,20.71978812993153,36.957781831983596,0.06286456912986038,382.5966646671295,177.831857919693,248.81946182250977,7987,2221,5766,5766,0,14,2752000.0
2752,2752999,20.716627517247705,36.95335597123313,0.06288899214873511,382.7780635356903,177.89720678329468,248.8584442138672,7993,2224,5769,5769,0,14,2753000.0
2753,2753999,20.713930137206816,36.94928947953714,0.06290864150264008,382.9624629020691,177.9631004333496,248.9674530029297,8002,2227,5775,5775,0,14,2754000.0
2754,2754999,20.711019271233795,36.94497246519278,0.06292548853800817,383.1113793849945,178.02888441085815,249.0980453491211,8004,2228,5776,5776,0,14,2755000.0
2755,2755999,20.708472520069684,36.941447172970584,0.06292342957955,383.2653338909149,178.09446358680725,249.18912506103516,8006,2229,5777,5777,0,14,2756000.0
2756,2756999,20.705915706134498,36.93767244807996,0.06292921097471049,383.40818071365356,178.1603970527649,249.26656341552734,8008,2230,5778,5778,0,14,2757000.0
2757,2757999,20.703565402992353,36.93397866717185,0.06293054343586413,383.54241275787354,178.22576022148132,249.35717010498047,8008,2230,5778,5778,0,14,2758000.0
2758,2758999,20.70103529027404,36.93009287370672,0.06293589867296046,383.6856927871704,178.2913191318512,249.40633010864258,8010,2231,5779,5779,0,14,2759000.0
2759,2759999,20.699744417045686,36.93459412512323,0.06290498918563714,383.82391023635864,178.35688543319702,249.48321533203125,8010,2231,5779,5779,0,14,2760000.0
2760,2760999,20.69763619905681,36.93123563529313,0.06290973907928976,383.95343828201294,178.42239356040955,249.54891204833984,8010,2231,5779,5779,0,14,2761000.0
2761,2761999,20.696169661405094,36.92861816333022,0.06289651689876985,384.08018040657043,178.48839616775513,249.59756088256836,8010,2231,5779,5779,0,14,2762000.0
2762,2762999,20.694796869526073,36.92599425782741,0.06289345846191108,384.24186873435974,178.5541958808899,249.59432983398438,8012,2232,5780,5780,0,14,2763000.0
2763,2763999,20.69492411401306,36.925715585065774,0.06288536358139318,384.4202575683594,178.61983966827393,249.53112030029297,8016,2234,5782,5782,0,14,2764000.0
2764,2764999,20.69415379399245,36.9240435524768,0.06287827694489434,384.54069328308105,178.68536472320557,249.60855102539062,8016,2234,5782,5782,0,14,2765000.0
2765,2765999,20.69394684748407,36.92307034602445,0.0628637472077046,384.6714446544647,178.75115442276,249.69536209106445,8016,2234,5782,5782,0,14,2766000.0
2766,2766999,20.693546403148755,36.92176133517082,0.06285291828261763,384.8206670284271,178.81710720062256,249.71074295043945,8018,2235,5783,5783,0,14,2767000.0
2767,2767999,20.693116153806155,36.91964024225889,0.06283386629633236,384.95218873023987,178.8826777935028,249.74560165405273,8018,2235,5783,5783,0,14,2768000.0
2768,2768999,20.692056924664573,36.91681978702173,0.0628257340537135,385.1067063808441,178.9493124485016,249.77519607543945,8020,2236,5784,5784,0,14,2769000.0
2769,2769999,20.690307331859877,36.913972120544834,0.06280015698547214,385.2424714565277,179.01620173454285,250.3039207458496,8034,2236,5798,5798,0,14,2770000.0
2770,2770999,20.687938321188945,36.90961366455988,0.06278526368227166,385.35263442993164,179.0811324119568,250.6223602294922,8036,2236,5800,5800,0,14,2771000.0
2771,2771999,20.685560775090003,36.90571519317428,0.0627743629495836,385.4888274669647,179.14654326438904,250.8548240661621,8039,2237,5802,5802,0,14,2772000.0
2772,2772999,20.6832540045448,36.90221336776958,0.06276576889662655,385.6334671974182,179.21207451820374,250.94618606567383,8041,2238,5803,5803,0,14,2773000.0
2773,2773999,20.681315483645395,36.8990509466133,0.0627543870895032,385.79731798171997,179.27840971946716,250.96282196044922,8045,2240,5805,5805,0,14,2774000.0
2774,2774999,20.678584871588097,36.894875128512446,0.06275516105159984,385.9490203857422,179.3444046974182,251.2052001953125,8048,2241,5807,5807,0,14,2775000.0
2775,2775999,20.676166103600664,36.89044541998093,0.06274630905080292,386.0668902397156,179.41059851646423,251.35015869140625,8048,2241,5807,5807,0,14,2776000.0
2776,2776999,20.67330773984163,36.88561996191783,0.06274824452350158,386.21542143821716,179.47635531425476,251.4626808166504,8051,2242,5809,5809,0,14,2777000.0
2777,2777999,20.670927213960226,36.88144870234428,0.06274225767512087,386.3511085510254,179.54252552986145,251.52346420288086,8053,2243,5810,5810,0,14,2778000.0
2778,2778999,20.66851189879511,36.876947513105364,0.06274272905775602,386.55020666122437,179.60970211029053,251.491943359375,8061,2246,5815,5815,0,14,2779000.0
2779,2779999,20.666123865484877,36.87256041065439,0.06273231865402373,386.69078850746155,179.67649149894714,251.63294219970703,8061,2246,5815,5815,0,14,2780000.0
2780,2780999,20.66448314787826,36.869872003966556,0.06270821067972443,386.81607818603516,179.74215054512024,251.75814819335938,8061,2246,5815,5815,0,14,2781000.0
2781,2781999,20.66246377358391,36.8660570325618,0.062699367199615,387.0025656223297,179.8084580898285,251.66072845458984,8067,2249,5818,5818,0,14,2782000.0
2782,2782999,20.66076260614627,36.86289836856712,0.06268770195165896,387.1242775917053,179.87504649162292,251.78414916992188,8067,2249,5818,5818,0,14,2783000.0
2783,2783999,20.659035139704827,36.85932823917023,0.06267431570893489,387.28503227233887,179.94155716896057,251.7984275817871,8069,2250,5819,5819,0,14,2784000.0
2784,2784999,20.657373795172404,36.85587618184262,0.06266064447843056,387.41800808906555,180.0075912475586,251.90163803100586,8069,2250,5819,5819,0,14,2785000.0
2785,2785999,20.656024617282565,36.85306025091947,0.06265137230753104,387.58052682876587,180.074303150177,251.8686065673828,8073,2252,5821,5821,0,14,2786000.0
2786,2786999,20.654403691570874,36.849400756049036,0.06264891155975838,387.7612986564636,180.14107394218445,251.8946990966797,8077,2254,5823,5823,0,14,2787000.0
2787,2787999,20.652950014510722,36.84798243859401,0.06263315804223357,387.8863515853882,180.20730066299438,252.0297966003418,8077,2254,5823,5823,0,14,2788000.0
2788,2788999,20.651129687995173,36.844528616956694,0.06262874479007463,388.03235840797424,180.27461123466492,252.1128692626953,8077,2254,5823,5823,0,14,2789000.0
2789,2789999,20.64882869190434,36.84035283830548,0.06262860103671064,388.17818880081177,180.34157252311707,252.2218017578125,8077,2254,5823,5823,0,14,2790000.0
2790,2790999,20.648971260913143,36.84429722412812,0.06260116613112932,388.3090355396271,180.4068374633789,252.72200775146484,8092,2254,5838,5838,0,14,2791000.0
2791,2791999,20.650105939274674,36.84599136481834,0.06255058670949021,388.431143283844,180.4717571735382,253.0415916442871,8094,2254,5840,5840,0,14,2792000.0
2792,2792999,20.649427482676824,36.84529763598082,0.06252363808061079,388.56901383399963,180.53658962249756,253.22567749023438,8094,2254,5840,5840,0,14,2793000.0
2793,2793999,20.64876174938009,36.84505538354383,0.0625162343592528,388.71955251693726,180.60187768936157,253.29752349853516,8098,2256,5842,5842,0,14,2794000.0
2794,2794999,20.6482994807473,36.844406927664224,0.06248788700465191,388.9113347530365,180.66811347007751,253.35083389282227,8104,2259,5845,5845,0,14,2795000.0
2795,2795999,20.648815502667695,36.847148142233465,0.062446403059850164,389.0633428096771,180.733389377594,253.46159744262695,8108,2261,5847,5847,0,14,2796000.0
2796,2796999,20.647684900844105,36.84548291711889,0.06242624530125496,389.1987907886505,180.79932165145874,253.58681869506836,8108,2261,5847,5847,0,14,2797000.0
2797,2797999,20.647256755483692,36.84517037011688,0.0624419744696485,389.34419107437134,180.86506128311157,253.69838333129883,8108,2261,5847,5847,0,14,2798000.0
2798,2798999,20.64740147935489,36.84524404583361,0.06243351921524054,389.4825129508972,180.93073964118958,253.72642517089844,8110,2262,5848,5848,0,14,2799000.0
2799,2799999,20.64756994231576,36.85085544049953,0.062387779031748414,389.655978679657,180.99730730056763,253.74277877807617,8114,2264,5850,5850,0,14,2800000.0
2800,2800999,20.647090455715926,36.84941468129548,0.06240842999998075,389.7853274345398,181.06300497055054,253.8500633239746,8114,2264,5850,5850,0,14,2801000.0
2801,2801999,20.646765302138245,36.84814069039578,0.06239644128717403,389.934739112854,181.12928986549377,253.86237335205078,8116,2265,5851,5851,0,14,2802000.0
2802,2802999,20.64666354609344,36.84783103361123,0.062392698387935375,390.0797724723816,181.19482159614563,253.8598289489746,8118,2266,5852,5852,0,14,2803000.0
2803,2803999,20.646330791864138,36.84719867043195,0.06237614006374825,390.2463595867157,181.26110363006592,253.83810424804688,8122,2267,5855,5855,0,14,2804000.0
2804,2804999,20.64570460813079,36.84559736965816,0.062358006042378955,390.40231251716614,181.32749891281128,253.87728118896484,8126,2268,5858,5858,0,14,2805000.0
2805,2805999,20.645633935221174,36.84408128939218,0.062344578739077616,390.54191040992737,181.39347672462463,253.875244140625,8129,2269,5860,5860,0,14,2806000.0
2806,2806999,20.645716361253395,36.842847603732075,0.062340556466533914,390.6744935512543,181.45967388153076,253.97773361206055,8129,2269,5860,5860,0,14,2807000.0
2807,2807999,20.64648388870827,36.849261514034716,0.062317473455567596,390.83103823661804,181.52561473846436,254.0033416748047,8131,2270,5861,5861,0,14,2808000.0
2808,2808999,20.646267588410563,36.847445719520024,0.06231547634814982,390.9649975299835,181.59181880950928,254.0714874267578,8131,2270,5861,5861,0,14,2809000.0
2809,2809999,20.64580707095082,36.84527454297592,0.06230810106410556,391.10648584365845,181.6575300693512,254.15844345092773,8131,2270,5861,5861,0,14,2810000.0
2810,2810999,20.64426765970324,36.84135218097197,0.06230219509073287,391.23453283309937,181.72326064109802,254.42065048217773,8142,2270,5872,5872,0,14,2811000.0
2811,2811999,20.6407585362227,36.836739876486405,0.06232662908994113,391.3538701534271,181.788831949234,255.18052673339844,8156,2270,5886,5886,0,14,2812000.0
2812,2812999,20.637321619618216,36.8322737625612,0.0623495496700488,391.46457743644714,181.85352087020874,255.4969825744629,8157,2270,5887,5887,0,14,2813000.0
2813,2813999,20.634097432442463,36.827969124658665,0.06237348860417613,391.6020529270172,181.9186511039734,255.6053466796875,8159,2271,5888,5888,0,14,2814000.0
2814,2814999,20.630913005831346,36.82321753626124,0.06239359460384075,391.7803888320923,181.98589730262756,255.63942337036133,8165,2274,5891,5891,0,14,2815000.0
2815,2815999,20.627923307059604,36.81861078192909,0.06240988235539102,391.93838810920715,182.0513038635254,255.80168914794922,8169,2276,5893,5893,0,14,2816000.0
2816,2816999,20.625312502270287,36.81523603124723,0.062418880142669386,392.08794116973877,182.11754655838013,255.95891571044922,8171,2277,5894,5894,0,14,2817000.0
2817,2817999,20.622702450541663,36.811515473424954,0.06242414746407321,392.2626459598541,182.18450355529785,255.9892234802246,8177,2280,5897,5897,0,14,2818000.0
2818,2818999,20.6199849330623,36.80733857400011,0.06243160288531857,392.46311044692993,182.2507085800171,256.0089225769043,8188,2284,5904,5904,0,14,2819000.0
2819,2819999,20.617289823886875,36.80271452604241,0.06243468068131419,392.63753485679626,182.31777119636536,256.152156829834,8192,2286,5906,5906,0,14,2820000.0
2820,2820999,20.614785484054284,36.798412075675735,0.062433823962838586,392.77745842933655,182.3837375640869,256.24442291259766,8194,2287,5907,5907,0,14,2821000.0
2821,2821999,20.612821690486676,36.79527313491587,0.06242551572567767,392.93159532546997,182.44999933242798,256.342960357666,8199,2288,5911,5911,0,14,2822000.0
2822,2822999,20.612269782635405,36.80213640685086,0.062380003448619936,393.07651829719543,182.51629257202148,256.4156913757324,8201,2289,5912,5912,0,14,2823000.0
2823,2823999,20.61211457883006,36.80246520519869,0.06234828205341836,393.20249247550964,182.58240413665771,256.53164291381836,8201,2289,5912,5912,0,14,2824000.0
2824,2824999,20.612088994929184,36.802695849378765,0.06232181672201775,393.35120129585266,182.64838290214539,256.53433990478516,8203,2290,5913,5913,0,14,2825000.0
2825,2825999,20.612890317066277,36.805029210815405,0.062286665936052144,393.4860734939575,182.7149956226349,256.688232421875,8203,2290,5913,5913,0,14,2826000.0
2826,2826999,20.613411300355892,36.80550434095142,0.06227461945112722,393.63716435432434,182.7810628414154,256.73737716674805,8207,2291,5916,5916,0,14,2827000.0
2827,2827999,20.6132269496256,36.80392341765135,0.06227258610320008,393.76783323287964,182.84777688980103,256.84284591674805,8207,2291,5916,5916,0,14,2828000.0
2828,2828999,20.6145965346952,36.80529127128777,0.062282232211682165,393.93156123161316,182.91555452346802,256.88926696777344,8209,2292,5917,5917,0,14,2829000.0
2829,2829999,20.615268832946143,36.80500019776418,0.0622870769472762,394.0858986377716,182.9827492237091,256.9121437072754,8213,2293,5920,5920,0,14,2830000.0
2830,2830999,20.61495954625804,36.803090217033365,0.0622889662850552,394.23851585388184,183.0494351387024,256.96502685546875,8215,2294,5921,5921,0,14,2831000.0
2831,2831999,20.613827730108433,36.80016767219955,0.062288985824152765,394.4354431629181,183.11648678779602,257.22564697265625,8237,2297,5940,5940,0,14,2832000.0
2832,2832999,20.611208593719226,36.797078100377,0.06229464828492637,394.59398555755615,183.18197464942932,257.59595489501953,8250,2299,5951,5951,0,14,2833000.0
2833,2833999,20.60859540896821,36.79404024235058,0.06229710471504524,394.71461153030396,183.24698328971863,257.89347076416016,8250,2299,5951,5951,0,14,2834000.0
2834,2834999,20.605675617924998,36.78916052316406,0.0623086405724117,394.84632396698,183.31176900863647,258.0128974914551,8252,2300,5952,5952,0,14,2835000.0
2835,2835999,20.6036189956093,36.785461567639956,0.06231239868925531,395.00864839553833,183.37824177742004,258.1536750793457,8256,2302,5954,5954,0,14,2836000.0
2836,2836999,20.601783227156087,36.78317888330762,0.06231156550750416,395.2166380882263,183.44412636756897,258.20301818847656,8267,2306,5961,5961,0,14,2837000.0
2837,2837999,20.60045551690681,36.7817458312608,0.06230993605244184,395.35282158851624,183.50999069213867,258.3097953796387,8269,2307,5962,5962,0,14,2838000.0
2838,2838999,20.599744066133077,36.781256638769676,0.06230995696461783,395.4870204925537,183.57633781433105,258.4870071411133,8269,2307,5962,5962,0,14,2839000.0
2839,2839999,20.599669361733085,36.783105561304424,0.062303319382548406,395.66897439956665,183.64336729049683,258.50575256347656,8277,2310,5967,5967,0,14,2840000.0
2840,2840999,20.60051677910112,36.78554423150519,0.062289762215792965,395.8317987918854,183.70968294143677,258.5913505554199,8281,2312,5969,5969,0,14,2841000.0
2841,2841999,20.601460925893765,36.78842824432822,0.062309554290803426,395.96955847740173,183.77549529075623,258.71416091918945,8281,2312,5969,5969,0,14,2842000.0
2842,2842999,20.60338800830517,36.79418745740617,0.06235777824084132,396.0996894836426,183.8406057357788,258.8372573852539,8281,2312,5969,5969,0,14,2843000.0
2843,2843999,20.60710528132177,36.80739577563331,0.06249195308335376,396.26321506500244,183.90672063827515,258.8165397644043,8285,2314,5971,5971,0,14,2844000.0
2844,2844999,20.610052919035255,36.81451985644683,0.06257004737062499,396.39770126342773,183.97266054153442,258.9034538269043,8285,2314,5971,5971,0,14,2845000.0
2845,2845999,20.614210432716643,36.82657659118501,0.06269035312526805,396.53469467163086,184.03966307640076,259.01433181762695,8285,2314,5971,5971,0,14,2846000.0
2846,2846999,20.619088957638578,36.838431019011004,0.06272199344980933,396.66220355033875,184.1055839061737,259.0903968811035,8285,2314,5971,5971,0,14,2847000.0
2847,2847999,20.62392266542324,36.85085074512728,0.06285530915078708,396.8165135383606,184.17126083374023,259.06880950927734,8287,2315,5972,5972,0,14,2848000.0
2848,2848999,20.628831181026598,36.862045346775794,0.06297539830509047,396.98442029953003,184.2372224330902,259.1218605041504,8291,2317,5974,5974,0,14,2849000.0
2849,2849999,20.632792675377516,36.869750672949486,0.06303364956604551,397.13516068458557,184.30333304405212,259.1554718017578,8293,2318,5975,5975,0,14,2850000.0
2850,2850999,20.63721920429388,36.87902056435434,0.06315301418801267,397.3204278945923,184.3729865550995,259.1952476501465,8297,2320,5977,5977,0,14,2851000.0
2851,2851999,20.63999064203334,36.883495777255554,0.0631748511972755,397.4534013271332,184.439715385437,259.30827713012695,8297,2320,5977,5977,0,14,2852000.0
2852,2852999,20.638990061367995,36.88127970507363,0.06315682721728,397.5721507072449,184.50599551200867,260.2480125427246,8327,2320,6007,6007,0,14,2853000.0
2853,2853999,20.636845946680836,36.87830910479935,0.06315050385315546,397.6823151111603,184.5714819431305,260.68302154541016,8328,2320,6008,6008,0,14,2854000.0
2854,2854999,20.634154998418012,36.873832313276196,0.06315892651490662,397.8127861022949,184.63741397857666,260.9623260498047,8331,2321,6010,6010,0,14,2855000.0
2855,2855999,20.63318263230901,36.87676886088052,0.06313886738700836,397.9737741947174,184.70415782928467,261.11060333251953,8335,2323,6012,6012,0,14,2856000.0
2856,2856999,20.63135856529161,36.87341802955822,0.06313265788723399,398.1484708786011,184.77017045021057,261.18820571899414,8341,2326,6015,6015,0,14,2857000.0
2857,2857999,20.62995151959736,36.870657023186254,0.06312079106579116,398.26977491378784,184.83577370643616,261.4781723022461,8341,2326,6015,6015,0,14,2858000.0
2858,2858999,20.627941593734544,36.86675307898898,0.06311667570862545,398.41136360168457,184.90212106704712,261.61389541625977,8343,2327,6016,6016,0,14,2859000.0
2859,2859999,20.626481988196996,36.86466589683121,0.06310964680326658,398.58138942718506,184.96890258789062,261.69374084472656,8347,2329,6018,6018,0,14,2860000.0
2860,2860999,20.62571046799062,36.86369222654671,0.06308836528673933,398.7362506389618,185.03463697433472,261.76820373535156,8351,2331,6020,6020,0,14,2861000.0
2861,2861999,20.62481389123891,36.86141731158706,0.06307951710636528,398.8721408843994,185.10145235061646,261.89656829833984,8351,2331,6020,6020,0,14,2862000.0
2862,2862999,20.623655148295054,36.85923062792514,0.06307074312755989,399.0583074092865,185.1683211326599,261.84922790527344,8357,2334,6023,6023,0,14,2863000.0
2863,2863999,20.623241065919505,36.85874462456332,0.06305092456720318,399.2181234359741,185.23469352722168,261.9835090637207,8361,2336,6025,6025,0,14,2864000.0
2864,2864999,20.622793765093437,36.85688477047205,0.06304452617579703,399.36526918411255,185.30084657669067,262.04813385009766,8363,2337,6026,6026,0,14,2865000.0
2865,2865999,20.62251070026294,36.85623099295583,0.06303510232744525,399.5016739368439,185.3670289516449,262.1319770812988,8365,2338,6027,6027,0,14,2866000.0
2866,2866999,20.622587195098905,36.85528715290163,0.06302847670834422,399.65935468673706,185.4336919784546,262.2085952758789,8367,2339,6028,6028,0,14,2867000.0
2867,2867999,20.622689956406724,36.85556251982297,0.06301545517584206,399.82041573524475,185.50009894371033,262.2188301086426,8369,2340,6029,6029,0,14,2868000.0
2868,2868999,20.622766286849505,36.85447201477374,0.06301341414719153,399.9405884742737,185.56674361228943,262.34424591064453,8369,2340,6029,6029,0,14,2869000.0
2869,2869999,20.62313568073757,36.85387042440729,0.06300747155736752,400.0931851863861,185.63376092910767,262.4566345214844,8374,2341,6033,6033,0,14,2870000.0
2870,2870999,20.622851585396983,36.851875723930185,0.0630172884084561,400.24725341796875,185.70016407966614,262.4988136291504,8376,2342,6034,6034,0,14,2871000.0
2871,2871999,20.622589981566723,36.849906123103366,0.06302286771885013,400.372177362442,185.76649165153503,262.59354400634766,8376,2342,6034,6034,0,14,2872000.0
2872,2872999,20.62161400232519,36.84687777165572,0.06302582680179436,400.4979660511017,185.83311653137207,262.7025566101074,8376,2342,6034,6034,0,14,2873000.0
2873,2873999,20.619459126450995,36.84268221738596,0.0630254209749681,400.62861251831055,185.90031218528748,263.3761863708496,8396,2342,6054,6054,0,14,2874000.0
2874,2874999,20.61669618327708,36.83845565935186,0.06303720668101542,400.74823546409607,185.966162443161,263.87267684936523,8401,2342,6059,6059,0,14,2875000.0
2875,2875999,20.614276334942673,36.836116259591016,0.06304020703848379,400.8768484592438,186.0316286087036,264.0613899230957,8403,2343,6060,6060,0,14,2876000.0
2876,2876999,20.611763743422948,36.832404548824165,0.06305157928256067,401.0598816871643,186.09712624549866,264.0781707763672,8409,2346,6063,6063,0,14,2877000.0
2877,2877999,20.609292447196687,36.8280167668729,0.06306083511903082,401.22574281692505,186.16359114646912,264.2815589904785,8416,2348,6068,6068,0,14,2878000.0
2878,2878999,20.607055237152903,36.82455231589945,0.06306549139552686,401.35935044288635,186.22885489463806,264.4292640686035,8418,2349,6069,6069,0,14,2879000.0
2879,2879999,20.604755629446363,36.820604918947225,0.06307063423910353,401.543993473053,186.2947916984558,264.4199676513672,8424,2352,6072,6072,0,14,2880000.0
2880,2880999,20.603063197796136,36.81754864753636,0.06306357313596056,401.67700600624084,186.36063289642334,264.615478515625,8424,2352,6072,6072,0,14,2881000.0
2881,2881999,20.601474587919178,36.81473825836119,0.06305423937780807,401.85619854927063,186.4269416332245,264.6330337524414,8430,2355,6075,6075,0,14,2882000.0
2882,2882999,20.60078741231488,36.81332840621487,0.0630345677713674,402.0242688655853,186.49328541755676,264.70630264282227,8434,2357,6077,6077,0,14,2883000.0
2883,2883999,20.60071599396317,36.81205383255296,0.06300986991771973,402.16924357414246,186.5593204498291,264.83391189575195,8436,2358,6078,6078,0,14,2884000.0
2884,2884999,20.601092958418356,36.81247839189031,0.06298812456759684,402.3387689590454,186.62668919563293,264.9106330871582,8443,2360,6083,6083,0,14,2885000.0
2885,2885999,20.601544825094546,36.811808971579474,0.06297847975957072,402.4626727104187,186.69266057014465,265.03025817871094,8443,2360,6083,6083,0,14,2886000.0
2886,2886999,20.60275321515352,36.81262654508405,0.06296323496032896,402.6119146347046,186.75864672660828,265.1106719970703,8469,2361,6108,6108,0,14,2887000.0
2887,2887999,20.603847161094635,36.8126617560153,0.06297632164759104,402.7617108821869,186.82590222358704,265.16329193115234,8471,2362,6109,6109,0,14,2888000.0
2888,2888999,20.604744509918522,36.812058001666415,0.06297629613172617,402.9064271450043,186.89299821853638,265.2814178466797,8471,2362,6109,6109,0,14,2889000.0
2889,2889999,20.605029284066717,36.81078142710074,0.06296380570034532,403.0221264362335,186.95854306221008,265.3549385070801,8471,2362,6109,6109,0,14,2890000.0
2890,2890999,20.604747038470123,36.808244891394324,0.06295720496889834,403.19202280044556,187.0243570804596,265.3604965209961,8475,2364,6111,6111,0,14,2891000.0
2891,2891999,20.603204656906854,36.80934899415614,0.06295206609998016,403.30605721473694,187.09048795700073,266.182430267334,8496,2364,6132,6132,0,14,2892000.0
2892,2892999,20.600878790949885,36.80643801799761,0.06296739920823236,403.44241070747375,187.15542006492615,266.44223403930664,8500,2365,6135,6135,0,14,2893000.0
2893,2893999,20.598584461996985,36.80208144463717,0.06299398220462338,403.5622618198395,187.2202854156494,266.6585350036621,8500,2365,6135,6135,0,14,2894000.0
2894,2894999,20.597146230135696,36.80023313104761,0.0630131303534589,403.7216444015503,187.28558707237244,266.7964744567871,8504,2367,6137,6137,0,14,2895000.0
2895,2895999,20.595073646771027,36.79704332599763,0.06302963978363585,403.9333109855652,187.35231113433838,266.89527893066406,8512,2371,6141,6141,0,14,2896000.0
2896,2896999,20.592969632999157,36.79362288301038,0.06304736520036502,404.0923867225647,187.4193196296692,267.031494140625,8516,2373,6143,6143,0,14,2897000.0
2897,2897999,20.590821824047925,36.789641839799714,0.0630628606442788,404.2697494029999,187.4850423336029,267.07949447631836,8522,2376,6146,6146,0,14,2898000.0
2898,2898999,20.588814958513655,36.78609199319232,0.06307978932300007,404.39640522003174,187.55077505111694,267.2439422607422,8522,2376,6146,6146,0,14,2899000.0
2899,2899999,20.58712229577135,36.783505543389765,0.06307960261963164,404.51803946495056,187.61592888832092,267.3943672180176,8522,2376,6146,6146,0,14,2900000.0
2900,2900999,20.586048835567006,36.78161895356337,0.0630707326796126,404.6582205295563,187.68252325057983,267.43104553222656,8524,2377,6147,6147,0,14,2901000.0
2901,2901999,20.584503032356075,36.77883897431006,0.06307256716141563,404.8099443912506,187.74877977371216,267.51145935058594,8526,2378,6148,6148,0,14,2902000.0
2902,2902999,20.583665888975464,36.77690014729847,0.06307026749484734,404.97240710258484,187.81464314460754,267.57054138183594,8528,2379,6149,6149,0,14,2903000.0
2903,2903999,20.582930601122744,36.77813131968915,0.06306822491140474,405.1159317493439,187.88119101524353,267.63562393188477,8533,2380,6153,6153,0,14,2904000.0
2904,2904999,20.582338942740673,36.77628310226318,0.06306668774370028,405.2325921058655,187.94682264328003,267.7637939453125,8533,2380,6153,6153,0,14,2905000.0
2905,2905999,20.582115119968666,36.77513017402852,0.06306277043755548,405.42446851730347,188.012841463089,267.6941375732422,8539,2383,6156,6156,0,14,2906000.0
2906,2906999,20.582122025298233,36.77465987411516,0.06305149064157678,405.56961369514465,188.0786852836609,267.8152542114258,8539,2383,6156,6156,0,14,2907000.0
2907,2907999,20.581426568259715,36.774456921283544,0.063035970139933,405.7215631008148,188.1449248790741,267.9052505493164,8541,2384,6157,6157,0,14,2908000.0
2908,2908999,20.579249142410212,36.77028488444435,0.06304004464074053,405.85391211509705,188.22146081924438,268.57065200805664,8558,2384,6174,6174,0,14,2909000.0
2909,2909999,20.577177203867755,36.767879653471,0.06305545937825285,405.9684579372406,188.2873740196228,268.8674011230469,8560,2384,6176,6176,0,14,2910000.0
2910,2910999,20.575139386927848,36.764974099731496,0.0630750788769937,406.1122658252716,188.35236501693726,268.9631233215332,8562,2385,6177,6177,0,14,2911000.0
2911,2911999,20.573057802669396,36.76218584652352,0.0630954079744962,406.29106044769287,188.41759490966797,269.01108169555664,8566,2387,6179,6179,0,14,2912000.0
2912,2912999,20.570596207249316,36.75827422649092,0.06312330047540637,406.4545874595642,188.48322892189026,269.1165199279785,8568,2388,6180,6180,0,14,2913000.0
2913,2913999,20.568234328440344,36.754575715642794,0.06314013418139086,406.59137535095215,188.54844737052917,269.1731300354004,8570,2389,6181,6181,0,14,2914000.0
2914,2914999,20.566006111008413,36.75104445427128,0.06315493871602684,406.71217489242554,188.61528038978577,269.3062934875488,8571,2389,6182,6182,0,14,2915000.0
2915,2915999,20.56496659346392,36.75112668872031,0.06313699469848721,406.92357087135315,188.6818561553955,269.269588470459,8579,2393,6186,6186,0,14,2916000.0
2916,2916999,20.56459294583298,36.751809872342506,0.06311264244863757,407.05994868278503,188.74745178222656,269.3633804321289,8581,2394,6187,6187,0,14,2917000.0
2917,2917999,20.56411345790498,36.752601799045244,0.06310041872936123,407.2184519767761,188.81406617164612,269.47090911865234,8583,2395,6188,6188,0,14,2918000.0
2918,2918999,20.564371761809763,36.75394759335487,0.06308785189089772,407.35285115242004,188.87999773025513,269.5733299255371,8583,2395,6188,6188,0,14,2919000.0
2919,2919999,20.5636520071493,36.75325370940594,0.0631029688739082,407.49696707725525,188.94580030441284,269.61639404296875,8585,2396,6189,6189,0,14,2920000.0
2920,2920999,20.563512149176603,36.75354492934643,0.06309936521001924,407.63615250587463,189.01170229911804,269.7148208618164,8585,2396,6189,6189,0,14,2921000.0
2921,2921999,20.56299856963994,36.752419165767186,0.06311536222595582,407.7693693637848,189.07800722122192,269.78599548339844,8585,2396,6189,6189,0,14,2922000.0
2922,2922999,20.562944974238203,36.751821460298096,0.06311249947538555,407.9182119369507,189.14358139038086,269.8021545410156,8587,2397,6190,6190,0,14,2923000.0
2923,2923999,20.56307996942475,36.753774669082624,0.06311014778897062,409.06804847717285,189.20990872383118,269.8968276977539,8587,2397,6190,6190,0,14,2924000.0
2924,2924999,20.56364271755828,36.75352364519293,0.06310055063022502,409.1993873119354,189.27654385566711,269.9620361328125,8587,2397,6190,6190,0,14,2925000.0
2925,2925999,20.562722394363306,36.75061964462605,0.06310219995290822,409.3510642051697,189.342857837677,269.94012451171875,8589,2398,6191,6191,0,14,2926000.0
2926,2926999,20.561777675435945,36.74823938206235,0.06310140290050492,409.5193018913269,189.40937113761902,269.95277404785156,8594,2399,6195,6195,0,14,2927000.0
2927,2927999,20.559901151215172,36.74478743479246,0.0630952739542292,409.64777970314026,189.47623372077942,270.0920295715332,8594,2399,6195,6195,0,14,2928000.0
2928,2928999,20.55822798958601,36.74116262968486,0.06308576158031798,409.79452872276306,189.54265642166138,270.2874565124512,8597,2399,6198,6198,0,14,2929000.0
2929,2929999,20.555807956352968,36.73726251922104,0.06308572344904717,409.9255328178406,189.6073055267334,270.4080047607422,8597,2399,6198,6198,0,14,2930000.0
2930,2930999,20.553452961361828,36.732779913554154,0.0630856450068269,410.09127950668335,189.67249202728271,270.4286651611328,8602,2400,6202,6202,0,14,2931000.0
2931,2931999,20.55135293875781,36.72907800039667,0.06309009843938951,410.2691955566406,189.73754787445068,270.4214057922363,8606,2402,6204,6204,0,14,2932000.0
2932,2932999,20.5492402381364,36.72487321843935,0.06309217473423323,410.3904983997345,189.80290508270264,270.51133728027344,8606,2402,6204,6204,0,14,2933000.0
2933,2933999,20.547278195596267,36.720813769504176,0.06309211649626345,410.52300930023193,189.86740350723267,270.564998626709,8606,2402,6204,6204,0,14,2934000.0
2934,2934999,20.54537155874987,36.71737598418346,0.06308955234321945,410.69373750686646,189.93295812606812,270.5000762939453,8610,2403,6207,6207,0,14,2935000.0
2935,2935999,20.54326261812023,36.71328893758113,0.06309179376898133,410.82942247390747,189.99778509140015,270.57823944091797,8610,2403,6207,6207,0,14,2936000.0
2936,2936999,20.541582745201104,36.710534490177324,0.0630859228002224,410.96688079833984,190.0642158985138,270.62061309814453,8610,2403,6207,6207,0,14,2937000.0
2937,2937999,20.540615327958562,36.710141579689775,0.06307180334561269,411.11201572418213,190.12913632392883,270.5978584289551,8612,2404,6208,6208,0,14,2938000.0
2938,2938999,20.540865283541898,36.712451938030696,0.06304708146372273,411.26206851005554,190.19396567344666,270.64538955688477,8612,2404,6208,6208,0,14,2939000.0
2939,2939999,20.541353262097406,36.72231147141542,0.06300092030676774,411.41748309135437,190.25910568237305,270.6209297180176,8614,2405,6209,6209,0,14,2940000.0
2940,2940999,20.54249207554407,36.72831165166773,0.06297623350185755,411.58529472351074,190.3247594833374,270.56621170043945,8618,2406,6212,6212,0,14,2941000.0
2941,2941999,20.543451393927803,36.73195109111061,0.06297045398375811,411.7032654285431,190.3894910812378,270.62580490112305,8618,2406,6212,6212,0,14,2942000.0
2942,2942999,20.543462540096137,36.73265893601804,0.06297251638973056,411.88379192352295,190.45490384101868,270.5543098449707,8622,2407,6215,6215,0,14,2943000.0
2943,2943999,20.54442442032897,36.73496275642392,0.06296150473880446,412.0660481452942,190.52030038833618,270.45764923095703,8628,2409,6219,6219,0,14,2944000.0
2944,2944999,20.544674186699755,36.7354350464162,0.06296088531937905,412.1959722042084,190.58624744415283,270.54601287841797,8628,2409,6219,6219,0,14,2945000.0
2945,2945999,20.545836541766562,36.7381536445946,0.06297902459363125,412.3244502544403,190.65178632736206,270.61666107177734,8628,2409,6219,6219,0,14,2946000.0
2946,2946999,20.54527834606992,36.736920053350424,0.06300948810068496,412.46388506889343,190.71731734275818,270.65430068969727,8628,2409,6219,6219,0,14,2947000.0
2947,2947999,20.544697896628612,36.73568726175295,0.06302925225854372,412.5970320701599,190.78293228149414,270.69894790649414,8628,2409,6219,6219,0,14,2948000.0
2948,2948999,20.544042995728727,36.73756595450577,0.0630363338088249,412.7349228858948,190.84862804412842,270.87504959106445,8632,2409,6223,6223,0,14,2949000.0
2949,2949999,20.54212639153431,36.7365941911906,0.06303642924320518,412.8830292224884,190.91323328018188,270.9649200439453,8636,2410,6226,6226,0,14,2950000.0
2950,2950999,20.54039826435166,36.73540497224285,0.06303267971180326,413.0132851600647,190.98009252548218,271.115478515625,8637,2410,6227,6227,0,14,2951000.0
2951,2951999,20.53917016952971,36.73453680555213,0.06303694305266538,413.1849935054779,191.04503726959229,271.1352767944336,8641,2412,6229,6229,0,14,2952000.0
2952,2952999,20.538904979869823,36.736163143474016,0.0630261703983902,413.3631274700165,191.1112380027771,271.16943359375,8645,2414,6231,6231,0,14,2953000.0
2953,2953999,20.540020654305916,36.73943041509787,0.06302066938071593,413.5004155635834,191.17680191993713,271.26547622680664,8645,2414,6231,6231,0,14,2954000.0
2954,2954999,20.540172030894944,36.73983440460301,0.0630407411588072,413.6895122528076,191.24238967895508,271.2933654785156,8651,2416,6235,6235,0,14,2955000.0
2955,2955999,20.540241973693437,36.74037849028491,0.06304091265912493,413.8370680809021,191.30818510055542,271.3143310546875,8653,2417,6236,6236,0,14,2956000.0
2956,2956999,20.540458905022692,36.74583773509185,0.0630684254715489,413.98961091041565,191.37411642074585,271.34896087646484,8655,2418,6237,6237,0,14,2957000.0
2957,2957999,20.540271411333674,36.74527928865568,0.06308588160138695,414.15357279777527,191.44148063659668,271.35001373291016,8659,2420,6239,6239,0,14,2958000.0
2958,2958999,20.53995833794405,36.74455034564244,0.06311313644736727,414.3085243701935,191.50701093673706,271.4566345214844,8659,2420,6239,6239,0,14,2959000.0
2959,2959999,20.53927211294426,36.74256528527487,0.06313233397425733,414.44712829589844,191.5725178718567,271.52260971069336,8659,2420,6239,6239,0,14,2960000.0
2960,2960999,20.539557846583644,36.74256753587801,0.0631456158975886,414.5868766307831,191.64405059814453,271.5697555541992,8659,2420,6239,6239,0,14,2961000.0
2961,2961999,20.54025733665911,36.746176899766375,0.06316352772789202,414.7559623718262,191.70996642112732,271.54361724853516,8663,2421,6242,6242,0,14,2962000.0
2962,2962999,20.54065906334456,36.74575164992172,0.06320079622512731,414.91766023635864,191.77578401565552,271.4957618713379,8665,2422,6243,6243,0,14,2963000.0
2963,2963999,20.542143235658457,36.74713485594175,0.0632413917868403,415.0608124732971,191.84126782417297,271.47912979125977,8669,2423,6246,6246,0,14,2964000.0
2964,2964999,20.543466649632023,36.74831754266906,0.06326638236431803,415.1965594291687,191.90676164627075,271.55257415771484,8669,2423,6246,6246,0,14,2965000.0
2965,2965999,20.545265136875045,36.74969961688429,0.06332019155760804,415.32855796813965,191.97199487686157,271.60133361816406,8669,2423,6246,6246,0,14,2966000.0
2966,2966999,20.546324112803514,36.74971097671183,0.063362246562499,415.49289083480835,192.038400888443,271.56304931640625,8671,2424,6247,6247,0,14,2967000.0
2967,2967999,20.54644816618514,36.7479871709072,0.06341054788556788,415.63279151916504,192.10522723197937,271.6466064453125,8671,2424,6247,6247,0,14,2968000.0
2968,2968999,20.545693242433515,36.74555100705672,0.06344080253653983,415.7619562149048,192.17030143737793,271.6802635192871,8671,2424,6247,6247,0,14,2969000.0
2969,2969999,20.54453158604991,36.74180634520123,0.06342160368023086,415.89943957328796,192.236074924469,271.85132217407227,8673,2424,6249,6249,0,14,2970000.0
2970,2970999,20.543036008085565,36.739325114101305,0.0634053480823944,416.04467821121216,192.3007574081421,271.9493713378906,8676,2425,6251,6251,0,14,2971000.0
2971,2971999,20.541713642426867,36.73652797400291,0.06338858196961383,416.18907165527344,192.36583352088928,272.07154846191406,8677,2425,6252,6252,0,14,2972000.0
2972,2972999,20.54063948787579,36.73612747793677,0.0633621732639964,416.3203854560852,192.43019151687622,272.10277557373047,8677,2425,6252,6252,0,14,2973000.0
2973,2973999,20.539324014619723,36.733495260538355,0.06334004732958465,416.46042346954346,192.49470925331116,272.1476402282715,8677,2425,6252,6252,0,14,2974000.0
2974,2974999,20.53801214496406,36.736362224752604,0.06331477872286984,416.6076035499573,192.5684130191803,272.16820526123047,8677,2425,6252,6252,0,14,2975000.0
2975,2975999,20.53643168229591,36.73301467816111,0.06329581196711531,416.742742061615,192.63329911231995,272.19605255126953,8677,2425,6252,6252,0,14,2976000.0
2976,2976999,20.534909423111472,36.7294532873909,0.06327695246668574,416.88419914245605,192.6978406906128,272.2154731750488,8677,2425,6252,6252,0,14,2977000.0
2977,2977999,20.533623749935284,36.72610126063268,0.06325834268063346,417.0318446159363,192.76225113868713,272.2423973083496,8677,2425,6252,6252,0,14,2978000.0
2978,2978999,20.532760879682147,36.723915355468726,0.06323325225459797,417.1567871570587,192.82657527923584,272.2558250427246,8677,2425,6252,6252,0,14,2979000.0
2979,2979999,20.53199332088013,36.72205878507577,0.06320805370940374,417.3071885108948,192.89102602005005,272.1676940917969,8680,2426,6254,6254,0,14,2980000.0
2980,2980999,20.531961311608825,36.72140490114881,0.06317826768689283,417.4671003818512,192.95557379722595,272.12485122680664,8683,2427,6256,6256,0,14,2981000.0
2981,2981999,20.53206863682543,36.721487256886654,0.0631466732093966,417.6234493255615,193.02035474777222,272.10353088378906,8685,2428,6257,6257,0,14,2982000.0
2982,2982999,20.532841034728307,36.72242816671559,0.0631046932874566,417.7793023586273,193.0852370262146,272.1824378967285,8685,2428,6257,6257,0,14,2983000.0
2983,2983999,20.53368109527228,36.722787844047396,0.06306951432226615,417.90917229652405,193.14977526664734,272.2348823547363,8685,2428,6257,6257,0,14,2984000.0
2984,2984999,20.53520727737526,36.72442254348179,0.06302786654582526,418.04297828674316,193.21453738212585,272.2767028808594,8685,2428,6257,6257,0,14,2985000.0
2985,2985999,20.53775469132516,36.728010815551364,0.06297780363110372,418.1756126880646,193.2790081501007,272.3088264465332,8685,2428,6257,6257,0,14,2986000.0
2986,2986999,20.53944425654374,36.72982582995953,0.0629483333623081,418.3512489795685,193.34420657157898,272.25229263305664,8689,2430,6259,6259,0,14,2987000.0
2987,2987999,20.54190704837038,36.73308585673135,0.06291587348418215,418.4867196083069,193.40909624099731,272.2981071472168,8689,2430,6259,6259,0,14,2988000.0
2988,2988999,20.545219979442972,36.73954205687596,0.06288465714429514,418.6251766681671,193.4740695953369,272.3405990600586,8689,2430,6259,6259,0,14,2989000.0
2989,2989999,20.54647900291079,36.7431465352682,0.06285031623113968,418.74979877471924,193.53844332695007,272.3748016357422,8689,2430,6259,6259,0,14,2990000.0
2990,2990999,20.545201961741242,36.74284260767491,0.0628306240280766,418.8732707500458,193.60452342033386,273.15550994873047,8709,2430,6279,6279,0,14,2991000.0
2991,2991999,20.543366785291976,36.74233420163392,0.06281978690418788,419.0050051212311,193.66889142990112,273.44629669189453,8713,2431,6282,6282,0,14,2992000.0
2992,2992999,20.54100846899462,36.73813512886098,0.06282449740926144,419.1581106185913,193.73384809494019,273.6266288757324,8719,2433,6286,6286,0,14,2993000.0
2993,2993999,20.538937488884162,36.735360337428794,0.06282142123334289,419.35653829574585,193.79963493347168,273.6897659301758,8725,2436,6289,6289,0,14,2994000.0
2994,2994999,20.53699917966618,36.73297601294599,0.06281504674377392,419.49559903144836,193.86483502388,273.9564552307129,8730,2437,6293,6293,0,14,2995000.0
2995,2995999,20.534892363714075,36.72903544907646,0.06281950621217403,419.6863753795624,193.9301950931549,273.9878349304199,8739,2440,6299,6299,0,14,2996000.0
2996,2996999,20.53335549437941,36.72629099189688,0.06281302944555456,419.8624143600464,193.997620344162,274.05273056030273,8743,2442,6301,6301,0,14,2997000.0
2997,2997999,20.531737542968063,36.72299304863577,0.06280832054694896,419.98585271835327,194.06281518936157,274.2344551086426,8743,2442,6301,6301,0,14,2998000.0
2998,2998999,20.52994839763324,36.71969525633964,0.06280906573602407,420.12528944015503,194.1290717124939,274.37073516845703,8743,2442,6301,6301,0,14,2999000.0
2999,2999999,20.528927492882964,36.71743869983872,0.06279501582286462,420.28029203414917,194.19440412521362,274.46489334106445,8745,2443,6302,6302,0,14,3000000.0
3000,3000999,20.52829248576398,36.71594172942571,0.06277393043451107,420.40877318382263,194.25973963737488,274.5836410522461,8745,2443,6302,6302,0,14,3001000.0
3001,3001999,20.527467906310488,36.71356658179098,0.06275994889099945,420.5693323612213,194.32576251029968,274.62539291381836,8747,2444,6303,6303,0,14,3002000.0
3002,3002999,20.527274675174237,36.713487805243155,0.06273463869242535,420.71135330200195,194.39288187026978,274.6501922607422,8750,2445,6305,6305,0,14,3003000.0
3003,3003999,20.52853765053945,36.71645694632377,0.06269924021994489,420.8782465457916,194.4586582183838,274.7265434265137,8752,2446,6306,6306,0,14,3004000.0
3004,3004999,20.53111022144828,36.72275345211227,0.06267310841285356,421.02959179878235,194.52435111999512,274.8158493041992,8755,2447,6308,6308,0,14,3005000.0
3005,3005999,20.535018758945853,36.733470045669094,0.06265186732647055,421.1829161643982,194.5895495414734,274.8107566833496,8760,2448,6312,6312,0,14,3006000.0
3006,3006999,20.540025813672,36.74341602766104,0.06264302780688213,421.3106908798218,194.65504145622253,274.9287528991699,8760,2448,6312,6312,0,14,3007000.0
3007,3007999,20.5461875997348,36.75680502882641,0.06265896512399427,421.5055923461914,194.72177624702454,274.91198348999023,8764,2450,6314,6314,0,14,3008000.0
3008,3008999,20.552979751048213,36.77305388444613,0.06271765751410108,421.67479133605957,194.7879593372345,274.9146842956543,8768,2452,6316,6316,0,14,3009000.0
3009,3009999,20.559735682813958,36.78450669782849,0.06276707731658526,421.7961640357971,194.85584425926208,275.0382614135742,8768,2452,6316,6316,0,14,3010000.0
3010,3010999,20.563274567829417,36.78983165805579,0.06277623089763262,421.94374775886536,194.92125630378723,275.218448638916,8768,2452,6316,6316,0,14,3011000.0
3011,3011999,20.562358334335656,36.792462483967384,0.06274360874361362,422.057076215744,194.98754334449768,276.0980567932129,8789,2452,6337,6337,0,14,3012000.0
3012,3012999,20.560482554756646,36.791367341345726,0.06274323173437724,422.16854333877563,195.05083584785461,276.4240074157715,8789,2452,6337,6337,0,14,3013000.0
3013,3013999,20.558957933958443,36.78907292958934,0.06274645905596354,422.3646717071533,195.11645770072937,276.4852752685547,8797,2456,6341,6341,0,14,3014000.0
3014,3014999,20.557082846241638,36.78686791421625,0.0627470561603719,422.52492094039917,195.1812229156494,276.66305923461914,8801,2458,6343,6343,0,14,3015000.0
3015,3015999,20.55567695451311,36.78584844838621,0.06273611235240606,422.7061686515808,195.24598264694214,276.7786293029785,8807,2461,6346,6346,0,14,3016000.0
3016,3016999,20.5534670567235,36.782939692101834,0.06274171492667846,422.89694333076477,195.31122398376465,276.8015480041504,8813,2464,6349,6349,0,14,3017000.0
3017,3017999,20.551748344577565,36.77982429040521,0.06274450407160803,423.0497386455536,195.37738156318665,276.936710357666,8817,2466,6351,6351,0,14,3018000.0
3018,3018999,20.549969808926768,36.77681621772621,0.06275004336472234,423.1950464248657,195.44303560256958,277.11551666259766,8819,2467,6352,6352,0,14,3019000.0
3019,3019999,20.548176453900847,36.77347766775901,0.06275268858609051,423.3466718196869,195.50839591026306,277.2580337524414,8821,2468,6353,6353,0,14,3020000.0
3020,3020999,20.54690100205222,36.77076074883214,0.06274198742463322,423.47177934646606,195.57328343391418,277.4130210876465,8821,2468,6353,6353,0,14,3021000.0
3021,3021999,20.546179563295144,36.76908031475645,0.06272082020103065,423.62703800201416,195.63843894004822,277.4427795410156,8823,2469,6354,6354,0,14,3022000.0
3022,3022999,20.546163019715177,36.76932364013923,0.0626901085501127,423.77178740501404,195.70490789413452,277.5095863342285,8825,2470,6355,6355,0,14,3023000.0
3023,3023999,20.547040552655265,36.77026020830009,0.06266668221205896,423.91219663619995,195.77050375938416,277.6300621032715,8825,2470,6355,6355,0,14,3024000.0
3024,3024999,20.54735698355439,36.76943855384915,0.06265262492874357,424.0452723503113,195.83550882339478,277.7206916809082,8825,2470,6355,6355,0,14,3025000.0
3025,3025999,20.547902479781104,36.7723403247877,0.06263552427418095,424.1852045059204,195.90030241012573,277.7597427368164,8827,2471,6356,6356,0,14,3026000.0
3026,3026999,20.548193862721323,36.77147255352581,0.06264188029111273,424.34514260292053,195.9655523300171,277.8032646179199,8829,2472,6357,6357,0,14,3027000.0
3027,3027999,20.54742925341468,36.768779465068896,0.06264416890698188,424.4754195213318,196.03068923950195,277.89722442626953,8829,2472,6357,6357,0,14,3028000.0
3028,3028999,20.546097749733445,36.76544671062195,0.0626403740182615,424.604567527771,196.09545636177063,278.35208892822266,8842,2472,6370,6370,0,14,3029000.0
3029,3029999,20.54534794610685,36.76733238553537,0.06262226283885697,424.7116103172302,196.15901446342468,278.8215980529785,8844,2472,6372,6372,0,14,3030000.0
3030,3030999,20.54415121733212,36.7655404046199,0.06262823151253505,424.8192083835602,196.22295117378235,279.0513229370117,8844,2472,6372,6372,0,14,3031000.0
3031,3031999,20.54367675154878,36.76544427895434,0.06264894763411999,425.07114815711975,196.2897560596466,279.25071716308594,8916,2477,6439,6439,0,14,3032000.0
3032,3032999,20.543448366266635,36.76509207734763,0.06267204238440649,425.2331295013428,196.35582280158997,279.60203552246094,8920,2479,6441,6441,0,14,3033000.0
3033,3033999,20.543336287896242,36.76427806457395,0.06269996037561021,425.3561038970947,196.42040634155273,279.91576385498047,8921,2479,6442,6442,0,14,3034000.0
3034,3034999,20.542715441414543,36.76341544203405,0.06272389709230453,425.6002125740051,196.4862539768219,279.91719818115234,8931,2484,6447,6447,0,14,3035000.0
3035,3035999,20.54274785182796,36.76284795467481,0.06277603931542952,425.7420690059662,196.5517578125,280.2490005493164,8933,2485,6448,6448,0,14,3036000.0
3036,3036999,20.54287678822068,36.761853416763245,0.0628078389972816,425.8676345348358,196.61659049987793,280.51448822021484,8933,2485,6448,6448,0,14,3037000.0
3037,3037999,20.543256147770474,36.762454187397516,0.06288778024768504,426.0158896446228,196.68255734443665,280.6384048461914,8935,2486,6449,6449,0,14,3038000.0
3038,3038999,20.544614908001833,36.76735235488146,0.06296911721072551,426.15602946281433,196.7478325366974,280.81296157836914,8937,2487,6450,6450,0,14,3039000.0
3039,3039999,20.546203647461567,36.76991818278895,0.06307395494711787,426.29422664642334,196.81338810920715,280.95547103881836,8937,2487,6450,6450,0,14,3040000.0
3040,3040999,20.54756170847046,36.77136148498439,0.06315161621585685,426.4408094882965,196.8795874118805,281.0542106628418,8939,2488,6451,6451,0,14,3041000.0
3041,3041999,20.550232601188835,36.7775356671156,0.06321973674787207,426.5962464809418,196.94577980041504,281.1338310241699,8942,2489,6453,6453,0,14,3042000.0
3042,3042999,20.554183538829196,36.79087093437238,0.06333437424808164,426.7478766441345,197.01137495040894,281.2207374572754,8944,2490,6454,6454,0,14,3043000.0
3043,3043999,20.557710312000786,36.79843794323268,0.06343685650729292,426.8733627796173,197.07634162902832,281.37633514404297,8944,2490,6454,6454,0,14,3044000.0
3044,3044999,20.560846055909828,36.80211914977556,0.06358886105818362,427.0223228931427,197.1420545578003,281.4552230834961,8946,2491,6455,6455,0,14,3045000.0
3045,3045999,20.56476958701524,36.80644676793868,0.0636779403328831,427.1480631828308,197.20748496055603,281.5823745727539,8946,2491,6455,6455,0,14,3046000.0
3046,3046999,20.568602084537662,36.81087039859151,0.06381738710088614,427.297425031662,197.2727108001709,281.6380500793457,8948,2492,6456,6456,0,14,3047000.0
3047,3047999,20.572040719667392,36.817098071893284,0.06390102232572015,427.43813252449036,197.3390347957611,281.7840118408203,8948,2492,6456,6456,0,14,3048000.0
3048,3048999,20.572071103888227,36.81583593659463,0.06390631176352912,427.56035017967224,197.4040687084198,282.3469009399414,8964,2492,6472,6472,0,14,3049000.0
3049,3049999,20.57076656680114,36.81489063505787,0.06388696807599237,427.67714071273804,197.4697027206421,282.6847343444824,8965,2492,6473,6473,0,14,3050000.0
3050,3050999,20.56941150003215,36.814107350629996,0.06387322898832282,427.78535866737366,197.53389763832092,282.91657638549805,8966,2492,6474,6474,0,14,3051000.0
3051,3051999,20.56813483726183,36.81176661897824,0.0638666210919514,427.9590094089508,197.5989224910736,282.98043060302734,8970,2494,6476,6476,0,14,3052000.0
3052,3052999,20.567020208243548,36.81035595242553,0.06385624830744085,428.1514163017273,197.66451787948608,283.0973434448242,8977,2497,6480,6480,0,14,3053000.0
3053,3053999,20.565985598695065,36.807613192709226,0.06385094148838544,428.30665373802185,197.7294156551361,283.2563247680664,8981,2499,6482,6482,0,14,3054000.0
3054,3054999,20.565417470252196,36.805843286248425,0.06383998398646862,428.4555823802948,197.79484939575195,283.35269927978516,8983,2500,6483,6483,0,14,3055000.0
3055,3055999,20.564906438983524,36.80366662186841,0.06383653837259795,428.6235635280609,197.8602478504181,283.416259765625,8987,2502,6485,6485,0,14,3056000.0
3056,3056999,20.564660994840082,36.80196921455607,0.0638377209732901,428.7709572315216,197.92582607269287,283.5372123718262,8989,2503,6486,6486,0,14,3057000.0
3057,3057999,20.565042715596327,36.80126289634452,0.06383466653208303,428.8961591720581,197.99098563194275,283.64104080200195,8989,2503,6486,6486,0,14,3058000.0
3058,3058999,20.56602070661785,36.80139719580679,0.06384470744522086,429.0406002998352,198.05609774589539,283.6775932312012,8991,2504,6487,6487,0,14,3059000.0
3059,3059999,20.56904731572579,36.80632867625667,0.06386979672018922,429.1887559890747,198.1217484474182,283.74003982543945,8993,2505,6488,6488,0,14,3060000.0
3060,3060999,20.571375296529027,36.80988556340789,0.06391170447963657,429.37879848480225,198.18770265579224,283.6837463378906,8999,2508,6491,6491,0,14,3061000.0
3061,3061999,20.574183605472737,36.814220282065385,0.06394686515418635,429.5298762321472,198.25358200073242,283.7445869445801,9005,2509,6496,6496,0,14,3062000.0
3062,3062999,20.577893139867903,36.82345007969808,0.06398613163072109,429.6598176956177,198.31900119781494,283.87646484375,9005,2509,6496,6496,0,14,3063000.0
3063,3063999,20.583133009773228,36.83440120648409,0.0640760135511097,429.8089566230774,198.38472700119019,283.927921295166,9010,2510,6500,6500,0,14,3064000.0
3064,3064999,20.587608475054253,36.842019055511294,0.06415720131451952,429.9601020812988,198.45218563079834,283.9919776916504,9017,2511,6506,6506,0,14,3065000.0
3065,3065999,20.591368726137482,36.84704566337946,0.06425286494791871,430.0931761264801,198.5176649093628,284.06108474731445,9017,2511,6506,6506,0,14,3066000.0
3066,3066999,20.59505874450924,36.85219264811914,0.06433404004695464,430.2302756309509,198.58342337608337,284.1036491394043,9017,2511,6506,6506,0,14,3067000.0
3067,3067999,20.598529886849622,36.85573802692111,0.06440115786152822,430.3840980529785,198.64943718910217,284.13016510009766,9019,2512,6507,6507,0,14,3068000.0
3068,3068999,20.5997147001492,36.8557530761836,0.06442465677578113,430.5207040309906,198.7141056060791,284.24206924438477,9020,2512,6508,6508,0,14,3069000.0
3069,3069999,20.598490983579396,36.85609334350476,0.06439677176155789,430.6367208957672,198.77970600128174,284.8686218261719,9033,2512,6521,6521,0,14,3070000.0
3070,3070999,20.59695078579561,36.85483717218168,0.06437241289879503,430.7553782463074,198.84412240982056,285.14383697509766,9034,2512,6522,6522,0,14,3071000.0
3071,3071999,20.595325378132433,36.85269046364673,0.06436355265677562,430.911741733551,198.90917897224426,285.2718048095703,9038,2514,6524,6524,0,14,3072000.0
3072,3072999,20.594119125526127,36.852296621572556,0.06434043868418571,431.08418369293213,198.9743583202362,285.3880615234375,9042,2516,6526,6526,0,14,3073000.0
3073,3073999,20.592505339689883,36.84890949825575,0.06432920535860143,431.29407382011414,199.0400915145874,285.41326904296875,9050,2520,6530,6530,0,14,3074000.0
3074,3074999,20.591160020054463,36.84814207182081,0.06431355394486693,431.46779322624207,199.10671997070312,285.5627555847168,9054,2522,6532,6532,0,14,3075000.0
3075,3075999,20.590051472076766,36.84609285153197,0.06429679557370382,431.60953187942505,199.17226719856262,285.6913261413574,9056,2523,6533,6533,0,14,3076000.0
3076,3076999,20.58913000346862,36.84403770620481,0.06428143624685423,431.7514183521271,199.23793959617615,285.79955291748047,9058,2524,6534,6534,0,14,3077000.0
3077,3077999,20.588067217455663,36.841522077153236,0.06428749574621584,431.8725025653839,199.30349850654602,285.94665145874023,9058,2524,6534,6534,0,14,3078000.0
3078,3078999,20.587658311829028,36.840812574855136,0.06428734089503352,432.04864525794983,199.36936497688293,285.9320411682129,9062,2526,6536,6536,0,14,3079000.0
3079,3079999,20.587299503133302,36.83965834788965,0.06429168772209282,432.18411087989807,199.43481850624084,286.0142021179199,9064,2527,6537,6537,0,14,3080000.0
3080,3080999,20.58735065256579,36.839170966981975,0.06429792705267545,432.32238507270813,199.500550031662,286.1462287902832,9064,2527,6537,6537,0,14,3081000.0
3081,3081999,20.58703475380016,36.8374859440582,0.06430604839226839,432.4734718799591,199.5665864944458,286.2122611999512,9066,2528,6538,6538,0,14,3082000.0
3082,3082999,20.587667904624233,36.837970899009086,0.06430881581529313,432.59993958473206,199.63239097595215,286.3281135559082,9066,2528,6538,6538,0,14,3083000.0
3083,3083999,20.587874389690235,36.837432020741176,0.06432522689692133,432.74722957611084,199.701087474823,286.31409454345703,9071,2529,6542,6542,0,14,3084000.0
3084,3084999,20.58799617156975,36.836241446914535,0.06433320723454172,432.87250328063965,199.76692128181458,286.3967475891113,9071,2529,6542,6542,0,14,3085000.0
3085,3085999,20.588756683111875,36.83606659845384,0.06433742300404832,433.02293133735657,199.83279752731323,286.4873504638672,9071,2529,6542,6542,0,14,3086000.0
3086,3086999,20.58898584194014,36.834966236827746,0.0643494833950553,433.1524565219879,199.89851999282837,286.53644943237305,9071,2529,6542,6542,0,14,3087000.0
3087,3087999,20.588690054714146,36.832856998950554,0.06435275786413552,433.3074834346771,199.964741230011,286.5239372253418,9073,2530,6543,6543,0,14,3088000.0
3088,3088999,20.588285956841368,36.830498134073686,0.06435396032206764,433.454838514328,200.03095602989197,286.6098442077637,9073,2530,6543,6543,0,14,3089000.0
3089,3089999,20.587011836340313,36.826987085895716,0.06435390261760132,433.57616233825684,200.096275806427,287.2252998352051,9093,2530,6563,6563,0,14,3090000.0
3090,3090999,20.584550594422296,36.82356418453756,0.06436058972434866,433.6864290237427,200.16082167625427,287.5761260986328,9094,2530,6564,6564,0,14,3091000.0
3091,3091999,20.581801472192357,36.81985067103998,0.06437451852568354,433.80954694747925,200.2253773212433,287.81886291503906,9094,2530,6564,6564,0,14,3092000.0
3092,3092999,20.579828107075805,36.81834623903412,0.0643755727202413,433.9716989994049,200.2911732196808,288.2249946594238,9157,2532,6625,6625,0,14,3093000.0
3093,3093999,20.577654820596628,36.81485410682927,0.06437839951647584,434.1828145980835,200.3582866191864,288.6633491516113,9166,2536,6630,6630,0,14,3094000.0
3094,3094999,20.575418691446302,36.81167088709813,0.06438105359340796,434.3249068260193,200.4247682094574,288.9161033630371,9168,2537,6631,6631,0,14,3095000.0
3095,3095999,20.57303786309809,36.80772651528786,0.06438396079677977,434.5170748233795,200.49100518226624,288.9572296142578,9174,2540,6634,6634,0,14,3096000.0
3096,3096999,20.571424407540544,36.8067179162304,0.06437322873333062,434.70582938194275,200.55804181098938,289.0033760070801,9180,2543,6637,6637,0,14,3097000.0
3097,3097999,20.570005535503544,36.8055884092207,0.06436290213761575,434.8394558429718,200.62400770187378,289.20063400268555,9182,2544,6638,6638,0,14,3098000.0
3098,3098999,20.568940798457763,36.803284945359145,0.06435524542887994,434.9693832397461,200.690269947052,289.3867835998535,9182,2544,6638,6638,0,14,3099000.0
3099,3099999,20.567524134408227,36.800922167194926,0.06435187068033554,435.105144739151,200.75639295578003,289.50436782836914,9182,2544,6638,6638,0,14,3100000.0
3100,3100999,20.56732093447679,36.80053047964624,0.06433464171574466,435.253221988678,200.8225438594818,289.56635665893555,9184,2545,6639,6639,0,14,3101000.0
3101,3101999,20.56735373765255,36.80179912543873,0.06431920322617712,435.4201638698578,200.88929867744446,289.5548629760742,9191,2547,6644,6644,0,14,3102000.0
3102,3102999,20.567746573473574,36.802249126550414,0.06430507445349087,435.54389691352844,200.9571361541748,289.6832084655762,9191,2547,6644,6644,0,14,3103000.0
3103,3103999,20.567985323096426,36.80279782503402,0.06428904729220286,435.675222158432,201.02302241325378,289.78401947021484,9191,2547,6644,6644,0,14,3104000.0
3104,3104999,20.56780686298021,36.8019263124705,0.06427704359110331,435.8057441711426,201.0889027118683,289.86146545410156,9191,2547,6644,6644,0,14,3105000.0
3105,3105999,20.56857049894261,36.80248930616683,0.06427603442223095,436.0103805065155,201.15542435646057,289.75476455688477,9201,2550,6651,6651,0,14,3106000.0
3106,3106999,20.568951418318814,36.80277129553634,0.0642707452717215,436.1402237415314,201.2216010093689,289.88990020751953,9201,2550,6651,6651,0,14,3107000.0
3107,3107999,20.57014671564652,36.804365214377654,0.06427377795791267,436.2864406108856,201.28781652450562,289.9898109436035,9201,2550,6651,6651,0,14,3108000.0
3108,3108999,20.57100742240106,36.804434167820105,0.06427762700852702,436.44301319122314,201.35447311401367,290.0172653198242,9203,2551,6652,6652,0,14,3109000.0
3109,3109999,20.57124649465227,36.803452012074914,0.06428216215993632,436.5681936740875,201.42045497894287,290.11542892456055,9203,2551,6652,6652,0,14,3110000.0
3110,3110999,20.56972966385657,36.80118034960034,0.06428020968043391,436.6909499168396,201.48682928085327,290.7195281982422,9218,2551,6667,6667,0,14,3111000.0
3111,3111999,20.56715774855438,36.79759387591685,0.06428572881755024,436.8054163455963,201.55173802375793,291.0290336608887,9219,2551,6668,6668,0,14,3112000.0
3112,3112999,20.565081214941298,36.79499643254272,0.0642869050208188,436.94951820373535,201.6165120601654,291.0953712463379,9225,2552,6673,6673,0,14,3113000.0
3113,3113999,20.56275096198931,36.79152558665227,0.06429680848909458,437.1505525112152,201.6813609600067,291.0675735473633,9234,2555,6679,6679,0,14,3114000.0
3114,3114999,20.56056855526028,36.787808777778764,0.06430136073477255,437.2841942310333,201.74635481834412,291.2297592163086,9236,2556,6680,6680,0,14,3115000.0
3115,3115999,20.558799886304925,36.78603266605021,0.06430287748005836,437.4472279548645,201.8114640712738,291.32787704467773,9240,2558,6682,6682,0,14,3116000.0
3116,3116999,20.557382134953333,36.78433766496105,0.06429232616262504,437.61588430404663,201.87798023223877,291.3442802429199,9244,2560,6684,6684,0,14,3117000.0
3117,3117999,20.556248412020537,36.78218414341734,0.0642862781963166,437.8250575065613,201.94421935081482,291.41674423217773,9250,2563,6687,6687,0,14,3118000.0
3118,3118999,20.555278322821827,36.78039507719453,0.06428277570807095,437.9468746185303,202.01122498512268,291.5736618041992,9250,2563,6687,6687,0,14,3119000.0
3119,3119999,20.554739175852177,36.77936243646411,0.0642817693224419,438.0975499153137,202.07684111595154,291.59558868408203,9252,2564,6688,6688,0,14,3120000.0
3120,3120999,20.554821163893536,36.780216461375666,0.0642865476425587,438.2305874824524,202.14326214790344,291.7230529785156,9252,2564,6688,6688,0,14,3121000.0
3121,3121999,20.554822121398335,36.77970687604994,0.06429372099280295,438.3589186668396,202.2092399597168,291.8187789916992,9252,2564,6688,6688,0,14,3122000.0
3122,3122999,20.555180521915158,36.78073082416767,0.06429687419148411,438.51261806488037,202.27483677864075,291.86254119873047,9254,2565,6689,6689,0,14,3123000.0
3123,3123999,20.55578351504353,36.78214364822096,0.06430945505003072,438.6562910079956,202.34026670455933,291.836727142334,9259,2566,6693,6693,0,14,3124000.0
3124,3124999,20.556467199837787,36.78290498819499,0.06432338741878818,438.7941143512726,202.40614819526672,291.9437828063965,9259,2566,6693,6693,0,14,3125000.0
3125,3125999,20.557596303063846,36.78453961085329,0.06433511393955427,438.96299719810486,202.47222781181335,291.93345642089844,9263,2568,6695,6695,0,14,3126000.0
3126,3126999,20.55794433875046,36.78411274983981,0.0643511894005131,439.1167104244232,202.5378406047821,291.98541259765625,9265,2569,6696,6696,0,14,3127000.0
3127,3127999,20.558410773285996,36.7835518348737,0.06435605325691796,439.2478370666504,202.6035077571869,292.05625915527344,9265,2569,6696,6696,0,14,3128000.0
3128,3128999,20.559115722989226,36.783351093858585,0.06435691487580819,439.3760600090027,202.66890025138855,292.11236572265625,9265,2569,6696,6696,0,14,3129000.0
3129,3129999,20.559118880296506,36.78208418469951,0.06435502072632204,439.52433133125305,202.73593997955322,292.20735931396484,9265,2569,6696,6696,0,14,3130000.0
3130,3130999,20.558620367597065,36.77991093737876,0.06435094998900615,439.68114972114563,202.80184531211853,292.23377990722656,9267,2570,6697,6697,0,14,3131000.0
3131,3131999,20.55776129491221,36.78213502169722,0.0643111953706138,439.80291175842285,202.8673779964447,292.9060592651367,9284,2570,6714,6714,0,14,3132000.0
3132,3132999,20.555504208908946,36.778737383987185,0.06430513183327924,439.9255163669586,202.9323365688324,293.19585037231445,9284,2570,6714,6714,0,14,3133000.0
3133,3133999,20.553381958630354,36.77556253325497,0.06430263390478275,440.09130096435547,202.99752378463745,293.2932929992676,9288,2572,6716,6716,0,14,3134000.0
3134,3134999,20.55160866791524,36.77449842439382,0.06429230921853546,440.254843711853,203.06291508674622,293.4219512939453,9292,2574,6718,6718,0,14,3135000.0
3135,3135999,20.550534512800677,36.77329091235694,0.06428414632207213,440.4206898212433,203.12880659103394,293.5421676635742,9297,2576,6721,6721,0,14,3136000.0
3136,3136999,20.549866972560288,36.77206960320893,0.06426845822244609,440.5967769622803,203.1944100856781,293.6405220031738,9301,2578,6723,6723,0,14,3137000.0
3137,3137999,20.549006621964132,36.77047645275455,0.06426362611932879,440.73919010162354,203.26043486595154,293.77274322509766,9303,2579,6724,6724,0,14,3138000.0
3138,3138999,20.548566340336276,36.7701068565052,0.06424891556200785,440.8834686279297,203.3263087272644,293.884090423584,9305,2580,6725,6725,0,14,3139000.0
3139,3139999,20.548739614281093,36.76996009100868,0.06424902818323686,441.045104265213,203.39275431632996,293.8918876647949,9310,2581,6729,6729,0,14,3140000.0
3140,3140999,20.550428469529393,36.77775377909732,0.06423019070401725,441.19244480133057,203.45874643325806,293.9407615661621,9312,2582,6730,6730,0,14,3141000.0
3141,3141999,20.55421754109885,36.78608139177459,0.06424265357312897,441.3560836315155,203.5249490737915,293.9785614013672,9316,2584,6732,6732,0,14,3142000.0
3142,3142999,20.56072607595841,36.80154484768079,0.06425687634424704,441.5105011463165,203.59179091453552,294.0430030822754,9322,2585,6737,6737,0,14,3143000.0
3143,3143999,20.568824353838917,36.832665289052365,0.06421382458626235,441.65989351272583,203.65779852867126,294.101505279541,9324,2586,6738,6738,0,14,3144000.0
3144,3144999,20.577639545986234,36.859921005521315,0.06422995229487516,441.8129131793976,203.72437047958374,294.1972961425781,9324,2586,6738,6738,0,14,3145000.0
3145,3145999,20.5884583396626,36.89570512099199,0.06427068451899454,441.9443669319153,203.79057717323303,294.3186912536621,9324,2586,6738,6738,0,14,3146000.0
3146,3146999,20.601385698638392,36.93614197571198,0.0643794802808676,442.0714190006256,203.85652828216553,294.4108428955078,9324,2586,6738,6738,0,14,3147000.0
3147,3147999,20.613396254638,36.97311729860567,0.06450054317992271,442.22582244873047,203.92287635803223,294.4980659484863,9326,2587,6739,6739,0,14,3148000.0
3148,3148999,20.623563030731685,36.99784880789349,0.06467432574947052,442.37831711769104,203.98871302604675,294.47521209716797,9328,2588,6740,6740,0,14,3149000.0
3149,3149999,20.634249099122954,37.024945741544485,0.06490055036849984,442.5150661468506,204.0558705329895,294.5550651550293,9328,2588,6740,6740,0,14,3150000.0
3150,3150999,20.644967239349395,37.05140417285923,0.06509906302397761,442.6715350151062,204.1221306324005,294.5375213623047,9330,2589,6741,6741,0,14,3151000.0
3151,3151999,20.652158934838603,37.06710017463576,0.06515178126379062,442.8430564403534,204.18806982040405,294.9424705505371,9343,2590,6753,6753,0,14,3152000.0
3152,3152999,20.65171627127322,37.07177704743746,0.06511692676485725,442.9634213447571,204.25424933433533,295.3694610595703,9350,2590,6760,6760,0,14,3153000.0
3153,3153999,20.650607818472736,37.07064940300406,0.06510623668967408,443.0835213661194,204.3192002773285,295.58432388305664,9351,2590,6761,6761,0,14,3154000.0
3154,3154999,20.649705346100085,37.069903300894275,0.06510381130402132,443.2473404407501,204.3844301700592,295.640380859375,9355,2592,6763,6763,0,14,3155000.0
3155,3155999,20.648948808084857,37.068923354606234,0.06508398330508869,443.41634821891785,204.45012831687927,295.76189041137695,9359,2594,6765,6765,0,14,3156000.0
3156,3156999,20.64805284224441,37.067464198717595,0.06507558170162653,443.5800483226776,204.5160312652588,295.87340545654297,9363,2596,6767,6767,0,14,3157000.0
3157,3157999,20.64676550695097,37.064807458700585,0.06507157898781457,443.749146938324,204.58238673210144,295.91467666625977,9367,2598,6769,6769,0,14,3158000.0
3158,3158999,20.646441264015074,37.069031916788084,0.06504201484611738,443.9125864505768,204.6491208076477,296.06352615356445,9369,2599,6770,6770,0,14,3159000.0
3159,3159999,20.64540280020725,37.06688155863996,0.06502926309099988,444.04274106025696,204.71521306037903,296.18166732788086,9369,2599,6770,6770,0,14,3160000.0
3160,3160999,20.64471463133183,37.06529472928799,0.06501439634634065,444.19431376457214,204.78165650367737,296.2048530578613,9375,2600,6775,6775,0,14,3161000.0
3161,3161999,20.64386891114373,37.06358873520084,0.0650040063075854,444.36136651039124,204.8476221561432,296.2688179016113,9377,2601,6776,6776,0,14,3162000.0
3162,3162999,20.64372091075125,37.0636274320977,0.06498235644312844,444.5153748989105,204.91403460502625,296.3080749511719,9379,2602,6777,6777,0,14,3163000.0
3163,3163999,20.643616092532408,37.063270027991386,0.06496759634040294,444.65100717544556,204.98020887374878,296.3860168457031,9379,2602,6777,6777,0,14,3164000.0
3164,3164999,20.64358348150156,37.06279108007667,0.06495549384152755,444.77768778800964,205.04620718955994,296.47023010253906,9379,2602,6777,6777,0,14,3165000.0
3165,3165999,20.64351211358731,37.06149863958361,0.06494053548583556,444.9085066318512,205.1120843887329,296.5310363769531,9379,2602,6777,6777,0,14,3166000.0
3166,3166999,20.643184516838485,37.05947319490414,0.06493838264737928,445.08336305618286,205.17860460281372,296.5518684387207,9383,2604,6779,6779,0,14,3167000.0
3167,3167999,20.64329133895941,37.05849761746959,0.06492377411933847,445.2364149093628,205.24517488479614,296.558837890625,9389,2605,6784,6784,0,14,3168000.0
3168,3168999,20.643290248288572,37.05691162105828,0.06491867210206814,445.36386919021606,205.31195664405823,296.6318473815918,9389,2605,6784,6784,0,14,3169000.0
3169,3169999,20.64253837686704,37.05583657710431,0.0649028582415655,445.5083885192871,205.37788581848145,296.72119903564453,9389,2605,6784,6784,0,14,3170000.0
3170,3170999,20.640824427928738,37.05290973247669,0.06490386032211837,445.6550099849701,205.4430661201477,297.2973213195801,9407,2606,6801,6801,0,14,3171000.0
3171,3171999,20.63842958388098,37.04959841504177,0.06491220081459514,445.76947236061096,205.5074827671051,297.6546630859375,9409,2606,6803,6803,0,14,3172000.0
3172,3172999,20.636227995382022,37.046409749785454,0.06491688508770233,445.90535378456116,205.5723443031311,297.78870391845703,9411,2607,6804,6804,0,14,3173000.0
3173,3173999,20.633466656711114,37.04195134564758,0.06493281053295452,446.0729491710663,205.63813662528992,297.8836135864258,9415,2609,6806,6806,0,14,3174000.0
3174,3174999,20.631421235182206,37.038319279499234,0.06493295809994537,446.2761800289154,205.70354580879211,297.9166145324707,9423,2613,6810,6810,0,14,3175000.0
3175,3175999,20.629133028601792,37.03554104511379,0.06493860387974859,446.4593698978424,205.76967573165894,298.0306510925293,9427,2615,6812,6812,0,14,3176000.0
3176,3176999,20.626642203033413,37.03149932974683,0.0649490496031222,446.61831521987915,205.83592772483826,298.16466522216797,9429,2616,6813,6813,0,14,3177000.0
3177,3177999,20.624440143861978,37.027703939486216,0.06495011528122552,446.75736021995544,205.90134716033936,298.2546043395996,9431,2617,6814,6814,0,14,3178000.0
3178,3178999,20.622494869334805,37.02552842062269,0.06494314980080107,446.9043245315552,205.96715211868286,298.3561248779297,9433,2618,6815,6815,0,14,3179000.0
3179,3179999,20.620706258748942,37.02263144842623,0.06494593273122329,447.0615680217743,206.03299522399902,298.4348907470703,9435,2619,6816,6816,0,14,3180000.0
3180,3180999,20.618885049911643,37.0193601950854,0.06494264614798295,447.20096468925476,206.09866786003113,298.5515251159668,9435,2619,6816,6816,0,14,3181000.0
3181,3181999,20.61725641368627,37.01630222795809,0.0649331108954414,447.3205564022064,206.16431260108948,298.6339874267578,9435,2619,6816,6816,0,14,3182000.0
3182,3182999,20.615891282821718,37.01327351389883,0.06492011410642429,447.4547629356384,206.23069596290588,298.6959114074707,9435,2619,6816,6816,0,14,3183000.0
3183,3183999,20.615180406443955,37.011689153454,0.0649048000993564,447.57989740371704,206.29627132415771,298.7839469909668,9435,2619,6816,6816,0,14,3184000.0
3184,3184999,20.615340146218813,37.01404380547984,0.06486566777118963,447.7186539173126,206.3621838092804,298.8386459350586,9435,2619,6816,6816,0,14,3185000.0
3185,3185999,20.615586711889737,37.0145550899804,0.06484788076450765,447.8445494174957,206.42769598960876,298.90568923950195,9435,2619,6816,6816,0,14,3186000.0
3186,3186999,20.615743433710456,37.014023697332526,0.06484019410709807,447.99401783943176,206.49352502822876,298.9789352416992,9435,2619,6816,6816,0,14,3187000.0
3187,3187999,20.61638128838579,37.014786740065894,0.06481955673518314,448.1235980987549,206.55907106399536,299.02586364746094,9435,2619,6816,6816,0,14,3188000.0
3188,3188999,20.617076688391425,37.01557924645856,0.06480205665469985,448.298202753067,206.62557172775269,298.9556884765625,9439,2621,6818,6818,0,14,3189000.0
3189,3189999,20.617426106323,37.01478558063602,0.0647853156968281,448.4365019798279,206.69121074676514,299.0972213745117,9439,2621,6818,6818,0,14,3190000.0
3190,3190999,20.617399571705995,37.01476586496236,0.064752913819634,448.5676324367523,206.7574508190155,299.53784942626953,9451,2621,6830,6830,0,14,3191000.0
3191,3191999,20.614945068005653,37.01047161859937,0.06475926413164412,448.67737650871277,206.82185435295105,299.8079605102539,9452,2621,6831,6831,0,14,3192000.0
3192,3192999,20.612999252088883,37.00779404845447,0.06475644113917478,448.8410818576813,206.88776564598083,299.8914375305176,9457,2623,6834,6834,0,14,3193000.0
3193,3193999,20.61142856281698,37.005364270524815,0.06474674043834538,448.97252368927,206.95285201072693,300.0591926574707,9457,2623,6834,6834,0,14,3194000.0
3194,3194999,20.609621755741202,37.003216129456135,0.06473696782521432,449.1667079925537,207.018483877182,300.016357421875,9463,2626,6837,6837,0,14,3195000.0
3195,3195999,20.60762287879507,37.00133235769081,0.06473077700206542,449.36621952056885,207.08449482917786,300.02751541137695,9473,2629,6844,6844,0,14,3196000.0
3196,3196999,20.605648224132874,36.99767549671836,0.06472426788873775,449.48930764198303,207.14996361732483,300.1643600463867,9473,2629,6844,6844,0,14,3197000.0
3197,3197999,20.603604447996926,36.99413738933045,0.06472451682072089,449.6209888458252,207.21520829200745,300.25178146362305,9473,2629,6844,6844,0,14,3198000.0
3198,3198999,20.602192749324015,36.99297746134792,0.06470496023899819,449.77989077568054,207.28102350234985,300.32523345947266,9476,2630,6846,6846,0,14,3199000.0
3199,3199999,20.600670650513063,36.989789055385145,0.06469879448777494,449.90606904029846,207.34619140625,300.3990287780762,9476,2630,6846,6846,0,14,3200000.0
3200,3200999,20.59970368851933,36.98830975541453,0.06468597891054029,450.1041738986969,207.41213154792786,300.2434387207031,9486,2633,6853,6853,0,14,3201000.0
3201,3201999,20.59939863530965,36.988397655679194,0.06466286912264085,450.25607347488403,207.4786674976349,300.4001350402832,9486,2633,6853,6853,0,14,3202000.0
3202,3202999,20.599084729917518,36.98800307991963,0.0646458260375099,450.3847153186798,207.54435896873474,300.4814796447754,9486,2633,6853,6853,0,14,3203000.0
3203,3203999,20.600698926927674,36.99294805392115,0.0646148146074007,450.557968378067,207.61003828048706,300.37883377075195,9497,2635,6862,6862,0,14,3204000.0
3204,3204999,20.603918417613983,37.00065524007414,0.0645741820977177,450.6753981113434,207.67652583122253,300.4857978820801,9497,2635,6862,6862,0,14,3205000.0
3205,3205999,20.607467376571947,37.01215422387729,0.06452886732767649,450.81750321388245,207.74242973327637,300.55186462402344,9497,2635,6862,6862,0,14,3206000.0
3206,3206999,20.611586556414114,37.020644201421376,0.06451417781217528,450.97183752059937,207.8083622455597,300.54917907714844,9499,2636,6863,6863,0,14,3207000.0
3207,3207999,20.61616375620402,37.02949077118067,0.06451610824283516,451.10562539100647,207.8741455078125,300.6377182006836,9499,2636,6863,6863,0,14,3208000.0
3208,3208999,20.620487693215956,37.038049874122244,0.06455025616476107,451.2605812549591,207.9402313232422,300.6274528503418,9501,2637,6864,6864,0,14,3209000.0
3209,3209999,20.624356879728097,37.04611375989995,0.06458040142050592,451.4121062755585,208.00622534751892,300.700626373291,9503,2638,6865,6865,0,14,3210000.0
3210,3210999,20.629110943616045,37.05412579120379,0.06464545772239105,451.55438780784607,208.07251572608948,300.7992477416992,9503,2638,6865,6865,0,14,3211000.0
3211,3211999,20.63249528625266,37.06613450297572,0.0646547296994523,451.6966953277588,208.13826990127563,301.25231552124023,9520,2638,6882,6882,0,14,3212000.0
3212,3212999,20.63037420544187,37.063823695007194,0.06464367159681594,451.8228597640991,208.20614075660706,301.7792091369629,9526,2638,6888,6888,0,14,3213000.0
3213,3213999,20.62821353638265,37.060416607984635,0.06464836290250098,451.95362734794617,208.2716372013092,302.04417419433594,9526,2638,6888,6888,0,14,3214000.0
3214,3214999,20.626135952354936,37.05700465070968,0.06465102623090013,452.11687755584717,208.33775424957275,302.1566276550293,9530,2640,6890,6890,0,14,3215000.0
3215,3215999,20.624229131055305,37.05384162395234,0.06465299732845187,452.2826473712921,208.40392541885376,302.216251373291,9538,2642,6896,6896,0,14,3216000.0
3216,3216999,20.622501098617086,37.051731573451896,0.06464601794516855,452.4449145793915,208.4705090522766,302.3626365661621,9542,2644,6898,6898,0,14,3217000.0
3217,3217999,20.62102997425614,37.050162209683634,0.06463408972694118,452.63319158554077,208.53655338287354,302.39263916015625,9551,2647,6904,6904,0,14,3218000.0
3218,3218999,20.61960402306065,37.04873716317177,0.06462617287277195,452.8256514072418,208.60340189933777,302.41419219970703,9557,2650,6907,6907,0,14,3219000.0
3219,3219999,20.61879539733074,37.04894469867595,0.06461578558658354,452.9581503868103,208.66981101036072,302.66349029541016,9557,2650,6907,6907,0,14,3220000.0
3220,3220999,20.618768123385852,37.053302614136484,0.06458926792263242,453.1075437068939,208.73623633384705,302.7097587585449,9559,2651,6908,6908,0,14,3221000.0
3221,3221999,20.619808424426655,37.05853109172746,0.06455647494812433,453.2382550239563,208.8026306629181,302.8564872741699,9559,2651,6908,6908,0,14,3222000.0
3222,3222999,20.623325236835196,37.07005803846856,0.06452993235087279,453.38734555244446,208.86890530586243,302.96033477783203,9561,2652,6909,6909,0,14,3223000.0
3223,3223999,20.62721311185869,37.0848363802431,0.06449428138349544,453.5654950141907,208.93564128875732,302.92447662353516,9565,2654,6911,6911,0,14,3224000.0
3224,3224999,20.63306924902469,37.10217863001805,0.06450954993407942,453.73826479911804,209.00272822380066,303.00632095336914,9569,2656,6913,6913,0,14,3225000.0
3225,3225999,20.639799569431965,37.12211315401469,0.06455217060681562,453.8927767276764,209.07029581069946,303.1581916809082,9571,2657,6914,6914,0,14,3226000.0
3226,3226999,20.645470819403588,37.13811700622891,0.0646126451040464,454.04121446609497,209.1371397972107,303.22410583496094,9573,2658,6915,6915,0,14,3227000.0
3227,3227999,20.65294307696898,37.160183272540976,0.06467073758964126,454.1921169757843,209.20391249656677,303.32976150512695,9604,2659,6945,6945,0,14,3228000.0
3228,3228999,20.66002690832985,37.18115404650852,0.06472791198979655,454.3239998817444,209.27019333839417,303.4590148925781,9604,2659,6945,6945,0,14,3229000.0
3229,3229999,20.667731918016024,37.20094492841541,0.0647778336241207,454.4578001499176,209.33670282363892,303.53488540649414,9604,2659,6945,6945,0,14,3230000.0
3230,3230999,20.677410730488905,37.228660972277595,0.06486860858905064,454.6080255508423,209.4037127494812,303.56401443481445,9606,2660,6946,6946,0,14,3231000.0
3231,3231999,20.682580793958895,37.240326392385874,0.06490995452053927,454.7574510574341,209.4710774421692,303.65174102783203,9606,2660,6946,6946,0,14,3232000.0
3232,3232999,20.68336960032077,37.24173381129596,0.06490221056401047,454.9096336364746,209.53691697120667,304.3595771789551,9635,2661,6974,6974,0,14,3233000.0
3233,3233999,20.681840225499236,37.23972007256604,0.06490110148672357,455.0206730365753,209.6026976108551,304.75555419921875,9638,2661,6977,6977,0,14,3234000.0
3234,3234999,20.68060572128707,37.24197946206329,0.06489098889574363,455.16386675834656,209.66775560379028,304.95706939697266,9640,2662,6978,6978,0,14,3235000.0
3235,3235999,20.679550977496778,37.24049195778652,0.06489283216044239,455.3143570423126,209.73330903053284,305.12469482421875,9642,2663,6979,6979,0,14,3236000.0
3236,3236999,20.67847364215799,37.23866700662977,0.06487995076041031,455.4402196407318,209.7992537021637,305.31331634521484,9642,2663,6979,6979,0,14,3237000.0
3237,3237999,20.677341259809356,37.23640495006993,0.06488179132068994,455.6681251525879,209.86593651771545,305.30270767211914,9653,2667,6986,6986,0,14,3238000.0
3238,3238999,20.67570484061422,37.232914736803316,0.06488257244862716,455.85302090644836,209.93236088752747,305.32154846191406,9659,2670,6989,6989,0,14,3239000.0
3239,3239999,20.674289419215228,37.22989435900829,0.06488595548903353,455.99611353874207,209.99866390228271,305.5424919128418,9662,2671,6991,6991,0,14,3240000.0
3240,3240999,20.673174011393783,37.227513016864656,0.06488619451751398,456.13037395477295,210.06454706192017,305.69336318969727,9662,2671,6991,6991,0,14,3241000.0
3241,3241999,20.672510579470703,37.225577833044966,0.0648868851365435,456.27548837661743,210.1305615901947,305.7898406982422,9664,2672,6992,6992,0,14,3242000.0
3242,3242999,20.6718101594485,37.22344212163299,0.06487905344812583,456.45054507255554,210.1966118812561,305.8146781921387,9668,2674,6994,6994,0,14,3243000.0
3243,3243999,20.672792605054514,37.22540459324256,0.06486931408565477,456.5748772621155,210.26324224472046,305.95384979248047,9668,2674,6994,6994,0,14,3244000.0
3244,3244999,20.673865560879367,37.22689891025549,0.06487639207580898,456.7047755718231,210.3291277885437,306.05081939697266,9668,2674,6994,6994,0,14,3245000.0
3245,3245999,20.67652155908437,37.233348119890465,0.06486385528528549,456.8786404132843,210.39566111564636,306.08643341064453,9670,2675,6995,6995,0,14,3246000.0
3246,3246999,20.680170903869573,37.246018498784096,0.06484626815408745,457.0232093334198,210.46214270591736,306.1831474304199,9672,2676,6996,6996,0,14,3247000.0
3247,3247999,20.684635655021168,37.25567522035916,0.0648355704360023,457.1892600059509,210.52854537963867,306.19213104248047,9676,2678,6998,6998,0,14,3248000.0
3248,3248999,20.689596614161612,37.26642251667563,0.06488489397757435,457.3604152202606,210.5947642326355,306.26587677001953,9684,2680,7004,7004,0,14,3249000.0
3249,3249999,20.693932911845277,37.276002967768164,0.06491277723855926,457.4938724040985,210.6610541343689,306.3461570739746,9684,2680,7004,7004,0,14,3250000.0
3250,3250999,20.69859804112059,37.2834253014656,0.06495501184835983,457.6603605747223,210.72838926315308,306.3646354675293,9686,2681,7005,7005,0,14,3251000.0
3251,3251999,20.70417111775281,37.29175660489895,0.06503949486903238,457.8230941295624,210.7951681613922,306.4107894897461,9688,2682,7006,7006,0,14,3252000.0
3252,3252999,20.70685531520279,37.296987849817036,0.06508264671824127,457.95987200737,210.86115527153015,306.52684783935547,9688,2682,7006,7006,0,14,3253000.0
3253,3253999,20.704962813783336,37.29433258491701,0.06507820895847127,458.1058053970337,210.9279670715332,307.4917755126953,9722,2683,7039,7039,0,14,3254000.0
3254,3254999,20.702660891782198,37.290913770426485,0.06508611509330342,458.2442593574524,210.99412512779236,307.86953353881836,9726,2684,7042,7042,0,14,3255000.0
3255,3255999,20.701072336774832,37.29233480281326,0.06506598064735525,458.3825719356537,211.06001472473145,308.0994300842285,9728,2685,7043,7043,0,14,3256000.0
3256,3256999,20.69948013126022,37.28952312302242,0.0650534969358727,458.52099418640137,211.12579870224,308.29698181152344,9730,2686,7044,7044,0,14,3257000.0
3257,3257999,20.69796646915067,37.28827705693576,0.06504757581536247,458.71349930763245,211.1923747062683,308.39517974853516,9736,2689,7047,7047,0,14,3258000.0
3258,3258999,20.696816414330147,37.2866576106541,0.06503778744228139,458.83281803131104,211.25794672966003,308.63178634643555,9736,2689,7047,7047,0,14,3259000.0
3259,3259999,20.69541517237753,37.28578516972907,0.065021347229955,459.0861773490906,211.3256471157074,308.5411911010742,9746,2694,7052,7052,0,14,3260000.0
3260,3260999,20.693855826734783,37.282991686113554,0.06501909661189276,459.226140499115,211.3932478427887,308.77878189086914,9748,2695,7053,7053,0,14,3261000.0
3261,3261999,20.692472989517363,37.280281851531036,0.06501286645587245,459.36189818382263,211.46076774597168,308.92420196533203,9748,2695,7053,7053,0,14,3262000.0
3262,3262999,20.691581036524944,37.27879180453674,0.06499840035498805,459.4781348705292,211.52636408805847,309.03095626831055,9748,2695,7053,7053,0,14,3263000.0
3263,3263999,20.690545819176688,37.277831977158286,0.06499668920328161,459.6272072792053,211.59272933006287,309.12195587158203,9750,2696,7054,7054,0,14,3264000.0
3264,3264999,20.690496806897098,37.277003087896524,0.06498830056425375,459.76282954216003,211.65906834602356,309.2209281921387,9750,2696,7054,7054,0,14,3265000.0
3265,3265999,20.690725563253054,37.27651787529468,0.06497433432723776,459.9235544204712,211.7255482673645,309.27095794677734,9752,2697,7055,7055,0,14,3266000.0
3266,3266999,20.692021376270578,37.27746208614394,0.06496288258648408,460.0575077533722,211.79169273376465,309.34201431274414,9752,2697,7055,7055,0,14,3267000.0
3267,3267999,20.694462501469033,37.281001852645865,0.0649462775703501,460.2085657119751,211.85854816436768,309.39317321777344,9754,2698,7056,7056,0,14,3268000.0
3268,3268999,20.697447039179817,37.284729393947615,0.06493392626437455,460.3565275669098,211.9250729084015,309.45785903930664,9756,2699,7057,7057,0,14,3269000.0
3269,3269999,20.700630198597974,37.28907330527592,0.064946715185764,460.523065328598,211.99147081375122,309.5033531188965,9758,2700,7058,7058,0,14,3270000.0
3270,3270999,20.704172720491425,37.29351845625226,0.06496692361381562,460.68728590011597,212.05840301513672,309.50140380859375,9762,2702,7060,7060,0,14,3271000.0
3271,3271999,20.70689764282276,37.29574188833819,0.06499591636079682,460.82317781448364,212.12492990493774,309.62246322631836,9762,2702,7060,7060,0,14,3272000.0
3272,3272999,20.709335703686985,37.297553021195895,0.06502426703395603,460.9551422595978,212.19162034988403,309.72862243652344,9762,2702,7060,7060,0,14,3273000.0
3273,3273999,20.711080014563738,37.298494129312,0.0650525421870981,461.09082293510437,212.25833225250244,309.84042739868164,9762,2702,7060,7060,0,14,3274000.0
3274,3274999,20.710404959403668,37.29602447955071,0.06504785873263419,461.2167258262634,212.32428240776062,310.82397079467773,9795,2702,7093,7093,0,14,3275000.0
3275,3275999,20.70917603052235,37.29347298695402,0.06501083891089654,461.3365054130554,212.38968086242676,311.27337646484375,9798,2702,7096,7096,0,14,3276000.0
3276,3276999,20.707605820646936,37.29079618856993,0.06499110468935987,461.4521253108978,212.45495915412903,311.5652046203613,9798,2702,7096,7096,0,14,3277000.0
3277,3277999,20.706421882520544,37.28813903354854,0.0649706586596197,461.60088896751404,212.52008628845215,311.71136474609375,9803,2703,7100,7100,0,14,3278000.0
3278,3278999,20.704708841894195,37.28463019044745,0.0649582859251795,461.73600602149963,212.58536005020142,311.84578704833984,9805,2704,7101,7101,0,14,3279000.0
3279,3279999,20.703835469320587,37.2860298654554,0.06491576796427811,461.92144227027893,212.65100693702698,311.96017837524414,9815,2707,7108,7108,0,14,3280000.0
3280,3280999,20.70217215024629,37.28309199914416,0.06490294696838361,462.137216091156,212.71758008003235,311.9620056152344,9823,2711,7112,7112,0,14,3281000.0
3281,3281999,20.700867026270174,37.28000771547349,0.06488043258297216,462.3719701766968,212.79163336753845,311.9554214477539,9834,2715,7119,7119,0,14,3282000.0
3282,3282999,20.699290857525096,37.2768362823884,0.06486775538825662,462.49169301986694,212.85814261436462,312.1973648071289,9834,2715,7119,7119,0,14,3283000.0
3283,3283999,20.6982181385162,37.27399581595471,0.06484750344108625,462.6389515399933,212.92409443855286,312.2900619506836,9836,2716,7120,7120,0,14,3284000.0
3284,3284999,20.697753091951046,37.273036444308396,0.06481924642850645,462.80355954170227,212.99038815498352,312.3450241088867,9840,2718,7122,7122,0,14,3285000.0
3285,3285999,20.697428236641144,37.271699409478764,0.06479962142376428,462.941730260849,213.063485622406,312.5524444580078,9840,2718,7122,7122,0,14,3286000.0
3286,3286999,20.69748955546487,37.27044652958465,0.0647986817663535,463.07388973236084,213.12946677207947,312.66891860961914,9840,2718,7122,7122,0,14,3287000.0
3287,3287999,20.69786615588569,37.27004477606491,0.06478721376980479,463.1929178237915,213.19532251358032,312.77224349975586,9840,2718,7122,7122,0,14,3288000.0
3288,3288999,20.698689169834577,37.27035872498646,0.06476838914455219,463.3474872112274,213.26166009902954,312.84772872924805,9842,2719,7123,7123,0,14,3289000.0
3289,3289999,20.699563358517885,37.2703327910468,0.06475106670796171,463.495530128479,213.3274793624878,312.9120216369629,9844,2720,7124,7124,0,14,3290000.0
3290,3290999,20.70038342279502,37.26964264601619,0.06473811706770882,463.64871430397034,213.39367270469666,312.9768486022949,9846,2721,7125,7125,0,14,3291000.0
3291,3291999,20.70110266739006,37.268699370930435,0.0647366369771728,463.7923686504364,213.46150660514832,313.0830307006836,9848,2722,7126,7126,0,14,3292000.0
3292,3292999,20.702302299589515,37.271152249733596,0.06471590648010395,463.9415900707245,213.52741765975952,313.1090621948242,9853,2723,7130,7130,0,14,3293000.0
3293,3293999,20.70353509850824,37.27699326905194,0.06467982876010803,464.0955319404602,213.5935616493225,313.1583251953125,9855,2724,7131,7131,0,14,3294000.0
3294,3294999,20.703873948862263,37.27549569476389,0.0646678683607621,464.2692229747772,213.6603901386261,313.1768264770508,9859,2726,7133,7133,0,14,3295000.0
3295,3295999,20.703307457693715,37.2743753054453,0.06464549168173261,464.3921341896057,213.72772359848022,313.7478446960449,9877,2726,7151,7151,0,14,3296000.0
3296,3296999,20.702720602197623,37.27372093692221,0.06464119351594133,464.50457406044006,213.79261183738708,314.28054428100586,9883,2726,7157,7157,0,14,3297000.0
3297,3297999,20.7022426246108,37.27186154343634,0.06464149673129538,464.6186683177948,213.8569896221161,314.540584564209,9883,2726,7157,7157,0,14,3298000.0
3298,3298999,20.701840852451856,37.27003146545744,0.06464393658009637,464.81203866004944,213.92260265350342,314.66943359375,9889,2729,7160,7160,0,14,3299000.0
3299,3299999,20.70151827326409,37.26907851963831,0.06464038314454945,464.976681470871,213.988343000412,314.8049087524414,9896,2731,7165,7165,0,14,3300000.0
3300,3300999,20.70101784966898,37.267532333424015,0.06464621557420192,465.19026231765747,214.05431652069092,314.8063545227051,9904,2735,7169,7169,0,14,3301000.0
3301,3301999,20.701191520388264,37.26684327127345,0.06464452309865265,465.355836391449,214.12045884132385,314.93542861938477,9908,2737,7171,7171,0,14,3302000.0
3302,3302999,20.70123930017417,37.26541463732019,0.06464756321007603,465.4782826900482,214.18643641471863,315.1170845031738,9908,2737,7171,7171,0,14,3303000.0
3303,3303999,20.70205100309395,37.267357031607,0.06467101337223513,465.6494674682617,214.25238752365112,315.15393829345703,9912,2739,7173,7173,0,14,3304000.0
3304,3304999,20.702549200765006,37.26906836810727,0.06467718777641696,465.8149952888489,214.31858491897583,315.17173767089844,9916,2741,7175,7175,0,14,3305000.0
3305,3305999,20.704557418761848,37.27932187819913,0.06469966762981849,465.98744893074036,214.3851420879364,315.3672332763672,9918,2742,7176,7176,0,14,3306000.0
3306,3306999,20.708081575797856,37.28990633575761,0.06477691003268415,466.1118264198303,214.4509859085083,315.50014877319336,9918,2742,7176,7176,0,14,3307000.0
3307,3307999,20.710989701891968,37.29724368796223,0.06486575486001267,466.276193857193,214.51752638816833,315.5556106567383,9922,2744,7178,7178,0,14,3308000.0
3308,3308999,20.714247846639044,37.30424839918191,0.06499072791904803,466.41902136802673,214.58359456062317,315.6848564147949,9924,2745,7179,7179,0,14,3309000.0
3309,3309999,20.717413603510355,37.31020052922888,0.06509551104620548,466.5483889579773,214.64969444274902,315.7866744995117,9924,2745,7179,7179,0,14,3310000.0
3310,3310999,20.720080714695023,37.31447247953325,0.06517143400817293,466.6850118637085,214.7160358428955,315.8895263671875,9924,2745,7179,7179,0,14,3311000.0
3311,3311999,20.723487073552104,37.320531472123314,0.06529995863411808,466.8132474422455,214.7818911075592,315.9929542541504,9924,2745,7179,7179,0,14,3312000.0
3312,3312999,20.72592602837121,37.32377748695598,0.0653774349363877,466.9428770542145,214.84824967384338,316.05613708496094,9924,2745,7179,7179,0,14,3313000.0
3313,3313999,20.727790651400163,37.325225674481416,0.06542106617303867,467.07153129577637,214.91423177719116,316.13887786865234,9924,2745,7179,7179,0,14,3314000.0
3314,3314999,20.727892874529342,37.325954589819446,0.0653971675888726,467.19806265830994,216.16239404678345,316.88591384887695,9948,2745,7203,7203,0,14,3315000.0
3315,3315999,20.726800962991586,37.325255035033976,0.06538665692737333,467.312824010849,216.22788166999817,317.2778511047363,9948,2745,7203,7203,0,14,3316000.0
3316,3316999,20.72551549633756,37.32352583151348,0.06539329451677112,467.42963337898254,216.29324555397034,317.48633193969727,9948,2745,7203,7203,0,14,3317000.0
3317,3317999,20.72475967516603,37.324150145626405,0.06539182931214393,467.6005039215088,216.3591914176941,317.5884552001953,9952,2747,7205,7205,0,14,3318000.0
3318,3318999,20.72477663768077,37.324307572326,0.06540035827756485,467.74918389320374,216.42558407783508,317.75585556030273,9954,2748,7206,7206,0,14,3319000.0
3319,3319999,20.724285437209534,37.32539681734441,0.06542733755986108,468.0045714378357,216.49262404441833,317.7175827026367,9964,2753,7211,7211,0,14,3320000.0
3320,3320999,20.724085273842807,37.32653789809674,0.06544925406789814,468.1826994419098,216.5591585636139,317.8140678405762,9968,2755,7213,7213,0,14,3321000.0
3321,3321999,20.724670300189008,37.3284373127616,0.06547747292448902,468.3830108642578,216.62645936012268,317.9048538208008,9974,2758,7216,7216,0,14,3322000.0
3322,3322999,20.724696150202192,37.32823056432389,0.06552907372501182,468.55264830589294,216.69318318367004,318.0476531982422,9978,2760,7218,7218,0,14,3323000.0
3323,3323999,20.725495508735484,37.33006896166951,0.06559135355519108,468.7301049232483,216.75990390777588,318.137752532959,9982,2762,7220,7220,0,14,3324000.0
3324,3324999,20.726715590275997,37.332482591647704,0.06563372331124895,468.9247057437897,216.83567643165588,318.20053482055664,9986,2764,7222,7222,0,14,3325000.0
3325,3325999,20.72825364728281,37.33437068203062,0.06569848594505812,469.0833201408386,216.9021623134613,318.29341888427734,9988,2765,7223,7223,0,14,3326000.0
3326,3326999,20.730236331094595,37.343001757576104,0.06574651969097811,469.21426010131836,216.9684398174286,318.39839935302734,9988,2765,7223,7223,0,14,3327000.0
3327,3327999,20.732047390920375,37.34798161044998,0.06580958790521474,469.3640863895416,217.03500747680664,318.4991455078125,9990,2766,7224,7224,0,14,3328000.0
3328,3328999,20.734293469346305,37.35444415568575,0.06589204771829948,469.53131771087646,217.10222029685974,318.5391960144043,9992,2767,7225,7225,0,14,3329000.0
3329,3329999,20.736479992403854,37.35723756833994,0.06593024031843642,469.66470432281494,217.16854453086853,318.6310806274414,9992,2767,7225,7225,0,14,3330000.0
3330,3330999,20.738902698792923,37.36220439558188,0.06600662982456962,469.79629492759705,217.2371370792389,318.73261642456055,9992,2767,7225,7225,0,14,3331000.0
3331,3331999,20.74095875962644,37.36513651891839,0.0660307370326052,469.92375016212463,217.30333137512207,318.8060302734375,9992,2767,7225,7225,0,14,3332000.0
3332,3332999,20.743393887579767,37.37097055767139,0.06604336878190542,470.0878064632416,217.37080216407776,318.7996711730957,9997,2768,7229,7229,0,14,3333000.0
3333,3333999,20.74502499442122,37.37231914381585,0.06609431783110387,470.23919796943665,217.44083976745605,318.92296981811523,9997,2768,7229,7229,0,14,3334000.0
3334,3334999,20.745948056105238,37.37656745955825,0.06608240477558636,470.4059581756592,217.50731110572815,319.28433990478516,10011,2769,7242,7242,0,14,3335000.0
3335,3335999,20.744681322815723,37.37502918955697,0.06606969904744031,470.53850197792053,217.57346773147583,319.65069580078125,10015,2769,7246,7246,0,14,3336000.0
3336,3336999,20.74280399163543,37.37183455806353,0.06606913546839344,470.65749955177307,217.63830018043518,319.86137771606445,10016,2769,7247,7247,0,14,3337000.0
3337,3337999,20.74106650892941,37.36849269673374,0.0660643989345504,470.83281207084656,217.70348596572876,319.89949798583984,10020,2771,7249,7249,0,14,3338000.0
3338,3338999,20.739888913089054,37.36682909098735,0.06605473831769226,470.9951961040497,217.7691731452942,320.02613830566406,10022,2772,7250,7250,0,14,3339000.0
3339,3339999,20.738292898430533,37.36356023032673,0.0660448256147469,471.20675015449524,217.83624458312988,320.02766036987305,10030,2776,7254,7254,0,14,3340000.0
3340,3340999,20.737276555645057,37.36231770981032,0.06602987734454135,471.3222146034241,217.9019923210144,320.23834228515625,10030,2776,7254,7254,0,14,3341000.0
3341,3341999,20.736207011590686,37.35996001241448,0.06601412450687993,471.471533536911,217.96778297424316,320.31190490722656,10032,2777,7255,7255,0,14,3342000.0
3342,3342999,20.735475109315058,37.3577835864026,0.06599625130271958,471.6291694641113,218.03406810760498,320.437686920166,10035,2778,7257,7257,0,14,3343000.0
3343,3343999,20.735438354420708,37.35770511578752,0.06598329542891046,471.77237129211426,218.10037803649902,320.5315971374512,10035,2778,7257,7257,0,14,3344000.0
3344,3344999,20.735488826260298,37.35717173788807,0.06596350786719085,471.9114468097687,218.16659212112427,320.5927391052246,10035,2778,7257,7257,0,14,3345000.0
3345,3345999,20.736733428685305,37.360552986422825,0.06593966474590329,472.0573592185974,218.23269176483154,320.67126083374023,10035,2778,7257,7257,0,14,3346000.0
3346,3346999,20.739057502032352,37.36626380679763,0.06591437602252193,472.2026615142822,218.2988269329071,320.7275085449219,10035,2778,7257,7257,0,14,3347000.0
3347,3347999,20.741511275117027,37.37092513118237,0.06589795279939192,472.3758547306061,218.37141370773315,320.7609405517578,10037,2779,7258,7258,0,14,3348000.0
3348,3348999,20.744441853187514,37.37684171621319,0.0658842053373837,472.49840569496155,218.43738412857056,320.83666229248047,10037,2779,7258,7258,0,14,3349000.0
3349,3349999,20.74843312611649,37.38608478160867,0.06587279346339414,472.7145400047302,218.5041675567627,320.6998062133789,10047,2782,7265,7265,0,14,3350000.0
3350,3350999,20.75310631140649,37.39560690885965,0.0658731699287648,472.83157324790955,218.5701093673706,320.78515243530273,10047,2782,7265,7265,0,14,3351000.0
3351,3351999,20.757832426331305,37.41190098459852,0.06587085083729016,473.01232409477234,218.6364631652832,320.7823677062988,10051,2784,7267,7267,0,14,3352000.0
3352,3352999,20.761413813354242,37.41900402672095,0.06588909753820738,473.15998911857605,218.70334315299988,320.8606262207031,10051,2784,7267,7267,0,14,3353000.0
3353,3353999,20.76525953577352,37.42663453126264,0.06590938609766728,473.2940607070923,218.77001929283142,320.91332244873047,10051,2784,7267,7267,0,14,3354000.0
3354,3354999,20.767369172068147,37.4285911351569,0.06595433001411377,473.46162605285645,218.83671402931213,320.94360733032227,10053,2785,7268,7268,0,14,3355000.0
3355,3355999,20.768372169743746,37.42983370356558,0.06594145510217075,473.68443298339844,218.90490007400513,321.13977432250977,10072,2788,7284,7284,0,14,3356000.0
3356,3356999,20.76751282183141,37.428247758249604,0.06592470674250916,473.8080880641937,218.9713122844696,321.71607971191406,10086,2788,7298,7298,0,14,3357000.0
3357,3357999,20.76669794505559,37.4289920519504,0.06590862555967703,473.93111991882324,219.03842043876648,321.98636627197266,10086,2788,7298,7298,0,14,3358000.0
3358,3358999,20.76576908109992,37.42766381351778,0.0659010337997693,474.1343340873718,219.1048948764801,321.9893608093262,10092,2791,7301,7301,0,14,3359000.0
3359,3359999,20.764407469049374,37.424590667575835,0.06589675639318227,474.3052248954773,219.17136883735657,322.1761932373047,10096,2793,7303,7303,0,14,3360000.0
3360,3360999,20.763340886870836,37.42197130999759,0.06588589456070426,474.4970784187317,219.23819303512573,322.3083267211914,10103,2795,7308,7308,0,14,3361000.0
3361,3361999,20.76281567097937,37.42025314277614,0.06587721587040452,474.6172194480896,219.30627965927124,322.4923629760742,10103,2795,7308,7308,0,14,3362000.0
3362,3362999,20.762044275736482,37.41801032695923,0.06587161469072844,474.7540752887726,219.3724126815796,322.5969581604004,10103,2795,7308,7308,0,14,3363000.0
3363,3363999,20.761570904462957,37.41786688434121,0.06585521550516815,474.9053349494934,219.438494682312,322.68656158447266,10105,2796,7309,7309,0,14,3364000.0
3364,3364999,20.760794259206826,37.41622032035404,0.06584664316610367,475.06762981414795,219.50462317466736,322.71600341796875,10107,2797,7310,7310,0,14,3365000.0
3365,3365999,20.76061998370124,37.415042676691314,0.06583412209891704,475.2054488658905,219.57044076919556,322.81341552734375,10107,2797,7310,7310,0,14,3366000.0
3366,3366999,20.761684206421307,37.421783121280285,0.06579578599375402,475.387900352478,219.63688850402832,322.7879333496094,10117,2799,7318,7318,0,14,3367000.0
3367,3367999,20.764192916964497,37.431448932325964,0.0657512940507915,475.5177044868469,219.70295524597168,322.8760299682617,10117,2799,7318,7318,0,14,3368000.0
3368,3368999,20.768158932417307,37.439947080915736,0.06572679891561006,475.68337225914,219.76904678344727,322.9017677307129,10119,2800,7319,7319,0,14,3369000.0
3369,3369999,20.772516220747566,37.45224807514699,0.06569760123288826,475.8298497200012,219.8353476524353,322.9692573547363,10121,2801,7320,7320,0,14,3370000.0
3370,3370999,20.77945272474413,37.47367611906088,0.06567381455201449,475.9859278202057,219.90167260169983,323.0092086791992,10123,2802,7321,7321,0,14,3371000.0
3371,3371999,20.788676032843895,37.50045514016136,0.06570179405044396,476.19880509376526,219.96819758415222,322.93241119384766,10132,2805,7327,7327,0,14,3372000.0
3372,3372999,20.798040715421095,37.52814510977054,0.0657403037243589,476.335964679718,220.0343463420868,323.052490234375,10132,2805,7327,7327,0,14,3373000.0
3373,3373999,20.80700240000638,37.55115139948793,0.06578378776392546,476.5041308403015,220.10095643997192,323.04806900024414,10134,2806,7328,7328,0,14,3374000.0
3374,3374999,20.81566260435949,37.569773994842286,0.06588529745644012,476.6604242324829,220.1673400402069,323.07583236694336,10136,2807,7329,7329,0,14,3375000.0
3375,3375999,20.82327688823035,37.58612787548504,0.06597589345652444,476.7968716621399,220.2362835407257,323.22624588012695,10136,2807,7329,7329,0,14,3376000.0
3376,3376999,20.826841350428616,37.59313809009779,0.06601166418804483,476.9251992702484,220.30262994766235,323.82897186279297,10152,2807,7345,7345,0,14,3377000.0
3377,3377999,20.826509909993597,37.59350923654092,0.06599136935276795,477.04391622543335,220.36767649650574,324.09125900268555,10152,2807,7345,7345,0,14,3378000.0
3378,3378999,20.826249146801608,37.594509621235616,0.06597391875879022,477.1719970703125,220.43200707435608,324.27412033081055,10152,2807,7345,7345,0,14,3379000.0
3379,3379999,20.827417859642384,37.59922712096392,0.06595405534752719,477.36914110183716,220.497798204422,324.2728042602539,10158,2810,7348,7348,0,14,3380000.0
3380,3380999,20.828410713873975,37.60638236951327,0.06592108299018107,477.54387402534485,220.56392288208008,324.3836860656738,10162,2812,7350,7350,0,14,3381000.0
3381,3381999,20.828862607089064,37.606617580844194,0.06592419929425564,477.7369306087494,220.62957334518433,324.45592880249023,10168,2815,7353,7353,0,14,3382000.0
3382,3382999,20.829899667384517,37.608269505084436,0.06595584406475408,477.8852746486664,220.69565653800964,324.58026123046875,10170,2816,7354,7354,0,14,3383000.0
3383,3383999,20.83089407625558,37.608680004671996,0.06598779911817132,478.0386655330658,220.76158714294434,324.69937896728516,10172,2817,7355,7355,0,14,3384000.0
3384,3384999,20.831593383375512,37.60913752153483,0.06600615284917222,478.1678783893585,220.82722783088684,324.81461334228516,10172,2817,7355,7355,0,14,3385000.0
3385,3385999,20.831850817143966,37.60906196553435,0.06601669918038777,478.3147964477539,220.89269709587097,324.8690414428711,10178,2818,7360,7360,0,14,3386000.0
3386,3386999,20.832959007397058,37.609900172535184,0.06604683859657146,478.47717809677124,220.95866775512695,324.8982162475586,10180,2819,7361,7361,0,14,3387000.0
3387,3387999,20.83337505105675,37.60918698225436,0.06605961784429926,478.6146094799042,221.02411723136902,324.9793395996094,10180,2819,7361,7361,0,14,3388000.0
3388,3388999,20.834548892044392,37.61089337323819,0.06606663568844284,478.76166558265686,221.0895893573761,324.99717712402344,10182,2820,7362,7362,0,14,3389000.0
3389,3389999,20.83548658683064,37.6117955108858,0.06610522322858159,478.9154598712921,221.1551148891449,324.9534721374512,10184,2821,7363,7363,0,14,3390000.0
3390,3390999,20.836414367523748,37.61202805654241,0.06611206470699671,479.05899691581726,221.22257018089294,325.0794105529785,10184,2821,7363,7363,0,14,3391000.0
3391,3391999,20.838011321699607,37.61552173254787,0.06613401209885172,479.21758818626404,221.28862166404724,325.0426254272461,10190,2822,7368,7368,0,14,3392000.0
3392,3392999,20.83930518810099,37.616269250197504,0.06615127350152739,479.34885931015015,221.3543140888214,325.10013580322266,10190,2822,7368,7368,0,14,3393000.0
3393,3393999,20.840574588977233,37.61717190586629,0.06615576132368506,479.4742214679718,221.4198386669159,325.1809310913086,10190,2822,7368,7368,0,14,3394000.0
3394,3394999,20.841567739500977,37.61707850957502,0.06615337341778704,479.6120913028717,221.48580265045166,325.2372055053711,10190,2822,7368,7368,0,14,3395000.0
3395,3395999,20.842594745746577,37.61616905865367,0.06617541510352765,479.793728351593,221.55219769477844,325.22412490844727,10192,2823,7369,7369,0,14,3396000.0
3396,3396999,20.84291195775119,37.61710107281616,0.06618478745418566,479.90955233573914,221.6181402206421,325.30187225341797,10192,2823,7369,7369,0,14,3397000.0
3397,3397999,20.842740462344768,37.61985086215214,0.0661606222325577,480.06142234802246,221.6847379207611,325.7150459289551,10212,2824,7388,7388,0,14,3398000.0
3398,3398999,20.84156597205496,37.6196847695271,0.06614047541842005,480.18180227279663,221.74992847442627,326.05773544311523,10215,2824,7391,7391,0,14,3399000.0
3399,3399999,20.839452267720247,37.61623453047934,0.0661425385729888,480.34654092788696,221.81535649299622,326.1738471984863,10223,2826,7397,7397,0,14,3400000.0
3400,3400999,20.837356920928418,37.61355807933595,0.06614562431616655,480.4961767196655,221.8815221786499,326.28310775756836,10225,2827,7398,7398,0,14,3401000.0
3401,3401999,20.835373781679873,37.61023575905388,0.0661464733650109,480.68210315704346,221.94704127311707,326.2794303894043,10231,2830,7401,7401,0,14,3402000.0
3402,3402999,20.833444163682532,37.608195999563115,0.06614500119121836,480.83041286468506,222.01286363601685,326.51774978637695,10234,2831,7403,7403,0,14,3403000.0
3403,3403999,20.831358065217287,37.60458638127152,0.06614694803350785,480.9750065803528,222.0786759853363,326.63217544555664,10236,2832,7404,7404,0,14,3404000.0
3404,3404999,20.829131837519654,37.60084888201184,0.06615257847305889,481.1613657474518,222.1447570323944,326.6797409057617,10243,2834,7409,7409,0,14,3405000.0
3405,3405999,20.826864870402844,37.596853733571976,0.06615427481106173,481.34600949287415,222.21991109848022,326.76300048828125,10252,2836,7416,7416,0,14,3406000.0
3406,3406999,20.825830129505917,37.59568997310332,0.06614017932062599,481.504412651062,222.28667950630188,326.84110260009766,10254,2837,7417,7417,0,14,3407000.0
3407,3407999,20.824779596474812,37.59322020797943,0.06612714933440511,481.62742471694946,222.35255122184753,326.9718933105469,10254,2837,7417,7417,0,14,3408000.0
3408,3408999,20.82383478259847,37.59094057948693,0.06610986316014844,481.81346106529236,222.41896224021912,327.0041198730469,10258,2839,7419,7419,0,14,3409000.0
3409,3409999,20.82366962327535,37.59172140452977,0.0660836622164821,481.95650362968445,222.4853711128235,327.1012954711914,10260,2840,7420,7420,0,14,3410000.0
3410,3410999,20.82294704726004,37.590190938350695,0.06606449851197627,482.0787546634674,222.55239820480347,327.18499755859375,10260,2840,7420,7420,0,14,3411000.0
3411,3411999,20.823412120072312,37.59018445216643,0.06604211233611679,482.2601172924042,222.61942315101624,327.2679862976074,10262,2841,7421,7421,0,14,3412000.0
3412,3412999,20.824567290159223,37.59610052996776,0.06601146694894322,482.3911476135254,222.68632411956787,327.3660888671875,10262,2841,7421,7421,0,14,3413000.0
3413,3413999,20.826720585524917,37.60193998992053,0.06598782095384859,482.5417504310608,222.75252628326416,327.3947410583496,10264,2842,7422,7422,0,14,3414000.0
3414,3414999,20.830166619454133,37.61372933106505,0.06596430613452753,482.69137930870056,222.81898951530457,327.46595001220703,10266,2843,7423,7423,0,14,3415000.0
3415,3415999,20.833623007431214,37.62176854935093,0.065948837837557,482.8770444393158,222.88586974143982,327.50542068481445,10268,2844,7424,7424,0,14,3416000.0
3416,3416999,20.8374889490953,37.63142383221109,0.06591990955983973,483.018917798996,222.95226764678955,327.5061912536621,10270,2845,7425,7425,0,14,3417000.0
3417,3417999,20.84138370455095,37.640116708572045,0.06590093819557175,483.1523849964142,223.01888275146484,327.63982009887695,10270,2845,7425,7425,0,14,3418000.0
3418,3418999,20.843160127043056,37.643155536005175,0.06586241857064301,483.29533529281616,223.08468389511108,328.091365814209,10284,2845,7439,7439,0,14,3419000.0
3419,3419999,20.84171092204999,37.64226547938485,0.06584555875528308,483.4143736362457,223.1504988670349,328.5474967956543,10290,2845,7445,7445,0,14,3420000.0
3420,3420999,20.839942190549976,37.641499726576036,0.06583291641775058,483.5327136516571,223.21597361564636,328.77728271484375,10290,2845,7445,7445,0,14,3421000.0
3421,3421999,20.838614092186116,37.64053374565364,0.0658134670996986,483.6902678012848,223.2807788848877,328.8571662902832,10294,2847,7447,7447,0,14,3422000.0
3422,3422999,20.83694714717862,37.63779629774761,0.06580533366452623,483.8861744403839,223.34686183929443,328.87183380126953,10304,2850,7454,7454,0,14,3423000.0
3423,3423999,20.835356173146526,37.635003195909384,0.06578987607315356,484.1248757839203,223.41369795799255,328.96899795532227,10312,2854,7458,7458,0,14,3424000.0
3424,3424999,20.833589682063927,37.63180942499171,0.06578958039206484,484.3284387588501,223.48063111305237,329.01403045654297,10318,2857,7461,7461,0,14,3425000.0
3425,3425999,20.83191066164211,37.628899286240504,0.0657809949444712,484.47396183013916,223.54664945602417,329.1408996582031,10320,2858,7462,7462,0,14,3426000.0
3426,3426999,20.8305251585217,37.627093900921686,0.06577008309246701,484.5962872505188,223.6124906539917,329.33776092529297,10320,2858,7462,7462,0,14,3427000.0
3427,3427999,20.829213757411136,37.6242859729487,0.06576850071637952,484.77591013908386,223.67919540405273,329.3908233642578,10324,2860,7464,7464,0,14,3428000.0
3428,3428999,20.828255782117157,37.62601687311994,0.06575138396195446,484.9177074432373,223.74554109573364,329.52051162719727,10324,2860,7464,7464,0,14,3429000.0
3429,3429999,20.827676961240968,37.62458908265643,0.06573985212253308,485.038024187088,223.81117916107178,329.6408004760742,10324,2860,7464,7464,0,14,3430000.0
3430,3430999,20.826819241279967,37.6225738006811,0.06573454965024395,485.1745550632477,223.8769190311432,329.66176986694336,10326,2861,7465,7465,0,14,3431000.0
3431,3431999,20.826788612137637,37.62240353244845,0.06571838475989344,485.3227114677429,223.9434244632721,329.7293891906738,10326,2861,7465,7465,0,14,3432000.0
3432,3432999,20.827739015151174,37.62577645930641,0.06569628612948686,485.46211218833923,224.00943994522095,329.8082084655762,10326,2861,7465,7465,0,14,3433000.0
3433,3433999,20.82887844048586,37.62846243742201,0.06568323154021216,485.58385157585144,224.0752294063568,329.872127532959,10326,2861,7465,7465,0,14,3434000.0
3434,3434999,20.830255976354803,37.629885902457666,0.06566687814733108,485.7322177886963,224.1415774822235,329.91563415527344,10326,2861,7465,7465,0,14,3435000.0
3435,3435999,20.83159942794516,37.63076403640625,0.06566115694350494,485.9021408557892,224.2082233428955,329.9062309265137,10330,2863,7467,7467,0,14,3436000.0
3436,3436999,20.833468988052243,37.63263972831784,0.06565809297111114,486.0357596874237,224.2739725112915,329.9978370666504,10330,2863,7467,7467,0,14,3437000.0
3437,3437999,20.835335863018557,37.63675678750916,0.06565756470311745,486.19803738594055,224.3400444984436,330.04307556152344,10330,2863,7467,7467,0,14,3438000.0
3438,3438999,20.836765372874602,37.637109366532584,0.06566598271000101,486.31979513168335,224.40614914894104,330.1052055358887,10330,2863,7467,7467,0,14,3439000.0
3439,3439999,20.836989684184818,37.63568504832297,0.06566429477039482,486.47329902648926,224.47196006774902,330.11033630371094,10336,2864,7472,7472,0,14,3440000.0
3440,3440999,20.835253196523713,37.63285471417004,0.06566194156736671,486.59303855895996,224.53814840316772,331.07703018188477,10365,2864,7501,7501,0,14,3441000.0
3441,3441999,20.832906251725827,37.62916266039017,0.06567478087420575,486.70666575431824,224.602703332901,331.46179962158203,10367,2864,7503,7503,0,14,3442000.0
3442,3442999,20.830699757306995,37.62551186390585,0.06568817206571209,486.86669158935547,224.66764092445374,331.6020851135254,10371,2866,7505,7505,0,14,3443000.0
3443,3443999,20.82847209539004,37.62195558421752,0.06569408698541745,487.02755999565125,224.73247933387756,331.7501983642578,10375,2868,7507,7507,0,14,3444000.0
3444,3444999,20.826312363003368,37.61929067917355,0.06569753458034222,487.19274377822876,224.80418395996094,331.9555435180664,10377,2869,7508,7508,0,14,3445000.0
3445,3445999,20.82439439108043,37.61735205699914,0.06569543777506137,487.36639499664307,224.8701512813568,332.04273223876953,10381,2871,7510,7510,0,14,3446000.0
3446,3446999,20.82229389012693,37.61423169864809,0.06569987266077693,487.4842166900635,224.93645477294922,332.21316146850586,10381,2871,7510,7510,0,14,3447000.0
3447,3447999,20.8203752870695,37.613542230048076,0.06568941500944658,487.63803482055664,225.00181484222412,332.3054885864258,10383,2872,7511,7511,0,14,3448000.0
3448,3448999,20.818790571193006,37.61520642094563,0.06567558030847254,487.81362080574036,225.067400932312,332.37785720825195,10387,2874,7513,7513,0,14,3449000.0
3449,3449999,20.817178297169455,37.613825180915576,0.06567077637905083,488.0114252567291,225.13403224945068,332.38090896606445,10393,2877,7516,7516,0,14,3450000.0
3450,3450999,20.815956691124633,37.616958318119515,0.06564716327361986,488.1863088607788,225.19977593421936,332.440185546875,10397,2879,7518,7518,0,14,3451000.0
3451,3451999,20.814542147207383,37.614353646514786,0.06564407719762633,488.3438723087311,225.2668173313141,332.5023193359375,10399,2880,7519,7519,0,14,3452000.0
3452,3452999,20.81322282766373,37.61208387849343,0.06564095435835726,488.4968829154968,225.33332443237305,332.5839958190918,10417,2881,7536,7536,0,14,3453000.0
3453,3453999,20.81214014543093,37.60986737685334,0.06563705449441315,488.6686592102051,225.39934158325195,332.6111717224121,10425,2883,7542,7542,0,14,3454000.0
3454,3454999,20.810707142857805,37.606959414837014,0.06563803968214621,488.8052701950073,225.4651448726654,332.71197509765625,10425,2883,7542,7542,0,14,3455000.0
3455,3455999,20.80927755759773,37.603745790573264,0.06564135208395372,488.93031215667725,225.5304398536682,332.8205871582031,10425,2883,7542,7542,0,14,3456000.0
3456,3456999,20.807915808868522,37.60094937228856,0.06564358507519774,489.0938994884491,225.59697699546814,332.8750991821289,10427,2884,7543,7543,0,14,3457000.0
3457,3457999,20.806728814007258,37.597867982939334,0.06564789757075662,489.2076699733734,225.66264009475708,332.96883392333984,10427,2884,7543,7543,0,14,3458000.0
3458,3458999,20.805253349518043,37.59490475762444,0.06564740833983185,489.42125701904297,225.72911524772644,333.1133918762207,10442,2887,7555,7555,0,14,3459000.0
3459,3459999,20.803238966215293,37.59252117571597,0.06565127578065322,489.54466557502747,225.79482316970825,333.82670974731445,10457,2887,7570,7570,0,14,3460000.0
3460,3460999,20.80160222508933,37.59320510909443,0.06564618542088418,489.66773104667664,225.85960507392883,334.10597229003906,10457,2887,7570,7570,0,14,3461000.0
3461,3461999,20.799571060362755,37.590158538410726,0.06566157561320496,489.8095874786377,225.924325466156,334.2570610046387,10459,2888,7571,7571,0,14,3462000.0
3462,3462999,20.79734097634934,37.5864594791894,0.0656724673303618,489.9794042110443,225.99002861976624,334.3877182006836,10463,2890,7573,7573,0,14,3463000.0
3463,3463999,20.79572445542773,37.585402602115906,0.06566800805875117,490.1653482913971,226.0555648803711,334.47455978393555,10469,2893,7576,7576,0,14,3464000.0
3464,3464999,20.793765594471676,37.58271059552094,0.06567043692309638,490.3138177394867,226.12120270729065,334.57342529296875,10471,2894,7577,7577,0,14,3465000.0
3465,3465999,20.791859262263966,37.58013932786134,0.06566832447118531,490.46375584602356,226.18716502189636,334.69042587280273,10473,2895,7578,7578,0,14,3466000.0
3466,3466999,20.7903861319604,37.57753923748187,0.06566302357714016,490.62243723869324,226.2529947757721,334.8126525878906,10475,2896,7579,7579,0,14,3467000.0
3467,3467999,20.788969470971455,37.5748947604903,0.06565800601156246,490.78704476356506,226.3188374042511,334.8763961791992,10477,2897,7580,7580,0,14,3468000.0
3468,3468999,20.787455274958553,37.57227194854924,0.06565202634601319,490.9095952510834,226.38422465324402,335.0100517272949,10477,2897,7580,7580,0,14,3469000.0
3469,3469999,20.786643326134215,37.57455705300534,0.06562602288053665,491.0830852985382,226.4555847644806,335.05701065063477,10482,2898,7584,7584,0,14,3470000.0
3470,3470999,20.785996693722655,37.57442018608685,0.0656048688188069,491.21459698677063,226.52112317085266,335.140567779541,10482,2898,7584,7584,0,14,3471000.0
3471,3471999,20.785237849007185,37.57295304237693,0.06558635546520397,491.35921335220337,226.587007522583,335.1431694030762,10484,2899,7585,7585,0,14,3472000.0
3472,3472999,20.784713516882412,37.57100296351698,0.06557128273976465,491.5363428592682,226.6529746055603,335.08961486816406,10491,2901,7590,7590,0,14,3473000.0
3473,3473999,20.784135729814523,37.56937632388485,0.06555751647242347,491.72931122779846,226.71950364112854,335.08539962768555,10495,2903,7592,7592,0,14,3474000.0
3474,3474999,20.783937951710605,37.56839424039203,0.0655409793843873,491.87701439857483,226.78562140464783,335.14667892456055,10497,2904,7593,7593,0,14,3475000.0
3475,3475999,20.78416075677697,37.56820511208394,0.06552045232677595,492.00978112220764,226.85146975517273,335.2675361633301,10497,2904,7593,7593,0,14,3476000.0
3476,3476999,20.78419702563189,37.56705438569432,0.06550709310078184,492.16119480133057,226.9171540737152,335.26628494262695,10499,2905,7594,7594,0,14,3477000.0
3477,3477999,20.78418682242441,37.56595441936191,0.06549490120546664,492.31911182403564,226.982985496521,335.33140563964844,10501,2906,7595,7595,0,14,3478000.0
3478,3478999,20.783668391828122,37.563870428952036,0.06548359541913518,492.4560880661011,227.0498559474945,335.42890548706055,10501,2906,7595,7595,0,14,3479000.0
3479,3479999,20.782347737422413,37.56155453545293,0.06546074210814934,492.5771963596344,227.11644625663757,336.34647369384766,10530,2906,7624,7624,0,14,3480000.0
3480,3480999,20.779845878693507,37.557795764199604,0.06546642513688605,492.68637347221375,227.18153357505798,336.77159881591797,10533,2906,7627,7627,0,14,3481000.0
3481,3481999,20.777648902804312,37.55475504899094,0.06546748857478235,492.8195400238037,227.24639201164246,337.0582504272461,10536,2907,7629,7629,0,14,3482000.0
3482,3482999,20.776098541083567,37.55293815000142,0.06546017880238997,492.9826204776764,227.31184315681458,337.2426414489746,10540,2909,7631,7631,0,14,3483000.0
3483,3483999,20.774223778275466,37.551948668949954,0.06544845095006568,493.1430604457855,227.37748551368713,337.3633499145508,10544,2911,7633,7633,0,14,3484000.0
3484,3484999,20.772986301941426,37.55086491069543,0.06543425951346082,493.3790829181671,227.4437403678894,337.4564514160156,10554,2916,7638,7638,0,14,3485000.0
3485,3485999,20.771883178603417,37.548665820976794,0.06542793157468052,493.5217094421387,227.51000547409058,337.6371040344238,10556,2917,7639,7639,0,14,3486000.0
3486,3486999,20.771927891484946,37.549077153479566,0.06540361427423824,493.6976709365845,227.57648992538452,337.7725944519043,10560,2919,7641,7641,0,14,3487000.0
3487,3487999,20.77255771046504,37.55005561783099,0.06539116399190648,493.89152336120605,227.64352679252625,337.8201675415039,10566,2922,7644,7644,0,14,3488000.0
3488,3488999,20.77417417733619,37.5536333959427,0.06538361064415266,494.0367901325226,227.70961713790894,337.94323348999023,10568,2923,7645,7645,0,14,3489000.0
3489,3489999,20.77689933801418,37.560356933606066,0.06537515001454863,494.25762963294983,227.77653861045837,337.94161224365234,10576,2927,7649,7649,0,14,3490000.0
3490,3490999,20.780142252417328,37.56707970221741,0.06539205109468016,494.42998790740967,227.84361958503723,338.10076904296875,10580,2929,7651,7651,0,14,3491000.0
3491,3491999,20.78449772612777,37.57527930801892,0.06545659520140279,494.57558512687683,227.91084218025208,338.2382469177246,10582,2930,7652,7652,0,14,3492000.0
3492,3492999,20.78925601501365,37.58366347201014,0.06556238653910396,494.72579193115234,227.97864437103271,338.345027923584,10584,2931,7653,7653,0,14,3493000.0
3493,3493999,20.79403209650988,37.590913775498954,0.06569438480203671,494.92868971824646,228.04691863059998,338.34862518310547,10590,2934,7656,7656,0,14,3494000.0
3494,3494999,20.800229323243684,37.60283516758955,0.06589228191560259,495.08214116096497,228.11398839950562,338.4448699951172,10592,2935,7657,7657,0,14,3495000.0
3495,3495999,20.807238518880855,37.61544963073108,0.06613876196956592,495.21841311454773,228.18085312843323,338.65501403808594,10592,2935,7657,7657,0,14,3496000.0
3496,3496999,20.81334651067024,37.62635264982849,0.06638182039106766,495.35369849205017,228.24804043769836,338.77799224853516,10592,2935,7657,7657,0,14,3497000.0
3497,3497999,20.818279268107517,37.6354722750045,0.06654126388042014,495.5287368297577,228.31529545783997,338.76880645751953,10599,2937,7662,7662,0,14,3498000.0
3498,3498999,20.824326433191256,37.6441196847203,0.06677945444452105,495.65669107437134,228.38176679611206,338.9325065612793,10599,2937,7662,7662,0,14,3499000.0
3499,3499999,20.828870430951564,37.651697451985,0.06699291172654687,495.7844445705414,228.44828486442566,339.0794982910156,10599,2937,7662,7662,0,14,3500000.0
3500,3500999,20.827648625400517,37.64982800042391,0.06698001519144337,495.93587613105774,228.51432919502258,339.8949890136719,10629,2938,7691,7691,0,14,3501000.0
3501,3501999,20.826129864674098,37.647998950773555,0.06697664598181174,496.0578954219818,228.5797622203827,340.24684143066406,10631,2938,7693,7693,0,14,3502000.0
3502,3502999,20.825298156305156,37.64727402329387,0.0669672951301451,496.1996076107025,228.64520239830017,340.45169830322266,10633,2939,7694,7694,0,14,3503000.0
3503,3503999,20.824399987728793,37.64610221282272,0.06695979035707911,496.4127426147461,228.71123147010803,340.4672737121582,10641,2943,7698,7698,0,14,3504000.0
3504,3504999,20.822997682529287,37.644448714653734,0.06695253660562572,496.6034367084503,228.77744150161743,340.645320892334,10647,2946,7701,7701,0,14,3505000.0
3505,3505999,20.82193494990083,37.6424321579331,0.06695176583135476,496.7182743549347,228.84381580352783,340.8513717651367,10647,2946,7701,7701,0,14,3506000.0
3506,3506999,20.82106088816973,37.64366380375138,0.06693148211923372,496.84121203422546,228.90966057777405,340.9820899963379,10647,2946,7701,7701,0,14,3507000.0
3507,3507999,20.820594347584546,37.643378784364174,0.06692314988403436,496.9884693622589,228.97561764717102,341.1334800720215,10647,2946,7701,7701,0,14,3508000.0
3508,3508999,20.82008823021341,37.64255274955788,0.06692010161587103,497.11732172966003,229.04193139076233,341.2246208190918,10647,2946,7701,7701,0,14,3509000.0
3509,3509999,20.82209795150325,37.64999595236794,0.06691269980026215,497.2682499885559,229.10771894454956,341.25708770751953,10649,2947,7702,7702,0,14,3510000.0
3510,3510999,20.825544573588186,37.661472754475405,0.06691836449464528,497.5130019187927,229.17414450645447,341.13111114501953,10659,2952,7707,7707,0,14,3511000.0
3511,3511999,20.83122590025372,37.68059892626898,0.06702915223168815,497.63152289390564,229.24025988578796,341.3813934326172,10660,2952,7708,7708,0,14,3512000.0
3512,3512999,20.83606925739888,37.692832463053854,0.06711764124344877,497.8234040737152,229.30677914619446,341.3138885498047,10668,2954,7714,7714,0,14,3513000.0
3513,3513999,20.84154285480657,37.7081428814418,0.06722012349661033,498.03738141059875,229.3742744922638,341.36096954345703,10698,2957,7741,7741,0,14,3514000.0
3514,3514999,20.84686693782166,37.72654581066546,0.06734284558163728,498.23355412483215,229.44106936454773,341.41695404052734,10702,2959,7743,7743,0,14,3515000.0
3515,3515999,20.851346180874707,37.735481965178344,0.06744154496169319,498.37926387786865,229.50777316093445,341.4936103820801,10704,2960,7744,7744,0,14,3516000.0
3516,3516999,20.856494816670615,37.74684389966117,0.06753768714118757,498.52754759788513,229.57443594932556,341.60311126708984,10706,2961,7745,7745,0,14,3517000.0
3517,3517999,20.86132579322685,37.75670055471715,0.06764271451526183,498.6604309082031,229.64246344566345,341.76325607299805,10706,2961,7745,7745,0,14,3518000.0
3518,3518999,20.86550511307244,37.76340925605052,0.06773445905500464,498.7964732646942,229.70902681350708,341.8798141479492,10706,2961,7745,7745,0,14,3519000.0
3519,3519999,20.86831330844373,37.766930966213515,0.06778126776278304,498.9293260574341,229.77587914466858,341.99587631225586,10706,2961,7745,7745,0,14,3520000.0
3520,3520999,20.868022031362834,37.766300736216344,0.06777066237448848,499.047482252121,229.8420867919922,342.7765312194824,10728,2961,7767,7767,0,14,3521000.0
3521,3521999,20.86693951621986,37.76541130294014,0.06776286896430361,499.1599488258362,229.9066128730774,343.0975341796875,10728,2961,7767,7767,0,14,3522000.0
3522,3522999,20.86605852561609,37.765513395033395,0.06775722682112117,499.3067808151245,229.97191667556763,343.2913017272949,10731,2962,7769,7769,0,14,3523000.0
3523,3523999,20.865940696934658,37.768107586814565,0.06774856674825558,499.4690773487091,230.03753781318665,343.34793853759766,10735,2964,7771,7771,0,14,3524000.0
3524,3524999,20.865098219595474,37.76648029457003,0.06774523009553512,499.6409182548523,230.1026496887207,343.4603805541992,10739,2966,7773,7773,0,14,3525000.0
3525,3525999,20.86463960857712,37.76567303045523,0.06774613337236424,499.84280228614807,230.1685483455658,343.58017349243164,10745,2969,7776,7776,0,14,3526000.0
3526,3526999,20.86372560194761,37.76351595913151,0.06774674079620291,500.047860622406,230.23467683792114,343.60905838012695,10751,2972,7779,7779,0,14,3527000.0
3527,3527999,20.863117090972434,37.76215765314244,0.0677553096454454,500.17867827415466,230.30100774765015,343.8244934082031,10751,2972,7779,7779,0,14,3528000.0
3528,3528999,20.863423240648725,37.763704197677306,0.0677654391616247,500.3438186645508,230.3669033050537,343.8897476196289,10753,2973,7780,7780,0,14,3529000.0
3529,3529999,20.865848595985845,37.772541999174464,0.06776694054730015,500.46770787239075,230.4325306415558,344.02111053466797,10753,2973,7780,7780,0,14,3530000.0
3530,3530999,20.869101138879902,37.78076935304371,0.06777606646424639,500.59315371513367,230.4984393119812,344.13461685180664,10753,2973,7780,7780,0,14,3531000.0
3531,3531999,20.874339508969285,37.7970531337624,0.06779344796266773,500.70774245262146,230.56364107131958,344.21221923828125,10753,2973,7780,7780,0,14,3532000.0
3532,3532999,20.881247731629077,37.81527385037237,0.06782698141860133,500.9031319618225,230.63006114959717,344.1573028564453,10757,2975,7782,7782,0,14,3533000.0
3533,3533999,20.88900138425867,37.838492000590136,0.06795167596035079,501.0916383266449,230.6968321800232,344.13393783569336,10765,2977,7788,7788,0,14,3534000.0
3534,3534999,20.898716711754172,37.86937310207144,0.06811459138368436,501.28727316856384,230.76324892044067,344.0873107910156,10771,2980,7791,7791,0,14,3535000.0
3535,3535999,20.91035154381273,37.910005135465475,0.06829517579530031,501.4136984348297,230.82927918434143,344.23476791381836,10771,2980,7791,7791,0,14,3536000.0
3536,3536999,20.92177860220019,37.947030563908676,0.0684950056318906,501.57238578796387,230.89566469192505,344.3333206176758,10773,2981,7792,7792,0,14,3537000.0
3537,3537999,20.933749554518318,37.98091712683478,0.06873927506143862,501.7283568382263,230.96206259727478,344.3854446411133,10775,2982,7793,7793,0,14,3538000.0
3538,3538999,20.946795616389974,38.01514444665067,0.0690336997545764,501.86017656326294,231.02827954292297,344.5202980041504,10775,2982,7793,7793,0,14,3539000.0
3539,3539999,20.952917306873307,38.027474036584685,0.06915754755521908,501.9979155063629,231.09409976005554,344.9189147949219,10788,2982,7806,7806,0,14,3540000.0
3540,3540999,20.952080711064998,38.02730970456655,0.06913239141381,502.11123418807983,231.15926575660706,345.3615913391113,10794,2982,7812,7812,0,14,3541000.0
3541,3541999,20.951736010851615,38.0308770322666,0.06911568285208491,502.26355719566345,231.22526097297668,345.50630950927734,10800,2983,7817,7817,0,14,3542000.0
3542,3542999,20.952235865592275,38.03359607442011,0.06909161524083363,502.41328740119934,231.2901976108551,345.6009292602539,10802,2984,7818,7818,0,14,3543000.0
3543,3543999,20.952701353850735,38.035556538645686,0.06906549474018975,502.57582426071167,231.3556580543518,345.68802642822266,10804,2985,7819,7819,0,14,3544000.0
3544,3544999,20.9533695439814,38.03846506647312,0.06904682292540631,502.7295262813568,231.42102432250977,345.7930221557617,10806,2986,7820,7820,0,14,3545000.0
3545,3545999,20.953186219627796,38.03757229150863,0.06903662944385103,502.8613181114197,231.48760437965393,345.9000816345215,10806,2986,7820,7820,0,14,3546000.0
3546,3546999,20.95378676351456,38.039126109323064,0.06902146222323224,503.0330991744995,231.55284929275513,345.9087142944336,10810,2988,7822,7822,0,14,3547000.0
3547,3547999,20.95449065509966,38.04031562593754,0.06900613150317092,503.16128396987915,231.61898732185364,346.0568199157715,10810,2988,7822,7822,0,14,3548000.0
3548,3548999,20.956209791603953,38.043897561308526,0.06898581086206934,503.3144340515137,231.6842815876007,346.0120544433594,10816,2989,7827,7827,0,14,3549000.0
3549,3549999,20.958329315735128,38.046889673791966,0.06898524061537958,503.5250005722046,231.75031876564026,345.88158798217773,10822,2992,7830,7830,0,14,3550000.0
3550,3550999,20.961100916124995,38.05453439210689,0.06898156042083248,503.658682346344,231.81780886650085,346.06396484375,10822,2992,7830,7830,0,14,3551000.0
3551,3551999,20.965433472042722,38.064323484344015,0.06897754882625373,503.7959234714508,231.88359236717224,346.1647644042969,10822,2992,7830,7830,0,14,3552000.0
3552,3552999,20.96992372832003,38.073361935588686,0.06899073703250758,503.9191825389862,231.94877910614014,346.2341079711914,10822,2992,7830,7830,0,14,3553000.0
3553,3553999,20.97483445475707,38.083859413416015,0.06902394177001603,504.099974155426,232.0146632194519,346.2548522949219,10828,2994,7834,7834,0,14,3554000.0
3554,3554999,20.98049706834812,38.10068646067116,0.06908949016892396,504.2318284511566,232.08018517494202,346.34445571899414,10828,2994,7834,7834,0,14,3555000.0
3555,3555999,20.988293243980337,38.119016597238634,0.06916258761969774,504.3634684085846,232.14573121070862,346.43584060668945,10828,2994,7834,7834,0,14,3556000.0
3556,3556999,20.995822605427612,38.140182419088,0.06922415510586422,504.49604535102844,232.21101713180542,346.5078773498535,10828,2994,7834,7834,0,14,3557000.0
3557,3557999,21.002383262321036,38.15597080956134,0.0692781868954554,504.6318814754486,232.27682185173035,346.55830001831055,10828,2994,7834,7834,0,14,3558000.0
3558,3558999,21.01287388544716,38.18427224363776,0.06934697475495988,504.745973110199,232.34222626686096,346.6255569458008,10828,2994,7834,7834,0,14,3559000.0
3559,3559999,21.020340651041078,38.199827611512774,0.06941847644618615,504.9120235443115,232.40772604942322,346.67906951904297,10830,2995,7835,7835,0,14,3560000.0
3560,3560999,21.02030074463681,38.200568156008785,0.0693914474667583,505.0663414001465,232.47395491600037,347.0862922668457,10838,2995,7843,7843,0,14,3561000.0
3561,3561999,21.019216574228228,38.200912442019096,0.06937255467577697,505.19603848457336,232.5385673046112,347.23374938964844,10838,2995,7843,7843,0,14,3562000.0
3562,3562999,21.018616800035716,38.200920311374176,0.06936248508284393,505.3436920642853,232.6038579940796,347.32725524902344,10844,2996,7848,7848,0,14,3563000.0
3563,3563999,21.018681463801883,38.20790153886007,0.06932265955840278,505.52233362197876,232.66886353492737,347.3209228515625,10848,2998,7850,7850,0,14,3564000.0
3564,3564999,21.017754920333495,38.20635053083071,0.0693111283336153,505.70438504219055,232.7345175743103,347.393497467041,10852,3000,7852,7852,0,14,3565000.0
3565,3565999,21.017211146360076,38.20497409710013,0.06929495514058237,505.87223863601685,232.7998149394989,347.47120666503906,10854,3001,7853,7853,0,14,3566000.0
3566,3566999,21.01624621479513,38.20454972977368,0.06927217602342128,506.0017976760864,232.86452054977417,347.55150604248047,10854,3001,7853,7853,0,14,3567000.0
3567,3567999,21.015682248844573,38.20256448229261,0.06926322253725414,506.1879119873047,232.9307894706726,347.54005432128906,10861,3003,7858,7858,0,14,3568000.0
3568,3568999,21.015057732112524,38.20062983385757,0.0692543171930543,506.35151720046997,232.9964816570282,347.5352592468262,10863,3004,7859,7859,0,14,3569000.0
3569,3569999,21.015475356749175,38.20283351614203,0.06922978443452954,506.4864993095398,233.06179285049438,347.6291389465332,10863,3004,7859,7859,0,14,3570000.0
3570,3570999,21.015554310278198,38.20198784799527,0.06921418280117708,506.6201162338257,233.12696981430054,347.70050048828125,10863,3004,7859,7859,0,14,3571000.0
3571,3571999,21.01562068219499,38.201280059327615,0.06919558951898419,506.74898052215576,233.19219255447388,347.75189208984375,10863,3004,7859,7859,0,14,3572000.0
3572,3572999,21.017088072817277,38.20533183936299,0.06917286976532522,506.88818979263306,233.25780820846558,347.7953796386719,10863,3004,7859,7859,0,14,3573000.0
3573,3573999,21.019095645398416,38.21072094533718,0.06915597440002652,507.02467131614685,233.32314157485962,347.8437843322754,10863,3004,7859,7859,0,14,3574000.0
3574,3574999,21.02138220957146,38.21446674632442,0.06914993553291848,507.1760516166687,233.38897347450256,347.88342666625977,10863,3004,7859,7859,0,14,3575000.0
3575,3575999,21.024321888059003,38.217654817384975,0.06913886667145364,507.30654740333557,233.4539134502411,347.9146919250488,10863,3004,7859,7859,0,14,3576000.0
3576,3576999,21.028164021982857,38.22667519050766,0.06912246019671608,507.4306004047394,233.5189893245697,347.95808029174805,10863,3004,7859,7859,0,14,3577000.0
3577,3577999,21.032297063879767,38.233090046990604,0.06913420857873931,507.57490730285645,233.58425116539001,347.9892272949219,10863,3004,7859,7859,0,14,3578000.0
3578,3578999,21.035364147975816,38.2370231780663,0.06914342147136099,507.71745324134827,233.64985156059265,348.00969314575195,10863,3004,7859,7859,0,14,3579000.0
3579,3579999,21.039561628129483,38.243471852494366,0.06915920283568544,507.8638861179352,233.71540069580078,348.0432929992676,10863,3004,7859,7859,0,14,3580000.0
3580,3580999,21.042002418143067,38.24917700151126,0.06917439668555336,507.98759508132935,233.78034162521362,348.0757865905762,10863,3004,7859,7859,0,14,3581000.0
3581,3581999,21.04113293048766,38.246841387905256,0.06916768442892829,508.1139693260193,233.84537148475647,348.47783279418945,10872,3004,7868,7868,0,14,3582000.0
3582,3582999,21.03957569459108,38.24422302724635,0.069164130902159,508.23879742622375,233.90966033935547,348.69572830200195,10873,3004,7869,7869,0,14,3583000.0
3583,3583999,21.038204947209316,38.24225316118378,0.06916413051555625,508.37233424186707,233.97437524795532,348.82961654663086,10873,3004,7869,7869,0,14,3584000.0
3584,3584999,21.03675495000592,38.23945368712899,0.06915907847413161,508.60803174972534,234.03989577293396,348.81419372558594,10881,3008,7873,7873,0,14,3585000.0
3585,3585999,21.03581420766516,38.238820921995575,0.06914166312289871,508.7663288116455,234.10598015785217,348.945369720459,10884,3009,7875,7875,0,14,3586000.0
3586,3586999,21.034882221806672,38.23711962745878,0.06912912928242942,508.9821367263794,234.17164492607117,348.947566986084,10894,3013,7881,7881,0,14,3587000.0
3587,3587999,21.033539238139507,38.234851721454085,0.06912231023044346,509.11783170700073,234.23699045181274,349.1006660461426,10894,3013,7881,7881,0,14,3588000.0
3588,3588999,21.032862161280597,38.2343284947233,0.06910840544712238,509.24060440063477,234.30270409584045,349.2035827636719,10894,3013,7881,7881,0,14,3589000.0
3589,3589999,21.03227646105482,38.232762971317285,0.06909554957733322,509.3987340927124,234.36819553375244,349.2303695678711,10896,3014,7882,7882,0,14,3590000.0
3590,3590999,21.03240760399488,38.236366132926356,0.06907022774687432,509.5580973625183,234.43392539024353,349.2106285095215,10901,3015,7886,7886,0,14,3591000.0
3591,3591999,21.032982771521112,38.23671743383836,0.06906486639466436,509.6890790462494,234.49912643432617,349.28579330444336,10901,3015,7886,7886,0,14,3592000.0
3592,3592999,21.033876127948027,38.23717153877105,0.06905790971385783,509.862606048584,234.56515336036682,349.25545501708984,10906,3016,7890,7890,0,14,3593000.0
3593,3593999,21.03528340162122,38.23824698890224,0.0690668896355896,510.00370144844055,234.63107538223267,349.3097839355469,10906,3016,7890,7890,0,14,3594000.0
3594,3594999,21.036098775818864,38.24131125996382,0.06905767679158259,510.1302659511566,234.69695520401,349.3824691772461,10906,3016,7890,7890,0,14,3595000.0
3595,3595999,21.038066826946253,38.24846116070822,0.06905163519261226,510.26575469970703,234.7625606060028,349.4333076477051,10906,3016,7890,7890,0,14,3596000.0
3596,3596999,21.039646080144937,38.25228815064128,0.06906470793983888,510.4249334335327,234.82844233512878,349.4234275817871,10908,3017,7891,7891,0,14,3597000.0
3597,3597999,21.04058222774345,38.25324862566384,0.06907289613538625,510.5634958744049,234.89443254470825,349.49143981933594,10908,3017,7891,7891,0,14,3598000.0
3598,3598999,21.041840830814788,38.254754260642386,0.06908803025961774,510.70013880729675,234.96065592765808,349.55418395996094,10908,3017,7891,7891,0,14,3599000.0
3599,3599999,21.044573547352655,38.25843381650221,0.0690741840992648,510.86305046081543,235.02585458755493,349.5944137573242,10912,3018,7894,7894,0,14,3600000.0
3600,3600999,21.04333487515966,38.25681411432514,0.06906170239002929,510.977646112442,235.08988881111145,350.4217758178711,10930,3018,7912,7912,0,14,3601000.0
3601,3601999,21.04145786925774,38.25538327384353,0.06906277180681242,511.0840473175049,235.15392875671387,350.74610900878906,10934,3018,7916,7916,0,14,3602000.0
3602,3602999,21.039665316627147,38.25239197237962,0.06906795522381992,511.26573944091797,235.21836495399475,350.9016532897949,10938,3020,7918,7918,0,14,3603000.0
3603,3603999,21.038056348683888,38.25046081340195,0.0690629623063167,511.4075536727905,235.2823567390442,351.1115951538086,10943,3021,7922,7922,0,14,3604000.0
3604,3604999,21.03671650069005,38.248500544553295,0.06906118470197864,511.59061551094055,235.3513743877411,351.1765670776367,10948,3023,7925,7925,0,14,3605000.0
3605,3605999,21.035463635165396,38.24710589385274,0.0690554407888394,511.83300137519836,235.41667532920837,351.14184188842773,10959,3028,7931,7931,0,14,3606000.0
3606,3606999,21.034390213604645,38.246722288351336,0.06904079152724474,512.0096004009247,235.48175406455994,351.34249114990234,10963,3030,7933,7933,0,14,3607000.0
3607,3607999,21.034196935736816,38.246769041094794,0.06902066696684128,512.1780519485474,235.54658150672913,351.4490661621094,10968,3032,7936,7936,0,14,3608000.0
3608,3608999,21.034568710495503,38.24779699204577,0.06900173926871045,512.3056879043579,235.61154103279114,351.6462097167969,10969,3032,7937,7937,0,14,3609000.0
3609,3609999,21.035299375194718,38.25029453580479,0.06898668907429284,512.5138893127441,235.6776258945465,351.5897674560547,10975,3035,7940,7940,0,14,3610000.0
3610,3610999,21.037367111775016,38.25474215687142,0.06899064611718275,512.6840989589691,235.74302458763123,351.709171295166,10979,3037,7942,7942,0,14,3611000.0
3611,3611999,21.040279578954195,38.26492946390698,0.0689915550272443,512.8073325157166,235.8084511756897,351.87556076049805,10979,3037,7942,7942,0,14,3612000.0
3612,3612999,21.044085134818296,38.27432565817842,0.06903951835333244,512.9434275627136,235.87507700920105,352.01063537597656,10979,3037,7942,7942,0,14,3613000.0
3613,3613999,21.047543977573856,38.28355898805359,0.06905993922370901,513.0721340179443,235.9401662349701,352.134578704834,10979,3037,7942,7942,0,14,3614000.0
3614,3614999,21.05248835384713,38.302235235177406,0.06911542452538255,513.253292798996,236.00566720962524,352.15348052978516,10983,3039,7944,7944,0,14,3615000.0
3615,3615999,21.05708468528053,38.312717400785,0.06919282091900603,513.3988769054413,236.07106518745422,352.2025718688965,10985,3040,7945,7945,0,14,3616000.0
3616,3616999,21.061468071340556,38.32470023742296,0.06929272409050813,513.5683677196503,236.13725996017456,352.2611389160156,10990,3041,7949,7949,0,14,3617000.0
3617,3617999,21.065424739095796,38.33304412141446,0.06936311718582,513.6957678794861,236.20284986495972,352.3774528503418,10990,3041,7949,7949,0,14,3618000.0
3618,3618999,21.06861666814509,38.33702504910135,0.06945992635027998,513.8194017410278,236.267982006073,352.4790573120117,10990,3041,7949,7949,0,14,3619000.0
3619,3619999,21.071623554318865,38.34235667297091,0.0695676785536069,513.9553778171539,236.33299851417542,352.58705139160156,10990,3041,7949,7949,0,14,3620000.0
3620,3620999,21.070723383359447,38.34036532256833,0.06956245672857497,514.0758650302887,236.3974847793579,353.3264923095703,11007,3041,7966,7966,0,14,3621000.0
3621,3621999,21.06931398044321,38.33933473532387,0.06956056107025532,514.2170281410217,236.46230936050415,353.5128707885742,11009,3042,7967,7967,0,14,3622000.0
3622,3622999,21.06834140360517,38.33906703215812,0.06955426210900029,514.3848190307617,236.5267252922058,353.6285514831543,11013,3044,7969,7969,0,14,3623000.0
3623,3623999,21.067281032221473,38.33754588979688,0.06956037864961573,514.5061118602753,236.59092211723328,353.8053665161133,11013,3044,7969,7969,0,14,3624000.0
3624,3624999,21.06609515729717,38.33526640614928,0.06957072912756856,514.680771112442,236.65561604499817,353.89929962158203,11017,3046,7971,7971,0,14,3625000.0
3625,3625999,21.06495003369829,38.33324604006941,0.06958609899942847,514.8243832588196,236.72003531455994,354.02895736694336,11019,3047,7972,7972,0,14,3626000.0
3626,3626999,21.06398088502178,38.33137565777818,0.0695975287047863,514.981208562851,236.78524088859558,354.109188079834,11021,3048,7973,7973,0,14,3627000.0
3627,3627999,21.06329990705441,38.33044730722624,0.0696073866961534,515.1676089763641,236.85000085830688,354.1384925842285,11025,3050,7975,7975,0,14,3628000.0
3628,3628999,21.063576621285712,38.332330249572564,0.0696124979865087,515.2824068069458,236.91448044776917,354.2623634338379,11025,3050,7975,7975,0,14,3629000.0
3629,3629999,21.06405584986171,38.337578543023625,0.06961025595877512,515.4058980941772,236.97888374328613,354.3434600830078,11025,3050,7975,7975,0,14,3630000.0
3630,3630999,21.06487139004713,38.339793990951705,0.06963373161112374,515.6188385486603,237.0443081855774,354.27400970458984,11031,3053,7978,7978,0,14,3631000.0
3631,3631999,21.066188248749683,38.341939944926274,0.069659044561304,515.7461421489716,237.10958051681519,354.39476776123047,11031,3053,7978,7978,0,14,3632000.0
3632,3632999,21.067271924405834,38.34336215322942,0.06968251185586083,515.907742023468,237.17445302009583,354.44596099853516,11033,3054,7979,7979,0,14,3633000.0
3633,3633999,21.068793910202636,38.345633305997275,0.06972828080077542,516.1098453998566,237.2397632598877,354.4857597351074,11056,3057,7999,7999,0,14,3634000.0
3634,3634999,21.07054217084056,38.351447626483406,0.06979082937798486,516.2673661708832,237.30503177642822,354.5302391052246,11058,3058,8000,8000,0,14,3635000.0
3635,3635999,21.072062951379433,38.35255961172071,0.06985369369174999,516.3917624950409,237.36975717544556,354.6535110473633,11058,3058,8000,8000,0,14,3636000.0
3636,3636999,21.073763526960658,38.354314773627216,0.06991947207530136,516.5468163490295,237.43513011932373,354.6952095031738,11060,3059,8001,8001,0,14,3637000.0
3637,3637999,21.074647295672975,38.35597807443996,0.06995642484193898,516.7137246131897,237.50018310546875,354.7278175354004,11062,3060,8002,8002,0,14,3638000.0
3638,3638999,21.076044117991255,38.35806550441592,0.0700105936650246,516.8725607395172,237.56536555290222,354.7973289489746,11064,3061,8003,8003,0,14,3639000.0
3639,3639999,21.076528198834584,38.36272402674873,0.07003037067816342,517.0039927959442,237.6316044330597,354.8870429992676,11064,3061,8003,8003,0,14,3640000.0
3640,3640999,21.075821179209616,38.35992877346402,0.07003806303632021,517.1775450706482,237.69619607925415,355.3587951660156,11082,3063,8019,8019,0,14,3641000.0
3641,3641999,21.074262925582794,38.3570051654923,0.07004135944681733,517.2885982990265,237.7607877254486,355.71538162231445,11082,3063,8019,8019,0,14,3642000.0
3642,3642999,21.07273517460662,38.35402764785579,0.07004550853142533,517.4280309677124,237.8249225616455,355.9652786254883,11086,3064,8022,8022,0,14,3643000.0
3643,3643999,21.0712007200402,38.350700741663815,0.07005647968660034,517.6057076454163,237.88971066474915,356.0612907409668,11090,3066,8024,8024,0,14,3644000.0
3644,3644999,21.06969210345028,38.34779189825584,0.07005800269579765,517.7766876220703,237.95507740974426,356.18553924560547,11094,3068,8026,8026,0,14,3645000.0
3645,3645999,21.06853807247206,38.34546712193182,0.0700502712807951,517.9565207958221,238.02000093460083,356.2179870605469,11098,3070,8028,8028,0,14,3646000.0
3646,3646999,21.066956607880343,38.34217707517635,0.07005013799934434,518.1061379909515,238.08489513397217,356.3614501953125,11100,3071,8029,8029,0,14,3647000.0
3647,3647999,21.0654853107916,38.34072362888008,0.07004123710494048,518.3114764690399,238.15002965927124,356.3180847167969,11110,3074,8036,8036,0,14,3648000.0
3648,3648999,21.063933113560218,38.33744727290669,0.07004662286097763,518.4417045116425,238.2151176929474,356.4915771484375,11110,3074,8036,8036,0,14,3649000.0
3649,3649999,21.062907776990475,38.33514726918493,0.0700404006446993,518.6197307109833,238.28043699264526,356.52573013305664,11114,3076,8038,8038,0,14,3650000.0
3650,3650999,21.061126381204296,38.331690797216105,0.07004578551253982,518.7465653419495,238.34530353546143,356.6677360534668,11114,3076,8038,8038,0,14,3651000.0
3651,3651999,21.060015345348962,38.3291712188174,0.07005107186672999,518.8731768131256,238.40972566604614,356.7676200866699,11114,3076,8038,8038,0,14,3652000.0
3652,3652999,21.059221096727292,38.32736796004703,0.07005970113313675,519.0024666786194,238.47445225715637,356.84554290771484,11114,3076,8038,8038,0,14,3653000.0
3653,3653999,21.059558935280858,38.32794525211969,0.07007327941641572,519.147931098938,238.53926181793213,356.9342727661133,11114,3076,8038,8038,0,14,3654000.0
3654,3654999,21.05952855107537,38.32687797842566,0.07009272511526621,519.2879521846771,238.60456776618958,356.95458221435547,11116,3077,8039,8039,0,14,3655000.0
3655,3655999,21.06013201748711,38.3273494088461,0.07010016146044429,519.4534997940063,238.66956901550293,356.9459419250488,11118,3078,8040,8040,0,14,3656000.0
3656,3656999,21.060757256940786,38.32876130301282,0.07012659861772597,519.5725493431091,238.73579168319702,357.06685638427734,11118,3078,8040,8040,0,14,3657000.0
3657,3657999,21.060791075095036,38.32865413711463,0.07015170278436411,519.7163524627686,238.80095529556274,357.1430358886719,11118,3078,8040,8040,0,14,3658000.0
3658,3658999,21.061119082066103,38.329689365767855,0.0701593569026111,519.8603665828705,238.86643075942993,357.21594619750977,11118,3078,8040,8040,0,14,3659000.0
3659,3659999,21.060428529168778,38.32765013040324,0.07017979783501238,519.9836671352386,238.93125247955322,357.2896308898926,11118,3078,8040,8040,0,14,3660000.0
3660,3660999,21.0599773338196,38.32770418789753,0.07010301640501049,520.137372970581,238.99620532989502,357.98120880126953,11141,3079,8062,8062,0,14,3661000.0
3661,3661999,21.05827837620549,38.32536249341072,0.0701153146257294,520.2443208694458,239.06092238426208,358.27285385131836,11141,3079,8062,8062,0,14,3662000.0
3662,3662999,21.056590632609424,38.323294692265776,0.07013151905288972,520.3845133781433,239.1254382133484,358.4212303161621,11147,3080,8067,8067,0,14,3663000.0
3663,3663999,21.054520418266822,38.31986559305296,0.07015286917779195,520.6679680347443,239.1912386417389,358.35342025756836,11163,3086,8077,8077,0,14,3664000.0
3664,3664999,21.05276916600468,38.316653129385145,0.07017170742243495,520.8582997322083,239.25783967971802,358.52997970581055,11169,3089,8080,8080,0,14,3665000.0
3665,3665999,21.05103808893529,38.313640986725794,0.07018474619140802,521.0311801433563,239.32365822792053,358.6438980102539,11173,3091,8082,8082,0,14,3666000.0
3666,3666999,21.049125880333875,38.31036181382177,0.07020389870058774,521.1780726909637,239.38947224617004,358.8090019226074,11175,3092,8083,8083,0,14,3667000.0
3667,3667999,21.047334021429474,38.30749859405028,0.07021969165098119,521.3276779651642,239.45582962036133,358.97861099243164,11177,3093,8084,8084,0,14,3668000.0
3668,3668999,21.046012162309818,38.30999585484533,0.07021316731041427,521.4779059886932,239.52154517173767,359.07938385009766,11179,3094,8085,8085,0,14,3669000.0
3669,3669999,21.0446768705736,38.3072786390243,0.07021546942340329,521.6038694381714,239.58671069145203,359.20296478271484,11179,3094,8085,8085,0,14,3670000.0
3670,3670999,21.043442136823582,38.30443873363415,0.07022477493838564,521.7474710941315,239.65202283859253,359.21118927001953,11181,3095,8086,8086,0,14,3671000.0
3671,3671999,21.041896869361807,38.301425733079746,0.07023413005432855,521.9172918796539,239.718665599823,359.25940704345703,11187,3096,8091,8091,0,14,3672000.0
3672,3672999,21.04095400991383,38.301372600607,0.07023301752377098,522.0518169403076,239.78417921066284,359.3731384277344,11187,3096,8091,8091,0,14,3673000.0
3673,3673999,21.04009534755444,38.299012853647625,0.07023545446117896,522.2028234004974,239.84964179992676,359.41490173339844,11189,3097,8092,8092,0,14,3674000.0
3674,3674999,21.039227980737728,38.29619015973874,0.07024999933538423,522.3332123756409,239.9154098033905,359.51736068725586,11189,3097,8092,8092,0,14,3675000.0
3675,3675999,21.03817139422458,38.29379578157481,0.07026255850617513,522.4794011116028,239.98282408714294,359.5866050720215,11189,3097,8092,8092,0,14,3676000.0
3676,3676999,21.037428049657848,38.2946026432914,0.07025600351761063,522.6068387031555,240.0479998588562,359.6718864440918,11189,3097,8092,8092,0,14,3677000.0
3677,3677999,21.035636029355242,38.29092163394012,0.07027133996209256,522.7685153484344,240.11334824562073,360.0499153137207,11207,3098,8109,8109,0,14,3678000.0
3678,3678999,21.0335463781493,38.287612547142075,0.07027184365704897,522.8756248950958,240.1781554222107,360.3438301086426,11207,3098,8109,8109,0,14,3679000.0
3679,3679999,21.03123094729308,38.28410674823027,0.0702770836711828,522.9914388656616,240.24280095100403,360.58081817626953,11208,3098,8110,8110,0,14,3680000.0
3680,3680999,21.02916693289939,38.28067354215757,0.07028405217235123,523.1939227581024,240.30870652198792,360.6953430175781,11214,3101,8113,8113,0,14,3681000.0
3681,3681999,21.027352019498313,38.277289408064,0.07028354607641107,523.3329064846039,240.37376356124878,360.8014793395996,11219,3102,8117,8117,0,14,3682000.0
3682,3682999,21.025692165132213,38.27533616252129,0.07028105813766816,523.5343868732452,240.43929839134216,360.86439514160156,11225,3105,8120,8120,0,14,3683000.0
3683,3683999,21.023868916421176,38.27189161799934,0.0702762516045724,523.6906950473785,240.5049023628235,360.9739074707031,11227,3106,8121,8121,0,14,3684000.0
3684,3684999,21.022533125112425,38.26950185241019,0.07026886761773077,523.9089922904968,240.57476615905762,360.95589447021484,11233,3109,8124,8124,0,14,3685000.0
3685,3685999,21.02114108585329,38.26683353724074,0.07026727701631375,524.0612485408783,240.64053392410278,361.09798431396484,11252,3110,8142,8142,0,14,3686000.0
3686,3686999,21.020092778877082,38.265263676999204,0.07025964320114042,524.1909928321838,240.70554614067078,361.2111167907715,11252,3110,8142,8142,0,14,3687000.0
3687,3687999,21.019172213566208,38.263019676303756,0.07025721427018883,524.3399038314819,240.77244544029236,361.2647285461426,11254,3111,8143,8143,0,14,3688000.0
3688,3688999,21.018618930259006,38.26175234522678,0.07025572944518121,524.5136363506317,240.83820509910583,361.28564834594727,11262,3113,8149,8149,0,14,3689000.0
3689,3689999,21.01873967258321,38.2632889503256,0.07023995752660128,524.6856017112732,240.90432596206665,361.3514060974121,11264,3114,8150,8150,0,14,3690000.0
3690,3690999,21.018586047825444,38.26253401937524,0.07023458241252212,524.8187294006348,240.97034454345703,361.46175384521484,11264,3114,8150,8150,0,14,3691000.0
3691,3691999,21.018747593015764,38.262456818576936,0.07022642994890216,524.9361426830292,241.0360391139984,361.5728759765625,11264,3114,8150,8150,0,14,3692000.0
3692,3692999,21.019268857472248,38.262091391653556,0.0702256096796331,525.1014220714569,241.10221886634827,361.6107978820801,11266,3115,8151,8151,0,14,3693000.0
3693,3693999,21.020013537678977,38.26419998626095,0.07022180109806242,525.2385745048523,241.1680281162262,361.71030044555664,11266,3115,8151,8151,0,14,3694000.0
3694,3694999,21.02020921715347,38.26312842154196,0.07023031437726235,525.3636257648468,241.23427391052246,361.7868881225586,11266,3115,8151,8151,0,14,3695000.0
3695,3695999,21.020718989707312,38.26196709879703,0.07022758816556107,525.5153951644897,241.3003590106964,361.8379783630371,11266,3115,8151,8151,0,14,3696000.0
3696,3696999,21.020676912166127,38.260686445115795,0.0702314764183275,525.6495645046234,241.3664083480835,361.9140396118164,11266,3115,8151,8151,0,14,3697000.0
3697,3697999,21.019428502409927,38.258410581548326,0.07023028861399483,525.771457195282,241.43173670768738,362.6445503234863,11288,3115,8173,8173,0,14,3698000.0
3698,3698999,21.016692140865896,38.254204867150165,0.07024722753310797,525.883627653122,241.4966688156128,363.2504463195801,11288,3115,8173,8173,0,14,3699000.0
3699,3699999,21.01444792730443,38.25128952143777,0.07025718182196183,525.9962899684906,241.5613079071045,363.62822341918945,11288,3115,8173,8173,0,14,3700000.0
3700,3700999,21.012194449154638,38.247559115975065,0.07027276797444526,526.1467735767365,241.62675523757935,363.819034576416,11291,3116,8175,8175,0,14,3701000.0
3701,3701999,21.009938560557107,38.24496902606607,0.07028028138172127,526.2910175323486,241.69232439994812,363.9658508300781,11293,3117,8176,8176,0,14,3702000.0
3702,3702999,21.007825179001355,38.24126042926931,0.07029167863257801,526.407454252243,241.75686979293823,364.1616325378418,11293,3117,8176,8176,0,14,3703000.0
3703,3703999,21.00591914392207,38.237753073511435,0.07029856539999124,526.5638446807861,241.82218885421753,364.243408203125,11295,3118,8177,8177,0,14,3704000.0
3704,3704999,21.00460857704506,38.23620284773258,0.07029395003636962,526.812691450119,241.8887140750885,364.20667266845703,11310,3123,8187,8187,0,14,3705000.0
3705,3705999,21.00392011989657,38.238018141603774,0.07027657085917016,526.9910981655121,241.95477175712585,364.29946517944336,11314,3125,8189,8189,0,14,3706000.0
3706,3706999,21.003049803387086,38.236746298083034,0.0702683787981987,527.1950404644012,242.02115488052368,364.3299980163574,11320,3128,8192,8192,0,14,3707000.0
3707,3707999,21.00315340471612,38.237041256656305,0.07027775898616939,527.3960189819336,242.0892026424408,364.34170150756836,11331,3131,8200,8200,0,14,3708000.0
3708,3708999,21.0033240457684,38.237851899222804,0.07028843602295554,527.5536389350891,242.1557252407074,364.50951385498047,11333,3132,8201,8201,0,14,3709000.0
3709,3709999,21.004161971644496,38.24414641582735,0.07026990604931671,527.7614505290985,242.22246980667114,364.5192642211914,11343,3135,8208,8208,0,14,3710000.0
3710,3710999,21.004770933205865,38.244644562970336,0.07026949718489794,527.9296450614929,242.28857135772705,364.55554962158203,11351,3137,8214,8214,0,14,3711000.0
3711,3711999,21.005747435844686,38.246605705176904,0.0702407097583615,528.0912487506866,242.35482168197632,364.6936378479004,11358,3138,8220,8220,0,14,3712000.0
3712,3712999,21.00627895642066,38.24645171147374,0.07024319970471804,528.2282516956329,242.42074465751648,364.7905731201172,11358,3138,8220,8220,0,14,3713000.0
3713,3713999,21.007649133507844,38.249658390426745,0.07023812386786654,528.3829832077026,242.48717761039734,364.8806915283203,11360,3139,8221,8221,0,14,3714000.0
3714,3714999,21.00880776075914,38.25072461533167,0.07022975659421637,528.5254354476929,242.5527069568634,364.96554946899414,11366,3140,8226,8226,0,14,3715000.0
3715,3715999,21.00978619730725,38.25100267357926,0.07022082363083648,528.7144455909729,242.61938619613647,364.8860282897949,11370,3142,8228,8228,0,14,3716000.0
3716,3716999,21.010376530687854,38.250687828711015,0.07021154129701801,528.8746726512909,242.68596601486206,365.0010528564453,11377,3143,8234,8234,0,14,3717000.0
3717,3717999,21.010103794128874,38.24910444339842,0.07019483197231935,529.0040998458862,242.75170016288757,365.1528511047363,11377,3143,8234,8234,0,14,3718000.0
3718,3718999,21.008621201868706,38.24810856900904,0.070191820012111,529.1811723709106,242.81703996658325,365.6189880371094,11400,3145,8255,8255,0,14,3719000.0
3719,3719999,21.006501204561456,38.24503222120135,0.07020533725617673,529.3765885829926,242.8824164867401,365.6886177062988,11414,3148,8266,8266,0,14,3720000.0
3720,3720999,21.004109674998226,38.241558006021556,0.07022342519819114,529.5244154930115,242.94760465621948,365.8387794494629,11417,3149,8268,8268,0,14,3721000.0
3721,3721999,21.002380102168964,38.238641722294616,0.07023118068679102,529.7455477714539,243.01329112052917,365.8383102416992,11425,3153,8272,8272,0,14,3722000.0
3722,3722999,21.0003024272669,38.2352487370708,0.07024170415920006,529.8621010780334,243.07866859436035,366.12915420532227,11425,3153,8272,8272,0,14,3723000.0
3723,3723999,20.998878396108413,38.23290616716159,0.07023881028323986,530.0512664318085,243.14461994171143,366.2133560180664,11429,3155,8274,8274,0,14,3724000.0
3724,3724999,20.997193549855,38.22989099685195,0.07024223337324487,530.1990313529968,243.21047949790955,366.31320571899414,11431,3156,8275,8275,0,14,3725000.0
3725,3725999,20.995553288925144,38.227433443082106,0.07024399997560005,530.3276345729828,243.27660274505615,366.45411682128906,11431,3156,8275,8275,0,14,3726000.0
3726,3726999,20.994552461509063,38.226090380132646,0.07023934684018751,530.5121309757233,243.34285140037537,366.47205352783203,11435,3158,8277,8277,0,14,3727000.0
3727,3727999,20.99331032439168,38.22366986992537,0.0702317394475338,530.6781170368195,243.4087278842926,366.5602493286133,11437,3159,8278,8278,0,14,3728000.0
3728,3728999,20.99208394233326,38.22129244429175,0.07022667145425598,530.8267562389374,243.47423768043518,366.6275291442871,11439,3160,8279,8279,0,14,3729000.0
3729,3729999,20.99142008988749,38.220012535039764,0.07021800537306111,530.9549889564514,243.5400414466858,366.72222900390625,11439,3160,8279,8279,0,14,3730000.0
3730,3730999,20.990423822364562,38.21757029336072,0.0702178448226064,531.0892548561096,243.60580253601074,366.7860527038574,11439,3160,8279,8279,0,14,3731000.0
3731,3731999,20.989615704391145,38.21620388340353,0.07021401052455767,531.212247133255,243.67304849624634,366.8783531188965,11439,3160,8279,8279,0,14,3732000.0
3732,3732999,20.98871719876345,38.21390676952684,0.0702081472879843,531.4626142978668,243.73952770233154,366.78290939331055,11451,3164,8287,8287,0,14,3733000.0
3733,3733999,20.988446281552754,38.214847450537725,0.07019243748319115,531.5892007350922,243.80499839782715,366.89739990234375,11451,3164,8287,8287,0,14,3734000.0
3734,3734999,20.98769698994598,38.212580320242225,0.07019060707628033,531.7509524822235,243.87093925476074,366.8930473327637,11458,3165,8293,8293,0,14,3735000.0
3735,3735999,20.986934391092465,38.20998147636383,0.07019364047948518,531.8949382305145,243.93678069114685,366.98973083496094,11458,3165,8293,8293,0,14,3736000.0
3736,3736999,20.98583605772735,38.20878842363004,0.07018078759455548,532.0779042243958,244.00220799446106,366.92382049560547,11462,3167,8295,8295,0,14,3737000.0
3737,3737999,20.984237201132316,38.20659249750539,0.07014884760697837,532.1999444961548,244.06839156150818,367.5376396179199,11476,3167,8309,8309,0,14,3738000.0
3738,3738999,20.982303338903847,38.204046728226906,0.0701505131202782,532.3186049461365,244.13284063339233,367.7485656738281,11476,3167,8309,8309,0,14,3739000.0
3739,3739999,20.980343631513165,38.200479108918515,0.07016320520238017,532.5491321086884,244.19799613952637,367.69694900512695,11484,3171,8313,8313,0,14,3740000.0
3740,3740999,20.978722280068723,38.19793636110429,0.07016927082977187,532.6967716217041,244.2644190788269,367.89159393310547,11487,3172,8315,8315,0,14,3741000.0
3741,3741999,20.977576637042354,38.197844279071894,0.07015562145328369,532.8527588844299,244.32987213134766,368.0604782104492,11489,3173,8316,8316,0,14,3742000.0
3742,3742999,20.97623873099831,38.19548953369565,0.07014979774086261,532.9692752361298,244.39550375938416,368.2104911804199,11489,3173,8316,8316,0,14,3743000.0
3743,3743999,20.9750176837746,38.193880695848314,0.07013752246216076,533.16051030159,244.46175575256348,368.2506294250488,11493,3175,8318,8318,0,14,3744000.0
3744,3744999,20.974356598179572,38.19292959394013,0.07012523795267911,533.3240213394165,244.53646683692932,368.3340377807617,11495,3176,8319,8319,0,14,3745000.0
3745,3745999,20.973965553870663,38.19655210495214,0.0700993178667857,533.4567317962646,244.60187149047852,368.41983795166016,11495,3176,8319,8319,0,14,3746000.0
3746,3746999,20.974224047841908,38.196475754379954,0.0700959564301219,533.6193056106567,244.667964220047,368.4501075744629,11502,3177,8325,8325,0,14,3747000.0
3747,3747999,20.97457337059149,38.19746045567008,0.07010579376047354,533.7894930839539,244.73389506340027,368.4508628845215,11506,3179,8327,8327,0,14,3748000.0
3748,3748999,20.975292481299505,38.197927401152086,0.07009640164939401,533.9479286670685,244.80037832260132,368.50374603271484,11508,3180,8328,8328,0,14,3749000.0
3749,3749999,20.976919080674897,38.201784059432924,0.07008224927389406,534.1003398895264,244.8673961162567,368.58740615844727,11508,3180,8328,8328,0,14,3750000.0
3750,3750999,20.97900399996976,38.20903348051421,0.07005644874633998,534.2503082752228,244.9334695339203,368.60536193847656,11515,3181,8334,8334,0,14,3751000.0
3751,3751999,20.981060123668613,38.2152216862512,0.07004939294189705,534.442506313324,244.99988627433777,368.5842170715332,11524,3183,8341,8341,0,14,3752000.0
3752,3752999,20.9824430535997,38.21861979146937,0.07004812262500582,534.5851922035217,245.06573367118835,368.6893768310547,11524,3183,8341,8341,0,14,3753000.0
3753,3753999,20.98481743709764,38.22587211365091,0.07003302340655837,534.7172267436981,245.13186740875244,368.78432846069336,11524,3183,8341,8341,0,14,3754000.0
3754,3754999,20.986795632609947,38.2278007862973,0.07003923267929646,534.8506982326508,245.19740271568298,368.8428611755371,11524,3183,8341,8341,0,14,3755000.0
3755,3755999,20.988537976264872,38.23192554881176,0.07004144700064974,535.0171411037445,245.26465797424316,368.8113822937012,11526,3184,8342,8342,0,14,3756000.0
3756,3756999,20.989173890407287,38.23114188526151,0.07005476785899878,535.2285540103912,245.33178162574768,368.71483612060547,11535,3186,8349,8349,0,14,3757000.0
3757,3757999,20.9880292002212,38.22820977185332,0.07005727828601749,535.3587594032288,245.3977246284485,369.2883720397949,11552,3186,8366,8366,0,14,3758000.0
3758,3758999,20.986071737834187,38.22570352586903,0.07006054550471363,535.4779267311096,245.46359586715698,369.60926055908203,11554,3186,8368,8368,0,14,3759000.0
3759,3759999,20.984082249544517,38.222781080689145,0.07006406897626016,535.6337506771088,245.52899360656738,369.76294326782227,11561,3187,8374,8374,0,14,3760000.0
3760,3760999,20.98245445898919,38.22082513369981,0.07006155938245728,535.8289427757263,245.59460830688477,369.7739715576172,11567,3190,8377,8377,0,14,3761000.0
3761,3761999,20.98157420852034,38.22256159262897,0.07004003637521228,536.0062844753265,245.66191482543945,369.9534225463867,11571,3192,8379,8379,0,14,3762000.0
3762,3762999,20.980400781668937,38.22038530018628,0.0700356870959361,537.6354384422302,245.7287118434906,369.91040420532227,11576,3195,8381,8381,0,14,3763000.0
3763,3763999,20.979583595314782,38.220295779210566,0.07001864664142732,537.7531313896179,245.7948408126831,370.0975036621094,11576,3195,8381,8381,0,14,3764000.0
3764,3764999,20.978655113045104,38.21859079238531,0.07001074935075458,537.8825204372406,245.86079239845276,370.2225570678711,11576,3195,8381,8381,0,14,3765000.0
3765,3765999,20.977764257422734,38.21682161522597,0.07000294853300781,538.0159022808075,245.92715120315552,370.32607650756836,11576,3195,8381,8381,0,14,3766000.0
3766,3766999,20.977490896770444,38.216363259985116,0.06998494228563268,538.1918814182281,245.9933967590332,370.3390007019043,11580,3197,8383,8383,0,14,3767000.0
3767,3767999,20.977307039605282,38.21575274797041,0.0699697677379082,538.320725440979,246.05964350700378,370.4416618347168,11580,3197,8383,8383,0,14,3768000.0
3768,3768999,20.97813609588661,38.21726905667673,0.06994843524563854,538.5080296993256,246.12661457061768,370.42709732055664,11589,3199,8390,8390,0,14,3769000.0
3769,3769999,20.980612790465067,38.22491376280155,0.06991223213540321,538.6677312850952,246.19311380386353,370.4279327392578,11596,3200,8396,8396,0,14,3770000.0
3770,3770999,20.98372897132577,38.2333803224938,0.06987097448767077,538.8517441749573,246.25956439971924,370.3823585510254,11605,3202,8403,8403,0,14,3771000.0
3771,3771999,20.9882133786149,38.247612294604124,0.06981345978965903,539.0251708030701,246.32712030410767,370.5078430175781,11607,3203,8404,8404,0,14,3772000.0
3772,3772999,20.992089656103182,38.256171082450955,0.06980359202610664,539.221926689148,246.39442229270935,370.4288024902344,11620,3205,8415,8415,0,14,3773000.0
3773,3773999,20.99725153744989,38.2696430689944,0.06978217785932739,539.3782708644867,246.46102118492126,370.4442672729492,11625,3206,8419,8419,0,14,3774000.0
3774,3774999,21.00214787490334,38.28183386085115,0.06979324191415737,539.5945799350739,246.52813172340393,370.4163589477539,11635,3209,8426,8426,0,14,3775000.0
3775,3775999,21.00610983070955,38.28808335160365,0.06981178845435099,539.7960307598114,246.5955891609192,370.4452133178711,11644,3211,8433,8433,0,14,3776000.0
3776,3776999,21.010468394411077,38.295065757678785,0.06984846930162103,539.9222323894501,246.66258335113525,370.5680122375488,11644,3211,8433,8433,0,14,3777000.0
3777,3777999,21.01309272669723,38.297822472649585,0.06986869540797469,540.1226723194122,246.7299358844757,370.542724609375,11648,3213,8435,8435,0,14,3778000.0
3778,3778999,21.01322047594001,38.29697704525677,0.06986823328279357,540.2828330993652,246.79583978652954,371.01897048950195,11662,3214,8448,8448,0,14,3779000.0
3779,3779999,21.011530352900937,38.2982429077118,0.06985194580417498,540.4069759845734,246.86158919334412,371.27556228637695,11663,3214,8449,8449,0,14,3780000.0
3780,3780999,21.01020807220682,38.297119014983345,0.06984192393114086,540.579023361206,246.92681455612183,371.278865814209,11674,3216,8458,8458,0,14,3781000.0
3781,3781999,21.00897386980501,38.29540734498392,0.0698320073020201,540.7642686367035,246.99394512176514,371.364013671875,11678,3218,8460,8460,0,14,3782000.0
3782,3782999,21.007825867284744,38.29401536986543,0.06982174819805764,540.9194297790527,247.0598337650299,371.4616241455078,11680,3219,8461,8461,0,14,3783000.0
3783,3783999,21.006739204201093,38.29163305226111,0.06981291175314908,541.1050608158112,247.12539768218994,371.4591865539551,11684,3221,8463,8463,0,14,3784000.0
3784,3784999,21.005661092047227,38.29067833559303,0.06979882037850438,541.2621409893036,247.19149255752563,371.5773162841797,11686,3222,8464,8464,0,14,3785000.0
3785,3785999,21.004852998763585,38.28924504210906,0.06978774005612753,541.5330636501312,247.25824666023254,371.4130973815918,11696,3227,8469,8469,0,14,3786000.0
3786,3786999,21.003817279881794,38.287328007591846,0.06977807178500228,541.7175762653351,247.32632207870483,371.4543571472168,11705,3229,8476,8476,0,14,3787000.0
3787,3787999,21.003935921161965,38.289896515127225,0.06975446624776982,541.8691244125366,247.39240956306458,371.5767936706543,11707,3230,8477,8477,0,14,3788000.0
3788,3788999,21.006021095354356,38.29706214490645,0.06971058312310707,542.0640389919281,247.45904445648193,371.6095733642578,11711,3232,8479,8479,0,14,3789000.0
3789,3789999,21.010795649741006,38.312029836507335,0.06964904797289984,542.218875169754,247.52537417411804,371.7287063598633,11713,3233,8480,8480,0,14,3790000.0
3790,3790999,21.01594673234762,38.33144812639188,0.06962843840697475,542.3693306446075,247.591712474823,371.85201263427734,11715,3234,8481,8481,0,14,3791000.0
3791,3791999,21.022654072393454,38.35113427456157,0.06960065238974211,542.4985263347626,247.65745043754578,371.9614944458008,11715,3234,8481,8481,0,14,3792000.0
3792,3792999,21.029926269243898,38.36796771145626,0.06963536679887627,542.7170107364655,247.72904634475708,372.0045471191406,11739,3236,8503,8503,0,14,3793000.0
3793,3793999,21.03817389170439,38.38845619222386,0.06968250561895772,542.8789370059967,247.79568672180176,372.0404281616211,11746,3237,8509,8509,0,14,3794000.0
3794,3794999,21.046382468634,38.40679097396731,0.06980641323129011,543.1133801937103,247.8624143600464,371.9273986816406,11766,3241,8525,8525,0,14,3795000.0
3795,3795999,21.054658689765272,38.42485822424782,0.06995542254381837,543.3076689243317,247.92932868003845,371.98219299316406,11778,3243,8535,8535,0,14,3796000.0
3796,3796999,21.06214541097246,38.43873641754653,0.07011935215290566,543.4727957248688,247.9958689212799,372.02419662475586,11783,3244,8539,8539,0,14,3797000.0
3797,3797999,21.06989679051686,38.452686135456496,0.07035163331769279,543.5954020023346,248.06287455558777,372.15860748291016,11783,3244,8539,8539,0,14,3798000.0
3798,3798999,21.074557095003872,38.459369725328074,0.07047638767935871,543.8161580562592,248.13732028007507,372.1464653015137,11791,3246,8545,8545,0,14,3799000.0
3799,3799999,21.074966669801896,38.45958011524821,0.07045292343020637,543.9404978752136,248.20307564735413,372.7681541442871,11804,3246,8558,8558,0,14,3800000.0
3800,3800999,21.074439641437355,38.45812351632533,0.07040236713137071,544.0650455951691,248.26885843276978,372.96669006347656,11804,3246,8558,8558,0,14,3801000.0
3801,3801999,21.07417314295466,38.45733608880316,0.07036651872403887,544.2194430828094,248.33480763435364,373.07186126708984,11806,3247,8559,8559,0,14,3802000.0
3802,3802999,21.074780240702154,38.45964959967729,0.07032994198687326,544.409117937088,248.40548372268677,373.1260795593262,11810,3249,8561,8561,0,14,3803000.0
3803,3803999,21.074428169730016,38.45853519643116,0.07030899882606456,544.5588665008545,248.47145414352417,373.2250518798828,11812,3250,8562,8562,0,14,3804000.0
3804,3804999,21.074101499419154,38.45707818353136,0.07028259614537014,544.8025915622711,248.53848218917847,373.14839935302734,11830,3254,8576,8576,0,14,3805000.0
3805,3805999,21.073691250610437,38.456549820335574,0.0702659064959299,545.0568981170654,248.60621190071106,373.1629219055176,11838,3258,8580,8580,0,14,3806000.0
3806,3806999,21.073797859815492,38.4556393071004,0.07025569420758648,545.2155427932739,248.673091173172,373.3011474609375,11841,3259,8582,8582,0,14,3807000.0
3807,3807999,21.074278430719165,38.459799122241265,0.0702362504231715,545.3727593421936,248.73992252349854,373.40471267700195,11843,3260,8583,8583,0,14,3808000.0
3808,3808999,21.07526367487291,38.460646945918754,0.07023100302894347,545.5591626167297,248.8066828250885,373.3558921813965,11857,3262,8595,8595,0,14,3809000.0
3809,3809999,21.075868221262656,38.4616866292239,0.07022135101562321,545.7292490005493,248.87452673912048,373.44648361206055,11864,3263,8601,8601,0,14,3810000.0
3810,3810999,21.078301350743985,38.47017749411284,0.0701963400258162,545.895555973053,248.9411849975586,373.4730110168457,11866,3264,8602,8602,0,14,3811000.0
3811,3811999,21.08092067283937,38.47457870598467,0.07021633536686822,546.0543086528778,249.008145570755,373.50850677490234,11872,3265,8607,8607,0,14,3812000.0
3812,3812999,21.083633883010858,38.47796794719567,0.07023259123036829,546.2323980331421,249.07564973831177,373.5867347717285,11891,3266,8625,8625,0,14,3813000.0
3813,3813999,21.087556822926153,38.484178370086816,0.07026941621721083,546.4188323020935,249.1430308818817,373.5994186401367,11914,3268,8646,8646,0,14,3814000.0
3814,3814999,21.092046891350137,38.49395436546897,0.07032692141127761,546.612384557724,249.21021246910095,373.5338706970215,11923,3270,8653,8653,0,14,3815000.0
3815,3815999,21.096636447493026,38.502740377557615,0.07039402727093136,546.7689516544342,249.2774589061737,373.5721206665039,11930,3271,8659,8659,0,14,3816000.0
3816,3816999,21.10017296738958,38.50801189966029,0.07047723654188431,546.8985469341278,249.3445863723755,373.64775466918945,11930,3271,8659,8659,0,14,3817000.0
3817,3817999,21.104130603790455,38.514237849136144,0.07053955155241698,547.0460731983185,249.41186380386353,373.71614837646484,11930,3271,8659,8659,0,14,3818000.0
3818,3818999,21.107476761830338,38.51758355112692,0.0706182060419418,547.212858915329,249.47967529296875,373.75780868530273,11932,3272,8660,8660,0,15,3819000.0
3819,3819999,21.109095885048774,38.51783868063804,0.07061653419066838,547.3816368579865,249.54662537574768,374.2292671203613,11952,3273,8679,8679,0,15,3820000.0
3820,3820999,21.1074850943234,38.51601436204975,0.07060851137133484,547.4984567165375,249.6127803325653,374.7056770324707,11958,3273,8685,8685,0,15,3821000.0
3821,3821999,21.105868316075302,38.51361175478965,0.07060774497814559,547.642409324646,249.6786994934082,374.90015029907227,11962,3274,8688,8688,0,15,3822000.0
3822,3822999,21.104886912681696,38.51221702482788,0.07059570791935887,547.858371257782,249.74541783332825,374.96386337280273,11968,3277,8691,8691,0,15,3823000.0
3823,3823999,21.103357205583485,38.50941932768185,0.07059321421474762,548.0145256519318,249.81200504302979,375.15634536743164,11970,3278,8692,8692,0,15,3824000.0
3824,3824999,21.101536675564066,38.506325123073765,0.07059449514552962,548.196132183075,249.87862420082092,375.27016830444336,11974,3280,8694,8694,0,15,3825000.0
3825,3825999,21.09969277433359,38.50283342137767,0.07059568832019691,548.3237934112549,249.9454700946808,375.43470764160156,11974,3280,8694,8694,0,15,3826000.0
3826,3826999,21.09813060485905,38.49980516340256,0.07059802021621397,548.5660316944122,250.01257634162903,375.3360366821289,11990,3284,8706,8706,0,15,3827000.0
3827,3827999,21.096787359492854,38.49754511885567,0.07059414124447361,548.6942663192749,250.07934713363647,375.5266342163086,11990,3284,8706,8706,0,15,3828000.0
3828,3828999,21.095213302214464,38.49445796314163,0.07059280247887822,548.8526084423065,250.14610075950623,375.6047134399414,11992,3285,8707,8707,0,15,3829000.0
3829,3829999,21.094086573083885,38.49274089920811,0.07058257141671742,549.0539820194244,250.2131004333496,375.65100479125977,12012,3287,8725,8725,0,15,3830000.0
3830,3830999,21.09288814379281,38.49073510221329,0.07057338264812862,549.1824464797974,250.28191924095154,375.7910690307617,12012,3287,8725,8725,0,15,3831000.0
3831,3831999,21.092271630262076,38.48941103964658,0.07055794732475018,549.3650743961334,250.34899044036865,375.7832717895508,12021,3289,8732,8732,0,15,3832000.0
3832,3832999,21.091695563935403,38.48801964481481,0.07054069469232682,549.6248481273651,250.41688990592957,375.6841850280762,12039,3293,8746,8746,0,15,3833000.0
3833,3833999,21.091216436498105,38.48597732580859,0.0705244478035898,549.7595639228821,250.4837760925293,375.8211441040039,12039,3293,8746,8746,0,15,3834000.0
3834,3834999,21.090857692774645,38.48446837717509,0.0705097130762038,549.9242761135101,250.5510609149933,375.8724250793457,12041,3294,8747,8747,0,15,3835000.0
3835,3835999,21.090903907792878,38.48324607663539,0.07049223522451942,550.1255569458008,250.61835169792175,375.87250900268555,12050,3296,8754,8754,0,15,3836000.0
3836,3836999,21.091141955088712,38.48249909553532,0.0704764495687461,550.2626106739044,250.68528962135315,375.9906005859375,12050,3296,8754,8754,0,15,3837000.0
3837,3837999,21.091387904681717,38.48170904761859,0.0704602834042497,550.3999924659729,250.7552125453949,376.0611114501953,12050,3296,8754,8754,0,15,3838000.0
3838,3838999,21.09146585179271,38.48040465754151,0.07044452218864128,550.5508079528809,250.82261300086975,376.12149810791016,12050,3296,8754,8754,0,15,3839000.0
3839,3839999,21.09198796670265,38.47941342481766,0.07042730375158934,550.7174220085144,250.88989448547363,376.16101837158203,12052,3297,8755,8755,0,15,3840000.0
3840,3840999,21.091435757559857,38.47724980420713,0.07041761968219351,550.8530249595642,250.95631623268127,376.235408782959,12052,3297,8755,8755,0,15,3841000.0
3841,3841999,21.09004876953225,38.47501837117862,0.0704036165241616,551.0040309429169,251.02362895011902,376.96789169311523,12082,3298,8784,8784,0,15,3842000.0
3842,3842999,21.088351731269796,38.47349230270094,0.0703982241343476,551.1182115077972,251.08930706977844,377.3469581604004,12085,3298,8787,8787,0,15,3843000.0
3843,3843999,21.08646917541771,38.47080784929143,0.07040285319173722,551.2946455478668,251.155175447464,377.5231628417969,12089,3300,8789,8789,0,15,3844000.0
3844,3844999,21.08442268966178,38.467725838278106,0.07041380169836109,551.4646861553192,251.22149229049683,377.70397186279297,12093,3302,8791,8791,0,15,3845000.0
3845,3845999,21.082211278002696,38.46411286302361,0.07041975220944974,551.672455072403,251.2885570526123,377.6939506530762,12104,3305,8799,8799,0,15,3846000.0
3846,3846999,21.08040564079265,38.46125791437204,0.07042882759757985,551.8520905971527,251.3551676273346,377.96520614624023,12108,3307,8801,8801,0,15,3847000.0
3847,3847999,21.078639183687944,38.45819585226742,0.07043514661745787,552.0101273059845,251.42188429832458,378.1192932128906,12110,3308,8802,8802,0,15,3848000.0
3848,3848999,21.0766736103596,38.45471426837029,0.0704500160149466,552.1788110733032,251.48942399024963,378.2854766845703,12113,3309,8804,8804,0,15,3849000.0
3849,3849999,21.0750715239224,38.451655013740556,0.07046005428223456,552.3276598453522,251.55654788017273,378.3908157348633,12115,3310,8805,8805,0,15,3850000.0
3850,3850999,21.073732848573535,38.449194515548015,0.07046534857979037,552.5146865844727,251.6233150959015,378.38543701171875,12122,3312,8810,8810,0,15,3851000.0
3851,3851999,21.072542987161306,38.447121019605746,0.07046833895844784,552.6467039585114,251.690007686615,378.5183525085449,12122,3312,8810,8810,0,15,3852000.0
3852,3852999,21.07162797470806,38.44671224399732,0.07046133496813645,552.782075881958,251.75663208961487,378.6597328186035,12122,3312,8810,8810,0,15,3853000.0
3853,3853999,21.07087721109857,38.44539236038441,0.07045879012198486,552.9436135292053,251.82340955734253,378.68199157714844,12124,3313,8811,8811,0,15,3854000.0
3854,3854999,21.07042467698311,38.44960097439347,0.070445451923701,553.1423923969269,251.89147758483887,378.6860008239746,12145,3315,8830,8830,0,15,3855000.0
3855,3855999,21.069429994674888,38.447128408455114,0.07044466385155368,553.3274121284485,251.95850348472595,378.7102165222168,12149,3317,8832,8832,0,15,3856000.0
3856,3856999,21.06889680309393,38.44537993045804,0.07044997366108219,553.4874250888824,252.0253562927246,378.80038833618164,12156,3318,8838,8838,0,15,3857000.0
3857,3857999,21.06828942669783,38.44422361852239,0.07044874691668979,553.6826961040497,252.09227061271667,378.79927825927734,12165,3320,8845,8845,0,15,3858000.0
3858,3858999,21.06834129679402,38.44395980054817,0.07044563112548885,553.8101530075073,252.15876460075378,378.9332962036133,12165,3320,8845,8845,0,15,3859000.0
3859,3859999,21.067879523179464,38.44224167570144,0.07044555667697205,553.9749417304993,252.22515273094177,378.97040939331055,12167,3321,8846,8846,0,15,3860000.0
3860,3860999,21.067770281674484,38.4408867644637,0.07043948134662781,554.1150665283203,252.29197478294373,379.0409698486328,12167,3321,8846,8846,0,15,3861000.0
3861,3861999,21.067212137798695,38.43886420796703,0.07043510335712233,554.2534852027893,252.3585045337677,379.1448974609375,12167,3321,8846,8846,0,15,3862000.0
3862,3862999,21.066527074471995,38.43817933043408,0.07041847036613791,554.4283533096313,252.42483854293823,379.60883712768555,12193,3323,8870,8870,0,15,3863000.0
3863,3863999,21.06456611367699,38.43541387411388,0.07041633432071548,554.5395374298096,252.4915690422058,380.2358055114746,12204,3323,8881,8881,0,15,3864000.0
3864,3864999,21.06258174848142,38.4329541835162,0.07042303137603034,554.6592481136322,252.55714058876038,380.526065826416,12204,3323,8881,8881,0,15,3865000.0
3865,3865999,21.061015897477148,38.43175207614864,0.07042179796534953,554.858167886734,252.62285947799683,380.60480880737305,12210,3326,8884,8884,0,15,3866000.0
3866,3866999,21.05934507002908,38.42932008833614,0.07042183867545104,554.9979372024536,252.68870329856873,380.7865676879883,12212,3327,8885,8885,0,15,3867000.0
3867,3867999,21.057732470120474,38.42731422977514,0.07041808157011631,555.1449182033539,252.75544691085815,381.01660919189453,12214,3328,8886,8886,0,15,3868000.0
3868,3868999,21.055992077294167,38.42384436028144,0.07041756771750107,555.3015248775482,252.82190561294556,381.1376266479492,12216,3329,8887,8887,0,15,3869000.0
3869,3869999,21.055152510011727,38.42391429228806,0.07040087060425837,555.5482051372528,252.88885807991028,381.15572357177734,12224,3333,8891,8891,0,15,3870000.0
3870,3870999,21.054878472186605,38.42323621928056,0.07037943753006881,555.7341527938843,252.95537757873535,381.2323303222656,12232,3335,8897,8897,0,15,3871000.0
3871,3871999,21.05501625230806,38.424101487347144,0.07035605167803638,555.9104895591736,253.02197575569153,381.3251724243164,12236,3337,8899,8899,0,15,3872000.0
3872,3872999,21.055105405563356,38.42394748756024,0.07034404110405146,556.0347673892975,253.0895471572876,381.5221405029297,12236,3337,8899,8899,0,15,3873000.0
3873,3873999,21.0552055262429,38.423233536625794,0.07032708230873885,556.184552192688,253.15673422813416,381.6087112426758,12238,3338,8900,8900,0,15,3874000.0
3874,3874999,21.055974794450325,38.4237166063416,0.07030435098351429,556.3668870925903,253.22456240653992,381.6195297241211,12242,3340,8902,8902,0,15,3875000.0
3875,3875999,21.05636658190977,38.423139747615195,0.07028712025269634,556.5477793216705,253.29147958755493,381.62800216674805,12245,3342,8903,8903,0,15,3876000.0
3876,3876999,21.05644944028775,38.42215948190562,0.07027520394800135,556.6811714172363,253.35791993141174,381.7474708557129,12245,3342,8903,8903,0,15,3877000.0
3877,3877999,21.056806494525752,38.4212272458553,0.07026157856986537,556.8317472934723,253.42464995384216,381.8453598022461,12247,3343,8904,8904,0,15,3878000.0
3878,3878999,21.05723233207034,38.42049247182803,0.07024828616775014,557.0458998680115,253.49201655387878,381.8522758483887,12269,3346,8923,8923,0,15,3879000.0
3879,3879999,21.05749711286489,38.41976955043332,0.07024040753402738,557.1703791618347,253.55851912498474,381.97900390625,12269,3346,8923,8923,0,15,3880000.0
3880,3880999,21.057750376281717,38.41827721233152,0.07022925353117537,557.3560361862183,253.62507557868958,382.0732650756836,12273,3348,8925,8925,0,15,3881000.0
3881,3881999,21.05662965818984,38.41524733664354,0.0702265471158342,557.5369505882263,253.69159698486328,382.63015365600586,12302,3350,8952,8952,0,15,3882000.0
3882,3882999,21.054817723289833,38.41218493204596,0.07021570120979936,557.6800203323364,253.758118391037,383.27497482299805,12322,3351,8971,8971,0,15,3883000.0
3883,3883999,21.053137552802177,38.40943703526198,0.07021230417707569,557.7977576255798,253.82345843315125,383.613468170166,12322,3351,8971,8971,0,15,3884000.0
3884,3884999,21.051465027295542,38.40672152619387,0.07021242756545387,557.9918389320374,253.8889696598053,383.7341194152832,12336,3354,8982,8982,0,15,3885000.0
3885,3885999,21.05015006927696,38.40441929802046,0.07020934716468175,558.1384923458099,253.9552354812622,383.97189712524414,12339,3355,8984,8984,0,15,3886000.0
3886,3886999,21.04899630335705,38.40282381720665,0.07020293299061142,558.2795827388763,254.02069854736328,384.1740074157715,12341,3356,8985,8985,0,15,3887000.0
3887,3887999,21.04773403254388,38.40015755067449,0.07019962844100458,558.5165040493011,254.08744168281555,384.14777755737305,12349,3360,8989,8989,0,15,3888000.0
3888,3888999,21.04639985987282,38.39746359523512,0.07019961155318954,558.7273778915405,254.1550931930542,384.2976417541504,12355,3363,8992,8992,0,15,3889000.0
3889,3889999,21.045763297837922,38.395952470552565,0.07019507066676134,558.851553440094,254.22078037261963,384.4620246887207,12355,3363,8992,8992,0,15,3890000.0
3890,3890999,21.04494779737818,38.395272534858776,0.07018608271712179,559.0088391304016,254.2872703075409,384.5653305053711,12357,3364,8993,8993,0,15,3891000.0
3891,3891999,21.04471583076112,38.39509385771478,0.07016811957511404,559.1678764820099,254.3531723022461,384.7120590209961,12359,3365,8994,8994,0,15,3892000.0
3892,3892999,21.045018696337046,38.39574129914679,0.07013970353089283,559.3353452682495,254.41910076141357,384.7816505432129,12367,3367,9000,9000,0,15,3893000.0
3893,3893999,21.045518699264047,38.39915272382543,0.07010562884176896,559.458615064621,254.4858226776123,384.90892791748047,12367,3367,9000,9000,0,15,3894000.0
3894,3894999,21.04622928727278,38.39953402496279,0.0700846709029288,559.6112461090088,254.55187892913818,384.9717445373535,12369,3368,9001,9001,0,15,3895000.0
3895,3895999,21.04744846950571,38.400920403836984,0.0700677776872064,559.7818341255188,254.61855840682983,385.01354598999023,12371,3369,9002,9002,0,15,3896000.0
3896,3896999,21.04921162314167,38.40409698565356,0.0700485456505141,559.9355487823486,254.68464016914368,385.0706596374512,12377,3370,9007,9007,0,15,3897000.0
3897,3897999,21.050890217569773,38.406880294123155,0.07003660117881716,560.1222605705261,254.75102853775024,385.0904235839844,12381,3372,9009,9009,0,15,3898000.0
3898,3898999,21.052446599829693,38.40988794504897,0.070024870681764,560.2663948535919,254.8174605369568,385.15294647216797,12387,3373,9014,9014,0,15,3899000.0
3899,3899999,21.054073877755794,38.413874810848306,0.07000257288406275,560.3997006416321,254.88339734077454,385.2212944030762,12387,3373,9014,9014,0,15,3900000.0
3900,3900999,21.055516020210625,38.41439005915985,0.07000562487997408,560.535187959671,254.95129871368408,385.3517150878906,12387,3373,9014,9014,0,15,3901000.0
3901,3901999,21.055728205585183,38.412973122995325,0.07000278555295403,560.7039296627045,255.01733422279358,385.41737365722656,12389,3374,9015,9015,0,15,3902000.0
3902,3902999,21.05490663950513,38.41401741248191,0.06998243306139629,560.8228657245636,255.08347845077515,386.18494415283203,12411,3374,9037,9037,0,15,3903000.0
3903,3903999,21.053202011837826,38.411059909075945,0.0699695319864374,560.9425182342529,255.14900732040405,386.4536552429199,12411,3374,9037,9037,0,15,3904000.0
3904,3904999,21.05160407735366,38.40821159152156,0.0699604866786262,561.0817544460297,255.21431016921997,386.60612869262695,12413,3375,9038,9038,0,15,3905000.0
3905,3905999,21.050066638570893,38.40667693976784,0.0699509208297665,561.2715063095093,255.2805962562561,386.71432876586914,12417,3377,9040,9040,0,15,3906000.0
3906,3906999,21.0484490074935,38.40411324604762,0.06993847238005291,561.4280467033386,255.3480384349823,386.859676361084,12419,3378,9041,9041,0,15,3907000.0
3907,3907999,21.047039387237298,38.401565775334916,0.06992975876423435,561.5768887996674,255.41377019882202,386.9537544250488,12421,3379,9042,9042,0,15,3908000.0
3908,3908999,21.045715255852784,38.401611292339226,0.06991382745765151,561.7357199192047,255.48031520843506,387.022403717041,12423,3380,9043,9043,0,15,3909000.0
3909,3909999,21.04442586219629,38.398877782298065,0.06990038020848999,561.9989573955536,255.54720401763916,386.9135322570801,12438,3385,9053,9053,0,15,3910000.0
3910,3910999,21.04389518553948,38.39772371573661,0.06987990807447264,562.1845526695251,255.61402225494385,386.9721565246582,12442,3387,9055,9055,0,15,3911000.0
3911,3911999,21.043268357870147,38.39607531634782,0.06986549733113678,562.3782715797424,255.68224096298218,387.0207328796387,12449,3389,9060,9060,0,15,3912000.0
3912,3912999,21.042643607889154,38.39415931552618,0.0698538019481677,562.5575098991394,255.7503480911255,387.0348129272461,12463,3391,9072,9072,0,15,3913000.0
3913,3913999,21.043282705090945,38.40123176877532,0.06980333038595021,562.6834518909454,255.81637239456177,387.20123291015625,12463,3391,9072,9072,0,15,3914000.0
3914,3914999,21.04350022637358,38.40079808472884,0.06978329353551616,562.8562529087067,255.8823504447937,387.1772651672363,12467,3393,9074,9074,0,15,3915000.0
3915,3915999,21.043887770032406,38.40019837184555,0.06976753461625673,563.0276141166687,255.9492301940918,387.2353935241699,12469,3394,9075,9075,0,15,3916000.0
3916,3916999,21.044669102071726,38.40011895199425,0.06975957404900701,563.2145311832428,256.01628017425537,387.342098236084,12473,3396,9077,9077,0,15,3917000.0
3917,3917999,21.04537938685474,38.400612583698546,0.06973291048942243,563.3398721218109,256.0841031074524,387.4826965332031,12473,3396,9077,9077,0,15,3918000.0
3918,3918999,21.046770961472358,38.401841175801955,0.06970368017139994,563.5166919231415,256.15238642692566,387.5038604736328,12475,3397,9078,9078,0,15,3919000.0
3919,3919999,21.047934243642256,38.40246311907357,0.06970070470436163,563.6601076126099,256.22006607055664,387.61076736450195,12475,3397,9078,9078,0,15,3920000.0
3920,3920999,21.04872819852148,38.40251425043648,0.06968733686951845,563.7786629199982,256.28686714172363,387.68945693969727,12475,3397,9078,9078,0,15,3921000.0
3921,3921999,21.050817769462753,38.406927521926114,0.06965709930397612,564.002213716507,256.35493874549866,387.65958404541016,12481,3400,9081,9081,0,15,3922000.0
3922,3922999,21.051912064836678,38.40738939380622,0.0696365627464941,564.1431641578674,256.4225764274597,387.7919616699219,12481,3400,9081,9081,0,15,3923000.0
3923,3923999,21.051712949454,38.406081672095056,0.06962386845033863,564.2602579593658,256.48993134498596,388.5157928466797,12503,3400,9103,9103,0,15,3924000.0
3924,3924999,21.049550884174366,38.40288365255853,0.06962421358300508,564.3834455013275,256.55513739585876,388.84788513183594,12504,3400,9104,9104,0,15,3925000.0
3925,3925999,21.04791456168183,38.40050971957678,0.06961650871605773,564.5026261806488,256.6208038330078,389.0725326538086,12504,3400,9104,9104,0,15,3926000.0
3926,3926999,21.04692078695068,38.39916067308189,0.06959490574716831,564.6563379764557,256.6862745285034,389.19366455078125,12506,3401,9105,9105,0,15,3927000.0
3927,3927999,21.0457208656214,38.397037071480504,0.06958382796255946,564.8082258701324,256.75251388549805,389.3152275085449,12508,3402,9106,9106,0,15,3928000.0
3928,3928999,21.04476383386897,38.39545543544766,0.06956443014237723,564.9524376392365,256.81838035583496,389.44222259521484,12510,3403,9107,9107,0,15,3929000.0
3929,3929999,21.043928275728607,38.39306133454706,0.06954810013809398,565.1981673240662,256.88569808006287,389.4166564941406,12518,3407,9111,9111,0,15,3930000.0
3930,3930999,21.043132115650927,38.390723615523406,0.06953629479318901,565.4168565273285,256.95216250419617,389.4312515258789,12524,3410,9114,9114,0,15,3931000.0
3931,3931999,21.042323812167663,38.388024579501476,0.06952385154114415,565.6621115207672,257.02035093307495,389.47473907470703,12537,3414,9123,9123,0,15,3932000.0
3932,3932999,21.0416784772157,38.38594992675607,0.06950635789033577,565.780885219574,257.08655834198,389.6661071777344,12537,3414,9123,9123,0,15,3933000.0
3933,3933999,21.04170591999595,38.388645208489976,0.06948302064410128,565.9873085021973,257.15475058555603,389.68375396728516,12543,3417,9126,9126,0,15,3934000.0
3934,3934999,21.04129536052131,38.38689683893273,0.06947091365644542,566.1401567459106,257.2207646369934,389.8162040710449,12545,3418,9127,9127,0,15,3935000.0
3935,3935999,21.041342846447957,38.38641321335968,0.0694579532349533,566.2675769329071,257.2867953777313,389.94018936157227,12545,3418,9127,9127,0,15,3936000.0
3936,3936999,21.042176756652335,38.386535812544004,0.06943507353589584,566.4226317405701,257.35289001464844,389.99714279174805,12551,3419,9132,9132,0,15,3937000.0
3937,3937999,21.043604049410018,38.387812976869284,0.06941339148681902,566.5897817611694,257.41926550865173,390.0942192077637,12568,3420,9148,9148,0,15,3938000.0
3938,3938999,21.044454614634695,38.387686342834535,0.06940323267945758,566.721658706665,257.4862084388733,390.1696014404297,12568,3420,9148,9148,0,15,3939000.0
3939,3939999,21.04632022128952,38.389076654171106,0.06939227283662008,566.8837339878082,257.55255246162415,390.1930122375488,12570,3421,9149,9149,0,15,3940000.0
3940,3940999,21.048184373103563,38.39044471050388,0.0693851880317381,567.0159437656403,257.61879563331604,390.3029670715332,12570,3421,9149,9149,0,15,3941000.0
3941,3941999,21.050361756356864,38.39174103332819,0.06937876892501327,567.1704864501953,257.6849012374878,390.31431579589844,12577,3422,9155,9155,0,15,3942000.0
3942,3942999,21.05130822512643,38.391306212196326,0.06937242809286448,567.3061668872833,257.7509255409241,390.4003791809082,12577,3422,9155,9155,0,15,3943000.0
3943,3943999,21.05247237443558,38.390957751021055,0.06936708777521894,567.4289128780365,257.81713700294495,390.49267959594727,12577,3422,9155,9155,0,15,3944000.0
3944,3944999,21.052517159257278,38.389279442905085,0.06935640054798553,567.5665504932404,257.883428812027,390.8200454711914,12588,3422,9166,9166,0,15,3945000.0
3945,3945999,21.051951314704795,38.38896472393972,0.06933489773302681,567.6953761577606,257.9488580226898,391.06409454345703,12590,3422,9168,9168,0,15,3946000.0
3946,3946999,21.051275823905726,38.388768091518315,0.06932252625479285,567.8142352104187,258.01493549346924,391.25887298583984,12592,3422,9170,9170,0,15,3947000.0
3947,3947999,21.05112071001623,38.39114467690489,0.06930425733986312,567.9698941707611,258.08022356033325,391.3366050720215,12594,3423,9171,9171,0,15,3948000.0
3948,3948999,21.051957337204534,38.39494810768465,0.06928218950417542,568.1198225021362,258.1455318927765,391.4239807128906,12596,3424,9172,9172,0,15,3949000.0
3949,3949999,21.053127666990754,38.400591512855485,0.06926210162946755,568.299854516983,258.2112081050873,391.4200897216797,12600,3426,9174,9174,0,15,3950000.0
3950,3950999,21.053637089839768,38.402504787856444,0.06925543094112807,568.4765076637268,258.27721524238586,391.4511413574219,12604,3428,9176,9176,0,15,3951000.0
3951,3951999,21.054565803140733,38.40572318513798,0.06923928022565529,568.7028486728668,258.34393191337585,391.39985275268555,12621,3431,9190,9190,0,15,3952000.0
3952,3952999,21.055955619148754,38.40843663353464,0.06924479443590292,568.8592531681061,258.41034054756165,391.54586029052734,12624,3432,9192,9192,0,15,3953000.0
3953,3953999,21.05721975742718,38.413260288155776,0.06926162932463797,569.0174930095673,258.47657084465027,391.6047477722168,12626,3433,9193,9193,0,15,3954000.0
3954,3954999,21.058592370690445,38.41609470126625,0.06929259049171299,569.1804869174957,258.54306864738464,391.6810760498047,12628,3434,9194,9194,0,15,3955000.0
3955,3955999,21.06069226605099,38.42051195437903,0.0693143961109095,569.3747353553772,258.60965490341187,391.6519584655762,12637,3436,9201,9201,0,15,3956000.0
3956,3956999,21.062115914598447,38.4236938426481,0.06932727891168822,569.5001673698425,258.6757791042328,391.759578704834,12637,3436,9201,9201,0,15,3957000.0
3957,3957999,21.06391634409077,38.42583710419816,0.06934693485138088,569.6609997749329,258.74191904067993,391.80056381225586,12639,3437,9202,9202,0,15,3958000.0
3958,3958999,21.066041064281787,38.42918822023684,0.06935704261250875,569.8215205669403,258.80826783180237,391.8563690185547,12641,3438,9203,9203,0,15,3959000.0
3959,3959999,21.068348593300996,38.432297422303925,0.06937712943283303,570.0103132724762,258.8751425743103,391.83955001831055,12645,3440,9205,9205,0,15,3960000.0
3960,3960999,21.07127472519717,38.436500905224904,0.06941934228893121,570.1335394382477,258.94125604629517,391.9302101135254,12645,3440,9205,9205,0,15,3961000.0
3961,3961999,21.076105032093114,38.45426614296448,0.06944390945555934,570.3050436973572,259.0078136920929,391.9388313293457,12647,3441,9206,9206,0,15,3962000.0
3962,3962999,21.07993156550062,38.4621669431152,0.06947653788826191,570.4747195243835,259.07473278045654,391.9883270263672,12649,3442,9207,9207,0,15,3963000.0
3963,3963999,21.084219848264585,38.47111628098712,0.06950074607068746,570.6605994701385,259.1415367126465,391.93879318237305,12663,3444,9219,9219,0,15,3964000.0
3964,3964999,21.087369655375255,38.47556457921997,0.06953178870851884,570.8070204257965,259.2083718776703,392.0813674926758,12663,3444,9219,9219,0,15,3965000.0
3965,3965999,21.088392964010527,38.47950026297826,0.06950477366187868,570.96772813797,259.2743422985077,392.6809425354004,12683,3445,9238,9238,0,15,3966000.0
3966,3966999,21.087516319563402,38.47966052357301,0.0694947655059367,571.0919308662415,259.34003472328186,393.0552787780762,12688,3445,9243,9243,0,15,3967000.0
3967,3967999,21.08710357017502,38.479882061327224,0.06949035624476818,571.2423853874207,259.4054489135742,393.16455459594727,12695,3446,9249,9249,0,15,3968000.0
3968,3968999,21.087319375892218,38.48143330205913,0.06948236810149211,571.4455206394196,259.4712836742401,393.19433212280273,12701,3449,9252,9252,0,15,3969000.0
3969,3969999,21.087579994886948,38.48174129905972,0.06948892810473062,571.6475234031677,259.53753113746643,393.2428665161133,12712,3452,9260,9260,0,15,3970000.0
3970,3970999,21.088501249343,38.482801500436715,0.0694934120419125,571.8311936855316,259.60382103919983,393.44383239746094,12716,3454,9262,9262,0,15,3971000.0
3971,3971999,21.089356284395752,38.48368589157958,0.06950487317980258,571.9700682163239,259.6713922023773,393.61556243896484,12716,3454,9262,9262,0,15,3972000.0
3972,3972999,21.091171657889383,38.48713268069483,0.06952325082738975,572.1782128810883,259.73753547668457,393.5693054199219,12727,3457,9270,9270,0,15,3973000.0
3973,3973999,21.09344300988128,38.49125124052763,0.0695284702257204,572.2995777130127,259.8033001422882,393.7568550109863,12727,3457,9270,9270,0,15,3974000.0
3974,3974999,21.096037166377865,38.495400362261606,0.06954838504125194,572.4614477157593,259.8692033290863,393.8276596069336,12731,3458,9273,9273,0,15,3975000.0
3975,3975999,21.100306963189524,38.50372427330502,0.06961849442799806,572.6866595745087,259.93599033355713,393.77459716796875,12745,3461,9284,9284,0,15,3976000.0
3976,3976999,21.105447222577673,38.51968941504243,0.06969011575000439,572.804744720459,260.00276589393616,393.9107131958008,12745,3461,9284,9284,0,15,3977000.0
3977,3977999,21.111193731191292,38.52964839312668,0.06979228928573689,573.0346176624298,260.06953382492065,393.82131576538086,12761,3464,9297,9297,0,15,3978000.0
3978,3978999,21.11734704468179,38.5405984832013,0.06991485406122233,573.1927490234375,260.13611006736755,393.88961029052734,12767,3465,9302,9302,0,15,3979000.0
3979,3979999,21.123363514054365,38.55272855510492,0.07001921245880716,573.3618896007538,260.20289039611816,393.97924041748047,12769,3466,9303,9303,0,15,3980000.0
3980,3980999,21.131325673307494,38.57116359525579,0.07016048464816671,573.4980344772339,260.2692050933838,394.05655670166016,12769,3466,9303,9303,0,15,3981000.0
3981,3981999,21.13783889212179,38.58385495147721,0.07031350290339611,573.7205929756165,260.33648228645325,393.9821586608887,12789,3469,9320,9320,0,15,3982000.0
3982,3982999,21.144672480250463,38.59655001364605,0.07049935205708036,573.8799426555634,260.40445923805237,394.0513572692871,12795,3470,9325,9325,0,15,3983000.0
3983,3983999,21.15078098978135,38.60493055382875,0.07069226915957627,574.0495116710663,260.4711401462555,394.08813858032227,12801,3471,9330,9330,0,15,3984000.0
3984,3984999,21.157260017234222,38.6158608850376,0.0708907829793789,574.231614112854,260.53759241104126,394.1656303405762,12809,3473,9336,9336,0,15,3985000.0
3985,3985999,21.1622285632261,38.62489498767622,0.07103378817570738,574.4250028133392,260.6040987968445,394.3230667114258,12824,3475,9349,9349,0,15,3986000.0
3986,3986999,21.16139297137688,38.623844611711355,0.07102026448779075,574.5369081497192,260.6690242290497,394.78430557250977,12833,3475,9358,9358,0,15,3987000.0
3987,3987999,21.1603236684713,38.622000728331145,0.07101450125247988,574.6687226295471,260.734174489975,394.9783515930176,12833,3475,9358,9358,0,15,3988000.0
3988,3988999,21.159733563214253,38.6206244608273,0.07100907546823665,574.8170158863068,260.79973125457764,395.0453910827637,12835,3476,9359,9359,0,15,3989000.0
3989,3989999,21.159305024228743,38.620694495912346,0.07099220862604527,575.065661907196,260.8657503128052,395.0247802734375,12846,3480,9366,9366,0,15,3990000.0
3990,3990999,21.158448287600148,38.61857197150288,0.0709847145203717,575.2764434814453,260.9323513507843,395.11824798583984,12852,3483,9369,9369,0,15,3991000.0
3991,3991999,21.15749775338347,38.616298084490225,0.07097981238898887,575.3905808925629,260.9990348815918,395.30554580688477,12852,3483,9369,9369,0,15,3992000.0
3992,3992999,21.15701006441398,38.61495146867345,0.07097065177265194,575.6171164512634,261.0665876865387,395.2796401977539,12858,3486,9372,9372,0,15,3993000.0
3993,3993999,21.156869415924106,38.61398085218688,0.07095832370995303,575.7777590751648,261.1329731941223,395.4174270629883,12860,3487,9373,9373,0,15,3994000.0
3994,3994999,21.156622816198738,38.61271501871729,0.07094785087533173,575.8967337608337,261.19904923439026,395.54153060913086,12860,3487,9373,9373,0,15,3995000.0
3995,3995999,21.15650964113732,38.61165971029298,0.0709363274940018,576.067143201828,261.26549911499023,395.5941162109375,12862,3488,9374,9374,0,15,3996000.0
3996,3996999,21.157052145588068,38.611655004441765,0.0709266703813326,576.2025325298309,261.3329219818115,395.6993942260742,12862,3488,9374,9374,0,15,3997000.0
3997,3997999,21.15794894586915,38.61150011441216,0.0709187635768126,576.3753950595856,261.39917635917664,395.7221374511719,12864,3489,9375,9375,0,15,3998000.0
3998,3998999,21.15953386619373,38.613114406085025,0.0709403530392162,576.559775352478,261.46559405326843,395.6949005126953,12878,3491,9387,9387,0,15,3999000.0
3999,3999999,21.16075437155537,38.61377045688891,0.07094529592488852,576.7170915603638,261.5328583717346,395.7447509765625,12885,3492,9393,9393,0,15,4000000.0
4000,4000999,21.162178128837677,38.61471857885559,0.07096654623884147,576.9092152118683,261.59938311576843,395.76155853271484,12887,3493,9394,9394,0,15,4001000.0
4001,4001999,21.16373883378458,38.61530567083094,0.070984934095083,577.0342967510223,261.66546273231506,395.8425102233887,12887,3493,9394,9394,0,15,4002000.0
4002,4002999,21.164595577411077,38.61461194931224,0.07100470742919696,577.1756825447083,261.7319700717926,395.93976974487305,12887,3493,9394,9394,0,15,4003000.0
4003,4003999,21.165893331563478,38.614727309742584,0.07102905044159313,577.3007552623749,261.79805517196655,396.0001449584961,12887,3493,9394,9394,0,15,4004000.0
4004,4004999,21.166946196870267,38.61455640851586,0.07103966275473106,577.4470434188843,261.86460995674133,396.0393867492676,12887,3493,9394,9394,0,15,4005000.0
4005,4005999,21.168029995771565,38.613989975358415,0.07107605717931187,577.6349632740021,261.9312973022461,396.0013961791992,12899,3495,9404,9404,0,15,4006000.0
4006,4006999,21.168048997482156,38.61219856335067,0.07110861958670833,577.7569143772125,261.99732732772827,396.0701484680176,12899,3495,9404,9404,0,15,4007000.0
4007,4007999,21.166687351237684,38.60914385386022,0.07110942878322035,577.8861944675446,262.0628821849823,396.69607162475586,12916,3495,9421,9421,0,15,4008000.0
4008,4008999,21.165296422856517,38.60718660436254,0.07110677425811518,578.0148711204529,262.1352002620697,396.9552917480469,12917,3495,9422,9422,0,15,4009000.0
4009,4009999,21.164255967986264,38.607810682784354,0.07108442095427392,578.1299347877502,262.2004864215851,397.1324043273926,12917,3495,9422,9422,0,15,4010000.0
4010,4010999,21.162881250390406,38.60508434794772,0.07108666449850365,578.3273887634277,262.2742278575897,397.18957138061523,12921,3497,9424,9424,0,15,4011000.0
4011,4011999,21.16149828521333,38.60224936919384,0.07108481326089422,578.5584588050842,262.34761929512024,397.2773628234863,12928,3500,9428,9428,0,15,4012000.0
4012,4012999,21.16020226215517,38.59953768782059,0.07107954365941827,578.7742247581482,262.41456961631775,397.4038848876953,12934,3503,9431,9431,0,15,4013000.0
4013,4013999,21.15880773048252,38.59684242217747,0.07107808671587024,578.9587118625641,262.4903347492218,397.5361785888672,12936,3504,9432,9432,0,15,4014000.0
4014,4014999,21.157720362351135,38.59505347600266,0.07107151391585675,579.1437349319458,262.55662727355957,397.6063461303711,12941,3506,9435,9435,0,15,4015000.0
4015,4015999,21.156485621732752,38.592312925561735,0.07107009277259779,579.2763047218323,262.6225702762604,397.80004501342773,12941,3506,9435,9435,0,15,4016000.0
4016,4016999,21.155444659183914,38.591621751110786,0.07105659457327052,579.4037764072418,262.6889679431915,397.9338684082031,12941,3506,9435,9435,0,15,4017000.0
4017,4017999,21.154500929432544,38.58935203315779,0.07104913099255883,579.5868883132935,262.76499938964844,398.00365447998047,12943,3507,9436,9436,0,15,4018000.0
4018,4018999,21.153562124284644,38.58708764819856,0.07104200873848998,579.7403695583344,262.8311150074005,398.05946350097656,12945,3508,9437,9437,0,15,4019000.0
4019,4019999,21.15350453800668,38.59239329204117,0.07100609542809577,579.8625762462616,262.897344827652,398.1561164855957,12945,3508,9437,9437,0,15,4020000.0
4020,4020999,21.153253798220582,38.591984458472986,0.0709890499539142,580.0040893554688,262.96417140960693,398.25238037109375,12945,3508,9437,9437,0,15,4021000.0
4021,4021999,21.153819799781836,38.593880522894246,0.07096067915588522,580.1699559688568,263.03060126304626,398.2796630859375,12947,3509,9438,9438,0,15,4022000.0
4022,4022999,21.15412682507177,38.5928353215783,0.07094944738460884,580.325448513031,263.0973439216614,398.3358039855957,12949,3510,9439,9439,0,15,4023000.0
4023,4023999,21.154794206129324,38.593883209604314,0.07093260031615167,580.4432806968689,263.1634330749512,398.39627838134766,12949,3510,9439,9439,0,15,4024000.0
4024,4024999,21.155347652004608,38.59301661238442,0.0709203826144863,580.682904958725,263.2307050228119,398.33460998535156,12957,3513,9444,9444,0,15,4025000.0
4025,4025999,21.15477959708115,38.59112395097037,0.07091013369468813,580.8130631446838,263.29651975631714,398.4473190307617,12957,3513,9444,9444,0,15,4026000.0
4026,4026999,21.153764044344694,38.58893816764128,0.07089745081771592,580.9401228427887,263.3624336719513,399.06693267822266,12972,3513,9459,9459,0,15,4027000.0
4027,4027999,21.152661467532013,38.58798811034843,0.07088995362260031,581.058554649353,263.4278380870819,399.31591415405273,12972,3513,9459,9459,0,15,4028000.0
4028,4028999,21.151205615298384,38.5850147365702,0.0708924865511773,581.2115440368652,263.4932818412781,399.40552520751953,12974,3514,9460,9460,0,15,4029000.0
4029,4029999,21.149625167120057,38.58246328173257,0.07089060853261109,581.3667302131653,263.55882120132446,399.5581398010254,12981,3515,9466,9466,0,15,4030000.0
4030,4030999,21.148591922068476,38.58107017025692,0.07087723222464848,581.6030919551849,263.62502574920654,399.5802688598633,12989,3519,9470,9470,0,15,4031000.0
4031,4031999,21.147018756041653,38.57780506504172,0.07087680329639168,581.7601306438446,263.69164514541626,399.654239654541,12991,3520,9471,9471,0,15,4032000.0
4032,4032999,21.146002877201017,38.57627341604606,0.07086085757919591,581.9408619403839,263.75776743888855,399.72407150268555,12993,3521,9472,9472,0,15,4033000.0
4033,4033999,21.145210883250886,38.579849175039136,0.07083095370021153,582.0671539306641,263.82382583618164,399.8618354797363,12993,3521,9472,9472,0,15,4034000.0
4034,4034999,21.1443690297413,38.57831023897392,0.070816144914429,582.2233576774597,263.8894736766815,399.9031219482422,12995,3522,9473,9473,0,15,4035000.0
4035,4035999,21.14370552498902,38.57693203421893,0.07080064894563987,582.4282817840576,263.95599818229675,399.8604545593262,12999,3524,9475,9475,0,15,4036000.0
4036,4036999,21.143277121940194,38.57788347713777,0.07077409253323264,582.6548035144806,264.0229597091675,399.81822967529297,13018,3527,9491,9491,0,15,4037000.0
4037,4037999,21.14288088547812,38.57632763872176,0.07075935944436063,582.7790899276733,264.0891442298889,399.92618560791016,13018,3527,9491,9491,0,15,4038000.0
4038,4038999,21.142617844617238,38.57573501604267,0.07074007890947553,582.9187109470367,264.1555459499359,400.00770568847656,13018,3527,9491,9491,0,15,4039000.0
4039,4039999,21.14273613444763,38.577126833561294,0.07071129977118296,583.0488255023956,264.22178983688354,400.11363220214844,13018,3527,9491,9491,0,15,4040000.0
4040,4040999,21.142626470970928,38.57583405933538,0.07069360318593443,583.2376282215118,264.293466091156,400.09363555908203,13020,3528,9492,9492,0,15,4041000.0
4041,4041999,21.143614717880666,38.57591268199241,0.07066801598352379,583.3611114025116,264.3597047328949,400.1638526916504,13020,3528,9492,9492,0,15,4042000.0
4042,4042999,21.143840594219952,38.57490571553466,0.07065369449706937,583.4934120178223,264.4277353286743,400.249080657959,13020,3528,9492,9492,0,15,4043000.0
4043,4043999,21.144573470444676,38.57466724735563,0.07063735708853269,583.6173870563507,264.49348521232605,400.29519271850586,13020,3528,9492,9492,0,15,4044000.0
4044,4044999,21.14538296290049,38.57438276388477,0.0706213187861564,583.7828319072723,264.5598900318146,400.3017997741699,13026,3529,9497,9497,0,15,4045000.0
4045,4045999,21.145602577179634,38.573103251254295,0.07061276792212112,583.9260604381561,264.6260817050934,400.38420486450195,13026,3529,9497,9497,0,15,4046000.0
4046,4046999,21.145036275987106,38.571978604161,0.07059578493893415,584.114226102829,264.6925776004791,401.0892791748047,13057,3531,9526,9526,0,15,4047000.0
4047,4047999,21.14322805184297,38.57087415373902,0.070593843874171,584.2257537841797,264.75781750679016,401.5063819885254,13059,3531,9528,9528,0,15,4048000.0
4048,4048999,21.141527895372626,38.56805508752752,0.07059446133689451,584.3799407482147,264.8230974674225,401.75023651123047,13066,3532,9534,9534,0,15,4049000.0
4049,4049999,21.14004552561957,38.565858820041775,0.07059060438604947,584.5330255031586,264.8881390094757,401.88443756103516,13068,3533,9535,9535,0,15,4050000.0
4050,4050999,21.138608272600965,38.56298494452494,0.07058818063368821,584.7192192077637,264.9538116455078,401.99728775024414,13072,3535,9537,9537,0,15,4051000.0
4051,4051999,21.137463715306147,38.56040648965096,0.0705860250312168,584.8945937156677,265.01922082901,402.1338310241699,13076,3537,9539,9539,0,15,4052000.0
4052,4052999,21.136696783805156,38.558790279602725,0.07058412945275205,585.0418202877045,265.0860776901245,402.2703628540039,13078,3538,9540,9540,0,15,4053000.0
4053,4053999,21.13619798974973,38.55734185262148,0.07057964946635542,585.2328176498413,265.151798248291,402.2972755432129,13082,3540,9542,9542,0,15,4054000.0
4054,4054999,21.13585846674671,38.55618689008299,0.07057503753256367,585.4568777084351,265.2182424068451,402.38712310791016,13088,3543,9545,9545,0,15,4055000.0
4055,4055999,21.135998512536943,38.5558018614016,0.07057718994168405,585.6681518554688,265.2843050956726,402.4021224975586,13099,3546,9553,9553,0,15,4056000.0
4056,4056999,21.1365517270065,38.55679604412894,0.07057290148890472,585.8235158920288,265.3502538204193,402.54647064208984,13101,3547,9554,9554,0,15,4057000.0
4057,4057999,21.137289954094253,38.558009142587295,0.07057128088063813,585.9430322647095,265.4158544540405,402.68181228637695,13101,3547,9554,9554,0,15,4058000.0
4058,4058999,21.138304821434218,38.56006061015833,0.0705720122110326,586.1294867992401,265.4819402694702,402.71213150024414,13105,3549,9556,9556,0,15,4059000.0
4059,4059999,21.139362902230104,38.56126979815411,0.07059234329574982,586.2864151000977,265.5479419231415,402.7848014831543,13111,3550,9561,9561,0,15,4060000.0
4060,4060999,21.140477584031466,38.562314130484495,0.0705874716764322,586.4514565467834,265.6141109466553,402.8247299194336,13118,3551,9567,9567,0,15,4061000.0
4061,4061999,21.142130419686808,38.56466972806015,0.07059339433983214,586.5753307342529,265.679967880249,402.9448661804199,13118,3551,9567,9567,0,15,4062000.0
4062,4062999,21.144140492773097,38.56692907067898,0.07060982949931771,586.7066507339478,265.7459542751312,403.02973556518555,13118,3551,9567,9567,0,15,4063000.0
4063,4063999,21.146201303428683,38.56887484161581,0.0706010470955325,586.8784384727478,265.81189823150635,403.10675048828125,13120,3552,9568,9568,0,15,4064000.0
4064,4064999,21.14770174954976,38.569948481443475,0.0706027644415943,587.0733079910278,265.8783915042877,403.0963439941406,13124,3554,9570,9570,0,15,4065000.0
4065,4065999,21.14967681731805,38.571364007182176,0.07059921257473267,587.2342803478241,265.94476795196533,403.15026473999023,13126,3555,9571,9571,0,15,4066000.0
4066,4066999,21.15104788145658,38.5712647567169,0.07060050562545139,587.3992557525635,266.01097869873047,403.2229309082031,13133,3556,9577,9577,0,15,4067000.0
4067,4067999,21.152443595072132,38.57383840275436,0.0705900612133904,587.5272228717804,266.0767710208893,403.8413429260254,13153,3556,9597,9597,0,15,4068000.0
4068,4068999,21.15083571878078,38.57080077713346,0.07058556404355776,587.6368231773376,266.14138555526733,404.25414276123047,13156,3556,9600,9600,0,15,4069000.0
4069,4069999,21.14930002650967,38.56841465713921,0.07059034058562741,587.7634768486023,266.2068371772766,404.5176467895508,13156,3556,9600,9600,0,15,4070000.0
4070,4070999,21.148039611058525,38.56853217091477,0.0705780108307148,587.9367752075195,266.2717385292053,404.6072769165039,13160,3558,9602,9602,0,15,4071000.0
4071,4071999,21.14631492586806,38.56542789897225,0.07058663715909275,588.127133846283,266.3372495174408,404.7596130371094,13164,3560,9604,9604,0,15,4072000.0
4072,4072999,21.144786269063836,38.56290959015459,0.07058962643616962,588.2866020202637,266.4040791988373,404.93520736694336,13166,3561,9605,9605,0,15,4073000.0
4073,4073999,21.14343549651379,38.5610351964133,0.0705929627382953,588.4063920974731,266.4692211151123,405.0911293029785,13166,3561,9605,9605,0,15,4074000.0
4074,4074999,21.141844533239592,38.55798166241198,0.07059383432604494,588.5911729335785,266.53522396087646,405.1354675292969,13170,3563,9607,9607,0,15,4075000.0
4075,4075999,21.140443057769904,38.555698964814155,0.07059635902334427,588.7687652111053,266.6008949279785,405.2023048400879,13174,3565,9609,9609,0,15,4076000.0
4076,4076999,21.138856701355046,38.55250808395066,0.07060195651602852,588.95157289505,266.6665737628937,405.2919921875,13178,3567,9611,9611,0,15,4077000.0
4077,4077999,21.13757741480659,38.55016208730334,0.07060138947820116,589.1754879951477,266.73294377326965,405.2347297668457,13189,3570,9619,9619,0,15,4078000.0
4078,4078999,21.136215094384617,38.54758289457719,0.07059825851062052,589.3085412979126,266.79886960983276,405.39369201660156,13189,3570,9619,9619,0,15,4079000.0
4079,4079999,21.134947835828555,38.545206506524366,0.07059440222075286,589.4568543434143,266.86480689048767,405.42958068847656,13191,3571,9620,9620,0,15,4080000.0
4080,4080999,21.134160334957777,38.543516974239424,0.07058322556095209,589.5822203159332,266.93050265312195,405.5211524963379,13191,3571,9620,9620,0,15,4081000.0
4081,4081999,21.133092582324537,38.54099702037032,0.0705757804273559,589.7601866722107,266.99691677093506,405.5774269104004,13198,3572,9626,9626,0,15,4082000.0
4082,4082999,21.13240193099561,38.54254873320592,0.07055720588770631,589.8883302211761,267.06280493736267,405.66010665893555,13198,3572,9626,9626,0,15,4083000.0
4083,4083999,21.131902994868085,38.54126104187642,0.07054930155585215,590.0403971672058,267.12848949432373,405.69010162353516,13200,3573,9627,9627,0,15,4084000.0
4084,4084999,21.131275686625063,38.53961529539807,0.07054067127787989,590.1696076393127,267.19413208961487,405.7685012817383,13200,3573,9627,9627,0,15,4085000.0
4085,4085999,21.130416023288554,38.53734539720041,0.07053950226176453,590.3577587604523,267.26032400131226,405.7376022338867,13204,3575,9629,9629,0,15,4086000.0
4086,4086999,21.12958853882268,38.53496888569959,0.07054084219285728,590.5322034358978,267.32650899887085,405.76710510253906,13206,3576,9630,9630,0,15,4087000.0
4087,4087999,21.12891613773023,38.53259371665115,0.07053912970170484,590.6614942550659,267.3934717178345,405.88111877441406,13206,3576,9630,9630,0,15,4088000.0
4088,4088999,21.127808884379395,38.530066360237704,0.07053697616811483,590.812584400177,267.4595069885254,405.95475006103516,13208,3577,9631,9631,0,15,4089000.0
4089,4089999,21.12564704921216,38.526574966136195,0.07054574741455011,590.9627795219421,267.5274636745453,406.85116958618164,13244,3578,9666,9666,0,15,4090000.0
4090,4090999,21.123468616365415,38.52294853766878,0.07055561202528893,591.1079018115997,267.5933997631073,407.2265739440918,13254,3579,9675,9675,0,15,4091000.0
4091,4091999,21.121103975293273,38.51955992582521,0.07056654980241406,591.2181334495544,267.6587884426117,407.5128517150879,13255,3579,9676,9676,0,15,4092000.0
4092,4092999,21.119153144407743,38.51636317435165,0.07057828167372948,591.3713979721069,267.7244575023651,407.6654396057129,13257,3580,9677,9677,0,15,4093000.0
4093,4093999,21.117611088839126,38.51379515271463,0.07057869880158485,591.5531911849976,267.79047656059265,407.7441635131836,13261,3582,9679,9679,0,15,4094000.0
4094,4094999,21.115872387208025,38.51112893730934,0.07058339167643823,591.773202419281,267.85720443725586,407.81724548339844,13267,3585,9682,9682,0,15,4095000.0
4095,4095999,21.114058706352317,38.50782682407428,0.07059184188529366,591.9561331272125,267.92436242103577,407.91210174560547,13271,3587,9684,9684,0,15,4096000.0
4096,4096999,21.112458242070932,38.50496510387692,0.07059896064760773,592.1327929496765,267.99106907844543,408.033145904541,13275,3589,9686,9686,0,15,4097000.0
4097,4097999,21.110853618977387,38.502963439481775,0.07060030255703253,592.334442615509,268.05786180496216,408.13904571533203,13279,3591,9688,9688,0,15,4098000.0
4098,4098999,21.10961469116628,38.50112815186229,0.07059816131896235,592.458792924881,268.12534165382385,408.2902603149414,13279,3591,9688,9688,0,15,4099000.0
4099,4099999,21.108342660541243,38.49925909652844,0.0705928976383633,592.6437659263611,268.1922585964203,408.34180068969727,13283,3593,9690,9690,0,15,4100000.0
4100,4100999,21.107499130260894,38.49769807262365,0.0705811272773823,592.7744522094727,268.2585709095001,408.5060005187988,13283,3593,9690,9690,0,15,4101000.0
4101,4101999,21.107417645998027,38.50172437428429,0.07055045034960417,592.9198803901672,268.3250138759613,408.58734130859375,13285,3594,9691,9691,0,15,4102000.0
4102,4102999,21.10714760301937,38.50034492169302,0.07053466948642995,593.0806109905243,268.391907453537,408.6182060241699,13287,3595,9692,9692,0,15,4103000.0
4103,4103999,21.107383615153736,38.4999555984807,0.07050787313080575,593.3244681358337,268.4599041938782,408.62230682373047,13293,3598,9695,9695,0,15,4104000.0
4104,4104999,21.107540517232064,38.499755781227165,0.07048118169459672,593.4857211112976,268.5285687446594,408.69919204711914,13295,3599,9696,9696,0,15,4105000.0
4105,4105999,21.107737220486115,38.499243209382975,0.07045683203514985,593.6421291828156,268.5951352119446,408.7958450317383,13297,3600,9697,9697,0,15,4106000.0
4106,4106999,21.108355018200918,38.49898347534201,0.07043162567494943,593.7698800563812,268.66194200515747,408.9567565917969,13297,3600,9697,9697,0,15,4107000.0
4107,4107999,21.10867703962211,38.498402780146385,0.07041949115984436,593.9704015254974,268.7294924259186,408.9952621459961,13311,3602,9709,9709,0,15,4108000.0
4108,4108999,21.109401260653264,38.4978829378922,0.07041417895887714,594.1063356399536,268.79690742492676,409.1026268005371,13311,3602,9709,9709,0,15,4109000.0
4109,4109999,21.10956357176236,38.49637360445624,0.07040765584359387,594.236353635788,268.864057302475,409.2258605957031,13311,3602,9709,9709,0,15,4110000.0
4110,4110999,21.109085598654286,38.494798046681865,0.07040137279180825,594.3938436508179,268.9306855201721,409.8593864440918,13336,3603,9733,9733,0,15,4111000.0
4111,4111999,21.108126925269083,38.49252869401706,0.07039160718748971,594.5484261512756,268.99636816978455,410.15205001831055,13344,3604,9740,9740,0,15,4112000.0
4112,4112999,21.10783010384939,38.49128119921357,0.07038565251985307,594.6938660144806,269.0621817111969,410.39596939086914,13347,3605,9742,9742,0,15,4113000.0
4113,4113999,21.10817996167218,38.49155429346715,0.07038780605160999,594.8502817153931,269.12829780578613,410.56836700439453,13349,3606,9743,9743,0,15,4114000.0
4114,4114999,21.108340635403003,38.491515428165435,0.07039840650345541,595.1878452301025,269.19583916664124,410.5362129211426,13368,3613,9755,9755,0,15,4115000.0
4115,4115999,21.108133966591424,38.490275998171576,0.070430003961096,595.3402643203735,269.26267194747925,410.79923248291016,13370,3614,9756,9756,0,15,4116000.0
4116,4116999,21.10829510047307,38.48944169395004,0.07045712361707046,595.5320692062378,269.3301045894623,410.9658317565918,13403,3616,9787,9787,0,15,4117000.0
4117,4117999,21.10833299818254,38.48940260068447,0.07047529367000283,595.6848790645599,269.39639806747437,411.0870475769043,13405,3617,9788,9788,0,15,4118000.0
4118,4118999,21.10855584013982,38.4927065255201,0.07046409724289582,595.846408367157,269.4637701511383,411.17111587524414,13407,3618,9789,9789,0,15,4119000.0
4119,4119999,21.109275204344346,38.49303021744242,0.0704648515803511,595.9677176475525,269.53042697906494,411.3159408569336,13407,3618,9789,9789,0,15,4120000.0
4120,4120999,21.109885073496883,38.493266956122724,0.07047407485437784,596.1645946502686,269.60043382644653,411.3433609008789,13411,3620,9791,9791,0,15,4121000.0
4121,4121999,21.11115936955925,38.49473467415167,0.07045365038050566,596.3344795703888,269.6747884750366,411.4380111694336,13414,3621,9793,9793,0,15,4122000.0
4122,4122999,21.112900370710364,38.49628664060177,0.07045165953275245,596.5862464904785,269.74244570732117,411.4073143005371,13422,3625,9797,9797,0,15,4123000.0
4123,4123999,21.114560415320845,38.498225508440235,0.07045300361423024,596.7075188159943,269.8104839324951,411.5472183227539,13422,3625,9797,9797,0,15,4124000.0
4124,4124999,21.116573294121014,38.50246794101169,0.07045711671058508,596.8710174560547,269.8773396015167,411.63888931274414,13424,3626,9798,9798,0,15,4125000.0
4125,4125999,21.11846763505184,38.50424469783947,0.07047096459355628,597.1294901371002,269.9451005458832,411.58110427856445,13432,3630,9802,9802,0,15,4126000.0
4126,4126999,21.121058178132476,38.5073204779593,0.07050322697025613,597.2892184257507,270.01245403289795,411.67309188842773,13434,3631,9803,9803,0,15,4127000.0
4127,4127999,21.123153456062884,38.50928191748283,0.0705280198060716,597.4243488311768,270.0797507762909,411.84057235717773,13434,3631,9803,9803,0,15,4128000.0
4128,4128999,21.12646858726026,38.5172441655001,0.07057766920881803,597.5722978115082,270.1465697288513,411.94389724731445,13434,3631,9803,9803,0,15,4129000.0
4129,4129999,21.128973209774994,38.519672568353506,0.07059852488589224,597.7359201908112,270.2137784957886,411.9883155822754,13436,3632,9804,9804,0,15,4130000.0
4130,4130999,21.131102026665157,38.52082904457967,0.07061756053802037,597.8951542377472,270.28352880477905,412.06536865234375,13442,3633,9809,9809,0,15,4131000.0
4131,4131999,21.131416279295646,38.52210256187704,0.07062720030829017,598.0917327404022,270.3517162799835,412.53094482421875,13476,3635,9841,9841,0,15,4132000.0
4132,4132999,21.1303918000874,38.52201679129969,0.07060920088404998,598.2334160804749,270.41770458221436,412.9081916809082,13482,3636,9846,9846,0,15,4133000.0
4133,4133999,21.12900177943371,38.52059115667452,0.07060385689842619,598.3427793979645,270.4825587272644,413.1983299255371,13482,3636,9846,9846,0,15,4134000.0
4134,4134999,21.12775536906206,38.51948073962845,0.07059582735795822,598.5189061164856,270.5477271080017,413.3198699951172,13486,3638,9848,9848,0,15,4135000.0
4135,4135999,21.126963064056145,38.519280952710695,0.07057960566524502,598.704446554184,270.613808631897,413.4540252685547,13490,3640,9850,9850,0,15,4136000.0
4136,4136999,21.125974866826244,38.5172390159693,0.07057225398587541,598.9333603382111,270.67958998680115,413.53132247924805,13501,3643,9858,9858,0,15,4137000.0
4137,4137999,21.124751506726444,38.514776357643186,0.07057183987815085,599.1190648078918,270.7457275390625,413.69387435913086,13505,3645,9860,9860,0,15,4138000.0
4138,4138999,21.123663447106775,38.51250419507112,0.07056711453125841,599.2777035236359,270.8116693496704,413.8078498840332,13507,3646,9861,9861,0,15,4139000.0
4139,4139999,21.122777645108037,38.510998581430776,0.07055493606504759,599.5088312625885,270.8846914768219,413.8103942871094,13513,3649,9864,9864,0,15,4140000.0
4140,4140999,21.121829907838904,38.5088934399848,0.07054578164213765,599.6712596416473,270.9508535861969,413.9634323120117,13518,3650,9868,9868,0,15,4141000.0
4141,4141999,21.121291961185968,38.50853925550045,0.07052979402820847,599.8495552539825,271.0168056488037,414.0027275085449,13522,3652,9870,9870,0,15,4142000.0
4142,4142999,21.121254018040073,38.50837003558174,0.07051460182041336,600.0365252494812,271.0829641819,414.08467864990234,13531,3654,9877,9877,0,15,4143000.0
4143,4143999,21.12215861382282,38.51456525534787,0.0704780818118863,600.1712746620178,271.1488218307495,414.2153434753418,13531,3654,9877,9877,0,15,4144000.0
4144,4144999,21.12368380908148,38.517429969149944,0.07045577140261594,600.3699645996094,271.22376918792725,414.2144660949707,13535,3656,9879,9879,0,15,4145000.0
4145,4145999,21.126147376068573,38.52646595383636,0.07041491522375176,600.5309150218964,271.29002380371094,414.30355072021484,13537,3657,9880,9880,0,15,4146000.0
4146,4146999,21.12935767163429,38.53716467394893,0.07040475822540149,600.7044804096222,271.35711216926575,414.4237289428711,13539,3658,9881,9881,0,15,4147000.0
4147,4147999,21.13576514481808,38.55447568417,0.07039141424869344,600.8855576515198,271.4240701198578,414.4487495422363,13543,3660,9883,9883,0,15,4148000.0
4148,4148999,21.14183532554683,38.570598669260214,0.07042269132562284,601.0544550418854,271.4908392429352,414.58813858032227,13545,3661,9884,9884,0,15,4149000.0
4149,4149999,21.147357590120013,38.581648951069376,0.07044088956491579,601.1739370822906,271.55701303482056,414.6871871948242,13545,3661,9884,9884,0,15,4150000.0
4150,4150999,21.153768607370733,38.5961169289693,0.07048072078448697,601.3347673416138,271.62352204322815,414.7029113769531,13547,3662,9885,9885,0,15,4151000.0
4151,4151999,21.159550038149703,38.606624859453994,0.0705870983243374,601.4748079776764,271.6911106109619,414.8639221191406,13547,3662,9885,9885,0,15,4152000.0
4152,4152999,21.162245386870637,38.61029203304913,0.07060040784396793,601.7018268108368,271.7579526901245,415.2695007324219,13572,3665,9907,9907,0,15,4153000.0
4153,4153999,21.161009611410154,38.60828563495056,0.07059547978519465,601.8470764160156,271.8245048522949,415.57687759399414,13579,3666,9913,9913,0,15,4154000.0
4154,4154999,21.159965100839948,38.606654067292155,0.07058907538230841,601.9679343700409,271.88949751853943,415.8061943054199,13580,3666,9914,9914,0,15,4155000.0
4155,4155999,21.159409261317013,38.60731656368059,0.07057595699049246,602.124694108963,271.9543652534485,415.9013900756836,13582,3667,9915,9915,0,15,4156000.0
4156,4156999,21.158894099285305,38.60609365649556,0.0705653792321621,602.3152604103088,272.0204801559448,416.05834579467773,13586,3669,9917,9917,0,15,4157000.0
4157,4157999,21.157889937973742,38.60347343253804,0.07056031195244727,602.5000166893005,272.0872004032135,416.18611907958984,13590,3671,9919,9919,0,15,4158000.0
4158,4158999,21.15687239038149,38.60149012151929,0.07055289718685276,602.6624348163605,272.15309500694275,416.2584648132324,13597,3672,9925,9925,0,15,4159000.0
4159,4159999,21.156044342922414,38.599447209503914,0.0705503856425973,602.8751692771912,272.22782349586487,416.307186126709,13601,3674,9927,9927,0,15,4160000.0
4160,4160999,21.155522871326962,38.59838879305966,0.07053561853443024,602.9931354522705,272.29423666000366,416.4501838684082,13601,3674,9927,9927,0,15,4161000.0
4161,4161999,21.15510765282403,38.59715631232273,0.07052618264527555,603.1077411174774,272.3599741458893,416.5537910461426,13601,3674,9927,9927,0,15,4162000.0
4162,4162999,21.15520690456566,38.596718833263246,0.07050921255608145,603.3119127750397,272.4262421131134,416.5953063964844,13605,3676,9929,9929,0,15,4163000.0
4163,4163999,21.1555905918672,38.59648972120921,0.07048933367371446,603.4518764019012,272.4944350719452,416.6784248352051,13605,3676,9929,9929,0,15,4164000.0
4164,4164999,21.15663755898549,38.59776132396811,0.07046740361108295,603.5707893371582,272.56010150909424,416.7416763305664,13605,3676,9929,9929,0,15,4165000.0
4165,4165999,21.157371860136575,38.598059378812565,0.0704507903890903,603.7009103298187,272.6264810562134,416.8427543640137,13605,3676,9929,9929,0,15,4166000.0
4166,4166999,21.15929976005325,38.604353297175884,0.07041019137856486,603.8273739814758,272.69215536117554,416.91441345214844,13605,3676,9929,9929,0,15,4167000.0
4167,4167999,21.160027707747176,38.604400818934096,0.07039363890487793,603.9596390724182,272.7580261230469,416.982852935791,13605,3676,9929,9929,0,15,4168000.0
4168,4168999,21.160748974432448,38.604177132266,0.07038444748861383,604.1021611690521,272.82359552383423,417.0351753234863,13605,3676,9929,9929,0,15,4169000.0
4169,4169999,21.16148939808902,38.60408046544859,0.07037969093771246,604.2339956760406,272.8900408744812,417.07391357421875,13605,3676,9929,9929,0,15,4170000.0
4170,4170999,21.161756089522765,38.60335519306201,0.07037442899303259,604.3652606010437,272.9616701602936,417.1454277038574,13605,3676,9929,9929,0,15,4171000.0
4171,4171999,21.160632811272347,38.60059572993534,0.0703710259127841,604.5900950431824,273.0274004936218,417.2676658630371,13621,3679,9942,9942,0,15,4172000.0
4172,4172999,21.159123001776432,38.59763295519591,0.0703725961636511,604.7087416648865,273.0919780731201,417.4343719482422,13621,3679,9942,9942,0,15,4173000.0
4173,4173999,21.157933515860183,38.59624462992657,0.07036865870330367,604.8501954078674,273.1570653915405,417.54402923583984,13621,3679,9942,9942,0,15,4174000.0
4174,4174999,21.156839844035964,38.59426322287006,0.07036758793993403,605.0189507007599,273.2222261428833,417.59976959228516,13623,3680,9943,9943,0,15,4175000.0
4175,4175999,21.15599813466976,38.59237067228023,0.0703615513304765,605.157196521759,273.28692841529846,417.7031440734863,13623,3680,9943,9943,0,15,4176000.0
4176,4176999,21.155223469022246,38.59065377831737,0.07035085924086348,605.3195877075195,273.35197949409485,417.7510452270508,13630,3681,9949,9949,0,15,4177000.0
4177,4177999,21.154257689552313,38.58946383429899,0.07034572198710065,605.4972674846649,273.41698455810547,417.7177391052246,13636,3682,9954,9954,0,15,4178000.0
4178,4178999,21.154847487244332,38.59327008473398,0.07031709706611544,605.6348178386688,273.4821786880493,417.76924896240234,13636,3682,9954,9954,0,15,4179000.0
4179,4179999,21.158315172323434,38.606247919738735,0.07025638188438199,605.8594090938568,273.5477545261383,417.6352996826172,13650,3685,9965,9965,0,15,4180000.0
4180,4180999,21.162263918622813,38.61920023268855,0.07020670930996342,606.0379650592804,273.6134543418884,417.65989685058594,13652,3686,9966,9966,0,15,4181000.0
4181,4181999,21.169010466615408,38.64425801660847,0.07013608566149099,606.233149766922,273.67924189567566,417.6516990661621,13661,3688,9973,9973,0,15,4182000.0
4182,4182999,21.176450260397957,38.66686897021664,0.07008926719192943,606.441410779953,273.7450180053711,417.50792694091797,13669,3690,9979,9979,0,15,4183000.0
4183,4183999,21.184675173551064,38.69315428731372,0.0700289193272392,606.6029899120331,273.8104302883148,417.4774932861328,13675,3691,9984,9984,0,15,4184000.0
4184,4184999,21.192171235849873,38.71479690528392,0.06999675349282308,606.8148443698883,273.87674021720886,417.4528465270996,13686,3693,9993,9993,0,15,4185000.0
4185,4185999,21.200843236180475,38.73678254589657,0.07002268561808789,606.9746527671814,273.9426019191742,417.5253143310547,13688,3694,9994,9994,0,15,4186000.0
4186,4186999,21.210438536237447,38.766212218720284,0.07006068119281961,607.1700601577759,274.0086739063263,417.4762268066406,13699,3696,10003,10003,0,15,4187000.0
4187,4187999,21.217612090177266,38.78222173541532,0.07011913400554526,607.3045833110809,274.0736610889435,417.5612487792969,13699,3696,10003,10003,0,15,4188000.0
4188,4188999,21.226215644614978,38.80505996621798,0.07020477008204151,607.5033490657806,274.1402976512909,417.4921989440918,13710,3698,10012,10012,0,15,4189000.0
4189,4189999,21.233716930190447,38.820981924386764,0.07031436958530912,607.6802804470062,274.20642256736755,417.516845703125,13716,3699,10017,10017,0,15,4190000.0
4190,4190999,21.237141571467916,38.82823562831181,0.07036055886600312,607.8552899360657,274.2721493244171,417.79235458374023,13727,3700,10027,10027,0,15,4191000.0
4191,4191999,21.236646629990023,38.82997911692705,0.07034133893023842,607.9703783988953,274.33690571784973,417.9930725097656,13727,3700,10027,10027,0,15,4192000.0
4192,4192999,21.236840003519948,38.833189080146745,0.07031132416892316,608.1642553806305,274.40224623680115,417.9865379333496,13735,3702,10033,10033,0,15,4193000.0
4193,4193999,21.237154874557834,38.83445609144152,0.07028481545531529,608.3828213214874,274.4679379463196,417.9386100769043,13745,3705,10040,10040,0,15,4194000.0
4194,4194999,21.237421502633293,38.83498265373137,0.07027193940080034,608.5444266796112,274.53444051742554,418.0491943359375,13747,3706,10041,10041,0,15,4195000.0
4195,4195999,21.23728785961479,38.83430216099781,0.07025772102971872,608.7406268119812,274.6002388000488,418.039306640625,13755,3708,10047,10047,0,15,4196000.0
4196,4196999,21.236986143463294,38.833509603519246,0.0702445415585562,608.8585214614868,274.6657612323761,418.20115661621094,13755,3708,10047,10047,0,15,4197000.0
4197,4197999,21.23712531333381,38.83299484411566,0.07023554992990422,609.0615539550781,274.73193645477295,418.1625862121582,13763,3710,10053,10053,0,15,4198000.0
4198,4198999,21.237547265507725,38.83372247510194,0.07022055721814424,609.2378344535828,274.7981641292572,418.2142868041992,13769,3711,10058,10058,0,15,4199000.0
4199,4199999,21.237988274878212,38.83428843238005,0.07022423959297486,609.4359767436981,274.8649890422821,418.23709869384766,13776,3713,10063,10063,0,15,4200000.0
4200,4200999,21.23908257356381,38.836446073973455,0.07022169000928624,609.5662252902985,274.93064761161804,418.33190155029297,13776,3713,10063,10063,0,15,4201000.0
4201,4201999,21.240334521487185,38.83882981374141,0.07022143083009014,609.6940748691559,274.99734354019165,418.4512825012207,13776,3713,10063,10063,0,15,4202000.0
4202,4202999,21.242483230102284,38.841959138369695,0.07023225587084736,609.8555881977081,275.0631341934204,418.45752334594727,13782,3714,10068,10068,0,15,4203000.0
4203,4203999,21.244707028808005,38.845574573120096,0.07024025044942706,610.0161099433899,275.12928915023804,418.5188102722168,13782,3714,10068,10068,0,15,4204000.0
4204,4204999,21.24731670476528,38.848428142655415,0.07025147756991001,610.1797614097595,275.1949670314789,418.54607009887695,13788,3715,10073,10073,0,15,4205000.0
4205,4205999,21.250566848748193,38.85390548861731,0.07026794656931112,610.304993391037,275.2605152130127,418.6132164001465,13788,3715,10073,10073,0,15,4206000.0
4206,4206999,21.2535861045526,38.85793258319964,0.0702819997896238,610.4604029655457,275.32642436027527,418.6209182739258,13792,3716,10076,10076,0,15,4207000.0
4207,4207999,21.25696896281211,38.86333589245635,0.0703034372521566,610.5980706214905,275.3920841217041,418.6804618835449,13792,3716,10076,10076,0,15,4208000.0
4208,4208999,21.25958670198791,38.866173432770296,0.07032816653856666,610.7715873718262,275.4576439857483,418.66551208496094,13797,3717,10080,10080,0,15,4209000.0
4209,4209999,21.262790208985876,38.86993937212937,0.07036476163580474,610.9397733211517,275.5242486000061,418.66543197631836,13799,3718,10081,10081,0,15,4210000.0
4210,4210999,21.264497065066546,38.87062193500265,0.07038875774132247,611.103170633316,275.59090924263,418.69139099121094,13805,3719,10086,10086,0,15,4211000.0
4211,4211999,21.265062033454438,38.87064048828167,0.07039406691936845,611.3425121307373,275.6561634540558,418.6687316894531,13822,3722,10100,10100,0,15,4212000.0
4212,4212999,21.26377065116263,38.869210546231166,0.07038996168180023,611.4762604236603,275.72058296203613,418.8144416809082,13823,3722,10101,10101,0,15,4213000.0
4213,4213999,21.26243600690971,38.86666321852404,0.07039005189142578,611.6017887592316,275.78451228141785,418.9130401611328,13823,3722,10101,10101,0,15,4214000.0
4214,4214999,21.26145503571163,38.864344269236405,0.07038880594431396,611.795254945755,275.8489441871643,418.898738861084,13828,3724,10104,10104,0,15,4215000.0
4215,4215999,21.260271678628808,38.86182692290489,0.07038569257419858,611.970584154129,275.914430141449,418.99635314941406,13831,3725,10106,10106,0,15,4216000.0
4216,4216999,21.259181376240544,38.86003786567168,0.07037848521641388,612.0999135971069,275.9790759086609,419.088134765625,13831,3725,10106,10106,0,15,4217000.0
4217,4217999,21.25797044016151,38.857484463379514,0.07037882759142777,612.2342710494995,276.04366302490234,419.17499923706055,13831,3725,10106,10106,0,15,4218000.0
4218,4218999,21.25671816598433,38.854828961042315,0.07037388395394506,612.4004001617432,276.10851073265076,419.1898956298828,13833,3726,10107,10107,0,15,4219000.0
4219,4219999,21.255970844209624,38.85369712532398,0.07036606551625268,612.5518045425415,276.1735544204712,419.23670959472656,13833,3726,10107,10107,0,15,4220000.0
4220,4220999,21.25532234617697,38.85241792664147,0.07035701557261753,612.6797273159027,276.2385776042938,419.2754669189453,13833,3726,10107,10107,0,15,4221000.0
4221,4221999,21.25450937363766,38.85037273783737,0.07034861653650804,612.8340916633606,276.3039915561676,419.3009033203125,13833,3726,10107,10107,0,15,4222000.0
4222,4222999,21.25406701880583,38.84908071834109,0.07034774261809251,612.9851140975952,276.368860244751,419.2633399963379,13837,3727,10110,10110,0,15,4223000.0
4223,4223999,21.255192974151765,38.85119621040324,0.07034333769255674,613.1338851451874,276.4345841407776,419.3107261657715,13837,3727,10110,10110,0,15,4224000.0
4224,4224999,21.256256068297517,38.853209509800685,0.07033790182974609,613.2654292583466,276.49946784973145,419.3385200500488,13837,3727,10110,10110,0,15,4225000.0
4225,4225999,21.257974521465318,38.855592242709,0.07034251655376955,613.4325025081635,276.5652709007263,419.32471466064453,13839,3728,10111,10111,0,15,4226000.0
4226,4226999,21.259300306039165,38.85811466456031,0.07035559745342002,613.5550627708435,276.6301198005676,419.3696098327637,13839,3728,10111,10111,0,15,4227000.0
4227,4227999,21.26143866678838,38.86512402538125,0.0703446703837407,613.733225107193,276.6951575279236,419.29194259643555,13841,3729,10112,10112,0,15,4228000.0
4228,4228999,21.263748470244337,38.869446851021955,0.07035163698625291,613.8704166412354,276.7601454257965,419.3857841491699,13841,3729,10112,10112,0,15,4229000.0
4229,4229999,21.265323440197776,38.872494002565716,0.07036361960485737,614.0021011829376,276.8247003555298,419.42333984375,13841,3729,10112,10112,0,15,4230000.0
4230,4230999,21.266815797207272,38.87345280080654,0.07036673413224803,614.1474521160126,276.8900365829468,419.44652938842773,13841,3729,10112,10112,0,15,4231000.0
4231,4231999,21.26806016457371,38.87404756888773,0.07037768106040321,614.2808706760406,276.955274105072,419.48278427124023,13841,3729,10112,10112,0,15,4232000.0
4232,4232999,21.26792574191373,38.872567949848964,0.07038052358502211,614.451162815094,277.02017855644226,419.73229217529297,13858,3730,10128,10128,0,15,4233000.0
4233,4233999,21.266125759776124,38.86991983434419,0.0703821606328705,614.591564655304,277.0853922367096,420.34875106811523,13873,3731,10142,10142,0,15,4234000.0
4234,4234999,21.26413417365303,38.867671377194455,0.07038612372170716,614.7354593276978,277.15022587776184,420.64733505249023,13878,3732,10146,10146,0,15,4235000.0
4235,4235999,21.262077268275615,38.86452913016225,0.0703927338225393,614.9259462356567,277.2147536277771,420.8021430969238,13883,3734,10149,10149,0,15,4236000.0
4236,4236999,21.26033627885749,38.8617968654294,0.07039648171121327,615.0451240539551,277.27859592437744,420.99738693237305,13885,3734,10151,10151,0,15,4237000.0
4237,4237999,21.259278094927954,38.86060166788103,0.07038283982556104,615.2560889720917,277.3434956073761,421.16241455078125,13895,3737,10158,10158,0,15,4238000.0
4238,4238999,21.25797508130075,38.85815109973509,0.07037676199882814,615.4456989765167,277.4082090854645,421.3152160644531,13899,3739,10160,10160,0,15,4239000.0
4239,4239999,21.25689744209442,38.856345546784674,0.0703659367252707,615.7015614509583,277.47425746917725,421.32513427734375,13908,3743,10165,10165,0,15,4240000.0
4240,4240999,21.25599820443703,38.85453684709718,0.07036260958092,615.8500757217407,277.53905296325684,421.4997329711914,13911,3744,10167,10167,0,15,4241000.0
4241,4241999,21.255673205452048,38.85448955102666,0.07035559516166778,616.0046210289001,277.6053476333618,421.70677947998047,13914,3745,10169,10169,0,15,4242000.0
4242,4242999,21.255433169057692,38.85393008106812,0.07034705537127661,616.1635580062866,277.670512676239,421.7925910949707,13916,3746,10170,10170,0,15,4243000.0
4243,4243999,21.255287078520762,38.85300148949953,0.07033916128456019,616.3295409679413,277.73550510406494,421.9210395812988,13919,3747,10172,10172,0,15,4244000.0
4244,4244999,21.256060938774507,38.853450810809065,0.07033808513577289,616.4873299598694,277.80108642578125,422.0343017578125,13922,3748,10174,10174,0,15,4245000.0
4245,4245999,21.25733713960878,38.8573603813967,0.07033556513257988,616.6673502922058,277.8672471046448,422.11303329467773,13924,3749,10175,10175,0,15,4246000.0
4246,4246999,21.25916480946202,38.85974934181592,0.07035307847839578,616.785507440567,277.93284273147583,422.24232482910156,13924,3749,10175,10175,0,15,4247000.0
4247,4247999,21.260534156590037,38.86109769037119,0.07037170435840645,616.9509422779083,277.9996454715729,422.2986946105957,13926,3750,10176,10176,0,15,4248000.0
4248,4248999,21.262929612405337,38.86447146557383,0.07040727021835969,617.0737071037292,278.064918756485,422.39785385131836,13926,3750,10176,10176,0,15,4249000.0
4249,4249999,21.264996683339366,38.866693114262596,0.07043564325490148,617.3194425106049,278.13129901885986,422.311580657959,13932,3753,10179,10179,0,15,4250000.0
4250,4250999,21.26695816981083,38.868705313334054,0.07048901406176489,617.4404814243317,278.1968095302582,422.4540786743164,13932,3753,10179,10179,0,15,4251000.0
4251,4251999,21.268627260146612,38.86997951819182,0.07052690651716997,617.5763838291168,278.2626016139984,422.5489692687988,13932,3753,10179,10179,0,15,4252000.0
4252,4252999,21.270325912863825,38.87078295448713,0.07056767509130613,617.7077915668488,278.3289828300476,422.650390625,13932,3753,10179,10179,0,15,4253000.0
4253,4253999,21.271079126635463,38.871872691202284,0.07059314261322702,617.8444497585297,278.39402198791504,422.74732208251953,13932,3753,10179,10179,0,15,4254000.0
4254,4254999,21.269511949434005,38.86897594798511,0.07059591016261679,617.9564237594604,278.4583811759949,423.62003326416016,13953,3753,10200,10200,0,15,4255000.0
4255,4255999,21.267339572240367,38.866394545067216,0.0706047224869677,618.0669162273407,278.52230048179626,423.9391555786133,13953,3753,10200,10200,0,15,4256000.0
4256,4256999,21.265444425639235,38.863960795767134,0.07061154802741665,618.2703077793121,278.58625984191895,423.9835510253906,13965,3756,10209,10209,0,15,4257000.0
4257,4257999,21.26393845939606,38.86218463843914,0.07061454978262027,618.4745535850525,278.6508209705353,424.1313896179199,13972,3759,10213,10213,0,15,4258000.0
4258,4258999,21.262736330359314,38.861485076881415,0.07060574686227039,618.6628420352936,278.7169842720032,424.3005027770996,13976,3761,10215,10215,0,15,4259000.0
4259,4259999,21.26131238217734,38.860277415150506,0.0706036225893989,618.815589427948,278.78152298927307,424.5092430114746,13978,3762,10216,10216,0,15,4260000.0
4260,4260999,21.259814843698262,38.85766200291068,0.07060205489628457,619.0343976020813,278.8467562198639,424.5258483886719,13984,3765,10219,10219,0,15,4261000.0
4261,4261999,21.25857401772605,38.855265389114585,0.07059684397768107,619.1962697505951,278.91219687461853,424.7023506164551,13986,3766,10220,10220,0,15,4262000.0
4262,4262999,21.25731529593884,38.85295980313142,0.07059431562362362,619.3461117744446,278.9769697189331,424.8159599304199,13988,3767,10221,10221,0,15,4263000.0
4263,4263999,21.256755892992864,38.85235214223486,0.0705804750958482,619.5381529331207,279.0422396659851,424.7975654602051,13992,3769,10223,10223,0,15,4264000.0
4264,4264999,21.255837382808696,38.85016362454618,0.07057384025724378,619.6683609485626,279.1074872016907,424.95457458496094,13992,3769,10223,10223,0,15,4265000.0
4265,4265999,21.254885720253817,38.84841873824694,0.07056875016792608,619.8259468078613,279.17271661758423,425.05469131469727,13994,3770,10224,10224,0,15,4266000.0
4266,4266999,21.255058108244537,38.849684690886775,0.07054641296342112,619.9960017204285,279.23794317245483,425.0989761352539,13996,3771,10225,10225,0,15,4267000.0
4267,4267999,21.25440592037041,38.847666081416854,0.07054640117132693,620.1643099784851,279.30306601524353,425.1645851135254,14003,3772,10231,10231,0,15,4268000.0
4268,4268999,21.254338488066658,38.847070790669235,0.070536561991143,620.2814087867737,279.3680396080017,425.2769012451172,14003,3772,10231,10231,0,15,4269000.0
4269,4269999,21.254247181093064,38.847348505446014,0.07053281244131893,620.420202255249,279.43327617645264,425.3663520812988,14003,3772,10231,10231,0,15,4270000.0
4270,4270999,21.254123787519802,38.846638996051965,0.07052823740566783,620.5486288070679,279.4986298084259,425.44753646850586,14003,3772,10231,10231,0,15,4271000.0
4271,4271999,21.254422451958124,38.848942481951845,0.07052191775451266,620.6808295249939,279.56342458724976,425.5290069580078,14003,3772,10231,10231,0,15,4272000.0
4272,4272999,21.253984176664453,38.84687295535338,0.07052085742863379,620.849466085434,279.62849044799805,425.54529571533203,14005,3773,10232,10232,0,15,4273000.0
4273,4273999,21.253933447969267,38.84542517592413,0.07051886359728066,620.9915800094604,279.6933579444885,425.60998153686523,14005,3773,10232,10232,0,15,4274000.0
4274,4274999,21.25309764767557,38.84310955390077,0.07052153800493854,621.1188929080963,279.7581672668457,425.6709289550781,14005,3773,10232,10232,0,15,4275000.0
4275,4275999,21.251794683509203,38.84102528708814,0.07051698685767682,621.2338380813599,281.45211267471313,426.3722152709961,14026,3773,10253,10253,0,15,4276000.0
4276,4276999,21.249717258935288,38.838781235437416,0.07052130851488958,621.3529706001282,281.51737904548645,426.7745056152344,14027,3773,10254,10254,0,15,4277000.0
4277,4277999,21.24743590568244,38.83530254412421,0.07053058248342314,621.4712493419647,281.58229756355286,427.0318908691406,14027,3773,10254,10254,0,15,4278000.0
4278,4278999,21.245519922937056,38.8326612593063,0.0705371654014193,621.7201678752899,281.6485252380371,427.10303497314453,14035,3777,10258,10258,0,15,4279000.0
4279,4279999,21.244264161022944,38.831958482477845,0.07052921135801826,621.9038627147675,281.71391558647156,427.26115798950195,14040,3779,10261,10261,0,15,4280000.0
4280,4280999,21.242513892571946,38.82891694516235,0.07053110380547178,622.0622839927673,281.779004573822,427.5059585571289,14042,3780,10262,10262,0,15,4281000.0
4281,4281999,21.2408516028766,38.82635164910458,0.07053086539964071,622.3222675323486,281.8450884819031,427.46459197998047,14050,3784,10266,10266,0,15,4282000.0
4282,4282999,21.239320128240923,38.82375871752794,0.07053234347676396,622.4839725494385,281.91077065467834,427.63865661621094,14052,3785,10267,10267,0,15,4283000.0
4283,4283999,21.23801112159813,38.82217240615315,0.07052738878268427,622.6496362686157,281.9770305156708,427.7688751220703,14054,3786,10268,10268,0,15,4284000.0
4284,4284999,21.23657342478985,38.819411544855015,0.07052859533399403,622.7741174697876,282.04248094558716,427.9231605529785,14054,3786,10268,10268,0,15,4285000.0
4285,4285999,21.23560791230773,38.817685341437006,0.07051962168115111,622.9530575275421,282.10826444625854,428.0188331604004,14056,3787,10269,10269,0,15,4286000.0
4286,4286999,21.235422619987517,38.818868530744204,0.0704961707997771,623.1190173625946,282.17427134513855,428.0968246459961,14058,3788,10270,10270,0,15,4287000.0
4287,4287999,21.23513576053356,38.818112773759,0.07047799447964409,623.2483372688293,282.2399332523346,428.2050018310547,14058,3788,10270,10270,0,15,4288000.0
4288,4288999,21.235007690548315,38.81724747605034,0.07045929239847859,623.3849303722382,282.30571937561035,428.27921295166016,14058,3788,10270,10270,0,15,4289000.0
4289,4289999,21.236069423478853,38.820226191092935,0.07043074931800619,623.562299489975,282.37219405174255,428.33873748779297,14060,3789,10271,10271,0,15,4290000.0
4290,4290999,21.237453265072844,38.82231138943097,0.0704040065813143,623.6931722164154,282.4375958442688,428.41930389404297,14060,3789,10271,10271,0,15,4291000.0
4291,4291999,21.239144276077614,38.82490216692135,0.07038269362485361,623.827974319458,282.50339436531067,428.4815139770508,14060,3789,10271,10271,0,15,4292000.0
4292,4292999,21.241218127521783,38.828564331537564,0.07036587327245425,624.0338983535767,282.56964087486267,428.4578170776367,14069,3791,10278,10278,0,15,4293000.0
4293,4293999,21.24408024507514,38.83609391233079,0.07034710251239251,624.2328913211823,282.63614296913147,428.489013671875,14073,3793,10280,10280,0,15,4294000.0
4294,4294999,21.247533968297635,38.84697159247754,0.07033078915465174,624.373875617981,282.70186495780945,428.5778694152832,14073,3793,10280,10280,0,15,4295000.0
4295,4295999,21.24983857586296,38.85075591177036,0.07034369638121762,624.558435678482,282.7686855792999,428.65234375,14075,3794,10281,10281,0,15,4296000.0
4296,4296999,21.25092647254135,38.85260606233099,0.07035790324051738,624.6828110218048,282.8341443538666,429.20704650878906,14094,3794,10300,10300,0,15,4297000.0
4297,4297999,21.249536368890848,38.85120144444586,0.07034815378710835,624.7985932826996,282.9005994796753,429.6979103088379,14098,3794,10304,10304,0,15,4298000.0
4298,4298999,21.24788697166482,38.84961393218532,0.07034954006579697,624.9120914936066,282.9653310775757,429.98355865478516,14099,3794,10305,10305,0,15,4299000.0
4299,4299999,21.246753850236857,38.84875897927525,0.07034576570300521,625.0626173019409,283.02996039390564,430.1175537109375,14101,3795,10306,10306,0,15,4300000.0
4300,4300999,21.2452617949003,38.846738597628686,0.07034260351160404,625.3834993839264,283.0968623161316,430.1234817504883,14120,3801,10319,10319,0,15,4301000.0
4301,4301999,21.243838001412765,38.844283205404714,0.0703428024224525,625.5411601066589,283.1624083518982,430.3856735229492,14122,3802,10320,10320,0,15,4302000.0
4302,4302999,21.242418589754696,38.84219482433296,0.07033759896665992,625.7811324596405,283.22931265830994,430.4400978088379,14128,3805,10323,10323,0,15,4303000.0
4303,4303999,21.24141227015144,38.84046205709429,0.07033554334875358,625.9056499004364,283.29531383514404,430.6697120666504,14128,3805,10323,10323,0,15,4304000.0
4304,4304999,21.240176377430522,38.838234701460046,0.07033086708274428,626.1043889522552,283.36167454719543,430.73563385009766,14132,3807,10325,10325,0,15,4305000.0
4305,4305999,21.239344704749666,38.836526869808175,0.07032479426416238,626.3337833881378,283.42785024642944,430.6909370422363,14144,3810,10334,10334,0,15,4306000.0
4306,4306999,21.238634593439684,38.83495770765728,0.07031486693273159,626.4664084911346,283.4938774108887,430.8992042541504,14144,3810,10334,10334,0,15,4307000.0
4307,4307999,21.238178948783762,38.83413282668563,0.07029925748993993,626.6024112701416,283.55968260765076,431.02608489990234,14144,3810,10334,10334,0,15,4308000.0
4308,4308999,21.237309382715658,38.83208745972474,0.07028629430971511,626.7619476318359,283.6265552043915,431.0619468688965,14146,3811,10335,10335,0,15,4309000.0
4309,4309999,21.23679694273331,38.830604344144064,0.07027436652527741,626.9311578273773,283.69322752952576,431.18161392211914,14148,3812,10336,10336,0,15,4310000.0
4310,4310999,21.236896019405545,38.83665191958454,0.07023702581058822,627.1348433494568,283.7599124908447,431.2470016479492,14152,3814,10338,10338,0,15,4311000.0
4311,4311999,21.236695577390844,38.835598351903535,0.07022234286860685,627.2874131202698,283.82622027397156,431.35504150390625,14152,3814,10338,10338,0,15,4312000.0
4312,4312999,21.23639005622542,38.83402460271177,0.07021377800622552,627.4824285507202,283.89299273490906,431.35146713256836,14156,3816,10340,10340,0,15,4313000.0
4313,4313999,21.236112390440898,38.83255960143137,0.07020596825977043,627.6171631813049,283.95916748046875,431.4418487548828,14156,3816,10340,10340,0,15,4314000.0
4314,4314999,21.23552558665248,38.830789077747426,0.07020338419242789,627.7507164478302,284.026029586792,431.5513114929199,14156,3816,10340,10340,0,15,4315000.0
4315,4315999,21.234626757489497,38.828614035620575,0.07019439072473088,627.8748652935028,284.0917937755585,432.06354904174805,14171,3816,10355,10355,0,15,4316000.0
4316,4316999,21.23392147111844,38.82738409361778,0.07017906697904897,628.0326499938965,284.1575057506561,432.39593505859375,14182,3817,10365,10365,0,15,4317000.0
4317,4317999,21.233881280388307,38.827703463940665,0.07016703614769237,628.2162442207336,284.22450160980225,432.5262222290039,14186,3819,10367,10367,0,15,4318000.0
4318,4318999,21.23364576995613,38.82743878943361,0.07015672847800491,628.3678197860718,284.29044461250305,432.77164459228516,14188,3820,10368,10368,0,15,4319000.0
4319,4319999,21.233317259325077,38.82605463282222,0.07015506681701067,628.6257083415985,284.35757541656494,432.8505859375,14196,3824,10372,10372,0,15,4320000.0
4320,4320999,21.233091224743557,38.82532640324468,0.07017725187300872,628.829695224762,284.4266641139984,432.9914321899414,14200,3826,10374,10374,0,15,4321000.0
4321,4321999,21.233104834482788,38.82437183502591,0.07017688462549443,629.0659804344177,284.4937677383423,432.97900390625,14206,3829,10377,10377,0,15,4322000.0
4322,4322999,21.232826076310527,38.82329770340073,0.07018356231235778,629.2246582508087,284.56031107902527,433.15010833740234,14208,3830,10378,10378,0,15,4323000.0
4323,4323999,21.23274404906398,38.82228975361115,0.07017961272415507,629.4377307891846,284.6274645328522,433.1807174682617,14212,3832,10380,10380,0,15,4324000.0
4324,4324999,21.23282497951803,38.82142907593948,0.07018234796132139,629.5617477893829,284.694007396698,433.3530921936035,14212,3832,10380,10380,0,15,4325000.0
4325,4325999,21.233195895069265,38.82087329446553,0.0701804921741832,629.6913945674896,284.76079964637756,433.5142402648926,14212,3832,10380,10380,0,15,4326000.0
4326,4326999,21.233918713677127,38.82245002816267,0.07017533321317604,629.896835565567,284.82823944091797,433.53042221069336,14216,3834,10382,10382,0,15,4327000.0
4327,4327999,21.234275469753197,38.82215612655611,0.07018243486244846,630.0639350414276,284.8952307701111,433.61417388916016,14218,3835,10383,10383,0,15,4328000.0
4328,4328999,21.23485217072685,38.82186849261376,0.07019184394997546,630.1910021305084,284.96192717552185,433.7523765563965,14218,3835,10383,10383,0,15,4329000.0
4329,4329999,21.23633210666133,38.82564099748501,0.07019335268982818,630.3240015506744,285.02856945991516,433.8548583984375,14218,3835,10383,10383,0,15,4330000.0
4330,4330999,21.237880565243277,38.826700240549506,0.07022293500398036,630.4869420528412,285.0958061218262,433.9240264892578,14218,3835,10383,10383,0,15,4331000.0
4331,4331999,21.240401002590207,38.82985542572541,0.07027877913485114,630.6277587413788,285.1635015010834,434.0168151855469,14218,3835,10383,10383,0,15,4332000.0
4332,4332999,21.242523310951164,38.83281677435835,0.07032937887537605,630.7506799697876,285.23256492614746,434.07617568969727,14218,3835,10383,10383,0,15,4333000.0
4333,4333999,21.24502351938478,38.835702514147066,0.07036327853512714,630.9047226905823,285.30004715919495,434.11871337890625,14218,3835,10383,10383,0,15,4334000.0
4334,4334999,21.247381110084245,38.838111124916324,0.07040792960124465,631.0380597114563,285.366895198822,434.1888122558594,14218,3835,10383,10383,0,15,4335000.0
4335,4335999,21.24841243892856,38.8385071522348,0.0704170631555252,631.1785318851471,285.433228969574,434.55651473999023,14233,3835,10398,10398,0,15,4336000.0
4336,4336999,21.24709570029535,38.83734103661869,0.07040143911363661,631.296581029892,285.49939584732056,435.2927131652832,14247,3835,10412,10412,0,15,4337000.0
4337,4337999,21.245974905337057,38.839216931575436,0.07038617522735469,631.4166660308838,285.564710855484,435.6263618469238,14247,3835,10412,10412,0,15,4338000.0
4338,4338999,21.244589903871006,38.837017164133115,0.07038771710590952,631.5338661670685,285.63179755210876,435.8483695983887,14247,3835,10412,10412,0,15,4339000.0
4339,4339999,21.243630320879493,38.8355825389939,0.07038221932324751,631.7931144237518,285.6984796524048,435.9660110473633,14258,3839,10419,10419,0,15,4340000.0
4340,4340999,21.24231370950681,38.833275673074084,0.07037846089456345,631.983541727066,285.76657271385193,436.1768341064453,14262,3841,10421,10421,0,15,4341000.0
4341,4341999,21.24125504746584,38.83265757739215,0.07036890615898694,632.1722736358643,285.8333444595337,436.3229446411133,14266,3843,10423,10423,0,15,4342000.0
4342,4342999,21.24075633541342,38.83244691326381,0.0703574841337542,632.4328286647797,285.9006745815277,436.322208404541,14274,3847,10427,10427,0,15,4343000.0
4343,4343999,21.24012712947099,38.830918883966135,0.07035241246370771,632.5622444152832,285.9673285484314,436.5616989135742,14274,3847,10427,10427,0,15,4344000.0
4344,4344999,21.239697074246095,38.829143622828006,0.07034888763246305,632.7863876819611,286.0364365577698,436.6651191711426,14280,3850,10430,10430,0,15,4345000.0
4345,4345999,21.240255505434032,38.83010763581148,0.07033555453932872,632.948814868927,286.1029031276703,436.77975845336914,14282,3851,10431,10431,0,15,4346000.0
4346,4346999,21.24088661336556,38.83091306535513,0.07032352167165512,633.0783474445343,286.1704409122467,436.94726943969727,14282,3851,10431,10431,0,15,4347000.0
4347,4347999,21.241502006619424,38.83169590711263,0.07031524498398556,633.2493405342102,286.23772644996643,437.0272331237793,14284,3852,10432,10432,0,15,4348000.0
4348,4348999,21.242491089610585,38.83313525239564,0.07030709738165508,633.4566378593445,286.3046934604645,436.9899253845215,14288,3854,10434,10434,0,15,4349000.0
4349,4349999,21.244299472021474,38.83780681313203,0.07030071231250823,633.6486532688141,286.37203884124756,437.07254791259766,14298,3856,10442,10442,0,15,4350000.0
4350,4350999,21.246156124951593,38.84533327752265,0.0702879512235337,633.7899489402771,286.43926906585693,437.22955322265625,14298,3856,10442,10442,0,15,4351000.0
4351,4351999,21.248469326311533,38.8486153020333,0.0703042784554,633.9596700668335,286.5062777996063,437.2510108947754,14300,3857,10443,10443,0,15,4352000.0
4352,4352999,21.250728027878584,38.85137144776207,0.07032060078645663,634.0831768512726,286.57292890548706,437.4053764343262,14300,3857,10443,10443,0,15,4353000.0
4353,4353999,21.253198167293498,38.854324080843085,0.07033878156518214,634.2015798091888,286.6394417285919,437.4900016784668,14300,3857,10443,10443,0,15,4354000.0
4354,4354999,21.255457816857906,38.856411561384895,0.07035731129043021,634.3502178192139,286.7063925266266,437.5379333496094,14300,3857,10443,10443,0,15,4355000.0
4355,4355999,21.25823776102039,38.85934376676322,0.07039374979912727,634.5570673942566,286.7740366458893,437.55371856689453,14304,3859,10445,10445,0,15,4356000.0
4356,4356999,21.258926501325615,38.85845846834406,0.07041261732388215,634.7256591320038,286.8405866622925,437.58270263671875,14306,3860,10446,10446,0,15,4357000.0
4357,4357999,21.257737853737694,38.856442873757935,0.0704062010541191,634.8576505184174,286.9071397781372,438.4020233154297,14328,3860,10468,10468,0,15,4358000.0
4358,4358999,21.256484196029174,38.85649801660749,0.07039704757354215,635.0027391910553,286.9735825061798,438.69143295288086,14333,3861,10472,10472,0,15,4359000.0
4359,4359999,21.25578374345793,38.8559522599395,0.07039388975864125,635.1158003807068,287.038782119751,438.9784927368164,14334,3861,10473,10473,0,15,4360000.0
4360,4360999,21.255379407473065,38.85526424883161,0.07039377036682615,635.3713366985321,287.10467982292175,439.0536994934082,14343,3865,10478,10478,0,15,4361000.0
4361,4361999,21.255690434243487,38.85730969636223,0.07036742155211873,635.5607929229736,287.1706440448761,439.2205123901367,14347,3867,10480,10480,0,15,4362000.0
4362,4362999,21.255686874233756,38.857470489919365,0.07036712403670042,635.7152526378632,287.23635745048523,439.39560317993164,14349,3868,10481,10481,0,15,4363000.0
4363,4363999,21.255226776140706,38.855980348472094,0.0703721648018455,635.8747951984406,287.3024661540985,439.482723236084,14351,3869,10482,10482,0,15,4364000.0
4364,4364999,21.255262794021743,38.855334029020355,0.07037039642945508,636.1063649654388,287.36878848075867,439.55893325805664,14357,3872,10485,10485,0,15,4365000.0
4365,4365999,21.25482763389618,38.85376164025593,0.07037070572087745,636.2292673587799,287.435574054718,439.70964431762695,14357,3872,10485,10485,0,15,4366000.0
4366,4366999,21.25499860987995,38.85332608180972,0.07037277982877355,636.427577495575,287.5018606185913,439.75732803344727,14361,3874,10487,10487,0,15,4367000.0
4367,4367999,21.25472342449254,38.852378689748214,0.07037344518462851,636.5785579681396,287.56799960136414,439.8672904968262,14363,3875,10488,10488,0,15,4368000.0
4368,4368999,21.25496671913657,38.85208377827315,0.07037738281832229,636.707852602005,287.6341097354889,440.02063751220703,14363,3875,10488,10488,0,15,4369000.0
4369,4369999,21.255409361448685,38.85262196622497,0.07037225722557727,636.925591468811,287.7007324695587,440.0958251953125,14387,3877,10510,10510,0,15,4370000.0
4370,4370999,21.25610812259282,38.8528993009778,0.07034895237900451,637.092054605484,287.7683069705963,440.17933654785156,14389,3878,10511,10511,0,15,4371000.0
4371,4371999,21.25647172471398,38.8525004166188,0.07033921899062723,637.2164483070374,287.8341565132141,440.3412094116211,14389,3878,10511,10511,0,15,4372000.0
4372,4372999,21.25746966477308,38.85346048889608,0.07033358725545491,637.4257764816284,287.9008626937866,440.3849067687988,14393,3880,10513,10513,0,15,4373000.0
4373,4373999,21.258245805500597,38.85370762341424,0.07033509060663157,637.5699815750122,287.96690678596497,440.5288887023926,14393,3880,10513,10513,0,15,4374000.0
4374,4374999,21.258954318435972,38.85454067489451,0.07032799543539947,637.6932866573334,288.0325996875763,440.61705780029297,14393,3880,10513,10513,0,15,4375000.0
4375,4375999,21.259723589771756,38.8552852811917,0.07031730775880252,637.8276474475861,288.09866094589233,440.71657943725586,14393,3880,10513,10513,0,15,4376000.0
4376,4376999,21.260136336286312,38.85469676359358,0.07031926160838475,637.9582393169403,288.1649434566498,440.80738067626953,14393,3880,10513,10513,0,15,4377000.0
4377,4377999,21.260257904282287,38.854471491111276,0.07031312937553913,638.1526098251343,288.2324104309082,440.8036003112793,14397,3882,10515,10515,0,15,4378000.0
4378,4378999,21.260547119155618,38.85519165030915,0.0702681479620163,638.2870535850525,288.2983343601227,441.58924102783203,14418,3882,10536,10536,0,15,4379000.0
4379,4379999,21.260014430342935,38.85605058092967,0.07025393624525489,638.3958387374878,288.36289262771606,441.891902923584,14418,3882,10536,10536,0,15,4380000.0
4380,4380999,21.25951890150848,38.8550219677432,0.070249357153512,638.5410053730011,288.42804050445557,442.1173896789551,14422,3883,10539,10539,0,15,4381000.0
4381,4381999,21.25927939147885,38.85499350744077,0.07023482852633856,638.7318227291107,288.4933428764343,442.22929763793945,14427,3885,10542,10542,0,15,4382000.0
4382,4382999,21.259243575237363,38.8544542646751,0.07024763211710994,638.9135897159576,288.55890703201294,442.3701820373535,14432,3887,10545,10545,0,15,4383000.0
4383,4383999,21.259988281212777,38.865077996003855,0.07020140628599414,639.0648055076599,288.6240870952606,442.5619888305664,14434,3888,10546,10546,0,15,4384000.0
4384,4384999,21.25966893218155,38.86458936235469,0.07019745548007683,639.2611162662506,288.6908085346222,442.60949325561523,14438,3890,10548,10548,0,15,4385000.0
4385,4385999,21.25984247667027,38.86463569994947,0.0701997892651951,639.4276821613312,288.7566213607788,442.71875381469727,14440,3891,10549,10549,0,15,4386000.0
4386,4386999,21.259708350633446,38.86444508107359,0.07019512982006282,639.589385509491,288.82269263267517,442.74280548095703,14442,3892,10550,10550,0,15,4387000.0
4387,4387999,21.259753513074585,38.864423414743136,0.07019442407581145,639.7895579338074,288.8896026611328,442.7645149230957,14446,3894,10552,10552,0,15,4388000.0
4388,4388999,21.260228314022886,38.864933365722116,0.07019617734033867,639.946647644043,288.95582938194275,442.8551216125488,14454,3895,10559,10559,0,15,4389000.0
4389,4389999,21.26053348902885,38.86476313899787,0.07020094417326639,640.1880731582642,289.02296590805054,442.8514404296875,14465,3898,10567,10567,0,15,4390000.0
4390,4390999,21.261084815273815,38.866346697559,0.0701948540149,640.3519561290741,289.0902667045593,442.92731857299805,14467,3899,10568,10568,0,15,4391000.0
4391,4391999,21.261709910605887,38.86691376451202,0.07019499622345649,640.4799129962921,289.1561496257782,443.0237922668457,14467,3899,10568,10568,0,15,4392000.0
4392,4392999,21.262493228317386,38.86752074899958,0.07019752392888035,640.6213037967682,289.2223949432373,443.1351509094238,14467,3899,10568,10568,0,15,4393000.0
4393,4393999,21.263534031344825,38.86825847211444,0.07019955796764721,640.7564160823822,289.28847074508667,443.20947647094727,14467,3899,10568,10568,0,15,4394000.0
4394,4394999,21.26554771725689,38.87485268398492,0.07018081844118862,640.9272243976593,289.3554644584656,443.23225021362305,14469,3900,10569,10569,0,15,4395000.0
4395,4395999,21.2667141908082,38.876889925358455,0.07018203713413029,641.0660650730133,289.42201113700867,443.3271026611328,14469,3900,10569,10569,0,15,4396000.0
4396,4396999,21.267947972391962,38.87873067145066,0.07016985561619793,641.1905772686005,289.4877643585205,443.3943672180176,14469,3900,10569,10569,0,15,4397000.0
4397,4397999,21.269207275460236,38.88114842177946,0.0701651374791481,641.3591310977936,289.55421590805054,443.4237365722656,14471,3901,10570,10570,0,15,4398000.0
4398,4398999,21.26963872623939,38.88039107092618,0.07016511106305812,641.5302336215973,289.6205289363861,443.4685859680176,14473,3902,10571,10571,0,15,4399000.0
4399,4399999,21.268974004640707,38.87833237663424,0.0701628250954317,641.6879200935364,289.68657970428467,444.1477966308594,14505,3903,10602,10602,0,15,4400000.0
4400,4400999,21.26721602410804,38.87784778179629,0.07016335355761172,641.799073934555,289.75302362442017,444.5807762145996,14509,3903,10606,10606,0,15,4401000.0
4401,4401999,21.265421242930476,38.87580373875769,0.07016947474629198,641.9532239437103,289.8188726902008,444.7690963745117,14520,3904,10616,10616,0,15,4402000.0
4402,4402999,21.263829497614026,38.87396342359139,0.07017193281943501,642.1393365859985,289.88473749160767,444.88488006591797,14524,3906,10618,10618,0,15,4403000.0
4403,4403999,21.262217350292545,38.871292454215556,0.07017471917002871,642.3975079059601,289.95174407958984,444.94198989868164,14539,3910,10629,10629,0,15,4404000.0
4404,4404999,21.260991217373295,38.869336270943236,0.07017218964135452,642.5532619953156,290.0193204879761,445.14776611328125,14541,3911,10630,10630,0,15,4405000.0
4405,4405999,21.25971576336524,38.866663640049005,0.07017090125625813,642.7381224632263,290.0856981277466,445.22131729125977,14545,3913,10632,10632,0,15,4406000.0
4406,4406999,21.25909163195759,38.865445938644264,0.07015831894133828,642.9365694522858,290.15296602249146,445.35305404663086,14549,3915,10634,10634,0,15,4407000.0
4407,4407999,21.258722078978348,38.86523764042514,0.07014732528707934,643.1340198516846,290.21977066993713,445.36857986450195,14564,3917,10647,10647,0,15,4408000.0
4408,4408999,21.259337874981274,38.86801577919364,0.07012058277129984,643.2599141597748,290.2864611148834,445.52030181884766,14564,3917,10647,10647,0,15,4409000.0
4409,4409999,21.261677015270315,38.87580071531183,0.07008774344074487,643.5037157535553,290.35390520095825,445.5344047546387,14570,3920,10650,10650,0,15,4410000.0
4410,4410999,21.265239504746102,38.88755301649191,0.07004566235175902,643.6995453834534,290.4209189414978,445.62267303466797,14580,3922,10658,10658,0,15,4411000.0
4411,4411999,21.269899174858743,38.906232911966924,0.06999120698483352,643.8811590671539,290.48764657974243,445.7070960998535,14584,3924,10660,10660,0,15,4412000.0
4412,4412999,21.274648819024776,38.91968281217263,0.06997124661288123,644.154477596283,290.55567932128906,445.6573715209961,14592,3928,10664,10664,0,15,4413000.0
4413,4413999,21.279569537589577,38.935168313388466,0.07001565167411206,644.3202774524689,290.6248598098755,445.8407096862793,14594,3929,10665,10665,0,15,4414000.0
4414,4414999,21.285373220472867,38.95364623597759,0.07003922060767132,644.4445555210114,290.69175910949707,445.9943161010742,14594,3929,10665,10665,0,15,4415000.0
4415,4415999,21.29154896662877,38.97469828203486,0.0701005859859829,644.6094717979431,290.7592384815216,446.09192276000977,14596,3930,10666,10666,0,15,4416000.0
4416,4416999,21.29769303175072,38.98893169878541,0.07022297826758384,644.7454164028168,290.8263337612152,446.2296142578125,14596,3930,10666,10666,0,15,4417000.0
4417,4417999,21.30365786550783,39.00519616134687,0.07030701511255821,644.94118309021,290.8937900066376,446.21113204956055,14605,3932,10673,10673,0,15,4418000.0
4418,4418999,21.31088535830563,39.02297811789107,0.0704381096672494,645.1692950725555,290.9613733291626,446.1847038269043,14617,3935,10682,10682,0,15,4419000.0
4419,4419999,21.315933623109473,39.035218810862204,0.07056281547375087,645.3780710697174,291.0287187099457,446.2590103149414,14621,3937,10684,10684,0,15,4420000.0
4420,4420999,21.315889434610764,39.035676408027236,0.07055276254071574,645.4983303546906,291.0946400165558,447.1295738220215,14647,3937,10710,10710,0,15,4421000.0
4421,4421999,21.314157916595814,39.033232103924796,0.07055442364702336,645.6069705486298,291.1590988636017,447.48744201660156,14649,3937,10712,10712,0,15,4422000.0
4422,4422999,21.312854986072125,39.03094900789726,0.07055041015596875,645.7187826633453,291.2234377861023,447.75782775878906,14650,3937,10713,10713,0,15,4423000.0
4423,4423999,21.312330261977216,39.03504931270843,0.07052759071329984,645.9806046485901,291.289532661438,447.7799301147461,14659,3941,10718,10718,0,15,4424000.0
4424,4424999,21.311832325227325,39.03475653019131,0.0705169108002669,646.1277003288269,291.35522079467773,447.9602355957031,14661,3942,10719,10719,0,15,4425000.0
4425,4425999,21.311171333939093,39.03353981266345,0.07050784737086757,646.3585743904114,291.4212658405304,448.0330276489258,14673,3945,10728,10728,0,15,4426000.0
4426,4426999,21.310151523521284,39.031370958386034,0.07050603999338223,646.5418956279755,291.4872570037842,448.113094329834,14677,3947,10730,10730,0,15,4427000.0
4427,4427999,21.309482518716734,39.02943758670141,0.07051116436401916,646.6980855464935,291.5528862476349,448.25832748413086,14679,3948,10731,10731,0,15,4428000.0
4428,4428999,21.30902350207793,39.028045780512066,0.07050711547608601,646.865629196167,291.61933302879333,448.37427520751953,14681,3949,10732,10732,0,15,4429000.0
4429,4429999,21.309313076855144,39.0316464642892,0.07049035604196241,647.0640161037445,291.68575716018677,448.3985137939453,14685,3951,10734,10734,0,15,4430000.0
4430,4430999,21.30996085976186,39.032802444855875,0.07048463344906586,647.3726849555969,291.7532114982605,448.33533096313477,14695,3956,10739,10739,0,15,4431000.0
4431,4431999,21.310813505368532,39.0341545797553,0.07048480344900998,647.4975111484528,291.81973457336426,448.5760803222656,14695,3956,10739,10739,0,15,4432000.0
4432,4432999,21.31175875607516,39.03561782509545,0.07048634814181853,647.689044713974,291.88606452941895,448.5950241088867,14699,3958,10741,10741,0,15,4433000.0
4433,4433999,21.3130328365583,39.037440659611114,0.07049101021744886,647.819010257721,291.95289611816406,448.76343536376953,14699,3958,10741,10741,0,15,4434000.0
4434,4434999,21.31468900586014,39.04072545575228,0.07050765553593863,647.9836776256561,292.01958298683167,448.8791198730469,14702,3959,10743,10743,0,15,4435000.0
4435,4435999,21.317200880827034,39.04494706471574,0.07053612752274607,648.165369272232,292.0861306190491,449.00666427612305,14710,3960,10750,10750,0,15,4436000.0
4436,4436999,21.31921746201582,39.05183290774209,0.0705362551166635,648.3173267841339,292.1523365974426,449.0458106994629,14712,3961,10751,10751,0,15,4437000.0
4437,4437999,21.321174765548637,39.05426624887559,0.07057410527652508,648.4839174747467,292.21969866752625,449.12311935424805,14714,3962,10752,10752,0,15,4438000.0
4438,4438999,21.323543604129398,39.05876931687803,0.07058734705834824,648.6435277462006,292.2865345478058,449.17824935913086,14716,3963,10753,10753,0,15,4439000.0
4439,4439999,21.326123711758658,39.06357970248805,0.07062548587868034,648.7944540977478,292.35291481018066,449.28162384033203,14718,3964,10754,10754,0,15,4440000.0
4440,4440999,21.32767350168645,39.065429512525945,0.0706362084998805,649.008632183075,292.4198844432831,449.2864799499512,14728,3966,10762,10762,0,15,4441000.0
4441,4441999,21.327541951311098,39.06445499093001,0.07063487977412664,649.1750123500824,292.48667764663696,449.95269775390625,14752,3967,10785,10785,0,15,4442000.0
4442,4442999,21.32595435509771,39.0623358198554,0.07063918663094959,649.2904093265533,292.5519335269928,450.3897171020508,14757,3967,10790,10790,0,15,4443000.0
4443,4443999,21.324401885283443,39.06104228595941,0.07064013321253793,649.435818195343,292.61781668663025,450.63757705688477,14760,3968,10792,10792,0,15,4444000.0
4444,4444999,21.322632803118566,39.05871954885016,0.07064768956899992,649.5621783733368,292.68300771713257,450.87855529785156,14760,3968,10792,10792,0,15,4445000.0
4445,4445999,21.32116030660225,39.05626547422289,0.07064898356457161,649.7518312931061,292.74941754341125,451.01974868774414,14765,3970,10795,10795,0,15,4446000.0
4446,4446999,21.319656049623966,39.05374878878095,0.07065338518221898,649.9521777629852,292.8166401386261,451.0855178833008,14774,3972,10802,10802,0,15,4447000.0
4447,4447999,21.318263963368135,39.051552015811225,0.07065109928645164,650.1762270927429,292.88275241851807,451.04699325561523,14780,3975,10805,10805,0,15,4448000.0
4448,4448999,21.31697571218227,39.04900362535712,0.0706544826419565,650.3637268543243,292.94943022727966,451.20649337768555,14785,3977,10808,10808,0,15,4449000.0
4449,4449999,21.315684756740694,39.04653598600024,0.07065754248178158,650.4929845333099,293.0155382156372,451.4113464355469,14785,3977,10808,10808,0,15,4450000.0
4450,4450999,21.314546042812125,39.044648658250814,0.07065666193182663,650.6773061752319,293.08179450035095,451.4291534423828,14789,3979,10810,10810,0,15,4451000.0
4451,4451999,21.313761498763174,39.0424991331669,0.07065149148086691,650.8462522029877,293.14809226989746,451.5400810241699,14791,3980,10811,10811,0,15,4452000.0
4452,4452999,21.312985215796306,39.04110198612656,0.07065011809843114,650.9682233333588,293.21457076072693,451.6843681335449,14791,3980,10811,10811,0,15,4453000.0
4453,4453999,21.3118396111772,39.03861706399399,0.07065230037515113,651.123970746994,293.2809405326843,451.7299270629883,14793,3981,10812,10812,0,15,4454000.0
4454,4454999,21.311049058296756,39.036617051156504,0.07064994936258462,651.2970128059387,293.34723377227783,451.791805267334,14801,3982,10819,10819,0,15,4455000.0
4455,4455999,21.310281741646296,39.034458381891916,0.07064789371927005,651.5137887001038,293.41382360458374,451.77298736572266,14805,3984,10821,10821,0,15,4456000.0
4456,4456999,21.309734759817328,39.03267132126281,0.0706440657020978,651.6362497806549,293.48031210899353,451.8757781982422,14805,3984,10821,10821,0,15,4457000.0
4457,4457999,21.30901252116271,39.03069513179795,0.07064221090477718,651.8010568618774,293.5471076965332,451.9182777404785,14811,3985,10826,10826,0,15,4458000.0
4458,4458999,21.308125801551853,39.02848784895196,0.07064545767324171,652.0059230327606,293.61364459991455,451.883731842041,14815,3987,10828,10828,0,15,4459000.0
4459,4459999,21.307304909373443,39.026687402615295,0.07064628643684512,652.2027158737183,293.6802713871002,451.9668617248535,14819,3989,10830,10830,0,15,4460000.0
4460,4460999,21.306194989546878,39.02530019735872,0.0706420541300492,652.3213324546814,293.7474105358124,452.9122619628906,14849,3989,10860,10860,0,15,4461000.0
4461,4461999,21.3043524951128,39.02261584299946,0.07064989645790087,652.4333252906799,293.81326246261597,453.3474998474121,14852,3989,10863,10863,0,15,4462000.0
4462,4462999,21.302929858441015,39.02099813991264,0.07065553296581151,652.5565328598022,293.8789556026459,453.5914840698242,14852,3989,10863,10863,0,15,4463000.0
4463,4463999,21.301252607872748,39.0184157914873,0.07066484371475834,652.8170292377472,293.9454388618469,453.63622283935547,14864,3993,10871,10871,0,15,4464000.0
4464,4464999,21.29986715152188,39.016393386589314,0.07067097158227365,653.0015060901642,294.01171255111694,453.81622314453125,14868,3995,10873,10873,0,15,4465000.0
4465,4465999,21.298644948393324,39.0147672679467,0.07067453720863537,653.2220585346222,294.0782108306885,453.91093826293945,14880,3998,10882,10882,0,15,4466000.0
4466,4466999,21.297403490087323,39.0162878782485,0.07066184204067716,653.4206116199493,294.1447334289551,453.9847946166992,14884,4000,10884,10884,0,15,4467000.0
4467,4467999,21.29577211808128,39.013466807700304,0.07066632818333773,653.5449929237366,294.21128368377686,454.19556045532227,14884,4000,10884,10884,0,15,4468000.0
4468,4468999,21.29450860881281,39.01101855752142,0.07066433233529057,653.7056238651276,294.2777895927429,454.2988395690918,14886,4001,10885,10885,0,15,4469000.0
4469,4469999,21.293115357658202,39.00854551141962,0.07066869756194594,653.9065892696381,294.3447835445404,454.3375663757324,14890,4003,10887,10887,0,15,4470000.0
4470,4470999,21.292178420025415,39.00667390083556,0.07066345476741609,654.079594373703,294.4115788936615,454.46480560302734,14892,4004,10888,10888,0,15,4471000.0
4471,4471999,21.291477576501315,39.005054319755125,0.07065915008613965,654.2428634166718,294.47774386405945,454.5074996948242,14894,4005,10889,10889,0,15,4472000.0
4472,4472999,21.2907889945181,39.00394080592871,0.07065369572837188,654.3657195568085,294.5441691875458,454.6156425476074,14894,4005,10889,10889,0,15,4473000.0
4473,4473999,21.2901956774691,39.00257051021972,0.07064897956934202,654.496490240097,294.6130681037903,454.73137283325195,14894,4005,10889,10889,0,15,4474000.0
4474,4474999,21.28971422524398,39.001180545180034,0.07063984949907132,654.6259293556213,294.6794936656952,454.8097152709961,14894,4005,10889,10889,0,15,4475000.0
4475,4475999,21.289413460413986,38.99958361802124,0.07063613327131169,654.7637355327606,294.7461416721344,454.8646240234375,14894,4005,10889,10889,0,15,4476000.0
4476,4476999,21.288923111589835,38.99772525510339,0.07063463088053068,654.9937160015106,294.8128385543823,454.7705841064453,14910,4008,10902,10902,0,15,4477000.0
4477,4477999,21.289155105596837,38.99720781057149,0.07061809793445417,655.2058570384979,294.8795521259308,454.7775459289551,14926,4010,10916,10916,0,15,4478000.0
4478,4478999,21.28910316925439,38.99590490089433,0.07061220746712649,655.3298676013947,294.94607949256897,454.85433197021484,14926,4010,10916,10916,0,15,4479000.0
4479,4479999,21.288794735730775,38.99447764833385,0.07060694088510844,655.469131231308,295.0125849246979,454.9559516906738,14926,4010,10916,10916,0,15,4480000.0
4480,4480999,21.288204765209073,38.99328707512872,0.0706001783741168,655.6359627246857,295.08049607276917,455.24322509765625,14938,4011,10927,10927,0,15,4481000.0
4481,4481999,21.286320256056957,38.991183672592214,0.07060651442192489,655.7893509864807,295.14744424819946,456.0592727661133,14969,4012,10957,10957,0,15,4482000.0
4482,4482999,21.284760474151465,38.99186028072967,0.07059862357619218,655.8981266021729,295.2122836112976,456.44500732421875,14971,4012,10959,10959,0,15,4483000.0
4483,4483999,21.28292558586692,38.9894418843281,0.07060581082917206,656.1249992847443,295.2790324687958,456.58698654174805,14977,4015,10962,10962,0,15,4484000.0
4484,4484999,21.2816158618966,38.98865808386207,0.07060464481737361,656.2455716133118,295.34476137161255,456.8638458251953,14978,4015,10963,10963,0,15,4485000.0
4485,4485999,21.280046726582015,38.98612259378887,0.07060616174250212,656.529354095459,295.41103887557983,456.84741973876953,14993,4020,10973,10973,0,15,4486000.0
4486,4486999,21.27848539137261,38.983521699265445,0.07061183268202575,656.6884186267853,295.4778308868408,457.1012535095215,14995,4021,10974,10974,0,15,4487000.0
4487,4487999,21.276781918049696,38.980775974982215,0.07061365080603121,656.9506404399872,295.5454297065735,457.1287651062012,15003,4025,10978,10978,0,15,4488000.0
4488,4488999,21.275487061984126,38.97873324537775,0.07061430011638781,657.1800346374512,295.6128249168396,457.287052154541,15010,4028,10982,10982,0,15,4489000.0
4489,4489999,21.27408551427621,38.97596152418641,0.070615419768435,657.2978987693787,295.6791081428528,457.4919662475586,15010,4028,10982,10982,0,15,4490000.0
4490,4490999,21.272624485273173,38.97336206117347,0.07061798144378706,657.4356689453125,295.74618268013,457.6525115966797,15010,4028,10982,10982,0,15,4491000.0
4491,4491999,21.271691731668614,38.97149078575064,0.07061764852096553,657.5927395820618,295.81267952919006,457.7466011047363,15012,4029,10983,10983,0,15,4492000.0
4492,4492999,21.271072441504877,38.97077770223125,0.07060751836873069,657.7558603286743,295.8795475959778,457.8273010253906,15014,4030,10984,10984,0,15,4493000.0
4493,4493999,21.27054474723492,38.96969452043651,0.0706028306940576,657.9569206237793,295.9473628997803,457.89023208618164,15018,4032,10986,10986,0,15,4494000.0
4494,4494999,21.269927496069705,38.96847762431095,0.07059945799817902,658.1190931797028,296.0138671398163,457.97954177856445,15020,4033,10987,10987,0,15,4495000.0
4495,4495999,21.26986582587066,38.96778263667554,0.07058775290253305,658.3362522125244,296.0813817977905,458.03094482421875,15024,4035,10989,10989,0,15,4496000.0
4496,4496999,21.269508381201412,38.96606827169404,0.07058199750837213,658.457926273346,296.1480221748352,458.1584167480469,15024,4035,10989,10989,0,15,4497000.0
4497,4497999,21.26892465159325,38.96435889245688,0.07058330014183667,658.5800054073334,296.2142210006714,458.28213119506836,15024,4035,10989,10989,0,15,4498000.0
4498,4498999,21.2688737331977,38.963181104889934,0.07057820418976257,658.7325327396393,296.2809188365936,458.3771514892578,15024,4035,10989,10989,0,15,4499000.0
4499,4499999,21.26841798654902,38.96129648179529,0.07057484805441094,658.8874969482422,296.3474278450012,458.4052963256836,15026,4036,10990,10990,0,15,4500000.0
4500,4500999,21.268328420939838,38.96153186378898,0.07056798430509048,659.0345017910004,296.4146828651428,458.5279235839844,15026,4036,10990,10990,0,15,4501000.0
4501,4501999,21.26779615972183,38.95970181627286,0.07056565733400644,659.1540238857269,296.4808979034424,458.6394577026367,15026,4036,10990,10990,0,15,4502000.0
4502,4502999,21.267237000933196,38.95910750911291,0.07055196381698314,659.3188374042511,296.5492241382599,459.533260345459,15057,4037,11020,11020,0,15,4503000.0
4503,4503999,21.265797420782963,38.958775091273424,0.07055179370877795,659.4295976161957,296.6149814128876,460.01642990112305,15063,4037,11026,11026,0,15,4504000.0
4504,4504999,21.264457939894925,38.95628476353465,0.0705560388303238,659.6143839359283,296.6807084083557,460.26862716674805,15069,4039,11030,11030,0,15,4505000.0
4505,4505999,21.263325015728626,38.954258929855136,0.07055793478501915,659.7736623287201,296.7474322319031,460.5065002441406,15072,4040,11032,11032,0,15,4506000.0
4506,4506999,21.261876564036918,38.951377035099384,0.07056544388339714,659.959230184555,296.81340432167053,460.6349411010742,15076,4042,11034,11034,0,15,4507000.0
4507,4507999,21.2610385067914,38.949990760619635,0.07056603361459246,660.1492569446564,296.879435300827,460.868896484375,15080,4044,11036,11036,0,15,4508000.0
4508,4508999,21.26044791565629,38.948164475618384,0.07056915713209266,660.4540836811066,296.9488537311554,460.79528045654297,15090,4049,11041,11041,0,15,4509000.0
4509,4509999,21.259594373195668,38.946222831351285,0.07057937003983428,660.608978509903,297.0154700279236,461.07011795043945,15092,4050,11042,11042,0,15,4510000.0
4510,4510999,21.258597363581107,38.943904115446955,0.07059010117529962,660.8019495010376,297.08238792419434,461.15141677856445,15096,4052,11044,11044,0,15,4511000.0
4511,4511999,21.257842796561846,38.94237548935568,0.07059641511869463,660.9263079166412,297.14960646629333,461.3495750427246,15096,4052,11044,11044,0,15,4512000.0
4512,4512999,21.257208941732834,38.9403756453308,0.07060512331426805,661.049008846283,297.21634244918823,461.4886283874512,15096,4052,11044,11044,0,15,4513000.0
4513,4513999,21.256789089355212,38.9390870902456,0.07061403264055666,661.2211995124817,297.2831087112427,461.5530014038086,15098,4053,11045,11045,0,15,4514000.0
4514,4514999,21.256446818434444,38.93786566831727,0.07061477121331061,661.415441274643,297.3504512310028,461.53116607666016,15102,4055,11047,11047,0,15,4515000.0
4515,4515999,21.256237997659728,38.93674761083785,0.07061220118232381,661.5855257511139,297.41864490509033,461.67227935791016,15104,4056,11048,11048,0,15,4516000.0
4516,4516999,21.256075622632082,38.935087860675644,0.07060623686766132,661.715060710907,297.4855833053589,461.81233978271484,15104,4056,11048,11048,0,15,4517000.0
4517,4517999,21.25604786034825,38.933861341133905,0.07059837582943629,661.8841636180878,297.55382800102234,461.87902450561523,15106,4057,11049,11049,0,15,4518000.0
4518,4518999,21.255907761731116,38.9322192107687,0.07059753738787511,662.0817151069641,297.6213948726654,461.8913345336914,15116,4059,11057,11057,0,15,4519000.0
4519,4519999,21.256079958471,38.93138693068936,0.0705919416556553,662.2205672264099,297.6882390975952,462.0381660461426,15116,4059,11057,11057,0,15,4520000.0
4520,4520999,21.25629521241775,38.93043207672853,0.0705829227860939,662.3790867328644,297.7546682357788,462.08242416381836,15118,4060,11058,11058,0,15,4521000.0
4521,4521999,21.256225324824477,38.92885108808778,0.0705795223290634,662.547372341156,297.8218057155609,462.1382637023926,15120,4061,11059,11059,0,15,4522000.0
4522,4522999,21.256147574640156,38.927519738006175,0.07057705530179448,662.7121253013611,297.8884127140045,462.2301788330078,15122,4062,11060,11060,0,15,4523000.0
4523,4523999,21.255344175470746,38.925588239120344,0.07057352807806494,662.8786959648132,297.9549915790558,462.94869232177734,15152,4063,11089,11089,0,15,4524000.0
4524,4524999,21.253690806148335,38.923795049756514,0.0705768481555954,662.9926345348358,298.02092361450195,463.66210174560547,15167,4063,11104,11104,0,15,4525000.0
4525,4525999,21.252229151443313,38.92147236688607,0.07057437387232035,663.1045651435852,298.0863411426544,464.048583984375,15169,4063,11106,11106,0,15,4526000.0
4526,4526999,21.250519338510962,38.91884894449757,0.07057695632552108,663.2895865440369,298.15196895599365,464.21739196777344,15179,4065,11114,11114,0,15,4527000.0
4527,4527999,21.249280187347505,38.918037377751794,0.0705710064688263,663.5155711174011,298.21794605255127,464.3237533569336,15196,4068,11128,11128,0,15,4528000.0
4528,4528999,21.248020748153476,38.91572639643048,0.07057149376331262,663.7090878486633,298.2841410636902,464.50558853149414,15206,4070,11136,11136,0,15,4529000.0
4529,4529999,21.246480805071396,38.91277996406293,0.07057370797753526,663.9091510772705,298.35095143318176,464.6331901550293,15216,4072,11144,11144,0,15,4530000.0
4530,4530999,21.245037030628083,38.91004453571215,0.07057231165967348,664.1375529766083,298.417622089386,464.6665344238281,15222,4075,11147,11147,0,15,4531000.0
4531,4531999,21.243680715751008,38.907868118516745,0.07057084726204754,664.3637945652008,298.4842760562897,464.7991638183594,15228,4078,11150,11150,0,15,4532000.0
4532,4532999,21.242483658752118,38.905485799009604,0.07056637406194888,664.4904413223267,298.55127453804016,464.99009704589844,15228,4078,11150,11150,0,15,4533000.0
4533,4533999,21.241356021629684,38.90322794934094,0.07055962394686888,664.6437630653381,298.61737608909607,465.0863494873047,15230,4079,11151,11151,0,15,4534000.0
4534,4534999,21.240392069008248,38.90135924905403,0.07055167127645834,664.8402254581451,298.68441224098206,465.162654876709,15234,4081,11153,11153,0,15,4535000.0
4535,4535999,21.240069992156418,38.90126706098681,0.07053745395289046,665.0059921741486,298.75157284736633,465.22281646728516,15236,4082,11154,11154,0,15,4536000.0
4536,4536999,21.239303693238426,38.899806001532774,0.07052615089022951,665.137350320816,298.8178114891052,465.3703804016113,15236,4082,11154,11154,0,15,4537000.0
4537,4537999,21.23875979379491,38.898248227872905,0.07051122337477733,665.2652282714844,298.8856906890869,465.5332374572754,15236,4082,11154,11154,0,15,4538000.0
4538,4538999,21.238420398574526,38.89686171311785,0.07049665291091112,665.3828194141388,298.9517092704773,465.6211280822754,15236,4082,11154,11154,0,15,4539000.0
4539,4539999,21.23850872093239,38.89600965101792,0.07047696602099329,665.6583001613617,299.0185513496399,465.5503959655762,15244,4086,11158,11158,0,15,4540000.0
4540,4540999,21.23860977053467,38.8954966150445,0.07046122733397164,665.7924268245697,299.084885597229,465.7045211791992,15244,4086,11158,11158,0,15,4541000.0
4541,4541999,21.23903378535588,38.89520151508359,0.07045009470755781,665.9173626899719,299.1511652469635,465.80207443237305,15244,4086,11158,11158,0,15,4542000.0
4542,4542999,21.239609881729997,38.89530797745733,0.07043402328764814,666.0449724197388,299.2173202037811,465.8818893432617,15244,4086,11158,11158,0,15,4543000.0
4543,4543999,21.240336178608835,38.895209847551826,0.0704238734782896,666.1803977489471,299.2836310863495,465.9873275756836,15244,4086,11158,11158,0,15,4544000.0
4544,4544999,21.24006358805861,38.89356701378937,0.07041210578765167,666.3150069713593,299.3498091697693,466.0882873535156,15244,4086,11158,11158,0,15,4545000.0
4545,4545999,21.23812873315231,38.890430657299234,0.07041893532725207,666.4305675029755,299.416540145874,467.05753326416016,15273,4086,11187,11187,0,15,4546000.0
4546,4546999,21.236383077302456,38.88882197937088,0.0704167395247417,666.6065037250519,299.48160004615784,467.3094596862793,15277,4088,11189,11189,0,15,4547000.0
4547,4547999,21.234703398199628,38.88825143680778,0.07041066505866878,666.7161386013031,299.546635389328,467.5865287780762,15278,4088,11190,11190,0,15,4548000.0
4548,4548999,21.233531097897348,38.886617440475916,0.07040494915092121,666.908209323883,299.612491607666,467.73538970947266,15283,4090,11193,11193,0,15,4549000.0
4549,4549999,21.23280846605009,38.88635808553287,0.07039569039372418,667.1340973377228,299.67869091033936,467.85172271728516,15289,4093,11196,11196,0,15,4550000.0
4550,4550999,21.23216695229008,38.88536076557643,0.07038954986192802,667.2978529930115,299.745325088501,468.0219841003418,15291,4094,11197,11197,0,15,4551000.0
4551,4551999,21.231484045483924,38.884926755641835,0.0703840991224034,667.5639338493347,299.81213188171387,467.974063873291,15299,4098,11201,11201,0,15,4552000.0
4552,4552999,21.231320225501467,38.88533551297615,0.07038960107642311,667.7260410785675,299.8798520565033,468.1529541015625,15301,4099,11202,11202,0,15,4553000.0
4553,4553999,21.23146432586806,38.88582582009179,0.07040517558671,667.9231979846954,299.94668102264404,468.2763137817383,15305,4101,11204,11204,0,15,4554000.0
4554,4554999,21.231808885141433,38.886780659357925,0.07040951737700996,668.0894494056702,300.0136966705322,468.3508491516113,15307,4102,11205,11205,0,15,4555000.0
4555,4555999,21.232284735984596,38.888294700211084,0.07041317908056333,668.232827425003,300.08021545410156,468.5423049926758,15307,4102,11205,11205,0,15,4556000.0
4556,4556999,21.233013008983292,38.88928507061151,0.07042829482561008,668.3499608039856,300.1490845680237,468.65266036987305,15307,4102,11205,11205,0,15,4557000.0
4557,4557999,21.234200739218906,38.891561951973934,0.07042717385111319,668.4907751083374,300.22555708885193,468.7528266906738,15307,4102,11205,11205,0,15,4558000.0
4558,4558999,21.236291117767845,38.895482073370715,0.07042471252808724,668.6557989120483,300.29250931739807,468.8134536743164,15309,4103,11206,11206,0,15,4559000.0
4559,4559999,21.238322564886353,38.898468519339744,0.0704403129229445,668.8238661289215,300.3592462539673,468.8629035949707,15311,4104,11207,11207,0,15,4560000.0
4560,4560999,21.240391471489925,38.90121536698589,0.07045720223215113,668.9871685504913,300.42593216896057,468.90360260009766,15313,4105,11208,11208,0,15,4561000.0
4561,4561999,21.242924062934772,38.90455193521996,0.07048186069724838,669.1251032352448,300.49265718460083,469.04151916503906,15313,4105,11208,11208,0,15,4562000.0
4562,4562999,21.245534040804483,38.90860538178071,0.07050355534359565,669.2558059692383,300.55959010124207,469.1298141479492,15313,4105,11208,11208,0,15,4563000.0
4563,4563999,21.248555262477414,38.91303893819211,0.07053997482093122,669.448837518692,300.6265504360199,469.1453552246094,15323,4107,11216,11216,0,15,4564000.0
4564,4564999,21.251785333329796,38.917254314044,0.07056929123862332,669.580404996872,300.6934554576874,469.2586364746094,15323,4107,11216,11216,0,15,4565000.0
4565,4565999,21.254040484893142,38.919226204666565,0.07061391865642741,669.7571589946747,300.76009464263916,469.30151748657227,15325,4108,11217,11217,0,15,4566000.0
4566,4566999,21.252912271646974,38.91676408055271,0.07060709313719349,669.9097652435303,300.82694816589355,470.1721496582031,15352,4109,11243,11243,0,15,4567000.0
4567,4567999,21.25144414101989,38.915156916612794,0.0706033847697154,670.0981132984161,300.89516949653625,470.4208564758301,15358,4111,11247,11247,0,15,4568000.0
4568,4568999,21.25020714867813,38.9140170047503,0.07059472122340071,670.2143778800964,300.9601466655731,470.72589111328125,15359,4111,11248,11248,0,15,4569000.0
4569,4569999,21.248786251845225,38.9112990528843,0.0705920694474722,670.3949122428894,301.0349099636078,470.83800506591797,15362,4112,11250,11250,0,15,4570000.0
4570,4570999,21.24745537693017,38.90870061550407,0.07058431012329403,670.5822806358337,301.100426197052,470.89330673217773,15372,4114,11258,11258,0,15,4571000.0
4571,4571999,21.246372193308474,38.90665416564943,0.07057556062007264,670.7747950553894,301.16649413108826,471.00954818725586,15376,4116,11260,11260,0,15,4572000.0
4572,4572999,21.245282446580557,38.90517485238965,0.07055924287377391,671.1125376224518,301.2334005832672,470.9196891784668,15388,4122,11266,11266,0,15,4573000.0
4573,4573999,21.244145950628177,38.903583161623935,0.07055056456979447,671.38543009758,301.3005602359772,471.0217704772949,15396,4126,11270,11270,0,15,4574000.0
4574,4574999,21.24309937995329,38.90204315749571,0.07053948304030166,671.5106744766235,301.3664040565491,471.2572593688965,15396,4126,11270,11270,0,15,4575000.0
4575,4575999,21.24234476355867,38.90103457694144,0.07053124379330078,671.7844836711884,301.4339578151703,471.2516899108887,15415,4130,11285,11285,0,15,4576000.0
4576,4576999,21.242186643085876,38.90547022123302,0.07049770911802289,671.9415290355682,301.5011901855469,471.3999824523926,15417,4131,11286,11286,0,15,4577000.0
4577,4577999,21.243178225883955,38.90877727952368,0.07047019697550494,672.1039700508118,301.56759238243103,471.51104736328125,15419,4132,11287,11287,0,15,4578000.0
4578,4578999,21.245597448511354,38.91617805607986,0.0704466592590931,672.2335774898529,301.6338560581207,471.66210174560547,15419,4132,11287,11287,0,15,4579000.0
4579,4579999,21.248430331097783,38.923335222761345,0.07044420499086523,672.364164352417,301.70127415657043,471.7875671386719,15419,4132,11287,11287,0,15,4580000.0
4580,4580999,21.251582550195867,38.93243055371175,0.0704531702781056,672.5749838352203,301.7680399417877,471.8116149902344,15423,4134,11289,11289,0,15,4581000.0
4581,4581999,21.256337291650958,38.94500398865629,0.07048526996703841,672.7294912338257,301.83415603637695,471.9009017944336,15425,4135,11290,11290,0,15,4582000.0
4582,4582999,21.260957567180096,38.95575916876546,0.07054392214755101,672.9116215705872,301.9073803424835,472.0152053833008,15433,4136,11297,11297,0,15,4583000.0
4583,4583999,21.265958001599834,38.969040241607374,0.07061631363660892,673.0793466567993,301.97368931770325,472.0059509277344,15435,4137,11298,11298,0,15,4584000.0
4584,4584999,21.26978336983099,38.9766692880439,0.07067500842594288,673.2536909580231,302.04079842567444,472.03284072875977,15437,4138,11299,11299,0,15,4585000.0
4585,4585999,21.274570686539228,38.985121884073166,0.07076418849371002,673.4472091197968,302.107385635376,472.04358291625977,15447,4140,11307,11307,0,15,4586000.0
4586,4586999,21.276578901412826,38.987885855278016,0.07080037896279823,673.5693154335022,302.1737689971924,472.4613800048828,15460,4140,11320,11320,0,15,4587000.0
4587,4587999,21.27583799208733,38.987118172836226,0.07078960737661943,673.7313642501831,302.24079155921936,472.96371841430664,15475,4141,11334,11334,0,15,4588000.0
4588,4588999,21.275107830936648,38.98665221163481,0.07077848044845014,673.8481779098511,302.3057026863098,473.2568244934082,15478,4141,11337,11337,0,15,4589000.0
4589,4589999,21.274164182436333,38.984813425407886,0.07077813020155066,674.0322833061218,302.3718378543854,473.40521240234375,15483,4143,11340,11340,0,15,4590000.0
4590,4590999,21.273015582996955,38.98254669397272,0.07077840701886384,674.1839425563812,302.4376175403595,473.57703018188477,15486,4144,11342,11342,0,15,4591000.0
4591,4591999,21.27209154061975,38.9812530424178,0.07077446241710439,674.4062464237213,302.5033369064331,473.6407775878906,15497,4147,11350,11350,0,15,4592000.0
4592,4592999,21.271193771169074,38.98024242958618,0.07076036127216467,674.5716109275818,302.5695879459381,473.7676582336426,15499,4148,11351,11351,0,15,4593000.0
4593,4593999,21.270265273988525,38.9780785559322,0.07075006641628268,674.7719042301178,302.63758850097656,473.8412094116211,15509,4150,11359,11359,0,15,4594000.0
4594,4594999,21.26931492348187,38.9758804123589,0.070748730002262,674.9276413917542,302.70357155799866,473.9442481994629,15511,4151,11360,11360,0,15,4595000.0
4595,4595999,21.268772062608512,38.974197929620985,0.07074280484070261,675.1997427940369,302.7702693939209,473.9177589416504,15519,4155,11364,11364,0,15,4596000.0
4596,4596999,21.268680146909844,38.973270433058275,0.07072907643987902,675.3472409248352,302.8366074562073,474.11172103881836,15519,4155,11364,11364,0,15,4597000.0
4597,4597999,21.268608496686777,38.97312651979095,0.07071719555417255,675.5529110431671,302.9028539657593,474.1420593261719,15529,4157,11372,11372,0,15,4598000.0
4598,4598999,21.268472160268452,38.97205863752124,0.07070647981028777,675.6738414764404,302.96896624565125,474.2456932067871,15529,4157,11372,11372,0,15,4599000.0
4599,4599999,21.268661625153896,38.97158140075079,0.07069890131026835,675.842677116394,303.0370030403137,474.31725311279297,15534,4158,11376,11376,0,15,4600000.0
4600,4600999,21.26943025625447,38.97515834691489,0.07067392575189235,676.0137550830841,303.10652256011963,474.32934951782227,15536,4159,11377,11377,0,15,4601000.0
4601,4601999,21.26983666252589,38.976038510670776,0.07066274721756582,676.1824543476105,303.173504114151,474.40037536621094,15538,4160,11378,11378,0,15,4602000.0
4602,4602999,21.27063710163514,38.977312260832896,0.07065586269621194,676.3041687011719,303.2401330471039,474.5223503112793,15538,4160,11378,11378,0,15,4603000.0
4603,4603999,21.271203634529666,38.978494010919206,0.070648341047436,676.614010810852,303.30735301971436,474.3626518249512,15559,4165,11394,11394,0,15,4604000.0
4604,4604999,21.27158527389434,38.977713277273175,0.07064273741578797,676.7915143966675,303.38245725631714,474.4680862426758,15561,4166,11395,11395,0,15,4605000.0
4605,4605999,21.271438559790976,38.97699444874797,0.07061889064997928,677.0213294029236,303.449364900589,475.067928314209,15596,4169,11427,11427,0,15,4606000.0
4606,4606999,21.270893959809694,38.97694638521661,0.07061128889037915,677.1753554344177,303.515506029129,475.7688407897949,15621,4170,11451,11451,0,15,4607000.0
4607,4607999,21.269813636517675,38.97540166552333,0.07060761643427627,677.2927060127258,303.58163046836853,476.1014060974121,15622,4170,11452,11452,0,15,4608000.0
4608,4608999,21.268856039097027,38.973505402113446,0.07061069880108817,677.4548006057739,303.64740681648254,476.32022857666016,15624,4171,11453,11453,0,15,4609000.0
4609,4609999,21.26885775407127,38.97505577519605,0.0705924372133292,677.5721595287323,303.71312499046326,476.5718116760254,15624,4171,11453,11453,0,15,4610000.0
4610,4610999,21.269630469352386,38.97635271787885,0.07058361066701979,677.7988057136536,303.7792284488678,476.69366455078125,15630,4174,11456,11456,0,15,4611000.0
4611,4611999,21.27040977179857,38.976950006093084,0.07059653050738623,678.0703122615814,303.84650111198425,476.67524337768555,15643,4178,11465,11465,0,15,4612000.0
4612,4612999,21.271235254225196,38.979172918785,0.07061564422319122,678.2946653366089,303.9131963253021,476.8180732727051,15659,4181,11478,11478,0,15,4613000.0
4613,4613999,21.271664598973413,38.978921006522505,0.07063612801412145,678.4109025001526,303.98130226135254,477.025447845459,15660,4181,11479,11479,0,15,4614000.0
4614,4614999,21.272673516164772,38.98009101213943,0.07066664328044814,678.7044627666473,304.0491232872009,477.01868057250977,15684,4185,11499,11499,0,15,4615000.0
4615,4615999,21.27436932475828,38.98295714041608,0.07070507803471726,678.8702139854431,304.116886138916,477.1812171936035,15686,4186,11500,11500,0,15,4616000.0
4616,4616999,21.276144693005357,38.985462297210354,0.07074456950938302,679.1000802516937,304.18461084365845,477.21689224243164,15703,4189,11514,11514,0,15,4617000.0
4617,4617999,21.277204678988205,38.986448753848315,0.07078807463616932,679.2677805423737,304.25168228149414,477.31164932250977,15705,4190,11515,11515,0,15,4618000.0
4618,4618999,21.278801054237604,38.98863721922127,0.07083696357505787,679.5485918521881,304.3196885585785,477.2821159362793,15720,4194,11526,11526,0,15,4619000.0
4619,4619999,21.28075443752512,38.99233312478348,0.07091306760455385,679.7466523647308,304.38679695129395,477.3505172729492,15728,4196,11532,11532,0,15,4620000.0
4620,4620999,21.28243763239578,38.99424996071658,0.0710092819890612,679.9458663463593,304.45372462272644,477.4139404296875,15732,4198,11534,11534,0,15,4621000.0
4621,4621999,21.2845022246257,38.998148116992695,0.07109549464527909,680.1502270698547,304.521267414093,477.5216865539551,15736,4200,11536,11536,0,15,4622000.0
4622,4622999,21.286909297091217,39.001659346214225,0.07117019863671792,680.3546142578125,304.5884175300598,477.56908416748047,15745,4202,11543,11543,0,15,4623000.0
4623,4623999,21.28899686121237,39.00379309374819,0.07122066129394722,680.5233535766602,304.657377243042,477.6828193664551,15747,4203,11544,11544,0,15,4624000.0
4624,4624999,21.290806324607985,39.00637669541056,0.0712736788954913,680.6918153762817,304.72463512420654,477.81489181518555,15749,4204,11545,11545,0,15,4625000.0
4625,4625999,21.29174244437308,39.00654231600858,0.07126950546301214,680.8186423778534,304.7910387516022,478.5230941772461,15772,4204,11568,11568,0,15,4626000.0
4626,4626999,21.290624806059352,39.00538169977268,0.07126404956135024,680.9322061538696,304.85675263404846,478.9444465637207,15774,4204,11570,11570,0,15,4627000.0
4627,4627999,21.289779728246298,39.00371090351072,0.07126831040145765,681.1190340518951,304.9230875968933,479.1261177062988,15784,4206,11578,11578,0,15,4628000.0
4628,4628999,21.28900873774007,39.002010813002556,0.07127009335324808,681.3800892829895,304.989146232605,479.1396675109863,15801,4210,11591,11591,0,15,4629000.0
4629,4629999,21.2886568128209,39.00103034643633,0.07127099668995673,681.5332314968109,305.0547733306885,479.2942428588867,15804,4211,11593,11593,0,15,4630000.0
4630,4630999,21.288693011889166,39.001416246116065,0.07127328747524919,681.8093898296356,305.1210470199585,479.408016204834,15812,4215,11597,11597,0,15,4631000.0
4631,4631999,21.28881820357118,39.0013302027852,0.07126645909907159,682.0088198184967,305.1892943382263,479.5425910949707,15816,4217,11599,11599,0,15,4632000.0
4632,4632999,21.288714975467855,39.000133598403835,0.07127057456031805,682.2070579528809,305.25597381591797,479.63744354248047,15820,4219,11601,11601,0,15,4633000.0
4633,4633999,21.288603624062567,38.999227718690804,0.07128289332509541,682.3342897891998,305.3223235607147,479.83877182006836,15820,4219,11601,11601,0,15,4634000.0
4634,4634999,21.289215886374254,39.001907254127495,0.07129476114734457,682.5046937465668,305.38862133026123,479.94092178344727,15822,4220,11602,11602,0,15,4635000.0
4635,4635999,21.28956733826607,39.00208991790566,0.07130044626989385,682.6554203033447,305.4545066356659,480.01915740966797,15824,4221,11603,11603,0,15,4636000.0
4636,4636999,21.291005147488473,39.00520341973188,0.07132680249817192,682.7828216552734,305.5211045742035,480.1520118713379,15824,4221,11603,11603,0,15,4637000.0
4637,4637999,21.292899319338954,39.00884124768766,0.07136123392331006,682.9620943069458,305.58777499198914,480.2220687866211,15826,4222,11604,11604,0,15,4638000.0
4638,4638999,21.294258643062644,39.01055138397226,0.07139411071072377,683.1573679447174,305.6546115875244,480.2779541015625,15836,4224,11612,11612,0,15,4639000.0
4639,4639999,21.296161777741954,39.01376740856889,0.07142959094747592,683.326361656189,305.7211332321167,480.39489364624023,15838,4225,11613,11613,0,15,4640000.0
4640,4640999,21.298707795528646,39.017286418037564,0.07147341150957498,683.4871680736542,305.7871413230896,480.35095977783203,15840,4226,11614,11614,0,15,4641000.0
4641,4641999,21.301034282301586,39.02054141858604,0.07153992607432702,683.7003746032715,305.8555221557617,480.4169921875,15850,4228,11622,11622,0,15,4642000.0
4642,4642999,21.30382767994166,39.026775764370974,0.0715884335387098,683.8719682693481,305.92244482040405,480.52601623535156,15852,4229,11623,11623,0,15,4643000.0
4643,4643999,21.307175798812494,39.034877463666646,0.07163206572267189,683.9951183795929,305.9885997772217,480.6309814453125,15852,4229,11623,11623,0,15,4644000.0
4644,4644999,21.309777458262587,39.03903881198453,0.07165968718912663,684.130054473877,306.0549957752228,480.7188949584961,15852,4229,11623,11623,0,15,4645000.0
4645,4645999,21.312035439965676,39.04155428743273,0.0716730240393606,684.3001816272736,306.1220302581787,480.7047119140625,15854,4230,11624,11624,0,15,4646000.0
4646,4646999,21.312525110661518,39.042379591212246,0.07163795659739769,684.4707357883453,306.1897552013397,481.2544288635254,15874,4231,11643,11643,0,15,4647000.0
4647,4647999,21.311586642728965,39.041851417138396,0.07162814825226038,684.5850071907043,306.2552638053894,481.61901473999023,15877,4231,11646,11646,0,15,4648000.0
4648,4648999,21.31077960394971,39.04039845055421,0.07162543338789218,684.7060580253601,306.3212707042694,481.857177734375,15879,4231,11648,11648,0,15,4649000.0
4649,4649999,21.310184615841077,39.03905272626983,0.07162635884408586,684.8987908363342,306.39068365097046,481.95867919921875,15884,4233,11651,11651,0,15,4650000.0
4650,4650999,21.309770935880824,39.03866790807783,0.07161927743502094,685.1338846683502,306.45717692375183,481.98512268066406,15890,4236,11654,11654,0,15,4651000.0
4651,4651999,21.30953547942422,39.03751261105129,0.07162038633385714,685.3362925052643,306.5236032009125,482.22861099243164,15895,4238,11657,11657,0,15,4652000.0
4652,4652999,21.309117477504866,39.03655282345506,0.07161820858596923,685.5385150909424,306.59067010879517,482.3493194580078,15899,4240,11659,11659,0,15,4653000.0
4653,4653999,21.308556901555306,39.034851456961356,0.07162247631217189,685.6651182174683,306.65791034698486,482.5589065551758,15900,4240,11660,11660,0,15,4654000.0
4654,4654999,21.308752225586154,39.035112427227546,0.07162105645223549,685.9064202308655,306.7247815132141,482.5722770690918,15906,4243,11663,11663,0,15,4655000.0
4655,4655999,21.309193527512136,39.03593063852809,0.07162256663073796,686.1391839981079,306.7914879322052,482.61656188964844,15912,4246,11666,11666,0,15,4656000.0
4656,4656999,21.309807543861833,39.03665174152121,0.07162931858167954,686.3128335475922,306.8582057952881,482.7427978515625,15914,4247,11667,11667,0,15,4657000.0
4657,4657999,21.311053413840334,39.040350043774446,0.07166348975061065,686.479082107544,306.92494463920593,482.8428077697754,15916,4248,11668,11668,0,15,4658000.0
4658,4658999,21.311920842900967,39.041977815930984,0.07167240486396198,686.6112747192383,306.9914901256561,482.99592208862305,15916,4248,11668,11668,0,15,4659000.0
4659,4659999,21.31261794584281,39.04213754799291,0.07169238806110667,686.733793258667,307.05809211730957,483.11100006103516,15916,4248,11668,11668,0,15,4660000.0
4660,4660999,21.313607683085667,39.04317183939924,0.07168887601706408,686.8567337989807,307.12462186813354,483.22386932373047,15916,4248,11668,11668,0,15,4661000.0
4661,4661999,21.31563013851684,39.04598899899218,0.07170692253857125,687.0086333751678,307.19129610061646,483.28560638427734,15916,4248,11668,11668,0,15,4662000.0
4662,4662999,21.317563871054134,39.04952149067575,0.07172652400574853,687.2209849357605,307.25824880599976,483.30810546875,15920,4250,11670,11670,0,15,4663000.0
4663,4663999,21.319210838635293,39.0511076743119,0.07173887616931562,687.4229605197906,307.3248634338379,483.355712890625,15924,4252,11672,11672,0,15,4664000.0
4664,4664999,21.32067729471401,39.051803859632756,0.071745328469066,687.5890619754791,307.3918688297272,483.4016990661621,15926,4253,11673,11673,0,15,4665000.0
4665,4665999,21.322206061541447,39.05305878793164,0.0717549891738064,687.7242894172668,307.46838307380676,483.54706954956055,15926,4253,11673,11673,0,15,4666000.0
4666,4666999,21.322964819447595,39.0527276356222,0.07174506202435971,687.903440952301,307.5350613594055,483.93062591552734,15946,4254,11692,11692,0,15,4667000.0
4667,4667999,21.321976198817456,39.05107351555621,0.07173887778586086,688.0209405422211,307.60137724876404,484.45669174194336,15952,4254,11698,11698,0,15,4668000.0
4668,4668999,21.320726995716758,39.049015042186305,0.07173661606171167,688.134782075882,307.6667504310608,484.74291229248047,15953,4254,11699,11699,0,15,4669000.0
4669,4669999,21.319398025606084,39.046534172954,0.07174007743619293,688.361902475357,307.7332122325897,484.79154205322266,15966,4257,11709,11709,0,15,4670000.0
4670,4670999,21.3183693820004,39.04534968975392,0.07173783325984318,688.6243357658386,307.7997713088989,484.82873916625977,15981,4261,11720,11720,0,15,4671000.0
4671,4671999,21.317119473497947,39.04284384722168,0.07173749234537352,688.8556072711945,307.8669898509979,485.0633430480957,15988,4264,11724,11724,0,15,4672000.0
4672,4672999,21.31576655669155,39.040013366511005,0.07174075444615968,689.0520253181458,307.93345284461975,485.2019462585449,15992,4266,11726,11726,0,15,4673000.0
4673,4673999,21.315016136170495,39.039210386235375,0.0717374732110837,689.1884028911591,307.9998309612274,485.39281463623047,15992,4266,11726,11726,0,15,4674000.0
4674,4674999,21.31407506627598,39.03692422847375,0.07173972221821323,689.3485991954803,308.06651639938354,485.5895805358887,15994,4267,11727,11727,0,15,4675000.0
4675,4675999,21.31334281822951,39.035142208048015,0.07174057911218434,689.5032892227173,308.13284182548523,485.6797904968262,15996,4268,11728,11728,0,15,4676000.0
4676,4676999,21.312771531776207,39.03382613683126,0.07174011844062878,689.6309950351715,308.19901299476624,485.8040962219238,15996,4268,11728,11728,0,15,4677000.0
4677,4677999,21.312597008558182,39.03278360266875,0.07174132044305292,689.8024849891663,308.26634907722473,485.885009765625,15998,4269,11729,11729,0,15,4678000.0
4678,4678999,21.312866794933676,39.03511155039557,0.07173239270436838,689.914941072464,308.3319218158722,485.97473907470703,15998,4269,11729,11729,0,15,4679000.0
4679,4679999,21.312799637303325,39.03434790546652,0.07172340477257777,690.1288893222809,308.39870524406433,485.8900451660156,16002,4271,11731,11731,0,15,4680000.0
4680,4680999,21.31321314009943,39.03446514506271,0.07171653670065448,690.3366503715515,308.4658417701721,485.958683013916,16006,4273,11733,11733,0,15,4681000.0
4681,4681999,21.313993705046364,39.03533134203302,0.07170806080270387,690.4986453056335,308.53254294395447,486.0503807067871,16008,4274,11734,11734,0,15,4682000.0
4682,4682999,21.31497163697446,39.035822584532255,0.07170826517247397,690.6367678642273,308.59893798828125,486.14945220947266,16008,4274,11734,11734,0,15,4683000.0
4683,4683999,21.317324080245395,39.0480339836519,0.07168390404481906,690.8473098278046,308.66603803634644,486.2121887207031,16012,4276,11736,11736,0,15,4684000.0
4684,4684999,21.318551086062225,39.04935517163643,0.07168598981216046,691.0092952251434,308.73264026641846,486.25568771362305,16014,4277,11737,11737,0,15,4685000.0
4685,4685999,21.319925565626917,39.05259611045141,0.07168949312033024,691.1859810352325,308.80026483535767,486.266357421875,16016,4278,11738,11738,0,15,4686000.0
4686,4686999,21.321134538180686,39.053530509538646,0.07171253072107231,691.3281536102295,308.86699867248535,486.3759880065918,16016,4278,11738,11738,0,15,4687000.0
4687,4687999,21.320889413945913,39.052475092014454,0.0717143462915435,691.4854781627655,308.93456292152405,487.0941696166992,16047,4279,11768,11768,0,15,4688000.0
4688,4688999,21.319686426757343,39.051457152312615,0.07171449680262598,691.6016738414764,308.9998412132263,487.67269134521484,16053,4279,11774,11774,0,15,4689000.0
4689,4689999,21.318808868906224,39.05220636578995,0.07171288498010309,691.7124080657959,309.0644037723541,488.0005798339844,16054,4279,11775,11775,0,15,4690000.0
4690,4690999,21.317969316698143,39.051127630655934,0.07170961458474734,691.8317050933838,309.1291308403015,488.2034034729004,16055,4279,11776,11776,0,15,4691000.0
4691,4691999,21.31672959198179,39.04877756830669,0.0717125805196206,691.98686170578,309.19400429725647,488.3204002380371,16058,4280,11778,11778,0,15,4692000.0
4692,4692999,21.315879981918318,39.047155154282116,0.0717103053459408,692.1023015975952,309.25954723358154,488.5479736328125,16058,4280,11778,11778,0,15,4693000.0
4693,4693999,21.315383639925848,39.046687120527906,0.07170240964487495,692.3348789215088,309.32858180999756,488.5813674926758,16069,4283,11786,11786,0,15,4694000.0
4694,4694999,21.314606242929916,39.04464815530826,0.0717076325618915,692.6512098312378,309.39523816108704,488.46237564086914,16091,4288,11803,11803,0,15,4695000.0
4695,4695999,21.31426270205744,39.04436855878226,0.07169257902149584,692.9403483867645,309.4624583721161,488.4802474975586,16104,4292,11812,11812,0,15,4696000.0
4696,4696999,21.31453963764013,39.04516085324802,0.07168181041593491,693.1000669002533,309.5301113128662,488.6326484680176,16106,4293,11813,11813,0,15,4697000.0
4697,4697999,21.315018536945637,39.04724638398032,0.07167513794892921,693.3742146492004,309.59688425064087,488.60283279418945,16119,4297,11822,11822,0,15,4698000.0
4698,4698999,21.316018001895166,39.049505986111065,0.07166018494435189,693.5392646789551,309.6634769439697,488.80956268310547,16127,4298,11829,11829,0,15,4699000.0
4699,4699999,21.317705777978485,39.05532161000185,0.07164571098208017,693.6984717845917,309.72976064682007,488.9623489379883,16135,4299,11836,11836,0,15,4700000.0
4700,4700999,21.319652100914738,39.06033369116374,0.07162487586903377,693.8584411144257,309.79569840431213,489.0242576599121,16137,4300,11837,11837,0,15,4701000.0
4701,4701999,21.32214297366392,39.06793142012129,0.07160279344044473,694.1012523174286,309.8625268936157,489.0296173095703,16143,4303,11840,11840,0,15,4702000.0
4702,4702999,21.32533438741159,39.076516275153004,0.07160140390172565,694.2619400024414,309.9289758205414,489.16279220581055,16145,4304,11841,11841,0,15,4703000.0
4703,4703999,21.328994525260647,39.08782826561824,0.07158610244886221,694.430769443512,309.9951272010803,489.290283203125,16152,4305,11847,11847,0,15,4704000.0
4704,4704999,21.333140332423206,39.098698196311496,0.07158128822696885,694.6116645336151,310.0613934993744,489.3092956542969,16154,4306,11848,11848,0,15,4705000.0
4705,4705999,21.336741758546477,39.10911905299419,0.07157916360880034,694.7442953586578,310.12921714782715,489.4068717956543,16154,4306,11848,11848,0,15,4706000.0
4706,4706999,21.341071711816753,39.11974365851952,0.07160951402924143,694.9521420001984,310.19593930244446,489.48225021362305,16169,4308,11861,11861,0,15,4707000.0
4707,4707999,21.34379496585909,39.12472952086548,0.07161487895249441,695.1238677501678,310.26760745048523,490.10672760009766,16195,4309,11886,11886,0,15,4708000.0
4708,4708999,21.34208660356329,39.12188587283788,0.07161702292223449,695.293639421463,310.33321738243103,490.5572967529297,16214,4310,11904,11904,0,15,4709000.0
4709,4709999,21.34136572186261,39.12171484016095,0.07160414871284837,695.4120552539825,310.39819383621216,490.8699607849121,16214,4310,11904,11904,0,15,4710000.0
4710,4710999,21.340752848659303,39.12115897863692,0.07159159503884815,695.6797969341278,310.4647946357727,490.9400405883789,16237,4314,11923,11923,0,15,4711000.0
4711,4711999,21.339837326578845,39.11978099776447,0.07158203940960761,695.8379740715027,310.53019666671753,491.1431083679199,16240,4315,11925,11925,0,15,4712000.0
4712,4712999,21.339213930741188,39.11836629855105,0.071577239895395,696.0062124729156,310.600145816803,491.3731689453125,16242,4316,11926,11926,0,15,4713000.0
4713,4713999,21.338507049439063,39.11615768339784,0.0715725618706744,696.2453317642212,310.6665334701538,491.38140869140625,16248,4319,11929,11929,0,15,4714000.0
4714,4714999,21.337894038435188,39.114209575044235,0.07157054927580908,696.4524781703949,310.732558965683,491.4539222717285,16253,4321,11932,11932,0,15,4715000.0
4715,4715999,21.337392973443585,39.11273290946358,0.0715640689823781,696.6480627059937,310.7987983226776,491.58454513549805,16257,4323,11934,11934,0,15,4716000.0
4716,4716999,21.337017588332618,39.112922138887534,0.07155027984204543,696.8157639503479,310.8647930622101,491.6907539367676,16265,4324,11941,11941,0,15,4717000.0
4717,4717999,21.33715154671033,39.1125299875859,0.07153684491486556,696.9843430519104,310.9308662414551,491.7564239501953,16267,4325,11942,11942,0,15,4718000.0
4718,4718999,21.337416776223215,39.11273125129718,0.07152054203029945,697.1164681911469,310.9987874031067,491.9399604797363,16267,4325,11942,11942,0,15,4719000.0
4719,4719999,21.337865842673114,39.113465085031606,0.07151212069347201,697.2384233474731,311.0642628669739,492.0498809814453,16267,4325,11942,11942,0,15,4720000.0
4720,4720999,21.338884260743036,39.115215410859946,0.0714953141125727,697.401002407074,311.13118624687195,492.09642791748047,16269,4326,11943,11943,0,15,4721000.0
4721,4721999,21.3409244667529,39.11909115963096,0.07147303181509634,697.5655796527863,311.19766497612,492.1893844604492,16271,4327,11944,11944,0,15,4722000.0
4722,4722999,21.344012165014576,39.12567803411907,0.07145937262169388,697.7475926876068,311.26380467414856,492.2711067199707,16279,4328,11951,11951,0,15,4723000.0
4723,4723999,21.348263287188647,39.13379510846716,0.07147034331783597,697.9563601016998,311.3301959037781,492.3047180175781,16283,4330,11953,11953,0,15,4724000.0
4724,4724999,21.35197300078852,39.139226287875616,0.07149496238610287,698.1278803348541,311.39806604385376,492.384708404541,16285,4331,11954,11954,0,15,4725000.0
4725,4725999,21.35621140935714,39.146404752687644,0.07151915167772915,698.2462980747223,311.46383237838745,492.4733467102051,16285,4331,11954,11954,0,15,4726000.0
4726,4726999,21.361195088675455,39.15726526346661,0.07155549802876693,698.387980222702,311.5301938056946,492.58065032958984,16285,4331,11954,11954,0,15,4727000.0
4727,4727999,21.364979765765344,39.16452333139625,0.07159580909280727,698.5221302509308,311.59609627723694,492.67596435546875,16285,4331,11954,11954,0,15,4728000.0
4728,4728999,21.366009876801517,39.165199711666375,0.07160789765816,698.766411781311,311.6630003452301,493.2676773071289,16317,4334,11983,11983,0,15,4729000.0
4729,4729999,21.365647529567187,39.16575145060253,0.07160215733463526,698.924633026123,311.729465007782,493.8094596862793,16328,4335,11993,11993,0,15,4730000.0
4730,4730999,21.365374698847976,39.16575339778011,0.07159296029277307,699.109311580658,311.79558515548706,494.07086181640625,16335,4337,11998,11998,0,15,4731000.0
4731,4731999,21.365399884622885,39.16596968589464,0.07159665095488976,699.2995204925537,311.86183857917786,494.3040580749512,16339,4339,12000,12000,0,15,4732000.0
4732,4732999,21.36552028691882,39.166364861772784,0.07160369060077698,699.4921760559082,311.9289462566376,494.5258674621582,16344,4341,12003,12003,0,15,4733000.0
4733,4733999,21.365070075300185,39.16521161509263,0.07160703452861061,699.7322645187378,311.995685338974,494.70014572143555,16350,4344,12006,12006,0,15,4734000.0
4734,4734999,21.36459567275758,39.164352286336644,0.07162290082519751,699.8829400539398,312.06227374076843,494.87158203125,16352,4345,12007,12007,0,15,4735000.0
4735,4735999,21.363960598446827,39.163032394147685,0.07163986135170874,700.0744247436523,312.12911772727966,495.01634979248047,16356,4347,12009,12009,0,15,4736000.0
4736,4736999,21.363971909322984,39.16272474989565,0.07164103186816984,700.2502090930939,312.1955461502075,495.149658203125,16358,4348,12010,12010,0,15,4737000.0
4737,4737999,21.364153609284006,39.16252033042758,0.0716569563333368,700.4102692604065,312.26235699653625,495.2667770385742,16360,4349,12011,12011,0,15,4738000.0
4738,4738999,21.36416026423684,39.161576529688936,0.0716699746045859,700.5860681533813,312.3290739059448,495.40124130249023,16362,4350,12012,12012,0,15,4739000.0
4739,4739999,21.36431652840706,39.161133836970805,0.07168166042375301,700.747079372406,312.39541959762573,495.49584197998047,16364,4351,12013,12013,0,15,4740000.0
4740,4740999,21.36439975231521,39.16077700034544,0.07169239002684169,700.8658547401428,312.4617612361908,495.62519454956055,16364,4351,12013,12013,0,15,4741000.0
4741,4741999,21.365233869444825,39.16195066772813,0.07170921955177478,701.0309147834778,312.528089761734,495.6698799133301,16366,4352,12014,12014,0,15,4742000.0
4742,4742999,21.36665738114411,39.16480422380827,0.07172928207247475,701.1612374782562,312.59466648101807,495.77470779418945,16366,4352,12014,12014,0,15,4743000.0
4743,4743999,21.367740804412747,39.165590840261444,0.07176775934749202,701.3363556861877,312.66145873069763,495.8672981262207,16368,4353,12015,12015,0,15,4744000.0
4744,4744999,21.3686749990356,39.1667265867981,0.07179563714009018,701.5109202861786,312.72810101509094,495.92109298706055,16370,4354,12016,12016,0,15,4745000.0
4745,4745999,21.36994551311771,39.16927350174509,0.07180835400389307,701.6846108436584,312.7950201034546,496.0232734680176,16372,4355,12017,12017,0,15,4746000.0
4746,4746999,21.370300848231345,39.171674385329126,0.07179310000998884,703.6635460853577,312.86170196533203,496.8352355957031,16398,4355,12043,12043,0,15,4747000.0
4747,4747999,21.368802877890758,39.17042769502599,0.07179765836574803,703.7840406894684,312.9272348880768,497.3070602416992,16402,4355,12047,12047,0,15,4748000.0
4748,4748999,21.366994624174076,39.16757933652156,0.07181715139954403,703.8978760242462,312.9925196170807,497.55247497558594,16402,4355,12047,12047,0,15,4749000.0
4749,4749999,21.365463347836364,39.16593119349248,0.0718251021763252,704.1747660636902,313.0590829849243,497.59582901000977,16410,4359,12051,12051,0,15,4750000.0
4750,4750999,21.363890123403664,39.163538807704946,0.0718342169870152,704.3296165466309,313.12520456314087,497.84084701538086,16412,4360,12052,12052,0,15,4751000.0
4751,4751999,21.362604724685553,39.16168095363871,0.07183773355350387,704.5736830234528,313.19210147857666,497.9450340270996,16418,4363,12055,12055,0,15,4752000.0
4752,4752999,21.360998075238932,39.158861327684455,0.07184592534285905,704.8286080360413,313.2620952129364,497.98921966552734,16430,4366,12064,12064,0,15,4753000.0
4753,4753999,21.359532014021863,39.156456319860744,0.07185136326805541,705.0757892131805,313.3293135166168,498.0719223022461,16436,4369,12067,12067,0,15,4754000.0
4754,4754999,21.358305967670855,39.154148168197985,0.07185459867651256,705.2116768360138,313.3965091705322,498.2346382141113,16436,4369,12067,12067,0,15,4755000.0
4755,4755999,21.357022659556872,39.15167247303059,0.07185634297705046,705.372829914093,313.46322560310364,498.315673828125,16438,4370,12068,12068,0,15,4756000.0
4756,4756999,21.35631011220209,39.15025015666215,0.07185202354493514,705.5462007522583,313.5301158428192,498.4570617675781,16441,4371,12070,12070,0,15,4757000.0
4757,4757999,21.355685745590716,39.14894185530363,0.07184960457630085,705.7320327758789,313.5971405506134,498.554931640625,16443,4372,12071,12071,0,15,4758000.0
4758,4758999,21.354910634833377,39.14719102870826,0.07184938082793602,705.8595175743103,313.6640303134918,498.66089630126953,16443,4372,12071,12071,0,15,4759000.0
4759,4759999,21.355396545999383,39.14747706176659,0.07183819295434346,706.0292949676514,313.73103857040405,498.72671127319336,16445,4373,12072,12072,0,15,4760000.0
4760,4760999,21.356096133629833,39.14922607587566,0.07182831282923574,706.1498963832855,313.79734325408936,498.8468818664551,16445,4373,12072,12072,0,15,4761000.0
4761,4761999,21.356820941942907,39.14931927354497,0.0718299807096805,706.3428485393524,313.864205121994,498.8533706665039,16447,4374,12073,12073,0,15,4762000.0
4762,4762999,21.357867676619836,39.15185470602313,0.07183328989006454,706.5611054897308,313.9319441318512,498.8897018432617,16451,4376,12075,12075,0,15,4763000.0
4763,4763999,21.358451307155818,39.15192421579753,0.07185199402849363,706.72931432724,313.99918818473816,498.91784286499023,16453,4377,12076,12076,0,15,4764000.0
4764,4764999,21.358663021119675,39.150825019280994,0.07185970314725221,707.0152263641357,314.06697726249695,498.84886932373047,16461,4381,12080,12080,0,15,4765000.0
4765,4765999,21.358697351514447,39.149390907609344,0.07187356601611117,707.1719880104065,314.1345944404602,498.9863700866699,16461,4381,12080,12080,0,15,4766000.0
4766,4766999,21.358760424839847,39.152082173589335,0.07186225299008553,707.3492815494537,314.202064037323,499.55844497680664,16492,4382,12110,12110,0,15,4767000.0
4767,4767999,21.357038349569393,39.14996226805295,0.07184872570645606,707.4621224403381,314.2675402164459,500.0462989807129,16496,4382,12114,12114,0,15,4768000.0
4768,4768999,21.355196796107055,39.147229657193236,0.07186311822264635,707.5751316547394,314.3336887359619,500.3734245300293,16496,4382,12114,12114,0,15,4769000.0
4769,4769999,21.35357717106946,39.14468479581453,0.07187328916047298,707.7766010761261,314.39956164360046,500.4383316040039,16506,4384,12122,12122,0,15,4770000.0
4770,4770999,21.352027411590697,39.14240255374699,0.07188055276144512,708.102059841156,314.4662103652954,500.35095977783203,16535,4389,12146,12146,0,15,4771000.0
4771,4771999,21.35064669500842,39.13981278553062,0.07188716622292768,708.3862235546112,314.5332307815552,500.55678939819336,16543,4393,12150,12150,0,15,4772000.0
4772,4772999,21.349186814758667,39.1375591101998,0.07189383624198509,708.5895342826843,314.6015856266022,500.78551864624023,16547,4395,12152,12152,0,15,4773000.0
4773,4773999,21.347851717049554,39.135075209530335,0.07190160081865449,708.8006777763367,314.6679685115814,500.82454681396484,16551,4397,12154,12154,0,15,4774000.0
4774,4774999,21.346921938514985,39.13340953442123,0.07190417008250882,709.0487847328186,314.73528122901917,500.94178771972656,16557,4400,12157,12157,0,15,4775000.0
4775,4775999,21.34561786412669,39.13118290816817,0.07191056259293482,709.1785244941711,314.8037488460541,501.1145362854004,16557,4400,12157,12157,0,15,4776000.0
4776,4776999,21.34433606612532,39.12861609169104,0.0719132373788679,709.3051331043243,314.87076234817505,501.23654556274414,16557,4400,12157,12157,0,15,4777000.0
4777,4777999,21.343398957068217,39.126729161692,0.07191530524251499,709.4442241191864,314.9379503726959,501.3875846862793,16557,4400,12157,12157,0,15,4778000.0
4778,4778999,21.342201629891864,39.12416563520047,0.07192077200361247,709.6645998954773,315.00503182411194,501.3409004211426,16561,4402,12159,12159,0,15,4779000.0
4779,4779999,21.34146242673099,39.122719007950465,0.0719169854089664,709.8340108394623,315.07213497161865,501.42233657836914,16563,4403,12160,12160,0,15,4780000.0
4780,4780999,21.340893913121896,39.121145170725356,0.07191168622780275,709.959105014801,315.13887453079224,501.5547904968262,16563,4403,12160,12160,0,15,4781000.0
4781,4781999,21.340323801874696,39.11982611434428,0.07190531928263455,710.14417552948,315.20794343948364,501.6248588562012,16565,4404,12161,12161,0,15,4782000.0
4782,4782999,21.340079727993917,39.11866805174651,0.07190487638394494,710.3631858825684,315.2747938632965,501.6492805480957,16569,4406,12163,12163,0,15,4783000.0
4783,4783999,21.339854036659137,39.11788205336369,0.07189587143872589,710.544228553772,315.34164237976074,501.72353744506836,16571,4407,12164,12164,0,15,4784000.0
4784,4784999,21.34005631726645,39.1176291345831,0.07188399599612183,710.6862924098969,315.4121766090393,501.82518768310547,16571,4407,12164,12164,0,15,4785000.0
4785,4785999,21.33973260562216,39.116385695181606,0.07187861789097338,710.8551113605499,315.47933435440063,501.898494720459,16573,4408,12165,12165,0,15,4786000.0
4786,4786999,21.339337374958948,39.11471828107977,0.07187910161917477,711.032651424408,315.5462005138397,501.98173904418945,16575,4409,12166,12166,0,15,4787000.0
4787,4787999,21.33860148599025,39.11636303808576,0.0718605195659201,711.1641545295715,315.6121380329132,502.16120529174805,16577,4409,12168,12168,0,15,4788000.0
4788,4788999,21.33725384385905,39.11525459984397,0.071857543134635,711.2900085449219,315.67899107933044,502.96288299560547,16600,4409,12191,12191,0,15,4789000.0
4789,4789999,21.33552670936721,39.112122251156215,0.07187271876484358,711.4187052249908,315.74494433403015,503.2584915161133,16601,4409,12192,12192,0,15,4790000.0
4790,4790999,21.334102201400487,39.11033168240412,0.07187895526130561,711.582320690155,315.8109428882599,503.44078063964844,16610,4410,12200,12200,0,15,4791000.0
4791,4791999,21.332578476673312,39.10743060013237,0.07189773151399204,711.8616771697998,315.87758231163025,503.4239311218262,16625,4414,12211,12211,0,15,4792000.0
4792,4792999,21.331025212295206,39.104957951271395,0.07191035346755859,712.071973323822,315.9466350078583,503.5919876098633,16629,4416,12213,12213,0,15,4793000.0
4793,4793999,21.329578643866633,39.102599382430846,0.07192278296975918,712.2820944786072,316.01375913619995,503.7282524108887,16633,4418,12215,12215,0,15,4794000.0
4794,4794999,21.328022336269374,39.09983362186635,0.07193296084465461,712.5407259464264,316.0815358161926,503.7438735961914,16639,4421,12218,12218,0,15,4795000.0
4795,4795999,21.326295249611583,39.096861106718485,0.07194855924460364,712.6662726402283,316.1484842300415,503.9940719604492,16639,4421,12218,12218,0,15,4796000.0
4796,4796999,21.324809064718444,39.09415462098394,0.07195803396341638,712.8753402233124,316.2155964374542,504.05216217041016,16649,4423,12226,12226,0,15,4797000.0
4797,4797999,21.32337920562237,39.0917598280142,0.07196824068182117,713.0533945560455,316.2851769924164,504.1025505065918,16656,4424,12232,12232,0,15,4798000.0
4798,4798999,21.322194497594314,39.08925994176968,0.07197271240910863,713.1945073604584,316.35683250427246,504.2399101257324,16656,4424,12232,12232,0,15,4799000.0
4799,4799999,21.320784254986943,39.08665598698114,0.07198251656331256,713.3244080543518,316.42339849472046,504.34327697753906,16656,4424,12232,12232,0,15,4800000.0
4800,4800999,21.319596121936524,39.08453173789775,0.07198695984764747,713.5403249263763,316.4904901981354,504.2670440673828,16660,4426,12234,12234,0,15,4801000.0
4801,4801999,21.318449957893634,39.08262753512965,0.07199096130895999,713.6833763122559,316.557523727417,504.40270614624023,16660,4426,12234,12234,0,15,4802000.0
4802,4802999,21.317684742522864,39.08103108877918,0.07198973012484522,713.896066904068,316.6245210170746,504.33628845214844,16669,4428,12241,12241,0,15,4803000.0
4803,4803999,21.316991336236523,39.078982672216426,0.07199805423469108,714.0605108737946,316.6917896270752,504.4394340515137,16676,4429,12247,12247,0,15,4804000.0
4804,4804999,21.316177643664272,39.07691388997,0.07200325727918733,714.2323443889618,316.7591800689697,504.5223960876465,16678,4430,12248,12248,0,15,4805000.0
4805,4805999,21.31587678912758,39.0767675058927,0.07199930000951493,714.4562211036682,316.8264796733856,504.5251121520996,16693,4432,12261,12261,0,15,4806000.0
4806,4806999,21.315030699269663,39.074441713066605,0.07200403364541863,714.5877110958099,316.8933687210083,504.6014060974121,16693,4432,12261,12261,0,15,4807000.0
4807,4807999,21.31395251994288,39.07195586220234,0.07201066960309599,714.8178999423981,316.96107363700867,504.6529083251953,16703,4434,12269,12269,0,15,4808000.0
4808,4808999,21.312935474255855,39.071562220356,0.07201071857635433,715.0160603523254,317.0305006504059,505.2010917663574,16726,4435,12291,12291,0,15,4809000.0
4809,4809999,21.311265396076543,39.069397107255675,0.07201829451390418,715.217992067337,317.0972294807434,505.5518493652344,16744,4437,12307,12307,0,15,4810000.0
4810,4810999,21.30962904611944,39.06655647591946,0.07202947532460136,715.3769314289093,317.16316413879395,505.8071708679199,16750,4438,12312,12312,0,15,4811000.0
4811,4811999,21.308400757447902,39.06570322742043,0.07203288840137534,715.5029253959656,317.23163771629333,505.9913749694824,16751,4438,12313,12313,0,15,4812000.0
4812,4812999,21.30696326140274,39.06315164485314,0.07204182956603489,715.8231770992279,317.2984344959259,505.9186706542969,16772,4443,12329,12329,0,15,4813000.0
4813,4813999,21.30542622201087,39.06082749886,0.07204844269864863,716.0243983268738,317.36517429351807,506.10065841674805,16776,4445,12331,12331,0,15,4814000.0
4814,4814999,21.304024655770654,39.058822691719165,0.07205260680776993,716.267840385437,317.43166851997375,506.11395263671875,16782,4448,12334,12334,0,15,4815000.0
4815,4815999,21.302560461706133,39.0562167455734,0.07206253129632079,716.4715347290039,317.49895429611206,506.22685623168945,16791,4450,12341,12341,0,15,4816000.0
4816,4816999,21.301084166953327,39.053677490280585,0.07206718238707632,716.7577633857727,317.5664782524109,506.24856185913086,16813,4454,12359,12359,0,15,4817000.0
4817,4817999,21.299756826351167,39.051439040499105,0.07206998916068097,716.919636964798,317.63293743133545,506.3987922668457,16819,4455,12364,12364,0,15,4818000.0
4818,4818999,21.298734735267356,39.049614978788306,0.07206576852927671,717.054799079895,317.7021007537842,506.55191802978516,16819,4455,12364,12364,0,15,4819000.0
4819,4819999,21.2979688336718,39.04829193480277,0.07205822348689361,717.2324371337891,317.7686710357666,506.67405700683594,16821,4456,12365,12365,0,15,4820000.0
4820,4820999,21.29902023729432,39.05049839311797,0.07202572678917529,717.5227694511414,317.83651518821716,506.66466522216797,16833,4460,12373,12373,0,15,4821000.0
4821,4821999,21.300711544600613,39.05307476914676,0.07199563456602054,717.8112328052521,317.90413761138916,506.66687393188477,16874,4464,12410,12410,0,15,4822000.0
4822,4822999,21.303003167404384,39.05693530647491,0.07196954287927648,717.9849112033844,317.9713273048401,506.80141830444336,16880,4465,12415,12415,0,15,4823000.0
4823,4823999,21.304961609068123,39.05966086119892,0.07196428350096162,718.1921186447144,318.0389015674591,506.78913497924805,16884,4467,12417,12417,0,15,4824000.0
4824,4824999,21.307166917838128,39.06240965799625,0.07197777445793985,718.4444391727448,318.1064193248749,506.82863998413086,16894,4470,12424,12424,0,15,4825000.0
4825,4825999,21.308912897800944,39.06395016206804,0.07199723358956056,718.6227843761444,318.1737823486328,506.9605255126953,16896,4471,12425,12425,0,15,4826000.0
4826,4826999,21.310841846231657,39.06578327664458,0.07202732124167888,718.7453880310059,318.24047923088074,507.0635795593262,16896,4471,12425,12425,0,15,4827000.0
4827,4827999,21.312206132816872,39.06796417656949,0.07204367315623272,719.0101342201233,318.30778074264526,506.9953842163086,16906,4474,12432,12432,0,15,4828000.0
4828,4828999,21.313089656091663,39.067876606369396,0.07206971735050549,719.2659406661987,318.3756217956543,507.0802917480469,16920,4477,12443,12443,0,15,4829000.0
4829,4829999,21.312363437195227,39.06638786168306,0.07207512663910776,719.3869099617004,318.4421844482422,507.803897857666,16941,4477,12464,12464,0,15,4830000.0
4830,4830999,21.31065361447438,39.06355728397324,0.07208542684603902,719.499095916748,318.50746631622314,508.1722297668457,16943,4477,12466,12466,0,15,4831000.0
4831,4831999,21.30902030700786,39.06092258884306,0.07209339719698349,719.6608519554138,318.5731029510498,508.33522033691406,16947,4478,12469,12469,0,15,4832000.0
4832,4832999,21.307626317691646,39.05853411792869,0.07210038941878727,719.8610084056854,318.6386184692383,508.5125961303711,16951,4480,12471,12471,0,15,4833000.0
4833,4833999,21.30649272727187,39.057137312098554,0.07209778665262434,720.0312302112579,318.7046539783478,508.65724182128906,16954,4481,12473,12473,0,15,4834000.0
4834,4834999,21.305046915259894,39.054746432508004,0.07210355441794858,720.229649066925,318.7712905406952,508.78873443603516,16958,4483,12475,12475,0,15,4835000.0
4835,4835999,21.30370033135015,39.052279455013135,0.07210847649303542,720.3698070049286,318.83678817749023,508.9350929260254,16958,4483,12475,12475,0,15,4836000.0
4836,4836999,21.302429633634045,39.050094038893064,0.07210846226390866,720.5657937526703,318.9028000831604,509.00058364868164,16962,4485,12477,12477,0,15,4837000.0
4837,4837999,21.301340595549224,39.047974720506936,0.07210999306891086,720.8896782398224,318.97037529945374,508.86296463012695,16977,4490,12487,12487,0,15,4838000.0
4838,4838999,21.300142026523787,39.04531128721226,0.07211185592958147,721.0267088413239,319.0369815826416,509.08031845092773,16977,4490,12487,12487,0,15,4839000.0
4839,4839999,21.29927245109511,39.043896415107014,0.07210931672790255,721.2256031036377,319.1034104824066,509.0937805175781,16986,4492,12494,12494,0,15,4840000.0
4840,4840999,21.298487580859767,39.04200576452185,0.07210299738199433,721.473979473114,319.17003893852234,509.1037712097168,16997,4495,12502,12502,0,15,4841000.0
4841,4841999,21.29882758445998,39.043794595499556,0.0720777144239011,721.6441338062286,319.23696422576904,509.1668586730957,16999,4496,12503,12503,0,15,4842000.0
4842,4842999,21.300015809614425,39.04635383728273,0.07205774145192845,721.814026594162,319.3036139011383,509.29144287109375,17001,4497,12504,12504,0,15,4843000.0
4843,4843999,21.301740538772584,39.0488083622896,0.07204983356841632,722.0264167785645,319.3717498779297,509.38254165649414,17010,4499,12511,12511,0,15,4844000.0
4844,4844999,21.303804361940177,39.05186459266614,0.07205367381275773,722.198561668396,319.4386353492737,509.46057510375977,17012,4500,12512,12512,0,15,4845000.0
4845,4845999,21.30699979501124,39.06150333085202,0.07205250617223813,722.4037504196167,319.5060019493103,509.51749420166016,17016,4502,12514,12514,0,15,4846000.0
4846,4846999,21.3094196984387,39.064696667535685,0.0720734825566377,722.5641539096832,319.57264518737793,509.6472816467285,17018,4503,12515,12515,0,15,4847000.0
4847,4847999,21.311339186212983,39.067202583244686,0.07208328703349032,722.7118124961853,319.63938641548157,509.74975204467773,17018,4503,12515,12515,0,15,4848000.0
4848,4848999,21.313826915962654,39.06977435135166,0.07211246982170239,722.8852207660675,319.70615005493164,509.8271255493164,17020,4504,12516,12516,0,15,4849000.0
4849,4849999,21.315036369952637,39.07145673593253,0.07215004834242933,723.0940058231354,319.77461647987366,509.90052795410156,17024,4506,12518,12518,0,15,4850000.0
4850,4850999,21.315362532258014,39.071444167982875,0.0721459526630065,723.2377209663391,319.839786529541,510.19775772094727,17029,4506,12523,12523,0,15,4851000.0
4851,4851999,21.314454124988735,39.069355454493014,0.07214369102848184,723.3538780212402,319.9040412902832,510.34517669677734,17030,4506,12524,12524,0,15,4852000.0
4852,4852999,21.31344653071644,39.06739961924099,0.07214339472773068,723.605991601944,319.9728820323944,510.2940902709961,17039,4509,12530,12530,0,15,4853000.0
4853,4853999,21.312662861942663,39.066402777047635,0.07213557659079883,723.7728192806244,320.0384497642517,510.3712158203125,17041,4510,12531,12531,0,15,4854000.0
4854,4854999,21.311569586529675,39.064427738301276,0.07213807966706398,723.8907585144043,320.1034667491913,510.4632148742676,17042,4510,12532,12532,0,15,4855000.0
4855,4855999,21.31064738232519,39.06253853646442,0.07213291356980323,724.0139327049255,320.1676859855652,510.54576110839844,17042,4510,12532,12532,0,15,4856000.0
4856,4856999,21.309680843359523,39.06035852474206,0.07212595289479617,724.2481558322906,320.23321747779846,510.4925346374512,17049,4512,12537,12537,0,15,4857000.0
4857,4857999,21.308910708239637,39.0591269807229,0.07211555258464386,724.3713600635529,320.2981402873993,510.56313705444336,17049,4512,12537,12537,0,15,4858000.0
4858,4858999,21.308078338600122,39.057458898043436,0.07210954527231161,724.5834529399872,320.3638792037964,510.5452995300293,17053,4514,12539,12539,0,15,4859000.0
4859,4859999,21.307136644182787,39.05506559003173,0.07210631314693994,724.7582142353058,320.42913722991943,510.55623626708984,17055,4515,12540,12540,0,15,4860000.0
4860,4860999,21.306830074984784,39.054126128832415,0.0720949130323073,724.8912959098816,320.49476766586304,510.6144599914551,17055,4515,12540,12540,0,15,4861000.0
4861,4861999,21.3063267300924,39.052902363178696,0.0720831646796839,725.0223119258881,320.55988097190857,510.66980743408203,17055,4515,12540,12540,0,15,4862000.0
4862,4862999,21.306395699132654,39.05275128645387,0.07207362544516693,725.2089741230011,320.625652551651,510.59760665893555,17060,4516,12544,12544,0,15,4863000.0
4863,4863999,21.30641656830649,39.05236141335059,0.07205898799085375,725.3521466255188,320.6915194988251,510.6436576843262,17060,4516,12544,12544,0,15,4864000.0
4864,4864999,21.306833383407795,39.05222733461627,0.07204684229678981,725.4653751850128,320.75665616989136,510.69805908203125,17060,4516,12544,12544,0,15,4865000.0
4865,4865999,21.308029359490014,39.05377041541516,0.07203110573315619,725.6366016864777,320.8228487968445,510.72058486938477,17062,4517,12545,12545,0,15,4866000.0
4866,4866999,21.309432745721338,39.055165732147344,0.07200964337965299,725.7846562862396,320.88864850997925,510.77313232421875,17062,4517,12545,12545,0,15,4867000.0
4867,4867999,21.31112560413662,39.057036120645975,0.07198920107745355,725.9647402763367,320.9554262161255,510.73814392089844,17064,4518,12546,12546,0,15,4868000.0
4868,4868999,21.31272275786069,39.05856350249363,0.07197618334206879,726.1920304298401,321.021516084671,510.6280517578125,17071,4520,12551,12551,0,15,4869000.0
4869,4869999,21.31416770184472,39.05978780737931,0.07195899332474998,726.3207669258118,321.08733916282654,510.7064666748047,17071,4520,12551,12551,0,15,4870000.0
4870,4870999,21.31541900872359,39.06036256863673,0.07194653046042077,726.4674654006958,321.1533145904541,510.7865905761719,17071,4520,12551,12551,0,15,4871000.0
4871,4871999,21.31556360992137,39.059628061051306,0.07194219793008527,726.6180183887482,321.22048592567444,511.3623237609863,17093,4520,12573,12573,0,15,4872000.0
4872,4872999,21.31419759065528,39.05766538804067,0.07195059409026527,726.7233967781067,321.28412556648254,511.8585014343262,17096,4520,12576,12576,0,15,4873000.0
4873,4873999,21.31286236652712,39.0583948664199,0.07195530992269805,726.837390422821,321.34799790382385,512.1443786621094,17099,4520,12579,12579,0,15,4874000.0
4874,4874999,21.311894543964097,39.05898218083786,0.07195336259398544,727.0681507587433,321.41241121292114,512.289737701416,17107,4523,12584,12584,0,15,4875000.0
4875,4875999,21.310708201871908,39.06387758227808,0.0719361585834345,727.300883769989,321.4771206378937,512.4596939086914,17116,4526,12590,12590,0,15,4876000.0
4876,4876999,21.309748171377358,39.06368146232421,0.0719358717866001,727.4639160633087,321.5416121482849,512.6119651794434,17119,4527,12592,12592,0,15,4877000.0
4877,4877999,21.308083930026026,39.06059606724126,0.07194638864543923,727.6232717037201,321.6063973903656,512.7537651062012,17122,4528,12594,12594,0,15,4878000.0
4878,4878999,21.306506784408622,39.05783134059092,0.07195964106851183,727.8068771362305,321.6715784072876,512.8817977905273,17125,4529,12596,12596,0,15,4879000.0
4879,4879999,21.30498327147832,39.05503211125623,0.07196886095858934,727.9685199260712,321.73686695098877,513.0047912597656,17129,4530,12599,12599,0,15,4880000.0
4880,4880999,21.303556423728704,39.0524298783044,0.07197762647224126,728.125714302063,321.801575422287,513.0783157348633,17131,4531,12600,12600,0,15,4881000.0
4881,4881999,21.3024589021091,39.05249553944152,0.07197241799176302,728.2642974853516,321.8675043582916,513.2831611633301,17133,4531,12602,12602,0,15,4882000.0
4882,4882999,21.30129170975703,39.050000889828,0.07198569681951206,728.4257681369781,321.9324162006378,513.3585357666016,17135,4532,12603,12603,0,15,4883000.0
4883,4883999,21.30027348929263,39.04839929752434,0.07199061270794904,728.5972661972046,321.9972574710846,513.377326965332,17137,4533,12604,12604,0,15,4884000.0
4884,4884999,21.29931177929724,39.04652761932285,0.07199909151424466,728.7699077129364,322.0623080730438,513.4963035583496,17145,4534,12611,12611,0,15,4885000.0
4885,4885999,21.298367736766195,39.044269081185504,0.07201463321200718,728.9244346618652,322.1268174648285,513.5273780822754,17147,4535,12612,12612,0,15,4886000.0
4886,4886999,21.297517371513965,39.042152013913395,0.07202556505545932,729.1092376708984,322.19190311431885,513.5786743164062,17149,4536,12613,12613,0,15,4887000.0
4887,4887999,21.296470609995733,39.039601066865295,0.07204451696161895,729.2467019557953,322.2573883533478,513.6904449462891,17149,4536,12613,12613,0,15,4888000.0
4888,4888999,21.29573364101096,39.03840170421084,0.07204485011580564,729.3792595863342,322.32257771492004,514.2673950195312,17168,4536,12632,12632,0,15,4889000.0
4889,4889999,21.294527134677402,39.03896982677301,0.07204876054556597,729.4878153800964,322.386864900589,514.821891784668,17172,4536,12636,12636,0,15,4890000.0
4890,4890999,21.292892162502987,39.037124177734334,0.0720807498903645,729.677491903305,322.45093154907227,515.0044021606445,17176,4538,12638,12638,0,15,4891000.0
4891,4891999,21.2911234788469,39.03531307283543,0.07211323174193163,729.8748369216919,322.5154163837433,515.1904907226562,17180,4540,12640,12640,0,15,4892000.0
4892,4892999,21.289156040129882,39.032252301230066,0.07214918577668639,730.0723252296448,322.581013917923,515.3571548461914,17185,4542,12643,12643,0,15,4893000.0
4893,4893999,21.286974899896734,39.0289013303191,0.0721854366728808,730.3087184429169,322.64594984054565,515.474235534668,17197,4545,12652,12652,0,15,4894000.0
4894,4894999,21.28508742687689,39.026236028526775,0.07221231247802629,730.5483980178833,322.7111265659332,515.5602378845215,17203,4548,12655,12655,0,15,4895000.0
4895,4895999,21.283172544633768,39.023721667702596,0.07223782736722384,730.7189512252808,322.7762417793274,515.7058181762695,17205,4549,12656,12656,0,15,4896000.0
4896,4896999,21.281274233517713,39.021125600026444,0.07226508778105734,730.8285510540009,322.8406808376312,515.8660774230957,17205,4549,12656,12656,0,15,4897000.0
4897,4897999,21.27950915781845,39.018810100194194,0.07229158955669224,731.0443024635315,322.90603590011597,515.9363975524902,17209,4551,12658,12658,0,15,4898000.0
4898,4898999,21.27785383490954,39.01626282888385,0.07231298036964928,731.2097015380859,322.9711389541626,516.021427154541,17211,4552,12659,12659,0,15,4899000.0
4899,4899999,21.27622751799428,39.01351537629998,0.07233818875149833,731.3198516368866,323.0363259315491,516.2216033935547,17211,4552,12659,12659,0,15,4900000.0
4900,4900999,21.2747033211564,39.01097016664175,0.07236367483054851,731.4968447685242,323.1027274131775,516.2513122558594,17213,4553,12660,12660,0,15,4901000.0
4901,4901999,21.273372643723864,39.0086321268457,0.07239844607553436,731.6541419029236,323.1677942276001,516.3384704589844,17215,4554,12661,12661,0,15,4902000.0
4902,4902999,21.27189949822984,39.0059498173866,0.07242953996249601,731.8268659114838,323.233341217041,516.4418487548828,17217,4555,12662,12662,0,15,4903000.0
4903,4903999,21.270181178780277,39.00295965134794,0.07246459164568653,731.970460653305,323.2984576225281,516.5343475341797,17217,4555,12662,12662,0,15,4904000.0
4904,4904999,21.268829411910023,39.00077387299152,0.07249513422990739,732.0926342010498,323.3632161617279,516.6604080200195,17217,4555,12662,12662,0,15,4905000.0
4905,4905999,21.26714440790541,38.998712205544514,0.07251654297949195,732.3375959396362,323.42876172065735,517.2917022705078,17251,4558,12693,12693,0,15,4906000.0
4906,4906999,21.265040656600377,38.99602913981712,0.07254425266895004,732.4499323368073,323.4934084415436,517.7014427185059,17252,4558,12694,12694,0,15,4907000.0
4907,4907999,21.263594698276215,38.996471496359945,0.07255487603763255,732.6849436759949,323.55825686454773,517.7952041625977,17258,4561,12697,12697,0,15,4908000.0
4908,4908999,21.26201916525368,38.99446311052043,0.07258147004662996,732.8404154777527,323.6226325035095,518.0258483886719,17261,4562,12699,12699,0,15,4909000.0
4909,4909999,21.260165200696772,38.991527428474654,0.07261266994617621,733.1138668060303,323.6880872249603,518.1917190551758,17269,4566,12703,12703,0,15,4910000.0
4910,4910999,21.258257686789943,38.98883470192896,0.0726397217356698,733.2271933555603,323.75255727767944,518.4261703491211,17269,4566,12703,12703,0,15,4911000.0
4911,4911999,21.256532935253833,38.986505068363165,0.07265735361569059,733.4875586032867,323.8181252479553,518.5043716430664,17276,4569,12707,12707,0,15,4912000.0
4912,4912999,21.25494751353553,38.984736470601035,0.07266462146473285,733.6084771156311,323.8831503391266,518.7058639526367,17276,4569,12707,12707,0,15,4913000.0
4913,4913999,21.253478524666882,38.98338929594776,0.07267187371345007,733.7847924232483,323.94937658309937,518.8105773925781,17278,4570,12708,12708,0,15,4914000.0
4914,4914999,21.25254111498068,38.98250282036135,0.07266790162638403,733.9462568759918,324.0145778656006,518.8908386230469,17280,4571,12709,12709,0,15,4915000.0
4915,4915999,21.251599236417313,38.98106632974219,0.0726685153256117,734.1142926216125,324.0798919200897,518.9586067199707,17282,4572,12710,12710,0,15,4916000.0
4916,4916999,21.25107496492936,38.98028824484164,0.07266057592427178,734.2859802246094,324.1456117630005,519.0429420471191,17284,4573,12711,12711,0,15,4917000.0
4917,4917999,21.250457696904487,38.97933491626586,0.07265223837403623,734.4104042053223,324.21074891090393,519.1581954956055,17284,4573,12711,12711,0,15,4918000.0
4918,4918999,21.25028685828231,38.97913742212169,0.07264562483124548,734.5599036216736,324.2764208316803,519.274730682373,17285,4573,12712,12712,0,15,4919000.0
4919,4919999,21.2498579247392,38.97779894131676,0.07263970245903262,734.7261946201324,324.3414604663849,519.2635688781738,17287,4574,12713,12713,0,15,4920000.0
4920,4920999,21.249861439746503,38.97874234014661,0.07263341713469429,734.9356501102448,324.40684247016907,519.2104682922363,17291,4576,12715,12715,0,15,4921000.0
4921,4921999,21.24961884858444,38.9779447328712,0.07262766639131302,735.0572535991669,324.4724986553192,519.3099060058594,17291,4576,12715,12715,0,15,4922000.0
4922,4922999,21.249245300427024,38.976769577139216,0.0726275375687534,735.2013123035431,324.53769874572754,519.3869743347168,17291,4576,12715,12715,0,15,4923000.0
4923,4923999,21.248488153168164,38.97493606483984,0.0726342348459117,735.3813269138336,324.603976726532,519.4172096252441,17293,4577,12716,12716,0,15,4924000.0
4924,4924999,21.248134149739613,38.97381701272256,0.0726356311091454,735.5067007541656,324.6694746017456,519.5440788269043,17293,4577,12716,12716,0,15,4925000.0
4925,4925999,21.24674502270833,38.97119803089987,0.07264630520255788,735.647518157959,324.73520374298096,520.1619110107422,17314,4577,12737,12737,0,15,4926000.0
4926,4926999,21.24523158105539,38.96951384287126,0.07264746943754652,735.7633907794952,324.799791097641,520.6465911865234,17318,4577,12741,12741,0,15,4927000.0
4927,4927999,21.243043466694008,38.96631280730568,0.07266635470734306,735.8727760314941,324.8640854358673,520.954402923584,17318,4577,12741,12741,0,15,4928000.0
4928,4928999,21.241149905453764,38.9638357110627,0.0726785394955557,736.0721833705902,324.9294822216034,521.0640258789062,17323,4579,12744,12744,0,15,4929000.0
4929,4929999,21.239419291043173,38.96101035155275,0.07269430084357364,736.3569982051849,324.9955475330353,521.170482635498,17332,4583,12749,12749,0,15,4930000.0
4930,4930999,21.237561303804362,38.957989642810205,0.07270898788331803,736.5905981063843,325.06144666671753,521.3293533325195,17338,4586,12752,12752,0,15,4931000.0
4931,4931999,21.236182146154004,38.955737025982835,0.07271686741094308,736.7881166934967,325.1270558834076,521.4330863952637,17342,4588,12754,12754,0,15,4932000.0
4932,4932999,21.234690063779173,38.95315396919244,0.07272596206106019,737.0349540710449,325.1934344768524,521.4348640441895,17348,4591,12757,12757,0,15,4933000.0
4933,4933999,21.233059342184667,38.950755555612844,0.07273585211150835,737.2021265029907,325.26124835014343,521.6186599731445,17350,4592,12758,12758,0,15,4934000.0
4934,4934999,21.231663881261397,38.94854742076139,0.07274301582208909,737.3711111545563,325.32763409614563,521.7661933898926,17358,4593,12765,12765,0,15,4935000.0
4935,4935999,21.230365742338257,38.946294979862415,0.0727496127225532,737.4917809963226,325.39314460754395,521.8951950073242,17358,4593,12765,12765,0,15,4936000.0
4936,4936999,21.229087115741507,38.94404898417663,0.07275643313168423,737.6287314891815,325.45894980430603,522.0368537902832,17358,4593,12765,12765,0,15,4937000.0
4937,4937999,21.228034798246338,38.94183279404618,0.07276114318074922,737.747882604599,325.5243215560913,522.136360168457,17358,4593,12765,12765,0,15,4938000.0
4938,4938999,21.226987870844383,38.940123945643094,0.07275945565780162,737.9272031784058,325.5905327796936,522.1823539733887,17360,4594,12766,12766,0,15,4939000.0
4939,4939999,21.226288128956092,38.938318958501746,0.07275970975256663,738.0993053913116,325.65738320350647,522.2469177246094,17362,4595,12767,12767,0,15,4940000.0
4940,4940999,21.22541568536094,38.936520292798576,0.07275820869907923,738.2458910942078,325.7351062297821,522.3562698364258,17362,4595,12767,12767,0,15,4941000.0
4941,4941999,21.224635208547575,38.93468212624034,0.0727615036231607,738.4231815338135,325.80135440826416,522.3998832702637,17364,4596,12768,12768,0,15,4942000.0
4942,4942999,21.22386106066382,38.93258391292258,0.07276607252457323,738.595691204071,325.86782598495483,522.4480667114258,17366,4597,12769,12769,0,15,4943000.0
4943,4943999,21.22352572985908,38.93127755556662,0.07276623979376273,738.7633736133575,325.9344961643219,522.478889465332,17368,4598,12770,12770,0,15,4944000.0
4944,4944999,21.222915763264034,38.929998461110344,0.07276729551925099,739.0325484275818,326.00167059898376,522.428955078125,17374,4601,12773,12773,0,15,4945000.0
4945,4945999,21.222241986967383,38.92808886299423,0.07276580618041717,739.1641798019409,326.0678360462189,522.6067504882812,17374,4601,12773,12773,0,15,4946000.0
4946,4946999,21.22110278228225,38.92666462393344,0.07276346765678054,739.2814838886261,326.13451862335205,523.1381187438965,17390,4601,12789,12789,0,15,4947000.0
4947,4947999,21.22022757007144,38.92511641028486,0.0727682297016976,739.3934621810913,326.19980788230896,523.5158538818359,17392,4601,12791,12791,0,15,4948000.0
4948,4948999,21.219155890921595,38.92298019988977,0.07276147025760604,739.5062272548676,326.2648160457611,523.7896995544434,17393,4601,12792,12792,0,15,4949000.0
4949,4949999,21.218103853739095,38.920721077414065,0.07276621049692245,739.7440187931061,326.3304281234741,523.9220008850098,17400,4604,12796,12796,0,15,4950000.0
4950,4950999,21.217098771660805,38.91867102094068,0.0727723559394643,739.9469408988953,326.3964743614197,524.0088691711426,17405,4606,12799,12799,0,15,4951000.0
4951,4951999,21.21583499305992,38.9159950816855,0.07278040108745132,740.1503674983978,326.46323466300964,524.1564674377441,17415,4608,12807,12807,0,15,4952000.0
4952,4952999,21.2149195524949,38.91399397313555,0.07278216741729082,740.4981191158295,326.53052043914795,524.1023025512695,17425,4613,12812,12812,0,15,4953000.0
4953,4953999,21.213911434600185,38.911790958977065,0.0727797803464949,740.6955292224884,326.596328496933,524.1958274841309,17429,4615,12814,12814,0,15,4954000.0
4954,4954999,21.213334906332058,38.916188899481014,0.0727536825824121,740.8276419639587,326.6620008945465,524.3940773010254,17429,4615,12814,12814,0,15,4955000.0
4955,4955999,21.21220273930036,38.91388945817141,0.07275511086189168,740.9435052871704,326.7287049293518,524.5229225158691,17429,4615,12814,12814,0,15,4956000.0
4956,4956999,21.21136122209504,38.91228864365199,0.07274788245735286,741.1161110401154,326.7949604988098,524.5811195373535,17431,4616,12815,12815,0,15,4957000.0
4957,4957999,21.210350263016814,38.91009998076561,0.07274621614409083,741.241338968277,326.8606855869293,524.6974639892578,17431,4616,12815,12815,0,15,4958000.0
4958,4958999,21.20934464198262,38.90779816772179,0.072745221245617,741.4410161972046,326.9279658794403,524.7514762878418,17433,4617,12816,12816,0,15,4959000.0
4959,4959999,21.208362372639726,38.90580397020899,0.07274171221947123,741.5737426280975,326.9940893650055,524.8279914855957,17433,4617,12816,12816,0,15,4960000.0
4960,4960999,21.207527973275713,38.903572877895485,0.07273669337274968,741.705450296402,327.0601680278778,524.9211921691895,17433,4617,12816,12816,0,15,4961000.0
4961,4961999,21.207008278404462,38.90159766165455,0.07272728370247272,741.891271352768,327.1270213127136,524.8911819458008,17435,4618,12817,12817,0,15,4962000.0
4962,4962999,21.20644499651381,38.89962668594395,0.07272601498626996,742.021632194519,327.19330859184265,524.9805717468262,17435,4618,12817,12817,0,15,4963000.0
4963,4963999,21.206332249286604,38.8983908340728,0.07271649327668828,742.1486992835999,327.2592191696167,525.040943145752,17435,4618,12817,12817,0,15,4964000.0
4964,4964999,21.205701101934842,38.896453546655685,0.0727160436969142,742.2654931545258,327.3249320983887,525.0888442993164,17435,4618,12817,12817,0,15,4965000.0
4965,4965999,21.204854980961173,38.89407699929937,0.07271586862444679,742.4233567714691,327.39263343811035,525.1804542541504,17435,4618,12817,12817,0,15,4966000.0
4966,4966999,21.20382741906879,38.89163667878868,0.07271676331406651,742.5567729473114,327.45840430259705,525.2587928771973,17435,4618,12817,12817,0,15,4967000.0
4967,4967999,21.202648841531758,38.89148860058086,0.07268306420550141,742.6779503822327,327.5253219604492,526.2781181335449,17464,4618,12846,12846,0,15,4968000.0
4968,4968999,21.200705632909273,38.88967637615805,0.07269804589569495,742.7911522388458,327.59101700782776,526.6770210266113,17467,4618,12849,12849,0,15,4969000.0
4969,4969999,21.19862878294639,38.88664309017691,0.07271776271212427,742.9018311500549,327.6565909385681,526.9273643493652,17468,4618,12850,12850,0,15,4970000.0
4970,4970999,21.1965279404306,38.88333588898131,0.07274604387940475,743.1055254936218,327.72250962257385,527.0642623901367,17475,4620,12855,12855,0,15,4971000.0
4971,4971999,21.194625136736207,38.880547116325445,0.07276358238934577,743.313704252243,327.7886860370636,527.2492828369141,17479,4622,12857,12857,0,15,4972000.0
4972,4972999,21.19290834656453,38.877757313732275,0.07278110007737337,743.5141234397888,327.8552026748657,527.3524322509766,17483,4624,12859,12859,0,15,4973000.0
4973,4973999,21.19112304241044,38.87505644284014,0.0727977724423522,743.8529660701752,327.9226131439209,527.3310661315918,17493,4629,12864,12864,0,15,4974000.0
4974,4974999,21.18929722045639,38.87200326763483,0.0728111790520587,744.0111017227173,327.98900842666626,527.5493354797363,17495,4630,12865,12865,0,15,4975000.0
4975,4975999,21.187514493580487,38.869198651042836,0.07282615285184801,744.1788549423218,328.05525827407837,527.6982650756836,17497,4631,12866,12866,0,15,4976000.0
4976,4976999,21.18576326924296,38.86685557230118,0.07283744476230136,744.3064913749695,328.12127137184143,527.8458023071289,17497,4631,12866,12866,0,15,4977000.0
4977,4977999,21.18433544607521,38.864509898336244,0.07284173387761217,744.4670286178589,328.1875762939453,527.9594421386719,17499,4632,12867,12867,0,15,4978000.0
4978,4978999,21.18276357064723,38.861711847839246,0.07285028127467841,744.5881736278534,328.25366258621216,528.0680046081543,17499,4632,12867,12867,0,15,4979000.0
4979,4979999,21.181435535000922,38.859431862789116,0.07285279434834091,744.7639954090118,328.3224983215332,528.1176147460938,17501,4633,12868,12868,0,15,4980000.0
4980,4980999,21.180271352076755,38.85770139576539,0.07285431590488423,744.9368152618408,328.38898968696594,528.183349609375,17503,4634,12869,12869,0,15,4981000.0
4981,4981999,21.17980909210955,38.857439927070345,0.07284276424542357,745.1134624481201,328.45650601387024,528.254264831543,17505,4635,12870,12870,0,15,4982000.0
4982,4982999,21.17933629236963,38.856570076258926,0.07283798159298338,745.3253037929535,328.5235080718994,528.2242202758789,17509,4637,12872,12872,0,15,4983000.0
4983,4983999,21.179607059192886,38.85689916057307,0.07282632806781342,745.4616796970367,328.59006547927856,528.3581237792969,17509,4637,12872,12872,0,15,4984000.0
4984,4984999,21.179942597962444,38.85714963151062,0.07281455032658368,745.5750124454498,328.6563205718994,528.4531593322754,17509,4637,12872,12872,0,15,4985000.0
4985,4985999,21.180013723580036,38.856650423057054,0.07280655446549122,745.7204995155334,328.7233393192291,528.5295944213867,17509,4637,12872,12872,0,15,4986000.0
4986,4986999,21.179977366843712,38.8559384777053,0.07281073732244159,745.9061980247498,328.79034066200256,528.5875549316406,17511,4638,12873,12873,0,15,4987000.0
4987,4987999,21.179550596086255,38.855547085796395,0.07280383113083999,746.0405812263489,328.8561522960663,528.7257347106934,17511,4638,12873,12873,0,15,4988000.0
4988,4988999,21.178101240654012,38.85352602192344,0.07281152551270953,746.1539590358734,328.9217641353607,529.5746994018555,17533,4638,12895,12895,0,15,4989000.0
4989,4989999,21.17612651906441,38.850311824251214,0.07282957667259071,746.3121123313904,328.98702025413513,529.895751953125,17538,4639,12899,12899,0,15,4990000.0
4990,4990999,21.17444467664115,38.84854836048007,0.07283934421922478,746.5036957263947,329.05257296562195,530.1021156311035,17542,4641,12901,12901,0,15,4991000.0
4991,4991999,21.172985929975994,38.84582680725737,0.07285354628462415,746.7089865207672,329.11839151382446,530.223705291748,17547,4643,12904,12904,0,15,4992000.0
4992,4992999,21.171638921452786,38.843697236890584,0.07285765547822232,746.8277242183685,329.1836152076721,530.443675994873,17547,4643,12904,12904,0,15,4993000.0
4993,4993999,21.170749135850272,38.84191010029861,0.07286494985411884,746.9891564846039,329.25033617019653,530.6031799316406,17549,4644,12905,12905,0,15,4994000.0
4994,4994999,21.169933251915488,38.84017780985597,0.07286719017145349,747.261700630188,329.3168156147003,530.540397644043,17561,4647,12914,12914,0,15,4995000.0
4995,4995999,21.16907524453923,38.838636987204495,0.07287013015643218,747.4207859039307,329.38271594047546,530.7385787963867,17563,4648,12915,12915,0,15,4996000.0
4996,4996999,21.168495336355594,38.8371743722806,0.07287770235740743,747.6223273277283,329.44875979423523,530.8010787963867,17567,4650,12917,12917,0,15,4997000.0
4997,4997999,21.16820144197063,38.83615638956334,0.07287883591087951,747.7870669364929,329.514701128006,530.8926658630371,17569,4651,12918,12918,0,15,4998000.0
4998,4998999,21.16802730642761,38.83549223392067,0.07289098351465628,747.926506280899,329.58087682724,531.0289573669434,17569,4651,12918,12918,0,15,4999000.0
4999,4999999,21.16792019787429,38.83492603147192,0.072903677366713,748.1240508556366,329.6466028690338,531.0111923217773,17573,4653,12920,12920,0,15,5000000.0
5000,5000999,21.16770403488674,38.834041902292654,0.07292347996638637,748.3078558444977,329.71423387527466,531.0818023681641,17575,4654,12921,12921,0,15,5001000.0
5001,5001999,21.16767015543697,38.83354325573849,0.07295080267005394,748.4301688671112,329.77987813949585,531.1887245178223,17575,4654,12921,12921,0,15,5002000.0
5002,5002999,21.168084379099085,38.833883057938536,0.07295621459036972,748.5580410957336,329.8453848361969,531.2887496948242,17575,4654,12921,12921,0,15,5003000.0
5003,5003999,21.168524484646415,38.83523871085858,0.07295584358822949,748.846230506897,329.9120991230011,531.1837501525879,17583,4658,12925,12925,0,15,5004000.0
5004,5004999,21.168801279972495,38.83506216881789,0.07297736390390208,748.9887511730194,329.97952032089233,531.355842590332,17583,4658,12925,12925,0,15,5005000.0
5005,5005999,21.169012982408006,38.834179938151735,0.07299604555069084,749.1620106697083,330.0493474006653,531.4137191772461,17585,4659,12926,12926,0,15,5006000.0
5006,5006999,21.168971758080225,38.833164185812436,0.07300940630179242,749.2929809093475,330.1157500743866,531.5154571533203,17585,4659,12926,12926,0,15,5007000.0
5007,5007999,21.16884837262985,38.831846167484876,0.07301707591966766,749.4668850898743,330.1822304725647,531.5803146362305,17587,4660,12927,12927,0,15,5008000.0
5008,5008999,21.168222103184426,38.83019937922667,0.07302163657529126,749.6293745040894,330.2480947971344,531.8361320495605,17597,4661,12936,12936,0,15,5009000.0
5009,5009999,21.166723269911206,38.8277299454851,0.0730315880144643,749.7427625656128,330.31471991539,532.5669822692871,17612,4661,12951,12951,0,15,5010000.0
5010,5010999,21.165360390651042,38.82611865387967,0.07304190313191605,749.8629882335663,330.3851478099823,532.8861541748047,17614,4661,12953,12953,0,15,5011000.0
5011,5011999,21.163709325529364,38.82322410541975,0.07306178846468014,750.1064965724945,330.45064091682434,532.995433807373,17622,4664,12958,12958,0,15,5012000.0
5012,5012999,21.16262298091957,38.82214876705721,0.07306451070543629,750.22935962677,330.51618790626526,533.2427291870117,17623,4664,12959,12959,0,15,5013000.0
5013,5013999,21.1612810810157,38.82012439855198,0.07307261387913166,750.4710993766785,330.5818965435028,533.3018035888672,17636,4667,12969,12969,0,15,5014000.0
5014,5014999,21.160099168772344,38.81812335495479,0.0730771993361492,750.6764514446259,330.64800214767456,533.4176826477051,17640,4669,12971,12971,0,15,5015000.0
5015,5015999,21.158972795410442,38.81591396492622,0.07308506213491572,750.8940570354462,330.71431970596313,533.5357208251953,17644,4671,12973,12973,0,15,5016000.0
5016,5016999,21.1577037112948,38.81350989896161,0.07308886093044009,751.181480884552,330.78128933906555,533.5193977355957,17652,4675,12977,12977,0,15,5017000.0
5017,5017999,21.156875282305986,38.81908474495845,0.07306510974142677,751.2983186244965,330.8481147289276,533.7507286071777,17652,4675,12977,12977,0,15,5018000.0
5018,5018999,21.15575931899478,38.81683366219021,0.07306915905372646,751.4141867160797,330.91412353515625,533.9074821472168,17652,4675,12977,12977,0,15,5019000.0
5019,5019999,21.15460963998938,38.814270431678636,0.07307729216345915,751.592766046524,330.9804456233978,534.0153388977051,17654,4676,12978,12978,0,15,5020000.0
5020,5020999,21.153704297831112,38.814849720044464,0.07307230331610659,751.8156034946442,331.0472764968872,534.0487861633301,17658,4678,12980,12980,0,15,5021000.0
5021,5021999,21.152886267649855,38.813004387313796,0.07307043147035175,751.9801156520844,331.11346316337585,534.14453125,17660,4679,12981,12981,0,15,5022000.0
5022,5022999,21.152079821498887,38.81103644419279,0.07307544906828123,752.1001725196838,331.17935705184937,534.2585296630859,17660,4679,12981,12981,0,15,5023000.0
5023,5023999,21.15116755956859,38.808892430114895,0.0730861900044113,752.2402555942535,331.2453644275665,534.3767623901367,17660,4679,12981,12981,0,15,5024000.0
5024,5024999,21.150193927449397,38.80731096154215,0.0730956297508093,752.3678665161133,331.31188440322876,534.4467620849609,17660,4679,12981,12981,0,15,5025000.0
5025,5025999,21.149364887291703,38.8051293994039,0.0731064462524098,752.5423035621643,331.3778805732727,534.6189613342285,17668,4680,12988,12988,0,15,5026000.0
5026,5026999,21.148085387042485,38.80362924007009,0.07310494119756239,752.6608293056488,331.4449279308319,535.6624603271484,17696,4680,13016,13016,0,15,5027000.0
5027,5027999,21.14633003274115,38.800867935824606,0.0731250079322674,752.7716054916382,331.5115478038788,536.0363502502441,17698,4680,13018,13018,0,15,5028000.0
5028,5028999,21.144691730489274,38.7986025934638,0.07313885141016196,752.9722328186035,331.5783176422119,536.2106857299805,17704,4682,13022,13022,0,15,5029000.0
5029,5029999,21.143419044841803,38.797138310710345,0.07315045921763486,753.2099304199219,331.645122051239,536.3748016357422,17710,4685,13025,13025,0,15,5030000.0
5030,5030999,21.141980279750754,38.79516794238769,0.07316033275325085,753.4061555862427,331.71160984039307,536.5764617919922,17714,4687,13027,13027,0,15,5031000.0
5031,5031999,21.140955191938396,38.79411249722979,0.07316143885907267,753.5705428123474,331.7785484790802,536.7321624755859,17716,4688,13028,13028,0,15,5032000.0
5032,5032999,21.13974054541678,38.79239227405547,0.07316805339489241,753.7309641838074,331.84513783454895,536.8821220397949,17718,4689,13029,13029,0,15,5033000.0
5033,5033999,21.13861482418275,38.79045258813572,0.07316873531765611,753.9384508132935,331.91183853149414,536.9637107849121,17722,4691,13031,13031,0,15,5034000.0
5034,5034999,21.137710542688605,38.78859134353601,0.07316892537346209,754.2195529937744,331.9793484210968,536.9305458068848,17730,4695,13035,13035,0,15,5035000.0
5035,5035999,21.137318718031423,38.78816460842039,0.07316252318498984,754.4288425445557,332.0469539165497,537.0548629760742,17734,4697,13037,13037,0,15,5036000.0
5036,5036999,21.13737136661615,38.78832342837915,0.07316177819950498,754.5550417900085,332.1142807006836,537.277587890625,17734,4697,13037,13037,0,15,5037000.0
5037,5037999,21.137419312227188,38.788037815576295,0.07316305126087008,754.7672319412231,332.18209314346313,537.3589553833008,17738,4699,13039,13039,0,15,5038000.0
5038,5038999,21.137490898488718,38.78758283679827,0.07317426953840744,755.0622417926788,332.250372171402,537.337890625,17746,4703,13043,13043,0,15,5039000.0
5039,5039999,21.13743199503638,38.78675747051117,0.07319576556069074,755.2250108718872,332.3171546459198,537.4936141967773,17748,4704,13044,13044,0,15,5040000.0
5040,5040999,21.137733413266762,38.78752278311964,0.07321394595540298,755.3716974258423,332.38455033302307,537.6329154968262,17748,4704,13044,13044,0,15,5041000.0
5041,5041999,21.137657594173696,38.786717608107224,0.07322196696843175,755.5388278961182,332.4519393444061,537.7395553588867,17757,4705,13052,13052,0,15,5042000.0
5042,5042999,21.137613118248115,38.785808617369376,0.0732417680920523,755.6975421905518,332.51917266845703,537.7934989929199,17765,4706,13059,13059,0,15,5043000.0
5043,5043999,21.137348348080927,38.78429622638765,0.07324363822406177,755.8622968196869,332.5863401889801,537.8221664428711,17767,4707,13060,13060,0,15,5044000.0
5044,5044999,21.137108930964622,38.78274726945233,0.07324563978489884,756.001452922821,332.66062593460083,537.9604415893555,17767,4707,13060,13060,0,15,5045000.0
5045,5045999,21.13686736444048,38.781982478832774,0.07321587667477081,756.1769998073578,332.7282621860504,538.5853424072266,17793,4708,13085,13085,0,15,5046000.0
5046,5046999,21.135438756211396,38.77966352571926,0.073225133818144,756.3273260593414,332.7943823337555,539.1037902832031,17808,4709,13099,13099,0,15,5047000.0
5047,5047999,21.134911290669823,38.780721722873785,0.07323639750559285,756.4354474544525,332.859010219574,539.4181632995605,17809,4709,13100,13100,0,15,5048000.0
5048,5048999,21.134751353130515,38.780720150918135,0.07325088958545511,756.640383720398,332.92512702941895,539.5532302856445,17813,4711,13102,13102,0,15,5049000.0
5049,5049999,21.134531620523468,38.78052961883557,0.0732707836477332,756.9326183795929,332.9914059638977,539.6571769714355,17822,4715,13107,13107,0,15,5050000.0
5050,5050999,21.13500791605466,38.78791038399747,0.07332216798774605,757.1696591377258,333.057231426239,539.8175239562988,17828,4718,13110,13110,0,15,5051000.0
5051,5051999,21.13500014699682,38.78787741113215,0.07336047117895106,757.4132368564606,333.1247909069061,539.8499221801758,17834,4721,13113,13113,0,15,5052000.0
5052,5052999,21.134909999407625,38.78805568251343,0.07340582526872164,757.5816314220428,333.1913228034973,540.0842475891113,17836,4722,13114,13114,0,15,5053000.0
5053,5053999,21.135704977407833,38.790922158834896,0.07342532054228224,757.7453253269196,333.2577714920044,540.203498840332,17838,4723,13115,13115,0,15,5054000.0
5054,5054999,21.136575871672925,38.797498020511064,0.0734148211631026,757.9511520862579,333.3239290714264,540.2802581787109,17849,4725,13124,13124,0,15,5055000.0
5055,5055999,21.137177220234687,38.7977197944149,0.07343583896359207,758.1282861232758,333.3904526233673,540.3582229614258,17851,4726,13125,13125,0,15,5056000.0
5056,5056999,21.137771359959835,38.79797781068711,0.07346087889600517,758.2975347042084,333.4573771953583,540.4075736999512,17853,4727,13126,13126,0,15,5057000.0
5057,5057999,21.13864920919709,38.79898997689323,0.07348049295855907,758.4235992431641,333.5233693122864,540.5741882324219,17853,4727,13126,13126,0,15,5058000.0
5058,5058999,21.139055428380942,38.798604117033136,0.07349996461239905,758.7210760116577,333.5903718471527,540.4226493835449,17861,4731,13130,13130,0,15,5059000.0
5059,5059999,21.13966588852428,38.798605759345136,0.07353261106275522,758.8501658439636,333.65677070617676,540.6912689208984,17862,4731,13131,13131,0,15,5060000.0
5060,5060999,21.140509110647525,38.799178567437465,0.07354919454913311,759.0660543441772,333.72527527809143,540.7559776306152,17873,4733,13140,13140,0,15,5061000.0
5061,5061999,21.14153827172348,38.79969447551712,0.07358450352765833,759.1974129676819,333.79205894470215,540.8949813842773,17873,4733,13140,13140,0,15,5062000.0
5062,5062999,21.142557515267818,38.80001208153954,0.07363161139327024,759.3224771022797,333.8583393096924,541.0013160705566,17873,4733,13140,13140,0,15,5063000.0
5063,5063999,21.143380522082808,38.799933554647644,0.0736730083141427,759.4476013183594,333.92458605766296,541.0756301879883,17873,4733,13140,13140,0,15,5064000.0
5064,5064999,21.143979318689347,38.79938739304932,0.07370626969083272,759.6271824836731,333.99119448661804,541.1606712341309,17875,4734,13141,13141,0,15,5065000.0
5065,5065999,21.143941914715185,38.79808698821546,0.07372803025748065,759.8138701915741,334.0582239627838,541.5095329284668,17893,4735,13158,13158,0,15,5066000.0
5066,5066999,21.14301525186982,38.79732309779204,0.07370797507349203,759.925261259079,334.1240887641907,542.1976776123047,17905,4735,13170,13170,0,15,5067000.0
5067,5067999,21.141514177451526,38.79496202216735,0.07371173726689684,760.1552982330322,334.1899597644806,542.4296569824219,17917,4738,13179,13179,0,15,5068000.0
5068,5068999,21.140099794108906,38.7936234941563,0.07371257921872709,760.269490480423,334.2562551498413,542.7065353393555,17918,4738,13180,13180,0,15,5069000.0
5069,5069999,21.13864001185266,38.79109216181094,0.07371865177841264,760.5691044330597,334.32305216789246,542.7333755493164,17928,4742,13186,13186,0,15,5070000.0
5070,5070999,21.13746564836183,38.78884150340308,0.0737205009308326,760.7790236473083,334.3910994529724,542.9331665039062,17938,4744,13194,13194,0,15,5071000.0
5071,5071999,21.13638932048486,38.78675199733162,0.07372353163001932,761.0144460201263,334.4575181007385,542.9630584716797,17944,4747,13197,13197,0,15,5072000.0
5072,5072999,21.13585841078293,38.786155833256544,0.07372359102484094,761.2666275501251,334.5246024131775,543.1149978637695,17956,4750,13206,13206,0,15,5073000.0
5073,5073999,21.135720585945034,38.78595873623508,0.07372576707179923,761.432656288147,334.59181118011475,543.2650756835938,17965,4751,13214,13214,0,15,5074000.0
5074,5074999,21.135945089267704,38.785851891362405,0.07372893807921044,761.6766748428345,334.65856552124023,543.2774887084961,17971,4754,13217,13217,0,15,5075000.0
5075,5075999,21.136101267998573,38.78543485256945,0.07376232944239636,761.933794260025,334.72619438171387,543.3384170532227,17977,4757,13220,13220,0,15,5076000.0
5076,5076999,21.136534272563132,38.78577690524276,0.07378239805498776,762.1027534008026,334.7934148311615,543.5058631896973,17979,4758,13221,13221,0,15,5077000.0
5077,5077999,21.1370429641711,38.786519346758375,0.07380012592306195,762.309604883194,334.8623173236847,543.6339836120605,17983,4760,13223,13223,0,15,5078000.0
5078,5078999,21.13759386797473,38.78698456029386,0.0738147372831427,762.5251381397247,334.9297034740448,543.6418647766113,18001,4762,13239,13239,0,15,5079000.0
5079,5079999,21.138236533394455,38.78720844932578,0.07383049352639426,762.7119336128235,334.9969403743744,543.7651710510254,18003,4763,13240,13240,0,15,5080000.0
5080,5080999,21.13907056557478,38.787476753184514,0.07386594584959716,762.8415877819061,335.0640826225281,543.9254570007324,18003,4763,13240,13240,0,15,5081000.0
5081,5081999,21.139701905603925,38.78715254981255,0.0738803368964307,762.9828658103943,335.1310622692108,544.0606307983398,18003,4763,13240,13240,0,15,5082000.0
5082,5082999,21.1404046230401,38.78700791398389,0.07388983438649133,763.1527078151703,335.19855093955994,544.1107330322266,18005,4764,13241,13241,0,15,5083000.0
5083,5083999,21.140663584589998,38.7861308087939,0.07389553328474452,763.315512418747,335.2657313346863,544.1196632385254,18007,4765,13242,13242,0,15,5084000.0
5084,5084999,21.14132236844352,38.7855457764042,0.07388433869381283,763.5410537719727,335.3332431316376,544.1702613830566,18011,4767,13244,13244,0,15,5085000.0
5085,5085999,21.14112276044176,38.78463968869399,0.07387257303728667,763.6604037284851,335.40048694610596,544.9274940490723,18038,4767,13271,13271,0,15,5086000.0
5086,5086999,21.139809950133436,38.78465512669311,0.07387125588710897,763.8158891201019,335.4666690826416,545.4510383605957,18049,4768,13281,13281,0,15,5087000.0
5087,5087999,21.137996730608975,38.78159918598159,0.0738880845707861,763.9311282634735,335.53349208831787,545.8213882446289,18053,4768,13285,13285,0,15,5088000.0
5088,5088999,21.13629323259666,38.77917101465075,0.07390267883147195,764.1337852478027,335.5998194217682,545.9673080444336,18058,4770,13288,13288,0,15,5089000.0
5089,5089999,21.134571038823307,38.776594636650344,0.07391525994590908,764.2970759868622,335.66613483428955,546.1578216552734,18061,4771,13290,13290,0,15,5090000.0
5090,5090999,21.133145993382414,38.774182849663596,0.07391905337244287,764.5032975673676,335.7330176830292,546.3434982299805,18065,4773,13292,13292,0,15,5091000.0
5091,5091999,21.131601969883114,38.77171269047323,0.07392606898034582,764.6708011627197,335.8000612258911,546.4345817565918,18067,4774,13293,13293,0,15,5092000.0
5092,5092999,21.12994142079266,38.76902067123263,0.07394216401559661,765.0021803379059,335.86699175834656,546.4215316772461,18084,4779,13305,13305,0,15,5093000.0
5093,5093999,21.128635084942,38.766989321720345,0.0739507520797994,765.1990904808044,335.93352341651917,546.5096321105957,18093,4781,13312,13312,0,15,5094000.0
5094,5094999,21.127325519088817,38.764779246893866,0.07396445809240915,765.3243606090546,335.99991369247437,546.7105865478516,18093,4781,13312,13312,0,15,5095000.0
5095,5095999,21.126195575315432,38.7628741522646,0.0739685367233095,765.5824921131134,336.0672755241394,546.7507972717285,18099,4784,13315,13315,0,15,5096000.0
5096,5096999,21.12495883505918,38.7605116032945,0.0739722870387578,765.7471160888672,336.1341042518616,546.9271202087402,18101,4785,13316,13316,0,15,5097000.0
5097,5097999,21.12380149447028,38.75836884520516,0.07398241483218548,765.9901578426361,336.2014765739441,546.9568786621094,18112,4788,13324,13324,0,15,5098000.0
5098,5098999,21.12268602954135,38.756676531411976,0.07398387431861364,766.124237537384,336.26808857917786,547.098819732666,18112,4788,13324,13324,0,15,5099000.0
5099,5099999,21.121609129890285,38.7543472822741,0.07399263690069979,766.2527921199799,336.33471512794495,547.2467918395996,18112,4788,13324,13324,0,15,5100000.0
5100,5100999,21.12073439233231,38.75257671457953,0.07399573930226522,766.4293010234833,336.40113830566406,547.2617340087891,18114,4789,13325,13325,0,15,5101000.0
5101,5101999,21.11974580155054,38.75056293167654,0.0739989934760027,766.5511152744293,336.4672737121582,547.376636505127,18114,4789,13325,13325,0,15,5102000.0
5102,5102999,21.11906751253873,38.74913156062685,0.0740035574121034,766.691900730133,336.5337724685669,547.5035667419434,18114,4789,13325,13325,0,15,5103000.0
5103,5103999,21.11788987996626,38.746589104875696,0.0740085190089822,766.8653743267059,336.6003589630127,547.5562133789062,18121,4790,13331,13331,0,15,5104000.0
5104,5104999,21.117043208655748,38.74453127298371,0.07401501991328863,766.9973599910736,336.6668312549591,547.6456260681152,18121,4790,13331,13331,0,15,5105000.0
5105,5105999,21.11588463456448,38.74269615984506,0.0740230810694893,767.1632113456726,336.73348021507263,547.6961860656738,18123,4791,13332,13332,0,15,5106000.0
5106,5106999,21.11417068521284,38.73978198553492,0.07403960419701228,767.3319935798645,336.80029034614563,548.596622467041,18158,4792,13366,13366,0,15,5107000.0
5107,5107999,21.112126501196826,38.73750288271844,0.07405428214371967,767.4415831565857,336.86553382873535,549.0893669128418,18162,4792,13370,13370,0,15,5108000.0
5108,5108999,21.110215961709596,38.73469070016582,0.07406784362678298,767.6919355392456,336.93176341056824,549.2151412963867,18169,4795,13374,13374,0,15,5109000.0
5109,5109999,21.108281398559743,38.7318909291433,0.07408571683753096,767.8028807640076,336.99721908569336,549.5081558227539,18170,4795,13375,13375,0,15,5110000.0
5110,5110999,21.106253890543062,38.72874151839866,0.07410291024134108,767.9664783477783,337.0631127357483,549.6788902282715,18172,4796,13376,13376,0,15,5111000.0
5111,5111999,21.10432692315408,38.72569461978305,0.07411745252958202,768.1799364089966,337.1295349597931,549.8061637878418,18176,4798,13378,13378,0,15,5112000.0
5112,5112999,21.10241782811404,38.722692975832395,0.07413105593960401,768.3815517425537,337.1969678401947,549.9259262084961,18180,4800,13380,13380,0,15,5113000.0
5113,5113999,21.10065788845839,38.72036680882043,0.07413795340488938,768.5954971313477,337.2635359764099,550.0520935058594,18185,4802,13383,13383,0,15,5114000.0
5114,5114999,21.099112458551343,38.71830717917757,0.07414158318048025,768.7564532756805,337.3296699523926,550.1679534912109,18187,4803,13384,13384,0,15,5115000.0
5115,5115999,21.0975030044535,38.715545389437885,0.07415229986030847,768.8792889118195,337.39561104774475,550.3378639221191,18187,4803,13384,13384,0,15,5116000.0
5116,5116999,21.096298223442492,38.71361308794318,0.07415355765234588,769.0895512104034,337.4635806083679,550.4032592773438,18191,4805,13386,13386,0,15,5117000.0
5117,5117999,21.095726257103994,38.71275657439045,0.0741508515556577,769.2981774806976,337.5306067466736,550.4912185668945,18195,4807,13388,13388,0,15,5118000.0
5118,5118999,21.09565746814719,38.71215244745264,0.07414489761342791,769.4229447841644,337.5966773033142,550.652759552002,18195,4807,13388,13388,0,15,5119000.0
5119,5119999,21.096202516104903,38.715518174522636,0.0741303076445603,769.5963191986084,337.66329312324524,550.7091751098633,18197,4808,13389,13389,0,15,5120000.0
5120,5120999,21.096231142823317,38.715723859322324,0.07414421376176772,769.8185524940491,337.7305791378021,550.7222595214844,18201,4810,13391,13391,0,15,5121000.0
5121,5121999,21.096385446872432,38.7156978521239,0.07416698929758991,769.9880218505859,337.7971134185791,550.8045997619629,18203,4811,13392,13392,0,15,5122000.0
5122,5122999,21.096880499177253,38.71619605223248,0.07420757804080413,770.113513469696,337.86344504356384,550.9214286804199,18203,4811,13392,13392,0,15,5123000.0
5123,5123999,21.09697547266431,38.71582127331502,0.07424493192923831,770.2835855484009,337.9298486709595,550.9662818908691,18205,4812,13393,13393,0,15,5124000.0
5124,5124999,21.09646117731181,38.71422046520393,0.07425873620259726,770.4494867324829,337.99640369415283,551.0053367614746,18207,4813,13394,13394,0,15,5125000.0
5125,5125999,21.096361301285025,38.713293453535606,0.07428353311479918,770.582282781601,338.06310987472534,551.1260757446289,18207,4813,13394,13394,0,15,5126000.0
5126,5126999,21.09611400350892,38.71217887490308,0.07432265981219788,770.7972013950348,338.1296966075897,551.1178207397461,18211,4815,13396,13396,0,15,5127000.0
5127,5127999,21.09464494439353,38.710004018354354,0.07433099797863973,770.913113117218,338.1964519023895,552.1593742370605,18243,4815,13428,13428,0,15,5128000.0
5128,5128999,21.093009924278398,38.707824062130285,0.0743375573902223,771.0714733600616,338.26260900497437,552.5607070922852,18248,4816,13432,13432,0,15,5129000.0
5129,5129999,21.09146598747829,38.70531080317662,0.07434814209181528,771.1864831447601,338.3282985687256,552.8672676086426,18249,4816,13433,13433,0,15,5130000.0
5130,5130999,21.090043732627688,38.70365753166171,0.07435300134002854,771.3458650112152,338.397173166275,553.0721015930176,18253,4817,13436,13436,0,15,5131000.0
5131,5131999,21.088653566863456,38.7012942627507,0.07435529841826305,771.5980231761932,338.46366834640503,553.1670036315918,18259,4820,13439,13439,0,15,5132000.0
5132,5132999,21.08758805384066,38.69942157898514,0.07435668441807797,771.7642686367035,338.5294988155365,553.3199729919434,18261,4821,13440,13440,0,15,5133000.0
5133,5133999,21.086296015581024,38.69717889894313,0.07436248631969422,772.0248835086823,338.59673738479614,553.3564109802246,18267,4824,13443,13443,0,15,5134000.0
5134,5134999,21.085134669357384,38.695032431723206,0.07436345045375803,772.2285056114197,338.66343808174133,553.4953689575195,18271,4826,13445,13445,0,15,5135000.0
5135,5135999,21.08398068506148,38.69514546683767,0.07435785108825566,772.3524239063263,338.7293608188629,553.6458358764648,18271,4826,13445,13445,0,15,5136000.0
5136,5136999,21.083129075620363,38.6936995642318,0.07436469885098318,772.52760887146,338.7961916923523,553.7206993103027,18273,4827,13446,13446,0,15,5137000.0
5137,5137999,21.08273772313108,38.69323923945198,0.07436628464000516,772.6880323886871,338.86264157295227,553.8632164001465,18275,4828,13447,13447,0,15,5138000.0
5138,5138999,21.082723301146704,38.695600531693856,0.07436245461089264,772.8028585910797,338.92844891548157,553.9866714477539,18275,4828,13447,13447,0,15,5139000.0
5139,5139999,21.083289786039938,38.69946741465269,0.07436546678822997,773.1114821434021,338.99674129486084,553.9265213012695,18283,4832,13451,13451,0,15,5140000.0
5140,5140999,21.084068981812845,38.70089421379749,0.07439588981075429,773.3162722587585,339.063711643219,554.0392074584961,18287,4834,13453,13453,0,15,5141000.0
5141,5141999,21.08551207811853,38.7038359957279,0.07440386844504088,773.5328695774078,339.13053584098816,554.0774536132812,18291,4836,13455,13455,0,15,5142000.0
5142,5142999,21.086789902942737,38.706020385542246,0.0744546954854094,773.7018883228302,339.1980068683624,554.2323303222656,18293,4837,13456,13456,0,15,5143000.0
5143,5143999,21.088665229047376,38.70999220545141,0.0745051716243893,773.8323016166687,339.2682089805603,554.3904800415039,18293,4837,13456,13456,0,15,5144000.0
5144,5144999,21.090275155352607,38.71281371164308,0.07455571049679055,774.0005700588226,339.33532881736755,554.4822540283203,18295,4838,13457,13457,0,15,5145000.0
5145,5145999,21.091038454400888,38.71348779761647,0.07460131066612341,774.1684048175812,339.4022316932678,554.5263519287109,18297,4839,13458,13458,0,15,5146000.0
5146,5146999,21.09196838968651,38.71399679371985,0.07466093789254802,774.3991301059723,339.4696295261383,554.5889778137207,18301,4841,13460,13460,0,15,5147000.0
5147,5147999,21.093058540566563,38.71518224562953,0.07473688956406221,774.5292687416077,339.5359253883362,554.8975486755371,18308,4841,13467,13467,0,15,5148000.0
5148,5148999,21.09203096899245,38.713210744887846,0.07473659541662425,774.6535811424255,339.6032612323761,556.0781707763672,18348,4841,13507,13507,0,15,5149000.0
5149,5149999,21.090998370566037,38.71174943880279,0.07473584980499748,774.7672035694122,339.67003059387207,556.6185531616211,18354,4841,13513,13513,0,15,5150000.0
5150,5150999,21.08989042066583,38.709625463869656,0.07473903393806192,774.9306485652924,339.7358818054199,556.8866271972656,18357,4842,13515,13515,0,15,5151000.0
5151,5151999,21.088994521271765,38.70966581588829,0.07473072323048258,775.1263973712921,339.8019337654114,557.0954170227051,18368,4844,13524,13524,0,15,5152000.0
5152,5152999,21.087826462423234,38.710858627473776,0.0747216592565908,775.3179845809937,339.888299703598,557.3067779541016,18370,4845,13525,13525,0,15,5153000.0
5153,5153999,21.086468434131277,38.70816214797611,0.07472939253032118,775.502895116806,339.9622132778168,557.466007232666,18372,4846,13526,13526,0,15,5154000.0
5154,5154999,21.085565640126365,38.70634075545011,0.07472952382093645,775.7555565834045,340.02880907058716,557.5341033935547,18378,4849,13529,13529,0,15,5155000.0
5155,5155999,21.084585940774414,38.70474159250009,0.07472843358945924,775.9222869873047,340.0948932170868,557.6893920898438,18380,4850,13530,13530,0,15,5156000.0
5156,5156999,21.083369980169294,38.70273753345416,0.07473572406898843,776.1813371181488,340.16174054145813,557.7260284423828,18387,4853,13534,13534,0,15,5157000.0
5157,5157999,21.082412570261823,38.7007880825947,0.07474116874993364,776.342093706131,340.2279624938965,557.9410133361816,18389,4854,13535,13535,0,15,5158000.0
5158,5158999,21.081517596254997,38.701025354894675,0.07474339477194936,776.5423667430878,340.2941815853119,557.9910125732422,18393,4856,13537,13537,0,15,5159000.0
5159,5159999,21.080483741299858,38.698658669815444,0.07475322322020839,776.6749947071075,340.3607084751129,558.1181526184082,18393,4856,13537,13537,0,15,5160000.0
5160,5160999,21.07968162003862,38.69695736370709,0.07475589361184631,776.7979035377502,340.42677783966064,558.3277015686035,18393,4856,13537,13537,0,15,5161000.0
5161,5161999,21.07890275926318,38.697095657413385,0.0747559705510199,777.0108323097229,340.4929642677307,558.3112297058105,18397,4858,13539,13539,0,15,5162000.0
5162,5162999,21.07808823024328,38.69493138895734,0.0747628606142644,777.1837694644928,340.5591461658478,558.5023040771484,18399,4859,13540,13540,0,15,5163000.0
5163,5163999,21.076901181264883,38.69229857033899,0.0747786611159823,777.3142409324646,340.6250412464142,558.6279602050781,18399,4859,13540,13540,0,15,5164000.0
5164,5164999,21.075644654388295,38.690679348475214,0.07479026465839766,777.4576370716095,340.7007954120636,558.8139610290527,18399,4859,13540,13540,0,15,5165000.0
5165,5165999,21.074002430402473,38.68779747719268,0.07480283779072705,777.5815773010254,340.7669475078583,559.7917976379395,18427,4859,13568,13568,0,15,5166000.0
5166,5166999,21.07225760215445,38.685469301486755,0.0748164540810774,777.6984367370605,340.831995010376,560.1237983703613,18428,4859,13569,13569,0,15,5167000.0
5167,5167999,21.070672303493062,38.68399037768798,0.07482609001968177,777.9330954551697,340.8974199295044,560.2177848815918,18435,4862,13573,13573,0,15,5168000.0
5168,5168999,21.068963273602673,38.681177346233376,0.07483914905487643,778.0905570983887,340.9630837440491,560.4729843139648,18437,4863,13574,13574,0,15,5169000.0
5169,5169999,21.06749084463823,38.679151952046006,0.07484942407607487,778.3436117172241,341.03096890449524,560.5146408081055,18443,4866,13577,13577,0,15,5170000.0
5170,5170999,21.066186246731853,38.677244665847866,0.07485898452912543,778.5453991889954,341.097140789032,560.6300086975098,18447,4868,13579,13579,0,15,5171000.0
5171,5171999,21.065021289508,38.67636807957184,0.07485537768992934,778.7567143440247,341.16392707824707,560.7612228393555,18451,4870,13581,13581,0,15,5172000.0
5172,5172999,21.06375948982349,38.67436440426144,0.07485963498303938,778.9351758956909,341.2345886230469,560.8811645507812,18453,4871,13582,13582,0,15,5173000.0
5173,5173999,21.062766181966698,38.6731222351544,0.0748557471035135,779.097145318985,341.3008658885956,560.9974517822266,18455,4872,13583,13583,0,15,5174000.0
5174,5174999,21.06152012945245,38.67120183298896,0.07485521371812387,779.3507626056671,341.36745715141296,560.9670295715332,18461,4875,13586,13586,0,15,5175000.0
5175,5175999,21.06079163660583,38.669826153611695,0.07484528221422937,779.5255608558655,341.4338319301605,561.1188468933105,18463,4876,13587,13587,0,15,5176000.0
5176,5176999,21.060286770599372,38.66953705952073,0.07483403647193942,779.6665923595428,341.5100255012512,561.2857398986816,18463,4876,13587,13587,0,15,5177000.0
5177,5177999,21.05986530176434,38.668612719145735,0.07482577168653493,779.8017706871033,341.5767047405243,561.4309158325195,18463,4876,13587,13587,0,15,5178000.0
5178,5178999,21.059074671027087,38.66697175754106,0.07481886464144516,779.9806506633759,341.6430263519287,561.4796257019043,18465,4877,13588,13588,0,15,5179000.0
5179,5179999,21.05893863824719,38.666570121306194,0.07480084450847302,780.1445968151093,341.70972061157227,561.5313758850098,18467,4878,13589,13589,0,15,5180000.0
5180,5180999,21.058282621956895,38.66492265014495,0.07479728606337832,780.3185186386108,341.7762565612793,561.5723152160645,18469,4879,13590,13590,0,15,5181000.0
5181,5181999,21.057645402076382,38.663335814618144,0.07478586739852144,780.4493434429169,341.84245681762695,561.674186706543,18469,4879,13590,13590,0,15,5182000.0
5182,5182999,21.057081068568174,38.66199126878384,0.07477454692005159,780.5701515674591,341.90934586524963,561.7454223632812,18469,4879,13590,13590,0,15,5183000.0
5183,5183999,21.05682469656872,38.66437806527506,0.07474807265984407,780.7980461120605,341.9763517379761,561.7745094299316,18473,4881,13592,13592,0,15,5184000.0
5184,5184999,21.056197084154135,38.66495159279836,0.07473138153390468,780.9412062168121,342.04273414611816,562.2933540344238,18492,4881,13611,13611,0,15,5185000.0
5185,5185999,21.054721729631538,38.66310637673757,0.07473458883884998,781.0551068782806,342.10802936553955,562.9454956054688,18502,4881,13621,13621,0,15,5186000.0
5186,5186999,21.053215848571973,38.66169675775502,0.0747364581529173,781.2079412937164,342.1732485294342,563.242115020752,18505,4882,13623,13623,0,15,5187000.0
5187,5187999,21.052134855525143,38.660905578425485,0.07472901763028483,781.404899597168,342.2387149333954,563.391040802002,18509,4884,13625,13625,0,15,5188000.0
5188,5188999,21.051106956299037,38.659119319059556,0.07472678192626636,781.5263900756836,342.3048152923584,563.6374626159668,18512,4884,13628,13628,0,15,5189000.0
5189,5189999,21.050491820904163,38.65834335117869,0.07471356375871274,781.6385023593903,342.36989855766296,563.8257942199707,18512,4884,13628,13628,0,15,5190000.0
5190,5190999,21.049678131172996,38.65674226212282,0.07470641216420304,781.8851525783539,342.4359622001648,563.879451751709,18518,4887,13631,13631,0,15,5191000.0
5191,5191999,21.048791909928934,38.65488831901627,0.07469944187534217,782.2757661342621,342.5029435157776,563.7431144714355,18530,4893,13637,13637,0,15,5192000.0
5192,5192999,21.04776234905869,38.652682999033274,0.07469955201041545,782.4461932182312,342.56953978538513,563.9831199645996,18532,4894,13638,13638,0,15,5193000.0
5193,5193999,21.046945648388146,38.65089248419088,0.07469549979964385,782.6106283664703,342.63585591316223,564.1320877075195,18541,4895,13646,13646,0,15,5194000.0
5194,5194999,21.046545884264635,38.650417227957355,0.07468919887248227,782.8270509243011,342.70257091522217,564.1980590820312,18545,4897,13648,13648,0,15,5195000.0
5195,5195999,21.04587564487994,38.64847309512229,0.07468512194288579,782.9607484340668,342.7689414024353,564.355167388916,18545,4897,13648,13648,0,15,5196000.0
5196,5196999,21.045362938111097,38.64709297770535,0.0746865949222224,783.1220636367798,342.83622908592224,564.4447326660156,18547,4898,13649,13649,0,15,5197000.0
5197,5197999,21.04476467697268,38.64543158791915,0.07468188139545906,783.3771924972534,342.9032938480377,564.38623046875,18553,4901,13652,13652,0,15,5198000.0
5198,5198999,21.044515986883823,38.64670285579425,0.07466559591420074,783.5191249847412,342.97031927108765,564.5827331542969,18553,4901,13652,13652,0,15,5199000.0
5199,5199999,21.043870112264717,38.64477109794899,0.0746645454354502,783.682975769043,343.036728143692,564.6793556213379,18555,4902,13653,13653,0,15,5200000.0
5200,5200999,21.043196694864953,38.64280416043075,0.07466401855973037,783.9051229953766,343.1042821407318,564.689868927002,18559,4904,13655,13655,0,15,5201000.0
5201,5201999,21.04283375807862,38.641807110508715,0.07465953158032623,784.0748167037964,343.1708686351776,564.8340263366699,18561,4905,13656,13656,0,15,5202000.0
5202,5202999,21.042290674122487,38.63996056907147,0.07466084288969155,784.2202384471893,343.2376651763916,564.9422454833984,18561,4905,13656,13656,0,15,5203000.0
5203,5203999,21.041424034077295,38.63771058918959,0.07465895238098974,784.3476510047913,343.30394554138184,565.0237083435059,18561,4905,13656,13656,0,15,5204000.0
5204,5204999,21.040433180702507,38.63538384769627,0.0746573457249402,784.4711127281189,343.37029361724854,565.1288986206055,18561,4905,13656,13656,0,15,5205000.0
5205,5205999,21.03982922351697,38.63331996310253,0.07465669071831826,784.6480317115784,343.4370467662811,565.6147651672363,18583,4906,13677,13677,0,15,5206000.0
5206,5206999,21.038426331212168,38.630790119695384,0.07466365156038768,784.761958360672,343.5030572414398,566.0419464111328,18586,4906,13680,13680,0,15,5207000.0
5207,5207999,21.036847622035985,38.62813109005387,0.07467091362646538,784.8865852355957,343.568213224411,566.3626556396484,18590,4906,13684,13684,0,15,5208000.0
5208,5208999,21.03536722312837,38.62541432542914,0.0746827694723955,785.1442229747772,343.6382839679718,566.3860168457031,18604,4909,13695,13695,0,15,5209000.0
5209,5209999,21.03401181316181,38.62287920621073,0.07469272087608814,785.3454511165619,343.7039461135864,566.5289039611816,18610,4911,13699,13699,0,15,5210000.0
5210,5210999,21.032895531953613,38.62176570764347,0.07469381316995238,785.5162041187286,343.7709791660309,566.8309516906738,18614,4912,13702,13702,0,15,5211000.0
5211,5211999,21.03158839215331,38.61925768563376,0.07469990345386601,785.6719994544983,343.8366723060608,566.9617233276367,18616,4913,13703,13703,0,15,5212000.0
5212,5212999,21.030113300733316,38.616679353253865,0.0747108383164562,785.940553188324,343.90364480018616,567.0120544433594,18629,4916,13713,13713,0,15,5213000.0
5213,5213999,21.028908687265083,38.61429171916962,0.07471769780790527,786.1493029594421,343.97044467926025,567.0785140991211,18633,4918,13715,13715,0,15,5214000.0
5214,5214999,21.027936108627642,38.612594974400054,0.07472142424083517,786.3090422153473,344.0365717411041,567.2402305603027,18635,4919,13716,13716,0,15,5215000.0
5215,5215999,21.02684186383276,38.61070605187031,0.07472754209386723,786.450480222702,344.10307931900024,567.3847808837891,18635,4919,13716,13716,0,15,5216000.0
5216,5216999,21.025517860191705,38.60811927913937,0.07473801891154552,786.6555345058441,344.16965079307556,567.4859924316406,18640,4921,13719,13719,0,15,5217000.0
5217,5217999,21.024327904705697,38.60566755541843,0.07474371407699643,786.8226635456085,344.23714089393616,567.5858306884766,18642,4922,13720,13720,0,15,5218000.0
5218,5218999,21.023317271051887,38.60390211552071,0.0747464538190411,787.0805804729462,344.3041546344757,567.5155563354492,18655,4925,13730,13730,0,15,5219000.0
5219,5219999,21.022454555064755,38.60215236136477,0.07474706596200653,787.2624175548553,344.3713710308075,567.6725540161133,18657,4926,13731,13731,0,15,5220000.0
5220,5220999,21.021925257377404,38.601332560579806,0.07474713175983827,787.3935070037842,344.43819093704224,567.8070487976074,18657,4926,13731,13731,0,15,5221000.0
5221,5221999,21.021243672451195,38.599621570741895,0.07475351931016627,787.5172438621521,344.50446915626526,567.9259414672852,18657,4926,13731,13731,0,15,5222000.0
5222,5222999,21.020685408874037,38.5983418263738,0.07475547075868028,787.7295389175415,344.5710988044739,567.8642692565918,18661,4928,13733,13733,0,15,5223000.0
5223,5223999,21.020064806978432,38.597764496226795,0.07475480242124233,787.8953711986542,344.63964891433716,567.9213676452637,18663,4929,13734,13734,0,15,5224000.0
5224,5224999,21.018965953613783,38.59659092957452,0.07475376383500743,788.0580184459686,344.70642256736755,567.9868621826172,18665,4930,13735,13735,0,15,5225000.0
5225,5225999,21.017989963611956,38.594467086955376,0.07475393141203779,788.3697757720947,344.774210691452,568.383243560791,18693,4934,13759,13759,0,15,5226000.0
5226,5226999,21.01655586422749,38.593323514020135,0.0747636365378288,788.4864485263824,344.8413598537445,569.3679161071777,18724,4934,13790,13790,0,15,5227000.0
5227,5227999,21.014766580383732,38.59056764739918,0.07477724707389644,788.5976266860962,344.90715408325195,569.9304428100586,18729,4934,13795,13795,0,15,5228000.0
5228,5228999,21.013014135352943,38.587632388873345,0.07479059923742026,788.8803424835205,344.97339153289795,570.0789222717285,18744,4938,13806,13806,0,15,5229000.0
5229,5229999,21.011413367828517,38.58500348527945,0.07480106816351928,789.0488364696503,345.04015493392944,570.3620643615723,18747,4939,13808,13808,0,15,5230000.0
5230,5230999,21.010087119410294,38.58313302829041,0.07480423013802273,789.29811668396,345.1073899269104,570.6126022338867,18754,4942,13812,13812,0,15,5231000.0
5231,5231999,21.008441359578956,38.58035476311123,0.07481759286479983,789.4645149707794,345.17367124557495,570.780029296875,18756,4943,13813,13813,0,15,5232000.0
5232,5232999,21.00701439133064,38.57828086167196,0.0748257704102897,789.7177727222443,345.24062180519104,570.8466835021973,18762,4946,13816,13816,0,15,5233000.0
5233,5233999,21.005678303240195,38.57640964070008,0.07483104814984454,789.9189095497131,345.30728912353516,570.9921989440918,18766,4948,13818,13818,0,15,5234000.0
5234,5234999,21.004301006178768,38.57389719316876,0.07483812140299717,790.0474781990051,345.3746569156647,571.1933517456055,18766,4948,13818,13818,0,15,5235000.0
5235,5235999,21.002850307500907,38.5713266283631,0.07484952864465078,790.1759850978851,345.44111132621765,571.3341445922852,18766,4948,13818,13818,0,15,5236000.0
5236,5236999,21.001600078855482,38.56936030245519,0.07485589115519076,790.3530766963959,345.5080420970917,571.4550476074219,18768,4949,13819,13819,0,15,5237000.0
5237,5237999,21.000253574221674,38.56730374780064,0.0748604433790222,790.480462551117,345.5743384361267,571.5844268798828,18768,4949,13819,13819,0,15,5238000.0
5238,5238999,20.99881963776383,38.56492796791177,0.07486905026409985,790.6497230529785,345.6412796974182,571.6508026123047,18777,4950,13827,13827,0,15,5239000.0
5239,5239999,20.997703660371567,38.56270548786245,0.07486841446310077,790.8770298957825,345.7082619667053,571.743408203125,18781,4952,13829,13829,0,15,5240000.0
5240,5240999,20.996581412194377,38.56176855046361,0.0748632633085955,790.9974641799927,345.7748348712921,571.8534965515137,18781,4952,13829,13829,0,15,5241000.0
5241,5241999,20.995373311407167,38.559409114769885,0.07486839989894578,791.1328148841858,345.8411521911621,571.9343338012695,18781,4952,13829,13829,0,15,5242000.0
5242,5242999,20.994375544241453,38.55736964381062,0.07487020559716395,791.395022392273,345.90857219696045,571.9015846252441,18787,4955,13832,13832,0,15,5243000.0
5243,5243999,20.993147179502724,38.5549477890082,0.07487370511144842,791.5239326953888,345.9749844074249,572.0276527404785,18787,4955,13832,13832,0,15,5244000.0
5244,5244999,20.99182434929414,38.55238128762048,0.0748770312856959,791.7394878864288,346.04208278656006,572.0850639343262,18802,4957,13845,13845,0,15,5245000.0
5245,5245999,20.99032399813993,38.549843986368835,0.07488657340627725,791.9188404083252,346.1088402271271,572.1543998718262,18804,4958,13846,13846,0,15,5246000.0
5246,5246999,20.988788998466024,38.54710662739345,0.07490073285368559,792.0420167446136,346.17528200149536,573.0370826721191,18832,4958,13874,13874,0,15,5247000.0
5247,5247999,20.986948072559887,38.54432882250636,0.07491043996590219,792.2028052806854,346.2410478591919,573.3463668823242,18840,4959,13881,13881,0,15,5248000.0
5248,5248999,20.985138794031574,38.54162629030157,0.074923043775452,792.4451832771301,346.3066017627716,573.4682197570801,18854,4962,13892,13892,0,15,5249000.0
5249,5249999,20.98355753114282,38.538974297974804,0.07493647646380242,792.6931467056274,346.3728713989258,573.6325607299805,18862,4965,13897,13897,0,15,5250000.0
5250,5250999,20.9820910456392,38.53653703591521,0.07494291740391268,792.8969814777374,346.44012475013733,573.7871208190918,18866,4967,13899,13899,0,15,5251000.0
5251,5251999,20.98089753717172,38.53524660547519,0.07494663891002595,793.0609319210052,346.50612139701843,574.0032958984375,18868,4968,13900,13900,0,15,5252000.0
5252,5252999,20.979427853096077,38.53335374277995,0.07495264582633199,793.3170235157013,346.5725300312042,573.9714889526367,18874,4971,13903,13903,0,15,5253000.0
5253,5253999,20.978256986128134,38.53148095331198,0.0749617239655409,793.531661272049,346.6394422054291,574.0835800170898,18878,4973,13905,13905,0,15,5254000.0
5254,5254999,20.976954100992433,38.52939397819492,0.07496842756968991,793.7440280914307,346.70566987991333,574.1820259094238,18882,4975,13907,13907,0,15,5255000.0
5255,5255999,20.97569413693536,38.52717075783226,0.07497825504093591,793.8668704032898,346.7718253135681,574.3599891662598,18882,4975,13907,13907,0,15,5256000.0
5256,5256999,20.974687849689012,38.52513487748693,0.07497865149800997,794.0404403209686,346.8382647037506,574.4664497375488,18884,4976,13908,13908,0,15,5257000.0
5257,5257999,20.973548976773923,38.52316781433783,0.07498054893278183,794.173810005188,346.9050090312958,574.6059036254883,18884,4976,13908,13908,0,15,5258000.0
5258,5258999,20.972575839278697,38.52145707447807,0.07498080368765503,794.3840215206146,346.9713659286499,574.5834350585938,18888,4978,13910,13910,0,15,5259000.0
5259,5259999,20.971513214511226,38.51941325944378,0.07498067228369443,794.5215470790863,347.0381076335907,574.7162780761719,18888,4978,13910,13910,0,15,5260000.0
5260,5260999,20.970934419127374,38.51994184160796,0.07497768809521965,794.6535406112671,347.1051688194275,574.8413200378418,18888,4978,13910,13910,0,15,5261000.0
5261,5261999,20.97040620616436,38.519249045761676,0.07497776578352733,794.8728730678558,347.17210721969604,574.8221588134766,18892,4980,13912,13912,0,15,5262000.0
5262,5262999,20.96977736505047,38.519187009558124,0.07498395023517157,795.0581135749817,347.2387216091156,574.9041061401367,18894,4981,13913,13913,0,15,5263000.0
5263,5263999,20.96944742302249,38.5180332300832,0.07499542642815904,795.2279779911041,347.3053300380707,574.9248161315918,18896,4982,13914,13914,0,15,5264000.0
5264,5264999,20.969054448272242,38.51795808289431,0.07498642871315031,795.3553392887115,347.37166357040405,575.0261840820312,18896,4982,13914,13914,0,15,5265000.0
5265,5265999,20.96832952746441,38.51622466348652,0.07498202874619386,795.6253912448883,347.43892312049866,575.0054359436035,18902,4985,13917,13917,0,15,5266000.0
5266,5266999,20.967342148400057,38.51425021768294,0.07498239696807829,795.7463853359222,347.5050115585327,575.0925598144531,18902,4985,13917,13917,0,15,5267000.0
5267,5267999,20.96645581610109,38.51372404715443,0.07497610886798145,795.8697965145111,347.57121324539185,575.847599029541,18923,4985,13938,13938,0,15,5268000.0
5268,5268999,20.964962534321426,38.511338765823616,0.07498291445709937,796.0750253200531,347.6373987197876,576.0597496032715,18934,4987,13947,13947,0,15,5269000.0
5269,5269999,20.9638899502994,38.510195877547005,0.07498326116385301,796.1889314651489,347.7027096748352,576.3165245056152,18934,4987,13947,13947,0,15,5270000.0
5270,5270999,20.96293873721647,38.50849418535869,0.07498491334434265,796.4016559123993,347.7685465812683,576.402717590332,18939,4989,13950,13950,0,15,5271000.0
5271,5271999,20.962198635955342,38.507079441522116,0.07497990590002346,796.7085335254669,347.8351340293884,576.4333648681641,18948,4993,13955,13955,0,15,5272000.0
5272,5272999,20.961018090430166,38.50466703967002,0.07499034925691805,796.8773028850555,347.9023628234863,576.6955986022949,18950,4994,13956,13956,0,15,5273000.0
5273,5273999,20.95996442893045,38.50324883069588,0.0749912994366142,797.0910611152649,347.9691307544708,576.7433013916016,18954,4996,13958,13958,0,15,5274000.0
5274,5274999,20.95892925411784,38.50135134630618,0.07498991363077923,797.2143239974976,348.03525829315186,576.9230613708496,18955,4996,13959,13959,0,15,5275000.0
5275,5275999,20.957880295500935,38.49917292945173,0.07499729053140203,797.476003408432,348.10197257995605,576.9094390869141,18967,4999,13968,13968,0,15,5276000.0
5276,5276999,20.95718908161118,38.500166462755736,0.07499017546047371,797.5942170619965,348.16839361190796,577.0955390930176,18967,4999,13968,13968,0,15,5277000.0
5277,5277999,20.956158908716684,38.49794786624592,0.07499059935434726,797.7816059589386,348.23513627052307,577.1689758300781,18969,5000,13969,13969,0,15,5278000.0
5278,5278999,20.955555160922803,38.496614347220465,0.0749974959224059,797.9523484706879,348.30214858055115,577.2795143127441,18971,5001,13970,13970,0,15,5279000.0
5279,5279999,20.95496615109485,38.49506888364315,0.07499975751990173,798.0833261013031,348.3691508769989,577.3839149475098,18971,5001,13970,13970,0,15,5280000.0
5280,5280999,20.954885777939765,38.49638192795205,0.07499107200039634,798.2473804950714,348.43603324890137,577.4362449645996,18973,5002,13971,13971,0,15,5281000.0
5281,5281999,20.9548540597376,38.49581059436615,0.07498249324054751,798.437992811203,348.5031976699829,577.4652404785156,18975,5003,13972,13972,0,15,5282000.0
5282,5282999,20.954865781003175,38.495129758880466,0.07497977495842878,798.700642824173,348.57044219970703,577.3966293334961,18999,5006,13993,13993,0,15,5283000.0
5283,5283999,20.954911833908266,38.495789114944095,0.0749707839238698,798.88427567482,348.6371216773987,577.4590110778809,19001,5007,13994,13994,0,15,5284000.0
5284,5284999,20.955006515268018,38.49499445666702,0.07496793016563197,799.0181088447571,348.7037229537964,577.5381774902344,19001,5007,13994,13994,0,15,5285000.0
5285,5285999,20.95496965932268,38.49400148473714,0.07496034206358437,799.2409813404083,348.7712070941925,577.4766731262207,19005,5009,13996,13996,0,15,5286000.0
5286,5286999,20.95486008673481,38.49266188795353,0.07495124974224066,799.3762435913086,348.83813524246216,577.5906219482422,19005,5009,13996,13996,0,15,5287000.0
5287,5287999,20.954594379088494,38.49112333490642,0.07494336084145203,799.5468699932098,348.90518450737,577.6370391845703,19007,5010,13997,13997,0,15,5288000.0
5288,5288999,20.953937954281866,38.489942862646274,0.0749287169786631,799.6654367446899,348.97273230552673,578.5533828735352,19034,5010,14024,14024,0,15,5289000.0
5289,5289999,20.952754274589925,38.487904247628386,0.07493183389023317,799.827966928482,349.0399055480957,578.8608245849609,19037,5011,14026,14026,0,15,5290000.0
5290,5290999,20.951391685317923,38.485487538278036,0.07494357276187569,802.1672370433807,349.106351852417,579.0655670166016,19041,5012,14029,14029,0,15,5291000.0
5291,5291999,20.95037622678706,38.48355986755941,0.07494355664081642,802.3406429290771,349.17258191108704,579.1978759765625,19043,5013,14030,14030,0,15,5292000.0
5292,5292999,20.94933515111613,38.48147293396911,0.0749453759854044,802.5542261600494,349.23881244659424,579.3790283203125,19048,5015,14033,14033,0,15,5293000.0
5293,5293999,20.948090299902514,38.479692760303024,0.07494196094341021,802.8571972846985,349.3060300350189,579.3936309814453,19056,5019,14037,14037,0,15,5294000.0
5294,5294999,20.947335868291262,38.478105490715805,0.07493882170474675,803.1790299415588,349.37363171577454,579.4212532043457,19071,5023,14048,14048,0,15,5295000.0
5295,5295999,20.94648768336508,38.47633108288831,0.0749351790797066,803.3446907997131,349.44083642959595,579.5497665405273,19073,5024,14049,14049,0,15,5296000.0
5296,5296999,20.945672483787853,38.47437424432381,0.07493273738788064,803.5225851535797,349.5081202983856,579.7240524291992,19075,5025,14050,14050,0,15,5297000.0
5297,5297999,20.94507091562113,38.47311167946071,0.07493387984393063,803.8343374729156,349.5758602619171,579.7420272827148,19083,5029,14054,14054,0,15,5298000.0
5298,5298999,20.94461809745459,38.47157055136175,0.07494174239038531,803.955992937088,349.64452171325684,579.9138145446777,19083,5029,14054,14054,0,15,5299000.0
5299,5299999,20.943930967306255,38.4698166178286,0.07494806928652553,804.1027610301971,349.71145272254944,580.049732208252,19083,5029,14054,14054,0,15,5300000.0
5300,5300999,20.943698870466765,38.46918561577066,0.07495186327648307,804.229932308197,349.77867460250854,580.2034034729004,19083,5029,14054,14054,0,15,5301000.0
5301,5301999,20.943317697910068,38.467938041956714,0.07495449708785118,804.3576045036316,349.84567070007324,580.2965507507324,19083,5029,14054,14054,0,15,5302000.0
5302,5302999,20.942737893963688,38.466373054208596,0.07496415408819934,804.500116109848,349.91241216659546,580.4051780700684,19083,5029,14054,14054,0,15,5303000.0
5303,5303999,20.94218606720836,38.464690198295045,0.07497758097911922,804.6699986457825,349.97920179367065,580.4505615234375,19085,5030,14055,14055,0,15,5304000.0
5304,5304999,20.94136872493242,38.462422946326356,0.07499025462027897,804.8921782970428,350.0467038154602,580.5214767456055,19089,5032,14057,14057,0,15,5305000.0
5305,5305999,20.939995372322525,38.46188960442684,0.07499756488038312,805.0219311714172,350.1152424812317,581.7947578430176,19132,5032,14100,14100,0,15,5306000.0
5306,5306999,20.938596490552833,38.46119284751623,0.07500780597011414,805.147567987442,350.1844005584717,582.2818717956543,19134,5032,14102,14102,0,15,5307000.0
5307,5307999,20.93691949897001,38.45854555764069,0.07503159000495263,805.2653815746307,350.2504403591156,582.578426361084,19136,5032,14104,14104,0,15,5308000.0
5308,5308999,20.935496329136953,38.45699076100901,0.07505041479250907,805.4819808006287,350.3164677619934,582.7655410766602,19140,5034,14106,14106,0,15,5309000.0
5309,5309999,20.933890555896994,38.45437324815481,0.07507246665091882,805.7451388835907,350.3828945159912,582.8990936279297,19146,5037,14109,14109,0,15,5310000.0
5310,5310999,20.932324481021862,38.452234308979925,0.07508512755755847,805.9228830337524,350.44945788383484,583.0825271606445,19148,5038,14110,14110,0,15,5311000.0
5311,5311999,20.93087392628798,38.450576018604515,0.07509012464721576,806.0975382328033,350.51637983322144,583.243709564209,19150,5039,14111,14111,0,15,5312000.0
5312,5312999,20.929425086180846,38.44851154789895,0.07509511917079104,806.2687628269196,350.5823743343353,583.3479309082031,19152,5040,14112,14112,0,15,5313000.0
5313,5313999,20.928195979676097,38.44658867806859,0.07509670915561129,806.49569272995,350.64892053604126,583.4375228881836,19162,5042,14120,14120,0,15,5314000.0
5314,5314999,20.927160073522582,38.44511538272936,0.07509297262935533,806.7613234519958,350.71805024147034,583.4860191345215,19179,5045,14134,14134,0,15,5315000.0
5315,5315999,20.92635563543296,38.444638315236844,0.07508780969439943,806.9847438335419,350.7851793766022,583.5364723205566,19183,5047,14136,14136,0,15,5316000.0
5316,5316999,20.9256065940307,38.44400433573991,0.07508413526921287,807.1724100112915,350.85228991508484,583.6109352111816,19185,5048,14137,14137,0,15,5317000.0
5317,5317999,20.924954146015637,38.44295240295493,0.0750718357686766,807.384970664978,350.91929268836975,583.6666107177734,19195,5050,14145,14145,0,15,5318000.0
5318,5318999,20.924056547148712,38.44134035337512,0.07506538069018176,807.5253529548645,350.98568892478943,583.8187370300293,19195,5050,14145,14145,0,15,5319000.0
5319,5319999,20.9233409586436,38.43979983073137,0.07505455892545432,807.7394933700562,351.05404710769653,583.8645782470703,19205,5052,14153,14153,0,15,5320000.0
5320,5320999,20.92301423355348,38.438943482753295,0.07504518252391357,807.9682111740112,351.12091588974,583.9305419921875,19214,5054,14160,14160,0,15,5321000.0
5321,5321999,20.922484390961383,38.437830664144016,0.07503903419097735,808.1962141990662,351.1884527206421,583.9417762756348,19218,5056,14162,14162,0,15,5322000.0
5322,5322999,20.921704033035173,38.435972281161106,0.07503343579192023,808.3205223083496,351.2549340724945,584.0570068359375,19218,5056,14162,14162,0,15,5323000.0
5323,5323999,20.920999743235313,38.434400636749636,0.075028906192533,808.5190975666046,351.3222851753235,584.0965309143066,19220,5057,14163,14163,0,15,5324000.0
5324,5324999,20.920100307614526,38.43276114927371,0.07502657857435169,808.7071471214294,351.38932275772095,584.4617919921875,19235,5058,14177,14177,0,15,5325000.0
5325,5325999,20.918931413816395,38.43201398158924,0.07502116524393898,808.8266494274139,351.45528531074524,585.260871887207,19253,5058,14195,14195,0,15,5326000.0
5326,5326999,20.91776523415349,38.43032716146076,0.07502255134878588,808.9461314678192,351.5214169025421,585.6643104553223,19255,5058,14197,14197,0,15,5327000.0
5327,5327999,20.916541850497516,38.428388061175305,0.07502753636744519,809.1155397891998,351.58731627464294,585.8308258056641,19257,5059,14198,14198,0,15,5328000.0
5328,5328999,20.915363841373683,38.42653081136344,0.07503428313623917,809.340564250946,351.65306854248047,585.9691162109375,19263,5061,14202,14202,0,15,5329000.0
5329,5329999,20.914199119350723,38.424692578850035,0.07503768614839734,809.516104221344,351.7192211151123,586.1514434814453,19265,5062,14203,14203,0,15,5330000.0
5330,5330999,20.9129165059056,38.42222882133511,0.07504679013409665,809.6825766563416,351.7850544452667,586.2859306335449,19272,5063,14209,14209,0,15,5331000.0
5331,5331999,20.911612295793365,38.420425396217716,0.0750493629053568,809.9947099685669,351.8520255088806,586.1960754394531,19280,5067,14213,14213,0,15,5332000.0
5332,5332999,20.910273228953294,38.41808592310983,0.07505556916214073,810.2506926059723,351.92027616500854,586.3066520690918,19287,5070,14217,14217,0,15,5333000.0
5333,5333999,20.909231416399983,38.415841647818986,0.07505835107490533,810.5289189815521,351.9875226020813,586.4193725585938,19293,5073,14220,14220,0,15,5334000.0
5334,5334999,20.908283899281358,38.41402845667481,0.07506238666969578,810.6559867858887,352.05383944511414,586.5938682556152,19293,5073,14220,14220,0,15,5335000.0
5335,5335999,20.907098801931294,38.41202171526555,0.07506764791829501,810.7844502925873,352.1201968193054,586.7538757324219,19293,5073,14220,14220,0,15,5336000.0
5336,5336999,20.906273341600752,38.410129190828926,0.0750691118463841,810.9622061252594,352.1869306564331,586.8342781066895,19295,5074,14221,14221,0,15,5337000.0
5337,5337999,20.905200844586403,38.407941445663326,0.07507226718525117,811.0956916809082,352.2531750202179,586.9412384033203,19295,5074,14221,14221,0,15,5338000.0
5338,5338999,20.904440939795197,38.406673465590885,0.07507276076330516,811.2436788082123,352.3197591304779,587.0519142150879,19295,5074,14221,14221,0,15,5339000.0
5339,5339999,20.903661987673207,38.40496062688351,0.07507057467005529,811.4207973480225,352.3859324455261,587.098503112793,19297,5075,14222,14222,0,15,5340000.0
5340,5340999,20.90311969258297,38.40363113295538,0.07506994485997909,811.5942361354828,352.45250844955444,587.1522178649902,19299,5076,14223,14223,0,15,5341000.0
5341,5341999,20.902437187034725,38.40206727217914,0.07507112498804425,811.7358419895172,352.5197994709015,587.2776679992676,19299,5076,14223,14223,0,15,5342000.0
5342,5342999,20.902262182140287,38.40262560814437,0.07506154821542488,811.8825325965881,352.5868327617645,587.3425407409668,19299,5076,14223,14223,0,15,5343000.0
5343,5343999,20.901609444843277,38.4008536370911,0.07506272377244527,812.0569605827332,352.65313959121704,587.3856239318848,19307,5077,14230,14230,0,15,5344000.0
5344,5344999,20.900370964149353,38.39835134449572,0.07507290136207567,812.2529830932617,352.71995663642883,587.4296569824219,19309,5078,14231,14231,0,15,5345000.0
5345,5345999,20.899350835102133,38.3961027178817,0.0750795148568425,812.3936719894409,352.7868766784668,588.0822334289551,19334,5078,14256,14256,0,15,5346000.0
5346,5346999,20.897611139009694,38.39397684562797,0.07509161903133921,812.5163466930389,352.8540139198303,588.7443046569824,19344,5078,14266,14266,0,15,5347000.0
5347,5347999,20.895705920759276,38.390947924202905,0.07510393950955785,812.6326951980591,352.91989755630493,589.1245803833008,19346,5078,14268,14268,0,15,5348000.0
5348,5348999,20.893939359542873,38.38821489296901,0.07511608620912069,812.851060628891,352.98814630508423,589.3149490356445,19351,5080,14271,14271,0,15,5349000.0
5349,5349999,20.89243844009584,38.38624360279689,0.07512172050240773,813.0141665935516,353.0542838573456,589.4760246276855,19354,5081,14273,14273,0,15,5350000.0
5350,5350999,20.890933565762175,38.38420212962822,0.07512826910449943,813.3586006164551,353.1220335960388,589.5752754211426,19364,5086,14278,14278,0,15,5351000.0
5351,5351999,20.88965525971078,38.38192218536193,0.07513722663712785,813.480678319931,353.19155716896057,589.8423004150391,19364,5086,14278,14278,0,15,5352000.0
5352,5352999,20.888357293769598,38.38015706366528,0.07514043976269857,813.7002053260803,353.25952792167664,589.9807090759277,19368,5088,14280,14280,0,15,5353000.0
5353,5353999,20.888785324798057,38.383290147830735,0.07510610630572068,813.880086183548,353.32657504081726,590.0861854553223,19370,5089,14281,14281,0,15,5354000.0
5354,5354999,20.889113857172468,38.38429774701277,0.07508695727129033,814.0533742904663,353.3932704925537,590.1908912658691,19372,5090,14282,14282,0,15,5355000.0
5355,5355999,20.88959050167081,38.38555862431615,0.0750714254796716,814.3074791431427,353.4628620147705,590.2384567260742,19378,5093,14285,14285,0,15,5356000.0
5356,5356999,20.89067581667044,38.387659487618215,0.0750517918015341,814.5320782661438,353.53051948547363,590.324634552002,19382,5095,14287,14287,0,15,5357000.0
5357,5357999,20.89194329035489,38.39011549716944,0.07502920893485665,814.7198781967163,353.59840750694275,590.4762306213379,19384,5096,14288,14288,0,15,5358000.0
5358,5358999,20.89377639695494,38.3934910769436,0.07500113700247835,814.8894090652466,353.66569685935974,590.5887145996094,19386,5097,14289,14289,0,15,5359000.0
5359,5359999,20.895635932799152,38.396779948488884,0.07498521249467205,815.1663382053375,353.7334153652191,590.5235710144043,19392,5100,14292,14292,0,15,5360000.0
5360,5360999,20.897232162116946,38.39895113435022,0.07499122239985534,815.3439774513245,353.8016445636749,590.7138862609863,19394,5101,14293,14293,0,15,5361000.0
5361,5361999,20.898773084849434,38.4012396385176,0.07498754337378688,815.516695022583,353.86895418167114,590.8407402038574,19396,5102,14294,14294,0,15,5362000.0
5362,5362999,20.900740756884616,38.4037478265092,0.07497913940419687,815.7888498306274,353.9369351863861,590.7951774597168,19402,5105,14297,14297,0,15,5363000.0
5363,5363999,20.901716637538403,38.404635506268264,0.07498744435253524,815.9332990646362,354.004518032074,590.9367485046387,19402,5105,14297,14297,0,15,5364000.0
5364,5364999,20.902217906270305,38.40404937725777,0.07499190975950476,816.0641837120056,354.07172775268555,591.0875244140625,19402,5105,14297,14297,0,15,5365000.0
5365,5365999,20.90173171825592,38.402469233474,0.07498824116366487,816.1905159950256,354.14047861099243,591.9812126159668,19430,5105,14325,14325,0,15,5366000.0
5366,5366999,20.900137325885893,38.400359471455445,0.07499558305124554,816.3539252281189,354.2067303657532,592.3691902160645,19439,5106,14333,14333,0,15,5367000.0
5367,5367999,20.898612813598863,38.39799766111093,0.07500336446549061,816.5139584541321,354.2730188369751,592.719409942627,19444,5107,14337,14337,0,15,5368000.0
5368,5368999,20.89727280793724,38.395960472516805,0.07501217985767916,816.7308230400085,354.3391077518463,592.8846778869629,19449,5109,14340,14340,0,15,5369000.0
5369,5369999,20.89607316243178,38.39429513086063,0.07500992892646718,816.9895737171173,354.40607357025146,593.0070304870605,19455,5112,14343,14343,0,15,5370000.0
5370,5370999,20.894846168887284,38.3921074882556,0.07501110407710387,817.1515231132507,354.47306513786316,593.2199630737305,19457,5113,14344,14344,0,15,5371000.0
5371,5371999,20.893481985726613,38.38978729881294,0.07502021613134047,817.3655252456665,354.5400130748749,593.3011512756348,19461,5115,14346,14346,0,15,5372000.0
5372,5372999,20.892226540882007,38.387578247216645,0.07502456742325903,817.5910639762878,354.6070535182953,593.4040145874023,19465,5117,14348,14348,0,15,5373000.0
5373,5373999,20.890856680266257,38.385082841672805,0.0750326447308759,817.8112468719482,354.674120426178,593.4749412536621,19469,5119,14350,14350,0,15,5374000.0
5374,5374999,20.88980382466976,38.383600028867235,0.07503355785912491,818.0240278244019,354.74078392982483,593.5488357543945,19473,5121,14352,14352,0,15,5375000.0
5375,5375999,20.88858654341893,38.38134940831791,0.07503503995684446,818.2481009960175,354.8096125125885,593.6579742431641,19477,5123,14354,14354,0,15,5376000.0
5376,5376999,20.887510473688767,38.37937962815587,0.07503762513494161,818.4236822128296,354.8765757083893,593.8075790405273,19480,5124,14356,14356,0,15,5377000.0
5377,5377999,20.8867023012734,38.37790323940914,0.07503419659053234,818.595458984375,354.9436583518982,593.9329643249512,19482,5125,14357,14357,0,15,5378000.0
5378,5378999,20.88566780111518,38.375896601205255,0.07503200120945641,818.7677369117737,355.01031970977783,594.0365524291992,19484,5126,14358,14358,0,15,5379000.0
5379,5379999,20.884908949931482,38.37396636462936,0.07502556735084176,818.9082491397858,355.0767617225647,594.1877784729004,19484,5126,14358,14358,0,15,5380000.0
5380,5380999,20.884301696134393,38.372716494597945,0.07501970974043237,819.0341639518738,355.14403319358826,594.2764587402344,19484,5126,14358,14358,0,15,5381000.0
5381,5381999,20.883742660100644,38.371474882029396,0.07501610274944193,819.2271690368652,355.2115886211395,594.348819732666,19486,5127,14359,14359,0,15,5382000.0
5382,5382999,20.883426111415194,38.37030421634479,0.07500895229829385,819.3510956764221,355.27792501449585,594.4473991394043,19486,5127,14359,14359,0,15,5383000.0
5383,5383999,20.883101339073058,38.36894502174416,0.07500414052753601,819.4869258403778,355.34492444992065,594.5250396728516,19486,5127,14359,14359,0,15,5384000.0
5384,5384999,20.88284170199132,38.367849745280424,0.0750000976307782,819.6629087924957,355.412043094635,594.558837890625,19488,5128,14360,14360,0,15,5385000.0
5385,5385999,20.88226556101571,38.366130357544236,0.0749986887766031,819.7944095134735,355.4799094200134,595.2251014709473,19513,5128,14385,14385,0,15,5386000.0
5386,5386999,20.88090158784939,38.364577533075426,0.07500293999417906,819.9052827358246,355.54573941230774,595.840747833252,19521,5128,14393,14393,0,15,5387000.0
5387,5387999,20.87939032161788,38.362816914196095,0.07500532793735348,820.0137071609497,355.6108207702637,596.1979942321777,19521,5128,14393,14393,0,15,5388000.0
5388,5388999,20.878349522255665,38.365851855262044,0.07498732952688636,820.1721785068512,355.67588663101196,596.3658180236816,19524,5129,14395,14395,0,15,5389000.0
5389,5389999,20.876981542692963,38.36357990081868,0.07498862457972155,820.4266114234924,355.7415771484375,596.45068359375,19531,5132,14399,14399,0,15,5390000.0
5390,5390999,20.87586996287579,38.361468307290735,0.07498637167896727,820.6776168346405,355.80776476860046,596.637451171875,19537,5135,14402,14402,0,15,5391000.0
5391,5391999,20.87472020399368,38.35928200558037,0.07498440403625184,820.8920240402222,355.8746268749237,596.8473472595215,19541,5137,14404,14404,0,15,5392000.0
5392,5392999,20.873740019541206,38.35759277891359,0.07497866611884829,821.0240433216095,355.9417679309845,597.0138092041016,19541,5137,14404,14404,0,15,5393000.0
5393,5393999,20.872760388630052,38.35567655477429,0.07497251052195963,821.25195479393,356.0085744857788,597.071834564209,19545,5139,14406,14406,0,15,5394000.0
5394,5394999,20.871792408942238,38.3536656590751,0.07496829998263899,821.4182410240173,356.0746817588806,597.1801223754883,19547,5140,14407,14407,0,15,5395000.0
5395,5395999,20.871296088034896,38.352472044146786,0.07495866947683716,821.5376522541046,356.1406545639038,597.2964210510254,19547,5140,14407,14407,0,15,5396000.0
5396,5396999,20.87075567944477,38.35176453180383,0.07494573599992749,821.7073674201965,356.2070119380951,597.3699111938477,19549,5141,14408,14408,0,15,5397000.0
5397,5397999,20.870354371055168,38.350756516644715,0.07493562248584174,821.9717118740082,356.27424597740173,597.3325614929199,19562,5144,14418,14418,0,15,5398000.0
5398,5398999,20.87016489789651,38.34967868761461,0.07492942585944784,822.2459409236908,356.34242939949036,597.2799263000488,19568,5147,14421,14421,0,15,5399000.0
5399,5399999,20.870450180829398,38.35024535874146,0.0749165654567685,822.3786051273346,356.4088399410248,597.4564933776855,19568,5147,14421,14421,0,15,5400000.0
5400,5400999,20.871288813731635,38.354361751830744,0.07489234886446972,822.5485558509827,356.47538661956787,597.5421524047852,19570,5148,14422,14422,0,15,5401000.0
5401,5401999,20.873696792149715,38.36588005396117,0.0748427853016479,822.7588033676147,356.542053937912,597.5937347412109,19574,5150,14424,14424,0,15,5402000.0
5402,5402999,20.875579708210665,38.370074663411145,0.0748231042212979,822.897242307663,356.60817098617554,597.7465171813965,19574,5150,14424,14424,0,15,5403000.0
5403,5403999,20.877871201905435,38.37499665807855,0.07481208262982808,823.0779604911804,356.6750919818878,597.7664260864258,19576,5151,14425,14425,0,15,5404000.0
5404,5404999,20.879703464750296,38.37768771944327,0.07480292001635991,823.2133858203888,356.74122071266174,597.8956527709961,19576,5151,14425,14425,0,15,5405000.0
5405,5405999,20.88130635442241,38.380022622260704,0.0748020244424682,823.4358410835266,356.8078279495239,597.9186515808105,19580,5153,14427,14427,0,15,5406000.0
5406,5406999,20.881576693538197,38.380879781998786,0.07479342502970654,823.6047773361206,356.8749096393585,598.7476196289062,19610,5154,14456,14456,0,15,5407000.0
5407,5407999,20.880043080011248,38.3846674542868,0.07478192704504283,823.7332606315613,356.9417214393616,599.228271484375,19615,5154,14461,14461,0,15,5408000.0
5408,5408999,20.878551726722495,38.38322167725919,0.0747835849937778,823.8458259105682,357.00753593444824,599.5185890197754,19616,5154,14462,14462,0,15,5409000.0
5409,5409999,20.877062393100545,38.38083461006278,0.07479067391283745,823.9712061882019,357.07279086112976,599.6994552612305,19616,5154,14462,14462,0,15,5410000.0
5410,5410999,20.875698581601892,38.37878350488035,0.07479193480276802,824.1870810985565,357.1391005516052,599.801139831543,19621,5156,14465,14465,0,15,5411000.0
5411,5411999,20.87431589305059,38.37655139615294,0.07479547643057483,824.4001684188843,357.20494270324707,599.9457931518555,19625,5158,14467,14467,0,15,5412000.0
5412,5412999,20.872793247842136,38.37388799524063,0.07480086897782001,824.6101980209351,357.27143263816833,600.0495948791504,19635,5160,14475,14475,0,15,5413000.0
5413,5413999,20.871562303021705,38.37230970044305,0.07479973673046936,824.8850951194763,357.3384780883789,600.1367073059082,19642,5163,14479,14479,0,15,5414000.0
5414,5414999,20.8704432811897,38.37062162852705,0.07479632728528074,825.0957381725311,357.40471935272217,600.2080421447754,19646,5165,14481,14481,0,15,5415000.0
5415,5415999,20.86926846035461,38.368412241477216,0.07479426959533808,825.2581367492676,357.4707109928131,600.310863494873,19648,5166,14482,14482,0,15,5416000.0
5416,5416999,20.868311924640064,38.36676000884686,0.07478919284148433,825.4741032123566,357.5373342037201,600.3701972961426,19652,5168,14484,14484,0,15,5417000.0
5417,5417999,20.867376426147455,38.36467156902432,0.07478535327020541,825.6054608821869,357.60393142700195,600.551025390625,19652,5168,14484,14484,0,15,5418000.0
5418,5418999,20.866493992871476,38.36285343191006,0.07478219179111012,825.7263550758362,357.66991329193115,600.6810646057129,19652,5168,14484,14484,0,15,5419000.0
5419,5419999,20.86582631060351,38.36195374006645,0.07477508586474757,825.9582509994507,357.7366576194763,600.6410942077637,19661,5170,14491,14491,0,15,5420000.0
5420,5420999,20.865309908474227,38.360504463919476,0.07476963515331803,826.0868239402771,357.80304646492004,600.8221206665039,19661,5170,14491,14491,0,15,5421000.0
5421,5421999,20.86512511450663,38.360486324107086,0.07475635772715539,826.304187297821,357.87108302116394,600.8521385192871,19671,5172,14499,14499,0,15,5422000.0
5422,5422999,20.864944430379747,38.3598563287384,0.07474636216260211,826.4862802028656,357.9375183582306,600.9059028625488,19673,5173,14500,14500,0,15,5423000.0
5423,5423999,20.864996061057845,38.359619261868225,0.07473330546423962,826.6202902793884,358.0033950805664,601.044490814209,19673,5173,14500,14500,0,15,5424000.0
5424,5424999,20.865004995826624,38.358883648436766,0.07472400905983878,826.7700343132019,358.0696818828583,601.120361328125,19673,5173,14500,14500,0,15,5425000.0
5425,5425999,20.865461535732578,38.35892862348006,0.07470956703031462,826.8974752426147,358.13575625419617,601.1726531982422,19673,5173,14500,14500,0,15,5426000.0
5426,5426999,20.865131087929743,38.35762802180753,0.07469984849897127,827.0165708065033,358.2019467353821,601.2665596008301,19673,5173,14500,14500,0,15,5427000.0
5427,5427999,20.864328724727688,38.355779205401205,0.07470050226040836,827.1460447311401,358.2684164047241,602.1077995300293,19703,5173,14530,14530,0,15,5428000.0
5428,5428999,20.86291262770803,38.35427338481769,0.07470717548193329,827.2591507434845,358.33430576324463,602.7499885559082,19710,5173,14537,14537,0,15,5429000.0
5429,5429999,20.861594774908916,38.35231110951459,0.07471664192428484,827.4173049926758,358.39993357658386,603.0540199279785,19720,5174,14546,14546,0,15,5430000.0
5430,5430999,20.860293911086867,38.35026321131083,0.07472515742233321,827.7483298778534,358.4662320613861,603.1688270568848,19742,5179,14563,14563,0,15,5431000.0
5431,5431999,20.858931778010344,38.34791185937481,0.07473218140732374,827.9525673389435,358.5324685573578,603.3607139587402,19757,5181,14576,14576,0,15,5432000.0
5432,5432999,20.85765883640122,38.345340993705285,0.07473955658661402,828.2177848815918,358.5995886325836,603.5242919921875,19763,5184,14579,14579,0,15,5433000.0
5433,5433999,20.85643438888977,38.34381831244964,0.07474352368135917,828.3368039131165,358.66673398017883,603.7627792358398,19763,5184,14579,14579,0,15,5434000.0
5434,5434999,20.855210486967344,38.341527372413765,0.07475025798032542,828.4662396907806,358.73255920410156,603.9198760986328,19763,5184,14579,14579,0,15,5435000.0
5435,5435999,20.854196812263822,38.343160669869754,0.07475482671184941,828.7683482170105,358.799432516098,603.9156494140625,19776,5188,14588,14588,0,15,5436000.0
5436,5436999,20.852950334485644,38.34081968773324,0.07476905765827246,829.0316550731659,358.8666911125183,603.9796180725098,19783,5191,14592,14592,0,15,5437000.0
5437,5437999,20.851865199914645,38.33870729968564,0.0747791875995657,829.2057852745056,358.93320512771606,604.1431121826172,19785,5192,14593,14593,0,15,5438000.0
5438,5438999,20.850631152719295,38.33625051743833,0.07478974596268162,829.3824369907379,358.9997479915619,604.2661972045898,19787,5193,14594,14594,0,15,5439000.0
5439,5439999,20.849576485789132,38.33404924014348,0.07479985433624059,829.5109434127808,359.0659544467926,604.4336738586426,19787,5193,14594,14594,0,15,5440000.0
5440,5440999,20.848464437201436,38.33178700502392,0.07481157671059735,829.6820170879364,359.1322510242462,604.4902687072754,19789,5194,14595,14595,0,15,5441000.0
5441,5441999,20.847351966886897,38.32935759313812,0.07482456383176816,829.9086720943451,359.1991550922394,604.5885353088379,19793,5196,14597,14597,0,15,5442000.0
5442,5442999,20.84617164556411,38.3268643415338,0.07483686725107241,830.0817313194275,359.2657427787781,604.7229194641113,19799,5197,14602,14602,0,15,5443000.0
5443,5443999,20.844885426246627,38.32436532500014,0.07485216096910252,830.2633669376373,359.33184933662415,604.8130683898926,19801,5198,14603,14603,0,15,5444000.0
5444,5444999,20.843830286008018,38.32269003225126,0.07485552870721224,830.3872923851013,359.3982746601105,605.5800323486328,19824,5198,14626,14626,0,15,5445000.0
5445,5445999,20.842408722597035,38.32026884740251,0.0748653076032586,830.4973969459534,359.4633505344391,606.0833015441895,19828,5198,14630,14630,0,15,5446000.0
5446,5446999,20.84099119180682,38.31839463045977,0.07488035488930067,830.6141884326935,359.53056621551514,606.3190536499023,19828,5198,14630,14630,0,15,5447000.0
5447,5447999,20.839872090373415,38.32227718961142,0.0748718084988389,830.8213770389557,359.59620690345764,606.4411354064941,19832,5200,14632,14632,0,15,5448000.0
5448,5448999,20.838809626830013,38.3217474559736,0.07487437383901441,830.9926500320435,359.66171526908875,606.6652641296387,19835,5201,14634,14634,0,15,5449000.0
5449,5449999,20.83735528079808,38.31906180663907,0.074886030466491,831.166827917099,359.72755908966064,606.790943145752,19837,5202,14635,14635,0,15,5450000.0
5450,5450999,20.835999860639514,38.31683038610539,0.07489075406648571,831.4820954799652,359.7957661151886,606.7950553894043,19851,5206,14645,14645,0,15,5451000.0
5451,5451999,20.834769695338718,38.31514283696945,0.07489105272552365,831.5968697071075,359.8617174625397,606.9450645446777,19851,5206,14645,14645,0,15,5452000.0
5452,5452999,20.833497355918517,38.31283293707163,0.07489415685840695,831.865485906601,359.9283528327942,606.8936195373535,19857,5209,14648,14648,0,15,5453000.0
5453,5453999,20.832305732955813,38.31091250234716,0.07489261089863697,832.0293099880219,359.9945023059845,607.0376930236816,19859,5210,14649,14649,0,15,5454000.0
5454,5454999,20.831455447785398,38.30937486130087,0.07489103029624955,832.2476818561554,360.0608992576599,607.10302734375,19863,5212,14651,14651,0,15,5455000.0
5455,5455999,20.830982099505025,38.30786972051196,0.07488368202867812,832.3732943534851,360.1277711391449,607.2616004943848,19864,5212,14652,14652,0,15,5456000.0
5456,5456999,20.83047021943048,38.30645804629598,0.07487149276357286,832.597350358963,360.1942684650421,607.2616653442383,19868,5214,14654,14654,0,15,5457000.0
5457,5457999,20.829959843944938,38.30506932751857,0.0748656133980381,832.7807006835938,360.26069617271423,607.3802909851074,19870,5215,14655,14655,0,15,5458000.0
5458,5458999,20.82989363837287,38.30575208119975,0.07486045796846408,832.9569787979126,360.32729840278625,607.4330596923828,19872,5216,14656,14656,0,15,5459000.0
5459,5459999,20.829594323007687,38.306184678027215,0.07485348255054713,833.0866494178772,360.3940055370331,607.5222854614258,19872,5216,14656,14656,0,15,5460000.0
5460,5460999,20.829573181048733,38.30587118016349,0.0748447646489595,833.2139039039612,360.4602448940277,607.6371612548828,19872,5216,14656,14656,0,15,5461000.0
5461,5461999,20.829547850103612,38.30518556255255,0.07484031564185223,833.3579154014587,360.5265016555786,607.714469909668,19872,5216,14656,14656,0,15,5462000.0
5462,5462999,20.82928647365636,38.30410246398857,0.0748269972823522,833.5753772258759,360.59259700775146,607.5558815002441,19879,5218,14661,14661,0,15,5463000.0
5463,5463999,20.828678837248937,38.30272891967733,0.07482714568977822,833.8148341178894,360.6597695350647,607.6380310058594,19895,5220,14675,14675,0,15,5464000.0
5464,5464999,20.82787821282611,38.30396880969292,0.07482017765965754,833.9309504032135,360.7256510257721,608.4444808959961,19918,5220,14698,14698,0,15,5465000.0
5465,5465999,20.82620554051473,38.30173432075198,0.07482683050139505,834.040155172348,360.7896602153778,608.8553466796875,19923,5220,14703,14703,0,15,5466000.0
5466,5466999,20.824687838600283,38.299601668109375,0.07483125400644175,834.1970202922821,360.8536043167114,609.1153564453125,19927,5221,14706,14706,0,15,5467000.0
5467,5467999,20.82342573226252,38.298228210748114,0.07483349379594928,834.4573500156403,360.91885137557983,609.2205657958984,19934,5224,14710,14710,0,15,5468000.0
5468,5468999,20.8219599873547,38.29568888693691,0.07483932034245044,834.6585164070129,360.98356103897095,609.4269180297852,19941,5226,14715,14715,0,15,5469000.0
5469,5469999,20.820716889482682,38.29360822533171,0.07484147956575327,834.9172480106354,361.04836916923523,609.5292587280273,19951,5229,14722,14722,0,15,5470000.0
5470,5470999,20.819460102681713,38.29163359480117,0.07484435342617246,835.134081363678,361.11356496810913,609.638256072998,19955,5231,14724,14724,0,15,5471000.0
5471,5471999,20.81817364059935,38.289357459512836,0.07484964849402953,835.3030254840851,361.1783125400543,609.8331413269043,19959,5232,14727,14727,0,15,5472000.0
5472,5472999,20.81705086712695,38.28731597193694,0.0748498249869568,835.432868719101,361.2434024810791,610.0017013549805,19960,5232,14728,14728,0,15,5473000.0
5473,5473999,20.81612562374148,38.28563188512003,0.07484841252110819,835.5591948032379,361.30783462524414,610.1417694091797,19962,5232,14730,14730,0,15,5474000.0
5474,5474999,20.814898985422555,38.28331989491509,0.07485000781096474,835.7838850021362,361.37378573417664,610.1326522827148,19967,5234,14733,14733,0,15,5475000.0
5475,5475999,20.814221367671216,38.281534105794826,0.07484746583486368,835.9047856330872,361.4387321472168,610.3112258911133,19968,5234,14734,14734,0,15,5476000.0
5476,5476999,20.813201093817867,38.27949500026745,0.07485157869696812,836.0277445316315,361.50348234176636,610.4440269470215,19968,5234,14734,14734,0,15,5477000.0
5477,5477999,20.812319968412098,38.278523088674916,0.07484947537374353,836.2080023288727,361.56858348846436,610.4766998291016,19971,5235,14736,14736,0,15,5478000.0
5478,5478999,20.81146407184099,38.276543920858806,0.07485245851187039,836.3526377677917,361.6340477466583,610.6059799194336,19971,5235,14736,14736,0,15,5479000.0
5479,5479999,20.810469734417865,38.27472885787479,0.07485536909387058,836.5255739688873,361.69955039024353,610.6401901245117,19974,5236,14738,14738,0,15,5480000.0
5480,5480999,20.80954726269028,38.272812904228985,0.07485958941851611,836.7480173110962,361.7657239437103,610.619312286377,19979,5238,14741,14741,0,15,5481000.0
5481,5481999,20.808534373400324,38.270638984138095,0.07486679492284976,836.8884649276733,361.8308618068695,610.7539291381836,19979,5238,14741,14741,0,15,5482000.0
5482,5482999,20.807712177617468,38.26884151367607,0.07486813289366068,837.0038959980011,361.8956952095032,610.8535385131836,19979,5238,14741,14741,0,15,5483000.0
5483,5483999,20.806471652713846,38.266455113796106,0.07487628453974626,837.1418557167053,361.9606673717499,610.9126853942871,19979,5238,14741,14741,0,15,5484000.0
5484,5484999,20.80511718344945,38.26386986140376,0.07488384040236418,837.3181352615356,362.0261867046356,610.9582061767578,19981,5239,14742,14742,0,15,5485000.0
5485,5485999,20.80428803872536,38.262103303681826,0.07488906407942686,837.4903919696808,362.09200072288513,611.7799987792969,20006,5240,14766,14766,0,15,5486000.0
5486,5486999,20.80269542307454,38.25941726811569,0.07490006175458841,837.5950074195862,362.15552520751953,612.178653717041,20007,5240,14767,14767,0,15,5487000.0
5487,5487999,20.80158737012294,38.25988271705849,0.0748931870611137,837.8429470062256,362.2201769351959,612.2594947814941,20014,5243,14771,14771,0,15,5488000.0
5488,5488999,20.80029885142665,38.257611913227066,0.07489928839554572,838.0081045627594,362.2851858139038,612.5192222595215,20017,5244,14773,14773,0,15,5489000.0
5489,5489999,20.79930610820991,38.25593948679539,0.07489987056247316,838.1700026988983,362.3498842716217,612.7128677368164,20019,5245,14774,14774,0,15,5490000.0
5490,5490999,20.79867903095666,38.25493414152733,0.07489977698067829,838.4249744415283,362.4160587787628,612.8476371765137,20025,5248,14777,14777,0,15,5491000.0
5491,5491999,20.797560963907266,38.252732093132465,0.07490561598856249,838.7339534759521,362.48155093193054,612.8329544067383,20033,5252,14781,14781,0,15,5492000.0
5492,5492999,20.79669745797637,38.25122739159692,0.07490968430463663,838.8477387428284,362.5461208820343,613.0854911804199,20033,5252,14781,14781,0,15,5493000.0
5493,5493999,20.79588985181775,38.2494087816102,0.07491245374833677,839.0698924064636,362.61113953590393,613.1757850646973,20037,5254,14783,14783,0,15,5494000.0
5494,5494999,20.795305825624027,38.24775869186653,0.07491364053971261,839.1909892559052,362.67576932907104,613.3602333068848,20037,5254,14783,14783,0,15,5495000.0
5495,5495999,20.794776987162514,38.246444142875546,0.07491082505607827,839.3507659435272,362.7406828403473,613.4537506103516,20039,5255,14784,14784,0,15,5496000.0
5496,5496999,20.794404587918873,38.24533974429565,0.07491674391587855,839.4877915382385,362.80554270744324,613.5709037780762,20039,5255,14784,14784,0,15,5497000.0
5497,5497999,20.79383221718171,38.24402301562142,0.07491769718556596,839.663577079773,362.870596408844,613.6294136047363,20041,5256,14785,14785,0,15,5498000.0
5498,5498999,20.793268048942956,38.24268436478371,0.07491789695593476,839.8378381729126,362.9358127117157,613.7113342285156,20043,5257,14786,14786,0,15,5499000.0
5499,5499999,20.793048426645644,38.24452857320863,0.0749071725550553,839.9700782299042,363.0007834434509,613.8020820617676,20043,5257,14786,14786,0,15,5500000.0
5500,5500999,20.79275174755456,38.250588591437236,0.07489039610040926,840.138580083847,363.06564593315125,613.8320236206055,20045,5258,14787,14787,0,15,5501000.0
5501,5501999,20.792132493252062,38.24924495333758,0.07489035389259768,840.3037719726562,363.1315653324127,613.9003562927246,20047,5259,14788,14788,0,15,5502000.0
5502,5502999,20.7916037652847,38.24757271073166,0.07489550033323411,840.4885730743408,363.19686245918274,613.8903312683105,20049,5260,14789,14789,0,15,5503000.0
5503,5503999,20.790865373800315,38.24569729172232,0.07489321662769455,840.6784398555756,363.2622754573822,613.8643531799316,20051,5261,14790,14790,0,15,5504000.0
5504,5504999,20.789813889320815,38.24332886988594,0.07490335349880062,840.8892028331757,363.32769870758057,613.926139831543,20054,5263,14791,14791,0,15,5505000.0
5505,5505999,20.788758745605776,38.24118206257839,0.0749100078704219,841.0142114162445,363.3932161331177,614.6555328369141,20076,5263,14813,14813,0,15,5506000.0
5506,5506999,20.78695448143255,38.23900183238729,0.07491947330881021,841.1251966953278,363.4573218822479,615.085090637207,20076,5263,14813,14813,0,15,5507000.0
5507,5507999,20.78535349719068,38.2371427987858,0.07492570790269126,841.2801787853241,363.5222809314728,615.3523025512695,20084,5264,14820,14820,0,15,5508000.0
5508,5508999,20.783898690688876,38.2349855283089,0.07493607294213389,841.6689381599426,363.5881175994873,615.3288154602051,20097,5270,14827,14827,0,15,5509000.0
5509,5509999,20.782487059221776,38.23276580000436,0.07494467928563942,841.8798336982727,363.6536762714386,615.5672721862793,20102,5272,14830,14830,0,15,5510000.0
5510,5510999,20.780985696387592,38.23010537750199,0.07495267798429184,842.0868031978607,363.7199499607086,615.7799873352051,20106,5274,14832,14832,0,15,5511000.0
5511,5511999,20.779419335585448,38.227438827500784,0.07496293217800298,842.2656996250153,363.785138130188,615.9371795654297,20108,5275,14833,14833,0,15,5512000.0
5512,5512999,20.77794092423896,38.22524367570052,0.07497024122521445,842.4321210384369,363.8500792980194,616.0715446472168,20110,5276,14834,14834,0,15,5513000.0
5513,5513999,20.7764709020819,38.222677772172034,0.07497635385427792,842.5589754581451,363.9151668548584,616.2061386108398,20110,5276,14834,14834,0,15,5514000.0
5514,5514999,20.77510776087557,38.22008077246066,0.07498429489235614,842.678284406662,363.9811227321625,616.318904876709,20110,5276,14834,14834,0,15,5515000.0
5515,5515999,20.774488782810185,38.23425953548915,0.07492542274524139,842.8508985042572,364.04648089408875,616.3585510253906,20112,5277,14835,14835,0,15,5516000.0
5516,5516999,20.773383710161205,38.23198195423909,0.07492753746755454,842.9805972576141,364.1118001937866,616.4685592651367,20112,5277,14835,14835,0,15,5517000.0
5517,5517999,20.77235921612926,38.229899650951545,0.07492952526198726,843.2405874729156,364.1779553890228,616.4102783203125,20118,5280,14838,14838,0,15,5518000.0
5518,5518999,20.771214769435353,38.227729463339294,0.07492987639093951,843.3841807842255,364.2437982559204,616.526538848877,20118,5280,14838,14838,0,15,5519000.0
5519,5519999,20.77037463756921,38.227346817132805,0.07492455601660253,843.5687966346741,364.30920815467834,616.5765838623047,20127,5281,14846,14846,0,15,5520000.0
5520,5520999,20.769663339126897,38.22608865663462,0.07492091716448768,843.7492246627808,364.3752028942108,616.610107421875,20129,5282,14847,14847,0,15,5521000.0
5521,5521999,20.768958667303767,38.224980984944914,0.0749202952881668,843.9314379692078,364.44092774391174,616.6569557189941,20131,5283,14848,14848,0,15,5522000.0
5522,5522999,20.768206219165094,38.22329750162499,0.07492021158031537,844.0540444850922,364.50651025772095,616.7713203430176,20131,5283,14848,14848,0,15,5523000.0
5523,5523999,20.767515171786783,38.22180190553005,0.07492076853656993,844.1867108345032,364.57213521003723,616.843391418457,20131,5283,14848,14848,0,15,5524000.0
5524,5524999,20.76675601844671,38.22015753263246,0.07491783364872207,844.3674392700195,364.63759446144104,616.8649559020996,20133,5284,14849,14849,0,15,5525000.0
5525,5525999,20.765777343546414,38.21795422731291,0.07492118152672456,844.4965529441833,364.7031886577606,616.960620880127,20133,5284,14849,14849,0,15,5526000.0
5526,5526999,20.764584487015092,38.21602963405528,0.07492438489202968,844.6176071166992,364.7690010070801,617.7671546936035,20157,5284,14873,14873,0,15,5527000.0
5527,5527999,20.76297766283471,38.213791176580614,0.07492980875461197,844.7947299480438,364.84347009658813,618.102912902832,20169,5285,14884,14884,0,15,5528000.0
5528,5528999,20.761537055362684,38.21191146756549,0.07493420082403268,844.9019975662231,364.9082930088043,618.3735885620117,20170,5285,14885,14885,0,15,5529000.0
5529,5529999,20.76018320730908,38.20976792346283,0.07494526727390627,845.2451963424683,364.9737935066223,618.3704452514648,20180,5290,14890,14890,0,15,5530000.0
5530,5530999,20.7590108213053,38.20958616684619,0.07493894315817295,845.4530520439148,365.03938126564026,618.5805358886719,20184,5292,14892,14892,0,15,5531000.0
5531,5531999,20.757666439234022,38.2074344354134,0.0749441778972445,845.7598032951355,365.10561418533325,618.6742668151855,20193,5296,14897,14897,0,15,5532000.0
5532,5532999,20.756328666215197,38.20507000307298,0.07495066706865694,845.984206199646,365.1718542575836,618.7356643676758,20204,5298,14906,14906,0,15,5533000.0
5533,5533999,20.75505857268213,38.20308903719977,0.07495483434946137,846.1095614433289,365.23733019828796,618.9626770019531,20204,5298,14906,14906,0,15,5534000.0
5534,5534999,20.753797018329042,38.2007677674736,0.0749591657191806,846.2741219997406,365.30310225486755,619.0487632751465,20214,5299,14915,14915,0,15,5535000.0
5535,5535999,20.752784822019052,38.19883010976758,0.07496311048865412,846.3925273418427,365.36852049827576,619.1480979919434,20214,5299,14915,14915,0,15,5536000.0
5536,5536999,20.751876109591116,38.19705089121679,0.07496446394162892,846.6184048652649,365.43443608283997,619.1737251281738,20226,5301,14925,14925,0,15,5537000.0
5537,5537999,20.750817002529597,38.19499252205388,0.07496962588927669,846.7891147136688,365.500262260437,619.2668762207031,20236,5302,14934,14934,0,15,5538000.0
5538,5538999,20.749983012462767,38.1933755544527,0.07497029197051863,847.0453999042511,365.5751762390137,619.2189445495605,20240,5304,14936,14936,0,15,5539000.0
5539,5539999,20.749032852992556,38.191810447512815,0.07497280283247532,847.2242028713226,365.6411335468292,619.287296295166,20242,5305,14937,14937,0,15,5540000.0
5540,5540999,20.748409706595403,38.190757750623774,0.07496895579226104,847.3622713088989,365.7069058418274,619.4347305297852,20242,5305,14937,14937,0,15,5541000.0
5541,5541999,20.747610678180166,38.189141649550194,0.07496978945040644,847.5291953086853,365.77272844314575,619.5077514648438,20244,5306,14938,14938,0,15,5542000.0
5542,5542999,20.746968798190498,38.18752861429335,0.07496980686459487,847.79913854599,365.839457988739,619.5094108581543,20250,5309,14941,14941,0,15,5543000.0
5543,5543999,20.74664498404331,38.18629976850817,0.07496533694791441,847.9754676818848,365.9066846370697,619.5771865844727,20252,5310,14942,14942,0,15,5544000.0
5544,5544999,20.74604988722806,38.184899566537986,0.07496271949983024,848.1526281833649,365.9727509021759,619.636848449707,20254,5311,14943,14943,0,15,5545000.0
5545,5545999,20.74543382511381,38.18333339406629,0.07495552895798097,848.2834753990173,366.03875207901,619.723804473877,20254,5311,14943,14943,0,15,5546000.0
5546,5546999,20.744588217694922,38.18150076472919,0.07495278885043988,848.4308345317841,366.10529255867004,619.8483772277832,20254,5311,14943,14943,0,15,5547000.0
5547,5547999,20.743578791222472,38.179493065478084,0.07495228121627096,848.5532591342926,366.1713902950287,620.5331611633301,20272,5311,14961,14961,0,15,5548000.0
5548,5548999,20.742301832992414,38.17845272230237,0.07494620308213296,848.6612694263458,366.23586654663086,620.860668182373,20272,5311,14961,14961,0,15,5549000.0
5549,5549999,20.741027379779666,38.1762686312041,0.0749458522739671,848.7737185955048,366.30054569244385,621.113883972168,20273,5311,14962,14962,0,15,5550000.0
5550,5550999,20.739698986507317,38.173936403469895,0.07495098941957157,849.025897026062,366.366087436676,621.1953048706055,20279,5314,14965,14965,0,15,5551000.0
5551,5551999,20.73866017260477,38.17200409831291,0.07494434022637664,849.2964923381805,366.4325749874115,621.234073638916,20292,5317,14975,14975,0,15,5552000.0
5552,5552999,20.73746451336121,38.16965546572898,0.0749460450532844,849.5819153785706,366.5058844089508,621.3199348449707,20299,5320,14979,14979,0,15,5553000.0
5553,5553999,20.736444286224383,38.16759202373938,0.07494252683047442,849.8552024364471,366.5726237297058,621.3676261901855,20305,5323,14982,14982,0,15,5554000.0
5554,5554999,20.735440389352654,38.1656212924157,0.07494250104009925,850.026447057724,366.6386761665344,621.5409126281738,20307,5324,14983,14983,0,15,5555000.0
5555,5555999,20.734498578558043,38.16360420313312,0.07493570626112755,850.1510307788849,366.70430517196655,621.6978759765625,20307,5324,14983,14983,0,15,5556000.0
5556,5556999,20.73384579008861,38.16199281721982,0.07492976654400207,850.2853453159332,366.76977133750916,621.8088607788086,20307,5324,14983,14983,0,15,5557000.0
5557,5557999,20.733334726937226,38.16072593584753,0.07492674554985757,850.4829444885254,366.8444347381592,621.8577690124512,20309,5325,14984,14984,0,15,5558000.0
5558,5558999,20.733374115900915,38.160897972086666,0.0749140692923086,850.6188094615936,366.9103624820709,621.9895133972168,20309,5325,14984,14984,0,15,5559000.0
5559,5559999,20.733276032620648,38.159829791145896,0.0749066234671083,850.7520935535431,366.976300239563,622.0654792785645,20309,5325,14984,14984,0,15,5560000.0
5560,5560999,20.73310521439065,38.15888381105747,0.07489944006110205,850.933388710022,367.04271268844604,622.0869293212891,20311,5326,14985,14985,0,15,5561000.0
5561,5561999,20.733385292381243,38.15900250621199,0.07488526465757617,851.0621891021729,367.1084005832672,622.1806869506836,20311,5326,14985,14985,0,15,5562000.0
5562,5562999,20.734009338650516,38.159656277352,0.07487285470301808,851.193243265152,367.1738774776459,622.2604026794434,20311,5326,14985,14985,0,15,5563000.0
5563,5563999,20.73441370705084,38.1594106047121,0.07485956141324335,851.3312342166901,367.23964738845825,622.3110046386719,20311,5326,14985,14985,0,15,5564000.0
5564,5564999,20.73516128915606,38.159715145658595,0.07484530988660221,851.4569141864777,367.3052554130554,622.3897399902344,20311,5326,14985,14985,0,15,5565000.0
5565,5565999,20.735465650250894,38.159128167384516,0.0748417310496271,851.685010433197,367.3716561794281,622.3712768554688,20323,5328,14995,14995,0,15,5566000.0
5566,5566999,20.73570532936303,38.15843305815581,0.074835286873566,851.881266117096,367.4377899169922,622.3832702636719,20325,5329,14996,14996,0,15,5567000.0
5567,5567999,20.73569260239483,38.157236662178924,0.07483031772382209,852.0034959316254,367.50347995758057,622.4599304199219,20325,5329,14996,14996,0,15,5568000.0
5568,5568999,20.734896274853874,38.15544199654142,0.07483129229605867,852.138952255249,367.5810191631317,623.3135757446289,20354,5329,15025,15025,0,15,5569000.0
5569,5569999,20.733807606491304,38.153812473791795,0.07483369886427915,852.2565820217133,367.6513822078705,623.7755012512207,20355,5329,15026,15026,0,15,5570000.0
5570,5570999,20.73259148771152,38.15172237489767,0.07484117062801166,852.3701646327972,367.7165791988373,624.0472450256348,20357,5329,15028,15028,0,15,5571000.0
5571,5571999,20.731835615276548,38.15027397744575,0.07484035508273346,852.684431552887,367.7830328941345,624.118953704834,20367,5333,15034,15034,0,15,5572000.0
5572,5572999,20.73105771538503,38.14857037169127,0.07483863919050904,852.7957553863525,367.8481070995331,624.4203414916992,20367,5333,15034,15034,0,15,5573000.0
5573,5573999,20.73008713336613,38.14680492269763,0.07484116846242272,852.9991753101349,367.9140741825104,624.5742683410645,20371,5335,15036,15036,0,15,5574000.0
5574,5574999,20.72904715053975,38.14495154169499,0.07483904545690989,853.2639038562775,367.9806435108185,624.6410751342773,20377,5338,15039,15039,0,15,5575000.0
5575,5575999,20.728087851893804,38.1430599168529,0.07483594815572059,853.4900434017181,368.04714274406433,624.7425651550293,20381,5340,15041,15041,0,15,5576000.0
5576,5576999,20.727066180868633,38.14088037294037,0.07484112284703959,853.857962846756,368.1149961948395,624.7246131896973,20391,5345,15046,15046,0,15,5577000.0
5577,5577999,20.726047410492587,38.139009618860214,0.07484043230275161,853.9889726638794,368.18122267723083,624.9568176269531,20391,5345,15046,15046,0,15,5578000.0
5578,5578999,20.725376271472722,38.139370370370685,0.07483421984407068,854.1140961647034,368.24736428260803,625.1253852844238,20391,5345,15046,15046,0,15,5579000.0
5579,5579999,20.724265561020268,38.13699869822066,0.07484011002341961,854.2398104667664,368.3132891654968,625.2334899902344,20391,5345,15046,15046,0,15,5580000.0
5580,5580999,20.72350139650702,38.135229324965,0.07484080155172324,854.4347155094147,368.37998390197754,625.3009834289551,20393,5346,15047,15047,0,15,5581000.0
5581,5581999,20.722693719448117,38.13304837332056,0.07484847750498624,854.5900399684906,368.456294298172,625.3837890625,20393,5346,15047,15047,0,15,5582000.0
5582,5582999,20.72215673309515,38.13176974224868,0.07485575492037178,854.7116422653198,368.5227019786835,625.4936180114746,20393,5346,15047,15047,0,15,5583000.0
5583,5583999,20.721258366995706,38.12949019043596,0.07486665058911979,854.8375489711761,368.58868980407715,625.5779876708984,20393,5346,15047,15047,0,15,5584000.0
5584,5584999,20.720276560480897,38.12719171354533,0.07487618197066004,855.0155875682831,368.6552801132202,625.6340217590332,20395,5347,15048,15048,0,15,5585000.0
5585,5585999,20.719449737767114,38.12579895871104,0.07487885451474785,855.1487679481506,368.72124552726746,626.3341636657715,20413,5347,15066,15066,0,15,5586000.0
5586,5586999,20.718437524021812,38.12485702455199,0.07487786219560577,855.2651124000549,368.78621530532837,626.8208885192871,20419,5347,15072,15072,0,15,5587000.0
5587,5587999,20.71723282441848,38.122883772903464,0.07489240724964674,855.3773627281189,368.8510093688965,627.0688667297363,20419,5347,15072,15072,0,15,5588000.0
5588,5588999,20.715981593446028,38.120805913489555,0.0749043537804932,855.5963361263275,368.916645526886,627.1689186096191,20423,5349,15074,15074,0,15,5589000.0
5589,5589999,20.714948662054557,38.11923704363657,0.07490893949269517,855.7574965953827,368.98177433013916,627.336612701416,20425,5350,15075,15075,0,15,5590000.0
5590,5590999,20.71370778781428,38.11745635081105,0.07491463836036805,856.0147724151611,369.04800367355347,627.4383926391602,20439,5353,15086,15086,0,15,5591000.0
5591,5591999,20.71259084245835,38.115432256748015,0.07491773087021425,856.2366623878479,369.11391615867615,627.5076370239258,20443,5355,15088,15088,0,15,5592000.0
5592,5592999,20.71152133034502,38.11340426773264,0.07491897460209196,856.4548387527466,369.18057107925415,627.5896186828613,20447,5357,15090,15090,0,15,5593000.0
5593,5593999,20.710520441290747,38.111454196504084,0.07491955397877836,856.6905150413513,369.2470774650574,627.6653366088867,20451,5359,15092,15092,0,15,5594000.0
5594,5594999,20.709849786507345,38.11054927722646,0.07491043838273304,856.8293743133545,369.31286120414734,627.8487167358398,20451,5359,15092,15092,0,15,5595000.0
5595,5595999,20.709088569710364,38.1087434175429,0.07490620423135663,857.0014646053314,369.38011503219604,627.9320373535156,20453,5360,15093,15093,0,15,5596000.0
5596,5596999,20.708431951456014,38.10742364669675,0.0748996265010089,857.1173951625824,369.445636510849,628.0393562316895,20453,5360,15093,15093,0,15,5597000.0
5597,5597999,20.70800699072151,38.106470027302464,0.07488689806419668,857.2919414043427,369.51183128356934,628.0782432556152,20455,5361,15094,15094,0,15,5598000.0
5598,5598999,20.707694632134128,38.10513232978268,0.07487585542467934,857.4811248779297,369.57779598236084,628.1508102416992,20457,5362,15095,15095,0,15,5599000.0
5599,5599999,20.707155841041004,38.10394570776587,0.07486588192657628,857.6171951293945,369.64358282089233,628.2243614196777,20457,5362,15095,15095,0,15,5600000.0
5600,5600999,20.706743090819494,38.10261793250796,0.07485739649433698,857.735657453537,369.70936393737793,628.3189163208008,20457,5362,15095,15095,0,15,5601000.0
5601,5601999,20.706713290177852,38.10315732964529,0.07483850255155067,857.9413738250732,369.77571868896484,628.330924987793,20459,5363,15096,15096,0,15,5602000.0
5602,5602999,20.706185375974904,38.101517774260046,0.07483478407515531,858.0707542896271,369.84120774269104,628.4054489135742,20459,5363,15096,15096,0,15,5603000.0
5603,5603999,20.705700405643157,38.10001059734695,0.07482713176570666,858.186824798584,369.9069290161133,628.4791374206543,20459,5363,15096,15096,0,15,5604000.0
5604,5604999,20.70533170258603,38.09868937143423,0.0748188094635015,858.3703453540802,369.97280383110046,628.5649337768555,20462,5364,15098,15098,0,15,5605000.0
5605,5605999,20.704441692829768,38.0984139543092,0.0748117152835559,858.4895441532135,370.039103269577,629.4203338623047,20483,5364,15119,15119,0,15,5606000.0
5606,5606999,20.703368642824596,38.09691055223983,0.07480462994896775,858.6023724079132,370.10398530960083,629.7542190551758,20484,5364,15120,15120,0,15,5607000.0
5607,5607999,20.70250531497344,38.09539845610732,0.07480579552206346,858.8121345043182,370.16909670829773,629.8425674438477,20489,5366,15123,15123,0,15,5608000.0
5608,5608999,20.70154681953111,38.09351383070237,0.074810021362398,859.0311620235443,370.2358703613281,630.0491104125977,20494,5368,15126,15126,0,15,5609000.0
5609,5609999,20.700785446632676,38.09185848819613,0.07480812739292098,859.1521925926208,370.30107951164246,630.286922454834,20495,5368,15127,15127,0,15,5610000.0
5610,5610999,20.700141038694536,38.090439179810495,0.07480370722663854,859.2897064685822,370.3681757450104,630.4421730041504,20495,5368,15127,15127,0,15,5611000.0
5611,5611999,20.699506369172777,38.08888484786976,0.07479981774887134,859.5132100582123,370.43434381484985,630.4748725891113,20499,5370,15129,15129,0,15,5612000.0
5612,5612999,20.698972911386242,38.08757996953199,0.0747999840483401,859.7295832633972,370.5011670589447,630.5741310119629,20532,5372,15160,15160,0,15,5613000.0
5613,5613999,20.69861642864588,38.08664367206925,0.07479837642368037,859.9647414684296,370.5671148300171,630.5911331176758,20536,5374,15162,15162,0,15,5614000.0
5614,5614999,20.698411357763668,38.08567397334951,0.07479707402004876,860.1394124031067,370.6330144405365,630.684024810791,20538,5375,15163,15163,0,15,5615000.0
5615,5615999,20.698001974174673,38.08431463862245,0.07480010388727587,860.3083782196045,370.6992256641388,630.8205757141113,20539,5376,15163,15163,0,15,5616000.0
5616,5616999,20.69777916056447,38.08383736939807,0.07480186168469649,860.5748133659363,370.7658357620239,630.8361129760742,20545,5379,15166,15166,0,15,5617000.0
5617,5617999,20.697716934500797,38.08517233925857,0.07479222450142431,860.7958087921143,370.8326346874237,630.855884552002,20556,5381,15175,15175,0,15,5618000.0
5618,5618999,20.698119825222165,38.08618486028325,0.07478705002355057,860.9913606643677,370.90071415901184,630.9106483459473,20558,5382,15176,15176,0,15,5619000.0
5619,5619999,20.698389938756772,38.085845944151636,0.07478176919210744,861.1278176307678,370.9675064086914,631.0419502258301,20558,5382,15176,15176,0,15,5620000.0
5620,5620999,20.698867747330702,38.08536320940547,0.07477844634304054,861.2497925758362,371.0333421230316,631.1306381225586,20558,5382,15176,15176,0,15,5621000.0
5621,5621999,20.69956319387639,38.085448642422854,0.07477464581131132,861.3652679920197,371.09909081459045,631.2316055297852,20558,5382,15176,15176,0,15,5622000.0
5622,5622999,20.700200147380873,38.08548932274547,0.07476953113303153,861.5055239200592,371.16513681411743,631.3147583007812,20558,5382,15176,15176,0,15,5623000.0
5623,5623999,20.70053525976107,38.085045879897564,0.07476517172126995,861.6861522197723,371.23165822029114,631.313777923584,20568,5383,15185,15185,0,15,5624000.0
5624,5624999,20.700846552486755,38.084415856709406,0.07476523659415402,861.8179552555084,371.2974627017975,631.3850212097168,20568,5383,15185,15185,0,15,5625000.0
5625,5625999,20.70032549708634,38.08248924433983,0.07476339523977893,861.9898102283478,371.36588859558105,631.442699432373,20570,5384,15186,15186,0,15,5626000.0
5626,5626999,20.69885988465898,38.08133631761416,0.07476775743034159,862.1183581352234,371.43824219703674,632.577091217041,20606,5384,15222,15222,0,15,5627000.0
5627,5627999,20.697018347562523,38.07870490076819,0.0747813449516801,862.2296526432037,371.5043029785156,632.993896484375,20608,5384,15224,15224,0,15,5628000.0
5628,5628999,20.695565765639117,38.07709058019611,0.07478755449947694,862.3400053977966,371.5705621242523,633.2536773681641,20610,5384,15226,15226,0,15,5629000.0
5629,5629999,20.69393174363089,38.07451379217219,0.0748043649025466,862.6459517478943,371.63751316070557,633.3736381530762,20619,5388,15231,15231,0,15,5630000.0
5630,5630999,20.692523927557257,38.07269965523757,0.07481015721484319,862.8165156841278,371.7038805484772,633.5508193969727,20622,5389,15233,15233,0,15,5631000.0
5631,5631999,20.691037384290286,38.07031797269885,0.07482046938920373,862.9873232841492,371.77118158340454,633.7492218017578,20624,5390,15234,15234,0,15,5632000.0
5632,5632999,20.68937365090995,38.06762133458769,0.07483227038540441,863.1593039035797,371.83782601356506,633.8703231811523,20626,5391,15235,15235,0,15,5633000.0
5633,5633999,20.687884530310775,38.06500653945509,0.07484180392026185,863.3330941200256,371.9051704406738,633.9890480041504,20628,5392,15236,15236,0,15,5634000.0
5634,5634999,20.686765778239234,38.06314503739182,0.07484419321188784,863.498872756958,371.9717450141907,634.0689697265625,20630,5393,15237,15237,0,15,5635000.0
5635,5635999,20.686233350685594,38.06255572364481,0.07483795364682533,863.783102273941,372.03977370262146,634.0828704833984,20636,5396,15240,15240,0,15,5636000.0
5636,5636999,20.686192065666575,38.06366679693157,0.07482211939228156,863.9196817874908,372.1066300868988,634.2496719360352,20636,5396,15240,15240,0,15,5637000.0
5637,5637999,20.686345705855032,38.064261739360404,0.07480996689430097,864.0962362289429,372.1736752986908,634.3196182250977,20638,5397,15241,15241,0,15,5638000.0
5638,5638999,20.6873572731466,38.069020833751175,0.07478917897511617,864.4584875106812,372.2417893409729,634.2559013366699,20648,5402,15246,15246,0,15,5639000.0
5639,5639999,20.689078774776238,38.075864626280605,0.07476671778810484,864.5788927078247,372.3086087703705,634.4871444702148,20648,5402,15246,15246,0,15,5640000.0
5640,5640999,20.690875967764637,38.08225972321759,0.07477524425184157,864.760635137558,372.3759927749634,634.5691680908203,20650,5403,15247,15247,0,15,5641000.0
5641,5641999,20.692523571820693,38.086905388031326,0.07478878324044946,864.9375240802765,372.44323229789734,634.6293182373047,20652,5404,15248,15248,0,15,5642000.0
5642,5642999,20.69543289571288,38.095804518946565,0.07481230770092162,865.0614628791809,372.5100700855255,634.8103637695312,20652,5404,15248,15248,0,15,5643000.0
5643,5643999,20.69767034811671,38.102320558912844,0.07481943410595537,865.193612575531,372.5770175457001,634.914119720459,20652,5404,15248,15248,0,15,5644000.0
5644,5644999,20.69955640142384,38.106448053189744,0.07485381682172265,865.3844718933105,372.643887758255,634.9388694763184,20654,5405,15249,15249,0,15,5645000.0
5645,5645999,20.700691606613876,38.10867523529338,0.0748456351643777,865.5707201957703,372.7120370864868,635.0163154602051,20656,5406,15250,15250,0,15,5646000.0
5646,5646999,20.69992687253382,38.10851421546327,0.07484891188298792,865.6870357990265,372.77812123298645,636.0121650695801,20682,5406,15276,15276,0,15,5647000.0
5647,5647999,20.698548878673268,38.10740928979311,0.07485007679506273,865.8004488945007,372.8435559272766,636.4128837585449,20686,5406,15280,15280,0,15,5648000.0
5648,5648999,20.697172115267858,38.105753604260386,0.07485656186039513,866.0041561126709,372.9091577529907,636.5829811096191,20691,5408,15283,15283,0,15,5649000.0
5649,5649999,20.69575314867085,38.10352401052252,0.07486564255449546,866.17884349823,372.9751093387604,636.8165245056152,20693,5409,15284,15284,0,15,5650000.0
5650,5650999,20.694556976838058,38.10206724555208,0.07486556941771882,866.3015015125275,373.04167795181274,637.0348205566406,20694,5409,15285,15285,0,15,5651000.0
5651,5651999,20.6931601156722,38.09996175000529,0.07487127700360308,866.5217909812927,373.1073760986328,637.1008415222168,20698,5411,15287,15287,0,15,5652000.0
5652,5652999,20.691812116990313,38.1015960295935,0.07486496433696788,866.7017378807068,373.173504114151,637.1900939941406,20700,5412,15288,15288,0,15,5653000.0
5653,5653999,20.690538973761292,38.0993687242224,0.07487045474999521,866.8670246601105,373.2395408153534,637.3170547485352,20702,5413,15289,15289,0,15,5654000.0
5654,5654999,20.689430703858196,38.09731496939205,0.07487361549640936,867.1239495277405,373.3059492111206,637.3277893066406,20708,5416,15292,15292,0,15,5655000.0
5655,5655999,20.688499519857444,38.0955691592986,0.07487369461357929,867.2537081241608,373.37295055389404,637.4509239196777,20708,5416,15292,15292,0,15,5656000.0
5656,5656999,20.687856890377436,38.09460856139406,0.07486635277404707,867.5893309116364,373.4402816295624,637.4495811462402,20716,5420,15296,15296,0,15,5657000.0
5657,5657999,20.68703532708364,38.09288128219353,0.07486944575257937,867.7651653289795,373.5076107978821,637.5651092529297,20718,5421,15297,15297,0,15,5658000.0
5658,5658999,20.686175026507883,38.09102086736922,0.07487133009537905,867.9812622070312,373.57437229156494,637.5898284912109,20722,5423,15299,15299,0,15,5659000.0
5659,5659999,20.68562007323334,38.0896386448265,0.07487529629611389,868.1543352603912,373.6415231227875,637.7284355163574,20725,5424,15301,15301,0,15,5660000.0
5660,5660999,20.685302484102312,38.08849468304968,0.07487017723796785,868.2930092811584,373.70843410491943,637.8743324279785,20725,5424,15301,15301,0,15,5661000.0
5661,5661999,20.684960187546466,38.0871965013907,0.07487388648181814,868.4744229316711,373.7746334075928,637.9183502197266,20727,5425,15302,15302,0,15,5662000.0
5662,5662999,20.68498357332174,38.08815043323658,0.07486703706383924,868.6061935424805,373.8409357070923,638.0746536254883,20727,5425,15302,15302,0,15,5663000.0
5663,5663999,20.685173926233535,38.0878620037386,0.07486172321548268,868.7236959934235,373.90696930885315,638.1608657836914,20727,5425,15302,15302,0,15,5664000.0
5664,5664999,20.68491112346262,38.08663160737714,0.07486423638530482,868.9051041603088,373.97415041923523,638.1431121826172,20729,5426,15303,15303,0,15,5665000.0
5665,5665999,20.685015764242046,38.086036546870744,0.07485308357118803,869.097110748291,374.04097533226013,638.1688385009766,20731,5427,15304,15304,0,15,5666000.0
5666,5666999,20.684161984759516,38.08427929366766,0.07485249602468036,869.2923564910889,374.1085674762726,638.814151763916,20758,5428,15330,15330,0,15,5667000.0
5667,5667999,20.68268352963643,38.08214416148226,0.07486086952317605,869.4023742675781,374.17489552497864,639.3314056396484,20761,5428,15333,15333,0,15,5668000.0
5668,5668999,20.681034305544355,38.07935972383021,0.07487185580686728,869.5191366672516,374.24012780189514,639.6644706726074,20762,5428,15334,15334,0,15,5669000.0
5669,5669999,20.679591113539153,38.07686341529803,0.07488247641968437,869.6346380710602,374.3058078289032,639.8790245056152,20763,5428,15335,15335,0,15,5670000.0
5670,5670999,20.678366092972038,38.07542642468342,0.07488546385134653,869.8960678577423,374.3718650341034,639.942813873291,20769,5431,15338,15338,0,15,5671000.0
5671,5671999,20.676790478869037,38.07283621922048,0.07489463681746711,870.170793056488,374.4388265609741,640.0799980163574,20784,5434,15350,15350,0,15,5672000.0
5672,5672999,20.675305962531777,38.07031895481652,0.07490392752058406,870.3376891613007,374.5045804977417,640.2050743103027,20786,5435,15351,15351,0,15,5673000.0
5673,5673999,20.674044838475616,38.06844121923411,0.07490721901951436,870.5679919719696,374.57123947143555,640.3194274902344,20790,5437,15353,15353,0,15,5674000.0
5674,5674999,20.673024941417534,38.067316831997516,0.07490800667177422,870.6953647136688,374.6369516849518,640.513313293457,20791,5437,15354,15354,0,15,5675000.0
5675,5675999,20.672498242529358,38.06762813058862,0.07490815762949321,870.859531879425,374.70398235321045,640.6136512756348,20793,5438,15355,15355,0,15,5676000.0
5676,5676999,20.672678970539376,38.06976037365943,0.07489638506403584,871.147563457489,374.7710611820221,640.548641204834,20807,5441,15366,15366,0,15,5677000.0
5677,5677999,20.673215302164134,38.0724227077229,0.0748786955578824,871.3683667182922,374.83805298805237,640.6569175720215,20820,5443,15377,15377,0,15,5678000.0
5678,5678999,20.673854729687253,38.07432279339595,0.07487898688940775,871.5916683673859,374.90517258644104,640.6936683654785,20824,5445,15379,15379,0,15,5679000.0
5679,5679999,20.674336974602245,38.076024580149735,0.07489611311448108,871.8140075206757,374.9721853733063,640.7744140625,20828,5447,15381,15381,0,15,5680000.0
5680,5680999,20.675094888599176,38.07853730293807,0.07491917324357811,872.0371172428131,375.04074358940125,640.8899841308594,20832,5449,15383,15383,0,15,5681000.0
5681,5681999,20.676063775646565,38.08125867143917,0.07495601772465066,872.2168610095978,375.10800671577454,641.021354675293,20833,5450,15383,15383,0,15,5682000.0
5682,5682999,20.67665145087881,38.08253151966072,0.07499769924726296,872.4354093074799,375.1757574081421,641.0578765869141,20837,5452,15385,15385,0,15,5683000.0
5683,5683999,20.677937125510226,38.085202868133855,0.07502164073571638,872.5653233528137,375.242062330246,641.2194061279297,20837,5452,15385,15385,0,15,5684000.0
5684,5684999,20.67915222421817,38.08752963585909,0.0750629724430476,872.8230137825012,375.3090007305145,641.161304473877,20843,5455,15388,15388,0,15,5685000.0
5685,5685999,20.68059845748608,38.09270109188369,0.07504212831764623,873.0197715759277,375.37818145751953,641.2645111083984,20845,5456,15389,15389,0,15,5686000.0
5686,5686999,20.681254565423714,38.09344366765171,0.07505687078094758,873.1511745452881,375.4452440738678,641.3904724121094,20845,5456,15389,15389,0,15,5687000.0
5687,5687999,20.68140752399751,38.09409064052629,0.07502840246260811,873.281412601471,375.5124385356903,642.317497253418,20876,5456,15420,15420,0,15,5688000.0
5688,5688999,20.68015130500913,38.09205862026287,0.07502796918589794,873.4556128978729,375.5784523487091,642.774284362793,20889,5457,15432,15432,0,15,5689000.0
5689,5689999,20.678671875000905,38.0901315155269,0.07503042208077482,873.5704989433289,375.6448783874512,643.1260566711426,20892,5457,15435,15435,0,15,5690000.0
5690,5690999,20.677416512561027,38.088404015127594,0.07503188282949913,873.8705837726593,375.7112605571747,643.1949615478516,20900,5461,15439,15439,0,15,5691000.0
5691,5691999,20.676308337124233,38.086640812163296,0.07503090473047835,874.0443167686462,375.777809381485,643.4030380249023,20902,5462,15440,15440,0,15,5692000.0
5692,5692999,20.675333221101138,38.084979693487526,0.07502718433817557,874.3056130409241,375.84496998786926,643.5806999206543,20909,5465,15444,15444,0,15,5693000.0
5693,5693999,20.674180836562453,38.08307577551392,0.07502940260614266,874.4753241539001,375.91166734695435,643.7416725158691,20911,5466,15445,15445,0,15,5694000.0
5694,5694999,20.673428620101532,38.08162218334562,0.07503741691424803,874.7427949905396,375.978547334671,643.8160247802734,20917,5469,15448,15448,0,15,5695000.0
5695,5695999,20.672523888999432,38.08030278299006,0.07504328231832036,874.9547505378723,376.0467138290405,643.9141654968262,20937,5471,15466,15466,0,15,5696000.0
5696,5696999,20.67207850989904,38.07942956348984,0.07504758221092622,875.1384766101837,376.1139929294586,644.0539245605469,20939,5472,15467,15467,0,15,5697000.0
5697,5697999,20.671637163377284,38.07909097507497,0.07504804065317683,875.4544434547424,376.1820685863495,644.0716094970703,20947,5476,15471,15471,0,15,5698000.0
5698,5698999,20.671146958941343,38.0781277959104,0.07504749613839345,875.6835277080536,376.24957823753357,644.2037620544434,20951,5478,15473,15473,0,15,5699000.0
5699,5699999,20.671007878449906,38.08026920056543,0.07505521974911633,875.8515651226044,376.31687903404236,644.3416786193848,20953,5479,15474,15474,0,15,5700000.0
5700,5700999,20.670801902785886,38.07975250871148,0.07505843480993013,876.0319957733154,376.38444209098816,644.4002838134766,20955,5480,15475,15475,0,15,5701000.0
5701,5701999,20.670719270136853,38.07919431063423,0.07508597368137693,876.165524482727,376.4523310661316,644.5609130859375,20955,5480,15475,15475,0,15,5702000.0
5702,5702999,20.670607609415562,38.07831422553386,0.07509387593669492,876.3911798000336,376.5196328163147,644.5579986572266,20959,5482,15477,15477,0,15,5703000.0
5703,5703999,20.670447026599277,38.077626270498136,0.07510874339794205,876.5682184696198,376.5867488384247,644.6649780273438,20961,5483,15478,15478,0,15,5704000.0
5704,5704999,20.670543547298063,38.07675763784993,0.07512443424346738,876.705974817276,376.65453243255615,644.8161506652832,20961,5483,15478,15478,0,15,5705000.0
5705,5705999,20.67051891005178,38.0775621006342,0.07511598272134234,876.8321933746338,376.72183108329773,644.9212913513184,20961,5483,15478,15478,0,15,5706000.0
5706,5706999,20.670580630603602,38.07686272100084,0.07511915498275912,877.008544921875,376.78882479667664,644.9753074645996,20963,5484,15479,15479,0,15,5707000.0
5707,5707999,20.67059561576991,38.07601959951133,0.07511119053372772,877.2006525993347,376.8566439151764,645.0862503051758,20965,5485,15480,15480,0,15,5708000.0
5708,5708999,20.669988442052983,38.074448769340606,0.07510485073434381,877.3735942840576,376.92505145072937,645.8542976379395,20996,5486,15510,15510,0,15,5709000.0
5709,5709999,20.668588447899527,38.07281606529149,0.07511322656520092,877.4841253757477,376.99045586586,646.4438858032227,21003,5486,15517,15517,0,15,5710000.0
5710,5710999,20.667326228046033,38.072090396849674,0.0751182754347327,877.7040388584137,377.0589954853058,646.6535873413086,21009,5488,15521,15521,0,15,5711000.0
5711,5711999,20.6662009891203,38.07072112305657,0.07512294257998342,877.9140255451202,377.1248960494995,646.8763160705566,21013,5490,15523,15523,0,15,5712000.0
5712,5712999,20.6650065679555,38.069287555462765,0.07512628734304982,878.0751461982727,377.1916615962982,647.122314453125,21015,5491,15524,15524,0,15,5713000.0
5713,5713999,20.663417044986883,38.06668566955485,0.07513947910927155,878.3103227615356,377.2586796283722,647.2434043884277,21019,5493,15526,15526,0,15,5714000.0
5714,5714999,20.66204023307459,38.06451283931878,0.07514960085779276,878.4757244586945,377.32470178604126,647.4247131347656,21022,5494,15528,15528,0,15,5715000.0
5715,5715999,20.660902796701368,38.063012231264246,0.07515336070212653,878.7364542484283,377.3924729824066,647.4583740234375,21028,5497,15531,15531,0,15,5716000.0
5716,5716999,20.659568415748613,38.06099169704681,0.07516442674095247,878.8658323287964,377.4588429927826,647.6528739929199,21028,5497,15531,15531,0,15,5717000.0
5717,5717999,20.658213850481406,38.05861852929695,0.07517769293206877,879.0772929191589,377.52665185928345,647.7368965148926,21033,5499,15534,15534,0,15,5718000.0
5718,5718999,20.65681889923245,38.05614279021317,0.07519104315075775,879.3065321445465,377.593505859375,647.8412094116211,21037,5501,15536,15536,0,15,5719000.0
5719,5719999,20.655561238758764,38.05414083039121,0.0752051779382833,879.4237611293793,377.6600921154022,647.9740219116211,21037,5501,15536,15536,0,15,5720000.0
5720,5720999,20.654438096607578,38.052095165542774,0.0752193019158367,879.6051676273346,377.7272641658783,648.0412292480469,21047,5502,15545,15545,0,15,5721000.0
5721,5721999,20.65348883724298,38.05026446502525,0.07523158741365421,879.8424038887024,377.79462003707886,648.0536499023438,21051,5504,15547,15547,0,15,5722000.0
5722,5722999,20.65247030951819,38.048271908167145,0.07524632538895493,880.0167167186737,377.861177444458,648.2047843933105,21053,5505,15548,15548,0,15,5723000.0
5723,5723999,20.651589383642573,38.046354021186225,0.07526053973449409,880.255476474762,377.92877078056335,648.2529907226562,21057,5507,15550,15550,0,15,5724000.0
5724,5724999,20.65023573318788,38.043774561749636,0.07528301105578616,880.433522939682,377.9957106113434,648.3360176086426,21059,5508,15551,15551,0,15,5725000.0
5725,5725999,20.649377307381595,38.043344462973664,0.07525965035180615,880.6089262962341,378.0627586841583,649.1046485900879,21085,5509,15576,15576,0,15,5726000.0
5726,5726999,20.648105227152985,38.04132722805049,0.07526346786126503,880.7219779491425,378.1289892196655,649.7226753234863,21094,5509,15585,15585,0,15,5727000.0
5727,5727999,20.64712771685321,38.04077895075405,0.07526058891359622,880.8830413818359,378.1948575973511,649.9462623596191,21097,5510,15587,15587,0,15,5728000.0
5728,5728999,20.646159125504138,38.040556216787955,0.07525921296807614,881.0476496219635,378.26128005981445,650.1909255981445,21100,5511,15589,15589,0,15,5729000.0
5729,5729999,20.645191693253658,38.03920118226782,0.07526116127653693,881.3186919689178,378.330539226532,650.3469886779785,21106,5514,15592,15592,0,15,5730000.0
5730,5730999,20.644540168948897,38.03868861022338,0.07525563460007734,881.5543768405914,378.40799593925476,650.4764976501465,21110,5516,15594,15594,0,15,5731000.0
5731,5731999,20.64363059405196,38.03726050324842,0.0752579595767463,881.8284201622009,378.4747838973999,650.547737121582,21124,5519,15605,15605,0,15,5732000.0
5732,5732999,20.6426822452671,38.03538293930554,0.07525802251948244,881.994030714035,378.5411024093628,650.6861343383789,21126,5520,15606,15606,0,15,5733000.0
5733,5733999,20.64176727704351,38.03346709311463,0.07526010626000867,882.2631227970123,378.6076726913452,650.7200584411621,21140,5523,15617,15617,0,15,5734000.0
5734,5734999,20.641275288553395,38.033082479658496,0.07525452804573507,882.4550654888153,378.6745629310608,650.8487930297852,21142,5524,15618,15618,0,15,5735000.0
5735,5735999,20.64069383516775,38.031799634530344,0.07524902627991092,882.5682356357574,378.7408125400543,651.04248046875,21142,5524,15618,15618,0,15,5736000.0
5736,5736999,20.63992388962875,38.030419240315815,0.07524579266556441,882.7398717403412,378.80841875076294,651.1286773681641,21143,5525,15618,15618,0,15,5737000.0
5737,5737999,20.639326553436025,38.0289566040894,0.07523830328033165,882.8654658794403,378.8747184276581,651.2350273132324,21143,5525,15618,15618,0,15,5738000.0
5738,5738999,20.639103279346525,38.028772531959135,0.07522656398294625,883.1105189323425,378.94835209846497,651.2640571594238,21152,5527,15625,15625,0,15,5739000.0
5739,5739999,20.638997218143462,38.02889764877059,0.07521170311074199,883.3204636573792,379.02482628822327,651.3158264160156,21154,5528,15626,15626,0,15,5740000.0
5740,5740999,20.638439524254203,38.027355011160516,0.07520634617300226,883.6083598136902,379.0942714214325,651.3359031677246,21160,5531,15629,15629,0,15,5741000.0
5741,5741999,20.638263970779317,38.02641226207193,0.07520243241313906,883.7928013801575,379.1613380908966,651.4468612670898,21162,5532,15630,15630,0,15,5742000.0
5742,5742999,20.63842694395736,38.026043266036126,0.07518784503400333,884.0206243991852,379.2287700176239,651.414234161377,21168,5534,15634,15634,0,15,5743000.0
5743,5743999,20.638565875727938,38.02547115485832,0.07517795891442292,884.145956993103,379.2950129508972,651.5384941101074,21168,5534,15634,15634,0,15,5744000.0
5744,5744999,20.638752873336884,38.02732480585533,0.07515536378031962,884.2826538085938,379.3616189956665,651.6517601013184,21168,5534,15634,15634,0,15,5745000.0
5745,5745999,20.63789092980608,38.02538479117689,0.07515429391878592,884.409708738327,379.4293575286865,652.8456611633301,21212,5534,15678,15678,0,15,5746000.0
5746,5746999,20.6376321272747,38.02609632667205,0.07515189964302593,884.5232338905334,379.49536752700806,653.4286994934082,21217,5534,15683,15683,0,15,5747000.0
5747,5747999,20.637719562135867,38.02751034818196,0.07514731044746237,884.6344227790833,379.560485124588,653.7694129943848,21219,5534,15685,15685,0,15,5748000.0
5748,5748999,20.637561783184385,38.027202789230046,0.07516433567732195,884.8495919704437,379.6265318393707,653.936107635498,21223,5536,15687,15687,0,15,5749000.0
5749,5749999,20.637246586995218,38.02683146082715,0.07519222820915894,885.0704455375671,379.69365525245667,654.1372566223145,21228,5538,15690,15690,0,15,5750000.0
5750,5750999,20.636750908018524,38.02561968021427,0.07521081901639415,885.2853972911835,379.76030445098877,654.3293304443359,21233,5540,15693,15693,0,15,5751000.0
5751,5751999,20.636323933296154,38.02443148717476,0.07524254832592914,885.6104745864868,379.8280529975891,654.3809547424316,21241,5544,15697,15697,0,15,5752000.0
5752,5752999,20.636117415443373,38.02418601709299,0.07528739514516514,885.8805377483368,379.8952238559723,654.4924774169922,21247,5547,15700,15700,0,15,5753000.0
5753,5753999,20.635842454592332,38.023182752366814,0.0753072607114843,886.1153283119202,379.9627342224121,654.6379814147949,21251,5549,15702,15702,0,15,5754000.0
5754,5754999,20.635926513576322,38.022920948090466,0.07534943789284476,886.3390080928802,380.02957940101624,654.7117004394531,21262,5551,15711,15711,0,15,5755000.0
5755,5755999,20.635913744986382,38.0233972414206,0.07537540878302351,886.4536924362183,380.09606981277466,654.9190826416016,21262,5551,15711,15711,0,15,5756000.0
5756,5756999,20.636258738659535,38.02365682614972,0.07542691970435855,886.5853638648987,380.16269183158875,655.0599670410156,21262,5551,15711,15711,0,15,5757000.0
5757,5757999,20.63713454950258,38.02616260455933,0.07545422774971555,886.7679512500763,380.2292754650116,655.1385459899902,21272,5552,15720,15720,0,15,5758000.0
5758,5758999,20.63797699054879,38.02817966312204,0.075505885064714,886.8924942016602,380.29591369628906,655.2618255615234,21272,5552,15720,15720,0,15,5759000.0
5759,5759999,20.639399671432123,38.03251934546595,0.07554431580349519,887.0680310726166,380.3623094558716,655.2642135620117,21274,5553,15721,15721,0,15,5760000.0
5760,5760999,20.640473030537255,38.035031877833326,0.07560890690839073,887.3077306747437,380.43064308166504,655.3101654052734,21278,5555,15723,15723,0,15,5761000.0
5761,5761999,20.642286749601908,38.041066484408724,0.07566366290947213,887.5405604839325,380.49838376045227,655.4061508178711,21290,5557,15733,15733,0,15,5762000.0
5762,5762999,20.643763538280986,38.043560118555156,0.07575876701035067,887.7218158245087,380.56573605537415,655.5193138122559,21299,5558,15741,15741,0,15,5763000.0
5763,5763999,20.644523889339677,38.044340538349296,0.07583400520834183,887.8899142742157,380.632648229599,655.6062355041504,21308,5559,15749,15749,0,15,5764000.0
5764,5764999,20.644878062705253,38.0438109438705,0.07587164268472513,888.0622158050537,380.699364900589,655.6906661987305,21318,5560,15758,15758,0,15,5765000.0
5765,5765999,20.64519627741325,38.043762508027385,0.07588929969066827,888.2093534469604,380.76683139801025,656.3065185546875,21341,5560,15781,15781,0,15,5766000.0
5766,5766999,20.644419377335208,38.0433576983295,0.07588111285262256,888.3315391540527,380.84005331993103,656.8492202758789,21344,5560,15784,15784,0,15,5767000.0
5767,5767999,20.643515767235215,38.04186396080667,0.07588421454212169,888.4522020816803,380.904926776886,657.1551094055176,21344,5560,15784,15784,0,15,5768000.0
5768,5768999,20.642531562353984,38.03993978452075,0.07588617923519025,888.6733486652374,380.9703941345215,657.274284362793,21356,5562,15794,15794,0,15,5769000.0
5769,5769999,20.641766794082073,38.03842841997066,0.07588601850060239,888.8433723449707,381.03681683540344,657.4192085266113,21359,5563,15796,15796,0,15,5770000.0
5770,5770999,20.64086956250488,38.03661200556598,0.07588541896115764,889.0623095035553,381.1024270057678,657.524658203125,21364,5565,15799,15799,0,15,5771000.0
5771,5771999,20.639971078373264,38.0347835986005,0.07588415421840988,889.1848278045654,381.1680099964142,657.6828422546387,21364,5565,15799,15799,0,15,5772000.0
5772,5772999,20.639023215169956,38.032779965991864,0.07588661256537954,889.46178150177,381.23479866981506,657.7284660339355,21370,5568,15802,15802,0,15,5773000.0
5773,5773999,20.63812694960166,38.030713026331625,0.075889015489087,889.6868171691895,381.30076718330383,657.768627166748,21374,5570,15804,15804,0,15,5774000.0
5774,5774999,20.6372266563139,38.02874462007763,0.0758903175736666,889.9056758880615,381.36684942245483,657.8167610168457,21378,5572,15806,15806,0,15,5775000.0
5775,5775999,20.636330387620916,38.02670593765334,0.07588983595489951,890.1288409233093,381.4334373474121,657.8426513671875,21382,5574,15808,15808,0,15,5776000.0
5776,5776999,20.635713535495103,38.02497231087955,0.07588821421935144,890.3098134994507,381.4997582435608,658.0181694030762,21384,5575,15809,15809,0,15,5777000.0
5777,5777999,20.63507867293441,38.02334785218809,0.07588356939892027,890.4838297367096,381.5660972595215,658.1192932128906,21386,5576,15810,15810,0,15,5778000.0
5778,5778999,20.634551000129022,38.021916791765555,0.07588073025540631,890.616857290268,381.6323437690735,658.2377014160156,21386,5576,15810,15810,0,15,5779000.0
5779,5779999,20.634325758278063,38.02107841308513,0.075869828513637,890.8944568634033,381.70061326026917,658.1520881652832,21413,5579,15834,15834,0,15,5780000.0
5780,5780999,20.63386799436307,38.019690320240485,0.0758652591565756,891.0224704742432,381.76675248146057,658.2861862182617,21413,5579,15834,15834,0,15,5781000.0
5781,5781999,20.633481524284697,38.01831190995832,0.07586275462081649,891.2580366134644,381.8341016769409,658.2525444030762,21417,5581,15836,15836,0,15,5782000.0
5782,5782999,20.633222150703578,38.01702306930831,0.07586275723531044,891.4317326545715,381.9009976387024,658.3904724121094,21427,5582,15845,15845,0,15,5783000.0
5783,5783999,20.632708544389853,38.015459470500915,0.07586422181570307,891.5613007545471,381.9673664569855,658.4825401306152,21427,5582,15845,15845,0,15,5784000.0
5784,5784999,20.63203051487046,38.01361309928936,0.07586786816029267,891.77991771698,382.0340313911438,658.4521598815918,21431,5584,15847,15847,0,15,5785000.0
5785,5785999,20.63134998584292,38.01231109111216,0.07587027803151969,891.9264681339264,382.1008200645447,658.8080940246582,21437,5584,15853,15853,0,15,5786000.0
5786,5786999,20.629872197943182,38.00981386931959,0.0758763684037621,892.0393319129944,382.1670207977295,659.7205352783203,21458,5584,15874,15874,0,15,5787000.0
5787,5787999,20.62869294879114,38.00794031903463,0.07587102536583101,892.2039864063263,382.2323567867279,660.0352592468262,21467,5585,15882,15882,0,15,5788000.0
5788,5788999,20.627675332766305,38.00598098551953,0.0758577653912943,892.3658268451691,382.2974519729614,660.1976051330566,21470,5586,15884,15884,0,15,5789000.0
5789,5789999,20.62681776010891,38.00503863333292,0.0758449598731672,892.4911966323853,382.36249470710754,660.4175109863281,21472,5586,15886,15886,0,15,5790000.0
5790,5790999,20.626111661968192,38.00395003534965,0.07582555600020424,892.6017506122589,382.42745208740234,660.610481262207,21473,5586,15887,15887,0,15,5791000.0
5791,5791999,20.625204912969764,38.00218356770634,0.07581511663218277,892.8210725784302,382.49309945106506,660.6789321899414,21477,5588,15889,15889,0,15,5792000.0
5792,5792999,20.624376279399318,38.000153708162685,0.07580836583851458,893.3542928695679,382.5603828430176,660.4752159118652,21493,5596,15897,15897,0,15,5793000.0
5793,5793999,20.62366265812931,37.99885570191553,0.0757996560012405,893.5796077251434,382.62818813323975,660.698070526123,21497,5598,15899,15899,0,15,5794000.0
5794,5794999,20.62307304118713,37.99717236120666,0.0757933369150885,893.7503161430359,382.69430589675903,660.828067779541,21499,5599,15900,15900,0,15,5795000.0
5795,5795999,20.622589390206592,37.9962112896686,0.07578384329429466,893.9343757629395,382.7603087425232,660.9367904663086,21501,5600,15901,15901,0,15,5796000.0
5796,5796999,20.622043435404965,37.99455836965456,0.07577678799900178,894.1068634986877,382.8266577720642,661.0946846008301,21511,5601,15910,15910,0,15,5797000.0
5797,5797999,20.621888217527772,37.99400263950848,0.0757702179754306,894.3220813274384,382.8933975696564,661.1000366210938,21515,5603,15912,15912,0,15,5798000.0
5798,5798999,20.621531219130723,37.992925285071564,0.07576400172923892,894.4538977146149,382.95951318740845,661.2298774719238,21515,5603,15912,15912,0,15,5799000.0
5799,5799999,20.621475864316768,37.99223946345209,0.07575726337419009,894.6361720561981,383.0257329940796,661.3509635925293,21517,5604,15913,15913,0,15,5800000.0
5800,5800999,20.62108676233457,37.99085492224577,0.07574796458750999,894.8201904296875,383.09526681900024,661.3707542419434,21519,5605,15914,15914,0,15,5801000.0
5801,5801999,20.62094304599669,37.98990754286367,0.07574186820826323,894.9953105449677,383.16169476509094,661.4314155578613,21521,5606,15915,15915,0,15,5802000.0
5802,5802999,20.620768810332777,37.98870197390913,0.07573612386623207,895.1321244239807,383.2280218601227,661.5509605407715,21521,5606,15915,15915,0,15,5803000.0
5803,5803999,20.62060359991267,37.98773956482536,0.0757357607867506,895.3807454109192,383.29526925086975,661.5837287902832,21531,5608,15923,15923,0,15,5804000.0
5804,5804999,20.62016470473981,37.986162918267745,0.07573582548688151,895.4998965263367,383.3611807823181,661.6759262084961,21531,5608,15923,15923,0,15,5805000.0
5805,5805999,20.619666044242756,37.984246544685284,0.07572860290528327,895.7391517162323,383.42801117897034,661.6344108581543,21534,5610,15924,15924,0,15,5806000.0
5806,5806999,20.618839950678627,37.982102052325736,0.07572416236002655,895.8654093742371,383.4948923587799,662.3220672607422,21554,5610,15944,15944,0,15,5807000.0
5807,5807999,20.618018195054923,37.98087277063771,0.07571644880494799,895.9753291606903,383.56006026268005,662.7178611755371,21557,5610,15947,15947,0,15,5808000.0
5808,5808999,20.617501435195262,37.980164529045965,0.0756953871641215,896.1406047344208,383.62618613243103,663.002254486084,21571,5611,15960,15960,0,15,5809000.0
5809,5809999,20.617076775438424,37.97887913848414,0.07568576431024909,896.2584946155548,383.6910915374756,663.1769065856934,21571,5611,15960,15960,0,15,5810000.0
5810,5810999,20.616524179333712,37.97739887088225,0.07568208535930443,896.4859116077423,383.7573733329773,663.2346458435059,21584,5613,15971,15971,0,15,5811000.0
5811,5811999,20.615848200048283,37.97630843007387,0.07567445037102527,896.7549729347229,383.82371282577515,663.4158592224121,21596,5616,15980,15980,0,15,5812000.0
5812,5812999,20.615379870387617,37.97539293038173,0.07566423839057834,896.8759074211121,383.8893392086029,663.5753746032715,21596,5616,15980,15980,0,15,5813000.0
5813,5813999,20.61481462073964,37.97392841394787,0.07566144162807009,897.1076335906982,383.95564222335815,663.7004547119141,21601,5618,15983,15983,0,15,5814000.0
5814,5814999,20.61448251178404,37.97284012523589,0.07565527126652427,897.2774803638458,384.0220539569855,663.8412551879883,21603,5619,15984,15984,0,15,5815000.0
5815,5815999,20.61407473376571,37.971781677986854,0.07565215641389189,897.6112327575684,384.09045672416687,663.7876434326172,21611,5623,15988,15988,0,15,5816000.0
5816,5816999,20.614171074503933,37.97126884893884,0.07564803278978716,897.7799324989319,384.15694761276245,663.9470291137695,21613,5624,15989,15989,0,15,5817000.0
5817,5817999,20.61460396853435,37.97189317573897,0.07564689272714398,898.0041732788086,384.2236154079437,664.0645637512207,21626,5626,16000,16000,0,15,5818000.0
5818,5818999,20.615050159810334,37.97221710836859,0.07564625691012272,898.2459247112274,384.2912788391113,664.1523742675781,21638,5628,16010,16010,0,15,5819000.0
5819,5819999,20.615740689676016,37.97322755361908,0.07565669281125176,898.5252921581268,384.35800075531006,664.1271667480469,21644,5631,16013,16013,0,15,5820000.0
5820,5820999,20.61675140890823,37.9753289515105,0.07566993738602112,898.7121810913086,384.43532705307007,664.2417831420898,21646,5632,16014,16014,0,15,5821000.0
5821,5821999,20.61806668861027,37.97755638343198,0.07570477528171449,898.9957466125488,384.5027334690094,664.2797927856445,21652,5635,16017,16017,0,15,5822000.0
5822,5822999,20.619543490589656,37.98051470749682,0.07573028960982964,899.1691851615906,384.5698518753052,664.4281997680664,21654,5636,16018,16018,0,15,5823000.0
5823,5823999,20.621963040974645,37.98553085461894,0.07577230014666303,899.2940726280212,384.63605761528015,664.5966720581055,21654,5636,16018,16018,0,15,5824000.0
5824,5824999,20.624428594262962,37.99238767164149,0.07580229803300143,899.4781816005707,384.7028913497925,664.6135749816895,21664,5637,16027,16027,0,15,5825000.0
5825,5825999,20.62703321765499,37.99868373023429,0.07583873389354434,899.6068561077118,384.76925802230835,664.7091407775879,21664,5637,16027,16027,0,15,5826000.0
5826,5826999,20.628922580046403,38.00161489026373,0.07587678256328889,899.8469407558441,384.8362989425659,664.754524230957,21668,5639,16029,16029,0,15,5827000.0
5827,5827999,20.628849265467014,38.001236040040595,0.07584760948209313,900.1166877746582,384.90391540527344,665.7881278991699,21716,5642,16074,16074,0,15,5828000.0
5828,5828999,20.627634273275653,38.00000878860892,0.07584159523072576,900.2324032783508,384.9700057506561,666.5236358642578,21729,5642,16087,16087,0,15,5829000.0
5829,5829999,20.626678704870336,37.999134058323826,0.075837394169472,900.3434734344482,385.03607511520386,666.9293746948242,21731,5642,16089,16089,0,15,5830000.0
5830,5830999,20.625780784406654,37.99751581176665,0.07583380788710359,900.5176804065704,385.10167813301086,667.1674728393555,21733,5643,16090,16090,0,15,5831000.0
5831,5831999,20.625106983152826,37.996029361973,0.07582857276603483,900.8430216312408,385.1689987182617,667.2144317626953,21749,5647,16102,16102,0,15,5832000.0
5832,5832999,20.62444807125284,37.994791792771295,0.07582124342032437,901.0105600357056,385.2358386516571,667.5184936523438,21752,5648,16104,16104,0,15,5833000.0
5833,5833999,20.623723306151064,37.99317571590425,0.07581890995074991,901.1422779560089,385.30168652534485,667.6950836181641,21753,5648,16105,16105,0,15,5834000.0
5834,5834999,20.62333769736483,37.99213882056727,0.07581793392398795,901.3638837337494,385.36822628974915,667.8127098083496,21757,5650,16107,16107,0,15,5835000.0
5835,5835999,20.62363176139613,37.99508584758929,0.07579850269404664,901.5912046432495,385.435355424881,667.8758964538574,21761,5652,16109,16109,0,15,5836000.0
5836,5836999,20.624122566871755,37.99589566974021,0.0757991705491442,901.8262321949005,385.5018935203552,667.9280776977539,21765,5654,16111,16111,0,15,5837000.0
5837,5837999,20.62516152071817,37.997414848407566,0.07580847387776846,902.0058085918427,385.5688364505768,668.0489311218262,21767,5655,16112,16112,0,15,5838000.0
5838,5838999,20.626539246631793,37.99961941982815,0.07582627349167226,902.1719045639038,385.63513135910034,668.2372550964355,21776,5656,16120,16120,0,15,5839000.0
5839,5839999,20.62765420635401,38.00081443206289,0.07585073384993246,902.3156266212463,385.709091424942,668.4059791564941,21776,5656,16120,16120,0,15,5840000.0
5840,5840999,20.62918847426376,38.00265606290294,0.07586305829572704,902.5488879680634,385.77668619155884,668.4388732910156,21788,5658,16130,16130,0,15,5841000.0
5841,5841999,20.631050254917657,38.00718368276136,0.07588408340146668,902.6672239303589,385.8430869579315,668.6321067810059,21788,5658,16130,16130,0,15,5842000.0
5842,5842999,20.633313260293974,38.01234042745471,0.07592513419390823,902.8631632328033,385.9135935306549,668.6836776733398,21790,5659,16131,16131,0,15,5843000.0
5843,5843999,20.63527130413995,38.01486723692366,0.0759615829936986,902.9914338588715,385.9803011417389,668.8210144042969,21790,5659,16131,16131,0,15,5844000.0
5844,5844999,20.637962366018613,38.02114002198737,0.07599536660139561,903.1737947463989,386.0472662448883,668.8855247497559,21792,5660,16132,16132,0,15,5845000.0
5845,5845999,20.640086143208453,38.024716142915075,0.07603839288954328,903.3238441944122,386.11398911476135,668.9802322387695,21792,5660,16132,16132,0,15,5846000.0
5846,5846999,20.642960450668504,38.029294190073614,0.07609395979193767,903.4446833133698,386.1817235946655,669.1199150085449,21792,5660,16132,16132,0,15,5847000.0
5847,5847999,20.644384657068343,38.030510024828025,0.07610689633171719,903.6264352798462,386.2486996650696,669.4514236450195,21805,5661,16144,16144,0,15,5848000.0
5848,5848999,20.64362028546499,38.03071409682512,0.07609352996952734,903.7400240898132,386.3146028518677,670.2271347045898,21821,5661,16160,16160,0,15,5849000.0
5849,5849999,20.64279053020682,38.02960946204171,0.07609461482225177,903.8530070781708,386.37943053245544,670.5466156005859,21822,5661,16161,16161,0,15,5850000.0
5850,5850999,20.641842041220023,38.02786713055155,0.0760974213693516,904.031979560852,386.44545459747314,670.7217102050781,21826,5662,16164,16164,0,15,5851000.0
5851,5851999,20.640962360547746,38.026035389412144,0.07609690650838674,904.3039236068726,386.51165413856506,670.7999076843262,21832,5665,16167,16167,0,15,5852000.0
5852,5852999,20.63999619122678,38.027571584905445,0.07608684403766397,904.4829037189484,386.57782459259033,670.9609680175781,21834,5666,16168,16168,0,15,5853000.0
5853,5853999,20.63897609751229,38.025486043152114,0.07608908473739218,904.6573452949524,386.64424180984497,671.109016418457,21836,5667,16169,16169,0,15,5854000.0
5854,5854999,20.637907219893346,38.02324910027937,0.07609364613513414,904.8343091011047,386.7112467288971,671.2289123535156,21838,5668,16170,16170,0,15,5855000.0
5855,5855999,20.63690955697824,38.02149183281124,0.07609429538527035,905.0155494213104,386.7769093513489,671.3162231445312,21840,5669,16171,16171,0,15,5856000.0
5856,5856999,20.63589405920458,38.01951657971938,0.07609790229710967,905.2460827827454,386.8432939052582,671.3432579040527,21844,5671,16173,16173,0,15,5857000.0
5857,5857999,20.63499925195857,38.01778500439701,0.07610009754876945,905.4314496517181,386.90924882888794,671.4498252868652,21846,5672,16174,16174,0,15,5858000.0
5858,5858999,20.63414925162582,38.016142206765025,0.07610095368897185,905.5484607219696,386.9751989841461,671.583740234375,21846,5672,16174,16174,0,15,5859000.0
5859,5859999,20.63310785241607,38.01401775254199,0.07610862445867705,905.7348306179047,387.04125356674194,671.6518211364746,21848,5673,16175,16175,0,15,5860000.0
5860,5860999,20.632281600278638,38.01222416481334,0.07611430394105134,905.9601635932922,387.10752177238464,671.6559295654297,21851,5675,16176,16176,0,15,5861000.0
5861,5861999,20.631500321489263,38.01073349215745,0.07611955564005823,906.1346273422241,387.1735656261444,671.737979888916,21853,5676,16177,16177,0,15,5862000.0
5862,5862999,20.630665759344215,38.00874056889856,0.07612776599347248,906.3098783493042,387.2399368286133,671.7994956970215,21855,5677,16178,16178,0,15,5863000.0
5863,5863999,20.62981602058344,38.006929343058474,0.07613400030133277,906.4965078830719,387.30622148513794,671.8660278320312,21857,5678,16179,16179,0,15,5864000.0
5864,5864999,20.629000024907608,38.00501635228021,0.0761332804172481,906.6913142204285,387.37290263175964,672.170711517334,21877,5679,16198,16198,0,15,5865000.0
5865,5865999,20.628397310871055,38.00410492894424,0.07611086806049527,906.8039197921753,387.43870091438293,672.8114013671875,21888,5679,16209,16209,0,15,5866000.0
5866,5866999,20.628051032258437,38.00390447125667,0.07609216419800124,906.9145753383636,387.50377917289734,673.1037178039551,21889,5679,16210,16210,0,15,5867000.0
5867,5867999,20.62743399965734,38.002028162793145,0.07608481915287924,907.1459465026855,387.56973218917847,673.1881828308105,21893,5681,16212,16212,0,15,5868000.0
5868,5868999,20.626943338834973,38.00197589614463,0.07607347834817535,907.360532283783,387.63553977012634,673.3827934265137,21898,5683,16215,16215,0,15,5869000.0
5869,5869999,20.626578776415528,38.0012787725605,0.07606348258340145,907.6867828369141,387.7027339935303,673.4071922302246,21914,5687,16227,16227,0,15,5870000.0
5870,5870999,20.62605319975593,37.999599936299816,0.07606074421791342,907.912157535553,387.7699248790741,673.4976348876953,21918,5689,16229,16229,0,15,5871000.0
5871,5871999,20.625538247067485,37.99960151737355,0.07605472416911896,908.1368732452393,387.8369288444519,673.6911811828613,21924,5691,16233,16233,0,15,5872000.0
5872,5872999,20.62496586413696,37.998124012239046,0.07605149519101773,908.4156150817871,387.90393805503845,673.7809906005859,21930,5694,16236,16236,0,15,5873000.0
5873,5873999,20.624407462529344,37.996828353891054,0.0760440701699574,908.5901417732239,387.9716520309448,673.9549179077148,21932,5695,16237,16237,0,15,5874000.0
5874,5874999,20.62392625590536,37.99578104506522,0.07603640229123021,908.7142045497894,388.03792357444763,674.150764465332,21932,5695,16237,16237,0,15,5875000.0
5875,5875999,20.623486952596355,37.99458802927449,0.07603056490658056,908.8887462615967,388.10521602630615,674.2226829528809,21934,5696,16238,16238,0,15,5876000.0
5876,5876999,20.623136355947977,37.99394001455564,0.07602207540990447,909.0737266540527,388.1716191768646,674.291820526123,21936,5697,16239,16239,0,15,5877000.0
5877,5877999,20.623034238257333,37.99325871500192,0.0760150058713831,909.2464797496796,388.2384533882141,674.386646270752,21938,5698,16240,16240,0,15,5878000.0
5878,5878999,20.62306891063105,37.99305597301105,0.07600439755744492,909.4253587722778,388.3048527240753,674.4489212036133,21940,5699,16241,16241,0,15,5879000.0
5879,5879999,20.623162626953995,37.9925210276723,0.07599569700017883,909.6154305934906,388.3727352619171,674.5181274414062,21942,5700,16242,16242,0,15,5880000.0
5880,5880999,20.623723601777375,37.99286037694262,0.07598504471423417,909.742888212204,388.4388749599457,674.6529731750488,21942,5700,16242,16242,0,15,5881000.0
5881,5881999,20.623990657968385,37.992286578972184,0.07597670639338827,909.8696053028107,388.50590920448303,674.7164001464844,21942,5700,16242,16242,0,15,5882000.0
5882,5882999,20.624188721811045,37.99164520257936,0.07597008890547796,910.0530211925507,388.5729789733887,674.738353729248,21943,5701,16242,16242,0,15,5883000.0
5883,5883999,20.624585334713746,37.992151135471765,0.07595366615803079,910.2402396202087,388.64046025276184,674.8235092163086,21945,5702,16243,16243,0,15,5884000.0
5884,5884999,20.624434618528834,37.99283635793802,0.07593749073304101,910.4742612838745,388.70895409584045,675.4649467468262,21988,5704,16284,16284,0,15,5885000.0
5885,5885999,20.62346198538152,37.99060799885595,0.07592851973473891,910.5851736068726,388.7752709388733,675.911563873291,21990,5704,16286,16286,0,15,5886000.0
5886,5886999,20.62254855620104,37.98872904263234,0.07592313509324455,910.7530624866486,388.84081411361694,676.1291580200195,22000,5705,16295,16295,0,15,5887000.0
5887,5887999,20.621690702895183,37.98688647613543,0.07591934611346352,910.9766087532043,388.90680265426636,676.2720336914062,22004,5707,16297,16297,0,15,5888000.0
5888,5888999,20.620892778267752,37.98544231828119,0.07591774281621244,911.2984449863434,388.9734835624695,676.3419303894043,22012,5711,16301,16301,0,15,5889000.0
5889,5889999,20.620470319096697,37.98434103775328,0.07591260873113248,911.4680979251862,389.04029846191406,676.5808792114258,22015,5712,16303,16303,0,15,5890000.0
5890,5890999,20.620495708038327,37.98728396381441,0.07589153144444927,911.7092416286469,389.1073372364044,676.6562881469727,22026,5714,16312,16312,0,15,5891000.0
5891,5891999,20.619948397812703,37.98588968762333,0.07588896234651576,911.928662776947,389.174222946167,676.7728157043457,22030,5716,16314,16314,0,15,5892000.0
5892,5892999,20.61966978389593,37.98469343296574,0.07588720441650487,912.1042778491974,389.2405774593353,676.8889274597168,22032,5717,16315,16315,0,15,5893000.0
5893,5893999,20.61947941260892,37.98355414834009,0.07589012044952059,912.2923631668091,389.3072109222412,676.9715614318848,22034,5718,16316,16316,0,15,5894000.0
5894,5894999,20.61925549050881,37.982326775549616,0.07589314833118399,912.4735386371613,389.37392950057983,677.0649566650391,22036,5719,16317,16317,0,15,5895000.0
5895,5895999,20.618845911439642,37.98065737309303,0.07589512658898145,912.6539499759674,389.4412474632263,677.1711463928223,22046,5720,16326,16326,0,15,5896000.0
5896,5896999,20.61904624165159,37.98028539877932,0.07589395378011943,912.8894007205963,389.50838565826416,677.1277656555176,22050,5722,16328,16328,0,15,5897000.0
5897,5897999,20.61933408824163,37.9826343687211,0.07589372032213326,913.012689113617,389.57481813430786,677.2341499328613,22050,5722,16328,16328,0,15,5898000.0
5898,5898999,20.61954158542854,37.98231689128094,0.07589630078142351,913.1395852565765,389.6411621570587,677.3912620544434,22050,5722,16328,16328,0,15,5899000.0
5899,5899999,20.619791824205773,37.9816538261453,0.07589871070032106,913.3189988136292,389.7077383995056,677.4238967895508,22052,5723,16329,16329,0,15,5900000.0
5900,5900999,20.62124231052908,37.98326230584254,0.0759128384926192,913.4562950134277,389.77424907684326,677.4974708557129,22052,5723,16329,16329,0,15,5901000.0
5901,5901999,20.622052862591683,37.983621763751245,0.07592418846512705,913.6420750617981,389.84112095832825,677.5846786499023,22054,5724,16330,16330,0,15,5902000.0
5902,5902999,20.62270499732241,37.983093733760555,0.07594477618806039,913.7729558944702,389.9076793193817,677.6630897521973,22054,5724,16330,16330,0,15,5903000.0
5903,5903999,20.623024071089457,37.98263532053946,0.07595224169016845,913.9988586902618,389.97495317459106,677.645938873291,22058,5726,16332,16332,0,15,5904000.0
5904,5904999,20.623492324167465,37.982097874332084,0.07596628339604072,914.1412560939789,390.0421943664551,677.7598762512207,22058,5726,16332,16332,0,15,5905000.0
5905,5905999,20.622976604402954,37.98054503715666,0.07596679713717935,914.3175148963928,390.1091420650482,678.7696113586426,22108,5727,16381,16381,0,15,5906000.0
5906,5906999,20.62155561817621,37.979195582068286,0.07596705002717452,916.9105627536774,390.17566752433777,679.4273414611816,22116,5727,16389,16389,0,15,5907000.0
5907,5907999,20.620356104137315,37.9774730615308,0.07596797490880869,917.0286293029785,390.2419180870056,679.8080711364746,22119,5727,16392,16392,0,15,5908000.0
5908,5908999,20.61949781955237,37.97654207913646,0.07596499742133822,917.3067061901093,390.30825686454773,679.935489654541,22125,5730,16395,16395,0,15,5909000.0
5909,5909999,20.61841057306793,37.97452914069422,0.07596608993948739,917.5385222434998,390.37596011161804,680.1437759399414,22129,5732,16397,16397,0,15,5910000.0
5910,5910999,20.617484327952106,37.97246018889393,0.07596778713570917,917.7143518924713,390.4424681663513,680.4050025939941,22131,5733,16398,16398,0,15,5911000.0
5911,5911999,20.616388444718464,37.970319311686964,0.07597075938668452,917.8944108486176,390.50950384140015,680.5475196838379,22133,5734,16399,16399,0,15,5912000.0
5912,5912999,20.615602822325275,37.96883404929342,0.07596907191876456,918.1282687187195,390.5768964290619,680.6732292175293,22137,5736,16401,16401,0,15,5913000.0
5913,5913999,20.614652883453765,37.96703103426264,0.07597102612587303,918.3216478824615,390.6439733505249,680.7821617126465,22139,5737,16402,16402,0,15,5914000.0
5914,5914999,20.614081020300205,37.968133724541474,0.07595907810121671,918.5546176433563,390.71088671684265,680.8433609008789,22143,5739,16404,16404,0,15,5915000.0
5915,5915999,20.61343876030764,37.96690482292846,0.07596231891656191,918.7302982807159,390.7772912979126,680.9742050170898,22145,5740,16405,16405,0,15,5916000.0
5916,5916999,20.613057727640243,37.96616287146025,0.07596259628930124,918.969081401825,390.8443794250488,680.987247467041,22157,5742,16415,16415,0,15,5917000.0
5917,5917999,20.612737867146308,37.965049247828645,0.07596290565896602,919.1577842235565,390.91113233566284,681.0913772583008,22159,5743,16416,16416,0,15,5918000.0
5918,5918999,20.612585415592847,37.96467613333759,0.07597218179758236,919.3860001564026,390.97807240486145,681.1708869934082,22163,5745,16418,16418,0,15,5919000.0
5919,5919999,20.612716534923706,37.96594265742872,0.07597009747782257,919.5854346752167,391.04512214660645,681.3084259033203,22165,5746,16419,16419,0,15,5920000.0
5920,5920999,20.61310752592911,37.966023662427666,0.07597286568770478,919.8683149814606,391.1122453212738,681.3050537109375,22178,5749,16429,16429,0,15,5921000.0
5921,5921999,20.613635413308305,37.966166994352896,0.07598089189004609,920.0479865074158,391.17919659614563,681.4475326538086,22180,5750,16430,16430,0,15,5922000.0
5922,5922999,20.613995884990572,37.96590168053558,0.07599389347121643,920.2391350269318,391.2478618621826,681.5600166320801,22182,5751,16431,16431,0,15,5923000.0
5923,5923999,20.614086492276066,37.965555054864275,0.07600347516311678,920.423024892807,391.3144254684448,681.5899238586426,22184,5752,16432,16432,0,15,5924000.0
5924,5924999,20.614312917313452,37.96510320053204,0.07600195259067899,920.5658557415009,391.3813364505768,681.7566833496094,22184,5752,16432,16432,0,15,5925000.0
5925,5925999,20.61395910926798,37.963739528883835,0.07600937721476098,920.8049626350403,391.44899010658264,682.4197540283203,22211,5754,16457,16457,0,15,5926000.0
5926,5926999,20.612478746059075,37.96128442319013,0.07601576692560907,920.9233689308167,391.51497054100037,682.9015350341797,22216,5754,16462,16462,0,15,5927000.0
5927,5927999,20.611389115636236,37.959597601907525,0.07601263757799948,921.0449106693268,391.5820908546448,683.2374114990234,22218,5754,16464,16464,0,15,5928000.0
5928,5928999,20.61037414204405,37.95791463909659,0.07601157681856818,921.2813150882721,391.64783000946045,683.335750579834,22223,5756,16467,16467,0,15,5929000.0
5929,5929999,20.60954499137644,37.95723334340967,0.07600742431473706,921.5713315010071,391.7144603729248,683.5031394958496,22230,5759,16471,16471,0,15,5930000.0
5930,5930999,20.60870918531322,37.955426814213176,0.07600467048365034,921.7492611408234,391.78054881095886,683.7278442382812,22232,5760,16472,16472,0,15,5931000.0
5931,5931999,20.607754669706253,37.95351141007601,0.07600363926476972,921.8783159255981,391.8469727039337,683.8911781311035,22232,5760,16472,16472,0,15,5932000.0
5932,5932999,20.607000684188485,37.95206195375018,0.0759984499919486,922.0685231685638,391.9131746292114,683.985954284668,22235,5761,16474,16474,0,15,5933000.0
5933,5933999,20.606182773654623,37.950121677489456,0.07599812825480645,922.4173467159271,391.979953289032,683.9510841369629,22243,5765,16478,16478,0,15,5934000.0
5934,5934999,20.60581378752388,37.948917415399855,0.07599514004519348,922.5427927970886,392.04581594467163,684.1409111022949,22243,5765,16478,16478,0,15,5935000.0
5935,5935999,20.605802018779475,37.94834817799512,0.07599144321919138,922.6683416366577,392.1118104457855,684.2807197570801,22243,5765,16478,16478,0,15,5936000.0
5936,5936999,20.606185385002203,37.94887922070972,0.07598234382011593,922.794266462326,392.1777195930481,684.4148025512695,22243,5765,16478,16478,0,15,5937000.0
5937,5937999,20.606803884017904,37.94936704638082,0.0759759604009066,922.972412109375,392.2440369129181,684.4701385498047,22245,5766,16479,16479,0,15,5938000.0
5938,5938999,20.60732588624874,37.949602312110144,0.07597778018132328,923.3729708194733,392.31198716163635,684.3294067382812,22255,5771,16484,16484,0,15,5939000.0
5939,5939999,20.607844899325983,37.94980983996747,0.07598428984655636,923.5671670436859,392.37907242774963,684.4530830383301,22257,5772,16485,16485,0,15,5940000.0
5940,5940999,20.60864373893887,37.95030585547004,0.07599560785363502,923.6934986114502,392.4453902244568,684.6000061035156,22257,5772,16485,16485,0,15,5941000.0
5941,5941999,20.60980588851654,37.9512631034592,0.07600606213999728,923.8728234767914,392.5120644569397,684.6570739746094,22259,5773,16486,16486,0,15,5942000.0
5942,5942999,20.610732020748255,37.95174276102437,0.07601058482839607,923.9998722076416,392.5791313648224,684.8192749023438,22259,5773,16486,16486,0,15,5943000.0
5943,5943999,20.611308531368625,37.95169510889569,0.07602023425525717,924.1337971687317,392.645756483078,684.9149398803711,22259,5773,16486,16486,0,15,5944000.0
5944,5944999,20.611855066054748,37.95157439289336,0.07602398339044325,924.3795650005341,392.7155704498291,684.9309959411621,22271,5775,16496,16496,0,15,5945000.0
5945,5945999,20.612311138690735,37.95107032722647,0.07602089331512263,924.5257720947266,392.78194665908813,685.0535621643066,22271,5775,16496,16496,0,15,5946000.0
5946,5946999,20.6115401147488,37.94954070843865,0.07601293721175217,924.6486365795135,392.8489611148834,686.0421371459961,22301,5775,16526,16526,0,15,5947000.0
5947,5947999,20.610458382811537,37.94784059803313,0.07601310322191113,924.763528585434,392.91507720947266,686.5280914306641,22306,5775,16531,16531,0,15,5948000.0
5948,5948999,20.60968581087752,37.946838955242626,0.0760120073405578,924.9882838726044,392.9810993671417,686.6859741210938,22311,5777,16534,16534,0,15,5949000.0
5949,5949999,20.60889505317195,37.94506885247818,0.07601548364554889,925.1571831703186,393.0472722053528,686.9212875366211,22313,5778,16535,16535,0,15,5950000.0
5950,5950999,20.608087255267215,37.94322546657188,0.07601877537434021,925.3855774402618,393.11375403404236,687.1082954406738,22317,5780,16537,16537,0,15,5951000.0
5951,5951999,20.607600769782717,37.942822802371865,0.07601251823980992,925.7242383956909,393.18086314201355,687.1917762756348,22325,5784,16541,16541,0,15,5952000.0
5952,5952999,20.606603654903815,37.9410527980962,0.07601323560236617,925.9059405326843,393.2477481365204,687.325267791748,22327,5785,16542,16542,0,15,5953000.0
5953,5953999,20.60585452943596,37.9393742718669,0.07601547076364745,926.1399326324463,393.3148822784424,687.4471092224121,22331,5787,16544,16544,0,15,5954000.0
5954,5954999,20.60546168466307,37.93864046203856,0.07601227851365755,926.3216631412506,393.3822371959686,687.5770568847656,22333,5788,16545,16545,0,15,5955000.0
5955,5955999,20.605083583919672,37.93739291125196,0.0760113219681332,926.5067212581635,393.44894766807556,687.6592025756836,22335,5789,16546,16546,0,15,5956000.0
5956,5956999,20.60455061398637,37.93626266399851,0.07601535507345492,926.7539639472961,393.51598048210144,687.7380523681641,22339,5791,16548,16548,0,15,5957000.0
5957,5957999,20.604290226649034,37.935121706919084,0.07601987284794154,926.9375777244568,393.583025932312,687.8592147827148,22341,5792,16549,16549,0,15,5958000.0
5958,5958999,20.604136201950098,37.93496296496723,0.07602688089229592,927.0592586994171,393.6498990058899,688.0037002563477,22341,5792,16549,16549,0,15,5959000.0
5959,5959999,20.604296295671215,37.93510809889034,0.07602811414328525,927.1838302612305,393.716379404068,688.1013412475586,22341,5792,16549,16549,0,15,5960000.0
5960,5960999,20.60413001280954,37.934310270227336,0.07603376823993746,927.3939037322998,393.7837703227997,688.1795616149902,22343,5793,16550,16550,0,15,5961000.0
5961,5961999,20.60449736086232,37.93472941114048,0.0760421428378375,927.5108079910278,393.8500256538391,688.2775611877441,22343,5793,16550,16550,0,15,5962000.0
5962,5962999,20.60456364463132,37.934097953110296,0.07605411090471192,927.8100683689117,393.9177141189575,688.2523422241211,22349,5796,16553,16553,0,15,5963000.0
5963,5963999,20.60470140060258,37.93345942649531,0.07605865413178248,928.0045585632324,393.9867684841156,688.328254699707,22351,5797,16554,16554,0,15,5964000.0
5964,5964999,20.60483414984146,37.93295259431243,0.07606053638458166,928.2613747119904,394.05437994003296,688.2993049621582,22354,5799,16555,16555,0,15,5965000.0
5965,5965999,20.605396407560047,37.932750506013974,0.07605934589887986,928.3906140327454,394.1212236881256,688.4579925537109,22354,5799,16555,16555,0,15,5966000.0
5966,5966999,20.605087169447796,37.9314619365681,0.07605240519216616,928.5893366336823,394.1889235973358,688.5141983032227,22356,5800,16556,16556,0,15,5967000.0
5967,5967999,20.604642617717,37.931429284144,0.07601938903298644,928.7275640964508,394.26162791252136,689.4729537963867,22383,5800,16583,16583,0,15,5968000.0
5968,5968999,20.60355638580445,37.92926628468617,0.07602116188013563,928.8442373275757,394.3278648853302,689.9163475036621,22386,5800,16586,16586,0,15,5969000.0
5969,5969999,20.602427541399035,37.92715924298866,0.07602307152730847,928.9681463241577,394.39417934417725,690.1590385437012,22386,5800,16586,16586,0,15,5970000.0
5970,5970999,20.60177850565214,37.9256899905753,0.07602278968993992,929.2500684261322,394.4610779285431,690.2336082458496,22392,5803,16589,16589,0,15,5971000.0
5971,5971999,20.6011868759092,37.92452279138567,0.07601746841757606,929.481906414032,394.5279395580292,690.4023475646973,22396,5805,16591,16591,0,15,5972000.0
5972,5972999,20.60071314750789,37.923468658554214,0.07600964222723694,929.6533682346344,394.594749212265,690.6006202697754,22398,5806,16592,16592,0,15,5973000.0
5973,5973999,20.600333139683915,37.925270574342,0.07599161969925772,929.9358615875244,394.6618797779083,690.5923881530762,22404,5809,16595,16595,0,15,5974000.0
5974,5974999,20.599758988125156,37.92365510269683,0.0759888700324074,930.171578168869,394.72952461242676,690.7388496398926,22408,5811,16597,16597,0,15,5975000.0
5975,5975999,20.59952502279001,37.92259478379277,0.07598138717010505,930.4060463905334,394.79738426208496,690.7835884094238,22425,5813,16612,16612,0,15,5976000.0
5976,5976999,20.599560812797453,37.922546652260564,0.07597287759211624,930.5941262245178,394.8647553920746,690.886157989502,22427,5814,16613,16613,0,15,5977000.0
5977,5977999,20.599816668758034,37.923040392362594,0.07598180502341179,930.784321308136,394.93276715278625,691.0054397583008,22429,5815,16614,16614,0,15,5978000.0
5978,5978999,20.600061752789642,37.924881383163495,0.07598802884638678,930.9651629924774,395.0001382827759,691.1110000610352,22432,5816,16616,16616,0,15,5979000.0
5979,5979999,20.60052101774311,37.9254031788149,0.07598867301606327,931.2619252204895,395.06837797164917,691.1018104553223,22446,5819,16627,16627,0,15,5980000.0
5980,5980999,20.601231257968127,37.92686637142057,0.07599724276912301,931.4030120372772,395.1399371623993,691.2263298034668,22446,5819,16627,16627,0,15,5981000.0
5981,5981999,20.601860784427835,37.92758297377711,0.07600076541324696,931.5863182544708,395.2096381187439,691.337474822998,22448,5820,16628,16628,0,15,5982000.0
5982,5982999,20.60261827596239,37.92886796202005,0.07601226368336045,931.8751449584961,395.2774772644043,691.3086395263672,22454,5823,16631,16631,0,15,5983000.0
5983,5983999,20.603473564851452,37.92983336366483,0.07601789594205821,932.0717160701752,395.3456165790558,691.4545783996582,22456,5824,16632,16632,0,15,5984000.0
5984,5984999,20.604310935132496,37.93087692331831,0.07603301152087993,932.3189342021942,395.4134249687195,691.4883155822754,22460,5826,16634,16634,0,15,5985000.0
5985,5985999,20.60542290397125,37.93230379497499,0.07604027687584192,932.4451611042023,395.48065638542175,691.6069717407227,22460,5826,16634,16634,0,15,5986000.0
5986,5986999,20.60690461795874,37.93456661434387,0.07604912676015407,932.5815482139587,395.54872393608093,691.7176132202148,22460,5826,16634,16634,0,15,5987000.0
5987,5987999,20.6072906808374,37.934397405489605,0.07604536537004658,932.7793071269989,395.6192123889923,691.7900390625,22462,5827,16635,16635,0,15,5988000.0
5988,5988999,20.60624910635365,37.932854381031795,0.07604234894156792,932.9056823253632,395.68654346466064,692.8846244812012,22493,5827,16666,16666,0,15,5989000.0
5989,5989999,20.604837326962276,37.9310218472546,0.07604749282259371,933.0235023498535,395.7523400783539,693.2777137756348,22493,5827,16666,16666,0,15,5990000.0
5990,5990999,20.603674659443726,37.92979429550829,0.07604959812226786,933.148656129837,395.8180561065674,693.5281829833984,22494,5827,16667,16667,0,15,5991000.0
5991,5991999,20.60255952792972,37.927889680156234,0.07605763783000818,933.3204190731049,395.8838367462158,693.6847839355469,22496,5828,16668,16668,0,15,5992000.0
5992,5992999,20.601420867790576,37.92611008122019,0.07606181720645833,933.5926246643066,395.95028257369995,693.8033027648926,22502,5831,16671,16671,0,15,5993000.0
5993,5993999,20.600249396555675,37.924088619579294,0.07606738808097713,934.0308775901794,396.01783204078674,693.7560653686523,22514,5837,16677,16677,0,15,5994000.0
5994,5994999,20.59908519005649,37.92189411572234,0.07607316653663465,934.2073156833649,396.084764957428,694.0161399841309,22516,5838,16678,16678,0,15,5995000.0
5995,5995999,20.59844815754375,37.92101385488547,0.07607290696456681,934.5013813972473,396.1526470184326,694.0451850891113,22522,5841,16681,16681,0,15,5996000.0
5996,5996999,20.597569932977795,37.919669611121215,0.0760782033859787,934.7387964725494,396.21995186805725,694.1506004333496,22526,5843,16683,16683,0,15,5997000.0
5997,5997999,20.596977233217952,37.91875538332659,0.07607578191450703,934.9316356182098,396.2880036830902,694.3072662353516,22536,5844,16692,16692,0,15,5998000.0
5998,5998999,20.59649017880179,37.9177974701979,0.0760747385724071,935.0530860424042,396.3547434806824,694.4676933288574,22536,5844,16692,16692,0,15,5999000.0
5999,5999999,20.59583649428001,37.91671984762562,0.07608146646685066,935.2418773174286,396.4218122959137,694.5264625549316,22538,5845,16693,16693,0,15,6000000.0
6000,6000999,20.59547025370342,37.91586893222756,0.07608907563780554,935.4319546222687,396.48920249938965,694.6315574645996,22540,5846,16694,16694,0,15,6001000.0
6001,6001999,20.594909945639213,37.91456601175385,0.0760945308451545,935.5801291465759,396.55618166923523,694.7300071716309,22540,5846,16694,16694,0,15,6002000.0
6002,6002999,20.59412112327887,37.91262742226276,0.07610609887654629,935.8217232227325,396.62398386001587,694.8103179931641,22544,5848,16696,16696,0,15,6003000.0
6003,6003999,20.593356609878004,37.910885124059384,0.07611483610154668,935.9980268478394,396.6908025741577,694.8744812011719,22551,5849,16702,16702,0,15,6004000.0
6004,6004999,20.592321074726566,37.90863905955274,0.0761273263760609,936.1292605400085,396.75703859329224,695.0180740356445,22551,5849,16702,16702,0,15,6005000.0
6005,6005999,20.59144026108459,37.907446207793484,0.0761268982136395,936.2615203857422,396.8240957260132,695.9269866943359,22579,5849,16730,16730,0,15,6006000.0
6006,6006999,20.59027727764648,37.90594273572404,0.07612804132306994,936.3770475387573,396.88943791389465,696.3681221008301,22584,5849,16735,16735,0,15,6007000.0
6007,6007999,20.589511478345504,37.91223465298936,0.0761059184567362,936.5484783649445,396.9555196762085,696.5931968688965,22587,5850,16737,16737,0,15,6008000.0
6008,6008999,20.588953433080178,37.91479437978609,0.07609758536425726,936.7695260047913,397.02137207984924,696.7564125061035,22596,5852,16744,16744,0,15,6009000.0
6009,6009999,20.58794900403625,37.91301866195386,0.07610174093952304,937.0519411563873,397.0882160663605,696.8487548828125,22602,5855,16747,16747,0,15,6010000.0
6010,6010999,20.586920662632927,37.91133113319894,0.07610380546232132,937.2728950977325,397.1556055545807,696.9669761657715,22606,5857,16749,16749,0,15,6011000.0
6011,6011999,20.585887829739946,37.909459349116105,0.07610540058901183,937.4557640552521,397.2223596572876,697.1687469482422,22609,5858,16751,16751,0,15,6012000.0
6012,6012999,20.58511886479409,37.908060083243235,0.0761041348538154,937.5752954483032,397.28853392601013,697.3256721496582,22609,5858,16751,16751,0,15,6013000.0
6013,6013999,20.58447213201704,37.9068194219797,0.07610157486385405,937.7643914222717,397.3552634716034,697.4080200195312,22611,5859,16752,16752,0,15,6014000.0
6014,6014999,20.583784387684375,37.905520908943075,0.07610068903251532,937.9416515827179,397.42198395729065,697.5158729553223,22613,5860,16753,16753,0,15,6015000.0
6015,6015999,20.583015959626717,37.90415379246987,0.07610129837033841,938.0702593326569,397.4883713722229,697.6454315185547,22613,5860,16753,16753,0,15,6016000.0
6016,6016999,20.582270434995277,37.90255071705703,0.07610098336284787,938.3481287956238,397.55530428886414,697.5645332336426,22619,5863,16756,16756,0,15,6017000.0
6017,6017999,20.581794181595185,37.901645511996286,0.07609758286156809,938.5823004245758,397.62249422073364,697.650520324707,22631,5865,16766,16766,0,15,6018000.0
6018,6018999,20.581378525254966,37.90207673961798,0.07609276866891479,938.7612254619598,397.68953013420105,697.7206649780273,22633,5866,16767,16767,0,15,6019000.0
6019,6019999,20.58080036727475,37.90061417138355,0.07610613732230942,938.9420478343964,397.7563738822937,697.7467613220215,22635,5867,16768,16768,0,15,6020000.0
6020,6020999,20.580634576825474,37.90018834100221,0.07610725954648678,939.1270554065704,397.8248496055603,697.8663291931152,22637,5868,16769,16769,0,15,6021000.0
6021,6021999,20.58020413692853,37.899283221940856,0.07611121251209318,939.2573029994965,397.8919563293457,697.9875679016113,22637,5868,16769,16769,0,15,6022000.0
6022,6022999,20.579594703726052,37.897772060913226,0.07611942091683943,939.4033155441284,397.9590525627136,698.0613327026367,22637,5868,16769,16769,0,15,6023000.0
6023,6023999,20.57894007958703,37.895999318652805,0.07612166563353095,939.5888998508453,398.02626609802246,698.1386451721191,22639,5869,16770,16770,0,15,6024000.0
6024,6024999,20.57821487124824,37.89438565505338,0.07612242933663427,939.7075734138489,398.0924687385559,698.7741851806641,22655,5869,16786,16786,0,15,6025000.0
6025,6025999,20.57741679270299,37.89388080557198,0.07611538234935644,939.8239974975586,398.1595275402069,699.6262817382812,22673,5869,16804,16804,0,15,6026000.0
6026,6026999,20.57625918303144,37.891604389235056,0.07611642312898115,939.9375450611115,398.2250294685364,700.0510330200195,22675,5869,16806,16806,0,15,6027000.0
6027,6027999,20.575120849601795,37.88999936113343,0.07611650260860703,940.0515007972717,398.29061245918274,700.3056259155273,22675,5869,16806,16806,0,15,6028000.0
6028,6028999,20.57401229351849,37.887942758882,0.07612022643325922,940.239667892456,398.356728553772,700.4694061279297,22684,5870,16814,16814,0,15,6029000.0
6029,6029999,20.57294589476716,37.886248578610065,0.07611959085384867,940.358747959137,398.42220878601074,700.7113838195801,22684,5870,16814,16814,0,15,6030000.0
6030,6030999,20.572165147135582,37.88534146208023,0.07611703340783871,940.5884630680084,398.4885184764862,700.7588882446289,22695,5872,16823,16823,0,15,6031000.0
6031,6031999,20.571223122178083,37.8833561738813,0.07611893424214844,940.7779967784882,398.55438327789307,700.7983474731445,22697,5873,16824,16824,0,15,6032000.0
6032,6032999,20.570142045998217,37.88117952556846,0.07612288599575057,940.901998758316,398.6200728416443,700.9689865112305,22697,5873,16824,16824,0,15,6033000.0
6033,6033999,20.56941037249339,37.879480184251186,0.07612235621816243,941.132217168808,398.68691897392273,700.9526023864746,22701,5875,16826,16826,0,15,6034000.0
6034,6034999,20.568636892593652,37.87803341276369,0.07612286261539458,941.3293645381927,398.75370478630066,701.0276069641113,22703,5876,16827,16827,0,15,6035000.0
6035,6035999,20.56794011005242,37.87628384919395,0.07612364751174838,941.5200753211975,398.8314645290375,701.1349601745605,22705,5877,16828,16828,0,15,6036000.0
6036,6036999,20.567351043724123,37.87473971310412,0.07612830616290744,941.6878533363342,398.89766454696655,701.2113037109375,22707,5878,16829,16829,0,15,6037000.0
6037,6037999,20.566786644936073,37.87348333071395,0.07613248144982299,941.8854496479034,398.9644808769226,701.2777366638184,22709,5879,16830,16830,0,15,6038000.0
6038,6038999,20.566287278350867,37.871992896202244,0.07613457708461113,942.0592257976532,399.03058671951294,701.3825149536133,22711,5880,16831,16831,0,15,6039000.0
6039,6039999,20.565592466457712,37.87039039747094,0.07613851655082937,942.1977937221527,399.0968565940857,701.4823913574219,22711,5880,16831,16831,0,15,6040000.0
6040,6040999,20.56483492234731,37.86860001019412,0.07614377617281753,942.4223680496216,399.1633229255676,701.5049057006836,22721,5882,16839,16839,0,15,6041000.0
6041,6041999,20.564320144434923,37.86727128700368,0.07614528559744871,942.5706403255463,399.23009729385376,701.6273307800293,22721,5882,16839,16839,0,15,6042000.0
6042,6042999,20.56355539700652,37.865383071435126,0.07615436861540315,942.7400968074799,399.29646587371826,701.6498985290527,22729,5883,16846,16846,0,15,6043000.0
6043,6043999,20.56285309549138,37.86363171632657,0.07616193684011052,942.8658571243286,399.36269760131836,701.7288780212402,22729,5883,16846,16846,0,15,6044000.0
6044,6044999,20.562161636213443,37.86190387303456,0.076170042198476,943.0721960067749,399.42951917648315,701.8199310302734,22731,5884,16847,16847,0,15,6045000.0
6045,6045999,20.5611878214958,37.859782565970725,0.07617726925837942,943.3595333099365,399.49764037132263,702.3710556030273,22757,5887,16870,16870,0,15,6046000.0
6046,6046999,20.559765702427338,37.85876604727218,0.07618752997147682,943.5292444229126,399.56413412094116,702.8012313842773,22770,5888,16882,16882,0,15,6047000.0
6047,6047999,20.558245934269767,37.857138167038784,0.07619932663353557,943.6405336856842,399.6296465396881,703.111701965332,22771,5888,16883,16883,0,15,6048000.0
6048,6048999,20.556672444691568,37.85473110243061,0.07621540377681446,943.8665518760681,399.6956102848053,703.2148284912109,22776,5890,16886,16886,0,15,6049000.0
6049,6049999,20.555272001446564,37.85266088169313,0.07622842721846379,944.0415406227112,399.7616741657257,703.3806457519531,22778,5891,16887,16887,0,15,6050000.0
6050,6050999,20.553890399099203,37.850262607406684,0.07623991046130618,944.2173058986664,399.82750844955444,703.5377082824707,22780,5892,16888,16888,0,15,6051000.0
6051,6051999,20.552473298885225,37.84799510806541,0.07625762789772494,944.4523272514343,399.8945896625519,703.628589630127,22784,5894,16890,16890,0,15,6052000.0
6052,6052999,20.551045777450806,37.84558700940082,0.07627649484649301,944.6905598640442,399.9612965583801,703.7194023132324,22796,5896,16900,16900,0,15,6053000.0
6053,6053999,20.5496562346112,37.84331560716996,0.07628933814438088,944.8110418319702,400.02737069129944,703.8750419616699,22796,5896,16900,16900,0,15,6054000.0
6054,6054999,20.548450714210464,37.84123297890843,0.07630428621256735,945.0533871650696,400.0951409339905,703.8986206054688,22800,5898,16902,16902,0,15,6055000.0
6055,6055999,20.5471141745984,37.83900768213655,0.07632240341341989,945.230043888092,400.161648273468,704.0110054016113,22802,5899,16903,16903,0,15,6056000.0
6056,6056999,20.545709088268058,37.83680646227848,0.07633877993649263,945.4622645378113,400.2285752296448,704.0974273681641,22806,5901,16905,16905,0,15,6057000.0
6057,6057999,20.54433415789539,37.834654519161596,0.0763555131475302,945.6571705341339,400.2963659763336,704.2211265563965,22808,5902,16906,16906,0,15,6058000.0
6058,6058999,20.5428303078109,37.83216263590465,0.07637448371840216,945.8359785079956,400.362713098526,704.3090400695801,22810,5903,16907,16907,0,15,6059000.0
6059,6059999,20.54148297190689,37.83025936935784,0.0763873619727039,946.0189654827118,400.4294054508209,704.4340057373047,22812,5904,16908,16908,0,15,6060000.0
6060,6060999,20.540286654819813,37.82853741457955,0.07640129774055426,946.1541292667389,400.495619058609,704.5165977478027,22812,5904,16908,16908,0,15,6061000.0
6061,6061999,20.539089945398864,37.82650064743375,0.07641137492443684,946.2761180400848,400.5615336894989,704.629035949707,22812,5904,16908,16908,0,15,6062000.0
6062,6062999,20.538266446745364,37.825295695606194,0.07642098703174172,946.4648668766022,400.6282408237457,704.6217613220215,22814,5905,16909,16909,0,15,6063000.0
6063,6063999,20.537275846227416,37.82392495720652,0.0764337463396293,946.6520133018494,400.69495272636414,704.6944961547852,22823,5906,16917,16917,0,15,6064000.0
6064,6064999,20.536309636152332,37.822299195857575,0.07644773368764812,946.7884571552277,400.76206398010254,704.7856101989746,22823,5906,16917,16917,0,15,6065000.0
6065,6065999,20.535013329576778,37.81997435053015,0.07646684867462272,946.9615845680237,400.82842206954956,704.8350143432617,22825,5907,16918,16918,0,15,6066000.0
6066,6066999,20.534388506000262,37.818007381658,0.07646580394636793,947.0795488357544,400.89342641830444,705.2820663452148,22826,5907,16919,16919,0,15,6067000.0
6067,6067999,20.53352237325699,37.81587497369954,0.07646563091929326,947.2020587921143,400.95830178260803,705.4570503234863,22826,5907,16919,16919,0,15,6068000.0
6068,6068999,20.532974418003192,37.81444186008928,0.07646032740867081,947.3775177001953,401.0232672691345,705.5031509399414,22828,5908,16920,16920,0,15,6069000.0
6069,6069999,20.53235638768264,37.81259483409364,0.07645819578081392,947.5488030910492,401.0884573459625,705.5602378845215,22830,5909,16921,16921,0,15,6070000.0
6070,6070999,20.531990955782337,37.811184602603184,0.07645332067875688,947.674783706665,401.15358686447144,705.6756286621094,22831,5909,16922,16922,0,15,6071000.0
6071,6071999,20.5314253476258,37.80934577222742,0.07645085851025513,947.802327632904,401.2184829711914,705.741096496582,22831,5909,16922,16922,0,15,6072000.0
6072,6072999,20.530942150138493,37.80776445908302,0.07645100697210927,948.1562747955322,401.28483629226685,705.5756912231445,22846,5913,16933,16933,0,15,6073000.0
6073,6073999,20.530381994639882,37.80616961583451,0.07645229360622907,948.3943519592285,401.35111951828003,705.5277671813965,22853,5915,16938,16938,0,15,6074000.0
6074,6074999,20.53004718886148,37.804814837185226,0.07645501382635778,948.5854377746582,401.4170768260956,705.5765533447266,22859,5916,16943,16943,0,15,6075000.0
6075,6075999,20.529565560260156,37.8035557715234,0.07645686626799597,948.7746405601501,401.4830906391144,705.6131782531738,22865,5917,16948,16948,0,15,6076000.0
6076,6076999,20.528997889443694,37.80195709084465,0.07645746344202764,948.9148111343384,401.54875779151917,705.7464599609375,22865,5917,16948,16948,0,15,6077000.0
6077,6077999,20.528471904113857,37.800227203055464,0.0764615193340561,949.0438163280487,401.61428213119507,705.8114395141602,22865,5917,16948,16948,0,15,6078000.0
6078,6078999,20.52779818685196,37.79838561399517,0.0764683135668085,949.1826071739197,401.68073439598083,705.8624458312988,22865,5917,16948,16948,0,15,6079000.0
6079,6079999,20.527135558381396,37.796605980407286,0.07647125048858783,949.3160169124603,401.7464418411255,705.9261779785156,22865,5917,16948,16948,0,15,6080000.0
6080,6080999,20.526567682361648,37.794868960439466,0.07647723652687721,949.5047566890717,401.81272149086,705.8671569824219,22871,5918,16953,16953,0,15,6081000.0
6081,6081999,20.525776052877532,37.79288895521238,0.0764836826776083,949.6961815357208,401.87857604026794,705.8173294067383,22873,5919,16954,16954,0,15,6082000.0
6082,6082999,20.525113193630315,37.7910638546528,0.07649114427026626,949.835262298584,401.94464445114136,705.8997383117676,22873,5919,16954,16954,0,15,6083000.0
6083,6083999,20.524472073640784,37.790078809629314,0.07649666360188112,949.9747846126556,402.0106382369995,705.942081451416,22873,5919,16954,16954,0,15,6084000.0
6084,6084999,20.523598475875712,37.78802212482643,0.07651042812943121,950.110842704773,402.07640314102173,706.0075302124023,22873,5919,16954,16954,0,15,6085000.0
6085,6085999,20.52259483297397,37.78589827147966,0.07652044604570496,950.3011252880096,402.14220428466797,706.0002288818359,22879,5920,16959,16959,0,15,6086000.0
6086,6086999,20.521469215776044,37.7837926588738,0.07652673581799763,950.4135322570801,402.20806336402893,706.8637657165527,22901,5920,16981,16981,0,15,6087000.0
6087,6087999,20.519903868657494,37.78152392076678,0.07653351271069364,950.5782809257507,402.2729957103729,707.2113761901855,22908,5921,16987,16987,0,15,6088000.0
6088,6088999,20.51842785649876,37.77990033659952,0.07653443548085725,950.7987809181213,402.3374938964844,707.4010200500488,22914,5923,16991,16991,0,15,6089000.0
6089,6089999,20.517111857082728,37.77805038535412,0.07654148179554598,950.9693295955658,402.4019572734833,707.6379890441895,22918,5924,16994,16994,0,15,6090000.0
6090,6090999,20.51586213305424,37.7758643501344,0.07654395014360316,951.3489153385162,402.46786522865295,707.6844329833984,22931,5929,17002,17002,0,15,6091000.0
6091,6091999,20.51457214780877,37.773684682003136,0.07654621949888485,951.6383965015411,402.53428316116333,707.7622032165527,22938,5932,17006,17006,0,15,6092000.0
6092,6092999,20.51336123587344,37.77291061915446,0.07654307087152123,951.8297202587128,402.600061416626,707.9885215759277,22942,5933,17009,17009,0,15,6093000.0
6093,6093999,20.51231627508124,37.771077867344694,0.07654441359279929,951.9487175941467,402.66479420661926,708.1903839111328,22943,5933,17010,17010,0,15,6094000.0
6094,6094999,20.51121014916005,37.76894859553202,0.07654631661532096,952.0799491405487,402.73023867607117,708.3678131103516,22946,5933,17013,17013,0,15,6095000.0
6095,6095999,20.51029928960155,37.767117452199464,0.07654734512603478,952.2038714885712,402.795458316803,708.5042037963867,22947,5933,17014,17014,0,15,6096000.0
6096,6096999,20.50934460255154,37.76517175432038,0.07655219401589486,952.3366329669952,402.86056995391846,708.659740447998,22949,5933,17016,17016,0,15,6097000.0
6097,6097999,20.508380640083605,37.76310532734394,0.07655881383011454,952.5023205280304,402.9253988265991,708.7284507751465,22951,5934,17017,17017,0,15,6098000.0
6098,6098999,20.50734568871682,37.76143354278019,0.07656281945505305,952.756388425827,402.990793466568,708.7350425720215,22955,5936,17019,17019,0,15,6099000.0
6099,6099999,20.50646813225728,37.75986935368969,0.07656391688993536,952.9444451332092,403.0558588504791,708.7407760620117,22956,5937,17019,17019,0,15,6100000.0
6100,6100999,20.5055391005729,37.758048870874624,0.0765631157822887,953.0641031265259,403.1212582588196,708.8875846862793,22956,5937,17019,17019,0,15,6101000.0
6101,6101999,20.504711243195413,37.75628600559351,0.07656534481797994,953.1904690265656,403.18627643585205,708.9870719909668,22957,5937,17020,17020,0,15,6102000.0
6102,6102999,20.503728731475494,37.75437414341201,0.07656836927009725,953.3286788463593,403.25212812423706,709.0844535827637,22957,5937,17020,17020,0,15,6103000.0
6103,6103999,20.50316779952262,37.753087928920024,0.07656463829431925,953.4575517177582,403.31705498695374,709.1636390686035,22957,5937,17020,17020,0,15,6104000.0
6104,6104999,20.50222397393787,37.75227614863162,0.07656384939088412,953.5978775024414,403.3827314376831,709.2286758422852,22957,5937,17020,17020,0,15,6105000.0
6105,6105999,20.501268312404182,37.75030231615303,0.07656695209461084,953.7142057418823,403.44733691215515,709.2837562561035,22957,5937,17020,17020,0,15,6106000.0
6106,6106999,20.50027524945555,37.74834864100604,0.07657014802886053,953.8529319763184,403.5125253200531,709.375373840332,22957,5937,17020,17020,0,15,6107000.0
6107,6107999,20.49983954002643,37.747025184746036,0.07655964715689079,954.0248997211456,403.57857179641724,710.2785606384277,22989,5938,17051,17051,0,15,6108000.0
6108,6108999,20.499067079168444,37.74607624204207,0.0765462485453059,954.2427659034729,403.64370465278625,710.5882263183594,22993,5940,17053,17053,0,15,6109000.0
6109,6109999,20.498028363929023,37.7440435826316,0.07654139966655815,954.4118132591248,403.7079598903656,710.7927894592285,22995,5941,17054,17054,0,15,6110000.0
6110,6110999,20.49698211471374,37.74190794808364,0.07654337306859615,954.5832824707031,403.772381067276,710.9725914001465,22997,5942,17055,17055,0,15,6111000.0
6111,6111999,20.49632364721195,37.74046082770136,0.07653463067191502,954.855438709259,403.83804082870483,711.1132354736328,23003,5945,17058,17058,0,15,6112000.0
6112,6112999,20.495767078881514,37.739023576308625,0.0765260122883854,955.0913641452789,403.90273547172546,711.1717567443848,23007,5947,17060,17060,0,15,6113000.0
6113,6113999,20.49506929316512,37.7373711327648,0.07652640980036862,955.3703203201294,403.9683201313019,711.2677764892578,23013,5950,17063,17063,0,15,6114000.0
6114,6114999,20.49431024534811,37.735557173826265,0.07652508580329487,955.4800581932068,404.0329439640045,711.4607391357422,23013,5950,17063,17063,0,15,6115000.0
6115,6115999,20.493398053144364,37.73351171644103,0.07652960353147209,955.664687871933,404.0995132923126,711.5834274291992,23015,5951,17064,17064,0,15,6116000.0
6116,6116999,20.492841054378527,37.73217743865646,0.07652655119694096,955.803190946579,404.1650013923645,711.7121887207031,23015,5951,17064,17064,0,15,6117000.0
6117,6117999,20.49205647218616,37.7303812701689,0.07652622566515133,955.9828407764435,404.23074173927307,711.8330955505371,23017,5952,17065,17065,0,15,6118000.0
6118,6118999,20.491499944318406,37.7288941458232,0.0765206442977231,956.106616973877,404.2959175109863,711.9359169006348,23017,5952,17065,17065,0,15,6119000.0
6119,6119999,20.490954399375415,37.727592754773184,0.0765137388384638,956.2316508293152,404.3610782623291,712.0208625793457,23017,5952,17065,17065,0,15,6120000.0
6120,6120999,20.490360853636936,37.72604141575601,0.0765093502209242,956.3653090000153,404.4263241291046,712.1077651977539,23017,5952,17065,17065,0,15,6121000.0
6121,6121999,20.48993903096492,37.724876527803474,0.07650177182244589,956.6055955886841,404.49253129959106,712.0785331726074,23021,5954,17067,17067,0,15,6122000.0
6122,6122999,20.489343235023583,37.723605141806516,0.07649910083099509,956.7196116447449,404.5583770275116,712.1875762939453,23021,5954,17067,17067,0,15,6123000.0
6123,6123999,20.48888384194343,37.72233783322082,0.0764932846330989,956.9147591590881,404.62393736839294,712.2328948974609,23023,5955,17068,17068,0,15,6124000.0
6124,6124999,20.488506389952946,37.721065203481636,0.07648609292307929,957.0437519550323,404.6891505718231,712.2982559204102,23023,5955,17068,17068,0,15,6125000.0
6125,6125999,20.487972860345618,37.71959224927017,0.07648179979573799,957.1775226593018,404.75515055656433,712.3598785400391,23023,5955,17068,17068,0,15,6126000.0
6126,6126999,20.48760419193079,37.71824373206987,0.07647474874522242,957.3836255073547,404.8208794593811,712.3829956054688,23025,5956,17069,17069,0,15,6127000.0
6127,6127999,20.486988028537272,37.71705133329587,0.07646956387026527,957.5012907981873,404.88581109046936,712.4756355285645,23025,5956,17069,17069,0,15,6128000.0
6128,6128999,20.486027740564424,37.715330729679394,0.07647220603633609,957.6682171821594,404.95228123664856,713.3227806091309,23043,5957,17086,17086,0,15,6129000.0
6129,6129999,20.48493075599173,37.7135958464416,0.07647758168149166,957.777223110199,405.0165183544159,713.7183990478516,23044,5957,17087,17087,0,15,6130000.0
6130,6130999,20.483814661523088,37.71140253923471,0.07648662505224868,957.9959418773651,405.0812842845917,713.8814125061035,23048,5959,17089,17089,0,15,6131000.0
6131,6131999,20.48301954680195,37.71032823946094,0.07648621103340503,958.2689716815948,405.14647340774536,714.0605087280273,23054,5962,17092,17092,0,15,6132000.0
6132,6132999,20.482156123453507,37.70902927003922,0.0764845868418681,958.4894161224365,405.213171005249,714.2691192626953,23059,5964,17095,17095,0,15,6133000.0
6133,6133999,20.48110418629892,37.70698137991613,0.07649072322207995,958.6762719154358,405.27869725227356,714.4091339111328,23061,5965,17096,17096,0,15,6134000.0
6134,6134999,20.48014502012909,37.705427758295116,0.07649271121851853,958.8541986942291,405.34394812583923,714.5328254699707,23063,5966,17097,17097,0,15,6135000.0
6135,6135999,20.479101378448018,37.703228255379955,0.07649998731356211,958.9722259044647,405.4086308479309,714.6873931884766,23063,5966,17097,17097,0,15,6136000.0
6136,6136999,20.478041575602337,37.701024121538346,0.07650814088473867,959.155026435852,405.47380089759827,714.7793769836426,23065,5967,17098,17098,0,15,6137000.0
6137,6137999,20.47710232855841,37.69897883320788,0.07651532211324608,959.2836420536041,405.53867197036743,714.9047050476074,23065,5967,17098,17098,0,15,6138000.0
6138,6138999,20.47633106947515,37.6972533370008,0.07651963938829998,959.4181983470917,405.60372591018677,714.9942817687988,23065,5967,17098,17098,0,15,6139000.0
6139,6139999,20.47534024155083,37.69519556363319,0.07652862930399917,959.5519592761993,405.668576002121,715.0582504272461,23065,5967,17098,17098,0,15,6140000.0
6140,6140999,20.474477165134473,37.69311057255881,0.07654014644139351,959.8476800918579,405.7345161437988,714.9735984802246,23079,5970,17109,17109,0,15,6141000.0
6141,6141999,20.47362853054821,37.69119566168902,0.07655319833843754,959.9761040210724,405.8005495071411,715.0641746520996,23079,5970,17109,17109,0,15,6142000.0
6142,6142999,20.472690407716662,37.68914106177449,0.07656362693007523,960.1719732284546,405.86577224731445,715.1187171936035,23081,5971,17110,17110,0,15,6143000.0
6143,6143999,20.47159303132927,37.6868663561084,0.07657993357514048,960.3003084659576,405.93084931373596,715.2403907775879,23081,5971,17110,17110,0,15,6144000.0
6144,6144999,20.470729566518767,37.68657168372874,0.07658417768151826,960.4191687107086,405.99641513824463,715.5211639404297,23089,5971,17118,17118,0,15,6145000.0
6145,6145999,20.469524878175157,37.684846806565915,0.07659491112899297,960.5313444137573,406.06273579597473,716.4929695129395,23108,5971,17137,17137,0,15,6146000.0
6146,6146999,20.46812439467902,37.68302699759947,0.07661389701376864,960.6406383514404,406.12737488746643,716.8161277770996,23109,5971,17138,17138,0,15,6147000.0
6147,6147999,20.46688983530027,37.681656596086896,0.07662559646844258,960.8066248893738,406.19189953804016,716.9799842834473,23111,5972,17139,17139,0,15,6148000.0
6148,6148999,20.465686224099066,37.679723962403145,0.07663743774420384,961.1009042263031,406.2658200263977,717.151065826416,23117,5975,17142,17142,0,15,6149000.0
6149,6149999,20.464494419315667,37.67786555541924,0.07664813571318341,961.3803374767303,406.33182883262634,717.2527618408203,23123,5978,17145,17145,0,15,6150000.0
6150,6150999,20.463311700351746,37.67582576845605,0.0766559430380176,961.6605448722839,406.3992955684662,717.3341979980469,23129,5981,17148,17148,0,15,6151000.0
6151,6151999,20.46208828484182,37.6737271529495,0.07666298352619416,961.95214676857,406.46628165245056,717.4656028747559,23135,5984,17151,17151,0,15,6152000.0
6152,6152999,20.46117140552062,37.67269726218418,0.07666382145248396,962.0739479064941,406.5319459438324,717.6626472473145,23135,5984,17151,17151,0,15,6153000.0
6153,6153999,20.460027164015493,37.67068802584263,0.07666847836204982,962.2928483486176,406.5978796482086,717.7492713928223,23139,5986,17153,17153,0,15,6154000.0
6154,6154999,20.4593210055324,37.6696606074962,0.07666595471890025,962.481282711029,406.664897441864,717.8853797912598,23141,5987,17154,17154,0,15,6155000.0
6155,6155999,20.45836939207284,37.668118146496816,0.07666722489972455,962.5996165275574,406.7307496070862,718.0179138183594,23141,5987,17154,17154,0,15,6156000.0
6156,6156999,20.45717173846004,37.66595054360415,0.07667277122123017,962.782797574997,406.7969398498535,718.0710639953613,23143,5988,17155,17155,0,15,6157000.0
6157,6157999,20.456392226288546,37.66448512780115,0.07667355212734794,962.9093127250671,406.86274123191833,718.2081756591797,23143,5988,17155,17155,0,15,6158000.0
6158,6158999,20.455668964917155,37.66295941155408,0.0766737407027488,963.1501426696777,406.92896008491516,718.2398223876953,23155,5990,17165,17165,0,15,6159000.0
6159,6159999,20.454931814500664,37.661377529621035,0.07667225249655474,963.3320007324219,406.9949073791504,718.2725296020508,23157,5991,17166,17166,0,15,6160000.0
6160,6160999,20.45437759185773,37.660077275848046,0.07666967114787049,963.4980070590973,407.06106424331665,718.35888671875,23159,5992,17167,17167,0,15,6161000.0
6161,6161999,20.45371073529742,37.65841373927929,0.07666546423495568,963.6386497020721,407.1271002292633,718.4498748779297,23159,5992,17167,17167,0,15,6162000.0
6162,6162999,20.453028564710813,37.656871515628126,0.07666417826672711,963.8559746742249,407.1979351043701,718.4935073852539,23161,5993,17168,17168,0,15,6163000.0
6163,6163999,20.452231907663293,37.65516100565169,0.0766639277605079,963.9931440353394,407.2696485519409,718.597240447998,23161,5993,17168,17168,0,15,6164000.0
6164,6164999,20.45132978905573,37.65305731071206,0.07666737097115517,964.2753846645355,407.33568596839905,718.8326530456543,23181,5996,17185,17185,0,15,6165000.0
6165,6165999,20.450392052126286,37.652449574642816,0.07666747444964861,964.3888511657715,407.40191626548767,719.3828353881836,23189,5996,17193,17193,0,15,6166000.0
6166,6166999,20.44936240099217,37.650716022168595,0.07667059795219999,964.5593724250793,407.4672853946686,719.6772537231445,23201,5997,17204,17204,0,15,6167000.0
6167,6167999,20.448243507727106,37.64875505088634,0.0766739826194992,964.8432881832123,407.5338463783264,719.8151321411133,23207,6000,17207,17207,0,15,6168000.0
6168,6168999,20.447323176928894,37.64714710799038,0.07667644234357662,965.0135583877563,407.59961128234863,719.9719200134277,23209,6001,17208,17208,0,15,6169000.0
6169,6169999,20.44640228803382,37.64589803805335,0.0766756998450242,965.2501244544983,407.6660649776459,720.0930862426758,23213,6003,17210,17210,0,15,6170000.0
6170,6170999,20.44533751241352,37.64385198045776,0.07668079517247528,965.543671131134,407.7329194545746,720.1565933227539,23219,6006,17213,17213,0,15,6171000.0
6171,6171999,20.44425185616621,37.641994099978525,0.07668631829078865,965.7189071178436,407.8000297546387,720.284797668457,23221,6007,17214,17214,0,15,6172000.0
6172,6172999,20.443249024333884,37.640158542018746,0.0766903130947919,965.9058711528778,407.8662085533142,720.4119148254395,23223,6008,17215,17215,0,15,6173000.0
6173,6173999,20.442096263472326,37.63801043732269,0.07669367573613683,966.0300397872925,407.93223667144775,720.5384178161621,23223,6008,17215,17215,0,15,6174000.0
6174,6174999,20.441358512879496,37.638795182844135,0.07668330062925666,966.2054371833801,407.99841690063477,720.5766792297363,23225,6009,17216,17216,0,15,6175000.0
6175,6175999,20.440439530501088,37.63697307008308,0.07668529394843981,966.4620158672333,408.06584644317627,720.6311912536621,23247,6011,17236,17236,0,15,6176000.0
6176,6176999,20.43987809274272,37.63582638070299,0.07668015821122987,966.6445319652557,408.1319591999054,720.7018394470215,23249,6012,17237,17237,0,15,6177000.0
6177,6177999,20.439125642777796,37.6344409180964,0.07667567016128973,966.7794134616852,408.1982524394989,720.7824249267578,23249,6012,17237,17237,0,15,6178000.0
6178,6178999,20.439104967046536,37.63401432991556,0.07666572009351413,966.9626636505127,408.2646608352661,720.8707809448242,23251,6013,17238,17238,0,15,6179000.0
6179,6179999,20.43896975977002,37.63347163698614,0.07665726408856455,967.1465902328491,408.3308928012848,720.922248840332,23261,6014,17247,17247,0,15,6180000.0
6180,6180999,20.43902218888029,37.6332239757734,0.0766490059596695,967.2813408374786,408.39702463150024,720.9937782287598,23261,6014,17247,17247,0,15,6181000.0
6181,6181999,20.439377665117604,37.63376891392571,0.07663479767914083,967.4665937423706,408.46340680122375,721.0184745788574,23271,6015,17256,17256,0,15,6182000.0
6182,6182999,20.439628574025498,37.63375582461994,0.07662732792836768,967.7803041934967,408.5310137271881,720.8636779785156,23277,6018,17259,17259,0,15,6183000.0
6183,6183999,20.439367920647015,37.632612757209756,0.07663066426089882,968.0143578052521,408.5982210636139,720.9296531677246,23281,6020,17261,17261,0,15,6184000.0
6184,6184999,20.43895238716073,37.63135652264174,0.07662815336962814,968.1964490413666,408.6669406890869,721.0721435546875,23283,6021,17262,17262,0,15,6185000.0
6185,6185999,20.438219864492204,37.629698262377,0.07662886269555103,968.3174526691437,408.733362197876,721.7447700500488,23308,6021,17287,17287,0,15,6186000.0
6186,6186999,20.436581090894034,37.627263006626215,0.0766414126955065,968.4272656440735,408.7992422580719,722.3055839538574,23312,6021,17291,17291,0,15,6187000.0
6187,6187999,20.435231886736336,37.625791171398504,0.07664701554135722,968.5383861064911,408.8646423816681,722.6776695251465,23312,6021,17291,17291,0,15,6188000.0
6188,6188999,20.43400324925899,37.6244003987649,0.0766498791415593,968.7043175697327,408.92962884902954,722.8636131286621,23315,6022,17293,17293,0,15,6189000.0
6189,6189999,20.432695715558488,37.62209470976725,0.07665759228101554,968.9311623573303,408.9955129623413,723.0469512939453,23320,6024,17296,17296,0,15,6190000.0
6190,6190999,20.431456176965355,37.620010552237794,0.076660064206579,969.208877325058,409.06188011169434,723.1495323181152,23335,6027,17308,17308,0,15,6191000.0
6191,6191999,20.43024787977027,37.61795639170446,0.07666424379873116,969.5446176528931,409.129358291626,723.167896270752,23343,6031,17312,17312,0,15,6192000.0
6192,6192999,20.429140297749548,37.615974086607075,0.07666968976291344,969.7174806594849,409.195437669754,723.3417053222656,23345,6032,17313,17313,0,15,6193000.0
6193,6193999,20.428030878862412,37.613889347495395,0.07667438090680423,969.902884721756,409.2617132663727,723.5281410217285,23347,6033,17314,17314,0,15,6194000.0
6194,6194999,20.427077071741,37.61209836580546,0.07667815116089449,970.0742404460907,409.32777762413025,723.6472663879395,23349,6034,17315,17315,0,15,6195000.0
6195,6195999,20.426293936451106,37.61045916884175,0.0766790458855644,970.3566551208496,409.3956618309021,723.6843528747559,23355,6037,17318,17318,0,15,6196000.0
6196,6196999,20.425721303412594,37.609101582707645,0.0766788333727646,970.4771711826324,409.46165561676025,723.8683624267578,23355,6037,17318,17318,0,15,6197000.0
6197,6197999,20.4249737248183,37.60746033140253,0.07668115145531329,970.7254822254181,409.5285367965698,723.9210395812988,23359,6039,17320,17320,0,15,6198000.0
6198,6198999,20.424235346333713,37.60572317536913,0.07668472251294234,970.8528289794922,409.59476685523987,724.0276832580566,23359,6039,17320,17320,0,15,6199000.0
6199,6199999,20.423871365316728,37.60468872380279,0.07668289251156712,971.033632516861,409.6610891819,724.121223449707,23361,6040,17321,17321,0,15,6200000.0
6200,6200999,20.423626927529785,37.60368055919619,0.07668131044480009,971.1640961170197,409.72797417640686,724.2320938110352,23361,6040,17321,17321,0,15,6201000.0
6201,6201999,20.42332297850628,37.60366212347015,0.07668430432794271,971.3990478515625,409.79578375816345,724.2562255859375,23365,6042,17323,17323,0,15,6202000.0
6202,6202999,20.422903329758714,37.60231085085204,0.07669191301055056,971.594363451004,409.8630893230438,724.3316383361816,23367,6043,17324,17324,0,15,6203000.0
6203,6203999,20.422671382834313,37.60118569268929,0.07669425691349718,971.8314619064331,409.92993450164795,724.327033996582,23371,6045,17326,17326,0,15,6204000.0
6204,6204999,20.4222406080689,37.59965964406682,0.07669811710217234,972.0661036968231,409.99732208251953,724.3320083618164,23375,6047,17328,17328,0,15,6205000.0
6205,6205999,20.42153394961985,37.597745572596544,0.07670170295773993,972.2486522197723,410.0640449523926,724.4133262634277,23377,6048,17329,17329,0,15,6206000.0
6206,6206999,20.420408226192357,37.59539969827885,0.0767139551654199,972.3705768585205,410.1302299499512,725.1956214904785,23396,6048,17348,17348,0,15,6207000.0
6207,6207999,20.419067691751586,37.59308209767022,0.07672573428369855,972.5454256534576,410.1950931549072,725.508731842041,23400,6049,17351,17351,0,15,6208000.0
6208,6208999,20.417828398496503,37.59108466159767,0.07673261062566261,972.6600461006165,410.2606885433197,725.7478561401367,23400,6049,17351,17351,0,15,6209000.0
6209,6209999,20.416569307568146,37.58875860141442,0.07674401601204728,972.8902900218964,410.3263053894043,725.8810653686523,23405,6051,17354,17354,0,15,6210000.0
6210,6210999,20.415643102622777,37.587058896955234,0.0767449621099896,973.0151953697205,410.39157366752625,726.0723762512207,23406,6051,17355,17355,0,15,6211000.0
6211,6211999,20.414679409458508,37.5852935595589,0.07674912330710248,973.1897122859955,410.45687317848206,726.1926460266113,23408,6052,17356,17356,0,15,6212000.0
6212,6212999,20.413582774402038,37.58350894106237,0.07675793492813687,973.4780759811401,410.5228946208954,726.2111625671387,23414,6055,17359,17359,0,15,6213000.0
6213,6213999,20.412581082715494,37.581888205917295,0.07676199957934282,973.7763006687164,410.5897123813629,726.2524185180664,23428,6058,17370,17370,0,15,6214000.0
6214,6214999,20.411482257520387,37.57989917601822,0.07676998854518313,974.0079410076141,410.65632700920105,726.3270072937012,23432,6060,17372,17372,0,15,6215000.0
6215,6215999,20.410411871087064,37.57807145066056,0.07677638918932239,974.2395951747894,410.7224292755127,726.3567199707031,23436,6062,17374,17374,0,15,6216000.0
6216,6216999,20.40966796311143,37.577163612686164,0.07677471526276336,974.4804747104645,410.78891825675964,726.4623336791992,23449,6064,17385,17385,0,15,6217000.0
6217,6217999,20.408581598430892,37.57515105833685,0.07678237950076194,974.6532249450684,410.8566224575043,726.5252876281738,23451,6065,17386,17386,0,15,6218000.0
6218,6218999,20.407582349240972,37.5732500702726,0.0767854422749551,974.8387413024902,410.9229345321655,726.6045303344727,23453,6066,17387,17387,0,15,6219000.0
6219,6219999,20.406533712762208,37.57134039886687,0.07678853747978731,974.966489315033,410.9890522956848,726.7427406311035,23453,6066,17387,17387,0,15,6220000.0
6220,6220999,20.405490890789363,37.56950745740033,0.07679181241703814,975.1643619537354,411.0562355518341,726.7885894775391,23463,6067,17396,17396,0,15,6221000.0
6221,6221999,20.404621919181146,37.56808164881601,0.07679047284582685,975.2922692298889,411.1220419406891,726.8694496154785,23463,6067,17396,17396,0,15,6222000.0
6222,6222999,20.40375822646154,37.566515365966985,0.07679168827663274,975.4136118888855,411.18764638900757,726.9704360961914,23463,6067,17396,17396,0,15,6223000.0
6223,6223999,20.402790008328317,37.56468476690837,0.0767947490618508,975.6058263778687,411.2537844181061,726.9599189758301,23465,6068,17397,17397,0,15,6224000.0
6224,6224999,20.40183572513607,37.56300396038024,0.07679505684588583,975.7309031486511,411.31997537612915,727.0472526550293,23465,6068,17397,17397,0,15,6225000.0
6225,6225999,20.40078944919997,37.56099758935484,0.0767990748910573,975.9247782230377,411.38729333877563,727.082633972168,23475,6069,17406,17406,0,15,6226000.0
6226,6226999,20.399584446762763,37.558741751058754,0.07680767431423319,976.10271525383,411.45349407196045,727.2071495056152,23480,6070,17410,17410,0,15,6227000.0
6227,6227999,20.398595218620322,37.55777217197092,0.07680792158566152,976.2780120372772,411.5204141139984,728.0301933288574,23501,6071,17430,17430,0,15,6228000.0
6228,6228999,20.397406820438253,37.555838072295806,0.07681306546913114,976.4468252658844,411.5860507488251,728.3672218322754,23504,6072,17432,17432,0,15,6229000.0
6229,6229999,20.396036927832355,37.55350165933104,0.07682329878857763,976.7199816703796,411.65210127830505,728.4634094238281,23511,6075,17436,17436,0,15,6230000.0
6230,6230999,20.395076601359325,37.55323893304481,0.07682701445152251,976.8852005004883,411.71809577941895,728.7631340026855,23514,6076,17438,17438,0,15,6231000.0
6231,6231999,20.393852311702137,37.55105979272244,0.07683132664702153,977.1237082481384,411.78455686569214,728.8903884887695,23518,6078,17440,17440,0,15,6232000.0
6232,6232999,20.39300617874773,37.549374684369795,0.07683095351105773,977.237776517868,411.85030937194824,729.1025543212891,23518,6078,17440,17440,0,15,6233000.0
6233,6233999,20.39215275270485,37.547921159820824,0.07682903838591193,977.44606590271,411.9167251586914,729.2096366882324,23527,6079,17448,17448,0,15,6234000.0
6234,6234999,20.39137870901247,37.54657082110919,0.07682739057901133,977.6243057250977,411.9851083755493,729.3339767456055,23529,6080,17449,17449,0,15,6235000.0
6235,6235999,20.390700275891028,37.54524755461051,0.07682457942954868,977.7933263778687,412.05147409439087,729.4064140319824,23540,6081,17459,17459,0,15,6236000.0
6236,6236999,20.39028436137546,37.544636589566146,0.07681603065054798,977.9897909164429,412.11825704574585,729.4496726989746,23542,6082,17460,17460,0,15,6237000.0
6237,6237999,20.389726078186342,37.543710267667834,0.07681513767418346,978.2720596790314,412.1848289966583,729.3858451843262,23557,6085,17472,17472,0,15,6238000.0
6238,6238999,20.389159965529736,37.543116879634226,0.07681563158597005,978.5609283447266,412.25218987464905,729.4174537658691,23563,6088,17475,17475,0,15,6239000.0
6239,6239999,20.38857242964055,37.541817575024844,0.07682083547406005,978.8537850379944,412.3196711540222,729.4137077331543,23569,6091,17478,17478,0,15,6240000.0
6240,6240999,20.387928440564078,37.54057840470569,0.07682368138463125,978.9909238815308,412.38644671440125,729.5966567993164,23569,6091,17478,17478,0,15,6241000.0
6241,6241999,20.387332249772758,37.53919746416887,0.07682323852256501,979.2808742523193,412.4537913799286,729.6106834411621,23575,6094,17481,17481,0,15,6242000.0
6242,6242999,20.386885923147762,37.53865948397021,0.07681596022999038,979.4083790779114,412.52083468437195,729.7445259094238,23575,6094,17481,17481,0,15,6243000.0
6243,6243999,20.38639172230095,37.537425902738725,0.07682091663875323,979.5350370407104,412.5877377986908,729.9048538208008,23575,6094,17481,17481,0,15,6244000.0
6244,6244999,20.385925562817825,37.536473795927186,0.0768194204813839,979.6847734451294,412.65447068214417,729.9863700866699,23575,6094,17481,17481,0,15,6245000.0
6245,6245999,20.385319110269077,37.53499275438971,0.07681474474780414,979.810977935791,412.7211833000183,730.0732421875,23575,6094,17481,17481,0,15,6246000.0
6246,6246999,20.38477360803796,37.53367119108284,0.07681280530198764,979.9398181438446,412.78806233406067,730.1604843139648,23575,6094,17481,17481,0,15,6247000.0
6247,6247999,20.383976430144237,37.53212859455824,0.0768114540091337,980.1219475269318,412.8547089099884,730.2187652587891,23586,6095,17491,17491,0,15,6248000.0
6248,6248999,20.382725482706235,37.53009929390914,0.07681981202833099,980.3008728027344,412.9226357936859,731.2973899841309,23624,6096,17528,17528,0,15,6249000.0
6249,6249999,20.381164199797535,37.52803430139794,0.07683177826931509,980.4225623607635,412.98900961875916,731.7261848449707,23626,6096,17530,17530,0,15,6250000.0
6250,6250999,20.380010860258697,37.52660594709897,0.0768357718331405,980.5320599079132,413.0545380115509,731.9762725830078,23627,6096,17531,17531,0,15,6251000.0
6251,6251999,20.379051451002166,37.525184724891346,0.07684149076360802,980.8633172512054,413.1212091445923,732.0581245422363,23635,6100,17535,17535,0,15,6252000.0
6252,6252999,20.377883641204882,37.52321182506831,0.07684448764628671,981.0326027870178,413.1882333755493,732.2407875061035,23637,6101,17536,17536,0,15,6253000.0
6253,6253999,20.376648282253157,37.52097923879008,0.07685374848560911,981.3158559799194,413.2557489871979,732.3645553588867,23643,6104,17539,17539,0,15,6254000.0
6254,6254999,20.375475649067013,37.51931664689485,0.07685596662809335,981.5485966205597,413.32299065589905,732.4927406311035,23647,6106,17541,17541,0,15,6255000.0
6255,6255999,20.3747636561001,37.518466774487784,0.07685545319649578,981.7205250263214,413.38959431648254,732.6624374389648,23649,6107,17542,17542,0,15,6256000.0
6256,6256999,20.373960589537553,37.51694529176597,0.07685204446529503,981.8935809135437,413.45658230781555,732.8003578186035,23651,6108,17543,17543,0,15,6257000.0
6257,6257999,20.373449167321752,37.51574190186085,0.07684414013109808,982.1915125846863,413.524374961853,732.8154525756836,23657,6111,17546,17546,0,15,6258000.0
6258,6258999,20.373060103673208,37.51468673805581,0.07683961550340357,982.383341550827,413.59171867370605,733.0044174194336,23659,6112,17547,17547,0,15,6259000.0
6259,6259999,20.372846721487434,37.514281287712734,0.0768350614257467,982.6137776374817,413.65907168388367,733.0559921264648,23663,6114,17549,17549,0,15,6260000.0
6260,6260999,20.372563323446535,37.51320301839174,0.07683415473084965,982.744631767273,413.7265441417694,733.1761245727539,23663,6114,17549,17549,0,15,6261000.0
6261,6261999,20.372359671397383,37.51246328293891,0.07683012526989175,982.9332590103149,413.79415249824524,733.2701072692871,23665,6115,17550,17550,0,15,6262000.0
6262,6262999,20.372636549980925,37.51265018645654,0.07682252949683799,983.1130034923553,413.861186504364,733.3725357055664,23672,6116,17556,17556,0,15,6263000.0
6263,6263999,20.37277711309478,37.512568068786564,0.07683078348764749,983.2958555221558,413.92859625816345,733.4408645629883,23674,6117,17557,17557,0,15,6264000.0
6264,6264999,20.372893892139178,37.512100878143244,0.07683099241972335,983.4743881225586,413.9955885410309,733.5416870117188,23685,6118,17567,17567,0,15,6265000.0
6265,6265999,20.37317605100323,37.51202782537762,0.07683511506696661,983.6085064411163,414.0627284049988,733.6271209716797,23685,6118,17567,17567,0,15,6266000.0
6266,6266999,20.37346746766394,37.51186151315518,0.07683563427346518,983.736403465271,414.1299993991852,733.6991653442383,23685,6118,17567,17567,0,15,6267000.0
6267,6267999,20.37342979273673,37.510820711823776,0.07683975932963016,983.9813332557678,414.1973145008087,733.6884727478027,23689,6120,17569,17569,0,15,6268000.0
6268,6268999,20.373006178601617,37.509561564673746,0.07684386443371949,984.1684494018555,414.26443457603455,733.7180061340332,23691,6121,17570,17570,0,15,6269000.0
6269,6269999,20.37206485265476,37.50779016295817,0.07684794682717766,984.2834596633911,414.33035469055176,734.6049919128418,23715,6121,17594,17594,0,15,6270000.0
6270,6270999,20.37086896155413,37.50573568192587,0.07685971071944342,984.401059627533,414.3955099582672,735.0362930297852,23719,6121,17598,17598,0,15,6271000.0
6271,6271999,20.3698077981073,37.50436783731843,0.07686736626862034,984.5738425254822,414.4616048336029,735.2398338317871,23721,6122,17599,17599,0,15,6272000.0
6272,6272999,20.36856473653957,37.502257037270766,0.07687627687088783,984.7951107025146,414.52727484703064,735.4099769592285,23726,6124,17602,17602,0,15,6273000.0
6273,6273999,20.36736045980928,37.500109723485146,0.07688909514171938,985.0295875072479,414.5931394100189,735.5453681945801,23730,6126,17604,17604,0,15,6274000.0
6274,6274999,20.366420540919126,37.49899193275838,0.07689253729253243,985.2733232975006,414.66032242774963,735.653491973877,23734,6128,17606,17606,0,15,6275000.0
6275,6275999,20.365228131883647,37.497111057003636,0.07689993082679625,985.3946371078491,414.7258188724518,735.8533477783203,23734,6128,17606,17606,0,15,6276000.0
6276,6276999,20.364221907670704,37.49550350592037,0.07690549360878807,985.5070900917053,414.79126358032227,735.9865493774414,23734,6128,17606,17606,0,15,6277000.0
6277,6277999,20.363183835535576,37.493576504496865,0.07691227843908077,985.7497572898865,414.8573274612427,736.0244560241699,23738,6130,17608,17608,0,15,6278000.0
6278,6278999,20.362277506085558,37.49189699621434,0.07691975250797523,985.946887254715,414.9237914085388,736.1212882995605,23740,6131,17609,17609,0,15,6279000.0
6279,6279999,20.361383169625604,37.49032661826639,0.07692579802639021,986.0765128135681,414.989839553833,736.2319030761719,23740,6131,17609,17609,0,15,6280000.0
6280,6280999,20.36045984228291,37.48851156788184,0.0769348802865597,986.2118577957153,415.0554184913635,736.3098182678223,23740,6131,17609,17609,0,15,6281000.0
6281,6281999,20.359785165866814,37.487145167499314,0.0769386227961758,986.401983499527,415.1222040653229,736.3984985351562,23743,6132,17611,17611,0,15,6282000.0
6282,6282999,20.359034538836003,37.48565775951986,0.07695044882367164,986.5234091281891,415.1878523826599,736.4989166259766,23743,6132,17611,17611,0,15,6283000.0
6283,6283999,20.358088594577623,37.48385358259317,0.07696419534974841,986.6536836624146,415.25359773635864,736.5976486206055,23743,6132,17611,17611,0,15,6284000.0
6284,6284999,20.357039691962516,37.48173180048248,0.0769764251661379,986.8402576446533,415.3194537162781,736.6405754089355,23745,6133,17612,17612,0,15,6285000.0
6285,6285999,20.356008201393664,37.47951198197729,0.0769921641989505,986.9714992046356,415.3852074146271,736.741584777832,23745,6133,17612,17612,0,15,6286000.0
6286,6286999,20.355181106488644,37.478127567079724,0.0769910365552563,987.0944559574127,415.4520812034607,737.7102966308594,23775,6133,17642,17642,0,15,6287000.0
6287,6287999,20.35410384284118,37.47662480570605,0.07700192389372462,987.2042446136475,415.51816153526306,738.1737747192383,23778,6133,17645,17645,0,15,6288000.0
6288,6288999,20.353197733631532,37.47784412368215,0.07700286819040247,987.3170998096466,415.5833992958069,738.4318771362305,23779,6133,17646,17646,0,15,6289000.0
6289,6289999,20.3521215825251,37.47653670080099,0.07701580548959042,987.4947936534882,415.6493766307831,738.5965995788574,23781,6134,17647,17647,0,15,6290000.0
6290,6290999,20.351095965871433,37.475028360156074,0.07702656283820442,987.6658606529236,415.71499729156494,738.7824172973633,23783,6135,17648,17648,0,15,6291000.0
6291,6291999,20.349856181453934,37.47308284990644,0.0770379943576256,987.94660115242,415.7816925048828,738.8539886474609,23789,6138,17651,17651,0,15,6292000.0
6292,6292999,20.348697316311423,37.47124343547561,0.07704810135058926,988.2804539203644,415.8491690158844,738.9534339904785,23798,6142,17656,17656,0,15,6293000.0
6293,6293999,20.347528127861523,37.469405721240626,0.0770564513769787,988.4638698101044,415.91604137420654,739.071907043457,23800,6143,17657,17657,0,15,6294000.0
6294,6294999,20.346411381532107,37.46740235694717,0.07706372444643383,988.7584159374237,415.9835629463196,739.1258544921875,23806,6146,17660,17660,0,15,6295000.0
6295,6295999,20.345263398448505,37.46534098521553,0.0770681942846777,988.9429275989532,416.0506248474121,739.3561668395996,23809,6147,17662,17662,0,15,6296000.0
6296,6296999,20.344463479439057,37.46409877855695,0.07706599581849782,989.062931060791,416.11697793006897,739.5385665893555,23809,6147,17662,17662,0,15,6297000.0
6297,6297999,20.34366481634206,37.4626011302626,0.07706226528798377,989.2534642219543,416.1836166381836,739.6048431396484,23811,6148,17663,17663,0,15,6298000.0
6298,6298999,20.34297267733418,37.461414485893,0.07705744899666156,989.3881666660309,416.250449180603,739.6945190429688,23811,6148,17663,17663,0,15,6299000.0
6299,6299999,20.342437499833714,37.460298748596735,0.07704783737017173,989.5202486515045,416.3165833950043,739.8273811340332,23811,6148,17663,17663,0,15,6300000.0
6300,6300999,20.341818488440772,37.45892387960498,0.07704266064443055,989.6449897289276,416.38388323783875,739.9124603271484,23811,6148,17663,17663,0,15,6301000.0
6301,6301999,20.341350442086544,37.457782374546206,0.07703620501850372,989.7864737510681,416.45047307014465,740.0175132751465,23811,6148,17663,17663,0,15,6302000.0
6302,6302999,20.340945685479962,37.45672519054081,0.07702753321061562,989.9081809520721,416.5166528224945,740.099048614502,23812,6148,17664,17664,0,15,6303000.0
6303,6303999,20.34071118045959,37.456664819321766,0.07701313227931328,990.0862209796906,416.58347487449646,740.1171989440918,23822,6149,17673,17673,0,15,6304000.0
6304,6304999,20.340316596026756,37.45558711716649,0.0770073099192673,990.2839002609253,416.65380692481995,740.148998260498,23824,6150,17674,17674,0,15,6305000.0
6305,6305999,20.33974988747455,37.45472039680765,0.07699944627545408,990.5355176925659,416.7208893299103,740.094669342041,23828,6152,17676,17676,0,15,6306000.0
6306,6306999,20.33933715155338,37.45506716665653,0.07697729832896771,990.6608819961548,416.788316488266,741.246826171875,23864,6152,17712,17712,0,15,6307000.0
6307,6307999,20.33831820784896,37.45404835590725,0.07698040805817952,990.7722764015198,416.8538637161255,741.7075729370117,23867,6152,17715,17715,0,15,6308000.0
6308,6308999,20.337179800462685,37.45205750566651,0.07698832197565819,990.9369034767151,416.9194462299347,741.9723625183105,23876,6153,17723,17723,0,15,6309000.0
6309,6309999,20.336269664552542,37.45110665343764,0.0769939862375576,991.3296482563019,416.9863591194153,742.0252838134766,23893,6158,17735,17735,0,15,6310000.0
6310,6310999,20.33543514940894,37.44956686981047,0.07699651441361777,991.4466135501862,417.0524742603302,742.2961235046387,23893,6158,17735,17735,0,15,6311000.0
6311,6311999,20.33427014947942,37.44738408622207,0.07700597374112028,991.7325196266174,417.1204710006714,742.474983215332,23899,6161,17738,17738,0,15,6312000.0
6312,6312999,20.33312340712458,37.445348098947406,0.07701178366210881,991.9185647964478,417.1897678375244,742.6049308776855,23901,6162,17739,17739,0,15,6313000.0
6313,6313999,20.33224950087747,37.44406915409737,0.07701345396625747,992.0995750427246,417.25674867630005,742.7716674804688,23903,6163,17740,17740,0,15,6314000.0
6314,6314999,20.331132117902246,37.442083776605784,0.07701778226043476,992.3340127468109,417.32365465164185,742.8034248352051,23907,6165,17742,17742,0,15,6315000.0
6315,6315999,20.33035636219557,37.44113692991308,0.07701341117204397,992.6334323883057,417.3924117088318,742.8506660461426,23913,6168,17745,17745,0,15,6316000.0
6316,6316999,20.32943728959013,37.43980463072967,0.07701119267187673,992.8188858032227,417.45936012268066,743.0493125915527,23915,6169,17746,17746,0,15,6317000.0
6317,6317999,20.32883046588857,37.43847591456127,0.0770058257004177,993.0683522224426,417.52661967277527,743.1320838928223,23919,6171,17748,17748,0,15,6318000.0
6318,6318999,20.328154795931148,37.43854266436176,0.07699752483501698,993.2683911323547,417.60239696502686,743.1966934204102,23922,6172,17750,17750,0,15,6319000.0
6319,6319999,20.32748228259932,37.437216562065245,0.0769926128161541,993.395608663559,417.6689553260803,743.3052177429199,23922,6172,17750,17750,0,15,6320000.0
6320,6320999,20.32682747114175,37.4356098025396,0.07698939770244428,993.5273411273956,417.7356219291687,743.4557914733887,23922,6172,17750,17750,0,15,6321000.0
6321,6321999,20.326273376689336,37.434155726492236,0.07698844300029839,993.8766605854034,417.8042507171631,743.3085746765137,23947,6176,17771,17771,0,15,6322000.0
6322,6322999,20.32576329264621,37.43280755725413,0.07698372938266151,994.0038499832153,417.8712046146393,743.4666137695312,23947,6176,17771,17771,0,15,6323000.0
6323,6323999,20.32545379094023,37.43173235256168,0.07697532294006948,994.1385724544525,417.9384922981262,743.601016998291,23947,6176,17771,17771,0,15,6324000.0
6324,6324999,20.32474392007938,37.430172284493864,0.07697241578091907,994.2565271854401,418.00500202178955,743.6915702819824,23947,6176,17771,17771,0,15,6325000.0
6325,6325999,20.324019911538244,37.4284112474819,0.07697102322308302,994.5196969509125,418.0723555088043,743.6775741577148,23951,6178,17773,17773,0,15,6326000.0
6326,6326999,20.32330737172346,37.42726621712096,0.07696850502269847,994.6485273838043,418.13911485671997,743.8181457519531,23951,6178,17773,17773,0,15,6327000.0
6327,6327999,20.322144274398838,37.425429057937194,0.07697238409446838,994.7723076343536,418.20613837242126,744.8081207275391,23983,6178,17805,17805,0,15,6328000.0
6328,6328999,20.32119667284682,37.424313044493836,0.07697553031438775,994.8882958889008,418.2716431617737,745.2692832946777,23986,6178,17808,17808,0,15,6329000.0
6329,6329999,20.32008622099215,37.42333797460804,0.07698143597445506,995.1716160774231,418.33764696121216,745.4275398254395,23992,6181,17811,17811,0,15,6330000.0
6330,6330999,20.31887144812702,37.42123526764933,0.07699307324837756,995.3403704166412,418.40447092056274,745.6803016662598,23994,6182,17812,17812,0,15,6331000.0
6331,6331999,20.317600629435066,37.41904875339572,0.07700240015953053,995.5105850696564,418.47047996520996,745.8732681274414,23996,6183,17813,17813,0,15,6332000.0
6332,6332999,20.316744594177695,37.417366801441574,0.0770046868423313,995.7572793960571,418.5366804599762,746.0052909851074,24000,6185,17815,17815,0,15,6333000.0
6333,6333999,20.31556461258595,37.415376587802974,0.0770105203326561,995.991197347641,418.60390877723694,746.1535224914551,24004,6187,17817,17817,0,15,6334000.0
6334,6334999,20.31461611637369,37.4136304949912,0.07701366288426892,996.2188150882721,418.6706142425537,746.2990264892578,24010,6189,17821,17821,0,15,6335000.0
6335,6335999,20.31347792323219,37.412549476319136,0.0770184289134056,996.3406617641449,418.7371926307678,746.4930038452148,24010,6189,17821,17821,0,15,6336000.0
6336,6336999,20.312500819046253,37.410771953442726,0.07702233264634628,996.4661681652069,418.8034174442291,746.6289825439453,24010,6189,17821,17821,0,15,6337000.0
6337,6337999,20.31140564970826,37.40874197137761,0.07702918613277232,996.7062385082245,418.8712856769562,746.6698532104492,24014,6191,17823,17823,0,15,6338000.0
6338,6338999,20.310318761280147,37.40680412282408,0.07703568003037387,996.9529798030853,418.93826246261597,746.7071990966797,24018,6193,17825,17825,0,15,6339000.0
6339,6339999,20.309314961568266,37.40549470092589,0.07703932747095332,997.1908197402954,419.00524711608887,746.7231292724609,24022,6195,17827,17827,0,15,6340000.0
6340,6340999,20.308472979667197,37.40370750945479,0.07704178222442759,997.4340875148773,419.07240414619446,746.8052291870117,24026,6197,17829,17829,0,15,6341000.0
6341,6341999,20.30750310405852,37.40171617339738,0.0770453328741888,997.5590908527374,419.13880825042725,746.9623908996582,24026,6197,17829,17829,0,15,6342000.0
6342,6342999,20.306944840409578,37.40039686490934,0.07704264980565623,997.798131942749,419.2056884765625,747.0130577087402,24030,6199,17831,17831,0,15,6343000.0
6343,6343999,20.306218965691688,37.3986491863559,0.07704414768505441,997.9252226352692,419.27236557006836,747.1556205749512,24030,6199,17831,17831,0,15,6344000.0
6344,6344999,20.305515905027807,37.397027095575,0.07704404908226425,998.0589356422424,419.3392744064331,747.2546768188477,24030,6199,17831,17831,0,15,6345000.0
6345,6345999,20.304841821528516,37.39536113261407,0.0770440855854676,998.1883134841919,419.4060707092285,747.3393936157227,24030,6199,17831,17831,0,15,6346000.0
6346,6346999,20.303927231409347,37.393414611542184,0.07704941097868268,998.3245093822479,419.4730637073517,747.4477806091309,24030,6199,17831,17831,0,15,6347000.0
6347,6347999,20.30278194994064,37.39128614983583,0.07705706060162487,998.500700712204,419.54019260406494,748.1457672119141,24060,6200,17860,17860,0,15,6348000.0
6348,6348999,20.301783739741698,37.391145904130084,0.07705861977723372,998.611560344696,419.6061716079712,748.7728614807129,24069,6200,17869,17869,0,15,6349000.0
6349,6349999,20.300674236976544,37.39067788473016,0.07705913742053183,998.7756004333496,419.6719193458557,749.1523895263672,24072,6201,17871,17871,0,15,6350000.0
6350,6350999,20.299525374342974,37.389070070541365,0.07706512082287298,999.0013046264648,419.7382724285126,749.3386077880859,24076,6203,17873,17873,0,15,6351000.0
6351,6351999,20.298537686261874,37.38752504986443,0.07706734902750478,999.177610874176,419.8048369884491,749.5291633605957,24079,6204,17875,17875,0,15,6352000.0
6352,6352999,20.29754209663346,37.38597500470578,0.07706793424530223,999.352133512497,419.871351480484,749.7326469421387,24081,6205,17876,17876,0,15,6353000.0
6353,6353999,20.296521402801204,37.38409144435748,0.07707402251986606,999.7491104602814,419.9387574195862,749.6542282104492,24091,6210,17881,17881,0,15,6354000.0
6354,6354999,20.295522890454162,37.38242561974194,0.07708169463963566,999.9864313602448,420.0072088241577,749.9091911315918,24095,6212,17883,17883,0,15,6355000.0
6355,6355999,20.294672500486648,37.38103807088442,0.0770878071904103,1000.1636137962341,420.07398080825806,750.0779724121094,24097,6213,17884,17884,0,15,6356000.0
6356,6356999,20.293953893008855,37.380290280211575,0.07709126471413608,1000.4190995693207,420.14849972724915,750.1773452758789,24101,6215,17886,17886,0,15,6357000.0
6357,6357999,20.293304402138148,37.37896413394823,0.07709431372960429,1000.7095150947571,420.21625781059265,750.2522926330566,24107,6218,17889,17889,0,15,6358000.0
6358,6358999,20.292922995369,37.37834454223429,0.07710527936495626,1000.8262536525726,420.28305101394653,750.486011505127,24107,6218,17889,17889,0,15,6359000.0
6359,6359999,20.293274586045303,37.37934558281821,0.07709898002759652,1001.0099620819092,420.3501570224762,750.5944366455078,24109,6219,17890,17890,0,15,6360000.0
6360,6360999,20.29341405468322,37.37980313512724,0.07709329734434811,1001.1929996013641,420.41758942604065,750.6511688232422,24111,6220,17891,17891,0,15,6361000.0
6361,6361999,20.293663500694816,37.37998707350305,0.07710780333849943,1001.3760712146759,420.48485493659973,750.7704467773438,24113,6221,17892,17892,0,15,6362000.0
6362,6362999,20.29403585515666,37.38019909824917,0.07712002736330248,1001.7402107715607,420.5527894496918,750.7493133544922,24121,6225,17896,17896,0,15,6363000.0
6363,6363999,20.294848340996033,37.382259778608095,0.07711672423072957,1001.9367716312408,420.6205258369446,750.8276710510254,24123,6226,17897,17897,0,15,6364000.0
6364,6364999,20.29554788490237,37.382908452136235,0.07711819748268145,1002.1141247749329,420.68781065940857,750.9214782714844,24134,6227,17907,17907,0,15,6365000.0
6365,6365999,20.29630868752267,37.38350608550887,0.07712769007098996,1002.2489991188049,420.75519728660583,751.0341377258301,24134,6227,17907,17907,0,15,6366000.0
6366,6366999,20.296811806020454,37.38364166920964,0.07712869669241551,1002.3757929801941,420.82239270210266,751.1535911560059,24134,6227,17907,17907,0,15,6367000.0
6367,6367999,20.297042912096504,37.38308375459172,0.07713275709937129,1002.6687850952148,420.89013266563416,751.1290130615234,24140,6230,17910,17910,0,15,6368000.0
6368,6368999,20.296511179152887,37.381722803967186,0.07712313847308705,1002.8636646270752,420.95831775665283,752.1368446350098,24182,6231,17951,17951,0,15,6369000.0
6369,6369999,20.295721622792307,37.3833148910576,0.0771101086909125,1003.0386142730713,421.02524399757385,752.8552474975586,24199,6232,17967,17967,0,15,6370000.0
6370,6370999,20.295074875790775,37.38351333994498,0.07710163948633852,1003.2055716514587,421.090829372406,753.2129173278809,24212,6233,17979,17979,0,15,6371000.0
6371,6371999,20.294253105921566,37.38192274448176,0.07710209286935799,1003.3911912441254,421.161794424057,753.429859161377,24214,6234,17980,17980,0,15,6372000.0
6372,6372999,20.293501454523486,37.38029423296889,0.07710528171680675,1003.6219067573547,421.22986793518066,753.5870323181152,24218,6236,17982,17982,0,15,6373000.0
6373,6373999,20.292748097889906,37.37999748604849,0.07710508111446512,1003.8625774383545,421.304806470871,753.7928123474121,24223,6238,17985,17985,0,15,6374000.0
6374,6374999,20.291963394063625,37.3783991642557,0.07710512824986682,1004.3090362548828,421.3727250099182,753.7239837646484,24235,6244,17991,17991,0,15,6375000.0
6375,6375999,20.291326289975604,37.37711642209965,0.07710486305620279,1004.4298589229584,421.44063544273376,754.0324058532715,24235,6244,17991,17991,0,15,6376000.0
6376,6376999,20.290705937115874,37.37565596247373,0.07710492155775583,1004.6115305423737,421.50739645957947,754.2052917480469,24237,6245,17992,17992,0,15,6377000.0
6377,6377999,20.29012146134949,37.374192632490015,0.07710683637663929,1004.7939140796661,421.57453632354736,754.3445777893066,24239,6246,17993,17993,0,15,6378000.0
6378,6378999,20.289957747841676,37.37408583247817,0.07710940576206116,1005.0197994709015,421.64138293266296,754.4353981018066,24243,6248,17995,17995,0,15,6379000.0
6379,6379999,20.289784551305765,37.3732789748416,0.07711001861641431,1005.2577662467957,421.708176612854,754.5635643005371,24255,6250,18005,18005,0,15,6380000.0
6380,6380999,20.28982471951151,37.372740564626,0.0771152733013194,1005.3905701637268,421.7749092578888,754.738353729248,24255,6250,18005,18005,0,15,6381000.0
6381,6381999,20.289922211289028,37.37229863497879,0.07711909559612484,1005.5191023349762,421.8416600227356,754.8250007629395,24255,6250,18005,18005,0,15,6382000.0
6382,6382999,20.290295792588406,37.37254058116704,0.07711794896828272,1005.7640378475189,421.9088041782379,754.8517303466797,24259,6252,18007,18007,0,15,6383000.0
6383,6383999,20.2909235593672,37.37311035577427,0.07713048392789734,1005.8897488117218,421.97555112838745,754.9811859130859,24259,6252,18007,18007,0,15,6384000.0
6384,6384999,20.29131831344285,37.37297894675054,0.0771391076243425,1006.1717526912689,422.0424120426178,754.9864463806152,24273,6255,18018,18018,0,15,6385000.0
6385,6385999,20.29216569785442,37.373671212565895,0.07714617819854375,1006.3581254482269,422.10945773124695,755.0676765441895,24275,6256,18019,18019,0,15,6386000.0
6386,6386999,20.292720576729835,37.37467491904205,0.07715748600905936,1006.5564339160919,422.17704606056213,755.1512107849121,24277,6257,18020,18020,0,15,6387000.0
6387,6387999,20.29338880366039,37.37477390770005,0.07717011596675705,1006.7568805217743,422.2443985939026,755.2386856079102,24286,6258,18028,18028,0,15,6388000.0
6388,6388999,20.293580341716755,37.37425541977564,0.07717691960040296,1006.9373760223389,422.3111901283264,755.3151168823242,24288,6259,18029,18029,0,15,6389000.0
6389,6389999,20.293073693874906,37.37294673340277,0.07717043657008571,1007.0617761611938,422.3778886795044,756.207462310791,24316,6259,18057,18057,0,15,6390000.0
6390,6390999,20.29209869022804,37.371816303849265,0.07716701932187964,1007.1724109649658,422.4441318511963,756.6203842163086,24317,6259,18058,18058,0,15,6391000.0
6391,6391999,20.290968404791283,37.369694876289074,0.07717172739982381,1007.2861125469208,422.51024436950684,756.8634605407715,24317,6259,18058,18058,0,15,6392000.0
6392,6392999,20.290190985284383,37.368223907711666,0.07716983707713876,1007.6333727836609,422.5769293308258,756.9429626464844,24325,6263,18062,18062,0,15,6393000.0
6393,6393999,20.289911390754668,37.367863993186766,0.07716213023879914,1007.8670237064362,422.644052028656,757.0901107788086,24330,6265,18065,18065,0,15,6394000.0
6394,6394999,20.28913573254941,37.36649632369045,0.07716029026877003,1008.0389494895935,422.7105436325073,757.3469200134277,24332,6266,18066,18066,0,15,6395000.0
6395,6395999,20.288590086277313,37.3653465748649,0.07715932118885649,1008.3950893878937,422.77787041664124,757.366771697998,24340,6270,18070,18070,0,15,6396000.0
6396,6396999,20.28825225944423,37.364421348793755,0.07715645614407574,1008.5745956897736,422.8454737663269,757.5307083129883,24342,6271,18071,18071,0,15,6397000.0
6397,6397999,20.287771893870403,37.36318252615116,0.07715559465380217,1008.8683066368103,422.9122965335846,757.52587890625,24348,6274,18074,18074,0,15,6398000.0
6398,6398999,20.287691538812563,37.36362811893667,0.0771460926639238,1009.1155002117157,422.979638338089,757.6012992858887,24361,6276,18085,18085,0,15,6399000.0
6399,6399999,20.28765157879243,37.36286467784078,0.07714276926553532,1009.3600420951843,423.0466718673706,757.7014083862305,24365,6278,18087,18087,0,15,6400000.0
6400,6400999,20.28746385243638,37.36216242487922,0.07713996621692287,1009.478818655014,423.113037109375,757.8812942504883,24365,6278,18087,18087,0,15,6401000.0
6401,6401999,20.287600369199385,37.361727624283255,0.0771397367716703,1009.5999066829681,423.17946672439575,758.0072746276855,24365,6278,18087,18087,0,15,6402000.0
6402,6402999,20.28772499833299,37.36126945389385,0.07712936849371643,1009.909325838089,423.2467303276062,757.9170379638672,24371,6281,18090,18090,0,15,6403000.0
6403,6403999,20.287585505937702,37.36059875584684,0.07712755454565845,1010.1083195209503,423.31399059295654,758.0962867736816,24373,6282,18091,18091,0,15,6404000.0
6404,6404999,20.287596846362092,37.359974638867435,0.07713122245327153,1010.2241866588593,423.38083839416504,758.2474594116211,24373,6282,18091,18091,0,15,6405000.0
6405,6405999,20.287610370227082,37.35920473167026,0.07712682074015265,1010.350248336792,423.4477610588074,758.3451919555664,24373,6282,18091,18091,0,15,6406000.0
6406,6406999,20.287816787079628,37.35883964191491,0.07711951426142483,1010.4815969467163,423.514417886734,758.4529800415039,24373,6282,18091,18091,0,15,6407000.0
6407,6407999,20.28793956934988,37.35819684316859,0.07711556274985043,1010.6086213588715,423.58203864097595,758.5314254760742,24373,6282,18091,18091,0,15,6408000.0
6408,6408999,20.28801946969268,37.357381241336086,0.07710950306766284,1010.8694038391113,423.64987897872925,758.5115661621094,24377,6284,18093,18093,0,15,6409000.0
6409,6409999,20.28794833277386,37.35638455094722,0.0771035868372667,1011.0549440383911,423.7167944908142,758.5693321228027,24379,6285,18094,18094,0,15,6410000.0
6410,6410999,20.28732802163571,37.35485081130067,0.07709368210554146,1011.1855130195618,423.7835040092468,759.453540802002,24405,6285,18120,18120,0,15,6411000.0
6411,6411999,20.286561363158594,37.35461938966365,0.07708615823389242,1011.2969863414764,423.8492670059204,759.9660034179688,24409,6285,18124,18124,0,15,6412000.0
6412,6412999,20.28567246131029,37.35386064250185,0.077083905310117,1011.4088747501373,423.9159662723541,760.2381172180176,24410,6285,18125,18125,0,15,6413000.0
6413,6413999,20.28477225217365,37.35385869670895,0.07708010901226747,1011.6940455436707,423.9822909832001,760.3760185241699,24423,6288,18135,18135,0,15,6414000.0
6414,6414999,20.283797179409035,37.35202484182398,0.07708309465473573,1011.8720183372498,424.0481810569763,760.5538787841797,24434,6289,18145,18145,0,15,6415000.0
6415,6415999,20.28291001246357,37.35118557452624,0.07708293299571001,1012.2228207588196,424.11606526374817,760.6385383605957,24449,6293,18156,18156,0,15,6416000.0
6416,6416999,20.281874460726694,37.34949565435316,0.07708561089014199,1012.5140037536621,424.1830036640167,760.7149200439453,24455,6296,18159,18159,0,15,6417000.0
6417,6417999,20.281085107445975,37.34891017334939,0.07708231860336845,1012.9288938045502,424.2504496574402,760.7524032592773,24465,6301,18164,18164,0,15,6418000.0
6418,6418999,20.280111530918145,37.347225305251094,0.0770838911091204,1013.1100254058838,424.31708002090454,760.9686889648438,24467,6302,18165,18165,0,15,6419000.0
6419,6419999,20.27933320849125,37.34574346457131,0.07708529472930647,1013.399002790451,424.38434290885925,761.047981262207,24473,6305,18168,18168,0,15,6420000.0
6420,6420999,20.27848595377594,37.34426934358427,0.0770853375767151,1013.6424491405487,424.4519169330597,761.1090393066406,24477,6307,18170,18170,0,15,6421000.0
6421,6421999,20.27758609521862,37.34279231634112,0.07708961465346775,1013.7677915096283,424.51882767677307,761.2737731933594,24477,6307,18170,18170,0,15,6422000.0
6422,6422999,20.2768060559468,37.34132039912918,0.07709252787496124,1013.9550745487213,424.58725142478943,761.4444961547852,24480,6308,18172,18172,0,15,6423000.0
6423,6423999,20.2760254149609,37.33969211248707,0.07709651752776703,1014.0848624706268,424.653701543808,761.5739479064941,24480,6308,18172,18172,0,15,6424000.0
6424,6424999,20.275254839652785,37.33795279706792,0.07710185022658267,1014.2163598537445,424.72067880630493,761.7053527832031,24480,6308,18172,18172,0,15,6425000.0
6425,6425999,20.274471511857257,37.33714717919065,0.07710750684219048,1014.3438684940338,424.78742718696594,761.7898025512695,24480,6308,18172,18172,0,15,6426000.0
6426,6426999,20.273714844371025,37.33641488292346,0.07711300813707411,1014.466210603714,424.8541600704193,761.9048538208008,24480,6308,18172,18172,0,15,6427000.0
6427,6427999,20.272982850883366,37.33464464796762,0.07711287927612864,1014.663473367691,424.92153811454773,762.5473556518555,24508,6309,18199,18199,0,15,6428000.0
6428,6428999,20.272085474778635,37.33320997863244,0.07711800741827401,1014.7845544815063,424.98817920684814,763.0457725524902,24512,6309,18203,18203,0,15,6429000.0
6429,6429999,20.271001055172093,37.33143156572897,0.07712889979673176,1014.9550983905792,425.0541410446167,763.3469619750977,24524,6310,18214,18214,0,15,6430000.0
6430,6430999,20.270164896222965,37.33025713092745,0.07713114761598172,1015.0712656974792,425.11938738822937,763.5497550964355,24525,6310,18215,18215,0,15,6431000.0
6431,6431999,20.269311419284495,37.328706482547894,0.0771332505612965,1015.2507102489471,425.1855182647705,763.8001022338867,24529,6311,18218,18218,0,15,6432000.0
6432,6432999,20.26860802582223,37.32791442135402,0.07713544684280849,1015.4333925247192,425.2517740726471,763.9511985778809,24531,6312,18219,18219,0,15,6433000.0
6433,6433999,20.267982423786325,37.32698830411495,0.07713071546585937,1015.6114187240601,425.31827092170715,764.0804100036621,24533,6313,18220,18220,0,15,6434000.0
6434,6434999,20.26743576241525,37.32629635112922,0.07712439531182969,1015.9081959724426,425.38523292541504,764.0885696411133,24540,6316,18224,18224,0,15,6435000.0
6435,6435999,20.267008142812273,37.325576154544905,0.07711764832206958,1016.0325357913971,425.4515018463135,764.2891960144043,24540,6316,18224,18224,0,15,6436000.0
6436,6436999,20.266753107962575,37.32499331690522,0.07711159326122097,1016.2114911079407,425.51788783073425,764.3893051147461,24542,6317,18225,18225,0,15,6437000.0
6437,6437999,20.266736834848317,37.32453287453147,0.07710259753473203,1016.6188712120056,425.58743119239807,764.3376655578613,24553,6322,18231,18231,0,15,6438000.0
6438,6438999,20.266558596331095,37.32370189049755,0.077095593776071,1016.9764926433563,425.655401468277,764.2982521057129,24561,6326,18235,18235,0,15,6439000.0
6439,6439999,20.266610848499496,37.32330706954667,0.07708757928548005,1017.2750058174133,425.7228226661682,764.2953643798828,24575,6329,18246,18246,0,15,6440000.0
6440,6440999,20.26687521350189,37.32380230194195,0.07708365057878752,1017.4599823951721,425.79007482528687,764.4801940917969,24577,6330,18247,18247,0,15,6441000.0
6441,6441999,20.266819665034575,37.3231360536931,0.07708309030186755,1017.7062497138977,425.85730600357056,764.5677490234375,24581,6332,18249,18249,0,15,6442000.0
6442,6442999,20.267181692671986,37.32305313033351,0.07708812938576015,1017.8917605876923,425.92408537864685,764.6761894226074,24583,6333,18250,18250,0,15,6443000.0
6443,6443999,20.267714287982127,37.32349492701893,0.07708058464116474,1018.0067648887634,425.99109840393066,764.8724365234375,24583,6333,18250,18250,0,15,6444000.0
6444,6444999,20.26785979900988,37.32310998560953,0.07707654999829361,1018.1481966972351,426.0583028793335,764.983081817627,24583,6333,18250,18250,0,15,6445000.0
6445,6445999,20.268208234019234,37.323853074045005,0.07706857514382814,1018.3247187137604,426.1252546310425,765.0257225036621,24585,6334,18251,18251,0,15,6446000.0
6446,6446999,20.268384837865803,37.32335450429072,0.07706135938199032,1018.5020999908447,426.19303727149963,765.0978126525879,24587,6335,18252,18252,0,15,6447000.0
6447,6447999,20.268133664192007,37.322073782489745,0.07705533483393867,1018.7415752410889,426.2605152130127,765.9860229492188,24625,6337,18288,18288,0,15,6448000.0
6448,6448999,20.267902605619906,37.32203071577004,0.0770458803229157,1018.8605861663818,426.32728028297424,766.8948631286621,24648,6337,18311,18311,0,15,6449000.0
6449,6449999,20.268255163849485,37.32265789824561,0.07704559460016969,1018.9807608127594,426.39348578453064,767.3352546691895,24651,6337,18314,18314,0,15,6450000.0
6450,6450999,20.26861150152998,37.32280659850624,0.07704044311955294,1019.1594064235687,426.4604296684265,767.5393600463867,24653,6338,18315,18315,0,15,6451000.0
6451,6451999,20.269248782807633,37.32323557120552,0.07704180773450164,1019.4509320259094,426.527556180954,767.6316223144531,24664,6341,18323,18323,0,15,6452000.0
6452,6452999,20.270156958757187,37.325319326141,0.0770303446866254,1019.6838359832764,426.59438490867615,767.8534622192383,24668,6343,18325,18325,0,15,6453000.0
6453,6453999,20.27096594700914,37.32575442371793,0.07703299345175363,1019.9378337860107,426.66145849227905,767.9942779541016,24672,6345,18327,18327,0,15,6454000.0
6454,6454999,20.272310945106447,37.32734663703573,0.0770310794830571,1020.0566298961639,426.7275972366333,768.2419242858887,24673,6345,18328,18328,0,15,6455000.0
6455,6455999,20.273613827651225,37.32893037438963,0.07704233558749152,1020.2391476631165,426.794246673584,768.362361907959,24675,6346,18329,18329,0,15,6456000.0
6456,6456999,20.27489166921795,37.32983471025059,0.07706497875219465,1020.4253907203674,426.8614583015442,768.432056427002,24677,6347,18330,18330,0,15,6457000.0
6457,6457999,20.276139765403943,37.331252489061875,0.07711460429540107,1020.6069040298462,426.9284312725067,768.5601921081543,24679,6348,18331,18331,0,15,6458000.0
6458,6458999,20.277296129446714,37.33231574052347,0.07715815179577645,1020.7917275428772,426.9957308769226,768.6707763671875,24681,6349,18332,18332,0,15,6459000.0
6459,6459999,20.27856161924536,37.3332832961081,0.07718635520239647,1020.9110145568848,427.0623548030853,768.8049049377441,24681,6349,18332,18332,0,15,6460000.0
6460,6460999,20.27981949655332,37.33430494762365,0.0772394871502079,1021.1136920452118,427.1293203830719,768.9126396179199,24683,6350,18333,18333,0,15,6461000.0
6461,6461999,20.281282076398035,37.33547587830863,0.07727665431567288,1021.2999596595764,427.1962797641754,769.0204734802246,24693,6351,18342,18342,0,15,6462000.0
6462,6462999,20.28249356131362,37.33602111265384,0.07731748249211767,1021.4259898662567,427.26318645477295,769.1295852661133,24693,6351,18342,18342,0,15,6463000.0
6463,6463999,20.283704920851264,37.33676754066838,0.07736062176821923,1021.6052083969116,427.3298246860504,769.203987121582,24695,6352,18343,18343,0,15,6464000.0
6464,6464999,20.2848163219997,37.33712391695772,0.07738646646148795,1021.9158370494843,427.3974871635437,769.198055267334,24701,6355,18346,18346,0,15,6465000.0
6465,6465999,20.28594505828499,37.33742553095681,0.0774109654287628,1022.1075999736786,427.4644944667816,769.2667617797852,24703,6356,18347,18347,0,15,6466000.0
6466,6466999,20.28656960397967,37.336845495941525,0.07742679846640799,1022.3486497402191,427.53175377845764,769.3604202270508,24715,6358,18357,18357,0,15,6467000.0
6467,6467999,20.286604778101356,37.336003731498344,0.07741515945103272,1022.4736273288727,427.59841203689575,770.1590766906738,24741,6358,18383,18383,0,15,6468000.0
6468,6468999,20.28567600259105,37.334480267334314,0.07741551135370872,1022.640538930893,427.6645836830139,770.5568733215332,24746,6359,18387,18387,0,15,6469000.0
6469,6469999,20.284803382969052,37.333224459780816,0.07741500555573566,1022.8171236515045,427.73005509376526,770.7296371459961,24747,6360,18387,18387,0,15,6470000.0
6470,6470999,20.283954235692388,37.3318993486941,0.07741756367050867,1022.997460603714,427.79595279693604,770.9034729003906,24749,6361,18388,18388,0,15,6471000.0
6471,6471999,20.28331795273119,37.3308151741114,0.07741320487429582,1023.1718506813049,427.8617970943451,771.0540199279785,24761,6362,18399,18399,0,15,6472000.0
6472,6472999,20.28242972746218,37.32938226320986,0.07741193975587779,1023.4609928131104,427.92789602279663,771.1457633972168,24767,6365,18402,18402,0,15,6473000.0
6473,6473999,20.281885021146863,37.3287927452108,0.0774047328979407,1023.6416275501251,427.9942464828491,771.2957649230957,24769,6366,18403,18403,0,15,6474000.0
6474,6474999,20.281420682443386,37.32793190658781,0.07740043482318282,1024.0615284442902,428.0621316432953,771.2523574829102,24779,6371,18408,18408,0,15,6475000.0
6475,6475999,20.28106050455059,37.326905861437666,0.0773974908744488,1024.2372002601624,428.12876176834106,771.4187240600586,24781,6372,18409,18409,0,15,6476000.0
6476,6476999,20.280728509291443,37.32578059731564,0.0773958077221194,1024.4170219898224,428.1953856945038,771.554630279541,24783,6373,18410,18410,0,15,6477000.0
6477,6477999,20.280952453386714,37.325753566821014,0.07739785666293963,1024.614717721939,428.2621896266937,771.6806488037109,24785,6374,18411,18411,0,15,6478000.0
6478,6478999,20.281443826418375,37.325971996981394,0.07739866227729786,1024.744018316269,428.32963252067566,771.8317565917969,24785,6374,18411,18411,0,15,6479000.0
6479,6479999,20.281999511899066,37.32661928040556,0.07739930360244862,1024.8612911701202,428.3955409526825,771.947681427002,24785,6374,18411,18411,0,15,6480000.0
6480,6480999,20.28268823916653,37.327518472350256,0.07739418432018386,1025.0483915805817,428.4623408317566,771.9474258422852,24787,6375,18412,18412,0,15,6481000.0
6481,6481999,20.283584266894213,37.3282448580314,0.07740138878346636,1025.3095338344574,428.53036069869995,772.0064353942871,24791,6377,18414,18414,0,15,6482000.0
6482,6482999,20.284572643143587,37.32956133052533,0.07740560253511253,1025.606505870819,428.5990958213806,772.0317993164062,24804,6380,18424,18424,0,15,6483000.0
6483,6483999,20.285397919151745,37.33024913988423,0.07742876216192762,1025.7431371212006,428.6658205986023,772.174877166748,24804,6380,18424,18424,0,15,6484000.0
6484,6484999,20.286668201275592,37.33215084135344,0.07744141108301317,1025.8644483089447,428.73269724845886,772.2996597290039,24804,6380,18424,18424,0,15,6485000.0
6485,6485999,20.287611550993937,37.33301815310287,0.07745373541479306,1026.1403005123138,428.8001346588135,772.2751312255859,24808,6382,18426,18426,0,15,6486000.0
6486,6486999,20.288511792090997,37.33346707543896,0.07745947841764877,1026.2669625282288,428.8673496246338,772.3757972717285,24808,6382,18426,18426,0,15,6487000.0
6487,6487999,20.289009572069972,37.33320881471958,0.07746013288659104,1026.3930325508118,428.93462085723877,772.4774780273438,24808,6382,18426,18426,0,15,6488000.0
6488,6488999,20.288714925410066,37.33251972304193,0.07745206575668306,1026.5150353908539,429.00151777267456,773.2072334289551,24830,6382,18448,18448,0,15,6489000.0
6489,6489999,20.287557686480877,37.33099831456159,0.07745778484619892,1026.6886885166168,429.06817603111267,773.5352210998535,24842,6383,18459,18459,0,15,6490000.0
6490,6490999,20.286674852661662,37.32999372719859,0.07745993892401426,1026.8605093955994,429.1346583366394,773.8539543151855,24845,6384,18461,18461,0,15,6491000.0
6491,6491999,20.285781722937884,37.328610711503046,0.0774668968743405,1027.107037782669,429.2012255191803,773.8903541564941,24857,6386,18471,18471,0,15,6492000.0
6492,6492999,20.284997979575696,37.32702563235962,0.07746810107858071,1027.2875397205353,429.2677791118622,774.0841522216797,24859,6387,18472,18472,0,15,6493000.0
6493,6493999,20.283949853843936,37.325407592181314,0.07747028783377419,1027.4684371948242,429.3347306251526,774.2742156982422,24862,6388,18474,18474,0,15,6494000.0
6494,6494999,20.28316100009313,37.323745173213986,0.07746964052486649,1027.7640328407288,429.40190625190735,774.3150596618652,24877,6391,18486,18486,0,15,6495000.0
6495,6495999,20.282333525073327,37.32463372421967,0.07746061733902165,1028.0105574131012,429.4692587852478,774.4446830749512,24883,6393,18490,18490,0,15,6496000.0
6496,6496999,20.281410983024397,37.32289704100203,0.07746170663181906,1028.2495441436768,429.5361044406891,774.5599250793457,24887,6395,18492,18492,0,15,6497000.0
6497,6497999,20.28073538344532,37.321560449975415,0.07745739817063524,1028.4294381141663,429.60279273986816,774.7005157470703,24889,6396,18493,18493,0,15,6498000.0
6498,6498999,20.28044916863235,37.321070452569884,0.07745042602401797,1028.6744334697723,429.67041635513306,774.7482833862305,24893,6398,18495,18495,0,15,6499000.0
6499,6499999,20.280336998467128,37.32042995546116,0.077447753643757,1028.8571047782898,429.73770236968994,774.9183578491211,24895,6399,18496,18496,0,15,6500000.0
6500,6500999,20.28024654628556,37.319749180303525,0.0774447187230044,1029.097996711731,429.80491042137146,774.9523162841797,24904,6401,18503,18503,0,15,6501000.0
6501,6501999,20.28016015855296,37.31895291194746,0.0774432416785138,1029.2844245433807,429.87304496765137,775.0116691589355,24906,6402,18504,18504,0,15,6502000.0
6502,6502999,20.280880559158494,37.319361793231664,0.07743823425811858,1029.4217369556427,429.9398853778839,775.1577377319336,24906,6402,18504,18504,0,15,6503000.0
6503,6503999,20.2815053416665,37.32051668200544,0.07743117696344315,1029.5501589775085,430.0071187019348,775.2647743225098,24906,6402,18504,18504,0,15,6504000.0
6504,6504999,20.282478287550752,37.32184710102821,0.07743427244267631,1029.7377552986145,430.0741801261902,775.3660354614258,24908,6403,18505,18505,0,15,6505000.0
6505,6505999,20.283734147160423,37.32345979592521,0.07743396783776013,1029.984894990921,430.1413609981537,775.3635902404785,24912,6405,18507,18507,0,15,6506000.0
6506,6506999,20.28523335877177,37.326570885552776,0.07743326990073296,1030.1868159770966,430.2086498737335,775.4548263549805,24914,6406,18508,18508,0,15,6507000.0
6507,6507999,20.28669595475984,37.33028436520258,0.07743586190102769,1030.537790298462,430.27652168273926,775.348217010498,24939,6410,18529,18529,0,15,6508000.0
6508,6508999,20.28732110345032,37.330559021609545,0.07744804712088704,1030.666283607483,430.34398460388184,775.5186233520508,24939,6410,18529,18529,0,15,6509000.0
6509,6509999,20.287528013946567,37.33070041767481,0.0774341637114987,1030.7962501049042,430.41118693351746,776.301944732666,24960,6410,18550,18550,0,15,6510000.0
6510,6510999,20.287084834852678,37.32990136867789,0.07742398727535271,1030.9191348552704,430.47768688201904,776.8225936889648,24965,6410,18555,18555,0,15,6511000.0
6511,6511999,20.286361297668492,37.32819887876057,0.07742096243358354,1031.090986251831,430.544641494751,777.0848693847656,24975,6411,18564,18564,0,15,6512000.0
6512,6512999,20.285680581014127,37.32677457843056,0.0774232149180778,1031.2127213478088,430.61051511764526,777.2908630371094,24975,6411,18564,18564,0,15,6513000.0
6513,6513999,20.285169876257456,37.32537582515283,0.077420041578657,1031.3449754714966,430.67620491981506,777.449104309082,24975,6411,18564,18564,0,15,6514000.0
6514,6514999,20.284347469562594,37.32343270874935,0.07741932709455224,1031.5819036960602,430.74324917793274,777.5944175720215,24980,6413,18567,18567,0,15,6515000.0
6515,6515999,20.283736787388428,37.321844425379616,0.07742072816605616,1031.8895967006683,430.8102753162384,777.6704902648926,24986,6416,18570,18570,0,15,6516000.0
6516,6516999,20.283095574315524,37.32017216521242,0.07742187868351513,1032.1169996261597,430.87643456459045,777.7654495239258,24990,6418,18572,18572,0,15,6517000.0
6517,6517999,20.282507486571056,37.318542038395556,0.07742364375793753,1032.2385215759277,430.94308853149414,777.9454040527344,24990,6418,18572,18572,0,15,6518000.0
6518,6518999,20.282094256697597,37.317378443952734,0.07742549919665842,1032.4956941604614,431.00969672203064,777.966381072998,25001,6420,18581,18581,0,15,6519000.0
6519,6519999,20.281689565624177,37.315863719603165,0.07742835626459466,1032.6159400939941,431.07605624198914,778.1114921569824,25001,6420,18581,18581,0,15,6520000.0
6520,6520999,20.281178855361542,37.31437796256188,0.07743176783072692,1032.8001289367676,431.14309549331665,778.1657447814941,25003,6421,18582,18582,0,15,6521000.0
6521,6521999,20.28064966137917,37.31269379637373,0.07743909684491757,1032.9410960674286,431.21146845817566,778.2629890441895,25003,6421,18582,18582,0,15,6522000.0
6522,6522999,20.280357387892327,37.31114548884829,0.0774474996338056,1033.1282088756561,431.27772760391235,778.3224639892578,25013,6422,18591,18591,0,15,6523000.0
6523,6523999,20.28009221664968,37.30963631918824,0.07746132304072118,1033.49258852005,431.344868183136,778.2217826843262,25039,6426,18613,18613,0,15,6524000.0
6524,6524999,20.279169305109086,37.307670787979234,0.07747881497873288,1033.6165928840637,431.4124894142151,779.4625968933105,25081,6426,18655,18655,0,15,6525000.0
6525,6525999,20.27826550629388,37.306717809098735,0.07748256829870037,1033.7279977798462,431.47868156433105,780.1174507141113,25089,6426,18663,18663,0,15,6526000.0
6526,6526999,20.2772814964617,37.30548042752049,0.0774902250743964,1033.8393058776855,431.5444722175598,780.4866104125977,25091,6426,18665,18665,0,15,6527000.0
6527,6527999,20.276101317037927,37.30337177573382,0.07750303697797312,1034.0783553123474,431.61007857322693,780.7042503356934,25095,6428,18667,18667,0,15,6528000.0
6528,6528999,20.27492229409721,37.301229438747455,0.07751986680151868,1034.2483186721802,431.6758804321289,780.9429550170898,25097,6429,18668,18668,0,15,6529000.0
6529,6529999,20.273715159584526,37.2991096470252,0.07753357683711559,1034.4771637916565,431.74267745018005,781.1078338623047,25101,6431,18670,18670,0,15,6530000.0
6530,6530999,20.27256706360183,37.29711836553734,0.07754888847920471,1034.8288280963898,431.80964183807373,781.1263122558594,25109,6435,18674,18674,0,15,6531000.0
6531,6531999,20.27141156206562,37.29507383677666,0.07756324735962639,1035.071174621582,431.8762454986572,781.2833976745605,25113,6437,18676,18676,0,15,6532000.0
6532,6532999,20.270194751396907,37.29288004350441,0.07757701544204165,1035.2446196079254,431.943719625473,781.4787826538086,25115,6438,18677,18677,0,15,6533000.0
6533,6533999,20.269125352376648,37.29128216501549,0.07758428197877132,1035.4199907779694,432.00995230674744,781.6454238891602,25117,6439,18678,18678,0,15,6534000.0
6534,6534999,20.267891680510303,37.28915564320238,0.07759855370546997,1035.6681833267212,432.07640290260315,781.7137641906738,25137,6441,18696,18696,0,15,6535000.0
6535,6535999,20.26688201262243,37.28739864631271,0.0776122616020688,1035.8012676239014,432.14260935783386,781.9041862487793,25137,6441,18696,18696,0,15,6536000.0
6536,6536999,20.265829996135302,37.28575212256892,0.07762723151553441,1035.9212079048157,432.20972180366516,782.0471115112305,25137,6441,18696,18696,0,15,6537000.0
6537,6537999,20.26463993152792,37.28354496300414,0.07764658944882497,1036.2189893722534,432.27607107162476,782.0833320617676,25159,6444,18715,18715,0,15,6538000.0
6538,6538999,20.26358967720417,37.28156870465292,0.07766312819537557,1036.519228219986,432.3427450656891,782.0961723327637,25191,6447,18744,18744,0,15,6539000.0
6539,6539999,20.262370109910034,37.27938920723501,0.07768223000310859,1036.7703211307526,432.40943336486816,782.0865097045898,25195,6449,18746,18746,0,15,6540000.0
6540,6540999,20.261106605038385,37.2772120536418,0.07770110068957425,1037.024526834488,432.4762921333313,782.2058219909668,25199,6451,18748,18748,0,15,6541000.0
6541,6541999,20.260502953773987,37.277219605959054,0.07768399721358721,1037.1990458965302,432.54408288002014,783.0734558105469,25226,6452,18774,18774,0,15,6542000.0
6542,6542999,20.259536905806538,37.27533918857303,0.07768972640730354,1037.3166143894196,432.6095688343048,783.5668449401855,25231,6452,18779,18779,0,15,6543000.0
6543,6543999,20.259017337932345,37.27576535879191,0.07768323215771722,1037.5524241924286,432.67535614967346,783.7691421508789,25242,6454,18788,18788,0,15,6544000.0
6544,6544999,20.258213668927013,37.27416562518338,0.0776881741372133,1037.728458404541,432.7405581474304,784.0096549987793,25245,6455,18790,18790,0,15,6545000.0
6545,6545999,20.257549005194104,37.27293692348449,0.07768863985608276,1038.0287370681763,432.806978225708,784.1188316345215,25259,6458,18801,18801,0,15,6546000.0
6546,6546999,20.256908777862893,37.27150787536042,0.07769071833005625,1038.208946466446,432.8728995323181,784.2592887878418,25261,6459,18802,18802,0,15,6547000.0
6547,6547999,20.256167353878983,37.270127913020126,0.07769235237650673,1038.5150039196014,432.9397521018982,784.3262176513672,25268,6462,18806,18806,0,15,6548000.0
6548,6548999,20.255435633084257,37.2685027600722,0.07769625811834835,1038.756695985794,433.00623750686646,784.4363594055176,25272,6464,18808,18808,0,15,6549000.0
6549,6549999,20.254590131246246,37.26706065810901,0.0776986161383344,1038.8886396884918,433.0733730792999,784.6129112243652,25272,6464,18808,18808,0,15,6550000.0
6550,6550999,20.253946615743832,37.26577786511215,0.07769625850319217,1039.1358633041382,433.1400513648987,784.7134742736816,25276,6466,18810,18810,0,15,6551000.0
6551,6551999,20.253484885542452,37.26531312436411,0.07769304295790147,1039.3113038539886,433.2059426307678,784.8359565734863,25279,6467,18812,18812,0,15,6552000.0
6552,6552999,20.252873133833866,37.26395407792816,0.07769225135725055,1039.6248080730438,433.2727768421173,784.8378562927246,25285,6470,18815,18815,0,15,6553000.0
6553,6553999,20.252467365876143,37.26327832552466,0.07768594464991341,1039.8157761096954,433.3391492366791,784.9396286010742,25287,6471,18816,18816,0,15,6554000.0
6554,6554999,20.25199112648164,37.26202441336438,0.0776849169098427,1039.9383828639984,433.40522503852844,785.096019744873,25287,6471,18816,18816,0,15,6555000.0
6555,6555999,20.251501459959638,37.26063432863883,0.07768492657676851,1040.0749244689941,433.47332286834717,785.1819229125977,25287,6471,18816,18816,0,15,6556000.0
6556,6556999,20.251058545502683,37.259313604454434,0.07768724936916815,1040.264729976654,433.5396571159363,785.2423858642578,25289,6472,18817,18817,0,15,6557000.0
6557,6557999,20.250421867136176,37.25779275012981,0.07768830586860331,1040.450446844101,433.6067626476288,785.2814331054688,25300,6473,18827,18827,0,15,6558000.0
6558,6558999,20.249925587348645,37.25624232971437,0.07768992922522822,1040.644630908966,433.67425870895386,785.341480255127,25302,6474,18828,18828,0,15,6559000.0
6559,6559999,20.24930531760725,37.255303530231984,0.07767287910638909,1040.8411490917206,433.7419626712799,785.9449768066406,25327,6475,18852,18852,0,15,6560000.0
6560,6560999,20.249354404004578,37.260173288229915,0.07763534330709332,1041.01740193367,433.80947947502136,786.5246124267578,25338,6476,18862,18862,0,15,6561000.0
6561,6561999,20.24846099580352,37.25860999158332,0.07763558633115852,1041.1312873363495,433.8765666484833,786.9509811401367,25342,6476,18866,18866,0,15,6562000.0
6562,6562999,20.24774241438622,37.25793618562284,0.07763419809941174,1041.478515625,433.94365668296814,787.0582847595215,25350,6480,18870,18870,0,15,6563000.0
6563,6563999,20.24695877650482,37.256332218680804,0.07763772910157374,1041.6588401794434,434.0128574371338,787.3159255981445,25352,6481,18871,18871,0,15,6564000.0
6564,6564999,20.246116799065494,37.25509455901956,0.07763800466158854,1042.0192239284515,434.08067989349365,787.36572265625,25360,6485,18875,18875,0,15,6565000.0
6565,6565999,20.245159904658333,37.25387510360035,0.07763572737404356,1042.14888215065,434.1479661464691,787.6168632507324,25360,6485,18875,18875,0,15,6566000.0
6566,6566999,20.244394174416637,37.25231472069005,0.07763541083853398,1042.325982093811,434.2160050868988,787.7530136108398,25362,6486,18876,18876,0,15,6567000.0
6567,6567999,20.24394799415548,37.25171001954482,0.07762906909854184,1042.5763323307037,434.2837862968445,787.8257484436035,25375,6488,18887,18887,0,15,6568000.0
6568,6568999,20.243495052186148,37.25072453044159,0.07762453078634735,1042.8699469566345,434.35026025772095,787.8199501037598,25390,6491,18899,18899,0,15,6569000.0
6569,6569999,20.24284634976226,37.24932558752819,0.07762479241812481,1043.0629675388336,434.4171299934387,787.9854354858398,25392,6492,18900,18900,0,15,6570000.0
6570,6570999,20.242484031006164,37.24859169513373,0.07762076490681857,1043.1982209682465,434.4840598106384,788.1473541259766,25392,6492,18900,18900,0,15,6571000.0
6571,6571999,20.24242927657544,37.248224950163916,0.07761767431626765,1043.4372651576996,434.5516016483307,788.177791595459,25396,6494,18902,18902,0,15,6572000.0
6572,6572999,20.2425261081662,37.247736445336585,0.0776127906610623,1043.5600612163544,434.6177523136139,788.2997436523438,25396,6494,18902,18902,0,15,6573000.0
6573,6573999,20.242898734907435,37.24797836553,0.07761271805889058,1043.8581883907318,434.6849641799927,788.2844657897949,25402,6497,18905,18905,0,15,6574000.0
6574,6574999,20.243402361027936,37.248399432486636,0.07761482503945205,1043.994781255722,434.75161623954773,788.4000663757324,25402,6497,18905,18905,0,15,6575000.0
6575,6575999,20.244937584800347,37.251280407625416,0.07762270544474803,1044.191113948822,434.81884837150574,788.4819450378418,25404,6498,18906,18906,0,15,6576000.0
6576,6576999,20.245880660687646,37.25204537283018,0.07763910240377736,1044.3759186267853,434.8866460323334,788.5612831115723,25406,6499,18907,18907,0,15,6577000.0
6577,6577999,20.247471440149692,37.255793524841145,0.07763863171004959,1044.625471830368,434.9545142650604,788.5790710449219,25427,6501,18926,18926,0,15,6578000.0
6578,6578999,20.249085794026826,37.25783837608205,0.07764816621272796,1044.7575600147247,435.0225524902344,788.7060546875,25427,6501,18926,18926,0,15,6579000.0
6579,6579999,20.24995743075403,37.25833635011097,0.07765977802517765,1044.956196308136,435.08992624282837,788.7323150634766,25429,6502,18927,18927,0,15,6580000.0
6580,6580999,20.250081246720953,37.25829070217733,0.07766711803994863,1045.1401982307434,435.15918350219727,789.5685653686523,25465,6503,18962,18962,0,15,6581000.0
6581,6581999,20.24936877467464,37.25721165516666,0.07766285851894794,1045.3094894886017,435.22534680366516,790.0549354553223,25470,6504,18966,18966,0,15,6582000.0
6582,6582999,20.24901147004106,37.25690098579375,0.0776549893859243,1045.48393201828,435.2913587093353,790.3706245422363,25473,6505,18968,18968,0,15,6583000.0
6583,6583999,20.248995612078176,37.25887015590313,0.0776437075617118,1045.5979347229004,435.35694551467896,790.6335334777832,25473,6505,18968,18968,0,15,6584000.0
6584,6584999,20.248870403999035,37.25791786725381,0.0776402056973522,1045.9598505496979,435.4241256713867,790.7029685974121,25481,6509,18972,18972,0,15,6585000.0
6585,6585999,20.24892350698301,37.25768676032915,0.07763900779770605,1046.0750489234924,435.4907441139221,790.9650344848633,25481,6509,18972,18972,0,15,6586000.0
6586,6586999,20.248898233486315,37.25680903997214,0.07764068641753696,1046.3689849376678,435.55803418159485,791.0332260131836,25487,6512,18975,18975,0,15,6587000.0
6587,6587999,20.24901848156394,37.25666300633671,0.07764658233147181,1046.6900889873505,435.62638115882874,791.1161079406738,25493,6515,18978,18978,0,15,6588000.0
6588,6588999,20.249324693926457,37.25689995852593,0.0776526027447193,1046.8137137889862,435.69395875930786,791.3137702941895,25493,6515,18978,18978,0,15,6589000.0
6589,6589999,20.24964714919725,37.25706261609436,0.07766020843554944,1046.9311175346375,435.7612223625183,791.4837265014648,25493,6515,18978,18978,0,15,6590000.0
6590,6590999,20.250268806046776,37.257721970065795,0.07767525217512428,1047.2315962314606,435.8291165828705,791.4963340759277,25499,6518,18981,18981,0,15,6591000.0
6591,6591999,20.251056051267877,37.25864651142594,0.07771108111461278,1047.4203662872314,435.89730739593506,791.6655731201172,25502,6519,18983,18983,0,15,6592000.0
6592,6592999,20.252046780727408,37.25993825190781,0.07775507068108767,1047.628633260727,435.9655454158783,791.776538848877,25504,6520,18984,18984,0,15,6593000.0
6593,6593999,20.253670605956813,37.26431576469657,0.07780653356153044,1047.7462351322174,436.032342672348,791.8769454956055,25504,6520,18984,18984,0,15,6594000.0
6594,6594999,20.254794924740686,37.265391066382215,0.07783716942035468,1047.926558971405,436.0993585586548,791.9657020568848,25506,6521,18985,18985,0,15,6595000.0
6595,6595999,20.256679357115658,37.27045503306221,0.07790037383366488,1048.1787996292114,436.167503118515,791.9697570800781,25510,6523,18987,18987,0,15,6596000.0
6596,6596999,20.258712294547546,37.27684647017594,0.07794656615320128,1048.4173715114594,436.2349498271942,791.9691314697266,25514,6525,18989,18989,0,15,6597000.0
6597,6597999,20.260770051676147,37.280031954533754,0.07802102396534938,1048.6111099720001,436.3032793998718,792.0994148254395,25516,6526,18990,18990,0,15,6598000.0
6598,6598999,20.262491897693607,37.283510623517955,0.07809851031080761,1048.7525663375854,436.3714551925659,792.2460899353027,25516,6526,18990,18990,0,15,6599000.0
6599,6599999,20.26457061947444,37.28670002642095,0.0781758445687799,1048.9412021636963,436.43876004219055,792.3168487548828,25518,6527,18991,18991,0,15,6600000.0
6600,6600999,20.266126183331835,37.28842877803748,0.07822725644671646,1049.1353900432587,436.50591921806335,792.3784523010254,25520,6528,18992,18992,0,15,6601000.0
6601,6601999,20.265968567760154,37.2874595123182,0.07822362262903304,1049.2571468353271,436.57364225387573,793.3652305603027,25551,6528,19023,19023,0,15,6602000.0
6602,6602999,20.264844644013266,37.28595252916852,0.0782259481668387,1049.4342150688171,436.6406400203705,793.7589569091797,25554,6529,19025,19025,0,15,6603000.0
6603,6603999,20.264058901726006,37.28485075037247,0.07822103082036813,1049.6034269332886,436.706179857254,794.0037727355957,25556,6530,19026,19026,0,15,6604000.0
6604,6604999,20.26319391499541,37.283479918106664,0.0782207585432364,1049.8469903469086,436.7727150917053,794.110725402832,25560,6532,19028,19028,0,15,6605000.0
6605,6605999,20.262592432572973,37.282414993131525,0.07821592592973037,1050.0915710926056,436.8401188850403,794.3075904846191,25564,6534,19030,19030,0,15,6606000.0
6606,6606999,20.261685457620853,37.28079644160673,0.07821749889193497,1050.342126607895,436.9083881378174,794.4935035705566,25568,6536,19032,19032,0,15,6607000.0
6607,6607999,20.26082090839102,37.27906891317307,0.07821609529115425,1050.5778498649597,436.9753396511078,794.5954132080078,25572,6538,19034,19034,0,15,6608000.0
6608,6608999,20.25996128556755,37.27734933106927,0.07821667158305112,1050.7690603733063,437.04213070869446,794.7719383239746,25574,6539,19035,19035,0,15,6609000.0
6609,6609999,20.259161968899214,37.27554499235566,0.07821578608158042,1051.0136790275574,437.10857915878296,794.8027114868164,25578,6541,19037,19037,0,15,6610000.0
6610,6610999,20.258575266942092,37.27431520829257,0.07821067432010953,1051.1374263763428,437.1744296550751,794.9591827392578,25578,6541,19037,19037,0,15,6611000.0
6611,6611999,20.258013028095306,37.272895491602426,0.07820612828374518,1051.316201210022,437.24092173576355,795.05615234375,25580,6542,19038,19038,0,15,6612000.0
6612,6612999,20.25766158580491,37.27233875921898,0.07820119221348742,1051.5597088336945,437.3080554008484,795.0809326171875,25584,6544,19040,19040,0,15,6613000.0
6613,6613999,20.257177921463995,37.27091935458011,0.07819710823333015,1051.8718466758728,437.3764066696167,795.1595878601074,25591,6547,19044,19044,0,15,6614000.0
6614,6614999,20.25683898356394,37.269886360490176,0.07819234534712372,1052.187463760376,437.44403076171875,795.1656265258789,25597,6550,19047,19047,0,15,6615000.0
6615,6615999,20.25658255525811,37.26860509499668,0.07818188057749031,1052.3260304927826,437.52040696144104,795.3638114929199,25597,6550,19047,19047,0,15,6616000.0
6616,6616999,20.256486428710208,37.26780952740165,0.07818549736151637,1052.4574043750763,437.58768010139465,795.4729080200195,25597,6550,19047,19047,0,15,6617000.0
6617,6617999,20.25638394085105,37.267060066838965,0.07818172617696462,1052.650062084198,437.6554424762726,795.5634346008301,25599,6551,19048,19048,0,15,6618000.0
6618,6618999,20.256036270548655,37.265784120402,0.07818094732990533,1052.8441905975342,437.72313952445984,795.6487426757812,25601,6552,19049,19049,0,15,6619000.0
6619,6619999,20.25580248468404,37.26461262732099,0.07817950597285805,1053.0490679740906,437.791348695755,795.6946144104004,25603,6553,19050,19050,0,15,6620000.0
6620,6620999,20.25530633397855,37.26307395372704,0.07818234713540162,1053.2320704460144,437.8578681945801,795.7745628356934,25605,6554,19051,19051,0,15,6621000.0
6621,6621999,20.254840777934522,37.26157704736021,0.07817913071497962,1053.4201736450195,437.9257571697235,795.8974990844727,25607,6555,19052,19052,0,15,6622000.0
6622,6622999,20.254405600508495,37.261244079662454,0.07815716470359257,1056.543517589569,437.9934067726135,796.8177490234375,25655,6557,19098,19098,0,15,6623000.0
6623,6623999,20.25352024038028,37.259817551653214,0.07815650695669996,1056.8509974479675,438.0607717037201,797.1518859863281,25679,6560,19119,19119,0,15,6624000.0
6624,6624999,20.252437066822623,37.257694716765904,0.07816403161397978,1056.9708302021027,438.12732577323914,797.412166595459,25679,6560,19119,19119,0,15,6625000.0
6625,6625999,20.251612198791182,37.255892758743926,0.07816564788332203,1057.284214258194,438.1947467327118,797.4854774475098,25685,6563,19122,19122,0,15,6626000.0
6626,6626999,20.250812334845932,37.254349598881845,0.07816712948153448,1057.6724734306335,438.26465797424316,797.565185546875,25693,6567,19126,19126,0,15,6627000.0
6627,6627999,20.25008360898466,37.252885729797725,0.07816625631317009,1057.7931454181671,438.3318512439728,797.8408660888672,25693,6567,19126,19126,0,15,6628000.0
6628,6628999,20.249192713810388,37.25108691362564,0.07816975837896001,1058.0504887104034,438.39923191070557,797.956127166748,25697,6569,19128,19128,0,15,6629000.0
6629,6629999,20.248289377175013,37.24941966492913,0.07817179985884881,1058.1781764030457,438.46666955947876,798.1882858276367,25698,6569,19129,19129,0,15,6630000.0
6630,6630999,20.247438856354627,37.24773786622784,0.07817336714751255,1058.3766012191772,438.5351827144623,798.3011589050293,25700,6570,19130,19130,0,15,6631000.0
6631,6631999,20.246486526564333,37.245739437975786,0.07817929998458939,1058.629477262497,438.6033716201782,798.3685455322266,25704,6572,19132,19132,0,15,6632000.0
6632,6632999,20.245488088162052,37.24390286664658,0.07818222783761564,1058.758308649063,438.67057061195374,798.5304145812988,25704,6572,19132,19132,0,15,6633000.0
6633,6633999,20.244527432819037,37.242187638511616,0.0781837543523618,1058.8991985321045,438.73715329170227,798.6454200744629,25704,6572,19132,19132,0,15,6634000.0
6634,6634999,20.24373897848817,37.24109083928997,0.0781821868781647,1059.0465984344482,438.8121609687805,798.7348289489746,25704,6572,19132,19132,0,15,6635000.0
6635,6635999,20.243060066056774,37.23961706925044,0.07818331795699163,1059.1840980052948,438.8798909187317,798.8644256591797,25704,6572,19132,19132,0,15,6636000.0
6636,6636999,20.242328531829386,37.23847910063081,0.07817780262435547,1059.3748297691345,438.94768834114075,798.9067115783691,25706,6573,19133,19133,0,15,6637000.0
6637,6637999,20.241628651155768,37.23690661191215,0.07817757608042919,1059.633059978485,439.0181415081024,798.8492813110352,25717,6575,19142,19142,0,15,6638000.0
6638,6638999,20.24093973553835,37.23533538747312,0.07817772030451753,1059.8327887058258,439.0864157676697,798.9644584655762,25719,6576,19143,19143,0,15,6639000.0
6639,6639999,20.240286814414162,37.2338454781869,0.07817689187769095,1060.0325515270233,439.15462255477905,798.9927635192871,25721,6577,19144,19144,0,15,6640000.0
6640,6640999,20.239785349103055,37.234460937867325,0.07816958484058179,1060.3802645206451,439.22385835647583,798.9382820129395,25733,6580,19153,19153,0,15,6641000.0
6641,6641999,20.23896884417143,37.23265656029219,0.07817493140339726,1060.533630847931,439.29993057250977,799.0680885314941,25733,6580,19153,19153,0,15,6642000.0
6642,6642999,20.23844860906175,37.23098813974301,0.07817604474092321,1060.7265706062317,439.3700158596039,799.9890594482422,25770,6581,19189,19189,0,15,6643000.0
6643,6643999,20.2378894251801,37.229973301653494,0.07816717911721272,1060.853432416916,439.43785309791565,800.706615447998,25782,6581,19201,19201,0,15,6644000.0
6644,6644999,20.23712046135055,37.22831514460338,0.07816431046731709,1061.0960013866425,439.50617814064026,801.0033645629883,25800,6583,19217,19217,0,15,6645000.0
6645,6645999,20.236515221691857,37.226782760481925,0.07816021176596955,1061.3377194404602,439.5735614299774,801.1959114074707,25818,6585,19233,19233,0,15,6646000.0
6646,6646999,20.236216502522048,37.22539533646282,0.07815575385551676,1061.55526804924,439.6450343132019,801.4153594970703,25820,6586,19234,19234,0,15,6647000.0
6647,6647999,20.235533847046486,37.223614592676626,0.07815530113675784,1061.7441902160645,439.71264815330505,801.6241645812988,25829,6587,19242,19242,0,15,6648000.0
6648,6648999,20.235004094975057,37.221856289739705,0.07815476156625545,1061.936695575714,439.78070974349976,801.7422485351562,25831,6588,19243,19243,0,15,6649000.0
6649,6649999,20.234520530852738,37.22025521163232,0.07815535752110969,1062.1421236991882,439.8486304283142,801.8598289489746,25833,6589,19244,19244,0,15,6650000.0
6650,6650999,20.234068204961506,37.218826913016244,0.07815274953001161,1062.3950109481812,439.91656732559204,801.9674606323242,25873,6591,19282,19282,0,15,6651000.0
6651,6651999,20.233607526211618,37.217623601558316,0.07815018760771109,1062.6496391296387,439.9832572937012,802.010799407959,25877,6593,19284,19284,0,15,6652000.0
6652,6652999,20.233374542046857,37.21651540706304,0.07814791805325838,1062.8627905845642,440.05144238471985,802.0932159423828,25879,6594,19285,19285,0,15,6653000.0
6653,6653999,20.23288540030451,37.21536388393506,0.0781505824540516,1062.9908833503723,440.1194369792938,802.2375335693359,25879,6594,19285,19285,0,15,6654000.0
6654,6654999,20.232417175818824,37.21420911598101,0.07815352998871161,1063.297085762024,440.1862509250641,802.2089347839355,25899,6597,19302,19302,0,15,6655000.0
6655,6655999,20.23195756995953,37.21372626892654,0.07815345794757456,1063.6389157772064,440.2544550895691,802.2102432250977,25905,6600,19305,19305,0,15,6656000.0
6656,6656999,20.231477661277346,37.212400323992824,0.07815634844657782,1063.771250486374,440.3220648765564,802.3875617980957,25905,6600,19305,19305,0,15,6657000.0
6657,6657999,20.231442563656763,37.212246586471046,0.07815592799605275,1063.9687688350677,440.3896474838257,802.4586639404297,25907,6601,19306,19306,0,15,6658000.0
6658,6658999,20.23119278187587,37.2113014663245,0.07815736869683465,1064.1605756282806,440.4572467803955,802.5188179016113,25909,6602,19307,19307,0,15,6659000.0
6659,6659999,20.23082514252816,37.21017234260895,0.07815608891238868,1064.3035140037537,440.52391386032104,802.6852493286133,25909,6602,19307,19307,0,15,6660000.0
6660,6660999,20.230569364447472,37.20902422374624,0.07815355184715944,1064.4398715496063,440.59222865104675,802.7718849182129,25909,6602,19307,19307,0,15,6661000.0
6661,6661999,20.230246255387122,37.2076600824575,0.07815654191471533,1064.8922305107117,440.66045117378235,802.662899017334,25947,6607,19340,19340,0,15,6662000.0
6662,6662999,20.22977147371833,37.206035798388946,0.0781588127319589,1065.096078634262,440.72838282585144,802.8022117614746,25956,6608,19348,19348,0,15,6663000.0
6663,6663999,20.230003027167825,37.20650521880207,0.0781376497141294,1065.2924785614014,440.79714345932007,803.637939453125,25983,6609,19374,19374,0,15,6664000.0
6664,6664999,20.22992535252685,37.20644856469429,0.07812296107738248,1065.4151964187622,440.8644862174988,804.0542755126953,25985,6609,19376,19376,0,15,6665000.0
6665,6665999,20.229503649398207,37.205417858709396,0.07811521184172021,1065.597963809967,440.9313955307007,804.2506561279297,25988,6610,19378,19378,0,15,6666000.0
6666,6666999,20.229164378526075,37.204399537859345,0.07810798854717615,1065.7840752601624,440.99542212486267,804.4538688659668,25990,6611,19379,19379,0,15,6667000.0
6667,6667999,20.229101440568098,37.20416353143032,0.07809551715177221,1065.965662240982,441.05962681770325,804.644905090332,25992,6612,19380,19380,0,15,6668000.0
6668,6668999,20.228890548840152,37.203512646255625,0.07808773172277472,1066.1441156864166,441.12391543388367,804.813549041748,25994,6613,19381,19381,0,15,6669000.0
6669,6669999,20.22896659563852,37.20331562445478,0.0780784772917541,1066.383245229721,441.18884015083313,804.8862953186035,25999,6615,19384,19384,0,15,6670000.0
6670,6670999,20.229009100045477,37.2032015059872,0.07806530911226894,1066.5667366981506,441.2530851364136,805.0277442932129,26001,6616,19385,19385,0,15,6671000.0
6671,6671999,20.2288384956051,37.20240412732623,0.07805794860128557,1066.83056306839,441.31863474845886,805.08740234375,26005,6618,19387,19387,0,15,6672000.0
6672,6672999,20.22889453102076,37.20192443948244,0.07805096124141586,1066.9580211639404,441.3828649520874,805.2480430603027,26005,6618,19387,19387,0,15,6673000.0
6673,6673999,20.229027486517513,37.20231415309948,0.07803587504100662,1067.147459745407,441.4487533569336,805.3356857299805,26007,6619,19388,19388,0,15,6674000.0
6674,6674999,20.229193570044135,37.202210193127335,0.07802811717078995,1067.330720424652,441.51223707199097,805.3853530883789,26009,6620,19389,19389,0,15,6675000.0
6675,6675999,20.22933101400372,37.20192321242062,0.07802591979759255,1067.4514276981354,441.57677364349365,805.5309028625488,26009,6620,19389,19389,0,15,6676000.0
6676,6676999,20.229959587773315,37.20314240785658,0.07801543857915139,1067.6679863929749,441.6419348716736,805.5853729248047,26011,6621,19390,19390,0,15,6677000.0
6677,6677999,20.230892068680333,37.204983030693775,0.07800337434396742,1067.8469388484955,441.7053554058075,805.6786079406738,26013,6622,19391,19391,0,15,6678000.0
6678,6678999,20.23157044839119,37.20586927188783,0.07799253756613489,1068.0260145664215,441.7710418701172,805.7262382507324,26015,6623,19392,19392,0,15,6679000.0
6679,6679999,20.23263904377355,37.208238203462834,0.07798502138114827,1068.1505918502808,441.8343598842621,805.8501243591309,26015,6623,19392,19392,0,15,6680000.0
6680,6680999,20.233753478246236,37.21046601374565,0.07797599328484461,1068.3513379096985,441.8992073535919,805.8824806213379,26017,6624,19393,19393,0,15,6681000.0
6681,6681999,20.234902629322864,37.212805375426846,0.07797310182569794,1068.5380630493164,441.96316170692444,805.8985366821289,26019,6625,19394,19394,0,15,6682000.0
6682,6682999,20.23652823340192,37.21625410715757,0.07798102777829274,1068.8010680675507,442.0304505825043,805.9126434326172,26023,6627,19396,19396,0,15,6683000.0
6683,6683999,20.23775049685963,37.21908197175151,0.07798423429499213,1068.985314130783,442.09504199028015,806.0133285522461,26025,6628,19397,19397,0,15,6684000.0
6684,6684999,20.23842614719849,37.221644187611794,0.07796156616363681,1069.1012828350067,442.15995955467224,806.9174423217773,26050,6628,19422,19422,0,15,6685000.0
6685,6685999,20.238758149826808,37.23164400656391,0.07791834362235428,1069.221801996231,442.22719621658325,807.2393760681152,26051,6628,19423,19423,0,15,6686000.0
6686,6686999,20.238722981074677,37.23223263018802,0.0779071877941494,1069.6590204238892,442.29025053977966,807.2487983703613,26067,6633,19434,19434,0,15,6687000.0
6687,6687999,20.23870547860965,37.23498691284303,0.07788928638683612,1069.8987357616425,442.3545401096344,807.4944190979004,26073,6635,19438,19438,0,15,6688000.0
6688,6688999,20.238284186989404,37.23421989562499,0.07788552534281856,1070.0786485671997,442.4169018268585,807.6714363098145,26079,6636,19443,19443,0,15,6689000.0
6689,6689999,20.23835482955061,37.236762933037824,0.07786916876177563,1070.466603755951,442.4820909500122,807.7179565429688,26091,6640,19451,19451,0,15,6690000.0
6690,6690999,20.238666838329628,37.23726896198621,0.07785806871072076,1070.6435067653656,442.5453202724457,807.9525489807129,26096,6641,19455,19455,0,15,6691000.0
6691,6691999,20.238475269127317,37.236251864044824,0.07786121550488145,1070.8435187339783,442.60945987701416,808.1099128723145,26107,6642,19465,19465,0,15,6692000.0
6692,6692999,20.23917535071568,37.23817643076138,0.07785259095791486,1070.974348783493,442.67306113243103,808.3160781860352,26109,6642,19467,19467,0,15,6693000.0
6693,6693999,20.239538378013858,37.238921152537124,0.0778453720882264,1071.0963687896729,442.73544907569885,808.4429016113281,26109,6642,19467,19467,0,15,6694000.0
6694,6694999,20.240576253488964,37.24112820534347,0.07785442909174645,1071.2184467315674,442.7993552684784,808.578784942627,26111,6642,19469,19469,0,15,6695000.0
6695,6695999,20.241691285254912,37.24739313922225,0.07783959622836667,1071.4093797206879,442.86242055892944,808.6631889343262,26113,6643,19470,19470,0,15,6696000.0
6696,6696999,20.242825606332865,37.249420682866734,0.0778474704199067,1071.6216039657593,442.92746686935425,808.6933784484863,26116,6644,19472,19472,0,15,6697000.0
6697,6697999,20.24373087925569,37.2515170988533,0.07786562867456592,1071.858479976654,442.99017882347107,808.7848434448242,26120,6646,19474,19474,0,15,6698000.0
6698,6698999,20.24536082349377,37.256968062346786,0.07790051084852168,1072.1064732074738,443.0547180175781,808.8208045959473,26125,6648,19477,19477,0,15,6699000.0
6699,6699999,20.245928745765507,37.25728719134751,0.07788709790189774,1072.2860498428345,443.1190016269684,809.2892074584961,26144,6649,19495,19495,0,15,6700000.0
6700,6700999,20.246122656612634,37.25881963923258,0.07787147366165315,1072.535106420517,443.1850006580353,809.7081909179688,26151,6651,19500,19500,0,15,6701000.0
6701,6701999,20.24606721751189,37.25859730545735,0.07786370186775604,1072.6669187545776,443.2558329105377,810.0050773620605,26151,6651,19500,19500,0,15,6702000.0
6702,6702999,20.246421766708057,37.2593038340172,0.07785578115521352,1072.9084405899048,443.3212707042694,810.1537170410156,26155,6653,19502,19502,0,15,6703000.0
6703,6703999,20.24639038787314,37.25894763002952,0.0778527898303929,1073.102573633194,443.38561367988586,810.2461318969727,26157,6654,19503,19503,0,15,6704000.0
6704,6704999,20.246436383721264,37.25868828978738,0.07785247240336679,1073.3924794197083,443.45013451576233,810.3537673950195,26163,6657,19506,19506,0,15,6705000.0
6705,6705999,20.24677289556689,37.25880510282863,0.07785889076216812,1073.7229330539703,443.5224621295929,810.4442710876465,26169,6660,19509,19509,0,15,6706000.0
6706,6706999,20.247113050694907,37.258926956253575,0.07786241374031577,1073.9059102535248,443.5888295173645,810.5696640014648,26171,6661,19510,19510,0,15,6707000.0
6707,6707999,20.247948701823546,37.26041847866887,0.07786845023365108,1074.0497720241547,443.65542101860046,810.722770690918,26171,6661,19510,19510,0,15,6708000.0
6708,6708999,20.24872463666561,37.26123640485359,0.0778768533140306,1074.228729724884,443.7203688621521,810.8206520080566,26173,6662,19511,19511,0,15,6709000.0
6709,6709999,20.249800638758376,37.26227020430097,0.07788590750818847,1074.4131255149841,443.7845313549042,810.8560371398926,26175,6663,19512,19512,0,15,6710000.0
6710,6710999,20.25055985463973,37.26300387448161,0.07789314855997487,1074.5513610839844,443.84752440452576,810.9555969238281,26175,6663,19512,19512,0,15,6711000.0
6711,6711999,20.251583784120346,37.26435753003999,0.07789955583479258,1074.7418982982635,443.91430282592773,810.9938621520996,26177,6664,19513,19513,0,15,6712000.0
6712,6712999,20.2529938103916,37.26693261395567,0.0779044436948868,1074.9363145828247,443.9782769680023,811.0037384033203,26179,6665,19514,19514,0,15,6713000.0
6713,6713999,20.254158143315202,37.26801782161987,0.07792342088332094,1075.1244006156921,444.04404950141907,811.0863418579102,26181,6666,19515,19515,0,15,6714000.0
6714,6714999,20.255538326924984,37.270451235937685,0.07793997360847604,1075.3114557266235,444.10836362838745,811.1464385986328,26183,6667,19516,19516,0,15,6715000.0
6715,6715999,20.256461719973235,37.271230555650625,0.07795331545914208,1075.4981627464294,444.17161083221436,811.2077178955078,26185,6668,19517,19517,0,15,6716000.0
6716,6716999,20.257776843587862,37.272311216907006,0.07796953726176681,1075.6837527751923,444.2361214160919,811.2703971862793,26187,6669,19518,19518,0,15,6717000.0
6717,6717999,20.25896478821996,37.27324888001049,0.07797399331736499,1075.875877380371,444.30061745643616,811.3013725280762,26189,6670,19519,19519,0,15,6718000.0
6718,6718999,20.25986589253076,37.27472594862401,0.07792953666013691,1075.9920403957367,444.365193605423,811.9047775268555,26204,6670,19534,19534,0,15,6719000.0
6719,6719999,20.25997362209319,37.276022219567,0.07791210212174704,1076.1060733795166,444.427654504776,812.322624206543,26206,6670,19536,19536,0,15,6720000.0
6720,6720999,20.259650884716294,37.274970954340596,0.07790458244993714,1076.229207277298,444.49476623535156,812.5383071899414,26206,6670,19536,19536,0,15,6721000.0
6721,6721999,20.259411855627057,37.273924748859656,0.07789788558744759,1076.6458053588867,444.558753490448,812.5863304138184,26216,6675,19541,19541,0,15,6722000.0
6722,6722999,20.259403846822035,37.27393086126747,0.07788530614209777,1076.8738129138947,444.62176847457886,812.7065124511719,26220,6677,19543,19543,0,15,6723000.0
6723,6723999,20.259328173341807,37.273041016810616,0.07787900204318177,1077.0600311756134,444.68736028671265,812.8086013793945,26222,6678,19544,19544,0,15,6724000.0
6724,6724999,20.259126462701992,37.27206515516141,0.0778723430250049,1077.362693309784,444.7521584033966,812.8193511962891,26233,6681,19552,19552,0,15,6725000.0
6725,6725999,20.259190888591665,37.27163299657711,0.0778673393717968,1077.4890851974487,444.81649112701416,813.0060348510742,26233,6681,19552,19552,0,15,6726000.0
6726,6726999,20.259277732235304,37.27110887694671,0.07785615776013832,1077.6778507232666,444.8806002140045,813.0408172607422,26235,6682,19553,19553,0,15,6727000.0
6727,6727999,20.25979798649128,37.2716449881461,0.07784401340273395,1077.8721525669098,444.94673585891724,813.0935554504395,26237,6683,19554,19554,0,15,6728000.0
6728,6728999,20.260150837332496,37.27157896879798,0.07783716565737187,1078.0016238689423,445.01007866859436,813.2438774108887,26237,6683,19554,19554,0,15,6729000.0
6729,6729999,20.260567266987536,37.27134501228139,0.0778335383580212,1078.1291525363922,445.07633328437805,813.3484764099121,26237,6683,19554,19554,0,15,6730000.0
6730,6730999,20.261213636176695,37.2717625990259,0.07782467997568054,1078.3968427181244,445.15078353881836,813.2798843383789,26241,6685,19556,19556,0,15,6731000.0
6731,6731999,20.261659069054595,37.27176377213883,0.07781347283815343,1078.6706931591034,445.215633392334,813.2800254821777,26245,6687,19558,19558,0,15,6732000.0
6732,6732999,20.261999294803964,37.27137839833295,0.0778091748957791,1078.8496625423431,445.28003311157227,813.382152557373,26247,6688,19559,19559,0,15,6733000.0
6733,6733999,20.262717086588193,37.271674915592975,0.07781372440352519,1079.0328776836395,445.3456687927246,813.4560737609863,26249,6689,19560,19560,0,15,6734000.0
6734,6734999,20.262999078143277,37.27116448645496,0.07781117429878859,1079.219559431076,445.41011095046997,813.5327529907227,26251,6690,19561,19561,0,15,6735000.0
6735,6735999,20.263466063787874,37.2707569226746,0.0778024333471764,1079.416925907135,445.47591161727905,813.606128692627,26253,6691,19562,19562,0,15,6736000.0
6736,6736999,20.263808062516787,37.27030429648706,0.0777989638291886,1079.5391283035278,445.54440665245056,813.7005577087402,26253,6691,19562,19562,0,15,6737000.0
6737,6737999,20.26419957756512,37.26972829068471,0.07779219753147881,1079.7359251976013,445.6082270145416,813.7362747192383,26255,6692,19563,19563,0,15,6738000.0
6738,6738999,20.264240170644065,37.26855333457053,0.07778480966917045,1080.0544962882996,445.67236328125,813.9775047302246,26285,6695,19590,19590,0,15,6739000.0
6739,6739999,20.263353502236892,37.26689980391659,0.07778715203115516,1080.1639943122864,445.73649072647095,814.7077674865723,26299,6695,19604,19604,0,15,6740000.0
6740,6740999,20.262405697243977,37.265680067859044,0.07779301496352398,1080.2807257175446,445.8016269207001,815.0235252380371,26299,6695,19604,19604,0,15,6741000.0
6741,6741999,20.261584923307026,37.26429566964497,0.07779596524197496,1080.5043694972992,445.86348724365234,815.1183815002441,26303,6697,19606,19606,0,15,6742000.0
6742,6742999,20.260929235020388,37.26282131551734,0.07779589802172027,1080.739361524582,445.92729234695435,815.3335838317871,26307,6699,19608,19608,0,15,6743000.0
6743,6743999,20.260278341235942,37.261195380646996,0.07779765811068051,1080.9710416793823,445.9898052215576,815.4387397766113,26311,6701,19610,19610,0,15,6744000.0
6744,6744999,20.259656775670862,37.259597808712705,0.07780157423676781,1081.3227543830872,446.055615901947,815.4558143615723,26319,6705,19614,19614,0,15,6745000.0
6745,6745999,20.25921417666547,37.25850531208919,0.0778022749694871,1081.5571503639221,446.1186683177948,815.4995269775391,26323,6707,19616,19616,0,15,6746000.0
6746,6746999,20.258746404366683,37.25756481667668,0.07780303950520917,1081.7381365299225,446.182461977005,815.6531028747559,26325,6708,19617,19617,0,15,6747000.0
6747,6747999,20.258259201099882,37.25635305128177,0.07780908373677808,1081.989669084549,446.24728322029114,815.7357635498047,26329,6710,19619,19619,0,15,6748000.0
6748,6748999,20.257970703648738,37.255941356326574,0.07781044534334902,1082.1665015220642,446.3124508857727,815.8874092102051,26340,6711,19629,19629,0,15,6749000.0
6749,6749999,20.25752162938881,37.254718500533976,0.07781635198725201,1082.291300535202,446.3765592575073,816.0292930603027,26340,6711,19629,19629,0,15,6750000.0
6750,6750999,20.257424552401947,37.25396645055406,0.0778150036728158,1082.597809791565,446.4413697719574,815.9794464111328,26346,6714,19632,19632,0,15,6751000.0
6751,6751999,20.257496360361845,37.25530862914321,0.07781021057762061,1082.842048883438,446.5066568851471,816.0722618103027,26350,6716,19634,19634,0,15,6752000.0
6752,6752999,20.257625767083297,37.25502224677532,0.07781245877784992,1083.0274884700775,446.57068514823914,816.1712341308594,26352,6717,19635,19635,0,15,6753000.0
6753,6753999,20.258170174048328,37.25553204842878,0.0778115797236334,1083.2032780647278,446.6345765590668,816.2539138793945,26354,6718,19636,19636,0,15,6754000.0
6754,6754999,20.25875507868116,37.25746332520501,0.07780692100942566,1083.4457318782806,446.6991846561432,816.358226776123,26368,6720,19648,19648,0,15,6755000.0
6755,6755999,20.259599731386142,37.25836530005817,0.07780881549652219,1083.6391487121582,446.7640643119812,816.4183158874512,26370,6721,19649,19649,0,15,6756000.0
6756,6756999,20.26026080377137,37.259065571586675,0.07780763206416097,1083.8302912712097,446.8284773826599,816.4386138916016,26372,6722,19650,19650,0,15,6757000.0
6757,6757999,20.26101807469516,37.259814281676384,0.0778005690813901,1083.954862833023,446.89243602752686,816.5781326293945,26372,6722,19650,19650,0,15,6758000.0
6758,6758999,20.26107932761851,37.259134818148084,0.07779830787957276,1084.3091917037964,446.9589886665344,817.0674095153809,26415,6726,19689,19689,0,15,6759000.0
6759,6759999,20.260898231728806,37.25885155188134,0.0777953765698508,1084.4123678207397,447.0207848548889,817.4969673156738,26417,6726,19691,19691,0,15,6760000.0
6760,6760999,20.261267401112324,37.260039143836124,0.07777781112187587,1084.5794296264648,447.08456659317017,817.7556838989258,26420,6727,19693,19693,0,15,6761000.0
6761,6761999,20.26170835594918,37.260792809731356,0.07777549416930951,1084.86509847641,447.14852356910706,817.9180450439453,26426,6730,19696,19696,0,15,6762000.0
6762,6762999,20.262564910673152,37.26177018412026,0.07777757677191699,1085.1532092094421,447.2133069038391,817.9731407165527,26432,6733,19699,19699,0,15,6763000.0
6763,6763999,20.263779022405572,37.26322749309083,0.07778733249643333,1085.507342338562,447.27808833122253,818.0346221923828,26449,6737,19712,19712,0,15,6764000.0
6764,6764999,20.26465728237387,37.26378302758813,0.07780126447857183,1085.8162202835083,447.3421552181244,818.1133918762207,26455,6740,19715,19715,0,15,6765000.0
6765,6765999,20.266054931503525,37.26572220803348,0.07780515672838628,1086.0045597553253,447.4072835445404,818.2777061462402,26457,6741,19716,19716,0,15,6766000.0
6766,6766999,20.267070683060876,37.26654540570554,0.07782005770012079,1086.178543806076,447.47293639183044,818.3641624450684,26459,6742,19717,19717,0,15,6767000.0
6767,6767999,20.26806764443837,37.26710986962174,0.07784333476755867,1086.4221076965332,447.53734064102173,818.5100288391113,26473,6744,19729,19729,0,15,6768000.0
6768,6768999,20.26952980714109,37.26842513854243,0.07788538988600024,1086.6075217723846,447.6017394065857,818.6412200927734,26475,6745,19730,19730,0,15,6769000.0
6769,6769999,20.270802742437276,37.26997860141223,0.07792310443856121,1086.7883760929108,447.66635370254517,818.6921348571777,26477,6746,19731,19731,0,15,6770000.0
6770,6770999,20.271869621226678,37.27132945582622,0.07793980741490214,1087.0321938991547,447.73347425460815,818.670825958252,26481,6748,19733,19733,0,15,6771000.0
6771,6771999,20.272879553816455,37.2723130653436,0.07796587712743352,1087.1541485786438,447.7981986999512,818.8363075256348,26481,6748,19733,19733,0,15,6772000.0
6772,6772999,20.274319759701953,37.27397488547643,0.07800002186412203,1087.4044151306152,447.86328172683716,818.8593673706055,26485,6750,19735,19735,0,15,6773000.0
6773,6773999,20.275642265874385,37.27528921013081,0.07801752225265535,1087.5292224884033,447.92845273017883,818.9960746765137,26485,6750,19735,19735,0,15,6774000.0
6774,6774999,20.27714890671488,37.276696934491795,0.07802967849809894,1087.77556681633,447.99206495285034,819.0261726379395,26508,6752,19756,19756,0,15,6775000.0
6775,6775999,20.27852128870047,37.27819318829207,0.07803495276810046,1087.9625899791718,448.05707120895386,819.0673713684082,26510,6753,19757,19757,0,15,6776000.0
6776,6776999,20.279724545555506,37.27901391150444,0.0780453358261376,1088.1585457324982,448.1232919692993,819.1527557373047,26512,6754,19758,19758,0,15,6777000.0
6777,6777999,20.280378731406554,37.27878720105911,0.07804837541416254,1088.2893388271332,448.18866181373596,819.289981842041,26512,6754,19758,19758,0,15,6778000.0
6778,6778999,20.279808078664686,37.277955888859914,0.07804022465722271,1088.4055569171906,448.2541971206665,820.3032417297363,26542,6754,19788,19788,0,15,6779000.0
6779,6779999,20.27870836922716,37.27685192901541,0.07804249663594554,1088.5124697685242,448.3172359466553,820.6559753417969,26542,6754,19788,19788,0,15,6780000.0
6780,6780999,20.277679255993363,37.27508675993605,0.07804548372755282,1088.6183471679688,448.3796925544739,820.8839721679688,26542,6754,19788,19788,0,15,6781000.0
6781,6781999,20.276932918464045,37.274922644980016,0.07804025772834156,1088.9844059944153,448.4442539215088,820.9774742126465,26561,6758,19803,19803,0,15,6782000.0
6782,6782999,20.276061116812357,37.27321525834977,0.07803927081740669,1089.1060762405396,448.50766491889954,821.2342224121094,26561,6758,19803,19803,0,15,6783000.0
6783,6783999,20.27514293678563,37.27138404960958,0.0780421997234102,1089.4562728404999,448.573007106781,821.2740821838379,26569,6762,19807,19807,0,15,6784000.0
6784,6784999,20.274371803551446,37.270026751262236,0.07804418737539909,1089.6992990970612,448.6370966434479,821.3863296508789,26573,6764,19809,19809,0,15,6785000.0
6785,6785999,20.27369558832179,37.26851744120104,0.0780441458702743,1089.9916837215424,448.7018232345581,821.460075378418,26579,6767,19812,19812,0,15,6786000.0
6786,6786999,20.273211531387496,37.26778195711425,0.07804113273169277,1090.164808511734,448.7661061286926,821.6431655883789,26581,6768,19813,19813,0,15,6787000.0
6787,6787999,20.27260361362316,37.266357323657935,0.07804303555412695,1090.4569227695465,448.83046984672546,821.675407409668,26587,6771,19816,19816,0,15,6788000.0
6788,6788999,20.27206023959342,37.265106780159854,0.07804368576404253,1090.6446335315704,448.89398193359375,821.8670310974121,26598,6772,19826,19826,0,15,6789000.0
6789,6789999,20.271716719795688,37.26434970902802,0.07804136235323078,1090.8820104599,448.9576029777527,821.891487121582,26602,6774,19828,19828,0,15,6790000.0
6790,6790999,20.271577772528236,37.26361177790872,0.07803844556812867,1091.0573897361755,449.02090096473694,821.9999160766602,26604,6775,19829,19829,0,15,6791000.0
6791,6791999,20.27146469616129,37.26282446484712,0.078035928198251,1091.1872415542603,449.08792066574097,822.151538848877,26604,6775,19829,19829,0,15,6792000.0
6792,6792999,20.27144323807288,37.26215534554334,0.07803546013066465,1091.3718519210815,449.15236473083496,822.2275924682617,26606,6776,19830,19830,0,15,6793000.0
6793,6793999,20.271830210172507,37.26217349898781,0.07803230202751676,1091.5536370277405,449.21595191955566,822.2907867431641,26618,6777,19841,19841,0,15,6794000.0
6794,6794999,20.272143384649624,37.262135938489905,0.07803100915657113,1091.7369599342346,449.28088116645813,822.4196128845215,26620,6778,19842,19842,0,15,6795000.0
6795,6795999,20.2729349232902,37.26260284904506,0.07802595767099696,1091.8763830661774,449.34570050239563,822.5071983337402,26620,6778,19842,19842,0,15,6796000.0
6796,6796999,20.273595491550957,37.26267312790411,0.07802108345934011,1092.121330499649,449.40933418273926,822.4899253845215,26634,6780,19854,19854,0,15,6797000.0
6797,6797999,20.27440404689777,37.262947388208914,0.0780167189432649,1092.4308149814606,449.473997592926,822.4694213867188,26640,6783,19857,19857,0,15,6798000.0
6798,6798999,20.274751658423646,37.26249707742363,0.07800741789876342,1092.74578499794,449.54244112968445,822.9645957946777,26681,6786,19895,19895,0,15,6799000.0
6799,6799999,20.274083188633064,37.2614242250296,0.07799754872350384,1092.8596017360687,449.60601019859314,823.3709869384766,26682,6786,19896,19896,0,15,6800000.0
6800,6800999,20.27365899852923,37.26032012723635,0.07799049470524755,1092.9747467041016,449.6690242290497,823.6758308410645,26684,6786,19898,19898,0,15,6801000.0
6801,6801999,20.27344928978226,37.25964414416415,0.07798701224146587,1093.2696161270142,449.7331690788269,823.7467765808105,26690,6789,19901,19901,0,15,6802000.0
6802,6802999,20.273572920744634,37.25930005287295,0.07797995658592016,1093.4990632534027,449.7973942756653,823.9197769165039,26695,6791,19904,19904,0,15,6803000.0
6803,6803999,20.27355481199336,37.258762672123225,0.07797260974455578,1093.6838929653168,449.86259150505066,824.1105690002441,26697,6792,19905,19905,0,15,6804000.0
6804,6804999,20.27351594770846,37.25784730850689,0.07797413924434515,1093.7947356700897,449.92598247528076,824.3065338134766,26697,6792,19905,19905,0,15,6805000.0
6805,6805999,20.273292141616736,37.2569956935876,0.07797641904177244,1094.1614034175873,449.9921979904175,824.2955780029297,26705,6796,19909,19909,0,15,6806000.0
6806,6806999,20.27330587241928,37.256508160566725,0.07796966855990506,1094.394935131073,450.05706238746643,824.3679580688477,26709,6798,19911,19911,0,15,6807000.0
6807,6807999,20.273401707507393,37.256059225134216,0.07797240978370712,1094.5741946697235,450.12294578552246,824.4997978210449,26711,6799,19912,19912,0,15,6808000.0
6808,6808999,20.273451576810054,37.255248315904794,0.0779686015876605,1094.6979811191559,450.1860625743866,824.628833770752,26711,6799,19912,19912,0,15,6809000.0
6809,6809999,20.273467479208826,37.25434121333178,0.07796226629429848,1094.8240146636963,450.2494246959686,824.7711982727051,26711,6799,19912,19912,0,15,6810000.0
6810,6810999,20.274092572352902,37.254735157594,0.07796341486225633,1095.1235809326172,450.3142716884613,824.7004013061523,26717,6802,19915,19915,0,15,6811000.0
6811,6811999,20.27456647678606,37.25471165939858,0.0779548152445445,1095.300021648407,450.37853503227234,824.7692451477051,26719,6803,19916,19916,0,15,6812000.0
6812,6812999,20.27539516671458,37.25530174750276,0.07795157132968067,1095.5513653755188,450.44267892837524,824.830753326416,26723,6805,19918,19918,0,15,6813000.0
6813,6813999,20.27627643425262,37.25561181160633,0.07796407864423394,1095.7507364749908,450.5067181587219,824.9099617004395,26725,6806,19919,19919,0,15,6814000.0
6814,6814999,20.27715670106686,37.2560673063503,0.07796104535748138,1095.939565896988,450.5721526145935,824.9918441772461,26736,6807,19929,19929,0,15,6815000.0
6815,6815999,20.27809130917199,37.256207658850094,0.07796024505671095,1096.1938474178314,450.6404631137848,824.9860687255859,26759,6809,19950,19950,0,15,6816000.0
6816,6816999,20.279227905790687,37.25671049483188,0.0779618784189341,1096.3296315670013,450.7041816711426,825.0976943969727,26759,6809,19950,19950,0,15,6817000.0
6817,6817999,20.28026976869636,37.25697427306852,0.0779652054671025,1096.5137493610382,450.76807928085327,825.1701583862305,26761,6810,19951,19951,0,15,6818000.0
6818,6818999,20.28114313433333,37.25717361778772,0.07796163634408249,1096.811678647995,450.83236598968506,825.1452484130859,26767,6813,19954,19954,0,15,6819000.0
6819,6819999,20.28076069867159,37.25655253753019,0.0779511050845827,1096.987066268921,450.8973250389099,825.9076385498047,26801,6814,19987,19987,0,15,6820000.0
6820,6820999,20.280052882354806,37.255647479938254,0.07794798642184719,1097.0970075130463,450.96020579338074,826.3145370483398,26805,6814,19991,19991,0,15,6821000.0
6821,6821999,20.279257932204192,37.254108505404155,0.07795373169316677,1097.3982517719269,451.02355456352234,826.4199981689453,26822,6817,20005,20005,0,15,6822000.0
6822,6822999,20.278514428934667,37.2526044857403,0.0779560851232739,1097.649872303009,451.0896906852722,826.6168251037598,26827,6819,20008,20008,0,15,6823000.0
6823,6823999,20.277772365515407,37.25129814332055,0.07795912778682423,1097.7649292945862,451.15391874313354,826.8310813903809,26827,6819,20008,20008,0,15,6824000.0
6824,6824999,20.277287787762784,37.25038998161423,0.0779647817207989,1097.8823080062866,451.2199261188507,827.0097808837891,26827,6819,20008,20008,0,15,6825000.0
6825,6825999,20.27667115545283,37.24925687894352,0.07796759985198931,1098.2527515888214,451.284547328949,826.9031944274902,26835,6823,20012,20012,0,15,6826000.0
6826,6826999,20.27608438841756,37.24793434278912,0.07797406223853798,1098.3681890964508,451.35018134117126,827.076114654541,26835,6823,20012,20012,0,15,6827000.0
6827,6827999,20.275519535318736,37.24678468324171,0.0779785281763744,1098.6702353954315,451.41502261161804,827.0963020324707,26841,6826,20015,20015,0,15,6828000.0
6828,6828999,20.275108701341967,37.245924534199915,0.07798018215982228,1098.8616104125977,451.4798209667206,827.2234954833984,26843,6827,20016,20016,0,15,6829000.0
6829,6829999,20.275010473976234,37.245477348787325,0.07797711940430296,1099.0472152233124,451.5471065044403,827.3226509094238,26845,6828,20017,20017,0,15,6830000.0
6830,6830999,20.275167246901724,37.247609222697,0.07796769884733246,1099.2905287742615,451.6119294166565,827.3492012023926,26849,6830,20019,20019,0,15,6831000.0
6831,6831999,20.27540292188367,37.24881914656511,0.07796806184644134,1099.5396692752838,451.67664074897766,827.380199432373,26853,6832,20021,20021,0,15,6832000.0
6832,6832999,20.275421961839157,37.248647641343986,0.077989563548987,1099.6668903827667,451.7407064437866,827.4950332641602,26853,6832,20021,20021,0,15,6833000.0
6833,6833999,20.27529465152945,37.24769405084171,0.07800882354570338,1099.8528451919556,451.8041489124298,827.550178527832,26855,6833,20022,20022,0,15,6834000.0
6834,6834999,20.275095980543494,37.24781992877883,0.07801631272468346,1100.0515494346619,451.8713388442993,827.6569709777832,26857,6834,20023,20023,0,15,6835000.0
6835,6835999,20.274904747209497,37.24786110648297,0.0780193607759303,1100.2336065769196,451.93662786483765,828.4553413391113,26889,6835,20054,20054,0,15,6836000.0
6836,6836999,20.274760295743356,37.247791072485285,0.07801308452726896,1100.3469786643982,452.00076246261597,829.060432434082,26895,6835,20060,20060,0,15,6837000.0
6837,6837999,20.275299327183976,37.253792375866915,0.07799181371495534,1100.5184717178345,452.0651664733887,829.3552207946777,26906,6836,20070,20070,0,15,6838000.0
6838,6838999,20.27532287223601,37.25331328858771,0.07798892948947311,1100.8047757148743,452.1293623447418,829.5071411132812,26912,6839,20073,20073,0,15,6839000.0
6839,6839999,20.275661632850472,37.25482741067343,0.07798557988107746,1101.057700395584,452.2025363445282,829.6946563720703,26916,6841,20075,20075,0,15,6840000.0
6840,6840999,20.275869252274532,37.25433662832353,0.07798483673389156,1101.2477977275848,452.27621579170227,829.9054183959961,26918,6842,20076,20076,0,15,6841000.0
6841,6841999,20.276045822095128,37.25394537253043,0.07798016158753163,1101.5510745048523,452.3409192562103,830.0157661437988,26924,6845,20079,20079,0,15,6842000.0
6842,6842999,20.276329543167023,37.25619644488877,0.07797525682523299,1101.6738770008087,452.40628480911255,830.2432556152344,26924,6845,20079,20079,0,15,6843000.0
6843,6843999,20.276643373317647,37.25577876682678,0.07798525617214525,1101.8527374267578,452.47109866142273,830.3548316955566,26926,6846,20080,20080,0,15,6844000.0
6844,6844999,20.276945371505647,37.25550644366249,0.078009030519538,1102.1214172840118,452.54032850265503,830.384033203125,26939,6848,20091,20091,0,15,6845000.0
6845,6845999,20.27771804699534,37.258050959500004,0.07801917412110404,1102.3121256828308,452.6047167778015,830.4813346862793,26941,6849,20092,20092,0,15,6846000.0
6846,6846999,20.27819973621454,37.25854350289605,0.07802772348886611,1102.4315793514252,452.6690044403076,830.5867614746094,26941,6849,20092,20092,0,15,6847000.0
6847,6847999,20.27909027979902,37.25934380113805,0.07805580192599937,1102.8667352199554,452.7355043888092,830.529655456543,26951,6854,20097,20097,0,15,6848000.0
6848,6848999,20.279960178419735,37.26014358269351,0.07808326550978761,1103.0498452186584,452.80061531066895,830.6990737915039,26970,6855,20115,20115,0,15,6849000.0
6849,6849999,20.281030880760508,37.261702563955495,0.07809881273627906,1103.1857867240906,452.8686056137085,830.7987670898438,26970,6855,20115,20115,0,15,6850000.0
6850,6850999,20.281781505038456,37.26208550788624,0.07811845528657102,1103.371123790741,452.9324450492859,830.8918113708496,26972,6856,20116,20116,0,15,6851000.0
6851,6851999,20.283036009266677,37.26445876121319,0.07813309872246244,1103.4989573955536,452.997442483902,830.979434967041,26972,6856,20116,20116,0,15,6852000.0
6852,6852999,20.283986614207237,37.265928345228474,0.07815255425541545,1103.6784842014313,453.0622284412384,831.019229888916,26974,6857,20117,20117,0,15,6853000.0
6853,6853999,20.284589946333064,37.265719706367655,0.07817335123959501,1103.9116356372833,453.1273396015167,831.0305671691895,26987,6859,20128,20128,0,15,6854000.0
6854,6854999,20.285249315136205,37.266815356728856,0.07812528841864808,1104.092167854309,453.1930456161499,831.7543792724609,27040,6860,20180,20180,0,15,6855000.0
6855,6855999,20.285391036156895,37.26673376942582,0.0781139893317151,1104.203714132309,453.2569103240967,832.163200378418,27046,6860,20186,20186,0,15,6856000.0
6856,6856999,20.28573167430905,37.26781451960498,0.07810123011824532,1104.3218047618866,453.3231143951416,832.3889999389648,27046,6860,20186,20186,0,15,6857000.0
6857,6857999,20.28595657012159,37.26854184440882,0.07808264710316404,1104.6254451274872,453.3868181705475,832.5296783447266,27052,6863,20189,20189,0,15,6858000.0
6858,6858999,20.286198964037165,37.26858299025449,0.07807538171126238,1104.9369630813599,453.45346212387085,832.6384429931641,27058,6866,20192,20192,0,15,6859000.0
6859,6859999,20.286627690644192,37.26936318329504,0.07806523024892076,1105.188823223114,453.5191903114319,832.7107009887695,27071,6868,20203,20203,0,15,6860000.0
6860,6860999,20.28676716438319,37.26888745586314,0.07806212938957313,1105.4261951446533,453.5825414657593,832.7905044555664,27075,6870,20205,20205,0,15,6861000.0
6861,6861999,20.287087168372032,37.269051110606796,0.0780632773843104,1105.6604011058807,453.6470715999603,832.8911437988281,27079,6872,20207,20207,0,15,6862000.0
6862,6862999,20.28759633450324,37.26933092520858,0.07806544373917423,1105.7760622501373,453.71074390411377,833.0166778564453,27079,6872,20207,20207,0,15,6863000.0
6863,6863999,20.288137112287522,37.26952780029019,0.07806896813521802,1106.087869644165,453.7780194282532,832.9906272888184,27085,6875,20210,20210,0,15,6864000.0
6864,6864999,20.289008257699162,37.26999909916712,0.07808097732896602,1106.2954852581024,453.84383845329285,833.1344451904297,27087,6876,20211,20211,0,15,6865000.0
6865,6865999,20.289814401816574,37.27065639917015,0.07809941912435836,1106.6150646209717,453.91115140914917,833.1028861999512,27102,6879,20223,20223,0,15,6866000.0
6866,6866999,20.29033334502094,37.27070892388682,0.07811696062533247,1106.7242906093597,453.9749572277069,833.2502059936523,27102,6879,20223,20223,0,15,6867000.0
6867,6867999,20.29123060233354,37.27130970384192,0.0781500484560893,1106.9799811840057,454.040442943573,833.2805480957031,27117,6881,20236,20236,0,15,6868000.0
6868,6868999,20.292306455326962,37.272142043451986,0.07817424382966798,1107.1169047355652,454.10669016838074,833.4011268615723,27117,6881,20236,20236,0,15,6869000.0
6869,6869999,20.29313247862675,37.27241632723381,0.07819670576287896,1107.3726844787598,454.17134380340576,833.3633232116699,27121,6883,20238,20238,0,15,6870000.0
6870,6870999,20.29390158001264,37.273603787925445,0.07821890303400836,1107.6157310009003,454.2363452911377,833.412712097168,27134,6885,20249,20249,0,15,6871000.0
6871,6871999,20.294765953173975,37.273916136002605,0.07823935454999276,1107.8015656471252,454.30004596710205,833.5152702331543,27136,6886,20250,20250,0,15,6872000.0
6872,6872999,20.295597715697724,37.27430457744891,0.07825912703349114,1107.9910032749176,454.3656122684479,833.5398330688477,27138,6887,20251,20251,0,15,6873000.0
6873,6873999,20.29564773207968,37.27327800239083,0.07825789247909198,1108.1081986427307,454.429057598114,833.6593589782715,27138,6887,20251,20251,0,15,6874000.0
6874,6874999,20.295908615492397,37.2749206363424,0.07825851195623157,1108.2210762500763,454.49309968948364,834.6306304931641,27169,6887,20282,20282,0,15,6875000.0
6875,6875999,20.295881998305724,37.27633752031012,0.07823503595448944,1108.3926177024841,454.557254076004,834.9069900512695,27177,6888,20289,20289,0,15,6876000.0
6876,6876999,20.295626901450248,37.2756007382546,0.07822405392769927,1108.5765433311462,454.621297121048,835.0987815856934,27180,6889,20291,20291,0,15,6877000.0
6877,6877999,20.295413132985853,37.274497473624656,0.07822059115772018,1108.7471187114716,454.685747385025,835.2735710144043,27182,6890,20292,20292,0,15,6878000.0
6878,6878999,20.295160728742594,37.27362168265878,0.0782133874480393,1109.0461435317993,454.7510452270508,835.390079498291,27198,6893,20305,20305,0,15,6879000.0
6879,6879999,20.295101738688267,37.27308528430397,0.07820963157587157,1109.35103225708,454.81551027297974,835.515811920166,27204,6896,20308,20308,0,15,6880000.0
6880,6880999,20.294855611645733,37.27207297946146,0.07820852004452195,1109.5315396785736,454.88268208503723,835.7374572753906,27207,6897,20310,20310,0,15,6881000.0
6881,6881999,20.29469002751627,37.27150292664979,0.07821293735999224,1109.7223739624023,454.95069098472595,835.8531341552734,27218,6898,20320,20320,0,15,6882000.0
6882,6882999,20.29463333363104,37.27095880544349,0.07821548248675558,1109.9682755470276,455.01557183265686,835.8797950744629,27222,6900,20322,20322,0,15,6883000.0
6883,6883999,20.294561827885527,37.27056559055548,0.07821949286427954,1110.2076981067657,455.08266973495483,836.0463905334473,27237,6902,20335,20335,0,15,6884000.0
6884,6884999,20.295142320661743,37.27148216831807,0.07822610942383401,1110.39626121521,455.14991569519043,836.1847114562988,27240,6903,20337,20337,0,15,6885000.0
6885,6885999,20.296108662792307,37.27343351533421,0.07823443990612988,1110.6357264518738,455.21374464035034,836.2253913879395,27244,6905,20339,20339,0,15,6886000.0
6886,6886999,20.297077345177648,37.27461223433736,0.0782376495984557,1110.9555897712708,455.27995252609253,836.2698249816895,27250,6908,20342,20342,0,15,6887000.0
6887,6887999,20.29843830968489,37.27770652754818,0.07824609159237361,1111.1436619758606,455.3450376987457,836.3522453308105,27252,6909,20343,20343,0,15,6888000.0
6888,6888999,20.299748452648526,37.27971782076996,0.07825274033004037,1111.4572010040283,455.4103310108185,836.3453559875488,27267,6912,20355,20355,0,15,6889000.0
6889,6889999,20.301202048062752,37.28159910293144,0.07826085590852927,1111.6396822929382,455.47475481033325,836.4441146850586,27279,6913,20366,20366,0,15,6890000.0
6890,6890999,20.30244745884049,37.283142320967166,0.07827317378533716,1111.8910279273987,455.5435240268707,836.4427528381348,27283,6915,20368,20368,0,15,6891000.0
6891,6891999,20.303195671836356,37.28345588803525,0.0782835074467052,1112.1300637722015,455.6084887981415,836.5293464660645,27287,6917,20370,20370,0,15,6892000.0
6892,6892999,20.303697193837703,37.28412199612941,0.07825102791758876,1112.371155500412,455.6756932735443,837.4400749206543,27326,6919,20407,20407,0,15,6893000.0
6893,6893999,20.303517974325356,37.28442161438468,0.07823388691134048,1112.4828419685364,455.74193358421326,837.9824028015137,27331,6919,20412,20412,0,15,6894000.0
6894,6894999,20.303034485178298,37.28323106770881,0.07822891393795395,1112.5947725772858,455.80663108825684,838.2911682128906,27332,6919,20413,20413,0,15,6895000.0
6895,6895999,20.302640083029015,37.28206797606362,0.078227110017981,1113.0151484012604,455.8720541000366,838.3816680908203,27343,6924,20419,20419,0,15,6896000.0
6896,6896999,20.302251649567296,37.2808969899926,0.07822232349396097,1113.1901273727417,455.93675351142883,838.6503791809082,27345,6925,20420,20420,0,15,6897000.0
6897,6897999,20.301930022966772,37.279545782681744,0.07822065683710555,1113.4854080677032,456.0020799636841,838.8385887145996,27351,6928,20423,20423,0,15,6898000.0
6898,6898999,20.301428916588872,37.278339235500745,0.0782230591851697,1113.6563539505005,456.0663995742798,839.0450210571289,27353,6929,20424,20424,0,15,6899000.0
6899,6899999,20.30100693446036,37.276802590499805,0.0782210151107603,1113.771015882492,456.1296372413635,839.2639846801758,27353,6929,20424,20424,0,15,6900000.0
6900,6900999,20.300546326541554,37.27535346859841,0.07822080644098739,1113.9009847640991,456.19352173805237,839.4050407409668,27353,6929,20424,20424,0,15,6901000.0
6901,6901999,20.30008300145672,37.273779593367465,0.07822124947957454,1114.221370458603,456.2665569782257,839.4073600769043,27369,6932,20437,20437,0,15,6902000.0
6902,6902999,20.29961146061794,37.27270769439941,0.07821970047877125,1114.5221219062805,456.33074593544006,839.4788818359375,27377,6935,20442,20442,0,15,6903000.0
6903,6903999,20.299182940914648,37.27135209125469,0.07822273421233294,1114.7024466991425,456.3951003551483,839.6529235839844,27379,6936,20443,20443,0,15,6904000.0
6904,6904999,20.298878832474635,37.27026971807941,0.07822489162820923,1114.874358177185,456.45855593681335,839.7339248657227,27389,6937,20452,20452,0,15,6905000.0
6905,6905999,20.29860979078693,37.26910250388519,0.07823050105765283,1115.0107369422913,456.52629923820496,839.9063415527344,27389,6937,20452,20452,0,15,6906000.0
6906,6906999,20.29839223751561,37.26813294877517,0.07823193756603986,1115.3378858566284,456.59424805641174,839.8685569763184,27395,6940,20455,20455,0,15,6907000.0
6907,6907999,20.298386046261488,37.26737499852063,0.07823595663393934,1115.5721108913422,456.658043384552,839.9435882568359,27399,6942,20457,20457,0,15,6908000.0
6908,6908999,20.298117255341918,37.26606255429653,0.0782440061248506,1115.8122236728668,456.7230770587921,840.0536956787109,27403,6944,20459,20459,0,15,6909000.0
6909,6909999,20.2979265148254,37.264904325299455,0.07824840737838767,1116.003751039505,456.7863175868988,840.1482543945312,27405,6945,20460,20460,0,15,6910000.0
6910,6910999,20.297605566364656,37.263647054989015,0.07825462575017095,1116.1260256767273,456.8498446941376,840.2504234313965,27405,6945,20460,20460,0,15,6911000.0
6911,6911999,20.29698848263927,37.26196594312423,0.07826120393567548,1116.314180612564,456.91388416290283,840.3299026489258,27407,6946,20461,20461,0,15,6912000.0
6912,6912999,20.296359859249776,37.26049736896084,0.0782647476129873,1116.4434728622437,456.9791736602783,841.0328826904297,27434,6946,20488,20488,0,15,6913000.0
6913,6913999,20.2953494307306,37.25892352012653,0.07826501303956679,1116.5501143932343,457.0438494682312,841.56884765625,27440,6946,20494,20494,0,15,6914000.0
6914,6914999,20.29445579577867,37.25774722663059,0.0782656817174694,1116.7227435112,457.1074492931366,841.8765449523926,27443,6947,20496,20496,0,15,6915000.0
6915,6915999,20.293656701456108,37.25629940406635,0.07826568738625972,1117.0185630321503,457.17120885849,842.0557098388672,27450,6950,20500,20500,0,15,6916000.0
6916,6916999,20.29282575227909,37.25455936430383,0.07826629192073453,1117.1254496574402,457.2348327636719,842.3048057556152,27450,6950,20500,20500,0,15,6917000.0
6917,6917999,20.292251166281275,37.2537229466716,0.07826107425652207,1117.3630774021149,457.2987198829651,842.4641799926758,27454,6952,20502,20502,0,15,6918000.0
6918,6918999,20.2917555569068,37.2529077678987,0.0782581743304327,1117.6088619232178,457.36526250839233,842.5868034362793,27458,6954,20504,20504,0,15,6919000.0
6919,6919999,20.291279306779753,37.2521869666012,0.07825452534132715,1117.9133534431458,457.42896795272827,842.6887626647949,27466,6957,20509,20509,0,15,6920000.0
6920,6920999,20.290972285567143,37.25181744407032,0.07824584488890629,1118.0199794769287,457.49191212654114,842.9069747924805,27466,6957,20509,20509,0,15,6921000.0
6921,6921999,20.291254286469687,37.25310173137595,0.07823518424011333,1118.269635438919,457.5563726425171,842.9694633483887,27470,6959,20511,20511,0,15,6922000.0
6922,6922999,20.291615395813075,37.25648840654921,0.07822208814813869,1118.4495124816895,457.62000918388367,843.1264152526855,27472,6960,20512,20512,0,15,6923000.0
6923,6923999,20.29220452147213,37.25791979391345,0.07821624350938039,1118.746646642685,457.68529200553894,843.1461067199707,27487,6963,20524,20524,0,15,6924000.0
6924,6924999,20.293069524936236,37.26056265923166,0.0782095216657519,1118.938792705536,457.74995160102844,843.2730712890625,27489,6964,20525,20525,0,15,6925000.0
6925,6925999,20.293489054991994,37.2608108740738,0.07821620616015179,1119.1281714439392,457.81458377838135,843.359432220459,27491,6965,20526,20526,0,15,6926000.0
6926,6926999,20.294478386725014,37.26278188643895,0.07822620430375926,1119.3996133804321,457.8803741931915,843.4294052124023,27500,6967,20533,20533,0,15,6927000.0
6927,6927999,20.295416222745747,37.26450316000028,0.07824158700926487,1119.520882844925,457.94546937942505,843.5336227416992,27500,6967,20533,20533,0,15,6928000.0
6928,6928999,20.29628497935437,37.2658511281602,0.07825741786284246,1119.754937171936,458.0096733570099,843.5238380432129,27504,6969,20535,20535,0,15,6929000.0
6929,6929999,20.296896971595693,37.266305470697596,0.07827877485852475,1119.942309141159,458.0747790336609,843.6794853210449,27506,6970,20536,20536,0,15,6930000.0
6930,6930999,20.29752160633672,37.266570291037674,0.0782800751883469,1120.0634322166443,458.139972448349,843.8290214538574,27506,6970,20536,20536,0,15,6931000.0
6931,6931999,20.29797825397353,37.26651648636121,0.07828306515433292,1120.2508001327515,458.20395612716675,843.8904724121094,27517,6971,20546,20546,0,15,6932000.0
6932,6932999,20.298245960346605,37.26706871389765,0.07826509149147676,1120.4282038211823,458.27068042755127,844.922607421875,27557,6972,20585,20585,0,15,6933000.0
6933,6933999,20.297958163695785,37.26618430149178,0.07825864957588136,1120.599472284317,458.3346884250641,845.3287010192871,27564,6973,20591,20591,0,15,6934000.0
6934,6934999,20.297686843900806,37.265095478644206,0.07825407167868303,1120.8299760818481,458.39874744415283,845.4994735717773,27568,6975,20593,20593,0,15,6935000.0
6935,6935999,20.297516844125557,37.26427105178807,0.07824801049693342,1121.0640242099762,458.46329379081726,845.7265167236328,27582,6977,20605,20605,0,15,6936000.0
6936,6936999,20.297353424350504,37.26353975687548,0.07824582117350964,1121.3025941848755,458.5273153781891,845.9051399230957,27586,6979,20607,20607,0,15,6937000.0
6937,6937999,20.297006964447803,37.26219641956638,0.07823934658876797,1121.549034357071,458.59256529808044,846.0231399536133,27590,6981,20609,20609,0,15,6938000.0
6938,6938999,20.296741875624164,37.26089814727677,0.07824273570404483,1121.92818069458,458.6586136817932,846.0798301696777,27598,6985,20613,20613,0,15,6939000.0
6939,6939999,20.296702058849906,37.26012582399918,0.07823868305838078,1122.1035165786743,458.7248673439026,846.296314239502,27600,6986,20614,20614,0,15,6940000.0
6940,6940999,20.29661827537474,37.25931000958813,0.07823155988794017,1122.2244749069214,458.7884147167206,846.4572372436523,27600,6986,20614,20614,0,15,6941000.0
6941,6941999,20.2966472728713,37.26087931877539,0.07822332440061697,1122.4075095653534,458.8525366783142,846.5348243713379,27602,6987,20615,20615,0,15,6942000.0
6942,6942999,20.296896807568306,37.26085399734342,0.07822142168269541,1122.6566293239594,458.9194600582123,846.6209831237793,27606,6989,20617,20617,0,15,6943000.0
6943,6943999,20.297119942635327,37.26043141837542,0.07821747128844636,1122.8435325622559,458.98443245887756,846.7334518432617,27608,6990,20618,20618,0,15,6944000.0
6944,6944999,20.29756942471769,37.260555657322065,0.07821275203038636,1123.1064023971558,459.04879426956177,846.7378120422363,27612,6992,20620,20620,0,15,6945000.0
6945,6945999,20.298210361622974,37.26070843963995,0.07821757247967498,1123.4143204689026,459.1140501499176,846.7777290344238,27618,6995,20623,20623,0,15,6946000.0
6946,6946999,20.298766656149347,37.26065222949887,0.0782271814683756,1123.5382752418518,459.1793978214264,846.9849395751953,27618,6995,20623,20623,0,15,6947000.0
6947,6947999,20.299412230462675,37.26091019285034,0.0782351762388479,1123.6653826236725,459.2438280582428,847.0922698974609,27618,6995,20623,20623,0,15,6948000.0
6948,6948999,20.300088014977046,37.26093983636637,0.07824312511641596,1123.7843387126923,459.3069784641266,847.230712890625,27618,6995,20623,20623,0,15,6949000.0
6949,6949999,20.30074562870638,37.260876843333435,0.07825359157685052,1123.90749168396,459.37084221839905,847.3183860778809,27618,6995,20623,20623,0,15,6950000.0
6950,6950999,20.301425370999947,37.26082969124744,0.0782624530625331,1124.0332815647125,459.4354019165039,847.401496887207,27618,6995,20623,20623,0,15,6951000.0
6951,6951999,20.30180877855415,37.26017563808609,0.07827091763464467,1124.2258203029633,459.5007870197296,847.4914093017578,27630,6996,20634,20634,0,15,6952000.0
6952,6952999,20.302019286506702,37.260410363240695,0.07826235256821867,1124.4249794483185,459.5659646987915,848.1903953552246,27671,6997,20674,20674,0,15,6953000.0
6953,6953999,20.302104409719558,37.26036575700553,0.0782593480043332,1124.5326628684998,459.6296036243439,848.9789543151855,27688,6997,20691,20691,0,15,6954000.0
6954,6954999,20.30199072906855,37.25985713892096,0.07826138141838535,1124.6421556472778,459.6928594112396,849.5326766967773,27699,6997,20702,20702,0,15,6955000.0
6955,6955999,20.30199574133904,37.259601034364884,0.07826131645052581,1124.8261785507202,459.75770235061646,849.8325691223145,27703,6998,20705,20705,0,15,6956000.0
6956,6956999,20.302173663780565,37.259410023466124,0.07826325270130985,1125.0199887752533,459.82991886138916,850.1247062683105,27706,6999,20707,20707,0,15,6957000.0
6957,6957999,20.30258659491021,37.25958742023925,0.07828125931942076,1125.1953456401825,459.8932452201843,850.3413352966309,27708,7000,20708,20708,0,15,6958000.0
6958,6958999,20.302862973087286,37.25950736631483,0.07829344071001754,1125.5013308525085,459.95753049850464,850.3824653625488,27722,7003,20719,20719,0,15,6959000.0
6959,6959999,20.30332722161547,37.25999915660027,0.07830388060359772,1125.8777027130127,460.0216886997223,850.4841918945312,27730,7007,20723,20723,0,15,6960000.0
6960,6960999,20.304403781899005,37.26329576496326,0.07832268120069419,1126.0514903068542,460.0869052410126,850.6494445800781,27732,7008,20724,20724,0,15,6961000.0
6961,6961999,20.30541661875722,37.26426644551943,0.07835213421961651,1126.3070690631866,460.1517415046692,850.8007621765137,27746,7010,20736,20736,0,15,6962000.0
6962,6962999,20.306877633430357,37.269078664864395,0.07840222966024635,1126.6643152236938,460.2156147956848,850.8328056335449,27763,7014,20749,20749,0,15,6963000.0
6963,6963999,20.308125630234105,37.27033786189604,0.07843989383284011,1126.905936717987,460.28049421310425,850.8392906188965,27767,7016,20751,20751,0,15,6964000.0
6964,6964999,20.30958100981682,37.2724839046517,0.07850509011088691,1127.028659582138,460.3487057685852,851.1124420166016,27767,7016,20751,20751,0,15,6965000.0
6965,6965999,20.311749619251525,37.27584869370154,0.07857817582880922,1127.2122478485107,460.4132459163666,851.2573089599609,27769,7017,20752,20752,0,15,6966000.0
6966,6966999,20.313244886564775,37.27747163944892,0.07863923596912425,1127.3993570804596,460.47801327705383,851.3899612426758,27771,7018,20753,20753,0,15,6967000.0
6967,6967999,20.31537290869263,37.28047254157263,0.0787020075545748,1127.6566805839539,460.5429229736328,851.4162178039551,27784,7020,20764,20764,0,15,6968000.0
6968,6968999,20.31734342260082,37.2846531118446,0.07875762820038079,1127.7733616828918,460.60736775398254,851.6165008544922,27784,7020,20764,20764,0,15,6969000.0
6969,6969999,20.318766852106048,37.288371167910626,0.07874448421244584,1127.8949558734894,460.6735508441925,852.4606094360352,27811,7020,20791,20791,0,15,6970000.0
6970,6970999,20.320281607455286,37.29376354856164,0.07872629016638821,1128.004324913025,460.7369463443756,852.8552398681641,27811,7020,20791,20791,0,15,6971000.0
6971,6971999,20.321546347127498,37.29807176963434,0.07872241594198393,1128.1780905723572,460.79944348335266,853.0531387329102,27814,7021,20793,20793,0,15,6972000.0
6972,6972999,20.322429576655534,37.30004731094696,0.07872526366373833,1128.423187971115,460.8629126548767,853.2954368591309,27820,7023,20797,20797,0,15,6973000.0
6973,6973999,20.323688562539843,37.302941454348264,0.07871653586179195,1128.7180156707764,460.92699360847473,853.4212112426758,27885,7026,20859,20859,0,15,6974000.0
6974,6974999,20.32466128868369,37.305521856218924,0.0787253792512671,1128.9729435443878,460.99303126335144,854.3108444213867,27893,7028,20865,20865,0,15,6975000.0
6975,6975999,20.325563254097872,37.307214659224776,0.07872012856851895,1129.351393699646,461.06065797805786,854.605827331543,27901,7032,20869,20869,0,15,6976000.0
6976,6976999,20.32719016072894,37.31494195995826,0.07872798461287878,1129.4737601280212,461.124698638916,854.9941558837891,27901,7032,20869,20869,0,15,6977000.0
6977,6977999,20.328527086344963,37.31704238611979,0.07874367825986939,1129.583267211914,461.18887639045715,855.3230590820312,27902,7032,20870,20870,0,15,6978000.0
6978,6978999,20.329612252442004,37.31803378408429,0.07875846567709788,1129.8979392051697,461.2534410953522,855.4017562866211,27908,7035,20873,20873,0,15,6979000.0
6979,6979999,20.330984214987417,37.32003537360779,0.07876637815507659,1130.016853570938,461.31746220588684,855.5724334716797,27908,7035,20873,20873,0,15,6980000.0
6980,6980999,20.332408193529833,37.32319041882641,0.07876400587664101,1130.1420855522156,461.3846962451935,855.785343170166,27908,7035,20873,20873,0,15,6981000.0
6981,6981999,20.333876984986,37.32488972252826,0.0787787299822138,1130.2729380130768,461.4516839981079,855.992733001709,27908,7035,20873,20873,0,15,6982000.0
