,n_samples,MAE,RMSE,R2,time_learning,time_predicting,memory,n_nodes,n_branches,n_leaves,n_active_leaves,n_inactive_leaves,height,total_observed_weight
0,999,20.401038822654076,37.91708190971309,-0.013148671472235529,0.14768314361572266,0.06612849235534668,0.2982368469238281,3,1,2,2,0,2,1000.0
1,1999,21.362123666901432,42.908940440897815,-0.006030575683125816,0.30831098556518555,0.13483476638793945,0.3704261779785156,3,1,2,2,0,2,2000.0
2,2999,20.565912759444476,39.68833923722097,-0.005052775094398054,0.4708554744720459,0.19779109954833984,0.4081077575683594,3,1,2,2,0,2,3000.0
3,3999,20.809965887791222,44.73486800596238,-0.0033250874353638604,0.6136689186096191,0.2511448860168457,0.5408287048339844,16,2,14,14,0,3,4000.0
4,4999,20.316698235556043,42.22729550318578,-0.0034342523283465987,0.7501308917999268,0.3071589469909668,1.1770210266113281,36,3,33,33,0,3,5000.0
5,5999,19.893250054464385,40.779173467913495,-0.0037319587965352063,0.8461332321166992,0.3630378246307373,1.7423629760742188,36,3,33,33,0,3,6000.0
6,6999,19.78871135105464,39.69361187469024,-0.003125704254328898,0.957679271697998,0.4187960624694824,2.0777359008789062,37,3,34,34,0,3,7000.0
7,7999,19.914840226494093,39.16349692552543,-0.002444447973491748,1.075122356414795,0.4740414619445801,2.2842178344726562,37,3,34,34,0,3,8000.0
8,8999,20.248429849726985,39.382549866840506,-0.0017792056748424656,1.2006735801696777,0.5290200710296631,2.4335899353027344,37,3,34,34,0,3,9000.0
9,9999,20.75522096560564,40.04862224310034,0.0011311470866928186,1.31913161277771,0.5855896472930908,2.574657440185547,52,4,48,48,0,4,10000.0
10,10999,20.937760045684424,39.829745767285566,0.0007845936203391135,1.454927682876587,0.6454277038574219,2.769695281982422,55,5,50,50,0,4,11000.0
11,11999,21.09416372445828,39.561628584668156,0.002660567707859607,1.5805120468139648,0.7024164199829102,2.991748809814453,57,5,52,52,0,4,12000.0
12,12999,21.629194462280445,40.90847420170711,0.004783656245079482,1.713205337524414,0.7583737373352051,3.079418182373047,59,6,53,53,0,4,13000.0
13,13999,22.20712745870337,41.50664568181885,0.007461690499669826,1.8165473937988281,0.8149769306182861,3.220001220703125,59,6,53,53,0,4,14000.0
14,14999,22.697443991020467,41.96514514372801,0.011077594005423408,1.9466509819030762,0.8710987567901611,3.432239532470703,78,8,70,70,0,4,15000.0
15,15999,22.89323199279642,41.891270069834064,0.013115949892151257,2.0723202228546143,0.9270703792572021,3.6637802124023438,78,8,70,70,0,4,16000.0
16,16999,23.23186939021591,42.32209071773372,0.017415781830956267,2.2014577388763428,1.0368688106536865,3.763805389404297,84,9,75,75,0,4,17000.0
17,17999,23.473080813691446,42.23448449626987,0.01976976254224705,2.305262804031372,1.092254877090454,3.9115562438964844,84,9,75,75,0,4,18000.0
18,18999,23.45146453168484,41.86514562279523,0.0211730607641476,2.4289097785949707,1.1490237712860107,4.149467468261719,86,9,77,77,0,4,19000.0
19,19999,23.43550326741842,41.555823255423014,0.01726109626454908,2.549001693725586,1.2052342891693115,4.703144073486328,91,9,82,82,0,4,20000.0
20,20999,23.289902255819676,41.24791297329839,0.014645254080018932,2.665332317352295,1.261531114578247,4.9448699951171875,92,9,83,83,0,4,21000.0
21,21999,23.12718593023489,40.7601032129169,0.013226058658606932,2.7767043113708496,1.318016529083252,5.14324951171875,92,9,83,83,0,4,22000.0
22,22999,23.005239694702997,40.51500757481192,0.011486386678959848,2.9050135612487793,1.3744902610778809,5.326347351074219,93,9,84,84,0,4,23000.0
23,23999,22.8589888399635,40.0325266646731,0.010748917006943581,3.0224695205688477,1.4304897785186768,5.507453918457031,94,9,85,85,0,4,24000.0
24,24999,22.70870496325269,39.61745706025593,0.009774197462857792,3.1498608589172363,1.4867374897003174,5.6309661865234375,94,9,85,85,0,4,25000.0
25,25999,22.579539995073812,39.2932051653039,0.008932160856460536,3.2847912311553955,1.5430903434753418,5.808330535888672,100,10,90,90,0,5,26000.0
26,26999,22.4952479292822,38.96593161310606,0.007149684049340244,3.417938232421875,1.5984385013580322,6.002616882324219,101,10,91,91,0,5,27000.0
27,27999,22.382334597842107,38.67323862811179,0.006560597623958886,3.529204845428467,1.6541333198547363,6.1219482421875,101,10,91,91,0,5,28000.0
28,28999,22.283544032742377,38.542312152837155,0.005771312789659699,3.654855251312256,1.710022211074829,6.283000946044922,102,10,92,92,0,5,29000.0
29,29999,22.201589199677297,38.270098806668514,0.004965674131848119,3.7893803119659424,1.7666361331939697,6.424694061279297,102,10,92,92,0,5,30000.0
30,30999,22.14239626951022,38.4027033321117,0.004615491687538054,3.914457082748413,1.822899341583252,6.533180236816406,117,11,106,106,0,5,31000.0
31,31999,22.055774944088355,38.13880702282167,0.004672042804399368,4.020610570907593,1.8787024021148682,6.736629486083984,117,11,106,106,0,5,32000.0
32,32999,22.017658305831358,38.016026870841756,0.004309160667788858,4.1495630741119385,1.9349019527435303,6.9253387451171875,117,11,106,106,0,5,33000.0
33,33999,21.96280580581056,37.8273164198919,0.004847608105400192,4.260674238204956,1.99111008644104,7.066093444824219,117,11,106,106,0,5,34000.0
34,34999,21.920402074503027,37.6894075718171,0.0050087774670820595,4.388659477233887,2.0481278896331787,7.246540069580078,134,12,122,122,0,5,35000.0
35,35999,21.930300783264066,37.55670916844711,0.004990082833914555,4.522049427032471,2.104724407196045,7.480934143066406,153,13,140,140,0,5,36000.0
36,36999,21.90475259664738,37.39137052051594,0.004938462561745904,4.664474010467529,2.1618008613586426,7.758781433105469,153,13,140,140,0,5,37000.0
37,37999,21.87344773474546,37.19271510255577,0.00502856694676912,4.774057626724243,2.2192463874816895,7.925876617431641,153,13,140,140,0,5,38000.0
38,38999,21.82618225387565,37.01733989812561,0.004971560822108034,4.898066282272339,2.2799324989318848,8.073974609375,153,13,140,140,0,5,39000.0
39,39999,21.753165354763482,36.821828761108044,0.005200482075531698,5.027940273284912,2.3400237560272217,8.063957214355469,172,15,157,157,0,5,40000.0
40,40999,21.710089850930967,36.69654166499513,0.004107376925435613,5.184888601303101,2.412588357925415,8.44930648803711,175,15,160,160,0,5,41000.0
41,41999,21.60996162261867,36.44784916468754,0.0036751290915519874,5.3247315883636475,2.4732773303985596,8.636756896972656,175,15,160,160,0,5,42000.0
42,42999,21.52086678485226,36.23013233537164,0.0034291452587333904,5.4516191482543945,2.5321710109710693,8.802734375,175,15,160,160,0,5,43000.0
43,43999,21.417929039996576,35.985256793175694,0.0032538759578616405,5.574074029922485,2.590703010559082,8.913578033447266,177,16,161,161,0,5,44000.0
44,44999,21.335139019836937,35.790902470188485,0.0030886464605291986,5.696339845657349,2.648071527481079,9.025794982910156,177,16,161,161,0,5,45000.0
45,45999,21.233131004807625,35.54450627699112,0.0030864139199560103,5.818411827087402,2.7050704956054688,9.112823486328125,179,17,162,162,0,5,46000.0
46,46999,21.144823676416998,35.33285791948911,0.002725292617356101,5.9465930461883545,2.762415885925293,9.235015869140625,194,18,176,176,0,5,47000.0
47,47999,21.067314584388168,35.215965675149526,0.0023184811123887483,6.075225353240967,2.8203845024108887,9.360660552978516,196,19,177,177,0,5,48000.0
48,48999,21.021506124388498,35.19597697113586,0.0021060359271930507,6.202129602432251,2.878527879714966,9.454303741455078,198,20,178,178,0,5,49000.0
49,49999,20.964818689931956,35.156807034181035,0.001926017527195234,6.326925039291382,2.9356398582458496,9.54909896850586,200,21,179,179,0,5,50000.0
50,50999,20.934063973233243,35.10665345541534,0.0020542478280222154,6.46539831161499,2.9930429458618164,9.596858978271484,204,23,181,181,0,5,51000.0
51,51999,20.909233720146634,35.00733679137501,0.002609220189276673,6.581952333450317,3.051593542098999,9.789798736572266,219,24,195,195,0,5,52000.0
52,52999,20.856118713100212,34.88476761715878,0.002781715097231463,6.712019443511963,3.1083719730377197,9.999198913574219,219,24,195,195,0,5,53000.0
53,53999,20.83592790001955,34.84175662124646,0.002727864275488212,6.827094078063965,3.1645727157592773,10.10367202758789,219,24,195,195,0,5,54000.0
54,54999,20.827817360017796,34.788019276409365,0.0029796196335126757,6.9590418338775635,3.2221524715423584,10.286739349365234,219,24,195,195,0,5,55000.0
55,55999,20.83194762460341,34.75364911884185,0.003380516975304948,7.081029176712036,3.2787961959838867,10.354755401611328,219,24,195,195,0,5,56000.0
56,56999,20.836421454848864,34.71000461980981,0.0032014051617198502,7.214712381362915,3.337214946746826,10.51541519165039,219,24,195,195,0,5,57000.0
57,57999,20.839511518846667,34.658691460486125,0.003656722190861328,7.33059024810791,3.3942437171936035,10.65255355834961,219,24,195,195,0,5,58000.0
58,58999,20.8284073966847,34.58989725570995,0.003699242455753482,7.462289333343506,3.453237295150757,10.642719268798828,222,25,197,197,0,5,59000.0
59,59999,20.83639162148311,34.53608791197291,0.003743044073234447,7.584832191467285,3.5104641914367676,10.680828094482422,245,27,218,218,0,5,60000.0
60,60999,20.858737613124728,34.653575930914506,0.003672879446753763,7.70042610168457,3.567601442337036,10.816104888916016,260,28,232,232,0,5,61000.0
61,61999,20.807339432407932,34.541686208879746,0.0034962480308671218,7.897524118423462,3.6258387565612793,11.20626449584961,265,29,236,236,0,5,62000.0
62,62999,20.73636270089827,34.44926080644096,0.0036261686332204057,8.01751160621643,3.683767080307007,11.362197875976562,265,29,236,236,0,5,63000.0
63,63999,20.67807132987035,34.38826399328779,0.0034721758475895204,8.148698568344116,3.741096258163452,11.565731048583984,265,29,236,236,0,5,64000.0
64,64999,20.60342439083875,34.24891857029312,0.0030411527758812396,8.280353784561157,3.798527479171753,11.547492980957031,271,31,240,240,0,5,65000.0
65,65999,20.570632307780688,34.228341638863355,0.0029152480385112867,8.39601445198059,3.8561019897460938,11.804767608642578,271,31,240,240,0,5,66000.0
66,66999,20.54859484405757,34.263540042038805,0.0030279644006260265,8.512541770935059,3.9148483276367188,12.016937255859375,271,31,240,240,0,5,67000.0
67,67999,20.521292164651808,34.207937942192565,0.003091977731526363,8.63300895690918,3.9755988121032715,12.14432144165039,271,31,240,240,0,5,68000.0
68,68999,20.561369658184923,34.29331822131288,0.0029058300985475016,8.757505178451538,4.032081842422485,12.335132598876953,271,31,240,240,0,5,69000.0
69,69999,20.606627851596773,34.626222509572806,0.003289712611229123,8.887450456619263,4.089219808578491,12.510032653808594,271,31,240,240,0,5,70000.0
70,70999,20.684098036691303,34.870653876293275,0.004150648868861184,9.016425609588623,4.147092342376709,12.669776916503906,271,31,240,240,0,5,71000.0
71,71999,20.785597389293596,35.10794034567417,0.005273969615789964,9.143898725509644,4.208038330078125,12.678756713867188,277,32,245,245,0,6,72000.0
72,72999,20.86009301289929,35.47982841335731,0.006183682349281461,9.27483606338501,4.26698637008667,12.868820190429688,278,32,246,246,0,6,73000.0
73,73999,20.944744857458033,35.78240571356468,0.007752609657219911,9.38778305053711,4.324646234512329,13.019569396972656,279,32,247,247,0,6,74000.0
74,74999,21.021617675669752,35.941185015523494,0.008230605994848483,9.500479698181152,4.383167505264282,13.100898742675781,279,32,247,247,0,6,75000.0
75,75999,21.10194979471183,36.08829679876882,0.009186066236728574,9.622994661331177,4.43981409072876,13.251327514648438,280,32,248,248,0,6,76000.0
76,76999,21.235623880409126,36.545821982515726,0.009841790786545901,9.74874210357666,4.497710227966309,13.284454345703125,282,33,249,249,0,6,77000.0
77,77999,21.366248439461536,36.756483949587654,0.010337034087490315,9.872608184814453,4.554978132247925,13.44198989868164,283,33,250,250,0,6,78000.0
78,78999,21.469111255554978,36.9134032230762,0.010798578227260824,10.0029935836792,4.612466096878052,13.525909423828125,300,34,266,266,0,6,79000.0
79,79999,21.582160900203775,37.043681371181634,0.011105740482237336,10.119044780731201,4.670962572097778,13.662166595458984,301,34,267,267,0,6,80000.0
80,80999,21.65851241756866,37.110474874408915,0.011613299984363445,10.253966093063354,4.731240510940552,13.731204986572266,301,34,267,267,0,6,81000.0
81,81999,21.663522582807246,37.09444694841597,0.011106873130697248,10.37148380279541,4.788522720336914,13.962230682373047,319,35,284,284,0,6,82000.0
82,82999,21.64515176048741,37.07612527811861,0.010860363368257575,10.483906269073486,4.847325325012207,14.051826477050781,321,36,285,285,0,6,83000.0
83,83999,21.602612665506438,36.96273946573755,0.01095883078713733,10.605797529220581,4.905859708786011,14.137474060058594,321,36,285,285,0,6,84000.0
84,84999,21.578791004430435,36.885393574185166,0.010621384675799983,10.741406917572021,4.963315010070801,14.229976654052734,321,36,285,285,0,6,85000.0
85,85999,21.594682558452057,36.91332733129082,0.011359680800738903,10.869781970977783,5.020596027374268,14.242382049560547,342,40,302,302,0,6,86000.0
86,86999,21.581384744635333,36.861659431599485,0.01093677556944428,11.005595445632935,5.078882455825806,14.319316864013672,350,41,309,309,0,6,87000.0
87,87999,21.625025349323053,36.917672050187804,0.011275276676777746,11.118967056274414,5.136335611343384,14.462356567382812,350,41,309,309,0,6,88000.0
88,88999,21.673874405887965,36.98593415530729,0.01089600277074354,11.24178695678711,5.1936187744140625,14.605567932128906,350,41,309,309,0,6,89000.0
89,89999,21.72821032692766,37.039939953793244,0.011184039661070955,11.352160930633545,5.2510926723480225,14.750732421875,350,41,309,309,0,6,90000.0
90,90999,21.797258342157445,37.124147423227086,0.010940925099808152,11.468989849090576,5.308562994003296,14.865047454833984,350,41,309,309,0,6,91000.0
91,91999,21.88197847406731,37.25888361661655,0.011258285402751311,11.603538990020752,5.3686792850494385,14.93310546875,350,41,309,309,0,6,92000.0
92,92999,21.997341414349837,37.4889471659806,0.012555509804401788,11.720758199691772,5.429173469543457,15.019683837890625,350,41,309,309,0,6,93000.0
93,93999,22.085584199221906,37.61979269012962,0.013224211946450515,11.852736473083496,5.486901044845581,15.108352661132812,351,41,310,310,0,6,94000.0
94,94999,22.163560817174655,37.70856908377096,0.013472080672754405,11.987243175506592,5.544910192489624,15.211357116699219,351,41,310,310,0,6,95000.0
95,95999,22.269252173924322,37.88484761542023,0.013933811156554454,12.09830379486084,5.602682590484619,15.321109771728516,351,41,310,310,0,6,96000.0
96,96999,22.388060048649756,38.052977931937704,0.014273428284969025,12.23418116569519,5.661213159561157,15.307697296142578,367,42,325,325,0,6,97000.0
97,97999,22.522571278416375,38.3744593777512,0.01451787718699471,12.368680477142334,5.720373630523682,15.559127807617188,369,43,326,326,0,6,98000.0
98,98999,22.63932574832059,38.53991725310441,0.01505414814705941,12.503121137619019,5.7798707485198975,15.687660217285156,383,44,339,339,0,6,99000.0
99,99999,22.756740461482842,38.72107165736607,0.016126042846797195,12.64520001411438,5.848886013031006,15.780601501464844,383,44,339,339,0,6,100000.0
100,100999,22.849510460272953,38.821974482583364,0.016400036261529638,12.769078254699707,5.9075400829315186,15.911781311035156,383,44,339,339,0,6,101000.0
101,101999,22.883341637556196,38.83470492197737,0.016743089637667685,12.910274744033813,5.967038154602051,16.280792236328125,407,45,362,362,0,6,102000.0
102,102999,22.854269335060987,38.76099242646138,0.016865149563808468,13.04459023475647,6.025731325149536,16.496936798095703,409,46,363,363,0,6,103000.0
103,103999,22.84661460121424,38.75302753780903,0.016693937654559732,13.157746315002441,6.0833580493927,16.73290252685547,409,46,363,363,0,6,104000.0
104,104999,22.820423147482334,38.71584319979661,0.016358234105630642,13.2965087890625,6.140928745269775,16.64586639404297,434,49,385,385,0,6,105000.0
105,105999,22.793237184904967,38.647990215559126,0.01645247894115265,13.437304019927979,6.200234889984131,16.7501220703125,447,52,395,395,0,6,106000.0
106,106999,22.756761349267464,38.56765613531082,0.01637633268675387,13.560149908065796,6.258554220199585,17.03820037841797,447,52,395,395,0,6,107000.0
107,107999,22.715655783078372,38.46116119292879,0.016435526577155746,13.680752992630005,6.316458463668823,17.192096710205078,447,52,395,395,0,6,108000.0
108,108999,22.692040381766603,38.53445116516193,0.01622737444582656,13.824576377868652,6.376662492752075,17.355697631835938,447,52,395,395,0,6,109000.0
109,109999,22.662339423910435,38.46437310737801,0.016148728956387748,13.955432653427124,6.439420223236084,17.51907730102539,448,52,396,396,0,6,110000.0
110,110999,22.641715913425536,38.388130887215254,0.016139845549251963,14.082586288452148,6.499345302581787,17.70291519165039,456,53,403,403,0,6,111000.0
111,111999,22.63208353009817,38.45066766455748,0.015871943093843877,14.204105615615845,6.55845832824707,17.89151382446289,456,53,403,403,0,6,112000.0
112,112999,22.61332103358077,38.37575225504456,0.01585538857179658,14.331069469451904,6.616292715072632,18.023025512695312,456,53,403,403,0,6,113000.0
113,113999,22.605031639796827,38.32485780783578,0.015600451892087919,14.461072206497192,6.675535440444946,18.124378204345703,470,54,416,416,0,6,114000.0
114,114999,22.601767232171756,38.28332555045807,0.01554177703303039,14.611624240875244,6.830004692077637,18.24154281616211,483,55,428,428,0,6,115000.0
115,115999,22.594174041664,38.2221145517643,0.015305293286289157,14.742500066757202,6.891191482543945,18.46075439453125,483,55,428,428,0,6,116000.0
116,116999,22.58606280379609,38.15110154647429,0.015297462782084326,14.877315759658813,6.951514959335327,18.766681671142578,513,57,456,456,0,6,117000.0
117,117999,22.579893517943017,38.134927708282184,0.015142108642099528,15.007346630096436,7.011429786682129,19.085479736328125,513,57,456,456,0,6,118000.0
118,118999,22.558566138075978,38.06751288069641,0.015067799782420344,15.135719299316406,7.070537567138672,19.25792694091797,528,58,470,470,0,6,119000.0
119,119999,22.52855460657329,38.00294042280967,0.014831839963340698,15.251450538635254,7.132151126861572,19.775466918945312,532,58,474,474,0,6,120000.0
120,120999,22.495495060737987,37.918681741132865,0.014938452596913843,15.384888172149658,7.191721677780151,20.001773834228516,534,59,475,475,0,6,121000.0
121,121999,22.447397218880212,37.821639824702,0.014982069280219501,15.510012149810791,7.250948429107666,20.162940979003906,535,59,476,476,0,6,122000.0
122,122999,22.405004662277957,37.744744890842156,0.015301782774590822,15.637207984924316,7.311237096786499,20.21097183227539,545,62,483,483,0,6,123000.0
123,123999,22.359064987040632,37.65841611530759,0.01552434697288918,15.758070468902588,7.370587110519409,20.270580291748047,552,63,489,489,0,6,124000.0
124,124999,22.318822551619157,37.633508368527195,0.015936868434101914,15.88610577583313,7.430243253707886,20.319717407226562,559,64,495,495,0,6,125000.0
125,125999,22.284471767368405,37.56539060967882,0.016058234653739567,16.008297443389893,7.488670587539673,20.484901428222656,559,64,495,495,0,6,126000.0
126,126999,22.25126896324839,37.496515436004685,0.01605018914623646,16.135061979293823,7.548089981079102,20.631179809570312,559,64,495,495,0,6,127000.0
127,127999,22.21817534512715,37.427801154980486,0.015891320348449423,16.25924277305603,7.606083393096924,20.723064422607422,559,64,495,495,0,6,128000.0
128,128999,22.19458426232932,37.363325712597245,0.015792293253032885,16.385230779647827,7.66557765007019,20.796768188476562,579,65,514,514,0,6,129000.0
129,129999,22.171044669391158,37.31169139830412,0.015626728997440553,16.519495010375977,7.72785210609436,20.81098175048828,586,66,520,520,0,6,130000.0
130,130999,22.14482757167278,37.25664959660135,0.0159801457888491,16.652496099472046,7.787402391433716,20.81534194946289,594,68,526,526,0,6,131000.0
131,131999,22.14170033197142,37.305735989947266,0.01647843030977514,16.771175146102905,7.84690523147583,21.001567840576172,600,69,531,531,0,6,132000.0
132,132999,22.134561314085055,37.27895146397106,0.016421969379915913,16.895721197128296,7.905841588973999,21.157989501953125,601,69,532,532,0,6,133000.0
133,133999,22.146716749079328,37.29621314018787,0.016351000601883103,17.025622367858887,7.965154647827148,21.286602020263672,601,69,532,532,0,6,134000.0
134,134999,22.16983180928444,37.32159567228111,0.016582389073093173,17.158886671066284,8.024595499038696,21.44989013671875,613,70,543,543,0,6,135000.0
135,135999,22.187596823670923,37.32141104999684,0.01685565155250024,17.28696632385254,8.084785223007202,21.690887451171875,614,70,544,544,0,6,136000.0
136,136999,22.204868389213797,37.33307090264048,0.01713298590648593,17.423784017562866,8.144220113754272,21.721729278564453,666,71,595,595,0,6,137000.0
137,137999,22.23228664737839,37.40308716402748,0.017715455626935106,17.560034036636353,8.20383620262146,22.128284454345703,684,72,612,612,0,6,138000.0
138,138999,22.231126147025435,37.381141009244764,0.018102080899449202,17.678863525390625,8.26352310180664,22.806690216064453,692,72,620,620,0,6,139000.0
139,139999,22.19514905658722,37.35993944965932,0.018171863101297925,17.788487434387207,8.322182893753052,23.138195037841797,692,72,620,620,0,6,140000.0
140,140999,22.151743705084247,37.284150060132276,0.018341230060238467,17.907249689102173,8.38157320022583,23.431861877441406,692,72,620,620,0,6,141000.0
141,141999,22.119416686042353,37.219363974422386,0.018423214122956555,18.02940559387207,8.441307306289673,23.705772399902344,709,73,636,636,0,6,142000.0
142,142999,22.081679968884696,37.141915036884356,0.018456935596002144,18.15636897087097,8.500065326690674,23.766647338867188,713,75,638,638,0,6,143000.0
143,143999,22.048267249031795,37.09663910248571,0.018457406299641432,18.272944927215576,8.558043241500854,24.04717254638672,713,75,638,638,0,6,144000.0
144,144999,22.013969028445814,37.022887241215265,0.018421376804803824,18.40188217163086,8.615437269210815,24.13565444946289,721,76,645,645,0,6,145000.0
145,145999,21.980900560135925,36.95532585451598,0.018584562606019372,18.51605772972107,8.673731327056885,24.33104705810547,721,76,645,645,0,6,146000.0
146,146999,21.951947982509125,36.896926079192966,0.01864889936019809,18.650362491607666,8.732884407043457,24.351726531982422,725,78,647,647,0,6,147000.0
147,147999,21.92252706322601,36.82672775944001,0.018674376019955474,18.775990962982178,8.796070575714111,24.55950927734375,725,78,647,647,0,6,148000.0
148,148999,21.906634105832264,36.78964892610203,0.0185271099491493,18.904005527496338,8.854886293411255,24.738300323486328,725,78,647,647,0,6,149000.0
149,149999,21.889396875654775,36.73358662353089,0.018346210384165507,19.0151686668396,8.913198947906494,24.81496810913086,725,78,647,647,0,6,150000.0
150,150999,21.879332945930585,36.705861563111746,0.018230550415915148,19.147886991500854,8.972560167312622,24.884170532226562,740,80,660,660,0,6,151000.0
151,151999,21.866579085922925,36.66082767186324,0.018194311146753406,19.277615785598755,9.031174421310425,24.957443237304688,748,81,667,667,0,6,152000.0
152,152999,21.850790807123705,36.616106566113224,0.018184334405144775,19.39761710166931,9.091723203659058,25.058242797851562,748,81,667,667,0,6,153000.0
153,153999,21.846318264500127,36.57321844960848,0.018075570097653926,19.674277782440186,9.151741743087769,25.065345764160156,782,85,697,697,0,6,154000.0
154,154999,21.839370673374972,36.51994443331042,0.017852232059442974,19.82412600517273,9.21274995803833,25.28426742553711,789,86,703,703,0,6,155000.0
155,155999,21.830850254632193,36.461227510047806,0.01769970236861007,19.94004464149475,9.271864175796509,25.59970474243164,789,86,703,703,0,6,156000.0
156,156999,21.823547019594706,36.41325275273278,0.017559868997795047,20.060802698135376,9.332156658172607,25.799392700195312,789,86,703,703,0,6,157000.0
157,157999,21.816407595772127,36.37599232920668,0.017442205976186953,20.193949460983276,9.391883611679077,25.857566833496094,797,87,710,710,0,6,158000.0
158,158999,21.802761892877413,36.31846375031599,0.017121227727145527,20.3159396648407,9.45083212852478,25.9813232421875,797,87,710,710,0,6,159000.0
159,159999,21.771570463605734,36.25548866694024,0.017081890654195853,20.43759322166443,9.510344505310059,26.511199951171875,813,88,725,725,0,6,160000.0
160,160999,21.723660365908785,36.17779236334021,0.017389147898654533,20.55021905899048,9.569465160369873,26.72171401977539,820,89,731,731,0,6,161000.0
161,161999,21.672414435598103,36.09851342387925,0.017680613208691187,20.665643453598022,9.629480600357056,26.895503997802734,820,89,731,731,0,6,162000.0
162,162999,21.626952267527994,36.02676116135008,0.017794075244193075,20.78874397277832,9.687016010284424,26.938926696777344,822,90,732,732,0,6,163000.0
163,163999,21.588254936461276,35.9794878952107,0.017754455135962965,20.901663303375244,9.744640350341797,27.10688018798828,822,90,732,732,0,6,164000.0
164,164999,21.54099472918523,35.89902423091711,0.017974971466085954,21.025129079818726,9.802594184875488,27.211441040039062,822,90,732,732,0,6,165000.0
165,165999,21.50817105992478,35.838570357645956,0.018210572461031638,21.154606819152832,9.861594915390015,27.293216705322266,822,90,732,732,0,6,166000.0
166,166999,21.478426342948342,35.77130586365139,0.01837816544128923,21.286872148513794,9.920740365982056,27.206523895263672,828,93,735,735,0,6,167000.0
167,167999,21.44690212537153,35.71997192238587,0.01853094056877358,21.416707038879395,9.983631372451782,27.39739990234375,834,94,740,740,0,6,168000.0
168,168999,21.42477563116846,35.66708076252659,0.018699193898137123,21.54108190536499,10.0463125705719,27.564266204833984,836,95,741,741,0,6,169000.0
169,169999,21.415316948575015,35.70488372970124,0.018330283119227908,21.661131143569946,10.10620927810669,27.66231918334961,843,96,747,747,0,6,170000.0
170,170999,21.40663290388697,35.69236674209886,0.01870575131101937,21.778334856033325,10.168121576309204,27.813312530517578,843,96,747,747,0,6,171000.0
171,171999,21.406045111268003,35.685141665208974,0.018497825494368847,21.909428358078003,10.226757764816284,27.902206420898438,843,96,747,747,0,6,172000.0
172,172999,21.406106596625825,35.68315239852834,0.018626088244991568,22.054486751556396,10.287842988967896,27.971832275390625,853,97,756,756,0,6,173000.0
173,173999,21.41090562220506,35.67292385687395,0.01857574629907477,22.18659234046936,10.347975492477417,28.029949188232422,855,98,757,757,0,6,174000.0
174,174999,21.422938757763113,35.67235560945957,0.018508728334328817,22.310600519180298,10.407442331314087,28.074199676513672,857,99,758,758,0,6,175000.0
175,175999,21.436743713695837,35.677674551415215,0.018467479105294782,22.442035675048828,10.466864347457886,28.159637451171875,859,100,759,759,0,6,176000.0
176,176999,21.449181476114312,35.682714846854154,0.018430232434730964,22.57524013519287,10.525508880615234,28.298728942871094,859,100,759,759,0,6,177000.0
177,177999,21.45534618901407,35.66618751189036,0.01841069124333916,22.69656729698181,10.584764957427979,28.39167022705078,859,100,759,759,0,6,178000.0
178,178999,21.448877822579515,35.62624790454573,0.01825051500841801,22.808582067489624,10.643943786621094,28.48729705810547,859,100,759,759,0,6,179000.0
179,179999,21.4168279948348,35.58980374495577,0.018572185063669533,22.927159309387207,10.70656132698059,28.985607147216797,874,101,773,773,0,6,180000.0
180,180999,21.378181139050675,35.52565444727057,0.01875853026042673,23.050315380096436,10.765503644943237,29.20195770263672,877,102,775,775,0,6,181000.0
181,181999,21.332303235212247,35.45258669140937,0.019035534102510132,23.179675340652466,10.825177907943726,29.313526153564453,890,104,786,786,0,6,182000.0
182,182999,21.29418847139762,35.392054375386856,0.019088611306826153,23.312480926513672,10.883976221084595,29.343647003173828,899,107,792,792,0,6,183000.0
183,183999,21.258871164627493,35.34041756748705,0.019220509101663952,23.435280799865723,10.943537950515747,29.572071075439453,899,107,792,792,0,6,184000.0
184,184999,21.22065272877997,35.27348211794891,0.019430786901430408,23.557548761367798,11.00276231765747,29.683746337890625,899,107,792,792,0,6,185000.0
185,185999,21.188112377497724,35.20890913072245,0.019575157442294988,23.677605628967285,11.06197452545166,29.77104949951172,899,107,792,792,0,6,186000.0
186,186999,21.152475661041258,35.14238239186791,0.01975571055534886,23.81629729270935,11.122411012649536,29.80050277709961,901,108,793,793,0,6,187000.0
187,187999,21.116195567703635,35.079055724521645,0.019957027661989035,23.940490245819092,11.181424617767334,29.78200912475586,911,109,802,802,0,6,188000.0
188,188999,21.087964019422365,35.026575726734016,0.020157300148726076,24.071574211120605,11.240219354629517,29.860092163085938,911,109,802,802,0,6,189000.0
189,189999,21.0605129514105,34.99193760275891,0.020139662944369308,24.190150022506714,11.29947566986084,29.94432830810547,911,109,802,802,0,6,190000.0
190,190999,21.02653199805744,34.930373059061516,0.02015255927691928,24.310906171798706,11.361427783966064,30.01455307006836,914,110,804,804,0,6,191000.0
191,191999,21.003105968767002,34.89573510679813,0.020127577738022984,24.44011926651001,11.419272899627686,30.01947021484375,920,111,809,809,0,6,192000.0
192,192999,20.98009075714639,34.85356253421522,0.020109570182270553,24.57252812385559,11.478415966033936,30.090831756591797,935,112,823,823,0,6,193000.0
193,193999,20.962603575230784,34.81567142912329,0.020120762835174277,24.706724166870117,11.537651777267456,30.166767120361328,937,113,824,824,0,6,194000.0
194,194999,20.944499318978693,34.77569406743049,0.020135280781073073,24.845771551132202,11.59766697883606,30.181007385253906,939,114,825,825,0,6,195000.0
195,195999,20.939310282570183,34.754847106530164,0.020249343135519737,24.978047609329224,11.65671443939209,30.218929290771484,950,116,834,834,0,6,196000.0
196,196999,20.92742881130479,34.7235824058182,0.020288970726618172,25.097564935684204,11.714589595794678,30.343093872070312,950,116,834,834,0,6,197000.0
197,197999,20.917478579242204,34.697720112987504,0.020408738063824816,25.24010944366455,11.776773691177368,30.428997039794922,963,117,846,846,0,6,198000.0
198,198999,20.90808334030115,34.664524995227545,0.020379995888936242,25.354939937591553,11.834672451019287,30.575176239013672,965,117,848,848,0,6,199000.0
199,199999,20.88610490716012,34.622093231978525,0.020659269966798455,25.47351336479187,11.894511699676514,31.21420669555664,979,117,862,862,0,6,200000.0
200,200999,20.85468672875438,34.587731957297606,0.020948086203905536,25.59404182434082,11.957058429718018,31.52935791015625,980,117,863,863,0,6,201000.0
201,201999,20.81703500087958,34.536776963744664,0.021279332196452838,25.729135990142822,12.019607305526733,31.66820526123047,987,118,869,869,0,6,202000.0
202,202999,20.78968713432762,34.50838672634445,0.021567170315710205,25.85945987701416,12.081412553787231,31.717994689941406,991,120,871,871,0,6,203000.0
203,203999,20.761105028490153,34.45814852963223,0.021743319237737868,25.977895736694336,12.140140056610107,31.92767333984375,991,120,871,871,0,6,204000.0
204,204999,20.73728593921512,34.41947008496881,0.021891701217813586,26.099456548690796,12.198103904724121,32.0054817199707,998,121,877,877,0,6,205000.0
205,205999,20.714487238630213,34.38043736095488,0.021974226479093195,26.213419198989868,12.257139921188354,32.119140625,998,121,877,877,0,6,206000.0
206,206999,20.691268758464258,34.34397426206968,0.02220517430118052,26.340960264205933,12.316568613052368,32.17600631713867,1000,122,878,878,0,6,207000.0
207,207999,20.67614052224208,34.333395440060904,0.02238219752978521,26.477163791656494,12.37602710723877,32.274452209472656,1004,124,880,880,0,6,208000.0
208,208999,20.654742705977675,34.29202248958188,0.022546750368149793,26.61569619178772,12.437525987625122,32.26765441894531,1016,126,890,890,0,6,209000.0
209,209999,20.647148978946156,34.27508413970528,0.022961751339522163,26.736881256103516,12.498343229293823,32.32954788208008,1018,127,891,891,0,6,210000.0
210,210999,20.638482184287515,34.29252577438622,0.02313621425826362,27.00872802734375,12.558042049407959,32.473995208740234,1030,129,901,901,0,6,211000.0
211,211999,20.627621944256298,34.269948974392086,0.02345467165275472,27.138810634613037,12.619699954986572,32.67543029785156,1050,131,919,919,0,6,212000.0
212,212999,20.624360771954652,34.277997872267946,0.023572598255013677,27.257818937301636,12.678482294082642,32.84212875366211,1054,132,922,922,0,6,213000.0
213,213999,20.624980606437838,34.29213530155736,0.02367136500760214,27.386687517166138,12.738524675369263,32.91246795654297,1068,134,934,934,0,6,214000.0
214,214999,20.6399947413195,34.333730371626565,0.02386898067322163,27.507561445236206,12.798368692398071,33.17948913574219,1072,134,938,938,0,6,215000.0
215,215999,20.655129646602713,34.36787734682086,0.023989878773879703,27.639819860458374,12.863079071044922,33.320953369140625,1075,135,940,940,0,6,216000.0
216,216999,20.67147055179192,34.39668047373009,0.02437135068454399,27.76907253265381,12.921454668045044,33.45978546142578,1086,136,950,950,0,6,217000.0
217,217999,20.68575382820942,34.42217436574575,0.02453247415415094,27.891140937805176,12.979609489440918,33.52192306518555,1097,137,960,960,0,6,218000.0
218,218999,20.70838352074876,34.46013808242876,0.024723128790118953,28.020825624465942,13.045310735702515,33.67057800292969,1097,137,960,960,0,6,219000.0
219,219999,20.703515973633912,34.43971158205279,0.02459795767158668,28.13316774368286,13.105473756790161,34.12854766845703,1110,137,973,973,0,6,220000.0
220,220999,20.68291431750068,34.419541249793305,0.02444671280249222,28.264277935028076,13.167757511138916,34.633445739746094,1115,137,978,978,0,6,221000.0
221,221999,20.65587808339461,34.3863866361839,0.024424878690401663,28.390079259872437,13.227553367614746,34.873470306396484,1115,137,978,978,0,6,222000.0
222,222999,20.62934511239404,34.342965770133745,0.024494311557628157,28.51576542854309,13.287615060806274,35.04237365722656,1115,137,978,978,0,6,223000.0
223,223999,20.6142338387888,34.33161294681865,0.024335550813851303,28.644699811935425,13.347240686416626,35.1333122253418,1119,139,980,980,0,6,224000.0
224,224999,20.600290428115436,34.30926608270308,0.02422444086531761,28.777642965316772,13.406748533248901,35.27650451660156,1131,140,991,991,0,6,225000.0
225,225999,20.590658541868198,34.28180956983952,0.02419213552795585,28.91321611404419,13.466854333877563,35.440208435058594,1145,141,1004,1004,0,6,226000.0
226,226999,20.58331095776754,34.271351859162735,0.024245828231293398,29.039130210876465,13.5266432762146,35.58906555175781,1156,142,1014,1014,0,6,227000.0
227,227999,20.579856622147492,34.26382778319795,0.024271583641499617,29.178508281707764,13.589250802993774,35.58108139038086,1162,145,1017,1017,0,6,228000.0
228,228999,20.581841486195696,34.28172738686363,0.02432741773343927,29.31446385383606,13.65131664276123,35.59152603149414,1204,149,1055,1055,0,6,229000.0
229,229999,20.582082698413384,34.29567072409192,0.02465094031569326,29.458099603652954,13.713557720184326,35.66147232055664,1208,151,1057,1057,0,6,230000.0
230,230999,20.59495341209594,34.33476617982771,0.024933786384321976,29.585694551467896,13.775973081588745,35.776546478271484,1211,152,1059,1059,0,6,231000.0
231,231999,20.60836910019724,34.360144809242875,0.025320516186840725,29.701479196548462,13.837556600570679,35.944034576416016,1212,152,1060,1060,0,6,232000.0
232,232999,20.63069990063368,34.421106474176796,0.02573568828496553,29.818677186965942,13.897027254104614,35.956199645996094,1214,153,1061,1061,0,6,233000.0
233,233999,20.666591291872024,34.50654942419053,0.026418962913862365,29.93657088279724,13.95963716506958,36.19332504272461,1215,153,1062,1062,0,6,234000.0
234,234999,20.709808523021444,34.643528538124535,0.02690710773713667,30.079676389694214,14.019582509994507,36.26171112060547,1228,156,1072,1072,0,6,235000.0
235,235999,20.755327290882935,34.78880388569524,0.027336613360297024,30.224923610687256,14.082471132278442,36.488563537597656,1244,157,1087,1087,0,6,236000.0
236,236999,20.809939793474104,34.9577337926806,0.027930544872424745,30.367786645889282,14.146929264068604,36.57289123535156,1264,159,1105,1105,0,6,237000.0
237,237999,20.84839280065955,35.0300199717787,0.028424770738682104,30.503688097000122,14.207945346832275,36.59760284423828,1294,162,1132,1132,0,6,238000.0
238,238999,20.878670190856944,35.08179214987623,0.02929771648880164,30.645041942596436,14.27132511138916,36.72772216796875,1310,164,1146,1146,0,6,239000.0
239,239999,20.88391116918983,35.109893986611645,0.029133840997749183,30.761545658111572,14.330831050872803,37.4264030456543,1333,164,1169,1169,0,6,240000.0
240,240999,20.870637232132935,35.1021175063264,0.029004571638912235,30.880069732666016,14.390634298324585,37.93194580078125,1346,165,1181,1181,0,6,241000.0
241,241999,20.85594945825811,35.073280300080675,0.02904251387303347,30.988438367843628,14.45077109336853,38.2015266418457,1346,165,1181,1181,0,6,242000.0
242,242999,20.841889191142457,35.065025410163116,0.02900691844328629,31.10481882095337,14.510150671005249,38.43696212768555,1347,165,1182,1182,0,6,243000.0
243,243999,20.82829539214845,35.043291559456556,0.029032538340341474,31.249937295913696,14.570554733276367,38.5449104309082,1364,168,1196,1196,0,6,244000.0
244,244999,20.81467363412881,35.01466886834326,0.029073276342711063,31.36120104789734,14.630730152130127,38.75058364868164,1364,168,1196,1196,0,6,245000.0
245,245999,20.803789964205077,34.98860911759341,0.029063379386992216,31.478800535202026,14.690431594848633,38.93342208862305,1373,169,1204,1204,0,6,246000.0
246,246999,20.792743654446355,34.97726482398607,0.029079287702124423,31.620929479599,14.749934673309326,39.05534744262695,1377,171,1206,1206,0,6,247000.0
247,247999,20.785732195613132,34.95991027872275,0.028995312431288056,31.736737489700317,14.809499502182007,39.273868560791016,1378,171,1207,1207,0,6,248000.0
248,248999,20.78034117222502,34.94537688547468,0.02899035104530967,31.851864099502563,14.868733406066895,39.42658996582031,1390,172,1218,1218,0,6,249000.0
249,249999,20.77535683068453,34.9298492772659,0.028823949254271675,31.993149518966675,14.928555727005005,39.47627639770508,1392,173,1219,1219,0,6,250000.0
250,250999,20.775486353252933,34.919158214381575,0.028733216948061968,32.12421631813049,14.988468647003174,39.681880950927734,1393,173,1220,1220,0,6,251000.0
251,251999,20.77439994286719,34.90555285017383,0.02859803855080889,32.25554037094116,15.048326015472412,39.79850769042969,1398,174,1224,1224,0,6,252000.0
252,252999,20.778847171527655,34.89362518736845,0.02849147695127896,32.376242876052856,15.108604192733765,40.026885986328125,1398,174,1224,1224,0,6,253000.0
253,253999,20.775806109028306,34.87356413982107,0.028560800031791733,32.50190877914429,15.16792631149292,40.210411071777344,1411,175,1236,1236,0,6,254000.0
254,254999,20.776183400516192,34.86171772571002,0.02850562147996316,32.637298345565796,15.2279052734375,40.338165283203125,1418,176,1242,1242,0,6,255000.0
255,255999,20.766550781294313,34.83403032820495,0.02845419333386867,32.763063192367554,15.459957838058472,41.127723693847656,1443,176,1267,1267,0,6,256000.0
256,256999,20.756873348540623,34.825953851284574,0.02875793695907536,32.88978409767151,15.5206618309021,41.60527801513672,1462,177,1285,1285,0,6,257000.0
257,257999,20.752685909687482,34.82312576228557,0.028730757405113216,33.00495171546936,15.583415985107422,41.933799743652344,1462,177,1285,1285,0,6,258000.0
258,258999,20.750772236205652,34.813349635727,0.028718864362928143,33.13274168968201,15.644459009170532,42.13469314575195,1465,178,1287,1287,0,6,259000.0
259,259999,20.747381900775057,34.80007015445943,0.028748162613632777,33.25927758216858,15.704646348953247,42.287967681884766,1475,180,1295,1295,0,6,260000.0
260,260999,20.75673197627371,34.83813325906921,0.028819382890356127,33.382944107055664,15.764583587646484,42.52875518798828,1481,181,1300,1300,0,6,261000.0
261,261999,20.762976059076138,34.85725166778617,0.028918274878375505,33.50966930389404,15.826734066009521,42.653560638427734,1495,182,1313,1313,0,6,262000.0
262,262999,20.77028633486476,34.868451653931395,0.029027031706708062,33.65465521812439,15.889212608337402,42.66252899169922,1514,186,1328,1328,0,6,263000.0
263,263999,20.782474921161988,34.88552127494806,0.02925843457353372,33.78019428253174,15.94915246963501,42.82695770263672,1526,187,1339,1339,0,6,264000.0
264,264999,20.801518793374868,34.91543599719389,0.02949914906520501,33.90420126914978,16.0113787651062,42.988555908203125,1526,187,1339,1339,0,6,265000.0
265,265999,20.824975651103937,34.98471495683934,0.029585175195457558,34.03136920928955,16.07251524925232,43.08455276489258,1538,188,1350,1350,0,6,266000.0
266,266999,20.842143512690175,35.00751046468832,0.029842364454014003,34.148451805114746,16.131823778152466,43.24114990234375,1539,188,1351,1351,0,6,267000.0
267,267999,20.862604502847073,35.02670541753558,0.03007917126231019,34.27847170829773,16.190848112106323,43.315887451171875,1541,189,1352,1352,0,6,268000.0
268,268999,20.886218032292632,35.052649662880924,0.0304018444345433,34.39779591560364,16.25013828277588,43.47138214111328,1544,190,1354,1354,0,6,269000.0
269,269999,20.907724154961798,35.07561792558385,0.03072985651375082,34.53508186340332,16.312645435333252,43.585601806640625,1546,191,1355,1355,0,6,270000.0
270,270999,20.94622899743387,35.15438233590723,0.031394116097134495,34.66350817680359,16.373451232910156,43.781551361083984,1558,192,1366,1366,0,6,271000.0
271,271999,20.96498923361733,35.16846115691321,0.03184078222668685,34.790141582489014,16.432526111602783,43.93510055541992,1558,192,1366,1366,0,6,272000.0
272,272999,20.98141156898174,35.17485595082558,0.03231490723043651,34.93668794631958,16.496809720993042,44.035850524902344,1568,194,1374,1374,0,6,273000.0
273,273999,20.996718280424048,35.24151504772313,0.03141433592728782,35.07354140281677,16.5632266998291,44.96099853515625,1605,195,1410,1410,0,6,274000.0
274,274999,21.007640808187436,35.29240595486494,0.031790530723795896,35.20126748085022,16.622161626815796,45.316253662109375,1635,197,1438,1438,0,6,275000.0
275,275999,21.017933405737153,35.36529190279597,0.031730706671247,35.3160617351532,16.680588006973267,45.65871810913086,1639,197,1442,1442,0,6,276000.0
276,276999,21.029217120066747,35.39030432588612,0.031700751373663794,35.43245196342468,16.73969030380249,45.90577697753906,1639,197,1442,1442,0,6,277000.0
277,277999,21.04338226657394,35.41692829492394,0.03173314921339554,35.59144115447998,16.80044174194336,46.05876541137695,1680,201,1479,1479,0,6,278000.0
278,278999,21.063553579819228,35.46279845750503,0.03197943462066921,35.72188425064087,16.862603187561035,46.310672760009766,1695,202,1493,1493,0,6,279000.0
279,279999,21.080484219841097,35.488857777462684,0.03246666446484536,35.838440895080566,16.92491912841797,46.45453643798828,1695,202,1493,1493,0,6,280000.0
280,280999,21.104650959270263,35.52676841458107,0.03284157537199439,35.98313593864441,16.985052824020386,46.26311111450195,1728,207,1521,1521,0,6,281000.0
281,281999,21.13279426029315,35.599429908588704,0.03358838149902055,36.10944437980652,17.048835515975952,46.61039352416992,1742,208,1534,1534,0,6,282000.0
282,282999,21.16551755881286,35.67627428901718,0.03435208037248216,36.23104000091553,17.10859990119934,46.76524353027344,1744,209,1535,1535,0,6,283000.0
283,283999,21.206264479943975,35.75646872194954,0.035166502863943294,36.37000870704651,17.16689968109131,46.82427978515625,1759,211,1548,1548,0,6,284000.0
284,284999,21.245243072427424,35.83292903055025,0.036280880549139805,36.48714852333069,17.226248741149902,47.038150787353516,1775,212,1563,1563,0,6,285000.0
285,285999,21.282802607573647,35.88101606988733,0.037464983714698974,36.61125087738037,17.286539793014526,47.110233306884766,1782,214,1568,1568,0,6,286000.0
286,286999,21.332239006056717,35.97908061392284,0.038855411901718484,36.74280333518982,17.347050666809082,47.34033203125,1795,215,1580,1580,0,6,287000.0
287,287999,21.374345556481877,36.04300868936555,0.04032721566483888,36.888325214385986,17.40799880027771,47.46684265136719,1817,219,1598,1598,0,6,288000.0
288,288999,21.42767632047687,36.161959054860915,0.04164779791978057,37.02941012382507,17.47096586227417,47.56334686279297,1843,222,1621,1621,0,6,289000.0
289,289999,21.48827182799784,36.27112008080846,0.0437971660825186,37.157310485839844,17.53088927268982,47.713218688964844,1857,223,1634,1634,0,6,290000.0
290,290999,21.545513286698135,36.378677355223104,0.04541146189950973,37.28541016578674,17.589950799942017,47.922401428222656,1870,224,1646,1646,0,7,291000.0
291,291999,21.597159064174562,36.46152755269754,0.04719364390443925,37.40548276901245,17.651204586029053,48.1382942199707,1870,224,1646,1646,0,7,292000.0
292,292999,21.626153860153046,36.51737901971377,0.04747625392208821,37.53080654144287,17.71276330947876,48.59189987182617,1892,225,1667,1667,0,7,293000.0
293,293999,21.635561372606187,36.557694772112036,0.0464298555196182,37.64565443992615,17.772449731826782,49.40275192260742,1915,226,1689,1689,0,7,294000.0
294,294999,21.630733579620316,36.557337505952255,0.04630562658223547,37.76341128349304,17.831267833709717,49.70367431640625,1917,227,1690,1690,0,7,295000.0
295,295999,21.626536259447995,36.55223398612327,0.04615999198325582,37.87882351875305,17.889971017837524,50.14144515991211,1918,227,1691,1691,0,7,296000.0
296,296999,21.625829607252843,36.544035957339325,0.04608404998526938,38.01573085784912,17.949426412582397,50.29347610473633,1948,230,1718,1718,0,7,297000.0
297,297999,21.623772319751964,36.53140687032389,0.0460777774545974,38.14494705200195,18.009804010391235,50.68708419799805,1980,232,1748,1748,0,7,298000.0
298,298999,21.623490009883874,36.52486828462746,0.04601140487414024,38.2692084312439,18.27608036994934,50.927616119384766,1988,233,1755,1755,0,7,299000.0
299,299999,21.62332512531855,36.5115624120061,0.045910939947416685,38.393059730529785,18.33924651145935,51.151092529296875,2003,234,1769,1769,0,7,300000.0
300,300999,21.62031027675552,36.49209626626976,0.04578994548213511,38.540961503982544,18.400097846984863,51.325504302978516,2008,236,1772,1772,0,7,301000.0
301,301999,21.61937067513031,36.48097025590438,0.04571432641935669,38.668840646743774,18.460368633270264,51.473663330078125,2036,238,1798,1798,0,7,302000.0
302,302999,21.616601444261004,36.46328436527972,0.04570096475368557,38.78810167312622,18.521440029144287,51.70048141479492,2036,238,1798,1798,0,7,303000.0
303,303999,21.6116780638822,36.44337911678532,0.04566913505721548,38.93289065361023,18.584316730499268,51.68815231323242,2041,240,1801,1801,0,7,304000.0
304,304999,21.613372959686473,36.43518619032996,0.045658272481593154,39.04267406463623,18.644408226013184,51.928077697753906,2041,240,1801,1801,0,7,305000.0
305,305999,21.61420007404228,36.42534863294976,0.04560422401401609,39.162089586257935,18.70643401145935,52.15005874633789,2043,240,1803,1803,0,7,306000.0
306,306999,21.616308006607117,36.41140484560927,0.04567828526385953,39.30510926246643,18.76731824874878,52.252288818359375,2079,243,1836,1836,0,7,307000.0
307,307999,21.623075627741613,36.40838967272742,0.045763643294563394,39.44119882583618,18.83094620704651,52.42303466796875,2094,244,1850,1850,0,7,308000.0
308,308999,21.638955665979083,36.441971317337,0.046005743795536236,39.56904888153076,18.89359760284424,52.59872055053711,2098,245,1853,1853,0,7,309000.0
309,309999,21.65806620298566,36.50218017019188,0.04605785007471985,39.6970431804657,18.952931880950928,52.78914260864258,2102,246,1856,1856,0,7,310000.0
310,310999,21.665374840362325,36.51992720608275,0.046115025122595465,39.83190727233887,19.01526665687561,52.90176773071289,2121,248,1873,1873,0,7,311000.0
311,311999,21.671557515234294,36.53975741835756,0.0465222544245073,39.96652269363403,19.07518696784973,53.09839630126953,2127,250,1877,1877,0,7,312000.0
312,312999,21.666725968891956,36.57831581484973,0.046279085427994415,40.08593225479126,19.137245178222656,54.37450408935547,2170,250,1920,1920,0,7,313000.0
313,313999,21.660200793625297,36.58645071274654,0.04602702216992882,40.20233917236328,19.19717264175415,54.78767395019531,2171,250,1921,1921,0,7,314000.0
314,314999,21.667846029359854,36.62442182775197,0.04603811512081257,40.31186819076538,19.256664514541626,55.12491989135742,2173,250,1923,1923,0,7,315000.0
315,315999,21.66876170684154,36.64713275108348,0.04618885602799072,40.441431522369385,19.317524433135986,55.35066223144531,2180,252,1928,1928,0,7,316000.0
316,316999,21.673516085189096,36.666841111547534,0.0463397556697438,40.5620322227478,19.377044916152954,55.7075080871582,2184,253,1931,1931,0,7,317000.0
317,317999,21.67441985391974,36.67833546032883,0.04650200196235166,40.68551588058472,19.440377712249756,56.00359344482422,2186,253,1933,1933,0,7,318000.0
318,318999,21.68011459631013,36.69993913086011,0.04658077092591728,40.7940354347229,19.49981141090393,56.267822265625,2187,253,1934,1934,0,7,319000.0
319,319999,21.684757162663956,36.7143099882114,0.046890788353749824,40.92670941352844,19.558618307113647,56.377384185791016,2192,255,1937,1937,0,7,320000.0
320,320999,21.689202830423138,36.720580756970584,0.046919711878370296,41.0711784362793,19.61764407157898,56.4975700378418,2238,259,1979,1979,0,7,321000.0
321,321999,21.688987801428556,36.71163428243584,0.04692158932882373,41.197033166885376,19.68103551864624,56.76020812988281,2243,260,1983,1983,0,7,322000.0
322,322999,21.694064871934025,36.71371013306081,0.04679504871139728,41.31636357307434,19.739601612091064,56.901641845703125,2256,261,1995,1995,0,7,323000.0
323,323999,21.70323709457628,36.75271776201498,0.04665067679616819,41.470696449279785,19.804309844970703,56.86494827270508,2292,265,2027,2027,0,7,324000.0
324,324999,21.704268188836142,36.74291888278416,0.046761035660952244,41.60774803161621,19.864798307418823,57.10449981689453,2311,267,2044,2044,0,7,325000.0
325,325999,21.705218319312397,36.73191685942513,0.04674102720187123,41.73192119598389,19.925392627716064,57.346012115478516,2315,268,2047,2047,0,7,326000.0
326,326999,21.71156560393894,36.73414228555088,0.04685438811982656,41.854886531829834,19.985737562179565,57.54547882080078,2330,269,2061,2061,0,7,327000.0
327,327999,21.713524355854783,36.72829466444415,0.04701769237300846,41.992658376693726,20.045348167419434,57.64029312133789,2349,272,2077,2077,0,7,328000.0
328,328999,21.71519978301221,36.72213150198906,0.04705957929823512,42.12557244300842,20.10411238670349,57.95960998535156,2351,272,2079,2079,0,7,329000.0
329,329999,21.708612379499485,36.700727224190686,0.047314164310104934,42.26648211479187,20.16683030128479,58.020713806152344,2379,275,2104,2104,0,7,330000.0
330,330999,21.70117739859876,36.67720675801381,0.04737592975075966,42.38438320159912,20.229065895080566,58.230140686035156,2380,275,2105,2105,0,7,331000.0
331,331999,21.70224057242541,36.69324662457827,0.04685113431474863,42.50231099128723,20.290021896362305,59.59123992919922,2429,275,2154,2154,0,7,332000.0
332,332999,21.68571218156881,36.66868650151724,0.046865449885671984,42.626972675323486,20.349679946899414,59.95256805419922,2442,276,2166,2166,0,7,333000.0
333,333999,21.67193426200823,36.64720319077263,0.04691849438931206,42.75393724441528,20.409026384353638,60.25917434692383,2468,278,2190,2190,0,7,334000.0
334,334999,21.662457713997483,36.64148091283891,0.046749245879630474,42.89272880554199,20.469138383865356,60.469181060791016,2483,281,2202,2202,0,7,335000.0
335,335999,21.65438212424656,36.62765613195525,0.04674905137078955,43.00235605239868,20.52786135673523,60.88450622558594,2484,281,2203,2203,0,7,336000.0
336,336999,21.651637074611767,36.63478122289237,0.04671604352603864,43.13890552520752,20.59136700630188,61.18458938598633,2488,282,2206,2206,0,7,337000.0
337,337999,21.645703210193965,36.61987845766019,0.04674686209231382,43.261351108551025,20.649598836898804,61.394283294677734,2491,283,2208,2208,0,7,338000.0
338,338999,21.64400803348561,36.61348587204752,0.046889486683653114,43.38514471054077,20.707355260849,61.56023406982422,2497,285,2212,2212,0,7,339000.0
339,339999,21.64140298007983,36.60205510452182,0.047011490340197026,43.52194118499756,20.767625093460083,61.901363372802734,2505,287,2218,2218,0,7,340000.0
340,340999,21.646352526913258,36.603356144326206,0.047134426684325326,43.64971876144409,20.828065395355225,62.1531982421875,2512,288,2224,2224,0,7,341000.0
341,341999,21.655230234963454,36.610787861500434,0.04736194562046414,43.77733588218689,20.8890221118927,62.42680358886719,2527,289,2238,2238,0,7,342000.0
342,342999,21.67789039036251,36.648987312716756,0.04772476201406728,43.897324085235596,20.948161840438843,62.69058609008789,2544,290,2254,2254,0,7,343000.0
343,343999,21.696702960711452,36.67428416803487,0.04807572803656679,44.01137566566467,21.006705045700073,62.90338897705078,2545,290,2255,2255,0,7,344000.0
344,344999,21.72481322445844,36.71396314984038,0.04869897887772301,44.39317226409912,21.065632343292236,63.103729248046875,2583,294,2289,2289,0,7,345000.0
345,345999,21.75205898759152,36.75442116692768,0.049445227533777336,44.53112554550171,21.12916874885559,63.50447082519531,2591,296,2295,2295,0,7,346000.0
346,346999,21.78167204785173,36.79361912890684,0.05008191307099452,44.648133516311646,21.189390420913696,63.8421516418457,2591,296,2295,2295,0,7,347000.0
347,347999,21.82393829727234,36.86410854698087,0.051278630099998335,44.78669190406799,21.251933574676514,64.19640731811523,2595,297,2298,2298,0,7,348000.0
348,348999,21.852638419768233,36.90069412799955,0.05190616020432437,44.910659313201904,21.312174320220947,64.44672393798828,2611,298,2313,2313,0,7,349000.0
349,349999,21.887068153327345,36.94554732559283,0.05264132637219632,45.04571294784546,21.3757541179657,64.64148330688477,2623,299,2324,2324,0,7,350000.0
350,350999,21.908872993827085,36.97402234690762,0.052950047222954044,45.19151759147644,21.44042205810547,64.80003356933594,2648,301,2347,2347,0,7,351000.0
351,351999,21.901958509017657,36.96323285356876,0.05281899183987615,45.31542754173279,21.502801179885864,66.21786117553711,2698,301,2397,2397,0,7,352000.0
352,352999,21.89136563444254,36.945735843044936,0.05269751426281477,45.432021379470825,21.563082695007324,66.75794982910156,2700,301,2399,2399,0,7,353000.0
353,353999,21.87708650094762,36.92379663645397,0.05265378091581052,45.545658588409424,21.62463355064392,67.13134765625,2701,301,2400,2400,0,7,354000.0
354,354999,21.86359389496588,36.89872981250917,0.0525801905271015,45.68128299713135,21.684892416000366,67.43434143066406,2705,302,2403,2403,0,7,355000.0
355,355999,21.858650517625424,36.88851196921307,0.052526188190267886,45.791218757629395,21.744905948638916,67.80603790283203,2706,302,2404,2404,0,7,356000.0
356,356999,21.85864339827202,36.87990934854055,0.05245662047592836,45.9179847240448,21.805086612701416,68.03469467163086,2710,303,2407,2407,0,7,357000.0
357,357999,21.8562516019493,36.86638525474395,0.05245917160019886,46.048848152160645,21.86836290359497,68.32254409790039,2728,304,2424,2424,0,7,358000.0
358,358999,21.852759547509,36.85065777750594,0.05244206158944553,46.18434119224548,21.930587768554688,68.4237060546875,2734,306,2428,2428,0,7,359000.0
359,359999,21.85017243374217,36.83726191382283,0.052479980408091986,46.323795795440674,21.990856885910034,68.71697235107422,2755,308,2447,2447,0,7,360000.0
360,360999,21.850576929975976,36.82942530774631,0.052543347449151456,46.443188428878784,22.049816370010376,68.93195343017578,2773,309,2464,2464,0,7,361000.0
361,361999,21.852298424537114,36.82233953686398,0.052639254348044395,46.57233500480652,22.110618352890015,69.18075942993164,2793,310,2483,2483,0,7,362000.0
362,362999,21.850997180681254,36.8111790435403,0.05266200162289858,46.69605207443237,22.17060947418213,69.37493896484375,2798,311,2487,2487,0,7,363000.0
363,363999,21.851598941615286,36.80100583738827,0.052730913631591436,46.80710411071777,22.231125354766846,69.61280059814453,2798,311,2487,2487,0,7,364000.0
364,364999,21.852182547685434,36.7919666087469,0.05261934138203039,46.930694818496704,22.290388107299805,69.86897277832031,2804,312,2492,2492,0,7,365000.0
365,365999,21.854467827014062,36.78366895972731,0.05265591254249502,47.06277775764465,22.351133108139038,70.09565734863281,2809,313,2496,2496,0,7,366000.0
366,366999,21.860597160808474,36.78200516727245,0.052668065759297056,47.20682740211487,22.411680459976196,70.2494125366211,2813,315,2498,2498,0,7,367000.0
367,367999,21.86474249188248,36.77869290559528,0.05272518508833701,47.3376829624176,22.47127890586853,70.46068572998047,2816,316,2500,2500,0,7,368000.0
368,368999,21.868156111301772,36.771570115346364,0.052748048204304676,47.46363377571106,22.53520107269287,70.7102279663086,2818,316,2502,2502,0,7,369000.0
369,369999,21.869767408455623,36.76100542237422,0.05277643517297326,47.60989189147949,22.59860134124756,70.78521347045898,2853,318,2535,2535,0,7,370000.0
370,370999,21.87549755984835,36.75211570640326,0.0528181124250382,47.73936057090759,22.658620834350586,71.02470397949219,2869,319,2550,2550,0,7,371000.0
371,371999,21.869591611342425,36.74193557744459,0.05260989003407701,47.87687921524048,22.72126865386963,72.13872528076172,2935,320,2615,2615,0,7,372000.0
372,372999,21.85970485909137,36.74717772237197,0.05230934556950617,47.988285541534424,22.781987190246582,72.838134765625,2942,320,2622,2622,0,7,373000.0
373,373999,21.842370767520944,36.72189548769856,0.05238599722300041,48.107810974121094,22.84261202812195,73.1772575378418,2959,321,2638,2638,0,7,374000.0
374,374999,21.82397437973394,36.69029598129317,0.052451811821839445,48.244802951812744,22.90378761291504,73.49041748046875,2985,323,2662,2662,0,7,375000.0
375,375999,21.807661579476743,36.663881480641145,0.05250109207812659,48.37886357307434,22.967697381973267,73.87342071533203,3006,325,2681,2681,0,7,376000.0
376,376999,21.794501483893118,36.65103870393877,0.052417106072839004,48.49965000152588,23.0279757976532,74.22107696533203,3025,326,2699,2699,0,7,377000.0
377,377999,21.780712438591824,36.63510934034036,0.05242463208250925,48.612993240356445,23.088470697402954,74.63857650756836,3028,326,2702,2702,0,7,378000.0
378,378999,21.76337050743396,36.60430290336132,0.052467956106240554,48.74425196647644,23.154568195343018,74.8531265258789,3034,327,2707,2707,0,7,379000.0
379,379999,21.748644356135422,36.57748465221946,0.05250519960193578,48.874329805374146,23.214810132980347,75.14128494262695,3042,329,2713,2713,0,7,380000.0
380,380999,21.740196607425972,36.56686206436937,0.05248153394635657,48.99983310699463,23.27798628807068,75.47996139526367,3064,330,2734,2734,0,7,381000.0
381,381999,21.726661989696634,36.543442817423845,0.05251382154844608,49.128247022628784,23.341349840164185,75.78278732299805,3067,330,2737,2737,0,7,382000.0
382,382999,21.71992699700093,36.54670492653694,0.05248332656887378,49.273152351379395,23.404940366744995,75.97538375854492,3087,332,2755,2755,0,7,383000.0
383,383999,21.711633783608903,36.5252008013625,0.0524982474645419,49.40965008735657,23.46616220474243,76.33771514892578,3094,333,2761,2761,0,7,384000.0
384,384999,21.7022470523423,36.5026471133215,0.05250167181198384,49.53917860984802,23.525914907455444,76.69824600219727,3114,334,2780,2780,0,7,385000.0
385,385999,21.692134065858518,36.477125255587836,0.05250380191254578,49.662434101104736,23.58885145187378,77.07609939575195,3117,334,2783,2783,0,7,386000.0
386,386999,21.680038393519535,36.45316154639494,0.052564026027826505,49.79686379432678,23.654385089874268,77.39864730834961,3132,335,2797,2797,0,7,387000.0
387,387999,21.669130829095355,36.42776498048143,0.052550583978832055,49.93786573410034,23.717347383499146,77.63014602661133,3138,337,2801,2801,0,7,388000.0
388,388999,21.67196814269524,36.478271268409955,0.05154855764292521,50.06083965301514,23.781716346740723,78.99851989746094,3190,337,2853,2853,0,7,389000.0
389,389999,21.67121655493022,36.485824864326375,0.05142350933711881,50.4481098651886,23.84156632423401,79.63579559326172,3198,337,2861,2861,0,7,390000.0
390,390999,21.667777216373796,36.47874760218396,0.05143083927591696,50.56790232658386,23.902175664901733,80.09157180786133,3202,337,2865,2865,0,7,391000.0
391,391999,21.67544190491595,36.49185246247116,0.05149465478912063,50.705039501190186,23.965622425079346,80.36722946166992,3208,339,2869,2869,0,7,392000.0
392,392999,21.689365544663346,36.523571423711786,0.05170048277937511,50.818496227264404,24.02632212638855,80.77529525756836,3211,339,2872,2872,0,7,393000.0
393,393999,21.711737528708895,36.574309124613364,0.052281198697367914,50.94332218170166,24.09248185157776,81.15579986572266,3212,339,2873,2873,0,7,394000.0
394,394999,21.73988625254141,36.63336389898008,0.052904470637751055,51.055060625076294,24.151163339614868,81.55930709838867,3215,339,2876,2876,0,7,395000.0
395,395999,21.765933730528637,36.68681642792195,0.053533548333996483,51.20824384689331,24.210845708847046,81.72462463378906,3239,343,2896,2896,0,7,396000.0
396,396999,21.794505610726308,36.744460503804845,0.054404109397439004,51.346678733825684,24.273319005966187,81.96320343017578,3277,345,2932,2932,0,7,397000.0
397,397999,21.836468903972168,36.839475892977795,0.05503003070165835,51.480621099472046,24.333077430725098,82.26991271972656,3285,347,2938,2938,0,7,398000.0
398,398999,21.871091256570484,36.90420302920227,0.055791273559259724,51.59855604171753,24.394456386566162,82.67879486083984,3289,347,2942,2942,0,7,399000.0
399,399999,21.90768433395689,37.00191810135067,0.05658259080234751,51.736591815948486,24.4641592502594,82.94063568115234,3295,348,2947,2947,0,7,400000.0
400,400999,21.947263449553464,37.08060007469906,0.05686948662460267,51.860007524490356,24.523601055145264,83.348388671875,3305,349,2956,2956,0,7,401000.0
401,401999,21.98805991423074,37.15002521593592,0.057892924673630275,52.00141930580139,24.58344292640686,83.63158798217773,3314,351,2963,2963,0,7,402000.0
402,402999,22.030853227542273,37.24342875866703,0.05877479544450637,52.1173779964447,24.642640352249146,83.99641799926758,3316,351,2965,2965,0,7,403000.0
403,403999,22.07492252134816,37.31867970553274,0.059843414797226324,52.24875235557556,24.70667266845703,84.23904418945312,3317,351,2966,2966,0,7,404000.0
404,404999,22.120517268249234,37.405952451402236,0.060663185775245654,52.369595766067505,24.765607357025146,84.561279296875,3319,351,2968,2968,0,7,405000.0
405,405999,22.15436234606027,37.45024028866299,0.061388259607957685,52.50288653373718,24.829846382141113,84.76251602172852,3322,352,2970,2970,0,7,406000.0
406,406999,22.169128985888655,37.46972375552439,0.06163116840219396,52.640279054641724,24.897204637527466,85.72768020629883,3382,353,3029,3029,0,7,407000.0
407,407999,22.16732928686477,37.48330447696744,0.06131193462920692,52.76651096343994,24.95592212677002,86.47112274169922,3416,355,3061,3061,0,7,408000.0
408,408999,22.166137948293915,37.51193389191751,0.06110674937963945,52.89910697937012,25.02659296989441,86.89524459838867,3418,355,3063,3063,0,7,409000.0
409,409999,22.163559811450664,37.51662366191124,0.061030621733657475,53.014392614364624,25.0897798538208,87.29889678955078,3422,355,3067,3067,0,7,410000.0
410,410999,22.163266662079426,37.52046292216331,0.06096767440704065,53.138447761535645,25.150060653686523,87.53466415405273,3424,356,3068,3068,0,7,411000.0
411,411999,22.161842232697992,37.518592234544144,0.060822442712852975,53.24951767921448,25.20976185798645,87.93046188354492,3426,356,3070,3070,0,7,412000.0
412,412999,22.15959014525166,37.50995690350297,0.060828560181277025,53.3689284324646,25.274154663085938,88.22980117797852,3429,356,3073,3073,0,7,413000.0
413,413999,22.155534608773376,37.496170983596755,0.06086743598336164,53.48085856437683,25.33312225341797,88.59140396118164,3433,356,3077,3077,0,7,414000.0
414,414999,22.15512529108182,37.48401463079681,0.06079428198896675,53.62325978279114,25.392284154891968,88.70366668701172,3439,359,3080,3080,0,7,415000.0
415,415999,22.15548067559568,37.47581142456511,0.06073738004758089,53.747111797332764,25.45377779006958,89.15230941772461,3444,359,3085,3085,0,7,416000.0
416,416999,22.15410459434869,37.47045057764748,0.06060965992920997,53.86521768569946,25.51449942588806,89.4456672668457,3448,359,3089,3089,0,7,417000.0
417,417999,22.152492485495642,37.458160200380604,0.06052023709448362,53.98420786857605,25.57432460784912,89.7627067565918,3448,359,3089,3089,0,7,418000.0
418,418999,22.150528254640836,37.44245823929961,0.06046111233944507,54.10153651237488,25.63431668281555,90.06051635742188,3451,359,3092,3092,0,7,419000.0
419,419999,22.151373929117018,37.43401721181217,0.06042310865757272,54.235289573669434,25.695581674575806,90.16971206665039,3469,361,3108,3108,0,7,420000.0
420,420999,22.153111266086416,37.463772938619954,0.060231297022872554,54.37690830230713,25.755215406417847,90.40147018432617,3494,364,3130,3130,0,7,421000.0
421,421999,22.157272941981848,37.48146570656404,0.06006923159381683,54.52662897109985,25.818490266799927,90.73891830444336,3531,367,3164,3164,0,7,422000.0
422,422999,22.158432367669402,37.472632474985176,0.0600794557112897,54.65062212944031,25.879207372665405,91.15373992919922,3534,368,3166,3166,0,7,423000.0
423,423999,22.157489338041987,37.455388328301744,0.060018640779350596,54.79424571990967,25.941469192504883,91.37297058105469,3550,370,3180,3180,0,7,424000.0
424,424999,22.15763043810755,37.44293125252502,0.05991878519266047,54.93475699424744,26.00858783721924,91.76077651977539,3573,372,3201,3201,0,7,425000.0
425,425999,22.155928032367274,37.42771788570438,0.05991290250723702,55.0751166343689,26.06761622428894,91.9956283569336,3586,375,3211,3211,0,7,426000.0
426,426999,22.147839074782375,37.403527122805485,0.05983543251733903,55.213531255722046,26.126941204071045,92.2703742980957,3625,377,3248,3248,0,7,427000.0
427,427999,22.131686657342296,37.38039556944995,0.05982301316122385,55.35749340057373,26.190345287322998,93.67741775512695,3692,379,3313,3313,0,7,428000.0
428,428999,22.110593583069974,37.35049104997029,0.0599791158859142,55.486058950424194,26.25088906288147,94.01404571533203,3727,381,3346,3346,0,7,429000.0
429,429999,22.09262524368241,37.32722908358459,0.0600740543674525,55.638314962387085,26.3157057762146,94.25009155273438,3750,384,3366,3366,0,7,430000.0
430,430999,22.0718956927008,37.298590549285734,0.06017062816805996,55.783546924591064,26.378628253936768,94.49928283691406,3758,386,3372,3372,0,7,431000.0
431,431999,22.054575106789816,37.270273543973275,0.06021653544933825,55.90554904937744,26.43901228904724,94.96762466430664,3783,387,3396,3396,0,7,432000.0
432,432999,22.038453241299155,37.251483018412,0.06021400747590888,56.030972480773926,26.498266220092773,95.29968643188477,3795,388,3407,3407,0,7,433000.0
433,433999,22.0182289494821,37.22047917328092,0.06035103430149502,56.15260410308838,26.558435678482056,95.64380645751953,3815,389,3426,3426,0,7,434000.0
434,434999,22.000661881087286,37.191968597376984,0.06046199736215019,56.28929686546326,26.61946702003479,95.94464874267578,3835,390,3445,3445,0,7,435000.0
435,435999,21.98206160981987,37.162987258844396,0.06057972048232463,56.41352081298828,26.679474115371704,96.31900787353516,3859,391,3468,3468,0,7,436000.0
436,436999,21.964316778146483,37.13559340957017,0.06067976636805805,56.54889154434204,26.739346742630005,96.54568099975586,3863,392,3471,3471,0,7,437000.0
437,437999,21.947690738616593,37.11019518826004,0.06073127160032321,56.6739501953125,26.800260305404663,96.8558578491211,3873,393,3480,3480,0,7,438000.0
438,438999,21.93311790479899,37.08692331834654,0.060795083721168486,56.786537647247314,26.861175298690796,97.22751998901367,3877,393,3484,3484,0,7,439000.0
439,439999,21.917571327896617,37.06005923124462,0.06087576979498077,56.91647791862488,26.921547174453735,97.36568069458008,3881,395,3486,3486,0,7,440000.0
440,440999,21.902972885727106,37.03302805799566,0.06090055938426142,57.04727387428284,26.98198938369751,97.6948127746582,3890,397,3493,3493,0,7,441000.0
441,441999,21.88872308318931,37.00453312327681,0.06091444332848195,57.21652293205261,27.044378757476807,97.8337631225586,3922,402,3520,3520,0,7,442000.0
442,442999,21.876677608143165,36.980629343867406,0.060960394635032,57.35166954994202,27.106376886367798,98.13642501831055,3925,403,3522,3522,0,7,443000.0
443,443999,21.862331107234194,36.952964486215855,0.06100774993007363,57.50244927406311,27.168094873428345,98.33399200439453,3956,406,3550,3550,0,7,444000.0
444,444999,21.847308492777,36.92540251859698,0.06108323584450093,57.67559599876404,27.22942352294922,98.50793075561523,3991,411,3580,3580,0,7,445000.0
445,445999,21.834248722963604,36.90118944411674,0.06116493437217596,58.15183186531067,27.29217004776001,98.97553634643555,4017,413,3604,3604,0,7,446000.0
446,446999,21.819171527122496,36.873813443183835,0.06125489612952595,58.28907322883606,27.357680320739746,99.67458724975586,4046,414,3632,3632,0,7,447000.0
447,447999,21.80326134680373,36.86280120677186,0.0611172300775541,58.42591834068298,27.418745517730713,100.83578109741211,4103,416,3687,3687,0,7,448000.0
448,448999,21.78277836819634,36.83212381252931,0.06127590517813086,58.540990352630615,27.47993040084839,101.4464340209961,4106,416,3690,3690,0,7,449000.0
449,449999,21.764090825730392,36.81251739736421,0.06135933743732069,58.66728925704956,27.539971113204956,101.81215286254883,4128,417,3711,3711,0,7,450000.0
450,450999,21.746240537316737,36.787511326231815,0.061493336670547794,58.827998638153076,27.60083270072937,101.98439407348633,4175,421,3754,3754,0,7,451000.0
451,451999,21.72993623868637,36.760400863938614,0.061596484057146905,58.94149994850159,27.660948276519775,102.40301132202148,4177,421,3756,3756,0,7,452000.0
452,452999,21.713521726033267,36.73767777770614,0.061660836405396435,59.08264446258545,27.72186827659607,102.72903823852539,4203,423,3780,3780,0,7,453000.0
453,453999,21.695396443183906,36.710856949852506,0.061781309111861304,59.213475942611694,27.785499095916748,103.04122924804688,4225,424,3801,3801,0,7,454000.0
454,454999,21.67860582109424,36.68516857279987,0.06190957424927357,59.37706637382507,27.846536874771118,103.22940444946289,4269,428,3841,3841,0,7,455000.0
455,455999,21.661524112338313,36.65974474133322,0.06203617333989708,59.49824023246765,27.91164779663086,103.67746353149414,4274,428,3846,3846,0,7,456000.0
456,456999,21.64240103566764,36.63306638256116,0.06215699530043428,59.62665867805481,27.971513509750366,103.86893081665039,4277,429,3848,3848,0,7,457000.0
457,457999,21.627230797308407,36.617794604343736,0.06215895879965283,59.772998094558716,28.032076358795166,104.10477066040039,4303,432,3871,3871,0,7,458000.0
458,458999,21.610456272179025,36.58845965825046,0.06223583322319626,59.90811085700989,28.095550060272217,104.48015213012695,4328,433,3895,3895,0,7,459000.0
459,459999,21.595369074182692,36.567064901846166,0.062246121186048886,60.04831790924072,28.15573263168335,104.64788436889648,4350,435,3915,3915,0,7,460000.0
460,460999,21.5822232833704,36.54284275872077,0.062269203213796365,60.17501640319824,28.21675944328308,104.97879409790039,4357,436,3921,3921,0,7,461000.0
461,461999,21.569118426163822,36.5166766980516,0.06231739872872455,60.32384753227234,28.279313325881958,105.30609130859375,4377,438,3939,3939,0,7,462000.0
462,462999,21.556167059642217,36.49166918195745,0.062347224435396864,60.446510791778564,28.33809804916382,105.61675643920898,4379,438,3941,3941,0,7,463000.0
463,463999,21.545662600242963,36.46997123798272,0.06237232963413353,60.60113501548767,28.39849853515625,105.73179244995117,4385,441,3944,3944,0,7,464000.0
464,464999,21.534124375180433,36.44664340010643,0.06239173962491251,60.738585233688354,28.461888074874878,106.1407356262207,4393,442,3951,3951,0,7,465000.0
465,465999,21.525314494171624,36.42687506193964,0.06240759776536553,60.85985469818115,28.523132801055908,106.50499725341797,4397,443,3954,3954,0,7,466000.0
466,466999,21.510176597232498,36.399745585989315,0.06244111386408169,60.97082734107971,28.582767486572266,106.79689407348633,4397,443,3954,3954,0,7,467000.0
467,467999,21.494438138109153,36.3748220209472,0.062410182160175465,61.10294032096863,28.6501944065094,108.47427368164062,4464,443,4021,4021,0,7,468000.0
468,468999,21.479823380570654,36.363737056213694,0.06239438109131368,61.22865867614746,28.711345195770264,108.99444198608398,4469,444,4025,4025,0,7,469000.0
469,469999,21.46531312825531,36.341405083749194,0.0624240306994448,61.35051131248474,28.775027990341187,109.35006713867188,4471,444,4027,4027,0,7,470000.0
470,470999,21.45154639556415,36.317859398195125,0.062477462762594804,61.4880428314209,28.835810899734497,109.70241165161133,4478,446,4032,4032,0,7,471000.0
471,471999,21.442346583853297,36.310727961209174,0.062452550239435634,61.60635685920715,28.89621877670288,110.11170959472656,4501,447,4054,4054,0,7,472000.0
472,472999,21.430669696353522,36.289540373703254,0.06248447403643009,61.734307050704956,28.957740545272827,110.39646530151367,4524,448,4076,4076,0,7,473000.0
473,473999,21.418550363357422,36.27288864687689,0.06248773782228012,61.847524881362915,29.0198712348938,110.67102813720703,4524,448,4076,4076,0,7,474000.0
474,474999,21.41102960368976,36.27639901589796,0.06239075641401248,61.9717218875885,29.080190896987915,111.0536880493164,4532,449,4083,4083,0,7,475000.0
475,475999,21.403176722227393,36.2663527493979,0.062312218216537985,62.097907066345215,29.140648365020752,111.42582321166992,4538,450,4088,4088,0,7,476000.0
476,476999,21.395761155049254,36.258199682089405,0.06221571507465584,62.2292160987854,29.20136022567749,111.6390495300293,4541,451,4090,4090,0,7,477000.0
477,477999,21.386380430450235,36.237068302350096,0.06218006570155721,62.35308027267456,29.261965036392212,111.95616912841797,4548,452,4096,4096,0,7,478000.0
478,478999,21.376995690854404,36.21902838281236,0.06216190708906699,62.47753858566284,29.32260513305664,112.16109848022461,4568,453,4115,4115,0,7,479000.0
479,479999,21.36944607269752,36.20078276505546,0.06210074537304877,62.58584713935852,29.38258671760559,112.59128189086914,4575,453,4122,4122,0,7,480000.0
480,480999,21.35942568118463,36.17934414315613,0.06207872052665708,62.73529028892517,29.444418907165527,112.91130065917969,4617,456,4161,4161,0,7,481000.0
481,481999,21.35292838287254,36.16564561769292,0.062050275413688016,62.8708610534668,29.506035327911377,113.27749633789062,4627,457,4170,4170,0,7,482000.0
482,482999,21.350884110263678,36.153236659334475,0.061868974083328365,63.029627561569214,29.568779945373535,113.43297576904297,4648,460,4188,4188,0,7,483000.0
483,483999,21.348328562402983,36.141090212005516,0.061798148643457895,63.18097901344299,29.63007950782776,113.72169876098633,4674,463,4211,4211,0,7,484000.0
484,484999,21.346075827235058,36.12907917251624,0.06168523220242961,63.3064181804657,29.689101219177246,114.20306015014648,4702,464,4238,4238,0,7,485000.0
485,485999,21.342542415830536,36.115806768043306,0.061665560258229,63.455544233322144,29.7529718875885,114.41041946411133,4728,467,4261,4261,0,7,486000.0
486,486999,21.340190508641424,36.103609194694144,0.06152583605675854,63.608816385269165,29.83686065673828,114.84741592407227,4731,467,4264,4264,0,7,487000.0
487,487999,21.328921378174368,36.08548276711595,0.06146640308182261,63.727240324020386,29.899105548858643,116.2176742553711,4791,467,4324,4324,0,7,488000.0
488,488999,21.31892696383183,36.08309066996041,0.06133717373969105,63.835944175720215,29.960753917694092,116.96126937866211,4798,467,4331,4331,0,7,489000.0
489,489999,21.30648189994824,36.073839569434604,0.0612620128687863,63.95869064331055,30.02154302597046,117.42259979248047,4802,467,4335,4335,0,7,490000.0
490,490999,21.292463817127636,36.050443896735494,0.06132001055052427,64.07019114494324,30.081374883651733,117.89720153808594,4808,467,4341,4341,0,7,491000.0
491,491999,21.284459760428067,36.04789497509746,0.06129252916380845,64.21269059181213,30.144257307052612,118.13715362548828,4810,468,4342,4342,0,7,492000.0
492,492999,21.27636594277944,36.033111149098005,0.06128883047674527,64.33775687217712,30.20993971824646,118.50166320800781,4813,468,4345,4345,0,7,493000.0
493,493999,21.2682339195396,36.01758943933235,0.06130323712866792,64.45959758758545,30.26899528503418,118.76744842529297,4823,469,4354,4354,0,7,494000.0
494,494999,21.25999495657579,36.00469117272592,0.06127044293579631,64.60032153129578,30.331835746765137,119.12648391723633,4841,471,4370,4370,0,7,495000.0
495,495999,21.250381272155654,35.98409223128199,0.061267566184617483,64.78432106971741,30.395885467529297,119.2761116027832,4870,476,4394,4394,0,7,496000.0
496,496999,21.2432874497086,35.97132706284806,0.061240632088848446,64.90380430221558,30.459133863449097,119.75203704833984,4875,476,4399,4399,0,7,497000.0
497,497999,21.238625223708873,35.9617454170328,0.061165232087023735,65.03463649749756,30.522165060043335,120.03392791748047,4882,477,4405,4405,0,7,498000.0
498,498999,21.235051850470384,35.95191780318937,0.061177230729641874,65.19535422325134,30.58637285232544,120.29195022583008,4918,480,4438,4438,0,7,499000.0
499,499999,21.2363333042362,35.95752325036022,0.061177748670576015,65.31235384941101,30.649242639541626,120.76640319824219,4925,480,4445,4445,0,7,500000.0
500,500999,21.23490483432937,35.94975490009287,0.061216863675910616,65.46250009536743,30.713265895843506,120.94375228881836,4933,482,4451,4451,0,7,501000.0
501,501999,21.238817626979124,35.95547441637237,0.061307075427803226,65.60896921157837,30.777374744415283,121.3719711303711,4949,484,4465,4465,0,7,502000.0
502,502999,21.251725894363304,35.97610281682815,0.06134332497481032,65.74156212806702,30.8408203125,121.86934280395508,4958,485,4473,4473,0,7,503000.0
503,503999,21.260849411735922,36.013738445363586,0.06121074063942278,65.88078022003174,30.903592824935913,122.24466323852539,4983,486,4497,4497,0,7,504000.0
504,504999,21.26711879928438,36.020523132219715,0.06118092578503542,66.04645109176636,31.367415189743042,122.43019104003906,5029,489,4540,4540,0,7,505000.0
505,505999,21.27718543869452,36.03207373964865,0.061194240949088874,66.17325258255005,31.431631088256836,122.89879608154297,5036,489,4547,4547,0,7,506000.0
506,506999,21.282959664315115,36.06602755762491,0.06109717384259383,66.33559274673462,31.49642586708069,123.02181243896484,5054,492,4562,4562,0,7,507000.0
507,507999,21.28326137887398,36.06337800733446,0.06114277228303566,66.4579119682312,31.56122088432312,123.32633972167969,5055,492,4563,4563,0,7,508000.0
508,508999,21.27834922359811,36.076948680726844,0.06081745926610249,66.62944436073303,31.628425121307373,124.87427520751953,5127,495,4632,4632,0,7,509000.0
509,509999,21.27096303392826,36.068431791892436,0.06087161610906011,66.74737548828125,31.69214129447937,125.60655975341797,5135,495,4640,4640,0,7,510000.0
510,510999,21.262052611772475,36.06047597991493,0.060928751849976925,66.86938858032227,31.756200075149536,126.11516189575195,5141,495,4646,4646,0,7,511000.0
511,511999,21.253256399090805,36.04592671453441,0.0610505690911034,67.0349338054657,31.821038961410522,126.4136848449707,5154,498,4656,4656,0,7,512000.0
512,512999,21.24775588118756,36.04277032411615,0.061112579097861386,67.16862654685974,31.884568452835083,126.72759628295898,5171,499,4672,4672,0,7,513000.0
513,513999,21.240031420957493,36.02950391748313,0.061191457392692716,67.2853889465332,31.947741270065308,127.13277435302734,5173,499,4674,4674,0,7,514000.0
514,514999,21.232375137107052,36.01393964217954,0.061305842648922027,67.42930030822754,32.012054443359375,127.58887100219727,5206,501,4705,4705,0,7,515000.0
515,515999,21.222125489387167,35.9960792945897,0.06133943283817256,67.5856351852417,32.07715916633606,127.9482536315918,5214,503,4711,4711,0,7,516000.0
516,516999,21.215063454953526,35.98340867305546,0.061449996411165886,67.72870087623596,32.13792443275452,128.21796035766602,5244,505,4739,4739,0,7,517000.0
517,517999,21.209432694088985,35.97087178750504,0.06138894806089079,67.86730456352234,32.2015278339386,128.66765594482422,5271,506,4765,4765,0,7,518000.0
518,518999,21.201432238655766,35.95709794451834,0.061508740617928104,68.01309370994568,32.26524806022644,129.05282974243164,5285,508,4777,4777,0,7,519000.0
519,519999,21.19271725542935,35.938629888745474,0.06158666082760289,68.14657473564148,32.32720351219177,129.44701766967773,5290,508,4782,4782,0,7,520000.0
520,520999,21.188822823560482,35.98036385583055,0.06141397499946388,68.28457880020142,32.38746762275696,129.8068389892578,5299,510,4789,4789,0,7,521000.0
521,521999,21.185071025105753,35.969805678817224,0.06143484139666089,68.41402769088745,32.448190450668335,130.29891204833984,5306,511,4795,4795,0,7,522000.0
522,522999,21.179675258497536,35.970443421812746,0.061366311329132395,68.52941298484802,32.51057696342468,130.77016067504883,5311,511,4800,4800,0,7,523000.0
523,523999,21.170010523233476,35.951708637379355,0.06144467261537678,68.67692279815674,32.57165741920471,131.16527938842773,5320,512,4808,4808,0,7,524000.0
524,524999,21.161517280825947,35.93348600693653,0.06144084703643049,68.81421971321106,32.633835792541504,131.54925537109375,5326,513,4813,4813,0,7,525000.0
525,525999,21.159221539367838,35.962141102895366,0.06085692652220731,68.95088219642639,32.69780373573303,133.17150115966797,5391,514,4877,4877,0,7,526000.0
526,526999,21.14964145067524,35.943830125650855,0.06092663530380826,69.0776891708374,32.76653289794922,133.9033966064453,5402,514,4888,4888,0,7,527000.0
527,527999,21.141164763129552,35.92997973042529,0.060983074062832654,69.20977783203125,32.829771757125854,134.43793487548828,5429,515,4914,4914,0,7,528000.0
528,528999,21.1322117824695,35.91658004554649,0.06096186344345278,69.3664059638977,32.893394947052,134.79485702514648,5437,517,4920,4920,0,7,529000.0
529,529999,21.1270927399891,35.90620560030805,0.060928654785768366,69.48417544364929,32.9542601108551,135.22468948364258,5440,517,4923,4923,0,7,530000.0
530,530999,21.12289404627526,35.90691574324937,0.06081372348507541,69.59154462814331,33.01429605484009,135.54636001586914,5440,517,4923,4923,0,7,531000.0
531,531999,21.11542775014125,35.8962063781667,0.060802280555115384,69.71408152580261,33.074777126312256,136.04396438598633,5450,518,4932,4932,0,7,532000.0
532,532999,21.109240596240763,35.91788951116377,0.06062187377362549,69.87048363685608,33.136306285858154,136.43556213378906,5461,521,4940,4940,0,7,533000.0
533,533999,21.10299712005112,35.91331977858266,0.06058283198204717,69.9893205165863,33.19932723045349,136.77796173095703,5463,521,4942,4942,0,7,534000.0
534,534999,21.09618648559865,35.89779612062181,0.0605781503683277,70.10721373558044,33.26045107841492,137.27871704101562,5469,521,4948,4948,0,7,535000.0
535,535999,21.09208127342235,35.89467388330236,0.060497587860973034,70.23669719696045,33.32085084915161,137.66773986816406,5478,522,4956,4956,0,7,536000.0
536,536999,21.090452467620985,35.89576144498091,0.06046734548069388,70.35042905807495,33.380868911743164,137.97381973266602,5479,522,4957,4957,0,7,537000.0
537,537999,21.095184485847728,35.90290990375049,0.06037558382810537,70.50135540962219,33.44408893585205,138.33737564086914,5510,524,4986,4986,0,7,538000.0
538,538999,21.099595983121667,35.906403202228745,0.06039441874829532,70.63669013977051,33.50586557388306,138.70217895507812,5522,526,4996,4996,0,7,539000.0
539,539999,21.101309382212307,35.905993267093336,0.06036134702012197,70.75596117973328,33.56437373161316,139.02018356323242,5522,526,4996,4996,0,7,540000.0
540,540999,21.10587983614365,35.92841731087144,0.06031102074905503,70.88711285591125,33.6260621547699,139.44084548950195,5543,527,5016,5016,0,7,541000.0
541,541999,21.108969117629957,35.925339441733115,0.0601418175249272,71.02221345901489,33.69034481048584,139.8830909729004,5554,528,5026,5026,0,7,542000.0
542,542999,21.111474400808113,35.922128591394255,0.06008121001501843,71.16129446029663,33.75075888633728,140.1077995300293,5560,530,5030,5030,0,7,543000.0
543,543999,21.109596040428865,35.91020690276309,0.05999531745574205,71.30565214157104,33.81379580497742,140.34697341918945,5565,532,5033,5033,0,7,544000.0
544,544999,21.105755500946422,35.90324728730311,0.05981904673868654,71.43804049491882,33.87792253494263,141.97454833984375,5641,533,5108,5108,0,7,545000.0
545,545999,21.096092216414903,35.900288454429756,0.0597200244284678,71.54637408256531,33.937028646469116,142.73692321777344,5647,533,5114,5114,0,7,546000.0
546,546999,21.08406622959162,35.88136148815551,0.05972660170587485,71.66120600700378,34.000468730926514,143.19799041748047,5651,533,5118,5118,0,7,547000.0
547,547999,21.074340026489665,35.87668477212205,0.059657418472257806,71.77233695983887,34.059643030166626,143.6778221130371,5656,533,5123,5123,0,7,548000.0
548,548999,21.065630365891863,35.86169540451892,0.05954840751233881,71.91225242614746,34.123271226882935,143.98709106445312,5660,534,5126,5126,0,7,549000.0
549,549999,21.05761836043224,35.84732085544144,0.05949574081274278,72.05311632156372,34.18625283241272,144.32609176635742,5664,535,5129,5129,0,7,550000.0
550,550999,21.05153526397816,35.832016141812744,0.05947048356011986,72.16227054595947,34.245951890945435,144.68141555786133,5667,535,5132,5132,0,7,551000.0
551,551999,21.050086220614602,35.82612220596356,0.05936361714013394,72.27355670928955,34.30682945251465,145.18833923339844,5675,535,5140,5140,0,7,552000.0
552,552999,21.044700430062136,35.813105426576946,0.05930588753678323,72.42928647994995,34.3678662776947,145.38507843017578,5679,537,5142,5142,0,7,553000.0
553,553999,21.04177009416535,35.8016626884665,0.05932434607359771,72.53430700302124,34.42622089385986,145.8649444580078,5685,537,5148,5148,0,7,554000.0
554,554999,21.039431108004113,35.79502959502146,0.05931712778716558,72.65052890777588,34.48730516433716,146.28572845458984,5692,537,5155,5155,0,7,555000.0
555,555999,21.03658733954266,35.78557491105167,0.059314617773581046,72.80602931976318,34.54767155647278,146.57582473754883,5710,540,5170,5170,0,7,556000.0
556,556999,21.034550853466605,35.775729467057374,0.059283538368944066,72.92288064956665,34.60938835144043,147.11611557006836,5718,540,5178,5178,0,7,557000.0
557,557999,21.031240498870204,35.7643497785154,0.059274357765862984,73.05844116210938,34.66894483566284,147.36307525634766,5728,542,5186,5186,0,7,558000.0
558,558999,21.029599677402185,35.75624279904857,0.05933665780715003,73.21679592132568,34.72975039482117,147.6938591003418,5751,545,5206,5206,0,7,559000.0
559,559999,21.027380564545204,35.748424558457465,0.0593041789451032,73.35189962387085,34.79433584213257,148.18205642700195,5759,546,5213,5213,0,7,560000.0
560,560999,21.025947096837555,35.740529742787636,0.059282126714906624,73.48457169532776,34.853044271469116,148.5988998413086,5790,548,5242,5242,0,7,561000.0
561,561999,21.027584675345427,35.738664608627296,0.05928836317456554,73.63680648803711,34.91445446014404,148.8837661743164,5828,550,5278,5278,0,7,562000.0
562,562999,21.027337009847603,35.73196288146943,0.059335459104444155,73.74922275543213,34.97569823265076,149.46494674682617,5835,550,5285,5285,0,7,563000.0
563,563999,21.02785182316767,35.72597113224569,0.05935876552116137,73.86928105354309,35.039284467697144,149.8366470336914,5837,550,5287,5287,0,7,564000.0
564,564999,21.022132498359937,35.71451074743504,0.05930954985731007,74.00462484359741,35.102113485336304,150.82666015625,5880,551,5329,5329,0,7,565000.0
565,565999,21.010873668472986,35.70342972370576,0.05913407315852903,74.11882829666138,35.16316080093384,151.9287109375,5909,551,5358,5358,0,7,566000.0
566,566999,20.9987266189525,35.68690649418871,0.05915052595478254,74.7164978981018,35.22250461578369,152.5286636352539,5924,552,5372,5372,0,7,567000.0
567,567999,20.987504248898613,35.67417025226619,0.05923339165840891,74.83900332450867,35.28726029396057,153.06282424926758,5929,552,5377,5377,0,7,568000.0
568,568999,20.97402084648522,35.65313991487707,0.059316136357607796,74.98531031608582,35.34890151023865,153.3506202697754,5933,554,5379,5379,0,7,569000.0
569,569999,20.96470601290949,35.63780217856145,0.05929976176851881,75.10151720046997,35.412638425827026,153.80641555786133,5937,554,5383,5383,0,7,570000.0
570,570999,20.953134777420775,35.618091473199435,0.05929856725923677,75.22423481941223,35.47777843475342,154.17108535766602,5940,554,5386,5386,0,7,571000.0
571,571999,20.94245294343865,35.59983054187321,0.0593624612890824,75.33311295509338,35.536996364593506,154.70090866088867,5948,554,5394,5394,0,7,572000.0
572,572999,20.93008675007323,35.58019896161838,0.05940003377926584,75.49094605445862,35.60299611091614,154.93562698364258,5952,556,5396,5396,0,7,573000.0
573,573999,20.92107976948914,35.56322416441487,0.059425628689873,75.60908102989197,35.66482210159302,155.48602676391602,5958,556,5402,5402,0,7,574000.0
574,574999,20.910240578361037,35.54342386374558,0.059448393280011835,75.74207782745361,35.72585153579712,155.89633178710938,5967,557,5410,5410,0,7,575000.0
575,575999,20.901963140474255,35.56035727366945,0.05935048056443937,75.8710515499115,35.786012172698975,156.1927833557129,5991,558,5433,5433,0,7,576000.0
576,576999,20.890986125801877,35.54000579211743,0.05935563034954827,76.00370192527771,35.84828281402588,156.63660049438477,6022,559,5463,5463,0,7,577000.0
577,577999,20.882853201382083,35.52362804912635,0.059353198821466724,76.15490388870239,35.90936517715454,156.9645004272461,6053,561,5492,5492,0,7,578000.0
578,578999,20.87344876236088,35.50577730391838,0.05935689222404761,76.28809571266174,35.97243309020996,157.26760864257812,6079,562,5517,5517,0,7,579000.0
579,579999,20.866143293334595,35.49169107213989,0.0593491048255016,76.43943762779236,36.033169746398926,157.6546859741211,6089,564,5525,5525,0,7,580000.0
580,580999,20.86093826989839,35.497368176051474,0.059252061724325844,76.57860159873962,36.09411883354187,158.10660934448242,6100,565,5535,5535,0,7,581000.0
581,581999,20.85197209190994,35.478929920388076,0.059316530511997256,76.72885227203369,36.15605020523071,158.39609909057617,6109,567,5542,5542,0,7,582000.0
582,582999,20.84458111863099,35.462639678763324,0.05935439575243284,76.84201145172119,36.217934370040894,158.77668380737305,6111,567,5544,5544,0,7,583000.0
583,583999,20.83504002832911,35.44530123037448,0.05938554235949345,76.98083972930908,36.28007125854492,159.09279251098633,6115,568,5547,5547,0,7,584000.0
584,584999,20.828201075524944,35.44777552297557,0.059295411331306336,77.12155365943909,36.34542417526245,160.2959327697754,6172,569,5603,5603,0,7,585000.0
585,585999,20.81718731072859,35.4491212286455,0.05812427129746511,77.24891185760498,36.409013509750366,161.20172119140625,6210,570,5640,5640,0,7,586000.0
586,586999,20.806738424313195,35.44589185609227,0.058044870066537135,77.36498546600342,36.47077751159668,161.94842147827148,6216,570,5646,5646,0,7,587000.0
587,587999,20.797007522310086,35.432498436459525,0.05795449042224676,77.47639679908752,36.531081199645996,162.48067092895508,6221,570,5651,5651,0,7,588000.0
588,588999,20.78755273760334,35.41833552297562,0.058010371278440775,77.62993741035461,36.59171962738037,162.71973419189453,6227,572,5655,5655,0,7,589000.0
589,589999,20.779823403955437,35.405680164312656,0.057995598636009116,77.74835991859436,36.6546311378479,163.14434814453125,6231,572,5659,5659,0,7,590000.0
590,590999,20.773320927814638,35.39900068095163,0.0579299584866777,77.89420485496521,36.71530532836914,163.4866943359375,6273,574,5699,5699,0,7,591000.0
591,591999,20.766123657690553,35.38346600836894,0.057925204464551405,78.00602507591248,36.77594566345215,164.0125846862793,6281,574,5707,5707,0,7,592000.0
592,592999,20.758994754468905,35.36981573324896,0.057929990496263684,78.17095518112183,36.8398072719574,164.1968002319336,6288,577,5711,5711,0,7,593000.0
593,593999,20.752032974954062,35.35707814774044,0.057924389505922935,78.29525542259216,36.89995884895325,164.66827011108398,6298,578,5720,5720,0,7,594000.0
594,594999,20.748954920761612,35.35525260814972,0.05789415904043549,78.44751763343811,36.961477756500244,165.0694923400879,6309,580,5729,5729,0,7,595000.0
595,595999,20.744628395868084,35.35055369568068,0.057832681560480714,78.57250118255615,37.020596981048584,165.33235549926758,6311,581,5730,5730,0,7,596000.0
596,596999,20.741112862446148,35.34047032374882,0.05780033733119294,78.68774771690369,37.08511400222778,165.8816261291504,6320,581,5739,5739,0,7,597000.0
597,597999,20.73704174345065,35.3302431828635,0.05780998707766116,78.81314730644226,37.14857292175293,166.30282974243164,6326,581,5745,5745,0,7,598000.0
598,598999,20.733384436882275,35.31907721509957,0.05778545560800019,78.93173480033875,37.21109127998352,166.60435104370117,6326,581,5745,5745,0,7,599000.0
599,599999,20.73255714351854,35.31172395139851,0.05778397738854313,79.09502863883972,37.27620220184326,166.96582794189453,6336,583,5753,5753,0,7,600000.0
600,600999,20.730473818733387,35.302520277053006,0.05776100363560743,79.23691153526306,37.34714412689209,167.41776657104492,6345,584,5761,5761,0,7,601000.0
601,601999,20.728543343126415,35.29202052745888,0.05776677322289725,79.39107370376587,37.41166162490845,167.77272415161133,6360,586,5774,5774,0,7,602000.0
602,602999,20.72548614243401,35.28050992191467,0.0576895370016286,79.53338098526001,37.47474002838135,168.09035110473633,6392,587,5805,5805,0,7,603000.0
603,603999,20.72176806898446,35.27614553997225,0.0576008739848074,79.71323823928833,37.53854417800903,168.42248153686523,6428,590,5838,5838,0,7,604000.0
604,604999,20.717807671244337,35.26511194737676,0.05743648749907304,79.85777568817139,37.603806495666504,169.856201171875,6470,591,5879,5879,0,7,605000.0
605,605999,20.714098065282784,35.25431918912705,0.057198461936041944,79.97971630096436,37.66826009750366,170.7057113647461,6481,591,5890,5890,0,7,606000.0
606,606999,20.71012175907965,35.246731756715135,0.05683488491072308,80.130122423172,37.732537508010864,171.23131561279297,6514,593,5921,5921,0,7,607000.0
607,607999,20.704982505516362,35.23639582899938,0.05666664499327989,80.24697279930115,37.79567360877991,171.80227279663086,6519,593,5926,5926,0,7,608000.0
608,608999,20.700932106244228,35.22547008395741,0.05659182612374947,80.3834125995636,37.85909414291382,172.1931381225586,6523,594,5929,5929,0,7,609000.0
609,609999,20.697882876087554,35.21521576842469,0.056477957839000004,80.50147032737732,37.92291331291199,172.6082878112793,6527,594,5933,5933,0,7,610000.0
610,610999,20.695059416653343,35.21192721083584,0.056392725473725536,80.6208438873291,37.986674785614014,173.00658798217773,6530,594,5936,5936,0,7,611000.0
611,611999,20.691116528593955,35.2000733578135,0.056284445103084946,80.74014902114868,38.050007581710815,173.54341888427734,6538,594,5944,5944,0,7,612000.0
612,612999,20.68898219758348,35.193093645266224,0.05618971324446165,80.88388419151306,38.113850116729736,173.95621871948242,6568,595,5973,5973,0,7,613000.0
613,613999,20.685266152462503,35.18207259859956,0.056116632992637916,81.00039887428284,38.17725348472595,174.26006698608398,6569,595,5974,5974,0,7,614000.0
614,614999,20.68569972659439,35.17848675182391,0.05602592110239857,81.11949300765991,38.241697549819946,174.72815704345703,6576,595,5981,5981,0,7,615000.0
615,615999,20.687544836023022,35.17572437538317,0.05603216939925537,81.24556994438171,38.304784536361694,175.09643173217773,6582,595,5987,5987,0,7,616000.0
616,616999,20.693935220874405,35.18198937794774,0.056041683032898026,81.37276315689087,38.373207092285156,175.48209762573242,6585,595,5990,5990,0,7,617000.0
617,617999,20.707298753922974,35.226269081692955,0.05607957986143397,81.51780080795288,38.4368257522583,175.94804000854492,6593,596,5997,5997,0,7,618000.0
618,618999,20.719575242722627,35.24296999779511,0.05617998017478831,81.63616514205933,38.50126934051514,176.37258911132812,6599,596,6003,6003,0,7,619000.0
619,619999,20.73460615918063,35.264486284684324,0.05639726054354832,81.78778147697449,38.563992738723755,176.6113624572754,6601,597,6004,6004,0,7,620000.0
620,620999,20.74892724840445,35.280463065600635,0.056529639067502746,81.92870807647705,38.62837219238281,177.05140686035156,6620,598,6022,6022,0,7,621000.0
621,621999,20.758756652167182,35.28703610949954,0.056651124665782815,82.04537630081177,38.691553354263306,177.48830032348633,6627,598,6029,6029,0,7,622000.0
622,622999,20.7706961596931,35.298277157832196,0.05689791690516777,82.16160893440247,38.75539040565491,177.84649658203125,6631,598,6033,6033,0,7,623000.0
623,623999,20.778162478451943,35.29693148253973,0.057038394260446545,82.31571555137634,38.81870937347412,178.10586166381836,6662,599,6063,6063,0,7,624000.0
624,624999,20.77461845909739,35.28746871748652,0.056982690252551316,82.44833445549011,38.88345694541931,179.7192726135254,6682,599,6083,6083,0,7,625000.0
625,625999,20.769164560693838,35.277202881079724,0.056935698606098484,82.56357550621033,38.94710373878479,180.44863891601562,6690,599,6091,6091,0,7,626000.0
626,626999,20.765051437354657,35.27308029833286,0.056858542055441275,82.70165657997131,39.01045322418213,180.86616134643555,6695,600,6095,6095,0,7,627000.0
627,627999,20.760450074642147,35.264466350541376,0.05678741810290577,82.87701272964478,39.073890209198,181.3069953918457,6732,603,6129,6129,0,7,628000.0
628,628999,20.757184730970078,35.262788207368004,0.05673138481172524,82.99785351753235,39.1364643573761,181.7674674987793,6737,603,6134,6134,0,7,629000.0
629,629999,20.75327255703626,35.25149993655077,0.056713199258510816,83.11846804618835,39.19978880882263,182.13679885864258,6740,603,6137,6137,0,7,630000.0
630,630999,20.749162868855187,35.241727802024435,0.05669797895870976,83.2375066280365,39.2623245716095,182.41936492919922,6741,603,6138,6138,0,7,631000.0
631,631999,20.74875879519204,35.263900036669526,0.05656548005708717,83.38562750816345,39.326329708099365,182.91017532348633,6753,604,6149,6149,0,7,632000.0
632,632999,20.74785174741079,35.25803596352192,0.056485790730538055,83.54037618637085,39.39012122154236,183.3233184814453,6782,606,6176,6176,0,7,633000.0
633,633999,20.746899806625635,35.25621872845256,0.056412304451278206,83.65758085250854,39.4524405002594,183.59041595458984,6783,606,6177,6177,0,7,634000.0
634,634999,20.747101787134536,35.249516590617446,0.05637410550919908,83.78058409690857,39.51576614379883,184.0127716064453,6790,606,6184,6184,0,7,635000.0
635,635999,20.74829794233967,35.24602007854775,0.0563590815085685,83.9315550327301,39.58035230636597,184.35651779174805,6799,607,6192,6192,0,7,636000.0
636,636999,20.752551579217492,35.26904825163549,0.056311893525783474,84.06307601928711,39.643192768096924,184.6766014099121,6804,608,6196,6196,0,7,637000.0
637,637999,20.75446578518109,35.26579897223619,0.05624559801402684,84.20408606529236,39.70699691772461,185.05867385864258,6819,609,6210,6210,0,7,638000.0
638,638999,20.76024416773603,35.26743328588187,0.05624481599657161,84.32952332496643,39.770283222198486,185.42357635498047,6824,609,6215,6215,0,7,639000.0
639,639999,20.767552166112708,35.275309733561464,0.056283777587051165,84.471031665802,39.83329248428345,185.67521286010742,6824,609,6215,6215,0,7,640000.0
640,640999,20.774147328502462,35.27972080259684,0.05626886473976067,84.59789681434631,39.896546602249146,186.13071823120117,6831,609,6222,6222,0,7,641000.0
641,641999,20.779138618712985,35.28001707608407,0.05627798672238915,84.72690153121948,39.960193157196045,186.4983367919922,6841,610,6231,6231,0,7,642000.0
642,642999,20.7874807384861,35.2856868870064,0.05633366853757038,84.84945774078369,40.02236747741699,186.73916244506836,6841,610,6231,6231,0,7,643000.0
643,643999,20.79251958780022,35.28293044257082,0.05630891046440667,84.99193572998047,40.08586096763611,187.0435905456543,6876,611,6265,6265,0,7,644000.0
644,644999,20.79135088893604,35.276507586203245,0.056228463671935125,85.12241125106812,40.150612115859985,188.4144287109375,6893,611,6282,6282,0,7,645000.0
645,645999,20.7879699179038,35.284234565157064,0.056138659202600194,85.25229930877686,40.214385986328125,189.29864501953125,6901,611,6290,6290,0,7,646000.0
646,646999,20.78421620573969,35.27686174793064,0.05613896009154107,85.37136697769165,40.277979612350464,189.86873245239258,6907,611,6296,6296,0,7,647000.0
647,647999,20.78040099772346,35.27405013949098,0.05608093791525104,85.49349904060364,40.34045338630676,190.34142303466797,6909,611,6298,6298,0,7,648000.0
648,648999,20.775188012044378,35.26142699185106,0.05610395175661542,86.18555855751038,40.40402817726135,190.81389617919922,6915,611,6304,6304,0,7,649000.0
649,649999,20.77271820941454,35.25340229459564,0.056060065124163505,86.31707859039307,40.46807670593262,191.21317291259766,6917,611,6306,6306,0,7,650000.0
650,650999,20.770688386527777,35.24525922033482,0.05604511450455507,86.43602800369263,40.532129526138306,191.70667266845703,6923,611,6312,6312,0,7,651000.0
651,651999,20.769033584769453,35.24192809475506,0.05596642620920478,86.57417964935303,40.59508466720581,192.0554428100586,6923,611,6312,6312,0,7,652000.0
652,652999,20.768069313568887,35.24523599111619,0.05597500595897287,86.70423793792725,40.65847587585449,192.49693298339844,6926,611,6315,6315,0,7,653000.0
653,653999,20.77074224774203,35.24550282311889,0.05595500559239219,86.82146501541138,40.72287654876709,192.93851852416992,6931,611,6320,6320,0,7,654000.0
654,654999,20.773808060653554,35.24761121045115,0.05589244320459619,86.93853712081909,40.78536057472229,193.2168960571289,6932,611,6321,6321,0,7,655000.0
655,655999,20.77513135308248,35.24321415006081,0.05583657613568238,87.06855773925781,40.84838604927063,193.67739868164062,6937,611,6326,6326,0,7,656000.0
656,656999,20.779533313615488,35.247416554634135,0.0557907075374634,87.21357274055481,40.9112012386322,194.11455917358398,6971,612,6359,6359,0,7,657000.0
657,657999,20.787021935051033,35.258845516707076,0.055797953160955704,87.3340802192688,40.97355055809021,194.54003143310547,6974,612,6362,6362,0,7,658000.0
658,658999,20.797357581907587,35.28811258818724,0.055689795885441096,87.49198126792908,41.03707027435303,194.93003463745117,7001,614,6387,6387,0,7,659000.0
659,659999,20.802431665517794,35.30672994489799,0.055604118246779244,87.62470173835754,41.10050988197327,195.48626708984375,7005,614,6391,6391,0,7,660000.0
660,660999,20.804909135774352,35.304692930717955,0.055523063840057785,87.78891658782959,41.16589641571045,195.86341857910156,7019,616,6403,6403,0,7,661000.0
661,661999,20.80419840146985,35.30870653590368,0.055289019907383,87.92965173721313,41.230157136917114,197.29248046875,7038,617,6421,6421,0,7,662000.0
662,662999,20.806036689778658,35.31868690507205,0.05500146135079609,88.07428932189941,41.29596948623657,198.1951904296875,7057,618,6439,6439,0,7,663000.0
663,663999,20.80526473628765,35.32306893451157,0.054742156055824664,88.19049644470215,41.35936403274536,198.8418197631836,7060,618,6442,6442,0,7,664000.0
664,664999,20.80520440450715,35.320871233874826,0.05452189023939735,88.33620476722717,41.423895835876465,199.35102081298828,7076,619,6457,6457,0,7,665000.0
665,665999,20.8038670515293,35.31328857058851,0.05437250008978811,88.455979347229,41.48863434791565,199.79450607299805,7078,619,6459,6459,0,7,666000.0
666,666999,20.803231436953258,35.30881245965777,0.05420741382717542,88.57638001441956,41.552226066589355,200.29270553588867,7078,619,6459,6459,0,7,667000.0
667,667999,20.804702969122175,35.31016733365117,0.05398667812798297,88.69387817382812,41.61636471748352,200.88029098510742,7081,619,6462,6462,0,7,668000.0
668,668999,20.805008922117853,35.305280252531475,0.053841013625849476,88.82168292999268,41.680023431777954,201.4154052734375,7082,619,6463,6463,0,7,669000.0
669,669999,20.80632013403875,35.31067115968687,0.05366400833561957,88.94028854370117,41.74269652366638,201.77566146850586,7082,619,6463,6463,0,7,670000.0
670,670999,20.809815375555083,35.3289669059049,0.05341614734515243,89.07559466362,41.80622148513794,202.2115821838379,7087,620,6467,6467,0,7,671000.0
671,671999,20.811752057652036,35.32564437512292,0.053215827468457544,89.2154061794281,41.869566679000854,202.5818748474121,7097,621,6476,6476,0,7,672000.0
672,672999,20.814797558417908,35.32355257095911,0.052990155781238335,89.35297679901123,41.93419790267944,202.91680908203125,7123,622,6501,6501,0,7,673000.0
673,673999,20.815476993986398,35.31802637263203,0.052831944458913926,89.48857975006104,41.99730825424194,203.38082885742188,7127,623,6504,6504,0,7,674000.0
674,674999,20.81957479374154,35.341199666171406,0.052646745157245656,89.60926151275635,42.06185555458069,203.8048553466797,7129,623,6506,6506,0,7,675000.0
675,675999,20.823445736542674,35.341318806809355,0.05248978078887179,89.73146510124207,42.12531399726868,204.0991973876953,7129,623,6506,6506,0,7,676000.0
676,676999,20.828173891481736,35.3379971977397,0.05232817674078605,89.87872886657715,42.18865084648132,204.6120719909668,7163,624,6539,6539,0,7,677000.0
677,677999,20.836194026241753,35.35196794759867,0.052038022089094804,90.01036930084229,42.252117395401,205.03311157226562,7195,625,6570,6570,0,7,678000.0
678,678999,20.83973101900089,35.347491235625284,0.05191205625418449,90.13274550437927,42.31549859046936,205.3646240234375,7197,625,6572,6572,0,7,679000.0
679,679999,20.843257041812905,35.34259062208208,0.05176921964625525,90.274667263031,42.37820816040039,205.64252090454102,7227,626,6601,6601,0,7,680000.0
680,680999,20.845373206016397,35.34217596984883,0.051539398273680814,90.40185499191284,42.44249153137207,207.08277893066406,7241,626,6615,6615,0,7,681000.0
681,681999,20.845878821487883,35.34360508386025,0.05131828662103588,90.5385491847992,42.50630044937134,207.75341033935547,7264,627,6637,6637,0,7,682000.0
682,682999,20.84618936164909,35.34154947417129,0.05106816285431992,90.69031000137329,42.57072329521179,208.27715682983398,7301,629,6672,6672,0,7,683000.0
683,683999,20.847232809527245,35.33885538453734,0.05090754690240884,90.82562637329102,42.63579607009888,208.8752326965332,7305,630,6675,6675,0,7,684000.0
684,684999,20.8479920752293,35.33667240495556,0.05079220223447578,90.95741271972656,42.69898748397827,209.2973861694336,7305,630,6675,6675,0,7,685000.0
685,685999,20.850111485411457,35.3338630427088,0.050706144111452245,91.07609510421753,42.762646436691284,209.7108917236328,7308,630,6678,6678,0,7,686000.0
686,686999,20.84995412951663,35.32562883164254,0.050598536604494426,91.23150444030762,42.826852798461914,210.05908203125,7324,632,6692,6692,0,7,687000.0
687,687999,20.854397027185446,35.3321169398692,0.05048013897123882,91.34817552566528,42.88970065116882,210.63977432250977,7326,632,6694,6694,0,7,688000.0
688,688999,20.85960999131766,35.336916435732824,0.05042640611022553,91.47642683982849,42.954246044158936,211.00502014160156,7326,632,6694,6694,0,7,689000.0
689,689999,20.86181619457045,35.331448796798014,0.05035611436081544,91.59038376808167,43.01718735694885,211.52859497070312,7327,632,6695,6695,0,7,690000.0
690,690999,20.868449897533658,35.33404369838196,0.05030215349006806,91.70910882949829,43.080119371414185,212.01100158691406,7330,632,6698,6698,0,7,691000.0
691,691999,20.873866155574035,35.334970834305565,0.05017869516925233,91.8458948135376,43.14331865310669,212.26310348510742,7345,633,6712,6712,0,7,692000.0
692,692999,20.880557926964027,35.33556482898328,0.05005947340811412,91.96373581886292,43.207382678985596,212.8491439819336,7350,633,6717,6717,0,7,693000.0
693,693999,20.88744590588481,35.3370911700518,0.049983477312711244,92.1054744720459,43.27185010910034,213.37875747680664,7383,634,6749,6749,0,7,694000.0
694,694999,20.894892418314285,35.3410130259332,0.04994942626044596,92.22895431518555,43.334794998168945,213.78656387329102,7384,634,6750,6750,0,7,695000.0
695,695999,20.90492620781078,35.3461841126967,0.0499603958136009,92.35429906845093,43.398926973342896,214.26030349731445,7385,634,6751,6751,0,7,696000.0
696,696999,20.914285980868055,35.350413719718574,0.04995804086294986,92.510995388031,43.463417291641235,214.8303337097168,7423,635,6788,6788,0,7,697000.0
697,697999,20.918858559137885,35.347839956744146,0.049954456885042076,92.6251573562622,43.527159452438354,215.27974319458008,7423,635,6788,6788,0,7,698000.0
698,698999,20.92546449273553,35.3468964796518,0.04991219075856912,92.74119257926941,43.59094595909119,215.6268424987793,7424,635,6789,6789,0,7,699000.0
699,699999,20.930378694453793,35.34376031594252,0.04981000148460024,92.87975692749023,43.654335498809814,216.07699966430664,7430,636,6794,6794,0,7,700000.0
700,700999,20.930130305045456,35.3393175372909,0.04971387591448195,93.01598787307739,43.71885323524475,217.49499130249023,7436,636,6800,6800,0,7,701000.0
701,701999,20.92240845140635,35.32966449671689,0.04973676283064099,93.13470506668091,43.782280683517456,218.37348175048828,7440,636,6804,6804,0,7,702000.0
702,702999,20.91598903022253,35.32321125964869,0.04964939794113443,93.25537419319153,43.846643686294556,219.03541946411133,7443,636,6807,6807,0,7,703000.0
703,703999,20.90890006048696,35.319757691985586,0.04963900623748452,93.385582447052,43.91020131111145,219.6801986694336,7446,636,6810,6810,0,7,704000.0
704,704999,20.909825161000715,35.362235326726456,0.04948230875196813,93.5225100517273,43.97400164604187,220.0975227355957,7463,637,6826,6826,0,7,705000.0
705,705999,20.91214530420075,35.373697576795514,0.049538461095187,93.64563298225403,44.037617921829224,220.55691528320312,7465,637,6828,6828,0,7,706000.0
706,706999,20.920441582932142,35.402298167270935,0.04954251129401088,93.76210570335388,44.10101675987244,220.99750137329102,7465,637,6828,6828,0,7,707000.0
707,707999,20.93190027687544,35.44146651646609,0.049537895255281295,93.8994791507721,44.165170431137085,221.5274543762207,7469,638,6831,6831,0,7,708000.0
708,708999,20.942961257464948,35.47677371671992,0.04956257366094163,94.03481864929199,44.22863268852234,222.04550170898438,7470,638,6832,6832,0,7,709000.0
709,709999,20.95428645164721,35.52013154775813,0.049463989625381455,94.14990520477295,44.292547941207886,222.3976593017578,7470,638,6832,6832,0,7,710000.0
710,710999,20.968701198062828,35.56683678345155,0.049505323193321904,94.2687349319458,44.35631775856018,222.8887481689453,7471,638,6833,6833,0,7,711000.0
711,711999,20.980421350365845,35.60242395440006,0.04952918548219287,94.40986943244934,44.421178102493286,223.36774063110352,7479,639,6840,6840,0,7,712000.0
712,712999,20.992695412499547,35.626489789135846,0.04964433203804164,94.52558302879333,44.48493242263794,223.77266693115234,7481,639,6842,6842,0,7,713000.0
713,713999,21.00478877004427,35.65405266872839,0.049642937837484635,94.65633344650269,44.54925847053528,224.31989288330078,7483,639,6844,6844,0,7,714000.0
714,714999,21.015850589388968,35.67337330620777,0.04973202477145067,94.80652952194214,44.61317563056946,224.72100448608398,7498,640,6858,6858,0,7,715000.0
715,715999,21.02915186367325,35.69751581341789,0.04975224649677812,94.92880821228027,44.67680644989014,225.28546524047852,7503,640,6863,6863,0,7,716000.0
716,716999,21.043173470551938,35.7194695790531,0.04974771333911743,95.0932400226593,44.74101662635803,225.5622100830078,7511,642,6869,6869,0,7,717000.0
717,717999,21.056008626526417,35.738167102025066,0.0497448566444354,95.20970106124878,44.80410861968994,226.0153465270996,7511,642,6869,6869,0,7,718000.0
718,718999,21.068261988533287,35.7518339593193,0.04975290134674748,95.32840418815613,44.867270708084106,226.4683837890625,7512,642,6870,6870,0,7,719000.0
719,719999,21.068281930420188,35.74904385719815,0.04968291695586846,95.51596522331238,44.93124175071716,227.79877471923828,7556,645,6911,6911,0,7,720000.0
720,720999,21.06663758598811,35.75780968506899,0.04960277172672667,95.66239523887634,44.99568581581116,228.6862449645996,7560,646,6914,6914,0,7,721000.0
721,721999,21.064061987493364,35.75404674715444,0.049503328386214074,95.78883075714111,45.05959892272949,229.36423873901367,7562,646,6916,6916,0,7,722000.0
722,722999,21.062586184422837,35.754644125964006,0.04944652078932532,95.91157150268555,45.12367486953735,230.05702590942383,7565,646,6919,6919,0,7,723000.0
723,723999,21.062043139867363,35.753080978342915,0.049386305912969775,96.03628134727478,45.18723487854004,230.54536056518555,7566,646,6920,6920,0,7,724000.0
724,724999,21.059394308624782,35.74827118972807,0.04934042904446101,96.15588879585266,45.25041651725769,230.9521942138672,7568,646,6922,6922,0,7,725000.0
725,725999,21.058210830260467,35.74330409701907,0.04929078676076437,96.29644703865051,45.31399655342102,231.41133880615234,7599,647,6952,6952,0,7,726000.0
726,726999,21.05658679463819,35.736109356369255,0.04925377974591538,96.41628432273865,45.37838935852051,232.02425384521484,7599,647,6952,6952,0,7,727000.0
727,727999,21.053887316153926,35.728296817311715,0.049194611357873286,96.59770703315735,45.44254922866821,232.50050354003906,7675,650,7025,7025,0,7,728000.0
728,728999,21.052028493304373,35.7233984153045,0.04915198156969813,96.72264575958252,45.50652837753296,232.91575622558594,7675,650,7025,7025,0,7,729000.0
729,729999,21.04973664904311,35.717396999755614,0.049101433761576274,96.84694623947144,45.57050824165344,233.49906539916992,7675,650,7025,7025,0,7,730000.0
730,730999,21.04648455824651,35.70796346120237,0.04905157292930673,96.96396398544312,45.634074449539185,233.98613739013672,7677,650,7027,7027,0,7,731000.0
731,731999,21.048031644742217,35.729060455365094,0.04887803605869401,97.077951669693,45.69812321662903,234.37142944335938,7679,650,7029,7029,0,7,732000.0
732,732999,21.045776775364725,35.721991268522075,0.048821652064329646,97.19969964027405,45.76245903968811,234.9274559020996,7679,650,7029,7029,0,7,733000.0
733,733999,21.046123769687945,35.71484519657469,0.048727232864944736,97.33311080932617,45.826393365859985,235.3818244934082,7679,650,7029,7029,0,7,734000.0
734,734999,21.04494250039908,35.70552673265115,0.048650038564774234,97.44926762580872,45.88922381401062,235.67383193969727,7679,650,7029,7029,0,7,735000.0
735,735999,21.047740892075158,35.70278855956722,0.048565131242933046,97.60212469100952,45.95340037345886,236.24521255493164,7713,651,7062,7062,0,7,736000.0
736,736999,21.04870740511245,35.697445863224914,0.04847519309901105,97.72361874580383,46.01697134971619,236.6936912536621,7713,651,7062,7062,0,7,737000.0
737,737999,21.04793530551575,35.689605908664035,0.04841571218630025,97.84272408485413,46.0794403553009,237.0373649597168,7713,651,7062,7062,0,7,738000.0
738,738999,21.047470982445503,35.68229275484667,0.048265324227916295,97.95566082000732,46.14135146141052,237.33142471313477,7713,651,7062,7062,0,7,739000.0
739,739999,21.046530102610078,35.70635671283471,0.04807385653717311,98.0812520980835,46.20500349998474,238.7018928527832,7716,651,7065,7065,0,7,740000.0
740,740999,21.040367656908863,35.73531639542987,0.04803024447938864,98.90893411636353,46.26919507980347,239.32504272460938,7726,653,7073,7073,0,7,741000.0
741,741999,21.033449354716417,35.7400619677373,0.04800512146426883,99.04098010063171,46.33439803123474,239.78229522705078,7726,653,7073,7073,0,7,742000.0
742,742999,21.02879454961986,35.75019644667707,0.047945737142974676,99.16720795631409,46.39828014373779,240.33233261108398,7727,653,7074,7074,0,7,743000.0
743,743999,21.022857550557504,35.74474851931848,0.047927938580599294,99.30194354057312,46.46318531036377,240.75199508666992,7729,653,7076,7076,0,7,744000.0
744,744999,21.014604305608277,35.73184683829216,0.04793639177890385,99.43938970565796,46.526732444763184,241.05327224731445,7730,653,7077,7077,0,7,745000.0
745,745999,21.01130384379545,35.73693179982928,0.047909873185335794,99.56345629692078,46.58938717842102,241.41254043579102,7730,653,7077,7077,0,7,746000.0
746,746999,21.00463281579184,35.72695935437444,0.04789545511774973,99.69457721710205,46.65297031402588,241.9010467529297,7730,653,7077,7077,0,7,747000.0
747,747999,21.000607922139448,35.72567158399144,0.047871748312213636,99.81014466285706,46.716572523117065,242.32509994506836,7730,653,7077,7077,0,7,748000.0
748,748999,20.994488318245043,35.718779387700835,0.04786347093078558,99.93621349334717,46.78061389923096,242.63277053833008,7730,653,7077,7077,0,7,749000.0
749,749999,20.992557835653372,35.71842635829181,0.047822307133108644,100.06740856170654,46.843608379364014,243.04565811157227,7730,653,7077,7077,0,7,750000.0
750,750999,20.990219548528657,35.719943381412875,0.047810776057100934,100.20569276809692,46.9074547290802,243.2939796447754,7736,654,7082,7082,0,7,751000.0
751,751999,20.984990813894942,35.70993074565728,0.04780796093692463,100.35275077819824,46.971755027770996,243.71236038208008,7754,655,7099,7099,0,7,752000.0
752,752999,20.980446689464276,35.70197092044367,0.047802828534899366,100.49684023857117,47.03554368019104,244.2342987060547,7756,656,7100,7100,0,7,753000.0
753,753999,20.980015497400025,35.704294159009386,0.04763430090707077,100.61422896385193,47.099112033843994,244.69039916992188,7756,656,7100,7100,0,7,754000.0
754,754999,20.97927550159123,35.70223179195708,0.0475803167472052,100.73250603675842,47.16162347793579,245.02479934692383,7756,656,7100,7100,0,7,755000.0
755,755999,20.980156471882967,35.70214401193894,0.04748713648698666,100.87171959877014,47.22611880302429,245.5594596862793,7768,657,7111,7111,0,7,756000.0
756,756999,20.981199742766126,35.701661132108235,0.04737172611148599,100.99325370788574,47.289432525634766,245.98781967163086,7769,657,7112,7112,0,7,757000.0
757,757999,20.98106232464415,35.69907075782717,0.04736871729818548,101.16664266586304,47.35342025756836,246.28540420532227,7787,659,7128,7128,0,7,758000.0
758,758999,20.979321751925756,35.69371226603542,0.047322313929057946,101.32095742225647,47.41753053665161,246.65596771240234,7799,661,7138,7138,0,7,759000.0
759,759999,20.975533246671297,35.68968750915987,0.047283549173722794,101.4506938457489,47.481536865234375,247.82862854003906,7800,661,7139,7139,0,7,760000.0
760,760999,20.96702917745851,35.68320822030663,0.04724773901107737,101.57492661476135,47.54587006568909,248.59584045410156,7804,661,7143,7143,0,7,761000.0
761,761999,20.956585115355114,35.66883160767749,0.04731254594007206,101.70827531814575,47.610254764556885,249.1308135986328,7804,661,7143,7143,0,7,762000.0
762,762999,20.949293439491637,35.673097332823524,0.04727312421991703,101.83968830108643,47.67426586151123,249.6437873840332,7805,661,7144,7144,0,7,763000.0
763,763999,20.94243516605515,35.66776272704219,0.04724952880671518,101.98005294799805,47.73797416687012,249.8711395263672,7807,662,7145,7145,0,7,764000.0
764,764999,20.93560651367691,35.66008201423483,0.047203364472503395,102.13984799385071,47.801837682724,250.28077697753906,7825,663,7162,7162,0,7,765000.0
765,765999,20.931112961156913,35.65633516246584,0.047181507850420634,102.30547189712524,47.86632227897644,250.73987197875977,7863,665,7198,7198,0,7,766000.0
766,766999,20.925983608250068,35.65249171709489,0.04715688681304975,102.44662237167358,47.92985463142395,251.19506454467773,7865,666,7199,7199,0,7,767000.0
767,767999,20.92126578370393,35.64818768994594,0.047100656737774305,102.56281018257141,47.99453020095825,251.57062149047852,7865,666,7199,7199,0,7,768000.0
768,768999,20.917031442888685,35.641575551665774,0.047029173508532196,102.69593834877014,48.058578968048096,252.02771377563477,7865,666,7199,7199,0,7,769000.0
769,769999,20.915328133688547,35.640351241696116,0.04695361532961939,102.86233353614807,48.12270903587341,252.36137008666992,7898,668,7230,7230,0,7,770000.0
770,770999,20.914962931072015,35.63803501242613,0.046883608734429205,102.98928642272949,48.18658709526062,252.7542724609375,7898,668,7230,7230,0,7,771000.0
771,771999,20.913206346055834,35.640561101682984,0.04679912158321631,103.10728168487549,48.250611305236816,253.24628448486328,7901,668,7233,7233,0,7,772000.0
772,772999,20.912005713058136,35.63730165180397,0.04675361684659041,103.22521328926086,48.314308166503906,253.525146484375,7902,668,7234,7234,0,7,773000.0
773,773999,20.912610478802662,35.63552340903065,0.0466867537065897,103.36843943595886,48.38132190704346,254.03358459472656,7902,668,7234,7234,0,7,774000.0
774,774999,20.914506691255834,35.639297967795166,0.04659247625778884,103.48288536071777,48.44450402259827,254.4472427368164,7902,668,7234,7234,0,7,775000.0
775,775999,20.915569944925977,35.63784725285511,0.046578743622266106,103.63074254989624,48.5088267326355,254.87168502807617,7907,669,7238,7238,0,7,776000.0
776,776999,20.918814644227776,35.66651877433387,0.04643937875915305,103.77086663246155,48.57223343849182,255.23530960083008,7911,670,7241,7241,0,7,777000.0
777,777999,20.921151008949426,35.66567665416528,0.04639872453165794,103.90430974960327,48.636536836624146,255.68600845336914,7911,670,7241,7241,0,7,778000.0
778,778999,20.92362691988348,35.66716031124784,0.04639161527624769,104.03507900238037,48.700571060180664,256.0666275024414,7911,670,7241,7241,0,7,779000.0
779,779999,20.9228195948873,35.669278411589886,0.04633238986101473,104.17439079284668,48.76429486274719,256.33531188964844,7942,671,7271,7271,0,7,780000.0
780,780999,20.915482628085904,35.676655116350965,0.04632284252454155,104.33270931243896,48.82791614532471,257.4965133666992,7946,672,7274,7274,0,7,781000.0
781,781999,20.906578001036177,35.66407024257881,0.046365414194997734,104.48602557182312,48.891658544540405,258.1152038574219,7949,673,7276,7276,0,7,782000.0
782,782999,20.897293118934343,35.65568269861835,0.04640846119093034,104.61597871780396,48.95607352256775,258.7194709777832,7949,673,7276,7276,0,7,783000.0
783,783999,20.889113108565905,35.646555466602436,0.04643591780564149,104.77906608581543,49.01997756958008,258.96010971069336,7953,675,7278,7278,0,7,784000.0
784,784999,20.883661250677672,35.652102056108085,0.04640880976123041,104.90479230880737,49.08468580245972,259.4103126525879,7956,675,7281,7281,0,7,785000.0
785,785999,20.877463502550448,35.64216751573211,0.046426327752568164,105.03147792816162,49.14858365058899,259.8558654785156,7956,675,7281,7281,0,7,786000.0
786,786999,20.871391907774182,35.63288087611286,0.046436369502271924,105.16720747947693,49.21237516403198,260.37907791137695,7956,675,7281,7281,0,7,787000.0
787,787999,20.86677077411174,35.64132467552183,0.04638652255694298,105.29112148284912,49.27670955657959,260.86804580688477,7956,675,7281,7281,0,7,788000.0
788,788999,20.860742888121347,35.65184459005062,0.046353026262957564,105.41023302078247,49.33926343917847,261.1496810913086,7956,675,7281,7281,0,7,789000.0
789,789999,20.85390616820049,35.64254254430032,0.04635531692427053,105.565110206604,49.4069447517395,261.5957832336426,7960,676,7284,7284,0,7,790000.0
790,790999,20.848258105376587,35.634079240135634,0.046352085442584956,105.72019076347351,49.47070026397705,262.1167755126953,7961,676,7285,7285,0,7,791000.0
791,791999,20.844227204831814,35.63012464943697,0.04634692667637319,105.84011101722717,49.5338237285614,262.4657745361328,7962,676,7286,7286,0,7,792000.0
792,792999,20.838632581872623,35.62364149368624,0.046374481144073054,105.97759127616882,49.597591161727905,262.8787651062012,7980,677,7303,7303,0,7,793000.0
793,793999,20.83476214293693,35.616938509643774,0.04637431732087893,106.10551881790161,49.66533398628235,263.39612197875977,7980,677,7303,7303,0,7,794000.0
794,794999,20.829398899086943,35.60471478602729,0.04637102020938133,106.2229630947113,49.72864747047424,264.0153579711914,7980,677,7303,7303,0,7,795000.0
795,795999,20.82455114503224,35.5953920016218,0.046392871623953225,106.40046763420105,49.792595863342285,264.3915367126465,8010,679,7331,7331,0,7,796000.0
796,796999,20.819265582659327,35.58354365159659,0.04634410751109419,106.53557109832764,49.85603451728821,265.09384536743164,8010,679,7331,7331,0,7,797000.0
797,797999,20.813201513989924,35.571486521448485,0.04634820271516471,106.66382193565369,49.9196879863739,266.3541450500488,8012,679,7333,7333,0,7,798000.0
798,798999,20.803410994470227,35.55510570262726,0.0464140708157007,106.81341338157654,49.983704805374146,266.9797821044922,8014,680,7334,7334,0,7,799000.0
799,799999,20.797596996427878,35.55884946009057,0.04631897553487396,106.96396398544312,50.04751896858215,267.4380226135254,8032,681,7351,7351,0,7,800000.0
800,800999,20.791440399171915,35.55168664302189,0.046325409495734604,107.13336110115051,50.1124312877655,267.91815185546875,8095,683,7412,7412,0,7,801000.0
801,801999,20.786557971821903,35.549214430072325,0.046310403988004456,107.28259372711182,50.17598271369934,268.32075119018555,8111,684,7427,7427,0,7,802000.0
802,802999,20.779473394789907,35.536935482462006,0.046305005996948645,107.46166229248047,50.24043107032776,268.7566795349121,8146,687,7459,7459,0,7,803000.0
803,803999,20.772967582591953,35.524784191465834,0.046244035524551586,107.62295579910278,50.310479164123535,269.3131332397461,8171,688,7483,7483,0,7,804000.0
804,804999,20.76686243187842,35.5166728937482,0.046220486584417686,107.77181696891785,50.37510395050049,269.80845642089844,8173,689,7484,7484,0,7,805000.0
805,805999,20.76212935724178,35.50814651238057,0.046169375918611366,107.88954639434814,50.438676595687866,270.23780059814453,8174,689,7485,7485,0,7,806000.0
806,806999,20.757437909272756,35.501936322808895,0.04612912007559056,108.03168439865112,50.50322103500366,270.69531631469727,8176,690,7486,7486,0,7,807000.0
807,807999,20.75456754837888,35.51056136525304,0.046052582443960266,108.18923616409302,50.573482036590576,271.1628608703613,8181,691,7490,7490,0,7,808000.0
808,808999,20.750577864928044,35.504516479457976,0.045943819014792386,108.32846808433533,50.63817262649536,271.5878448486328,8190,692,7498,7498,0,7,809000.0
809,809999,20.74725042774808,35.49794013527698,0.04589685462089221,108.44851112365723,50.70185852050781,272.11730194091797,8190,692,7498,7498,0,7,810000.0
810,810999,20.743726716249054,35.493533770611535,0.04582827780627796,108.5752649307251,50.766162395477295,272.5938415527344,8190,692,7498,7498,0,7,811000.0
811,811999,20.741918652717793,35.488661774899974,0.04578424112301904,108.70538425445557,50.82967138290405,272.91211318969727,8190,692,7498,7498,0,7,812000.0
812,812999,20.73879724365774,35.48058801544098,0.04574163628948358,108.82659316062927,50.894314765930176,273.5688247680664,8191,692,7499,7499,0,7,813000.0
813,813999,20.738312803245762,35.4763947491358,0.0456587136088179,108.94461226463318,50.958691120147705,274.04531478881836,8191,692,7499,7499,0,7,814000.0
814,814999,20.73594422176902,35.46809287250561,0.04561486379448065,109.10049796104431,51.022491693496704,274.3661231994629,8193,693,7500,7500,0,7,815000.0
815,815999,20.73248952381494,35.45772315541497,0.04553500787562681,109.23095655441284,51.08685612678528,274.73709869384766,8193,693,7500,7500,0,7,816000.0
816,816999,20.733303085672492,35.472149386784814,0.04531232407737451,109.38346576690674,51.151076793670654,275.83725357055664,8199,694,7505,7505,0,7,817000.0
817,817999,20.727452703686794,35.46106294622123,0.04520984544205375,109.50904369354248,51.215917110443115,276.5173110961914,8201,694,7507,7507,0,7,818000.0
818,818999,20.722291048307593,35.45215528892412,0.045148001024653106,109.63711857795715,51.28057932853699,277.08797454833984,8202,694,7508,7508,0,7,819000.0
819,819999,20.717500400357416,35.44070044787737,0.045164537126686,109.78897380828857,51.3442485332489,277.584529876709,8205,695,7510,7510,0,7,820000.0
820,820999,20.715539152047313,35.43709751089656,0.04514531294700519,109.93326091766357,51.40779709815979,277.9181480407715,8208,696,7512,7512,0,7,821000.0
821,821999,20.713474629079194,35.430648634366555,0.0451848051271575,110.05457401275635,51.471659421920776,278.33137130737305,8208,696,7512,7512,0,7,822000.0
822,822999,20.712551217539733,35.42486004386168,0.04526845756686282,110.17946934700012,51.53549766540527,278.8389549255371,8210,696,7514,7514,0,7,823000.0
823,823999,20.71341847839691,35.42187149654748,0.04544462558049389,110.30349898338318,51.59901976585388,279.4338073730469,8210,696,7514,7514,0,7,824000.0
824,824999,20.715026847744483,35.43122845809941,0.04550739223192701,110.42500472068787,51.662659645080566,279.7787055969238,8210,696,7514,7514,0,7,825000.0
825,825999,20.717606530100447,35.432805158429375,0.045669342734925955,110.5516357421875,51.72611689567566,280.3238945007324,8210,696,7514,7514,0,7,826000.0
826,826999,20.722066431555724,35.4407764327102,0.04589885620633716,110.68217945098877,51.7901713848114,280.8136405944824,8210,696,7514,7514,0,7,827000.0
827,827999,20.725167279410066,35.44276742293898,0.04598799720849067,110.83761048316956,51.85417985916138,281.0090217590332,8214,698,7516,7516,0,7,828000.0
828,828999,20.729476311800784,35.443638779460805,0.04612464331951582,110.9571270942688,51.91838073730469,281.60409927368164,8214,698,7516,7516,0,7,829000.0
829,829999,20.734729409150933,35.449261306472216,0.04627265782840562,111.07968139648438,51.982606410980225,282.08928298950195,8214,698,7516,7516,0,7,830000.0
830,830999,20.74093138147334,35.45528284420272,0.04649677347698544,111.19868803024292,52.04590368270874,282.45086669921875,8214,698,7516,7516,0,7,831000.0
831,831999,20.747727286193687,35.46050400008892,0.04654453663480185,111.34812045097351,52.1101598739624,282.8173027038574,8228,699,7529,7529,0,7,832000.0
832,832999,20.757310996452706,35.46961982616227,0.046642884292219744,111.49309229850769,52.17507076263428,283.4416618347168,8234,700,7534,7534,0,7,833000.0
833,833999,20.766622663479577,35.47772562996102,0.04676101635818142,111.6916332244873,52.23983311653137,283.8368377685547,8257,703,7554,7554,0,7,834000.0
834,834999,20.772118828559666,35.478152919569155,0.046850236504267784,111.83749985694885,52.30378794670105,284.1820526123047,8259,704,7555,7555,0,7,835000.0
835,835999,20.77416575246575,35.47329610578204,0.04690675711517123,111.96184062957764,52.36897349357605,284.68932723999023,8259,704,7555,7555,0,7,836000.0
836,836999,20.77135910857829,35.468509544655625,0.04687495285545229,112.10176944732666,52.43251037597656,285.6352119445801,8260,704,7556,7556,0,7,837000.0
837,837999,20.768385805979637,35.47340370400336,0.046816353302404745,112.23108386993408,52.49558997154236,286.2036666870117,8260,704,7556,7556,0,7,838000.0
838,838999,20.765490604628393,35.47501319914295,0.046796020944865124,112.3518180847168,52.55955386161804,286.6207504272461,8260,704,7556,7556,0,7,839000.0
839,839999,20.764629264882903,35.47514493393691,0.04679843669492789,112.5028657913208,52.62363409996033,287.00903701782227,8262,705,7557,7557,0,7,840000.0
840,840999,20.765450817660884,35.47438902084598,0.0467646251704692,112.66847801208496,52.68739318847656,287.2960968017578,8296,707,7589,7589,0,7,841000.0
841,841999,20.76720743298154,35.482439369151905,0.04671658550888358,112.8040361404419,52.75254797935486,287.7448921203613,8297,707,7590,7590,0,7,842000.0
842,842999,20.769464766194794,35.49190847313879,0.046649499895513924,112.95306444168091,52.81604528427124,288.3326530456543,8314,708,7606,7606,0,7,843000.0
843,843999,20.776716891616175,35.526167937733646,0.04650628765936782,113.07984185218811,52.88039588928223,288.879337310791,8314,708,7606,7606,0,7,844000.0
844,844999,20.78389614390108,35.5604768457054,0.04637129924348782,113.2053701877594,52.94441270828247,289.24059295654297,8314,708,7606,7606,0,7,845000.0
845,845999,20.798224061392855,35.619084441919505,0.04622645886104493,113.35467457771301,53.00862169265747,289.7011909484863,8316,709,7607,7607,0,7,846000.0
846,846999,20.81027941966393,35.67263261043827,0.046161851689071165,113.47464060783386,53.07302403450012,290.2659606933594,8317,709,7608,7608,0,7,847000.0
847,847999,20.82653703599702,35.7307318612911,0.0460833835568184,113.61111354827881,53.136828899383545,290.71129608154297,8319,710,7609,7609,0,7,848000.0
848,848999,20.841070712597485,35.774024155414715,0.046088963704637775,113.73510146141052,53.20121669769287,291.15271759033203,8319,710,7609,7609,0,7,849000.0
849,849999,20.860847153180753,35.83200542742664,0.04606224679831439,113.86009907722473,53.26467490196228,291.68429946899414,8319,710,7609,7609,0,7,850000.0
850,850999,20.879107114929145,35.89057980080733,0.0461166624897662,113.98511290550232,53.32803559303284,292.1634750366211,8319,710,7609,7609,0,7,851000.0
851,851999,20.900026203016402,35.944139216504446,0.04625896923722583,114.15599393844604,53.391799211502075,292.53578186035156,8324,712,7612,7612,0,7,852000.0
852,852999,20.90922073454992,35.96357969154243,0.046204996763441475,114.28588771820068,53.45570731163025,293.2701110839844,8326,712,7614,7614,0,7,853000.0
853,853999,20.92461601809832,36.05109390675781,0.04612169382518916,114.4312436580658,53.51929235458374,293.96850967407227,8329,713,7616,7616,0,7,854000.0
854,854999,20.946757150085563,36.15721836016289,0.04627142017160957,114.58396315574646,53.58302116394043,294.3991012573242,8332,714,7618,7618,0,7,855000.0
855,855999,20.964653393829497,36.23409098350089,0.04633121711594157,114.72579789161682,53.646299600601196,294.81036376953125,8337,715,7622,7622,0,8,856000.0
856,856999,20.98224349780122,36.30499571934671,0.04661241131680827,114.87505984306335,53.71031594276428,295.23020935058594,8342,716,7626,7626,0,8,857000.0
857,857999,20.998071940499404,36.35745503633094,0.04659789235893297,114.99879145622253,53.77402591705322,295.66073989868164,8344,716,7628,7628,0,8,858000.0
858,858999,21.01487030288723,36.404546882321206,0.04682037431348096,115.20302939414978,53.839359283447266,295.97830963134766,8410,720,7690,7690,0,8,859000.0
859,859999,21.032036843047603,36.44842281605648,0.046930474375424636,115.35528802871704,53.90439796447754,296.4564399719238,8415,721,7694,7694,0,8,860000.0
860,860999,21.048579116839953,36.48663664343937,0.04712154494133436,116.28503131866455,53.96846127510071,296.9199905395508,8415,721,7694,7694,0,8,861000.0
861,861999,21.05950857490098,36.505171399282176,0.04712564462125124,116.45404744148254,54.033297061920166,297.28839111328125,8423,723,7700,7700,0,8,862000.0
862,862999,21.074539201836814,36.537039709585144,0.04738194160454945,116.57871651649475,54.09741473197937,297.6549873352051,8423,723,7700,7700,0,8,863000.0
863,863999,21.089486364931673,36.58834711355487,0.04756187025006853,116.70609664916992,54.16292881965637,298.1449851989746,8423,723,7700,7700,0,8,864000.0
864,864999,21.109403223104607,36.65461897365769,0.0477825809372463,116.8577492237091,54.22718572616577,298.520751953125,8426,724,7702,7702,0,8,865000.0
865,865999,21.12562969385071,36.67788084952883,0.048086611250764855,117.00396537780762,54.29198408126831,298.9819221496582,8428,725,7703,7703,0,8,866000.0
866,866999,21.143418126901768,36.7231117643584,0.04835431949671798,117.15445137023926,54.35585260391235,299.34396743774414,8433,726,7707,7707,0,8,867000.0
867,867999,21.161282980810732,36.74886319743163,0.048549051937642806,117.32713198661804,54.42072343826294,299.7308349609375,8441,729,7712,7712,0,8,868000.0
868,868999,21.173826184525662,36.773138112082904,0.04855821949175376,117.49562001228333,54.48383450508118,300.2435111999512,8445,731,7714,7714,0,8,869000.0
869,869999,21.18867363184742,36.830327209912525,0.048442637441622693,117.63347792625427,54.54839468002319,300.9996528625488,8447,731,7716,7716,0,8,870000.0
870,870999,21.20086959526613,36.87507846610652,0.04838469066618356,117.7551109790802,54.61241388320923,301.4877395629883,8447,731,7716,7716,0,8,871000.0
871,871999,21.213527957818062,36.903807023100676,0.048472209637896,117.91743683815002,54.6761531829834,301.8645935058594,8456,733,7723,7723,0,8,872000.0
872,872999,21.230440945428274,36.9431147454709,0.04851237184906876,118.06635284423828,54.73960828781128,302.1774139404297,8488,734,7754,7754,0,8,873000.0
873,873999,21.247525517003137,37.00019563349177,0.048843828686827795,118.19857859611511,54.803810596466064,302.5397148132324,8488,734,7754,7754,0,8,874000.0
874,874999,21.260146930797784,37.027931141943895,0.04909074328111662,118.35183072090149,54.86753273010254,302.9648742675781,8521,735,7786,7786,0,8,875000.0
875,875999,21.276321295822445,37.07753946418285,0.04984363328105679,118.48482656478882,54.93069672584534,303.4267044067383,8521,735,7786,7786,0,8,876000.0
876,876999,21.293231947182683,37.11498749502443,0.05031949831452043,118.6189820766449,55.00139784812927,303.6853332519531,8529,736,7793,7793,0,8,877000.0
877,877999,21.313557071891402,37.1806989899448,0.051092170854728614,118.73609399795532,55.06461954116821,304.1001319885254,8529,736,7793,7793,0,8,878000.0
878,878999,21.33331488866454,37.223509489202925,0.05185593354447615,118.88417959213257,55.128106117248535,304.39587020874023,8531,737,7794,7794,0,8,879000.0
879,879999,21.350926616348257,37.256806310123956,0.05247627337004179,119.09303522109985,55.193641662597656,304.65259552001953,8551,740,7811,7811,0,8,880000.0
880,880999,21.370261367927256,37.29894200137253,0.053540472522739635,119.22056674957275,55.25791263580322,305.21119689941406,8551,740,7811,7811,0,8,881000.0
881,881999,21.38916530312434,37.33463699015506,0.05405959339372657,119.3461446762085,55.32214093208313,305.6184501647949,8551,740,7811,7811,0,8,882000.0
882,882999,21.411666659887096,37.38848706148877,0.05510245706116279,119.51099300384521,55.385676860809326,305.8881530761719,8557,742,7815,7815,0,8,883000.0
883,883999,21.43062854177366,37.42293245983429,0.055841138734118334,119.69473242759705,55.44937539100647,306.1094779968262,8621,745,7876,7876,0,8,884000.0
884,884999,21.447485858169475,37.44657758138142,0.05646534828683669,119.81532025337219,55.513054609298706,306.7130470275879,8622,745,7877,7877,0,8,885000.0
885,885999,21.46363493086555,37.47083807921035,0.057301044599602946,119.98603677749634,55.576926708221436,307.11728286743164,8644,747,7897,7897,0,8,886000.0
886,886999,21.48404714825594,37.51822075368764,0.05799121091896853,120.14673638343811,55.64192342758179,307.4503364562988,8650,749,7901,7901,0,8,887000.0
887,887999,21.49730518327436,37.53249254785162,0.05849612162920148,120.27134895324707,55.706018924713135,307.95978927612305,8650,749,7901,7901,0,8,888000.0
888,888999,21.50644487069396,37.55274783659297,0.058666970763415316,120.4168438911438,55.76921319961548,308.6944808959961,8657,750,7907,7907,0,8,889000.0
889,889999,21.505920231409124,37.554938958820266,0.058593633781552024,120.5778295993805,55.83285999298096,309.1850128173828,8663,752,7911,7911,0,8,890000.0
890,890999,21.509703956921467,37.57797063778252,0.05846623337263257,120.74397301673889,55.897103786468506,309.6244812011719,8696,754,7942,7942,0,8,891000.0
891,891999,21.51404915416013,37.5899216370879,0.058361618131848036,120.89663481712341,55.960612535476685,309.9551010131836,8711,755,7956,7956,0,8,892000.0
892,892999,21.51715143390105,37.59699538500028,0.05827305994095566,121.02240347862244,56.02357864379883,310.22558975219727,8711,755,7956,7956,0,8,893000.0
893,893999,21.520573744403098,37.60485632623826,0.05821761777541812,121.16712403297424,56.08674216270447,310.5627212524414,8713,756,7957,7957,0,8,894000.0
894,894999,21.522461989890267,37.60782453422507,0.05818703618473575,121.29256010055542,56.150043964385986,310.9375343322754,8713,756,7957,7957,0,8,895000.0
895,895999,21.52701260216202,37.61608040619053,0.05817052343291962,121.42552089691162,56.21337127685547,311.3763236999512,8713,756,7957,7957,0,8,896000.0
896,896999,21.53136575531254,37.623296192134,0.0581651556995223,121.61508083343506,56.277384757995605,311.50677490234375,8752,759,7993,7993,0,8,897000.0
897,897999,21.538715233636136,37.641112109415296,0.058208881648857735,121.74847364425659,56.341339111328125,311.96004486083984,8752,759,7993,7993,0,8,898000.0
898,898999,21.54740116608395,37.65797957328135,0.058353983250366004,121.87657022476196,56.4064736366272,312.3015670776367,8752,759,7993,7993,0,8,899000.0
899,899999,21.552648282279662,37.66659240625562,0.05842826595453099,122.01459836959839,56.46979832649231,312.50757598876953,8754,760,7994,7994,0,8,900000.0
900,900999,21.56158652924525,37.679111752323195,0.05859524554551088,122.18733406066895,56.53426694869995,312.9021530151367,8758,762,7996,7996,0,8,901000.0
901,901999,21.570436175426305,37.69340620662758,0.05872518735160137,122.33851838111877,56.598177433013916,313.173397064209,8760,763,7997,7997,0,8,902000.0
902,902999,21.5824983597064,37.71487635890101,0.05894420321536953,122.46390342712402,56.662546157836914,313.6366958618164,8760,763,7997,7997,0,8,903000.0
903,903999,21.596329785984523,37.74128800093986,0.05929051199105473,122.61045122146606,56.72628140449524,313.95190048217773,8762,764,7998,7998,0,8,904000.0
904,904999,21.610602302916316,37.762068415557714,0.05952871331973297,122.77643322944641,56.79105257987976,314.3819923400879,8793,766,8027,8027,0,8,905000.0
905,905999,21.623351508457606,37.77973412451151,0.05979531891454726,122.9302887916565,56.855082988739014,314.66171646118164,8824,767,8057,8057,0,8,906000.0
906,906999,21.63726691392657,37.8055204583887,0.06015341693066212,123.08243012428284,56.918646574020386,315.02478790283203,8840,768,8072,8072,0,8,907000.0
907,907999,21.65342392684422,37.832056620929414,0.06061888901390555,123.20765399932861,56.98210334777832,315.53361892700195,8840,768,8072,8072,0,8,908000.0
908,908999,21.660839498060692,37.83915197342,0.060848152208829664,123.3495819568634,57.045806646347046,315.857723236084,8873,769,8104,8104,0,8,909000.0
909,909999,21.66510119100905,37.861704040653805,0.06056264451018767,123.48031282424927,57.11102628707886,316.6416778564453,8875,769,8106,8106,0,8,910000.0
910,910999,21.66626412647828,37.86555439391476,0.06033304138882167,123.61755061149597,57.175474643707275,317.2379837036133,8875,769,8106,8106,0,8,911000.0
911,911999,21.669594707113706,37.872136910328685,0.06014523355661572,123.79590892791748,57.23980665206909,317.5543098449707,8909,771,8138,8138,0,8,912000.0
912,912999,21.67458812569515,37.885675273967244,0.059920761058523286,123.94361424446106,57.30309557914734,317.87807846069336,8940,772,8168,8168,0,8,913000.0
913,913999,21.677181185217798,37.88798519361041,0.05974712611869104,124.08310604095459,57.37156844139099,318.1808204650879,8940,772,8168,8168,0,8,914000.0
914,914999,21.680825520121175,37.89179522341383,0.05958864515078388,124.22301459312439,57.43580889701843,318.44171142578125,8943,773,8170,8170,0,8,915000.0
915,915999,21.6842564388398,37.89526355056666,0.05943475026469536,124.40368032455444,57.50054049491882,318.73684310913086,8951,775,8176,8176,0,8,916000.0
916,916999,21.68885931749939,37.905403480427154,0.05927280586983996,124.52900385856628,57.563552379608154,319.14524841308594,8952,775,8177,8177,0,8,917000.0
917,917999,21.692497884478396,37.910014774162846,0.059157190425215944,124.67943286895752,57.62759828567505,319.44051361083984,8957,776,8181,8181,0,8,918000.0
918,918999,21.70152527997762,37.95120164520007,0.05898791871542575,124.81132459640503,57.691102504730225,319.809513092041,8957,776,8181,8181,0,8,919000.0
919,919999,21.70545451615001,37.954063771128,0.058898893919428486,124.94788694381714,57.75462865829468,320.2433891296387,8957,776,8181,8181,0,8,920000.0
920,920999,21.7117415055049,37.959759246203454,0.05881063213876603,125.06314086914062,57.817880630493164,320.4703903198242,8957,776,8181,8181,0,8,921000.0
921,921999,21.716085509701955,37.963421775232675,0.058786154999244555,125.20697593688965,57.88141965866089,320.7753372192383,8963,777,8186,8186,0,8,922000.0
922,922999,21.723808340740394,37.979537229356644,0.05872110816042775,125.3760757446289,57.945117235183716,320.9621925354004,8965,778,8187,8187,0,8,923000.0
923,923999,21.72973737441488,37.98413905200897,0.05865193470290753,125.54038405418396,58.00934100151062,321.26516342163086,8983,780,8203,8203,0,8,924000.0
924,924999,21.73502106893542,37.98961466744197,0.05863053100006643,125.66536092758179,58.073676347732544,321.84370040893555,8983,780,8203,8203,0,8,925000.0
925,925999,21.740710407548395,37.99436243762252,0.058696236456985074,125.79095840454102,58.136698961257935,322.25476837158203,8983,780,8203,8203,0,8,926000.0
926,926999,21.74135254671731,37.98922059620934,0.05855324355054814,125.95696091651917,58.200414180755615,322.95782470703125,9018,782,8236,8236,0,8,927000.0
927,927999,21.74201750817713,37.988388868308164,0.05838229075463697,126.08206868171692,58.26444053649902,323.6063232421875,9020,782,8238,8238,0,8,928000.0
928,928999,21.743642580587203,37.98595167291485,0.058230023931851504,126.25180053710938,58.32890033721924,324.03326416015625,9051,783,8268,8268,0,8,929000.0
929,929999,21.743599946339305,37.978529712675204,0.05810038138127349,126.48021507263184,58.400211334228516,324.1338195800781,9105,787,8318,8318,0,8,930000.0
930,930999,21.744483697180094,37.9733304257772,0.057992835198957704,126.61184549331665,58.46481776237488,324.6099281311035,9105,787,8318,8318,0,8,931000.0
931,931999,21.74504869412086,37.96877316502503,0.057803974941581515,126.76446557044983,58.52887153625488,324.87735748291016,9107,788,8319,8319,0,8,932000.0
932,932999,21.744621578169102,37.96166637032591,0.057676955142545006,126.98359298706055,58.593733072280884,325.1281204223633,9178,792,8386,8386,0,8,933000.0
933,933999,21.74616965523509,37.97707348376471,0.05751345129940422,127.1304988861084,58.65774631500244,325.33884048461914,9180,793,8387,8387,0,8,934000.0
934,934999,21.746178881551675,37.96872421209002,0.057405329138876304,127.28552865982056,58.72181415557861,325.7247543334961,9182,794,8388,8388,0,8,935000.0
935,935999,21.746687896955354,37.966281858606244,0.057322622427410486,127.4087426662445,58.78498959541321,326.078556060791,9182,794,8388,8388,0,8,936000.0
936,936999,21.746547971366372,37.95969315526792,0.057225811018621675,127.5371880531311,58.84932041168213,326.3448028564453,9182,794,8388,8388,0,8,937000.0
937,937999,21.749251513857224,37.958748411752985,0.057208709472342134,127.67591738700867,58.912859201431274,326.7234916687012,9184,795,8389,8389,0,8,938000.0
938,938999,21.752314403837225,37.96394975130087,0.057109971174257645,127.82970571517944,58.97685432434082,326.93425369262695,9215,796,8419,8419,0,8,939000.0
939,939999,21.757359639555816,37.96552025645697,0.05705971004075705,127.98238801956177,59.04099678993225,327.21546936035156,9230,797,8433,8433,0,8,940000.0
940,940999,21.7632384249135,37.97041246815534,0.056986553229018244,128.15272426605225,59.10526156425476,327.44296646118164,9234,799,8435,8435,0,8,941000.0
941,941999,21.76617873517423,37.96824988924988,0.05691284273624042,128.3604600429535,59.170724868774414,327.7489128112793,9250,803,8447,8447,0,8,942000.0
942,942999,21.770496410069715,37.9686194718534,0.05686610287885274,128.49885034561157,59.23485326766968,328.1854438781738,9250,803,8447,8447,0,8,943000.0
943,943999,21.772993294291183,37.96572048746936,0.05679879102242957,128.65960335731506,59.29853820800781,328.4199905395508,9254,805,8449,8449,0,8,944000.0
944,944999,21.77627305248007,37.96960211033791,0.05669149156262898,128.79439163208008,59.36299777030945,328.92667388916016,9254,805,8449,8449,0,8,945000.0
945,945999,21.778264346069257,37.966858494641144,0.05662683761103515,128.9521894454956,59.432894229888916,329.47705078125,9262,806,8456,8456,0,8,946000.0
946,946999,21.776661987727127,37.97332586757653,0.05653920383430955,129.09819865226746,59.497058153152466,329.8639831542969,9264,807,8457,8457,0,8,947000.0
947,947999,21.772598937361966,37.96519009370497,0.05647851364246825,129.27679681777954,59.56152653694153,330.16007232666016,9268,809,8459,8459,0,8,948000.0
948,948999,21.76765047163981,37.95449738217621,0.05647085292723375,129.41413402557373,59.62648582458496,330.57752990722656,9268,809,8459,8459,0,8,949000.0
949,949999,21.765835760206894,37.95300582072811,0.0564133364365893,129.59648728370667,59.69028115272522,330.7551574707031,9283,812,8471,8471,0,8,950000.0
950,950999,21.763154614001948,37.94509208588429,0.05636711356430224,129.72082114219666,59.75360345840454,331.1496887207031,9283,812,8471,8471,0,8,951000.0
951,951999,21.760682846202936,37.93621625642156,0.05630243813105984,129.93598222732544,59.81854224205017,331.3423652648926,9323,816,8507,8507,0,8,952000.0
952,952999,21.758758512109164,37.928563456440344,0.056231163307750465,130.0740418434143,59.88723134994507,331.6027069091797,9324,816,8508,8508,0,8,953000.0
953,953999,21.756244921433712,37.92009066938926,0.05617402334548349,130.24101948738098,59.951892375946045,331.86735916137695,9341,818,8523,8523,0,8,954000.0
954,954999,21.754920053876717,37.916278459961966,0.056100313674051105,130.41413807868958,60.02070641517639,332.1466178894043,9345,820,8525,8525,0,8,955000.0
955,955999,21.754275821290566,37.91012535773501,0.05604657069515029,130.56190061569214,60.08548092842102,332.4044532775879,9350,821,8529,8529,0,8,956000.0
956,956999,21.753549117569396,37.90495196325636,0.05598737813299404,130.68975687026978,60.14951825141907,332.7583465576172,9350,821,8529,8529,0,8,957000.0
957,957999,21.754148001154228,37.9007705378575,0.05597928038144173,130.84749388694763,60.21340537071228,333.0307273864746,9352,822,8530,8530,0,8,958000.0
958,958999,21.75382219561768,37.89433224199092,0.0559662851915641,130.97712683677673,60.27781915664673,333.3104476928711,9352,822,8530,8530,0,8,959000.0
959,959999,21.756872690748967,37.894390940919614,0.05592372121453881,131.1351819038391,60.34164810180664,333.58230209350586,9369,823,8546,8546,0,8,960000.0
960,960999,21.761902038566998,37.89932344586964,0.05587291895806157,131.29929327964783,60.40711283683777,333.94094467163086,9373,825,8548,8548,0,8,961000.0
961,961999,21.764255441841325,37.89950888430531,0.05584151227394363,131.42139101028442,60.4704167842865,334.2312469482422,9373,825,8548,8548,0,8,962000.0
962,962999,21.766350803698593,37.89785619832236,0.055817672042394406,131.578467130661,60.53496074676514,334.6991195678711,9376,826,8550,8550,0,8,963000.0
963,963999,21.769818691109737,37.89730791234913,0.055821988600411876,131.77150893211365,60.599735260009766,334.9135322570801,9387,829,8558,8558,0,8,964000.0
964,964999,21.77325387397608,37.89608759722392,0.05579822530608802,131.9599380493164,60.6656858921051,335.05123138427734,9397,832,8565,8565,0,8,965000.0
965,965999,21.773602672948204,37.88984849607276,0.05578288107362073,132.13352847099304,60.73324751853943,335.4352912902832,9430,834,8596,8596,0,8,966000.0
966,966999,21.77200616940133,37.8897201499832,0.05576848155584524,132.31914377212524,60.79703402519226,336.0434341430664,9467,837,8630,8630,0,8,967000.0
967,967999,21.763628297588546,37.87870584284802,0.05580312680639865,132.4934561252594,60.86902570724487,336.5550003051758,9470,838,8632,8632,0,8,968000.0
968,968999,21.75545318635399,37.865896175727904,0.0558488994863483,132.65991473197937,60.93402600288391,336.920597076416,9476,840,8636,8636,0,8,969000.0
969,969999,21.74779340645434,37.85619294039153,0.05586046210716755,132.80917978286743,60.99966382980347,337.3465995788574,9478,841,8637,8637,0,8,970000.0
970,970999,21.740317555686506,37.844471968521724,0.05586272037726592,132.95139598846436,61.06341624259949,337.6112251281738,9480,842,8638,8638,0,8,971000.0
971,971999,21.73272196700244,37.83088632748601,0.05588051089264645,133.12211346626282,61.12824559211731,337.9731979370117,9486,844,8642,8642,0,8,972000.0
972,972999,21.7254609125228,37.81822947069132,0.05589319294370043,133.2612886428833,61.199487924575806,338.3748893737793,9486,844,8642,8642,0,8,973000.0
973,973999,21.718408977964504,37.80675070124426,0.055891076904310166,133.3976423740387,61.26796078681946,338.71898651123047,9486,844,8642,8642,0,8,974000.0
974,974999,21.710810688510737,37.79403291056934,0.05589581697350332,133.5523579120636,61.33282208442688,338.9608039855957,9502,845,8657,8657,0,8,975000.0
975,975999,21.70398561979996,37.78198756067366,0.055890643705143295,133.72367334365845,61.39723825454712,339.1904487609863,9508,847,8661,8661,0,8,976000.0
976,976999,21.698519315704356,37.77543867807885,0.055875828971167274,133.89145064353943,61.46186089515686,339.43379974365234,9515,849,8666,8666,0,8,977000.0
977,977999,21.691593535920752,37.762843637542865,0.05588714305432829,134.03856945037842,61.525405168533325,339.71096420288086,9517,850,8667,8667,0,8,978000.0
978,978999,21.68725775292602,37.77740219005224,0.05578414448010671,134.20687818527222,61.589317083358765,339.9980697631836,9521,852,8669,8669,0,8,979000.0
979,979999,21.682022767167688,37.76754168889657,0.055770413644278705,134.32494950294495,61.654855728149414,340.28166580200195,9521,852,8669,8669,0,8,980000.0
980,980999,21.67561459701882,37.75572604241809,0.05578550785644454,134.44676184654236,61.718127489089966,340.6268997192383,9521,852,8669,8669,0,8,981000.0
981,981999,21.67276712146154,37.74966898190361,0.055767009111041044,134.65026307106018,61.788132190704346,340.84119033813477,9564,855,8709,8709,0,8,982000.0
982,982999,21.669177023099483,37.74198359268743,0.05572310075617548,134.77853441238403,61.85447835922241,341.1648483276367,9564,855,8709,8709,0,8,983000.0
983,983999,21.663658556748626,37.731429258434964,0.05572930035536827,134.95373249053955,61.91995334625244,341.5811424255371,9573,857,8716,8716,0,8,984000.0
984,984999,21.659867904778164,37.7224831264316,0.05571440188100296,135.12232732772827,61.98439168930054,341.9209518432617,9580,859,8721,8721,0,8,985000.0
985,985999,21.654800183948204,37.71204933270085,0.055701239027511895,135.293035030365,62.0498743057251,342.15186309814453,9585,861,8724,8724,0,8,986000.0
986,986999,21.64892669255107,37.70073565695683,0.0556977753197907,135.44009637832642,62.113699197769165,342.52709197998047,9592,862,8730,8730,0,8,987000.0
987,987999,21.65473146787763,37.71936482653572,0.055480402900907944,135.58772206306458,62.17835998535156,343.2515678405762,9598,863,8735,8735,0,8,988000.0
988,988999,21.664465768941614,37.75074759355393,0.05536424784902472,135.76544642448425,62.242775440216064,343.7156295776367,9631,865,8766,8766,0,8,989000.0
989,989999,21.6769032145457,37.806131285186915,0.055364975945500494,135.9334180355072,62.307541847229004,344.1297035217285,9640,866,8774,8774,0,8,990000.0
990,990999,21.682511204054776,37.81207059881404,0.05529386593944807,136.0807909965515,62.37239193916321,344.47871017456055,9642,867,8775,8775,0,8,991000.0
991,991999,21.690069298815267,37.817814878156014,0.05506360896802476,136.20143604278564,62.43576264381409,344.77931213378906,9642,867,8775,8775,0,8,992000.0
992,992999,21.69853605695616,37.82941754236774,0.054924456556978196,136.3703544139862,62.500394105911255,345.0511245727539,9646,869,8777,8777,0,8,993000.0
993,993999,21.70691651879355,37.83551804275271,0.05471276886650778,136.50794124603271,62.563947916030884,345.3580780029297,9646,869,8777,8777,0,8,994000.0
994,994999,21.715447820750654,37.84416118847737,0.05448987068252509,136.62621784210205,62.62796354293823,345.6835289001465,9646,869,8777,8777,0,8,995000.0
995,995999,21.72335484801814,37.84945671915218,0.05427311589370709,136.80616116523743,62.692737340927124,345.81160736083984,9650,871,8779,8779,0,8,996000.0
996,996999,21.730576422914435,37.85488958269305,0.05402110732571852,136.94090700149536,62.7559175491333,346.00634384155273,9650,871,8779,8779,0,8,997000.0
997,997999,21.738204636432677,37.857446077008696,0.05371674733322629,137.06708669662476,62.81942796707153,346.2902946472168,9650,871,8779,8779,0,8,998000.0
998,998999,21.74535842565027,37.86260096621535,0.053463122747373415,137.20928502082825,62.882542848587036,346.4239845275879,9652,872,8780,8780,0,8,999000.0
999,999999,21.752123869148093,37.8676001043984,0.05333383756590582,137.37504863739014,62.94655966758728,346.64854431152344,9661,874,8787,8787,0,8,1000000.0
1000,1000999,21.75777165700557,37.86726567161382,0.05311106724559023,137.5384886264801,63.01037526130676,346.92031478881836,9665,876,8789,8789,0,8,1001000.0
1001,1001999,21.766138223268364,37.880623926354474,0.052829792686901356,137.66697549819946,63.0744194984436,347.182071685791,9665,876,8789,8789,0,8,1002000.0
1002,1002999,21.7740252818616,37.88382684694482,0.05258348588966344,137.8225293159485,63.13788056373596,347.3129577636719,9667,877,8790,8790,0,8,1003000.0
1003,1003999,21.78066679946606,37.884585181024285,0.05234226540976117,137.97707891464233,63.20177984237671,347.7060012817383,9672,878,8794,8794,0,8,1004000.0
1004,1004999,21.787197587291573,37.884011190182434,0.05214440823561595,138.14004778862,63.26563620567322,347.98276138305664,9675,879,8796,8796,0,8,1005000.0
1005,1005999,21.79207042374882,37.88271820250172,0.051950017683539795,138.29939723014832,63.32919216156006,348.1658744812012,9708,881,8827,8827,0,8,1006000.0
1006,1006999,21.797141204476375,37.88784617607902,0.0517933460223573,138.43755769729614,63.39307975769043,348.492244720459,9710,882,8828,8828,0,8,1007000.0
1007,1007999,21.797005589506746,37.8822983551644,0.051704653512674725,138.57689094543457,63.45730543136597,349.3443794250488,9711,882,8829,8829,0,8,1008000.0
1008,1008999,21.79410706093996,37.878833958600545,0.051658614886603615,138.71251606941223,63.52158570289612,349.9642105102539,9711,882,8829,8829,0,8,1009000.0
1009,1009999,21.79054524609075,37.872511742621946,0.05161071657371574,138.85968828201294,63.5860013961792,350.3393363952637,9713,883,8830,8830,0,8,1010000.0
1010,1010999,21.787361992810034,37.86740887474136,0.05157091652797863,139.00234365463257,63.6501259803772,350.7417221069336,9715,884,8831,8831,0,8,1011000.0
1011,1011999,21.784920576547577,37.861719855695135,0.05152393289870838,139.16960167884827,63.713916540145874,350.98946380615234,9751,886,8865,8865,0,8,1012000.0
1012,1012999,21.781494055265696,37.853849783609434,0.05150889783772805,139.3334128856659,63.77767014503479,351.2790107727051,9755,888,8867,8867,0,8,1013000.0
1013,1013999,21.780014282500677,37.84702116186443,0.051458581965906025,139.48352885246277,63.84288048744202,351.64155197143555,9757,889,8868,8868,0,8,1014000.0
1014,1014999,21.77787547747763,37.84219893948202,0.051424799135416976,139.60642957687378,63.90644907951355,352.04157638549805,9757,889,8868,8868,0,8,1015000.0
1015,1015999,21.77536723329818,37.835758390129556,0.05137509286865649,139.771817445755,63.97048902511597,352.2379455566406,9761,891,8870,8870,0,8,1016000.0
1016,1016999,21.774560027989008,37.830908621467835,0.051370668706144706,139.8957552909851,64.03532814979553,352.57714080810547,9761,891,8870,8870,0,8,1017000.0
1017,1017999,21.778242060623587,37.833173271176115,0.05133838209542374,140.01933646202087,64.09893441200256,352.8590087890625,9762,891,8871,8871,0,8,1018000.0
1018,1018999,21.78194159294138,37.83878225631993,0.05134535942426488,140.16547393798828,64.16226744651794,353.0328140258789,9765,892,8873,8873,0,8,1019000.0
1019,1019999,21.785029085096124,37.840668529551024,0.05136949730137774,140.3261523246765,64.22735714912415,353.33991622924805,9767,893,8874,8874,0,8,1020000.0
1020,1020999,21.787709779634504,37.84190141218048,0.05138220651301617,140.51778507232666,64.29213237762451,353.46063232421875,9802,896,8906,8906,0,8,1021000.0
1021,1021999,21.793211525393488,37.84717351605176,0.05137024710287896,140.64706373214722,64.35695004463196,353.84009552001953,9802,896,8906,8906,0,8,1022000.0
1022,1022999,21.798370235539252,37.851241627332854,0.05139201891975409,140.8343939781189,64.42077279090881,353.9870834350586,9813,899,8914,8914,0,8,1023000.0
1023,1023999,21.803355297072827,37.85254098765341,0.05138007917227205,140.97802090644836,64.48446583747864,354.38787841796875,9816,900,8916,8916,0,8,1024000.0
1024,1024999,21.807001112081227,37.85253141590876,0.0513808954108409,141.1288197040558,64.5479884147644,354.6414222717285,9818,901,8917,8917,0,8,1025000.0
1025,1025999,21.812841778786105,37.85643444069025,0.051401302915512925,141.25277471542358,64.61114168167114,354.9578514099121,9819,901,8918,8918,0,8,1026000.0
1026,1026999,21.81568216322566,37.855561530644486,0.051401461709610796,141.4267933368683,64.67535781860352,355.14403533935547,9823,903,8920,8920,0,8,1027000.0
1027,1027999,21.815926324177834,37.851028072656476,0.05138395850437116,141.59323382377625,64.73896503448486,355.36494064331055,9832,905,8927,8927,0,8,1028000.0
1028,1028999,21.80911884709891,37.84209578040412,0.05139115862897925,141.7287096977234,64.80288624763489,356.1002540588379,9833,905,8928,8928,0,8,1029000.0
1029,1029999,21.80238015225141,37.834718717639326,0.05141171361115715,141.85529828071594,64.86660885810852,356.64085388183594,9834,905,8929,8929,0,8,1030000.0
1030,1030999,21.796380749333686,37.82612513869688,0.051417636961510915,141.9766833782196,64.93070220947266,357.0493469238281,9835,905,8930,8930,0,8,1031000.0
1031,1031999,21.789464841865595,37.81538688915967,0.051455589868620755,142.19454860687256,64.99493455886841,357.2801856994629,9846,909,8937,8937,0,8,1032000.0
1032,1032999,21.78296926749399,37.80581838687852,0.05146807548097365,142.31652188301086,65.05929255485535,357.6469268798828,9846,909,8937,8937,0,8,1033000.0
1033,1033999,21.777590749882336,37.79783665462091,0.051467254549415475,142.44597935676575,65.12353825569153,357.95311737060547,9846,909,8937,8937,0,8,1034000.0
1034,1034999,21.772271116908122,37.79035077135349,0.05145217630121435,142.59181547164917,65.18698310852051,358.17980194091797,9848,910,8938,8938,0,8,1035000.0
1035,1035999,21.766869034392823,37.78478348520921,0.05143036854223537,142.77812886238098,65.25146961212158,358.36779403686523,9852,912,8940,8940,0,8,1036000.0
1036,1036999,21.762589852215278,37.78026966260624,0.05141015317426212,142.92326259613037,65.31448745727539,358.57836151123047,9854,913,8941,8941,0,8,1037000.0
1037,1037999,21.759479758616376,37.77426413580826,0.05136513883790905,143.0685589313507,65.37797784805298,358.83777236938477,9885,914,8971,8971,0,8,1038000.0
1038,1038999,21.75705865593396,37.76809392631244,0.05131790335013908,143.19379878044128,65.44258952140808,359.08281326293945,9885,914,8971,8971,0,8,1039000.0
1039,1039999,21.754318597535327,37.76296260386015,0.051276136629506475,143.4273316860199,65.50670385360718,359.0440559387207,9924,919,9005,9005,0,8,1040000.0
1040,1040999,21.753322936461558,37.761772034767006,0.05121774473892948,143.58560609817505,65.57079267501831,359.40881729125977,9926,920,9006,9006,0,8,1041000.0
1041,1041999,21.75191124650867,37.757358357347684,0.051151884558200966,143.7091269493103,65.63529181480408,359.77806854248047,9926,920,9006,9006,0,8,1042000.0
1042,1042999,21.752430468312358,37.75580318191359,0.05110722270142931,143.85651659965515,65.69882774353027,359.9507942199707,9928,921,9007,9007,0,8,1043000.0
1043,1043999,21.75473856984686,37.75821728111446,0.05103832364373073,144.03553414344788,65.7667989730835,360.13276290893555,9944,923,9021,9021,0,8,1044000.0
1044,1044999,21.75543150869368,37.75815621476198,0.050979013758038816,144.1750111579895,65.83467745780945,360.66979217529297,9944,923,9021,9021,0,8,1045000.0
1045,1045999,21.756754450504804,37.757566101129434,0.050927845716816966,144.321923494339,65.89840650558472,360.8613624572754,9950,924,9026,9026,0,8,1046000.0
1046,1046999,21.7595254928659,37.76020232010543,0.050869096779159406,145.47475600242615,65.96204662322998,361.04553604125977,9955,925,9030,9030,0,8,1047000.0
1047,1047999,21.761714881338435,37.75962823283317,0.050835570843877576,145.6283142566681,66.02614617347717,361.31555938720703,9957,926,9031,9031,0,8,1048000.0
1048,1048999,21.759699147196212,37.75247055796198,0.050800843364998016,145.83557319641113,66.09118103981018,361.47473907470703,9995,929,9066,9066,0,8,1049000.0
1049,1049999,21.75543240231704,37.748506170606845,0.050784593580863624,146.03637075424194,66.1558096408844,361.91386795043945,10010,932,9078,9078,0,8,1050000.0
1050,1050999,21.750331466063617,37.74101219002976,0.050800737270728646,146.22601866722107,66.22072529792786,362.43860244750977,10043,934,9109,9109,0,8,1051000.0
1051,1051999,21.742932567743182,37.729890103604795,0.05082990566519063,146.38009095191956,66.28701376914978,362.9211235046387,10047,935,9112,9112,0,8,1052000.0
1052,1052999,21.73918148652907,37.72241442353058,0.0508141498723943,146.53335309028625,66.35157012939453,363.27366638183594,10049,936,9113,9113,0,8,1053000.0
1053,1053999,21.734423306337344,37.71339628998473,0.050794238362935396,146.71647906303406,66.41661930084229,363.5535697937012,10056,938,9118,9118,0,8,1054000.0
1054,1054999,21.73283205594221,37.71551190961828,0.05073624739023941,146.9565670490265,66.4814932346344,363.69921493530273,10102,943,9159,9159,0,8,1055000.0
1055,1055999,21.73275835075297,37.72504264195893,0.05064635983192178,147.07963705062866,66.54771971702576,364.0934944152832,10102,943,9159,9159,0,8,1056000.0
1056,1056999,21.733538887233877,37.737530558159065,0.050594383451012415,147.26951694488525,66.6131522655487,364.4885940551758,10122,945,9177,9177,0,8,1057000.0
1057,1057999,21.740899013846267,37.794068610171635,0.05043374677068002,147.42336249351501,66.68032383918762,364.8485412597656,10125,946,9179,9179,0,8,1058000.0
1058,1058999,21.74589664396559,37.808212430045515,0.0503951833365196,147.63067173957825,66.74553847312927,365.03690338134766,10133,949,9184,9184,0,8,1059000.0
1059,1059999,21.75007135952954,37.8368427668494,0.050316619448597444,147.75954413414001,66.81169390678406,365.4789352416992,10134,949,9185,9185,0,8,1060000.0
1060,1060999,21.755019374090775,37.86240588249257,0.0502637951010918,147.90485191345215,66.876229763031,365.87905502319336,10165,950,9215,9215,0,8,1061000.0
1061,1061999,21.76516844250746,37.90478255478959,0.05019120993397452,148.1078019142151,66.9411952495575,366.10987854003906,10171,953,9218,9218,0,8,1062000.0
1062,1062999,21.774314951474267,37.93441586775004,0.050181118840359695,148.28407669067383,67.00733399391174,366.55204010009766,10175,955,9220,9220,0,8,1063000.0
1063,1063999,21.783509808820646,37.96571057450925,0.050163381025293496,148.4348521232605,67.07175993919373,366.968505859375,10183,956,9227,9227,0,8,1064000.0
1064,1064999,21.785829327852834,37.97488341036837,0.05014684490596022,148.60418343544006,67.1355185508728,367.47549057006836,10198,957,9241,9241,0,8,1065000.0
1065,1065999,21.787724048016248,37.98938963884672,0.05005487070468195,148.7811405658722,67.20148372650146,368.05774307250977,10234,959,9275,9275,0,8,1066000.0
1066,1066999,21.789586017898486,38.004063274353975,0.05002453806763185,148.93693614006042,67.26559042930603,368.6280403137207,10252,960,9292,9292,0,8,1067000.0
1067,1067999,21.792646162121006,38.02347917967948,0.04992576775502133,149.0921552181244,67.33010125160217,369.07375717163086,10254,961,9293,9293,0,8,1068000.0
1068,1068999,21.793964475904183,38.02648704986683,0.049941650564567786,149.26520109176636,67.39446902275085,369.32895278930664,10258,963,9295,9295,0,8,1069000.0
1069,1069999,21.80009824703189,38.04926956998575,0.04994742271639685,149.39483428001404,67.45968055725098,369.69377517700195,10260,963,9297,9297,0,8,1070000.0
1070,1070999,21.80450511204278,38.065111050932046,0.04989293772289238,149.53759050369263,67.5232982635498,370.0147399902344,10262,964,9298,9298,0,8,1071000.0
1071,1071999,21.80892276639233,38.07731281586712,0.04982849330622352,149.69355654716492,67.58796572685242,370.31746673583984,10267,965,9302,9302,0,8,1072000.0
1072,1072999,21.813677833205908,38.08650888076196,0.04984531251118818,149.84072065353394,67.65186882019043,370.52978897094727,10274,966,9308,9308,0,8,1073000.0
1073,1073999,21.821733026770914,38.11426854523958,0.04980671405703785,149.95861840248108,67.71542286872864,370.78998947143555,10275,966,9309,9309,0,8,1074000.0
1074,1074999,21.832934628357297,38.15827032118651,0.04978355808843826,150.12711215019226,67.7801296710968,371.04663467407227,10279,968,9311,9311,0,8,1075000.0
1075,1075999,21.84247024976164,38.17679245792902,0.049787030916675246,150.25531840324402,67.84345507621765,371.3850898742676,10279,968,9311,9311,0,8,1076000.0
1076,1076999,21.85618364845653,38.20570755131702,0.049816666262320064,150.39535188674927,67.90677762031555,371.5360527038574,10281,969,9312,9312,0,8,1077000.0
1077,1077999,21.870491872999363,38.23888193302199,0.049887413509863254,150.54452776908875,67.96990633010864,371.7205581665039,10312,970,9342,9342,0,8,1078000.0
1078,1078999,21.8870487994718,38.28524330246349,0.04990302746262543,150.74217772483826,68.03408718109131,372.06225204467773,10320,973,9347,9347,0,8,1079000.0
1079,1079999,21.9043134346741,38.327421601822216,0.0500495743702174,150.90629124641418,68.09896278381348,372.286190032959,10333,974,9359,9359,0,8,1080000.0
1080,1080999,21.92442151575483,38.3781247528637,0.05022568169926789,151.08006358146667,68.16300702095032,372.61384201049805,10370,976,9394,9394,0,8,1081000.0
1081,1081999,21.94460319398604,38.443641012413686,0.0502997298375254,151.2269310951233,68.22625541687012,372.9076385498047,10374,977,9397,9397,0,8,1082000.0
1082,1082999,21.948401547375397,38.45438726701487,0.05028398934990952,151.35036540031433,68.29034447669983,373.62353134155273,10378,977,9401,9401,0,8,1083000.0
1083,1083999,21.947950968564122,38.45809925862233,0.05013162702990104,151.516845703125,68.35467839241028,374.12013244628906,10392,979,9413,9413,0,8,1084000.0
1084,1084999,21.948955486349494,38.47232463299757,0.050045252125414996,151.67280554771423,68.4186658859253,374.43907165527344,10394,980,9414,9414,0,8,1085000.0
1085,1085999,21.94917927964862,38.47739231171023,0.05001360119599574,151.79160690307617,68.48333382606506,374.91140365600586,10394,980,9414,9414,0,8,1086000.0
1086,1086999,21.94902158445767,38.47787921735983,0.050037654851597835,151.9961223602295,68.54838037490845,375.20662689208984,10403,983,9420,9420,0,8,1087000.0
1087,1087999,21.950785668640286,38.49886790172073,0.04994109007409686,152.12567377090454,68.61335349082947,375.6399383544922,10403,983,9420,9420,0,8,1088000.0
1088,1088999,21.95359505982923,38.50302669712079,0.05000440475688894,152.32481861114502,68.6770133972168,375.78856658935547,10438,986,9452,9452,0,8,1089000.0
1089,1089999,21.956081993817843,38.50676918895122,0.04999584288904191,152.45128989219666,68.74060654640198,376.0749397277832,10438,986,9452,9452,0,8,1090000.0
1090,1090999,21.960683584385375,38.517034147077275,0.049991399475349474,152.6001012325287,68.80441975593567,376.3593864440918,10440,987,9453,9453,0,8,1091000.0
1091,1091999,21.96682211733219,38.529561954271585,0.05005765027391196,152.7233109474182,68.8677728176117,376.5885009765625,10440,987,9453,9453,0,8,1092000.0
1092,1092999,21.97372977569296,38.53951108442735,0.050168624737953915,152.86421728134155,68.9322783946991,376.8554344177246,10446,988,9458,9458,0,8,1093000.0
1093,1093999,21.980724471510126,38.55286571024873,0.05025994678328927,153.05621886253357,68.99658632278442,376.92432022094727,10457,991,9466,9466,0,8,1094000.0
1094,1094999,21.988145888102814,38.56249624930598,0.05034558007512957,153.1895351409912,69.06088376045227,377.28430938720703,10458,991,9467,9467,0,8,1095000.0
1095,1095999,21.997163591444505,38.588528007526456,0.05053951709824667,153.3887071609497,69.12631011009216,377.5322265625,10485,994,9491,9491,0,8,1096000.0
1096,1096999,22.008057127064774,38.60626662579904,0.0507029769603643,153.53806972503662,69.18992352485657,377.71912384033203,10487,995,9492,9492,0,8,1097000.0
1097,1097999,22.017361067868315,38.618617451956695,0.05083092547627577,153.68485069274902,69.25334429740906,377.9130172729492,10491,996,9495,9495,0,8,1098000.0
1098,1098999,22.02635108181353,38.628507509581375,0.0509332967670002,153.8062858581543,69.3167679309845,378.3633613586426,10493,996,9497,9497,0,8,1099000.0
1099,1099999,22.035519029810917,38.63859791477859,0.05105172142227521,153.98891949653625,69.38104391098022,378.64664459228516,10538,998,9540,9540,0,8,1100000.0
1100,1100999,22.041695928978,38.64319793811117,0.05117696637943625,154.1121106147766,69.44573926925659,378.9118003845215,10538,998,9540,9540,0,8,1101000.0
1101,1101999,22.046391965574262,38.64591477124982,0.0512266841361414,154.26245498657227,69.50936675071716,379.0871810913086,10540,999,9541,9541,0,8,1102000.0
1102,1102999,22.043598717723373,38.642150803176904,0.05122595528183238,154.40955185890198,69.57268333435059,379.6394348144531,10542,1000,9542,9542,0,8,1103000.0
1103,1103999,22.03869330299739,38.639927890346044,0.05121273512259272,154.5869448184967,69.63667273521423,380.079345703125,10559,1002,9557,9557,0,8,1104000.0
1104,1104999,22.033278560131247,38.63272753242093,0.05120575290984386,154.73808097839355,69.70063877105713,380.3970260620117,10561,1003,9558,9558,0,8,1105000.0
1105,1105999,22.029929962318167,38.62890343276035,0.05124036786443864,154.8699951171875,69.7649917602539,380.8056869506836,10561,1003,9558,9558,0,8,1106000.0
1106,1106999,22.028096907490433,38.6269411858596,0.05129640091433341,155.01624631881714,69.83013916015625,381.0353240966797,10563,1004,9559,9559,0,8,1107000.0
1107,1107999,22.024898109450184,38.62112436869396,0.05136839225047529,155.2295582294464,69.89522671699524,381.3569526672363,10656,1007,9649,9649,0,8,1108000.0
1108,1108999,22.022976877908622,38.61780943535865,0.051368463144997656,155.37200689315796,69.95905470848083,381.6717224121094,10689,1008,9681,9681,0,8,1109000.0
1109,1109999,22.02020813385284,38.61174667257102,0.0513812958330081,155.51103591918945,70.02409315109253,381.93098068237305,10689,1008,9681,9681,0,8,1110000.0
1110,1110999,22.016297441580306,38.604079001261205,0.051363409418907824,155.66161108016968,70.0882260799408,382.08362579345703,10693,1009,9684,9684,0,8,1111000.0
1111,1111999,22.01418907029841,38.59895330925952,0.051391933900415854,155.81655526161194,70.15511918067932,382.3167533874512,10695,1010,9685,9685,0,8,1112000.0
1112,1112999,22.01463679585427,38.59850309121939,0.05137636993230266,155.99339628219604,70.2191367149353,382.4344062805176,10699,1012,9687,9687,0,8,1113000.0
1113,1113999,22.01082104903466,38.59119538636006,0.05140179106979992,156.12553763389587,70.28295111656189,382.62742614746094,10699,1012,9687,9687,0,8,1114000.0
1114,1114999,22.01074204713231,38.59070426873623,0.05140687651476916,156.28753519058228,70.34703326225281,382.90231704711914,10702,1013,9689,9689,0,8,1115000.0
1115,1115999,22.008851291627003,38.583885383967846,0.051367209522133805,156.43085360527039,70.4118058681488,383.14152908325195,10704,1014,9690,9690,0,8,1116000.0
1116,1116999,22.00687632022598,38.580291718873276,0.05134159056478571,156.5755774974823,70.47541213035583,383.3064270019531,10707,1015,9692,9692,0,8,1117000.0
1117,1117999,22.004904068358147,38.57362331975551,0.051299510024952255,156.73309087753296,70.53959965705872,383.4628562927246,10709,1016,9693,9693,0,8,1118000.0
1118,1118999,22.002867159336457,38.56690207965795,0.051261306128167816,156.91475129127502,70.60369729995728,383.76256942749023,10715,1018,9697,9697,0,8,1119000.0
1119,1119999,21.999392121233605,38.55919740654544,0.05123821071810297,157.10601258277893,70.66761183738708,383.89387130737305,10727,1021,9706,9706,0,8,1120000.0
1120,1120999,21.99653447732488,38.55224989626201,0.051229849048965215,157.28278970718384,70.73129606246948,384.073543548584,10733,1023,9710,9710,0,8,1121000.0
1121,1121999,21.992092685131862,38.54245582521458,0.05121398002277,157.45896196365356,70.7963638305664,384.3444061279297,10742,1025,9717,9717,0,8,1122000.0
1122,1122999,21.98970455288325,38.53448922356015,0.05117540567485457,157.6086664199829,70.86061358451843,384.8705863952637,10749,1026,9723,9723,0,8,1123000.0
1123,1123999,21.98573571868854,38.53229466828233,0.051145084065340796,157.7290074825287,70.92485904693604,385.3187484741211,10753,1026,9727,9727,0,8,1124000.0
1124,1124999,21.97944036128966,38.52537912737701,0.05115686943793474,157.9095799922943,70.98908424377441,385.6141128540039,10777,1028,9749,9749,0,8,1125000.0
1125,1125999,21.97429472606215,38.51801264469066,0.05119124645236783,158.0344443321228,71.05290031433105,386.0966377258301,10777,1028,9749,9749,0,8,1126000.0
1126,1126999,21.969768305086,38.513003627471456,0.051158851081838486,158.159898519516,71.11627531051636,386.3498001098633,10777,1028,9749,9749,0,8,1127000.0
1127,1127999,21.964239182347157,38.50332870602655,0.05114813504304905,158.29142355918884,71.18081998825073,386.70165252685547,10777,1028,9749,9749,0,8,1128000.0
1128,1128999,21.959777551200244,38.49319255237742,0.05114103434065764,158.4172818660736,71.24495577812195,387.03010177612305,10777,1028,9749,9749,0,8,1129000.0
1129,1129999,21.955079364883765,38.48470951774911,0.05116147112027192,158.5705807209015,71.30856919288635,387.18359375,10779,1029,9750,9750,0,8,1130000.0
1130,1130999,21.951151858717438,38.481185557073864,0.05114229246504165,158.71271657943726,71.37260341644287,387.325252532959,10781,1030,9751,9751,0,8,1131000.0
1131,1131999,21.94625291503894,38.471617280942574,0.05112508332285082,158.88437700271606,71.43679618835449,387.47270584106445,10785,1032,9753,9753,0,8,1132000.0
1132,1132999,21.941304033837312,38.461820776465046,0.05113826102132324,159.04369449615479,71.50135540962219,387.581111907959,10802,1033,9769,9769,0,8,1133000.0
1133,1133999,21.93727243719022,38.453238981847825,0.05113613877073275,159.18878841400146,71.5644679069519,387.7401580810547,10804,1034,9770,9770,0,8,1134000.0
1134,1134999,21.933278822911717,38.44486468860333,0.05112025562568212,159.3423411846161,71.6285035610199,387.956974029541,10807,1035,9772,9772,0,8,1135000.0
1135,1135999,21.930837027663262,38.43982809600177,0.05108795708285119,159.4956510066986,71.69211673736572,388.161376953125,10809,1036,9773,9773,0,8,1136000.0
1136,1136999,21.92826472678429,38.43530879441675,0.051062228176411595,159.678240776062,71.75650024414062,388.3784866333008,10813,1038,9775,9775,0,8,1137000.0
1137,1137999,21.924620448222782,38.42549016396208,0.05102810093962551,159.80571007728577,71.82061719894409,388.6287612915039,10814,1038,9776,9776,0,8,1138000.0
1138,1138999,21.923558513139945,38.42205416052799,0.05100477490518507,159.96859765052795,71.88424229621887,388.6752243041992,10823,1040,9783,9783,0,8,1139000.0
1139,1139999,21.921096543677045,38.41450046178485,0.051000940002959294,160.1361062526703,71.94779586791992,389.02341079711914,10829,1042,9787,9787,0,8,1140000.0
1140,1140999,21.920457994872073,38.4098491331265,0.050974903810955485,160.34796667099,72.01227188110352,389.2992477416992,10860,1045,9815,9815,0,8,1141000.0
1141,1141999,21.91781255855256,38.40195573654699,0.05101507251671478,160.4780478477478,72.07641363143921,389.6731491088867,10860,1045,9815,9815,0,8,1142000.0
1142,1142999,21.915826244642037,38.39512298618903,0.051013864276927,160.6320629119873,72.14128804206848,389.89460372924805,10862,1046,9816,9816,0,8,1143000.0
1143,1143999,21.91651957975495,38.3982067664961,0.05096148369830222,160.75905752182007,72.20423674583435,390.4321174621582,10863,1046,9817,9817,0,8,1144000.0
1144,1144999,21.917456156498496,38.40121651043699,0.05092790656143331,160.93030047416687,72.26824927330017,390.71755599975586,10872,1048,9824,9824,0,8,1145000.0
1145,1145999,21.917840231541124,38.400732964640035,0.05096116104092063,161.10377049446106,72.33179903030396,390.97301864624023,10911,1050,9861,9861,0,8,1146000.0
1146,1146999,21.921134473785422,38.41049920003194,0.050924581934929214,161.23702812194824,72.39586400985718,391.3640022277832,10911,1050,9861,9861,0,8,1147000.0
1147,1147999,21.92269667951711,38.4160157372553,0.05088253069226767,161.41357326507568,72.45938324928284,391.52650451660156,10944,1052,9892,9892,0,8,1148000.0
1148,1148999,21.926450780084085,38.42490486252888,0.050902262794106035,161.54052829742432,72.52259230613708,391.89265060424805,10946,1052,9894,9894,0,8,1149000.0
1149,1149999,21.93331138743615,38.439814553307706,0.05091690078720745,161.68451595306396,72.58619976043701,392.23769760131836,10949,1053,9896,9896,0,8,1150000.0
1150,1150999,21.94217699563143,38.46352663638833,0.050940665777480576,161.85771989822388,72.65743112564087,392.5611686706543,10965,1054,9911,9911,0,8,1151000.0
1151,1151999,21.948436061844,38.47192985066008,0.05106071169974613,161.9742500782013,72.72050309181213,392.8124656677246,10965,1054,9911,9911,0,8,1152000.0
1152,1152999,21.957541525987175,38.494846163771605,0.05120992500019006,162.1780970096588,72.78439688682556,392.9388847351074,11000,1057,9943,9943,0,8,1153000.0
1153,1153999,21.970153394827577,38.5202698256302,0.051400422608324,162.3539788722992,72.84774613380432,393.0371437072754,11008,1059,9949,9949,0,8,1154000.0
1154,1154999,21.98025254904806,38.538623762616176,0.05159135624083622,162.5612096786499,72.9114944934845,393.09868240356445,11020,1062,9958,9958,0,8,1155000.0
1155,1155999,21.988244357850967,38.550840657640144,0.05183667526683622,162.70980668067932,72.97575664520264,393.40425872802734,11035,1063,9972,9972,0,8,1156000.0
1156,1156999,21.998891325629,38.567997031817306,0.05204487318980311,162.83684992790222,73.03907918930054,393.74939346313477,11035,1063,9972,9972,0,8,1157000.0
1157,1157999,22.012613189777465,38.59896301565597,0.052373083589137504,163.08113646507263,73.10311222076416,393.6856346130371,11045,1068,9977,9977,0,8,1158000.0
1158,1158999,22.026335108923927,38.63010552695027,0.0526665945651531,163.25474953651428,73.16732549667358,393.9687843322754,11065,1070,9995,9995,0,8,1159000.0
1159,1159999,22.04195370830654,38.66013384866389,0.05304251888410583,163.376638174057,73.2311418056488,394.5142021179199,11065,1070,9995,9995,0,8,1160000.0
1160,1160999,22.055209650969196,38.680211641044195,0.05335228722839147,163.4984381198883,73.29499053955078,394.8765983581543,11065,1070,9995,9995,0,8,1161000.0
1161,1161999,22.068477674165987,38.699564005388474,0.05380163686126216,163.67056798934937,73.35903763771057,395.0701103210449,11069,1072,9997,9997,0,8,1162000.0
1162,1162999,22.078746105678253,38.71661011126219,0.05423424889831785,163.86819195747375,73.42252922058105,395.30744552612305,11084,1075,10009,10009,0,8,1163000.0
1163,1163999,22.079271945239412,38.723537984532065,0.054201661104894217,163.98403096199036,73.48515963554382,395.7630958557129,11085,1075,10010,10010,0,8,1164000.0
1164,1164999,22.07897437591207,38.73021102563134,0.05415945000018496,164.1038990020752,73.54840588569641,395.98405838012695,11085,1075,10010,10010,0,8,1165000.0
1165,1165999,22.08009835073766,38.733862651438045,0.05416500742128527,164.2760558128357,73.61169195175171,396.2348823547363,11088,1076,10012,10012,0,8,1166000.0
1166,1166999,22.082691652226075,38.740420771869964,0.05416644679047988,164.40904188156128,73.67471265792847,396.4673156738281,11088,1076,10012,10012,0,8,1167000.0
1167,1167999,22.08525664408282,38.75977725037906,0.05407841347272835,164.53196549415588,73.73739409446716,396.74128341674805,11088,1076,10012,10012,0,8,1168000.0
1168,1168999,22.08743597004513,38.76214693677789,0.05409540877180696,164.66008019447327,73.80104804039001,397.0149803161621,11088,1076,10012,10012,0,8,1169000.0
1169,1169999,22.092732173325842,38.772595279404555,0.05409549815168002,164.82562708854675,73.87139439582825,397.15491485595703,11090,1077,10013,10013,0,8,1170000.0
1170,1170999,22.098323490428093,38.782900169444474,0.054110332921089244,165.0055501461029,73.93507218360901,397.3434181213379,11110,1079,10031,10031,0,8,1171000.0
1171,1171999,22.10260087655874,38.789896398886086,0.054146545523958145,165.1612102985382,73.9983422756195,397.53466415405273,11112,1080,10032,10032,0,8,1172000.0
1172,1172999,22.112057959092,38.810587018707366,0.054194481071103806,165.28874039649963,74.06138920783997,397.69491958618164,11112,1080,10032,10032,0,8,1173000.0
1173,1173999,22.124209769126907,38.8366508340905,0.05431231853900231,165.44269585609436,74.12495589256287,397.77993392944336,11114,1081,10033,10033,0,8,1174000.0
1174,1174999,22.132866337859955,38.85217633785115,0.054357921538021436,165.61519026756287,74.18825602531433,397.9150047302246,11130,1083,10047,10047,0,8,1175000.0
1175,1175999,22.142562440467927,38.87266880984819,0.05452886343701435,165.74377417564392,74.25231957435608,398.1517562866211,11131,1083,10048,10048,0,8,1176000.0
1176,1176999,22.153190302500743,38.894822079965216,0.0546029685783499,165.89962697029114,74.31676054000854,398.4136505126953,11133,1084,10049,10049,0,8,1177000.0
1177,1177999,22.1669958766907,38.92677314136303,0.05482112030353692,166.08145236968994,74.38100552558899,398.6474151611328,11151,1086,10065,10065,0,8,1178000.0
1178,1178999,22.17571958023998,38.93936603536669,0.05493902629094227,166.25121569633484,74.44447803497314,398.8605308532715,11155,1088,10067,10067,0,8,1179000.0
1179,1179999,22.186367360698295,38.96188794161902,0.05508358939446678,166.45764303207397,74.50929713249207,399.0360336303711,11177,1091,10086,10086,0,8,1180000.0
1180,1180999,22.200027544728993,38.985485233882336,0.05532634468258346,166.60967469215393,74.57254219055176,399.4317092895508,11182,1092,10090,10090,0,8,1181000.0
1181,1181999,22.209485373191587,38.99678110076097,0.05549669714960115,166.75075960159302,74.63602423667908,399.7122039794922,11185,1093,10092,10092,0,8,1182000.0
1182,1182999,22.215323356918578,39.00449095151426,0.055616996455498446,166.94270300865173,74.70783162117004,399.887638092041,11191,1095,10096,10096,0,8,1183000.0
1183,1183999,22.214762408401093,39.008383090176686,0.05554803669679709,167.08806467056274,74.77065563201904,400.50865173339844,11198,1096,10102,10102,0,8,1184000.0
1184,1184999,22.213614385856296,39.006330624901295,0.055550748373622505,167.2090711593628,74.83481097221375,400.9107780456543,11198,1096,10102,10102,0,8,1185000.0
1185,1185999,22.212223641908494,39.00568844500898,0.05554843505514884,167.40082001686096,74.89878058433533,401.2514457702637,11235,1099,10136,10136,0,8,1186000.0
1186,1186999,22.21144695031379,39.00347843096115,0.0555413474337626,167.53610849380493,74.96333122253418,401.6209907531738,11235,1099,10136,10136,0,8,1187000.0
1187,1187999,22.209457126261402,38.99840225234828,0.05557518326401334,167.6948013305664,75.02737808227539,401.88894271850586,11240,1100,10140,10140,0,8,1188000.0
1188,1188999,22.2072704951679,38.99232748943832,0.05557699857798104,167.82783222198486,75.09075856208801,402.31192779541016,11242,1100,10142,10142,0,8,1189000.0
1189,1189999,22.205409142493913,38.98851570849027,0.05557535979014172,167.95100688934326,75.15411305427551,402.5287780761719,11242,1100,10142,10142,0,8,1190000.0
1190,1190999,22.204657109838305,38.98666313813814,0.055556634825585816,168.0711317062378,75.21703815460205,402.7643737792969,11242,1100,10142,10142,0,8,1191000.0
1191,1191999,22.204146446017223,38.992165992389516,0.055535382848970194,168.26774883270264,75.28074502944946,402.87093353271484,11255,1103,10152,10152,0,8,1192000.0
1192,1192999,22.202760298773644,38.98677940980515,0.05555319574538986,168.3905680179596,75.34398818016052,403.1261329650879,11256,1103,10153,10153,0,8,1193000.0
1193,1193999,22.20219246935807,38.98251100325,0.05555001240389301,168.54321789741516,75.40746688842773,403.34975814819336,11283,1104,10179,10179,0,8,1194000.0
1194,1194999,22.201998492559856,38.9784188023052,0.05554344218033247,168.6892912387848,75.47152018547058,403.5288848876953,11310,1105,10205,10205,0,8,1195000.0
1195,1195999,22.201053605448703,38.972761785261596,0.05555107719009267,168.8333342075348,75.53512501716614,403.7841262817383,11310,1105,10205,10205,0,8,1196000.0
1196,1196999,22.201564189963378,38.96890571492249,0.055562563555516475,168.98962950706482,75.59944319725037,403.92614364624023,11317,1106,10211,10211,0,8,1197000.0
1197,1197999,22.20087661900622,38.96229629251553,0.05555621301604252,169.1184265613556,75.6625645160675,404.24157333374023,11318,1106,10212,10212,0,8,1198000.0
1198,1198999,22.20023936613748,38.95660683391313,0.05555870766424631,169.26668620109558,75.72591543197632,404.4674987792969,11323,1107,10216,10216,0,8,1199000.0
1199,1199999,22.200160498421553,38.95239561845985,0.055548541218803815,169.42600870132446,75.78977751731873,404.6599998474121,11331,1108,10223,10223,0,8,1200000.0
1200,1200999,22.197530784758516,38.951916806459884,0.05552053090018361,169.54863619804382,75.85273337364197,405.08802032470703,11332,1108,10224,10224,0,8,1201000.0
1201,1201999,22.195269948986486,38.958762411243406,0.05546402491571811,169.7106637954712,75.91713285446167,405.3813362121582,11339,1109,10230,10230,0,8,1202000.0
1202,1202999,22.192319997989106,38.95464890711517,0.05546108023627927,169.84637904167175,75.98081731796265,405.7333526611328,11339,1109,10230,10230,0,8,1203000.0
1203,1203999,22.188455223884368,38.94632365163891,0.05547318616305019,170.00257468223572,76.04407167434692,405.93968963623047,11358,1110,10248,10248,0,8,1204000.0
1204,1204999,22.1845385936529,38.94151466234671,0.05548205379668114,170.14047169685364,76.1090157032013,406.2487678527832,11358,1110,10248,10248,0,8,1205000.0
1205,1205999,22.18162093540182,38.93513209684385,0.05546381396611755,170.25617623329163,76.17188096046448,406.4960250854492,11358,1110,10248,10248,0,8,1206000.0
1206,1206999,22.177400094453628,38.92646164854964,0.055461032598075,170.38345289230347,76.23835349082947,406.6623764038086,11358,1110,10248,10248,0,8,1207000.0
1207,1207999,22.173151737071667,38.91663870200858,0.0554403523590814,170.50164914131165,76.30157899856567,406.7821159362793,11358,1110,10248,10248,0,8,1208000.0
1208,1208999,22.16958459344304,38.90758256226293,0.05543046724655454,170.62518668174744,76.36481499671936,406.93674087524414,11358,1110,10248,10248,0,8,1209000.0
1209,1209999,22.16587034891023,38.89813440596393,0.05540317201160472,170.7429530620575,76.42739295959473,407.026611328125,11358,1110,10248,10248,0,8,1210000.0
1210,1210999,22.16289969317302,38.890225102886724,0.055358742833368946,170.85635113716125,76.48986840248108,407.1672592163086,11358,1110,10248,10248,0,8,1211000.0
1211,1211999,22.159840442126296,38.88300928985069,0.05533698590125857,170.99930691719055,76.55306577682495,407.30751037597656,11358,1110,10248,10248,0,8,1212000.0
1212,1212999,22.158204918317807,38.87788453857312,0.05529373556657269,171.15416288375854,76.61624574661255,407.38720703125,11360,1111,10249,10249,0,8,1213000.0
1213,1213999,22.156688325065513,38.873882390920215,0.05525349192526097,171.36205530166626,76.6831591129303,407.41112899780273,11389,1114,10275,10275,0,8,1214000.0
1214,1214999,22.1563680134717,38.86982020957823,0.05520227844176662,171.5273163318634,76.7461621761322,407.49100494384766,11451,1116,10335,10335,0,8,1215000.0
1215,1215999,22.155652334496455,38.86416071103603,0.05517947201598894,171.7339825630188,76.80968928337097,407.5296516418457,11487,1119,10368,10368,0,8,1216000.0
1216,1216999,22.155785028541093,38.861061204548626,0.055129771777746917,171.91142082214355,76.87328362464905,407.7420654296875,11504,1121,10383,10383,0,8,1217000.0
1217,1217999,22.15536227394743,38.855763667199874,0.05508812028143295,172.1102809906006,76.93688154220581,407.86023330688477,11508,1123,10385,10385,0,8,1218000.0
1218,1218999,22.155089283329026,38.85050120273214,0.05505561924482749,172.26343822479248,77.00030827522278,408.0498924255371,11510,1124,10386,10386,0,8,1219000.0
1219,1219999,22.15480413475967,38.84548438225212,0.05502172434062913,172.40321803092957,77.06321835517883,408.1989212036133,11516,1125,10391,10391,0,8,1220000.0
1220,1220999,22.153058510560545,38.84350396050082,0.054951755564024984,172.53842639923096,77.1260097026825,408.65455627441406,11517,1125,10392,10392,0,8,1221000.0
1221,1221999,22.14949086632694,38.83629886769626,0.054912767016695674,172.66630220413208,77.19047355651855,408.93280029296875,11517,1125,10392,10392,0,8,1222000.0
1222,1222999,22.14639782475582,38.83025948520237,0.054880100383534525,172.79773497581482,77.25415706634521,409.2222480773926,11517,1125,10392,10392,0,8,1223000.0
1223,1223999,22.14327458177152,38.82130169834053,0.054843175452033543,172.92721724510193,77.31845664978027,409.59502029418945,11518,1125,10393,10393,0,8,1224000.0
1224,1224999,22.140073354633216,38.8129695789104,0.05480330601341743,173.08344292640686,77.38268184661865,409.89991760253906,11535,1126,10409,10409,0,8,1225000.0
1225,1225999,22.136893283018967,38.80355830118592,0.05478001292031165,173.20811200141907,77.44640231132507,410.1725730895996,11535,1126,10409,10409,0,8,1226000.0
1226,1226999,22.135395471671742,38.79684849724055,0.05473504262486717,173.36041688919067,77.51067757606506,410.4190444946289,11566,1127,10439,10439,0,8,1227000.0
1227,1227999,22.133305231315642,38.788081537218574,0.054686317915599636,173.48496413230896,77.574716091156,410.5657539367676,11566,1127,10439,10439,0,8,1228000.0
1228,1228999,22.13155495655367,38.78345130655138,0.054647314324045015,173.60053992271423,77.63785672187805,410.6760482788086,11566,1127,10439,10439,0,8,1229000.0
1229,1229999,22.129757186912972,38.77480052349807,0.0546195374156202,173.75176239013672,77.70102334022522,410.8251762390137,11569,1128,10441,10441,0,8,1230000.0
1230,1230999,22.131163620534366,38.77237192463147,0.054572631912294556,173.92190670967102,77.76454210281372,410.8213233947754,11572,1129,10443,10443,0,8,1231000.0
1231,1231999,22.13183656779843,38.77059217318901,0.054533334843763215,174.04408717155457,77.82812476158142,411.03369522094727,11572,1129,10443,10443,0,8,1232000.0
1232,1232999,22.13163851902435,38.76535194922842,0.05452731449218806,174.2049663066864,77.8921868801117,411.15071868896484,11579,1130,10449,10449,0,8,1233000.0
1233,1233999,22.13195356289692,38.76174007728292,0.054502650314156575,174.32252383232117,77.95565819740295,411.3047409057617,11579,1130,10449,10449,0,8,1234000.0
1234,1234999,22.13281398795337,38.760339395354805,0.05448503581227748,174.46844124794006,78.01900720596313,411.4676971435547,11581,1131,10450,10450,0,8,1235000.0
1235,1235999,22.135788265528618,38.76178888788118,0.054465231289102634,174.58806014060974,78.08200001716614,411.5963592529297,11581,1131,10450,10450,0,8,1236000.0
1236,1236999,22.137399495425786,38.7597463994365,0.05446231931884793,174.70733380317688,78.14570331573486,411.75896072387695,11581,1131,10450,10450,0,8,1237000.0
1237,1237999,22.13927882957243,38.756819448786196,0.05446294259471618,174.83215737342834,78.20882058143616,411.8932418823242,11581,1131,10450,10450,0,8,1238000.0
1238,1238999,22.141059805070157,38.75512929165544,0.054494601627871564,174.99931406974792,78.27243137359619,412.00933837890625,11583,1132,10451,10451,0,8,1239000.0
1239,1239999,22.142122524264604,38.7513834320067,0.05453708429325277,175.14760327339172,78.33583307266235,412.1262550354004,11588,1133,10455,10455,0,8,1240000.0
1240,1240999,22.143166140024487,38.75403242456645,0.054541033174803855,175.27483820915222,78.39857411384583,412.2496032714844,11588,1133,10455,10455,0,8,1241000.0
1241,1241999,22.14058284420295,38.746917719035565,0.054495632934454585,175.39687752723694,78.46229958534241,412.67971420288086,11590,1133,10457,10457,0,8,1242000.0
1242,1242999,22.136588332312208,38.739251572184834,0.054478019875273676,175.54428029060364,78.52540159225464,412.8830261230469,11595,1134,10461,10461,0,8,1243000.0
1243,1243999,22.1319804665007,38.73009707056303,0.05447402162792658,175.67332100868225,78.58902406692505,413.2520637512207,11596,1134,10462,10462,0,8,1244000.0
1244,1244999,22.128590018130488,38.722659940292424,0.054433519756835524,175.84011793136597,78.65350556373596,413.5243797302246,11600,1135,10465,10465,0,8,1245000.0
1245,1245999,22.125187981491727,38.71368060639361,0.05440526311257332,175.95698976516724,78.71666312217712,413.8724136352539,11600,1135,10465,10465,0,8,1246000.0
1246,1246999,22.121503569258444,38.70566553740577,0.05436843343018505,176.10029482841492,78.78102684020996,414.1069145202637,11600,1135,10465,10465,0,8,1247000.0
1247,1247999,22.11915631840945,38.69807831367937,0.05433479540980357,176.22306489944458,78.84552669525146,414.3804054260254,11600,1135,10465,10465,0,8,1248000.0
1248,1248999,22.116874134932058,38.690571750069275,0.054303776330475007,176.3646650314331,78.90896224975586,414.5069465637207,11604,1136,10468,10468,0,8,1249000.0
1249,1249999,22.114413426406745,38.68291042723861,0.05426774860414085,176.4853687286377,78.97203755378723,414.66962814331055,11604,1136,10468,10468,0,8,1250000.0
1250,1250999,22.112638958467603,38.67864809220711,0.0542297922013244,176.6465356349945,79.03583550453186,414.8680610656738,11611,1137,10474,10474,0,8,1251000.0
1251,1251999,22.111476607158426,38.67233508577488,0.05419374395920151,176.7949550151825,79.0991153717041,414.91018295288086,11613,1138,10475,10475,0,8,1252000.0
1252,1252999,22.110027362494044,38.66698930993249,0.054159481679128985,176.94273138046265,79.16317296028137,415.06629180908203,11641,1139,10502,10502,0,8,1253000.0
1253,1253999,22.108160757340507,38.661928047200675,0.054139062151756345,177.07752680778503,79.22701716423035,415.2660484313965,11641,1139,10502,10502,0,8,1254000.0
1254,1254999,22.106806627833475,38.65630892671641,0.05410919536886727,177.23134541511536,79.29049634933472,415.3826713562012,11643,1140,10503,10503,0,8,1255000.0
1255,1255999,22.107169666193325,38.65299413873909,0.05406933864874819,177.40893745422363,79.35412645339966,415.4372978210449,11647,1142,10505,10505,0,8,1256000.0
1256,1256999,22.10750215816409,38.661420212676205,0.054026808228209156,177.53862500190735,79.41797518730164,415.58860778808594,11647,1142,10505,10505,0,8,1257000.0
1257,1257999,22.10746738035134,38.656992135203765,0.05401522394123237,177.6570589542389,79.48185324668884,415.8092956542969,11647,1142,10505,10505,0,8,1258000.0
1258,1258999,22.1074620292959,38.65274483139997,0.054003971690724795,177.79799914360046,79.5455117225647,415.90708923339844,11649,1143,10506,10506,0,8,1259000.0
1259,1259999,22.10771182349856,38.648037777503966,0.05399179109436869,177.948171377182,79.6084554195404,416.03528213500977,11651,1144,10507,10507,0,8,1260000.0
1260,1260999,22.107164069045012,38.642366751298255,0.053988996368658504,178.07306933403015,79.67276954650879,416.25157165527344,11651,1144,10507,10507,0,8,1261000.0
1261,1261999,22.10499834293573,38.63514635779847,0.05400682829264136,178.19804334640503,79.73648762702942,416.5824089050293,11651,1144,10507,10507,0,8,1262000.0
1262,1262999,22.10094748326199,38.62752451738589,0.05402963015396556,178.3301773071289,79.80023956298828,416.97998046875,11653,1144,10509,10509,0,8,1263000.0
1263,1263999,22.097312360439194,38.62038161605147,0.05404809727923576,178.45256733894348,79.86379218101501,417.2698860168457,11653,1144,10509,10509,0,8,1264000.0
1264,1264999,22.094707827058006,38.61372057526832,0.05407910763526358,178.6218991279602,79.92798328399658,417.582218170166,11657,1145,10512,10512,0,8,1265000.0
1265,1265999,22.095041348879242,38.61327927924277,0.05407506325901379,178.80218482017517,79.9938895702362,417.8215560913086,11666,1147,10519,10519,0,8,1266000.0
1266,1266999,22.09691881771118,38.61476221470825,0.05409300670521999,178.9250192642212,80.05716872215271,418.1554260253906,11666,1147,10519,10519,0,8,1267000.0
1267,1267999,22.098326374233256,38.615773217273826,0.05411168023056312,179.10043501853943,80.12172102928162,418.3927345275879,11681,1149,10532,10532,0,8,1268000.0
1268,1268999,22.100319956630607,38.61773336565465,0.05409612131801156,179.25143551826477,80.18663382530212,418.7183723449707,11700,1150,10550,10550,0,8,1269000.0
1269,1269999,22.10273584409671,38.61969224330907,0.05410413210797582,179.3691041469574,80.2494637966156,418.91939544677734,11700,1150,10550,10550,0,8,1270000.0
1270,1270999,22.10518578084102,38.62190131227946,0.05410619297792063,179.52304196357727,80.31321167945862,419.0851821899414,11705,1151,10554,10554,0,8,1271000.0
1271,1271999,22.109102390542922,38.62624163271998,0.054079054945992966,179.64038825035095,80.37601900100708,419.2144966125488,11705,1151,10554,10554,0,8,1272000.0
1272,1272999,22.112134789501013,38.63030768715126,0.05410084074454802,179.79187083244324,80.43982410430908,419.3431968688965,11710,1152,10558,10558,0,8,1273000.0
1273,1273999,22.11450825736156,38.63146327728887,0.05411330228683664,179.92327332496643,80.50357818603516,419.5367126464844,11710,1152,10558,10558,0,8,1274000.0
1274,1274999,22.117662295370305,38.63271235003268,0.0541437808987687,180.07079553604126,80.56697487831116,419.6635856628418,11712,1153,10559,10559,0,8,1275000.0
1275,1275999,22.121228752155833,38.63579758040537,0.054143412128949575,180.20182728767395,80.63033413887024,419.8673515319824,11712,1153,10559,10559,0,8,1276000.0
1276,1276999,22.124934372610397,38.63829221804093,0.05418257643554514,180.3281021118164,80.69344449043274,420.01292419433594,11712,1153,10559,10559,0,8,1277000.0
1277,1277999,22.129509808470463,38.64596405167489,0.054193944913515035,180.44385075569153,80.75732779502869,420.134464263916,11712,1153,10559,10559,0,8,1278000.0
1278,1278999,22.134031919927104,38.65378642450992,0.05418016880174448,180.61146712303162,80.82142782211304,420.28493881225586,11745,1155,10590,10590,0,8,1279000.0
1279,1279999,22.137031183720442,38.655195482900346,0.054207136200790984,180.8252923488617,80.88541197776794,420.26756286621094,11756,1158,10598,10598,0,8,1280000.0
1280,1280999,22.139989138533917,38.65586615997039,0.05427090260248035,180.9504587650299,80.94852805137634,420.5460014343262,11756,1158,10598,10598,0,8,1281000.0
1281,1281999,22.140650707753014,38.65284702343937,0.05430666489422531,181.07788944244385,81.01245498657227,420.7463798522949,11756,1158,10598,10598,0,8,1282000.0
1282,1282999,22.13904379291607,38.64685937969753,0.054268718665339666,181.247052192688,81.07688617706299,421.1029472351074,11789,1160,10629,10629,0,8,1283000.0
1283,1283999,22.13384826524962,38.63930308842507,0.05426953586735439,181.38586854934692,81.140634059906,421.48902130126953,11789,1160,10629,10629,0,8,1284000.0
1284,1284999,22.128059717956113,38.63138097867581,0.0542603694378988,181.53972697257996,81.20446467399597,421.7475929260254,11791,1161,10630,10630,0,8,1285000.0
1285,1285999,22.124331761939136,38.628441225244494,0.054234701609298996,181.6755564212799,81.26991176605225,422.14655685424805,11791,1161,10630,10630,0,8,1286000.0
1286,1286999,22.119797186245567,38.618729250827485,0.05422450429346348,181.80076551437378,81.33473610877991,422.4175834655762,11792,1161,10631,10631,0,8,1287000.0
1287,1287999,22.114405448097514,38.608074101170835,0.054256520271037334,181.92612028121948,81.3981032371521,422.7154998779297,11792,1161,10631,10631,0,8,1288000.0
1288,1288999,22.110114312715393,38.5992678468129,0.0542421554095478,182.05886101722717,81.46217393875122,423.1242790222168,11792,1161,10631,10631,0,8,1289000.0
1289,1289999,22.105967968864146,38.5970589354051,0.05421297953415982,182.20483016967773,81.52572321891785,423.32557678222656,11794,1162,10632,10632,0,8,1290000.0
1290,1290999,22.101646941564724,38.58855586289376,0.05420543961223934,182.33495378494263,81.58944153785706,423.4932060241699,11794,1162,10632,10632,0,8,1291000.0
1291,1291999,22.09778775463563,38.58252370883176,0.054198479486342044,182.4875841140747,81.6531081199646,423.6105499267578,11797,1163,10634,10634,0,8,1292000.0
1292,1292999,22.095241636212155,38.581416699212554,0.05416583384250451,182.60706877708435,81.7173101902008,423.7775650024414,11797,1163,10634,10634,0,8,1293000.0
1293,1293999,22.091362639958106,38.573779545477265,0.054161737456799086,182.7325086593628,81.7807924747467,424.0287857055664,11797,1163,10634,10634,0,8,1294000.0
1294,1294999,22.087536029848057,38.5666445230043,0.05417498179384017,182.8623402118683,81.84397625923157,424.2012367248535,11797,1163,10634,10634,0,8,1295000.0
1295,1295999,22.084822544790104,38.56232937306257,0.054165200219709386,182.99057412147522,81.90737104415894,424.37331771850586,11797,1163,10634,10634,0,8,1296000.0
1296,1296999,22.08179152797002,38.55620094873831,0.054148032924563716,183.125337600708,81.97157025337219,424.5949935913086,11797,1163,10634,10634,0,8,1297000.0
1297,1297999,22.08067540189592,38.55240511254348,0.05410443037186552,183.24972701072693,82.03504824638367,424.7486000061035,11797,1163,10634,10634,0,8,1298000.0
1298,1298999,22.079073296995823,38.54693138433186,0.05407247904770163,183.38313937187195,82.09831547737122,424.87794494628906,11797,1163,10634,10634,0,8,1299000.0
1299,1299999,22.077890250841794,38.54285302564857,0.054040790476403866,183.50186610221863,82.16181445121765,425.084041595459,11797,1163,10634,10634,0,8,1300000.0
1300,1300999,22.07538528274925,38.53714214565807,0.05402417084179878,183.66068720817566,82.22550058364868,425.2050247192383,11799,1164,10635,10635,0,8,1301000.0
1301,1301999,22.07495184328832,38.534476092796936,0.05398174085865015,183.77533745765686,82.2890100479126,425.3419990539551,11799,1164,10635,10635,0,8,1302000.0
1302,1302999,22.073436872473795,38.52932702324053,0.05395614204241994,183.9284942150116,82.35236239433289,425.464412689209,11805,1165,10640,10640,0,8,1303000.0
1303,1303999,22.069553369545122,38.52095953268772,0.053955715607117316,184.1015121936798,82.41594648361206,425.7391242980957,11809,1167,10642,10642,0,8,1304000.0
1304,1304999,22.064339826595972,38.51296509598997,0.053977965702693864,184.28451824188232,82.48039841651917,425.86962509155273,11813,1169,10644,10644,0,8,1305000.0
1305,1305999,22.059325009815943,38.507819592364086,0.05398908648353884,184.41832399368286,82.54552173614502,426.12542724609375,11813,1169,10644,10644,0,8,1306000.0
1306,1306999,22.054480971348283,38.500777833466586,0.054016711093381464,184.57958245277405,82.61010193824768,426.4734344482422,11845,1170,10675,10675,0,8,1307000.0
1307,1307999,22.04940716468144,38.49180362202849,0.0540232007076793,184.75978446006775,82.67446851730347,426.5724906921387,11890,1172,10718,10718,0,8,1308000.0
1308,1308999,22.044564089967093,38.48257711483729,0.054039543983488536,184.9117193222046,82.73865795135498,426.7562942504883,11908,1173,10735,10735,0,8,1309000.0
1309,1309999,22.040216801185096,38.4729036227733,0.05405278239774336,185.03677010536194,82.80227398872375,427.059383392334,11908,1173,10735,10735,0,8,1310000.0
1310,1310999,22.03480431647758,38.46259166868255,0.05406145543001961,185.16355419158936,82.8658344745636,427.2609672546387,11908,1173,10735,10735,0,8,1311000.0
1311,1311999,22.030802506740823,38.45603808501447,0.05404775471643797,185.28500151634216,82.93078136444092,427.4556541442871,11908,1173,10735,10735,0,8,1312000.0
1312,1312999,22.026387406893644,38.44943350087493,0.054035452526246974,185.40954852104187,82.99397420883179,427.666805267334,11908,1173,10735,10735,0,8,1313000.0
1313,1313999,22.022391284063485,38.4416182351276,0.054048076101899656,185.5354664325714,83.05711507797241,427.77653884887695,11908,1173,10735,10735,0,8,1314000.0
1314,1314999,22.01826356161979,38.43290320178274,0.05404284100888401,185.69450855255127,83.12134337425232,428.0009117126465,11923,1174,10749,10749,0,8,1315000.0
1315,1315999,22.014410667135447,38.424981270399904,0.054035951226255374,185.82334923744202,83.18479323387146,428.2355155944824,11923,1174,10749,10749,0,8,1316000.0
1316,1316999,22.01051039569121,38.41639839142182,0.054031989533287694,185.9553349018097,83.2483377456665,428.45491790771484,11923,1174,10749,10749,0,8,1317000.0
1317,1317999,22.007909458158053,38.40958004626958,0.054003999035306394,186.13293051719666,83.31252455711365,428.6134796142578,11930,1176,10754,10754,0,8,1318000.0
1318,1318999,22.00577325333305,38.408527451171075,0.05399415774178962,186.254319190979,83.37565970420837,428.82806396484375,11930,1176,10754,10754,0,8,1319000.0
1319,1319999,22.004048852685553,38.40341654034294,0.053977105786484736,186.39886450767517,83.4398353099823,428.9991874694824,11937,1177,10760,10760,0,8,1320000.0
1320,1320999,22.004156152575955,38.402504550190585,0.05393735244734432,186.529878616333,83.50349068641663,429.2595520019531,11937,1177,10760,10760,0,8,1321000.0
1321,1321999,22.0037909402137,38.399383964097204,0.05390322461075692,186.6982536315918,83.56822919845581,429.50706481933594,11954,1178,10776,10776,0,8,1322000.0
1322,1322999,22.00397183608779,38.39683552007446,0.0538993011465142,186.82272005081177,83.63184404373169,429.73988342285156,11954,1178,10776,10776,0,8,1323000.0
1323,1323999,22.003009293481657,38.39359788432188,0.05387838753139229,186.94703841209412,83.6954357624054,429.93569564819336,11954,1178,10776,10776,0,8,1324000.0
1324,1324999,21.998876727679377,38.38520979611484,0.0538862546327914,187.14237332344055,83.7590503692627,430.25232315063477,11975,1180,10795,10795,0,8,1325000.0
1325,1325999,21.993879690608633,38.38601954247815,0.05388135342255984,187.26655173301697,83.8235502243042,430.8285369873047,11975,1180,10795,10795,0,8,1326000.0
1326,1326999,21.98871161140241,38.386702392155875,0.0538881832451108,187.38649129867554,83.88715481758118,431.2463569641113,11975,1180,10795,10795,0,8,1327000.0
1327,1327999,21.98247638483971,38.379109742253526,0.053922842849195574,187.51250219345093,83.95124888420105,431.6890411376953,11976,1180,10796,10796,0,8,1328000.0
1328,1328999,21.977085804257243,38.37394637681482,0.0539322822136431,187.64567518234253,84.01644611358643,432.0911865234375,11976,1180,10796,10796,0,8,1329000.0
1329,1329999,21.97072887067012,38.364204005899325,0.05396490322416192,187.79593515396118,84.08020043373108,432.3638801574707,12007,1181,10826,10826,0,8,1330000.0
1330,1330999,21.965071524902573,38.35505861376415,0.05398204417784358,187.94266748428345,84.14346957206726,432.64737701416016,12013,1182,10831,10831,0,8,1331000.0
1331,1331999,21.958505193977324,38.34578233002224,0.054007387818372776,188.10472130775452,84.20766854286194,432.81888580322266,12027,1183,10844,10844,0,8,1332000.0
1332,1332999,21.95240321474087,38.335658827048334,0.05403138660247475,188.23388195037842,84.2714409828186,433.1156578063965,12027,1183,10844,10844,0,8,1333000.0
1333,1333999,21.946818347814304,38.32694237584105,0.054044456420341835,188.3650667667389,84.33522486686707,433.37167739868164,12027,1183,10844,10844,0,8,1334000.0
1334,1334999,21.942504321436033,38.321562342082494,0.05403891552147799,188.49410891532898,84.39856886863708,433.64291763305664,12027,1183,10844,10844,0,8,1335000.0
1335,1335999,21.939097103978316,38.3199194021465,0.0540203406274814,188.61503267288208,84.46209168434143,433.8837089538574,12027,1183,10844,10844,0,8,1336000.0
1336,1336999,21.936063601959503,38.31537617065973,0.054019081116423284,188.72997903823853,84.52536654472351,434.0608825683594,12027,1183,10844,10844,0,8,1337000.0
1337,1337999,21.93280055421463,38.30991746433504,0.054017934773820886,188.84532642364502,84.58876252174377,434.33409118652344,12027,1183,10844,10844,0,8,1338000.0
1338,1338999,21.93212249172565,38.30933928616907,0.053998017653276276,188.9956500530243,84.65284991264343,434.50793075561523,12032,1184,10848,10848,0,8,1339000.0
1339,1339999,21.93095314094292,38.3104528538587,0.05397221087792681,189.17345523834229,84.71729850769043,434.6933059692383,12044,1186,10858,10858,0,8,1340000.0
1340,1340999,21.92890245778321,38.30738675677787,0.05395808149878567,189.29895329475403,84.78065037727356,434.9175262451172,12044,1186,10858,10858,0,8,1341000.0
1341,1341999,21.9261500715377,38.30085311038351,0.053953756946484965,189.43688464164734,84.84377646446228,435.0820426940918,12044,1186,10858,10858,0,8,1342000.0
1342,1342999,21.92245049214813,38.293641098549145,0.053946756178784305,189.55879497528076,84.90908741950989,435.6018409729004,12048,1186,10862,10862,0,8,1343000.0
1343,1343999,21.91752347131766,38.28714803604341,0.05395031206709344,189.6849467754364,84.97415971755981,436.11373138427734,12050,1186,10864,10864,0,8,1344000.0
1344,1344999,21.91240210531715,38.279271354074666,0.053974847330379716,189.81870484352112,85.03902292251587,436.5404930114746,12052,1186,10866,10866,0,8,1345000.0
1345,1345999,21.90871972289358,38.27905674073701,0.053949274442832484,189.97580766677856,86.35553503036499,436.9703674316406,12067,1187,10880,10880,0,8,1346000.0
1346,1346999,21.9050687366969,38.27186483793127,0.05396250190806384,190.10989499092102,86.42040729522705,437.3647041320801,12068,1187,10881,10881,0,8,1347000.0
1347,1347999,21.902085198006173,38.26504997160989,0.05395429714264621,190.23304677009583,86.48472261428833,437.73485565185547,12070,1187,10883,10883,0,8,1348000.0
1348,1348999,21.89848492636434,38.25809483906429,0.053938079676519646,190.36443996429443,86.54939031600952,438.03607177734375,12074,1187,10887,10887,0,8,1349000.0
1349,1349999,21.896179414591785,38.256724901186345,0.05387102207138117,190.4874382019043,86.61303377151489,438.2346611022949,12076,1187,10889,10889,0,8,1350000.0
1350,1350999,21.89419555936278,38.25673059225179,0.053840407813582014,190.67475199699402,86.67744851112366,438.34102630615234,12097,1189,10908,10908,0,8,1351000.0
1351,1351999,21.891963602408772,38.2519591972869,0.05376919200016694,190.79850006103516,86.74121737480164,438.5096435546875,12097,1189,10908,10908,0,8,1352000.0
1352,1352999,21.88856728256475,38.24469324440612,0.05375256924190219,190.93172979354858,86.80540013313293,438.6991844177246,12097,1189,10908,10908,0,8,1353000.0
1353,1353999,21.886472526312968,38.24097005884401,0.05373141930636949,191.0638403892517,86.86930131912231,438.85496520996094,12097,1189,10908,10908,0,8,1354000.0
1354,1354999,21.88561682891704,38.247495652688976,0.053691829959017556,191.24958539009094,86.93417239189148,438.9242362976074,12114,1191,10923,10923,0,8,1355000.0
1355,1355999,21.884809319168628,38.243443914716515,0.0536472976942165,191.40515899658203,86.9984245300293,439.23250579833984,12128,1192,10936,10936,0,8,1356000.0
1356,1356999,21.883774074159096,38.23949424652699,0.053605080768541646,191.52819967269897,87.06407904624939,439.4856376647949,12128,1192,10936,10936,0,8,1357000.0
1357,1357999,21.885269192093496,38.247379006327925,0.05350811059266125,191.7171654701233,87.12867259979248,439.6648063659668,12174,1194,10980,10980,0,8,1358000.0
1358,1358999,21.885170505662725,38.24469775217988,0.053463477963141326,191.84293794631958,87.19430708885193,439.98768615722656,12177,1194,10983,10983,0,8,1359000.0
1359,1359999,21.88550029085374,38.24259242428366,0.05339175628561654,192.0030870437622,87.26074862480164,440.09828186035156,12179,1195,10984,10984,0,8,1360000.0
1360,1360999,21.88573578174024,38.23915098615324,0.05333330898032029,192.17430520057678,87.32486748695374,440.2203903198242,12183,1196,10987,10987,0,8,1361000.0
1361,1361999,21.884842668406847,38.233771713092146,0.05328935746890828,192.2987871170044,87.38867735862732,440.5079040527344,12183,1196,10987,10987,0,8,1362000.0
1362,1362999,21.886261483679778,38.2330986388538,0.05317575667976315,192.46871757507324,87.45304155349731,440.97785568237305,12187,1197,10990,10990,0,8,1363000.0
1363,1363999,21.88482371712273,38.22992978937324,0.05307540675312028,192.59221744537354,87.5171799659729,441.34165954589844,12188,1197,10991,10991,0,8,1364000.0
1364,1364999,21.884564267658792,38.22996694706597,0.05299856734492847,192.71577882766724,87.58286738395691,441.7769889831543,12188,1197,10991,10991,0,8,1365000.0
1365,1365999,21.88439234649402,38.22838404837441,0.05291783355088675,192.87042260169983,87.64762783050537,442.14279556274414,12191,1198,10993,10993,0,8,1366000.0
1366,1366999,21.88411182877804,38.22594775256306,0.0528640149760633,192.9970531463623,87.71392178535461,442.42165756225586,12191,1198,10993,10993,0,8,1367000.0
1367,1367999,21.886209597641773,38.22826177509991,0.05281001509262084,193.15069580078125,87.77833294868469,442.66875076293945,12194,1199,10995,10995,0,8,1368000.0
1368,1368999,21.887182478854356,38.22723493103881,0.052732841676588094,193.3730592727661,87.84381794929504,442.9458427429199,12213,1202,11011,11011,0,8,1369000.0
1369,1369999,21.888800304607013,38.22800549997071,0.05265489354279351,193.52923965454102,87.90904331207275,443.11478424072266,12229,1203,11026,11026,0,8,1370000.0
1370,1370999,21.89044620570465,38.22627484314033,0.05258341390077459,193.68464946746826,87.97338819503784,443.4918327331543,12231,1204,11027,11027,0,8,1371000.0
1371,1371999,21.891381339595565,38.223399410422246,0.05249333966138048,193.814772605896,88.03806853294373,443.78692626953125,12231,1204,11027,11027,0,8,1372000.0
1372,1372999,21.893813497848534,38.22397281227153,0.05238387228097319,193.93995070457458,88.10201692581177,444.00292587280273,12231,1204,11027,11027,0,8,1373000.0
1373,1373999,21.89557730050085,38.22243116841078,0.05225811412470949,194.06797623634338,88.16607284545898,444.3009147644043,12231,1204,11027,11027,0,8,1374000.0
1374,1374999,21.897526176588883,38.22259859192493,0.05217196864657592,194.19001936912537,88.23002505302429,444.4985466003418,12231,1204,11027,11027,0,8,1375000.0
1375,1375999,21.898240618553878,38.21761508337586,0.052083298434838166,194.31710600852966,88.29422283172607,444.74763107299805,12231,1204,11027,11027,0,8,1376000.0
1376,1376999,21.89942948343134,38.2148952870009,0.05198914273126609,194.4417986869812,88.35860395431519,445.0369186401367,12231,1204,11027,11027,0,8,1377000.0
1377,1377999,21.901880718964076,38.21307897074532,0.05188816876169555,194.5923731327057,88.42237710952759,445.21512603759766,12235,1205,11030,11030,0,8,1378000.0
1378,1378999,21.905292295234787,38.214126859752085,0.05174568831552284,194.74133110046387,88.48768401145935,445.44003677368164,12249,1206,11043,11043,0,8,1379000.0
1379,1379999,21.907526314659084,38.21098674717212,0.05162673828536801,194.86531257629395,88.5536892414093,445.71338653564453,12250,1206,11044,11044,0,8,1380000.0
1380,1380999,21.909695950219128,38.207548453637976,0.05153960941169822,195.02411794662476,88.61861515045166,445.8569679260254,12252,1207,11045,11045,0,8,1381000.0
1381,1381999,21.90999015420365,38.201981044830596,0.051443649750508746,195.21251392364502,88.68246698379517,445.96270751953125,12264,1209,11055,11055,0,8,1382000.0
1382,1382999,21.909783390065154,38.19547135850597,0.051374693182052455,195.33276438713074,88.74669241905212,446.1512985229492,12264,1209,11055,11055,0,8,1383000.0
1383,1383999,21.90811464339088,38.190946308976784,0.05131808997700693,195.54704093933105,88.81049084663391,446.5707588195801,12287,1212,11075,11075,0,8,1384000.0
1384,1384999,21.905887638546687,38.183435506547454,0.051287349629647205,195.77204608917236,88.87426328659058,446.69822692871094,12293,1215,11078,11078,0,8,1385000.0
1385,1385999,21.903939504218073,38.17748094253794,0.05124270225144101,195.92818927764893,88.93810033798218,447.0668830871582,12295,1216,11079,11079,0,8,1386000.0
1386,1386999,21.90265755201928,38.173394537411376,0.05117546942786977,196.05015754699707,89.00234794616699,447.3915557861328,12295,1216,11079,11079,0,8,1387000.0
1387,1387999,21.90063043137558,38.16553155945065,0.05113430620337278,196.17943453788757,89.06617450714111,447.6483573913574,12295,1216,11079,11079,0,8,1388000.0
1388,1388999,21.89915352048071,38.159257514612335,0.05109683256121034,196.3350052833557,89.13078474998474,447.9835014343262,12298,1217,11081,11081,0,8,1389000.0
1389,1389999,21.896676340258388,38.15122801516273,0.051071953498377676,196.45700860023499,89.19456720352173,448.33966064453125,12298,1217,11081,11081,0,8,1390000.0
1390,1390999,21.894516623175303,38.143384695783766,0.051046565087665585,196.65713691711426,89.25877141952515,448.38681411743164,12304,1220,11084,11084,0,8,1391000.0
1391,1391999,21.892576928775103,38.13678571108036,0.05101755302968036,196.78217911720276,89.3223488330841,448.62454986572266,12304,1220,11084,11084,0,8,1392000.0
1392,1392999,21.890861700906967,38.129472776399105,0.05098756729128895,196.9364936351776,89.38748717308044,448.8239288330078,12306,1221,11085,11085,0,8,1393000.0
1393,1393999,21.889553807510254,38.12369133067318,0.05092495539929387,197.0942199230194,89.45079183578491,448.9852828979492,12311,1222,11089,11089,0,8,1394000.0
1394,1394999,21.889923071559515,38.12128431628501,0.05085283615032088,197.23903250694275,89.51469993591309,449.1771583557129,12314,1223,11091,11091,0,8,1395000.0
1395,1395999,21.891408853053758,38.123872201613466,0.05081647926252231,197.41724228858948,89.57933950424194,449.37824630737305,12317,1224,11093,11093,0,8,1396000.0
1396,1396999,21.895692436539235,38.13221132092523,0.05074792583902077,197.56491947174072,89.64313387870789,449.52045822143555,12323,1225,11098,11098,0,8,1397000.0
1397,1397999,21.900548519532645,38.141256708867765,0.050730179247543195,197.68073272705078,89.70650959014893,449.83942794799805,12324,1225,11099,11099,0,8,1398000.0
1398,1398999,21.906197563240873,38.15078377535417,0.050704082836772524,197.8510184288025,89.77052903175354,450.00117111206055,12331,1227,11104,11104,0,8,1399000.0
1399,1399999,21.91047125828466,38.15395668238247,0.05068366481343012,198.00518608093262,89.83515071868896,450.17070388793945,12333,1228,11105,11105,0,8,1400000.0
1400,1400999,21.91728529353111,38.16361592844513,0.05065655775306055,198.15484428405762,89.89954042434692,450.43836975097656,12337,1229,11108,11108,0,8,1401000.0
1401,1401999,21.921612913168158,38.16603824983015,0.05060848969548293,198.29854583740234,89.96313977241516,450.7024269104004,12340,1230,11110,11110,0,8,1402000.0
1402,1402999,21.926052861769385,38.168444840772885,0.050610393959976796,198.5663754940033,90.02886772155762,450.73849868774414,12375,1235,11140,11140,0,8,1403000.0
1403,1403999,21.928636616205832,38.171090278286734,0.050611516367995435,198.6961314678192,90.09225082397461,451.0606155395508,12377,1235,11142,11142,0,8,1404000.0
1404,1404999,21.930453216275772,38.169444518119874,0.05031014862910477,198.82096004486084,90.1562385559082,451.7283134460449,12379,1235,11144,11144,0,8,1405000.0
1405,1405999,21.93154436789694,38.16533101342728,0.05009871147346201,198.9553108215332,90.21966481208801,452.047794342041,12379,1235,11144,11144,0,8,1406000.0
1406,1406999,21.93240611742224,38.16006742087398,0.04992651606591825,199.13068675994873,90.28475069999695,452.3133964538574,12412,1237,11175,11175,0,8,1407000.0
1407,1407999,21.933379977705744,38.156089789553896,0.049753890567924675,199.31857228279114,90.34970092773438,452.47604751586914,12418,1239,11179,11179,0,8,1408000.0
1408,1408999,21.933450374382517,38.15083346360799,0.049602390317420086,199.44035124778748,90.4133505821228,452.76729583740234,12418,1239,11179,11179,0,8,1409000.0
1409,1409999,21.9336013750902,38.146521987387345,0.04944173118898265,199.5948748588562,90.47824835777283,453.09123611450195,12422,1240,11182,11182,0,8,1410000.0
1410,1410999,21.932945508165798,38.140315519942014,0.04932337006094656,199.80865287780762,90.54273343086243,453.2269592285156,12429,1243,11186,11186,0,8,1411000.0
1411,1411999,21.93279570987112,38.13526322945571,0.0492262835078594,199.93465781211853,90.60656189918518,453.54426193237305,12429,1243,11186,11186,0,8,1412000.0
1412,1412999,21.93339774690777,38.13255628204358,0.049091539143257035,200.08530449867249,90.67332792282104,453.7271385192871,12431,1244,11187,11187,0,8,1413000.0
1413,1413999,21.933936566678874,38.13028021976476,0.04897373926951709,200.23235964775085,90.74479961395264,453.9676322937012,12431,1244,11187,11187,0,8,1414000.0
1414,1414999,21.937869801192946,38.14005211334959,0.04891367084509313,200.43501257896423,90.81409358978271,453.9806213378906,12436,1246,11190,11190,0,8,1415000.0
1415,1415999,21.941972667263762,38.15503035616706,0.048827532213631675,200.58655047416687,90.8784704208374,454.20283126831055,12439,1247,11192,11192,0,8,1416000.0
1416,1416999,21.945974500380345,38.16007767267281,0.04873697662865051,200.72681522369385,90.9494276046753,454.4236030578613,12439,1247,11192,11192,0,8,1417000.0
1417,1417999,21.951178744372108,38.171881304763275,0.04867732274571546,200.9037594795227,91.01316022872925,454.48172760009766,12472,1249,11223,11223,0,8,1418000.0
1418,1418999,21.95672170436021,38.18331903414797,0.048588251926896975,201.06054878234863,91.07678246498108,454.6863708496094,12475,1250,11225,11225,0,8,1419000.0
1419,1419999,21.96013342238338,38.1872460816991,0.04857665008648293,201.21073818206787,91.14010715484619,454.8003234863281,12477,1251,11226,11226,0,8,1420000.0
1420,1420999,21.96755014846276,38.20417190146802,0.048603139472800594,201.38052320480347,91.20681881904602,455.02929306030273,12488,1252,11236,11236,0,8,1421000.0
1421,1421999,21.97463063378222,38.2140456900396,0.04860475849982915,201.50139927864075,91.27066779136658,455.2280960083008,12488,1252,11236,11236,0,8,1422000.0
1422,1422999,21.981295410980277,38.222089396278456,0.04860010027674411,201.65456581115723,91.33491516113281,455.4413528442383,12492,1253,11239,11239,0,8,1423000.0
1423,1423999,21.988172057949406,38.23076066797939,0.048625183752054824,201.81308841705322,91.3984808921814,455.5800361633301,12498,1254,11244,11244,0,8,1424000.0
1424,1424999,21.99008062157052,38.229410852784525,0.04862000102252528,201.97679996490479,91.46250629425049,455.74947357177734,12500,1255,11245,11245,0,8,1425000.0
1425,1425999,21.99737902081344,38.24098950764722,0.04806778455217975,202.1352128982544,91.52796006202698,456.23950958251953,12502,1256,11246,11246,0,8,1426000.0
1426,1426999,22.00223239788409,38.24561461288791,0.04771430452280334,202.27868247032166,91.59205842018127,456.5832862854004,12503,1256,11247,11247,0,8,1427000.0
1427,1427999,22.007188769557164,38.248091817350044,0.047315833209631286,202.46513390541077,91.65670156478882,456.8241844177246,12546,1258,11288,11288,0,8,1428000.0
1428,1428999,22.013597149589252,38.25284384888216,0.04690733221128729,202.59086203575134,91.72084283828735,457.1819534301758,12546,1258,11288,11288,0,8,1429000.0
1429,1429999,22.018809343476313,38.25621534163304,0.04652071995299578,202.71975588798523,91.78504157066345,457.4806938171387,12546,1258,11288,11288,0,8,1430000.0
1430,1430999,22.02214773289026,38.25538046412327,0.04625985009650935,202.87433314323425,91.8497564792633,457.67037200927734,12549,1259,11290,11290,0,8,1431000.0
1431,1431999,22.025083538113297,38.25422051089246,0.04606858766400235,203.00033402442932,91.91372609138489,458.0157012939453,12550,1259,11291,11291,0,8,1432000.0
1432,1432999,22.028459391706203,38.25429642720935,0.045805436687086254,203.1887788772583,91.97885513305664,458.15059661865234,12560,1261,11299,11299,0,8,1433000.0
1433,1433999,22.031969602918892,38.25288300029108,0.04560499439550969,203.3082823753357,92.04232048988342,458.34174728393555,12560,1261,11299,11299,0,8,1434000.0
1434,1434999,22.03610239268008,38.25245525186049,0.045384128621393405,203.45682191848755,92.1065502166748,458.5421485900879,12562,1262,11300,11300,0,8,1435000.0
1435,1435999,22.039804151822388,38.25178967592393,0.045171768506104826,203.60819959640503,92.17034673690796,458.67005157470703,12565,1263,11302,11302,0,8,1436000.0
1436,1436999,22.044138311008265,38.25266912054837,0.04497682995779462,203.7480709552765,92.24388837814331,458.88968658447266,12565,1263,11302,11302,0,8,1437000.0
1437,1437999,22.046932002151785,38.25164384804073,0.04482703571790936,203.90846133232117,92.30900144577026,459.0519485473633,12568,1264,11304,11304,0,8,1438000.0
1438,1438999,22.050809808649916,38.2526037144107,0.04471231569540779,204.1009910106659,92.38030886650085,459.0984191894531,12574,1266,11308,11308,0,8,1439000.0
1439,1439999,22.0559528687936,38.25327339692289,0.044606450433612554,204.23060154914856,92.44430446624756,459.36496353149414,12574,1266,11308,11308,0,8,1440000.0
1440,1440999,22.061010392486306,38.25609952805548,0.044541549540371705,204.39131379127502,92.50860977172852,459.5453643798828,12577,1267,11310,11310,0,8,1441000.0
1441,1441999,22.066263358508937,38.25880337989229,0.04451986121106366,204.55134654045105,92.57306456565857,459.68873596191406,12580,1268,11312,11312,0,8,1442000.0
1442,1442999,22.0713143374284,38.260241439908924,0.044403636980136385,204.67673683166504,92.63709878921509,459.84785079956055,12580,1268,11312,11312,0,8,1443000.0
1443,1443999,22.07576754492873,38.262297527042875,0.044389975118845904,204.88021159172058,92.70142340660095,459.9358673095703,12614,1271,11343,11343,0,8,1444000.0
1444,1444999,22.081091213767706,38.268737144313455,0.0444159566005935,205.03558039665222,92.76547980308533,460.05019760131836,12617,1272,11345,11345,0,8,1445000.0
1445,1445999,22.083051262420707,38.266003886419576,0.044436184526842726,205.1591124534607,92.8303017616272,460.2817039489746,12617,1272,11345,11345,0,8,1446000.0
1446,1446999,22.08225986061732,38.26372973317972,0.04433488425211718,205.30839586257935,92.89381170272827,460.79957580566406,12622,1273,11349,11349,0,8,1447000.0
1447,1447999,22.0816108566376,38.26752942257742,0.044274266305932675,205.4947099685669,92.95780444145203,461.1183853149414,12636,1275,11361,11361,0,8,1448000.0
1448,1448999,22.080305642638223,38.26260458386068,0.0441919424306666,205.65204167366028,93.02206587791443,461.5061264038086,12661,1276,11385,11385,0,8,1449000.0
1449,1449999,22.080484453357236,38.262648469466505,0.044123206956758754,205.773579120636,93.08597826957703,461.8485412597656,12661,1276,11385,11385,0,8,1450000.0
1450,1450999,22.08080308254006,38.26161531642779,0.044085430632886724,205.9554033279419,93.15038251876831,462.0907173156738,12669,1278,11391,11391,0,8,1451000.0
1451,1451999,22.080682495887558,38.26138967213962,0.04402304849472116,206.0786907672882,93.21552443504333,462.41915130615234,12669,1278,11391,11391,0,8,1452000.0
1452,1452999,22.080859108699165,38.25837750181638,0.04400488292405613,206.1968650817871,93.27899670600891,462.666690826416,12669,1278,11391,11391,0,8,1453000.0
1453,1453999,22.081504608046046,38.27578091848607,0.043914234463881985,206.37944507598877,93.34290838241577,462.78163146972656,12710,1280,11430,11430,0,8,1454000.0
1454,1454999,22.082562585525167,38.276247698109856,0.04388229755171147,206.5470860004425,93.40676021575928,462.94588470458984,12712,1281,11431,11431,0,8,1455000.0
1455,1455999,22.083855138743917,38.27567789538603,0.043844717403944466,206.66759586334229,93.47128391265869,463.1551856994629,12712,1281,11431,11431,0,8,1456000.0
1456,1456999,22.08570920122192,38.28870356422932,0.04381985652641762,206.8762195110321,93.53532910346985,463.2668228149414,12724,1284,11440,11440,0,8,1457000.0
1457,1457999,22.087107161491364,38.290280487391435,0.04377686598731023,207.01168966293335,93.59920597076416,463.5490913391113,12725,1284,11441,11441,0,8,1458000.0
1458,1458999,22.09003578367094,38.30610317003648,0.04371888893832365,207.21926617622375,93.6646900177002,463.6537399291992,12733,1287,11446,11446,0,8,1459000.0
1459,1459999,22.095167169319897,38.327611736161465,0.043711345218195086,207.37366032600403,93.72853446006775,463.89245223999023,12735,1288,11447,11447,0,8,1460000.0
1460,1460999,22.099423463422255,38.34742467564065,0.043633389390261845,207.50699138641357,93.79246068000793,464.15001678466797,12735,1288,11447,11447,0,8,1461000.0
1461,1461999,22.102529287244156,38.35206144638326,0.043583065677823773,207.6574206352234,93.8560619354248,464.3217315673828,12766,1289,11477,11477,0,8,1462000.0
1462,1462999,22.106733028061793,38.362990263487205,0.04354035246229082,207.83833265304565,93.92039489746094,464.34590911865234,12774,1291,11483,11483,0,8,1463000.0
1463,1463999,22.10814192440448,38.363648777473564,0.043493253081620664,208.01760840415955,93.98396515846252,464.70490646362305,12819,1293,11526,11526,0,8,1464000.0
1464,1464999,22.110272288917297,38.370444701405646,0.0434703197588,208.17821955680847,94.05003237724304,465.2861862182617,12836,1294,11542,11542,0,8,1465000.0
1465,1465999,22.114159697033926,38.382807845175094,0.04347323847959483,208.30626678466797,94.11478567123413,465.80065155029297,12838,1294,11544,11544,0,8,1466000.0
1466,1466999,22.11808772046565,38.39335107548373,0.04343115010630638,208.432030916214,94.17876052856445,466.1196746826172,12840,1294,11546,11546,0,8,1467000.0
1467,1467999,22.124411466918474,38.411864249612044,0.043360420771404895,208.646892786026,94.2433340549469,466.391170501709,12877,1297,11580,11580,0,8,1468000.0
1468,1468999,22.12774070116766,38.417703593862946,0.0433774167104114,208.80033946037292,94.30887341499329,466.6727485656738,12880,1298,11582,11582,0,8,1469000.0
1469,1469999,22.13231588272565,38.42612031063801,0.0433438459782427,208.9578993320465,94.37387490272522,466.90807723999023,12882,1299,11583,11583,0,8,1470000.0
1470,1470999,22.137831508185286,38.435697392514946,0.04338085356964816,209.07893991470337,94.43713235855103,467.1468620300293,12882,1299,11583,11583,0,8,1471000.0
1471,1471999,22.145110703869083,38.4502573031306,0.04338839256408655,209.2120349407196,94.50193190574646,467.33960723876953,12882,1299,11583,11583,0,8,1472000.0
1472,1472999,22.15225194865013,38.47334700429786,0.043408383497943404,209.37110829353333,94.56570506095886,467.5118942260742,12885,1300,11585,11585,0,8,1473000.0
1473,1473999,22.1572128411264,38.48087275916939,0.043427729461305686,209.5162374973297,94.62978315353394,467.71860122680664,12902,1301,11601,11601,0,8,1474000.0
1474,1474999,22.164398592943012,38.49563703173061,0.04351330533323727,209.6683371067047,94.69400787353516,467.8285598754883,12904,1302,11602,11602,0,8,1475000.0
1475,1475999,22.17198798914266,38.51287130075413,0.04356055029679695,209.8561975955963,94.75944423675537,468.05864334106445,12920,1304,11616,11616,0,8,1476000.0
1476,1476999,22.179685283996413,38.524800592572845,0.04373003551659038,209.98180031776428,94.82314252853394,468.3877182006836,12920,1304,11616,11616,0,8,1477000.0
1477,1477999,22.187265266858503,38.53576751722688,0.04374386563367094,210.13181948661804,94.88666439056396,468.6387062072754,12928,1305,11623,11623,0,8,1478000.0
1478,1478999,22.19356930618904,38.55389176061268,0.04380708655160359,210.26388669013977,94.9508650302887,468.86746978759766,12928,1305,11623,11623,0,8,1479000.0
1479,1479999,22.20199489383543,38.56994574355883,0.04389640193523292,210.38882184028625,95.01460790634155,469.02967834472656,12928,1305,11623,11623,0,8,1480000.0
1480,1480999,22.203280592375698,38.57111237229489,0.04392148311663291,210.50931644439697,95.07799100875854,469.3587646484375,12928,1305,11623,11623,0,8,1481000.0
1481,1481999,22.20236848700417,38.57305372209391,0.0438664493802593,210.64258790016174,95.14262270927429,469.82586669921875,12928,1305,11623,11623,0,8,1482000.0
1482,1482999,22.200983861772656,38.57206864943417,0.04380715715152217,210.79261112213135,95.20669627189636,470.0240173339844,12930,1306,11624,11624,0,8,1483000.0
1483,1483999,22.19823427222366,38.56899833674135,0.04379924098304033,210.92045164108276,95.27160143852234,470.33147048950195,12930,1306,11624,11624,0,8,1484000.0
1484,1484999,22.19713501361936,38.56652678888635,0.04378144686745189,211.0884358882904,95.33619379997253,470.6183738708496,12933,1307,11626,11626,0,8,1485000.0
1485,1485999,22.19608456000294,38.56423474908039,0.04375771383902738,211.21922755241394,95.40035200119019,470.89429092407227,12933,1307,11626,11626,0,8,1486000.0
1486,1486999,22.19422765631885,38.55817880460308,0.04373644204402061,211.36954164505005,95.46435880661011,471.0780715942383,12941,1308,11633,11633,0,8,1487000.0
1487,1487999,22.19337203820427,38.55466504948882,0.043716863041875165,211.48826956748962,95.52806043624878,471.3107719421387,12941,1308,11633,11633,0,8,1488000.0
1488,1488999,22.193898887692892,38.55591637074244,0.04371522793040927,211.67295861244202,95.59191417694092,471.3912162780762,12973,1310,11663,11663,0,8,1489000.0
1489,1489999,22.195201134079806,38.56211942435884,0.04370780624276127,211.81296181678772,95.65584111213684,471.5435256958008,12973,1310,11663,11663,0,8,1490000.0
1490,1490999,22.196447428819372,38.564119845909936,0.043678571600165306,212.03007912635803,95.72098994255066,471.5955467224121,12980,1313,11667,11667,0,8,1491000.0
1491,1491999,22.196666512470667,38.56303516255449,0.04368646598596948,212.15080213546753,95.78445410728455,471.7784996032715,12980,1313,11667,11667,0,8,1492000.0
1492,1492999,22.197422435377888,38.56396564035164,0.043720657378701455,212.31175565719604,95.848388671875,471.9030647277832,12982,1314,11668,11668,0,8,1493000.0
1493,1493999,22.199492232876786,38.56524127203919,0.04377985102075277,212.47911882400513,95.91261529922485,472.10250091552734,12984,1315,11669,11669,0,8,1494000.0
1494,1494999,22.20319760455213,38.56871990147694,0.04381382910588816,212.6020143032074,95.97606492042542,472.29276275634766,12984,1315,11669,11669,0,8,1495000.0
1495,1495999,22.206970335090414,38.57385622636741,0.043860739710085084,212.72375893592834,96.04076290130615,472.4350929260254,12984,1315,11669,11669,0,8,1496000.0
1496,1496999,22.209831615291655,38.57426041538524,0.043862229272945474,212.85397100448608,96.10460090637207,472.6485404968262,12984,1315,11669,11669,0,8,1497000.0
1497,1497999,22.214117853548068,38.58286392484986,0.04393438288309226,213.01266145706177,96.16887354850769,472.74527740478516,12989,1316,11673,11673,0,8,1498000.0
1498,1498999,22.219403747623232,38.589009102439874,0.04398411420669446,213.22645616531372,96.23345756530762,472.8355293273926,13001,1319,11682,11682,0,8,1499000.0
1499,1499999,22.221919549105234,38.5897807467808,0.04402843468959705,213.37399983406067,96.29790306091309,473.0371398925781,13008,1320,11688,11688,0,8,1500000.0
1500,1500999,22.222929856202075,38.597799152115314,0.04401550160253298,213.5653007030487,96.36151456832886,473.28842544555664,13070,1322,11748,11748,0,8,1501000.0
1501,1501999,22.220508057531937,38.602434199432835,0.04397776642771578,213.696875333786,96.42496109008789,473.54127502441406,13070,1322,11748,11748,0,8,1502000.0
1502,1502999,22.216462754299876,38.59696512605875,0.04397813641970383,213.8860137462616,96.4895761013031,473.7861137390137,13074,1324,11750,11750,0,8,1503000.0
1503,1503999,22.212732867604885,38.59004440581104,0.043964457788064126,214.01551461219788,96.55352354049683,474.0971870422363,13074,1324,11750,11750,0,8,1504000.0
1504,1504999,22.20963266451011,38.583967328370974,0.043953355582387665,214.1752429008484,96.61735439300537,474.1892890930176,13092,1325,11767,11767,0,8,1505000.0
1505,1505999,22.207559043972065,38.58327509752412,0.04395725653414362,214.3028314113617,96.68144392967224,474.5042419433594,13093,1325,11768,11768,0,8,1506000.0
1506,1506999,22.205368898884903,38.57800263342347,0.04394935283478296,214.43123745918274,96.74527978897095,474.7652816772461,13093,1325,11768,11768,0,8,1507000.0
1507,1507999,22.202945761659027,38.5736625222022,0.04393041271819609,214.55745220184326,96.80917644500732,474.9743995666504,13093,1325,11768,11768,0,8,1508000.0
1508,1508999,22.20120530709268,38.56848494698445,0.043897167007460824,214.6819109916687,96.8738865852356,475.1889343261719,13093,1325,11768,11768,0,8,1509000.0
1509,1509999,22.19897037872877,38.56288489342375,0.04388837726258432,214.87866735458374,96.93834328651428,475.28968048095703,13097,1327,11770,11770,0,8,1510000.0
1510,1510999,22.197198247928455,38.55696055910359,0.043883952336465026,215.06256198883057,97.00217700004578,475.3784370422363,13108,1329,11779,11779,0,8,1511000.0
1511,1511999,22.196532100788406,38.55490993249942,0.043870041031197626,215.25576758384705,97.06592202186584,475.57778549194336,13112,1331,11781,11781,0,8,1512000.0
1512,1512999,22.195663898328064,38.55219785165996,0.043858048872540634,215.43280005455017,97.12961864471436,475.67810440063477,13139,1333,11806,11806,0,8,1513000.0
1513,1513999,22.195214767801538,38.548664111912686,0.04386365963822614,215.62483477592468,97.19401955604553,475.84618377685547,13143,1335,11808,11808,0,8,1514000.0
1514,1514999,22.19574787341234,38.549386435552194,0.04384659744199393,215.74768662452698,97.2582380771637,476.21472930908203,13143,1335,11808,11808,0,8,1515000.0
1515,1515999,22.196592740772417,38.546722734798045,0.04385070649737788,215.90402269363403,97.32217812538147,476.4284973144531,13145,1336,11809,11809,0,8,1516000.0
1516,1516999,22.197561637027363,38.544427278953556,0.043860657883725396,216.02826404571533,97.38563799858093,476.6900062561035,13146,1336,11810,11810,0,8,1517000.0
1517,1517999,22.199568730691336,38.543898632001515,0.04387929632793175,216.24744868278503,97.45117378234863,476.81736755371094,13168,1339,11829,11829,0,8,1518000.0
1518,1518999,22.202336374613598,38.54380616237658,0.04391724191281454,216.38206696510315,97.51502990722656,477.0971145629883,13168,1339,11829,11829,0,8,1519000.0
1519,1519999,22.20476551423496,38.54468579772837,0.04394625445997602,216.59413504600525,97.57935833930969,477.20386505126953,13174,1342,11832,11832,0,8,1520000.0
1520,1520999,22.206056304515418,38.54346341401637,0.043977387724828065,216.7101137638092,97.64273357391357,477.4377136230469,13174,1342,11832,11832,0,8,1521000.0
1521,1521999,22.20450330739031,38.539064629592644,0.0439970752968758,216.83563780784607,97.70768237113953,477.8847541809082,13174,1342,11832,11832,0,8,1522000.0
1522,1522999,22.19982876996829,38.54126882937018,0.044002444605169444,216.9842677116394,97.7711706161499,478.10511016845703,13176,1343,11833,11833,0,8,1523000.0
1523,1523999,22.194185305615886,38.53703508754366,0.04403514858830038,217.1458842754364,97.83544254302979,478.3466491699219,13178,1344,11834,11834,0,8,1524000.0
1524,1524999,22.18807744243178,38.52857625403995,0.04406162846285899,217.2885365486145,97.89963889122009,478.6221923828125,13178,1344,11834,11834,0,8,1525000.0
1525,1525999,22.18248618474346,38.52002203617537,0.0440912850400651,217.4208698272705,97.96329975128174,478.8095474243164,13178,1344,11834,11834,0,8,1526000.0
1526,1526999,22.177553251486454,38.513053809511256,0.04411636294721544,217.57260251045227,98.02794122695923,479.0245704650879,13181,1345,11836,11836,0,8,1527000.0
1527,1527999,22.172997501034242,38.505593405407794,0.04413439129271579,217.7217206954956,98.09239602088928,479.2191276550293,13183,1346,11837,11837,0,8,1528000.0
1528,1528999,22.168233944612705,38.49748443982932,0.044161327214497614,217.93451809883118,98.15687894821167,479.2071647644043,13189,1349,11840,11840,0,8,1529000.0
1529,1529999,22.163667873325316,38.49007438160234,0.04418661937493207,218.0601110458374,98.2212746143341,479.49245834350586,13189,1349,11840,11840,0,8,1530000.0
1530,1530999,22.159631858655043,38.48473674637986,0.044190514332945297,218.2252779006958,98.2866268157959,479.63851165771484,13195,1350,11845,11845,0,8,1531000.0
1531,1531999,22.156328710276842,38.478740491943746,0.04419974575054497,218.38593554496765,98.35157036781311,479.76998138427734,13197,1351,11846,11846,0,8,1532000.0
1532,1532999,22.152081854567278,38.47135420103887,0.044214626532310786,218.56991839408875,98.41619086265564,480.041690826416,13216,1353,11863,11863,0,8,1533000.0
1533,1533999,22.148378225747663,38.463863177711055,0.04423031743835415,218.70456051826477,98.48031234741211,480.3958282470703,13216,1353,11863,11863,0,8,1534000.0
1534,1534999,22.144456754736105,38.45803250327276,0.04424223600250121,218.83508491516113,98.5441882610321,480.6033134460449,13216,1353,11863,11863,0,8,1535000.0
1535,1535999,22.14195880371842,38.45363564724249,0.044232804314087715,218.9877576828003,98.60824608802795,480.76974868774414,13218,1354,11864,11864,0,8,1536000.0
1536,1536999,22.140480295328846,38.451076300825996,0.044237638783263256,219.17429280281067,98.67280101776123,480.8953628540039,13223,1356,11867,11867,0,8,1537000.0
1537,1537999,22.138401220995597,38.44658224925023,0.04424886175610032,219.36066961288452,98.73686218261719,481.08709716796875,13228,1358,11870,11870,0,8,1538000.0
1538,1538999,22.136861693281865,38.44170492129911,0.044257388168556844,219.48464679718018,98.80026006698608,481.3789367675781,13229,1358,11871,11871,0,8,1539000.0
1539,1539999,22.13532482717042,38.43735809189619,0.044265659331872875,219.61037063598633,98.86415934562683,481.5859069824219,13229,1358,11871,11871,0,8,1540000.0
1540,1540999,22.133818624633708,38.43369263886673,0.04427488090077947,219.73367381095886,98.92804861068726,481.76488494873047,13230,1358,11872,11872,0,8,1541000.0
1541,1541999,22.13118784764372,38.42785348982976,0.044283063210932005,219.88689184188843,98.99181365966797,481.937442779541,13232,1359,11873,11873,0,8,1542000.0
1542,1542999,22.128850555849837,38.42103302514437,0.044218849915968916,220.0416123867035,99.0551335811615,482.38631439208984,13262,1360,11902,11902,0,8,1543000.0
1543,1543999,22.12818757958661,38.42043451851348,0.04406309778731865,220.26403188705444,99.12069320678711,482.4015464782715,13268,1363,11905,11905,0,8,1544000.0
1544,1544999,22.12725692531087,38.41523187340865,0.04395639018200559,220.41965556144714,99.18478536605835,482.6467819213867,13270,1364,11906,11906,0,8,1545000.0
1545,1545999,22.125691439038437,38.40974142636179,0.043882536088625024,220.57515406608582,99.24902629852295,482.8380241394043,13272,1365,11907,11907,0,8,1546000.0
1546,1546999,22.12596526568438,38.40660624667968,0.0437822498213275,220.74339532852173,99.3132016658783,482.9327049255371,13275,1366,11909,11909,0,8,1547000.0
1547,1547999,22.12779744030179,38.40551660594489,0.04372755399781103,220.9324860572815,99.37730574607849,483.04783630371094,13281,1368,11913,11913,0,8,1548000.0
1548,1548999,22.129367936680552,38.40434875690793,0.04374602368099245,221.0626780986786,99.4411985874176,483.3402976989746,13281,1368,11913,11913,0,8,1549000.0
1549,1549999,22.131947590164778,38.40933814623853,0.043710461082176355,221.1926212310791,99.50498962402344,483.54626083374023,13281,1368,11913,11913,0,8,1550000.0
1550,1550999,22.133590585162043,38.41071816909431,0.043740613826072194,221.34152030944824,99.56877064704895,483.6974067687988,13283,1369,11914,11914,0,8,1551000.0
1551,1551999,22.138163217409335,38.42094480908539,0.04376022546325842,221.5541307926178,99.6336977481842,483.7803382873535,13299,1372,11927,11927,0,8,1552000.0
1552,1552999,22.140838301161327,38.4259077534678,0.043753627233944714,221.7450339794159,99.69768571853638,483.7468376159668,13304,1374,11930,11930,0,8,1553000.0
1553,1553999,22.147338511099527,38.44464743197354,0.04375808827082206,221.93164896965027,99.76211309432983,483.907657623291,13308,1376,11932,11932,0,8,1554000.0
1554,1554999,22.15388475140717,38.46110268905691,0.04383728642320295,222.05765199661255,99.8267674446106,484.1218070983887,13308,1376,11932,11932,0,8,1555000.0
1555,1555999,22.159509081269704,38.47427168982357,0.043839220252324784,222.26719784736633,99.8913049697876,484.14072036743164,13314,1379,11935,11935,0,8,1556000.0
1556,1556999,22.16483040436853,38.48372194934455,0.043846478924510546,222.4563217163086,99.95519399642944,484.2841033935547,13324,1381,11943,11943,0,8,1557000.0
1557,1557999,22.170117707621444,38.49304506004146,0.04390443235867825,222.61525964736938,100.01897048950195,484.4937744140625,13355,1382,11973,11973,0,8,1558000.0
1558,1558999,22.173966547010114,38.49636619419464,0.04390081694888859,222.89650559425354,100.08437633514404,484.41307067871094,13367,1387,11980,11980,0,8,1559000.0
1559,1559999,22.179062409754764,38.502386095821606,0.04388267297371584,223.01716375350952,100.14795255661011,484.65391540527344,13368,1387,11981,11981,0,8,1560000.0
1560,1560999,22.18344941205513,38.50997820027191,0.04386776619527455,223.16728973388672,100.21170353889465,484.7770309448242,13371,1388,11983,11983,0,8,1561000.0
1561,1561999,22.187406536928034,38.51416619576169,0.043855257593531594,223.30184078216553,100.27560520172119,484.9983787536621,13372,1388,11984,11984,0,8,1562000.0
1562,1562999,22.187582600847676,38.51105501376996,0.04382231281522575,223.45536708831787,100.33984851837158,485.25025177001953,13376,1389,11987,11987,0,8,1563000.0
1563,1563999,22.186786835361698,38.509728760001586,0.043805728015672396,223.60741448402405,100.40355920791626,485.66465759277344,13378,1390,11988,11988,0,8,1564000.0
1564,1564999,22.186085114144458,38.50896545764958,0.043856628275231624,223.73822784423828,100.46935415267944,485.98749923706055,13378,1390,11988,11988,0,8,1565000.0
1565,1565999,22.185986924974813,38.50816673960464,0.043875001881227726,223.88797330856323,100.53340315818787,486.21507263183594,13386,1391,11995,11995,0,8,1566000.0
1566,1566999,22.18752047040068,38.509678447120734,0.04390530730004405,224.03700184822083,100.59739804267883,486.4001770019531,13389,1392,11997,11997,0,8,1567000.0
1567,1567999,22.189498558953982,38.51005041563648,0.043900925254351186,224.1637568473816,100.6618139743805,486.65815353393555,13391,1392,11999,11999,0,8,1568000.0
1568,1568999,22.191025991798035,38.511002793392485,0.04391216196293535,224.31758308410645,100.72625803947449,486.81693267822266,13408,1393,12015,12015,0,8,1569000.0
1569,1569999,22.193473070946162,38.51374954452132,0.04390854271895761,224.44835710525513,100.78995370864868,487.07384490966797,13408,1393,12015,12015,0,8,1570000.0
1570,1570999,22.1956308717601,38.51594731500075,0.0438903556438035,224.60769081115723,100.85579466819763,487.24291610717773,13410,1394,12016,12016,0,8,1571000.0
1571,1571999,22.198146960152744,38.51767242937416,0.043909548034301915,224.76613092422485,100.91997814178467,487.4488220214844,13413,1395,12018,12018,0,8,1572000.0
1572,1572999,22.202403421441144,38.5236261562351,0.04391528988821802,225.01439499855042,100.98412942886353,487.42076873779297,13422,1399,12023,12023,0,8,1573000.0
1573,1573999,22.208782631669003,38.54231319707321,0.04395175743688351,225.26050758361816,101.04873895645142,487.45577239990234,13433,1403,12030,12030,0,8,1574000.0
1574,1574999,22.214666052214504,38.551300820252415,0.04401480357484144,225.4528205394745,101.1128261089325,487.6268501281738,13450,1405,12045,12045,0,8,1575000.0
1575,1575999,22.222306827553076,38.56999836348429,0.044018017081427496,225.5757191181183,101.17645263671875,487.8568687438965,13450,1405,12045,12045,0,8,1576000.0
1576,1576999,22.231371413260746,38.59281745687295,0.044066203828770245,225.7654004096985,101.2413330078125,488.00341033935547,13457,1407,12050,12050,0,8,1577000.0
1577,1577999,22.238370487202108,38.6022554722802,0.044102598441684626,225.92249965667725,101.30640125274658,488.22800064086914,13488,1408,12080,12080,0,8,1578000.0
1578,1578999,22.24423683735899,38.6098656570517,0.04416786946462936,226.07802414894104,101.3702003955841,488.40593338012695,13500,1409,12091,12091,0,8,1579000.0
1579,1579999,22.25325698229394,38.622896831819446,0.044224527493313626,226.23707127571106,101.43451929092407,488.6172676086426,13503,1410,12093,12093,0,8,1580000.0
1580,1580999,22.261005088749016,38.632624518327084,0.044293451215587476,226.3888919353485,101.49854826927185,488.7307891845703,13505,1411,12094,12094,0,8,1581000.0
1581,1581999,22.269260285554875,38.64278444483583,0.04443774419276214,226.57488441467285,101.56427645683289,488.8121032714844,13510,1413,12097,12097,0,8,1582000.0
1582,1582999,22.277528579349365,38.65362395839752,0.0445659796814738,226.75487089157104,101.62797904014587,488.9900550842285,13543,1415,12128,12128,0,8,1583000.0
1583,1583999,22.279253556734748,38.65515374281691,0.04459089839875119,226.92369318008423,101.69159293174744,489.3742980957031,13546,1416,12130,12130,0,8,1584000.0
1584,1584999,22.27446618271396,38.646839060141026,0.04460565361713831,227.07259798049927,101.75621676445007,489.6361885070801,13548,1417,12131,12131,0,8,1585000.0
1585,1585999,22.268843054338216,38.63794783477117,0.04463159690935603,227.22835612297058,101.82025218009949,489.82706451416016,13555,1418,12137,12137,0,8,1586000.0
1586,1586999,22.264972552212974,38.632040260496446,0.04464381377248594,227.38854026794434,101.88462042808533,489.96790313720703,13557,1419,12138,12138,0,8,1587000.0
1587,1587999,22.261487390618107,38.628823909051924,0.04463718297617658,227.5551085472107,101.95007157325745,490.10580825805664,13559,1420,12139,12139,0,8,1588000.0
1588,1588999,22.258322935770654,38.6245636980531,0.044639528150396734,227.75189900398254,102.01478910446167,490.4341812133789,13581,1422,12159,12159,0,8,1589000.0
1589,1589999,22.255097078769904,38.61838528222563,0.04464059539420229,227.93234181404114,102.07930135726929,490.6283302307129,13615,1424,12191,12191,0,8,1590000.0
1590,1590999,22.250717019716486,38.61066135768267,0.04465395417711204,228.0673384666443,102.14353656768799,490.9365005493164,13615,1424,12191,12191,0,8,1591000.0
1591,1591999,22.247971218823302,38.60530007717779,0.04464522972187979,228.22367143630981,102.2075879573822,491.11083221435547,13618,1425,12193,12193,0,8,1592000.0
1592,1592999,22.245636261251132,38.60210333534296,0.04462454353112166,228.3785457611084,102.27174997329712,491.3277931213379,13620,1426,12194,12194,0,8,1593000.0
1593,1593999,22.24402719196908,38.59906637933199,0.044608720977348915,228.6337070465088,102.33787655830383,491.42180252075195,13674,1430,12244,12244,0,8,1594000.0
1594,1594999,22.243149329062717,38.597151548398244,0.04459262066660141,228.82824397087097,102.40285682678223,491.6501655578613,13680,1432,12248,12248,0,8,1595000.0
1595,1595999,22.24349801876219,38.59692062382705,0.04457381433324836,228.95405077934265,102.46662211418152,491.83071517944336,13680,1432,12248,12248,0,8,1596000.0
1596,1596999,22.244493955565538,38.60401019724137,0.04455264232395284,229.1012568473816,102.53026056289673,492.0079116821289,13682,1433,12249,12249,0,8,1597000.0
1597,1597999,22.24625382689482,38.60637555954768,0.04453825897784358,229.28699374198914,102.59444499015808,492.0948371887207,13687,1435,12252,12252,0,8,1598000.0
1598,1598999,22.250679872656537,38.61385750201865,0.04452485191393574,229.474867105484,102.65856695175171,492.25302505493164,13694,1437,12257,12257,0,8,1599000.0
1599,1599999,22.2552751811706,38.62172301256432,0.04453874790936474,229.67046737670898,102.72285866737366,492.3421211242676,13699,1439,12260,12260,0,8,1600000.0
1600,1600999,22.260892456555936,38.63016582432864,0.044509399426834184,229.8417477607727,102.78752660751343,492.5628356933594,13717,1440,12277,12277,0,8,1601000.0
1601,1601999,22.266861235583146,38.64098254743185,0.04453607168575768,230.03162264823914,102.85232663154602,492.78797149658203,13722,1442,12280,12280,0,8,1602000.0
1602,1602999,22.276280272802005,38.67527771944708,0.044495960153241976,230.1938066482544,102.91656637191772,493.00428771972656,13737,1443,12294,12294,0,8,1603000.0
1603,1603999,22.280655976894295,38.6810004895241,0.04450281610196216,230.3487148284912,102.98069620132446,493.2421646118164,13742,1444,12298,12298,0,8,1604000.0
1604,1604999,22.281544820047333,38.68153274337184,0.0444810237561174,230.47988772392273,103.044766664505,493.73465728759766,13742,1444,12298,12298,0,8,1605000.0
1605,1605999,22.281015109936757,38.69245143462572,0.04444461180015469,230.61073088645935,103.1093225479126,494.0673065185547,13743,1444,12299,12299,0,8,1606000.0
1606,1606999,22.28022320497342,38.698875433627556,0.04441502195042879,230.77199602127075,103.17448353767395,494.32422637939453,13745,1445,12300,12300,0,8,1607000.0
1607,1607999,22.27890131155406,38.70195785659396,0.04438186502111807,230.89450645446777,103.23878121376038,494.5704040527344,13745,1445,12300,12300,0,8,1608000.0
1608,1608999,22.277367658458616,38.69869060204415,0.04437709698582393,231.03061151504517,103.30308628082275,494.83409118652344,13747,1445,12302,12302,0,8,1609000.0
1609,1609999,22.276666121594566,38.6981821141082,0.044378885890581365,231.16757154464722,103.36737036705017,495.0921440124512,13748,1445,12303,12303,0,8,1610000.0
1610,1610999,22.276992138834984,38.70105547974485,0.04437273688087795,231.38853240013123,103.43189311027527,495.24769592285156,13785,1448,12337,12337,0,8,1611000.0
1611,1611999,22.277022576048694,38.70120588325245,0.04438707142609266,231.54353880882263,103.49720406532288,495.43341064453125,13787,1449,12338,12338,0,8,1612000.0
1612,1612999,22.276019041061204,38.698357548055434,0.04440725846031279,231.67160558700562,103.56123232841492,495.69714736938477,13787,1449,12338,12338,0,8,1613000.0
1613,1613999,22.276596367322153,38.699542067709984,0.04440094438696862,231.82886600494385,103.62614870071411,495.8864059448242,13789,1450,12339,12339,0,8,1614000.0
1614,1614999,22.2775945038409,38.70045209790661,0.04439995054489898,232.0569043159485,103.69184684753418,495.97863006591797,13824,1453,12371,12371,0,8,1615000.0
1615,1615999,22.278870248544415,38.71001892701431,0.044379535943150805,232.24657273292542,103.75610518455505,496.0894012451172,13834,1455,12379,12379,0,8,1616000.0
1616,1616999,22.278565556126217,38.70811858292628,0.044370286394684544,232.46471905708313,103.82072353363037,496.0452194213867,13841,1458,12383,12383,0,8,1617000.0
1617,1617999,22.279906863911332,38.70870065109858,0.04435746019720155,232.6019823551178,103.88457798957825,496.25553131103516,13841,1458,12383,12383,0,8,1618000.0
1618,1618999,22.27985081650454,38.705741731784606,0.044361414063919025,232.73294591903687,103.94824552536011,496.4603729248047,13841,1458,12383,12383,0,8,1619000.0
1619,1619999,22.28027026046781,38.70391426205593,0.044347990070735865,232.9882686138153,104.0133306980133,496.74462890625,13870,1462,12408,12408,0,8,1620000.0
1620,1620999,22.28125935293992,38.71011478453593,0.04432651946449839,233.11390328407288,104.07798671722412,497.1176300048828,13871,1462,12409,12409,0,8,1621000.0
1621,1621999,22.28093127226984,38.70661050384519,0.04432297164317567,233.30168271064758,104.14249062538147,497.2716636657715,13875,1464,12411,12411,0,8,1622000.0
1622,1622999,22.27856690908831,38.70020218594443,0.04431323852792812,233.4910626411438,104.20695114135742,497.59139251708984,13886,1466,12420,12420,0,8,1623000.0
1623,1623999,22.277446924244106,38.698471474771914,0.04429600691711366,233.62525463104248,104.27045607566833,497.9236755371094,13886,1466,12420,12420,0,8,1624000.0
1624,1624999,22.275829478333616,38.69209472531885,0.04426409892471783,233.77646589279175,104.3345890045166,498.03830337524414,13889,1467,12422,12422,0,8,1625000.0
1625,1625999,22.27428057514859,38.6886205131102,0.044231657435715,233.92557787895203,104.3984055519104,498.2773666381836,13891,1468,12423,12423,0,8,1626000.0
1626,1626999,22.273414291081284,38.68539343311969,0.04419747057354928,234.18007564544678,104.46372079849243,498.2413673400879,13903,1472,12431,12431,0,8,1627000.0
1627,1627999,22.271403185654467,38.67940966114301,0.044181799528898336,234.33095407485962,104.52779912948608,498.50693130493164,13906,1473,12433,12433,0,8,1628000.0
1628,1628999,22.269310151083644,38.67326925764134,0.04415395672609268,234.44920444488525,104.59227275848389,498.76650619506836,13906,1473,12433,12433,0,8,1629000.0
1629,1629999,22.267408088526008,38.666902704589006,0.044128609036628186,234.60241961479187,104.6572699546814,498.92972564697266,13908,1474,12434,12434,0,8,1630000.0
1630,1630999,22.265710545212883,38.66449059286097,0.04407710768462525,234.8742277622223,104.72175073623657,498.93996810913086,13931,1479,12452,12452,0,8,1631000.0
1631,1631999,22.263500625195075,38.65819398539556,0.044046748371394884,235.1425654888153,104.78654742240906,498.94339752197266,13947,1484,12463,12463,0,8,1632000.0
1632,1632999,22.26179160041806,38.65446750720393,0.04401196850119915,235.3633954524994,104.85335159301758,499.17302322387695,13965,1487,12478,12478,0,8,1633000.0
1633,1633999,22.260333420222036,38.650502571286886,0.04396495348326901,235.52497363090515,104.9176115989685,499.39106369018555,13967,1488,12479,12479,0,8,1634000.0
1634,1634999,22.25910197545858,38.64539358628589,0.04392467207021078,235.67835187911987,104.98145389556885,499.5531196594238,13969,1489,12480,12480,0,8,1635000.0
1635,1635999,22.258161120597986,38.64084615500307,0.04387530387251326,235.95558977127075,105.0464174747467,499.54457092285156,13982,1494,12488,12488,0,8,1636000.0
1636,1636999,22.257880591639367,38.63990850458203,0.04380880745323801,236.1727843284607,105.11105489730835,499.711856842041,13989,1497,12492,12492,0,8,1637000.0
1637,1637999,22.258837773665793,38.64941697732807,0.04373897084039036,236.40922594070435,105.17515730857849,499.7536277770996,13997,1501,12496,12496,0,8,1638000.0
1638,1638999,22.259309208856234,38.64593029950983,0.04366275843730427,236.6331605911255,105.23954057693481,499.89965438842773,14004,1504,12500,12500,0,8,1639000.0
1639,1639999,22.260359894336187,38.64331259274435,0.04359851098860534,236.75677847862244,105.30431985855103,500.19641494750977,14004,1504,12500,12500,0,8,1640000.0
1640,1640999,22.260102377583166,38.638555097676715,0.04353703698512934,236.9769730567932,105.36959338188171,500.3155059814453,14015,1507,12508,12508,0,8,1641000.0
1641,1641999,22.260369532780818,38.639313696094554,0.04345066367749029,237.16045665740967,105.43519949913025,500.46128845214844,14020,1509,12511,12511,0,8,1642000.0
1642,1642999,22.259216899412856,38.63610019932256,0.043396114965525645,237.3110773563385,105.49906182289124,500.9171485900879,14053,1510,12543,12543,0,8,1643000.0
1643,1643999,22.257379326158098,38.63159391776452,0.04334101794345624,237.49734544754028,105.56291842460632,500.91504669189453,14058,1512,12546,12546,0,8,1644000.0
1644,1644999,22.2553953303894,38.62910738481212,0.0432959525798704,237.65108180046082,105.62748003005981,501.16344833374023,14062,1513,12549,12549,0,8,1645000.0
1645,1645999,22.253019084737904,38.62565932505701,0.04324968278513652,237.81351399421692,105.69157123565674,501.2959747314453,14069,1514,12555,12555,0,8,1646000.0
1646,1646999,22.252192276350783,38.638247431726654,0.04316278291933584,237.97526741027832,105.75651907920837,501.4475326538086,14100,1515,12585,12585,0,8,1647000.0
1647,1647999,22.25056175388536,38.63329374463293,0.0431176216783854,238.13538336753845,105.82158613204956,501.6078071594238,14104,1516,12588,12588,0,8,1648000.0
1648,1648999,22.24887801794231,38.62671983838079,0.043061424111565105,238.31241083145142,105.88566780090332,501.7405776977539,14117,1518,12599,12599,0,8,1649000.0
1649,1649999,22.246694324143025,38.620253025831325,0.04301950465017479,238.4287052154541,105.94934129714966,501.9077033996582,14117,1518,12599,12599,0,8,1650000.0
1650,1650999,22.244881954984418,38.61369283904741,0.04298702318486913,238.58513641357422,106.01353073120117,501.9998321533203,14120,1519,12601,12601,0,8,1651000.0
1651,1651999,22.24299534550602,38.6075698037685,0.042947180667712526,238.71333026885986,106.07739901542664,502.2179527282715,14120,1519,12601,12601,0,8,1652000.0
1652,1652999,22.241874981432503,38.6019822245944,0.042881906971850015,238.93582153320312,106.14304113388062,502.2727355957031,14139,1522,12617,12617,0,8,1653000.0
1653,1653999,22.24146906335565,38.59782166192374,0.042781472236537166,239.15671300888062,106.20755171775818,502.3392791748047,14147,1525,12622,12622,0,8,1654000.0
1654,1654999,22.240824817184663,38.592707092611995,0.04269083954696218,239.3465747833252,106.27189660072327,502.37154388427734,14152,1527,12625,12625,0,8,1655000.0
1655,1655999,22.24028842330354,38.588287793831434,0.04263856323391646,239.57234978675842,106.33625268936157,502.3871765136719,14158,1530,12628,12628,0,8,1656000.0
1656,1656999,22.241271528271877,38.58610340402217,0.042560123400105954,239.7575488090515,106.40224361419678,502.54052352905273,14163,1532,12631,12631,0,8,1657000.0
1657,1657999,22.24320085765953,38.58471591480704,0.04248028609116827,239.9736406803131,106.46678376197815,502.6797866821289,14174,1535,12639,12639,0,8,1658000.0
1658,1658999,22.245182150037863,38.583894143811584,0.042413459111487195,240.1318542957306,106.53081369400024,502.8901176452637,14176,1536,12640,12640,0,8,1659000.0
1659,1659999,22.248204848611717,38.58546756766644,0.04235759692295826,240.2653088569641,106.59732508659363,503.2139015197754,14177,1536,12641,12641,0,8,1660000.0
1660,1660999,22.249979470915633,38.58343642690128,0.042309583078878665,240.47926378250122,106.66140127182007,503.2076530456543,14184,1539,12645,12645,0,8,1661000.0
1661,1661999,22.2516914984835,38.581633100880886,0.04224963819682992,240.73855996131897,106.72721099853516,503.1839408874512,14202,1543,12659,12659,0,8,1662000.0
1662,1662999,22.252797598405515,38.57908252885619,0.042214122469774185,240.9294810295105,106.79169869422913,503.3683547973633,14208,1545,12663,12663,0,8,1663000.0
1663,1663999,22.2502970970057,38.57355093939697,0.042193639622993606,241.05844974517822,106.85574746131897,503.7960548400879,14210,1545,12665,12665,0,8,1664000.0
1664,1664999,22.24668793576525,38.5685788091406,0.042201217172202266,241.2873990535736,106.91996788978577,503.79952239990234,14216,1548,12668,12668,0,8,1665000.0
1665,1665999,22.242014855578308,38.561405673779554,0.04222308699143673,241.42273497581482,106.98765277862549,504.0525894165039,14216,1548,12668,12668,0,8,1666000.0
1666,1666999,22.237566147192588,38.55789040516506,0.04223201453120229,241.64938735961914,107.06183862686157,504.18993759155273,14248,1550,12698,12698,0,8,1667000.0
1667,1667999,22.23364697465212,38.55161837397594,0.042205062009891825,241.80687975883484,107.12641429901123,504.51352310180664,14251,1551,12700,12700,0,8,1668000.0
1668,1668999,22.229787496341615,38.54506424339726,0.042210524624293644,241.96951627731323,107.19204688072205,504.78797149658203,14261,1552,12709,12709,0,8,1669000.0
1669,1669999,22.22620010209753,38.53855746589308,0.04221013524386252,242.12572383880615,107.25650978088379,505.0582580566406,14263,1553,12710,12710,0,8,1670000.0
1670,1670999,22.22204411478074,38.5317714623015,0.0422169818619168,242.24585056304932,107.32041573524475,505.2638511657715,14263,1553,12710,12710,0,8,1671000.0
1671,1671999,22.21801729771824,38.524446073922256,0.04222775169448101,242.4309947490692,107.38478350639343,505.2882537841797,14268,1555,12713,12713,0,8,1672000.0
1672,1672999,22.213956046620677,38.51707629770983,0.042238963748681524,242.63079810142517,107.45118021965027,505.48696517944336,14273,1557,12716,12716,0,8,1673000.0
1673,1673999,22.210003657786004,38.51072782777699,0.04224341175101409,242.83300018310547,107.51537680625916,505.5456237792969,14278,1559,12719,12719,0,8,1674000.0
1674,1674999,22.205786858350542,38.50319567397137,0.04226910412728446,242.98578143119812,107.57995414733887,505.7625923156738,14280,1560,12720,12720,0,8,1675000.0
1675,1675999,22.202412153880015,38.49677348824276,0.04227046410176849,243.1427140235901,107.64409708976746,505.9069633483887,14282,1561,12721,12721,0,8,1676000.0
1676,1676999,22.198619040186124,38.48982799101382,0.042272220833925345,243.3059597015381,107.70799326896667,506.0187339782715,14284,1562,12722,12722,0,8,1677000.0
1677,1677999,22.195760666358908,38.48433418261848,0.04227975937781148,243.45612907409668,107.77173805236816,506.16053771972656,14286,1563,12723,12723,0,8,1678000.0
1678,1678999,22.19516139878068,38.488042071479185,0.04196365146077241,243.66930174827576,107.83629059791565,506.3321228027344,14295,1566,12729,12729,0,8,1679000.0
1679,1679999,22.195096922652557,38.4906484611768,0.04194984850944539,243.95388054847717,107.91035723686218,506.3834457397461,14336,1570,12766,12766,0,8,1680000.0
1680,1680999,22.195004268707557,38.4929205017021,0.04193142556615903,244.10214400291443,107.97401595115662,506.6516532897949,14339,1571,12768,12768,0,8,1681000.0
1681,1681999,22.195166251925393,38.4946289957735,0.04191513650416323,244.2996826171875,108.03840279579163,506.763126373291,14345,1573,12772,12772,0,8,1682000.0
1682,1682999,22.19378475598558,38.4901948554613,0.04192840502431139,244.45454239845276,108.1034939289093,506.89661026000977,14347,1574,12773,12773,0,8,1683000.0
1683,1683999,22.19211555648367,38.485165350747344,0.041912909224248285,244.64990496635437,108.1677975654602,507.0210762023926,14352,1576,12776,12776,0,8,1684000.0
1684,1684999,22.188525291788963,38.478387279797275,0.04191519476823913,244.80019187927246,108.23230147361755,507.5128860473633,14361,1577,12784,12784,0,8,1685000.0
1685,1685999,22.18366170819838,38.4708290070384,0.04194271464437538,244.95181679725647,108.29694700241089,507.7061576843262,14363,1578,12785,12785,0,8,1686000.0
1686,1686999,22.17952315037475,38.46409369442362,0.041976674400523106,245.12080144882202,108.3613874912262,507.98979568481445,14368,1579,12789,12789,0,8,1687000.0
1687,1687999,22.1759744322878,38.457657094357465,0.04200092510163389,245.2795958518982,108.42678451538086,508.27048110961914,14371,1580,12791,12791,0,8,1688000.0
1688,1688999,22.172712810241897,38.45182444302792,0.04203140994381749,245.4661943912506,108.4912657737732,508.4212455749512,14376,1582,12794,12794,0,8,1689000.0
1689,1689999,22.170567718061484,38.44943322178775,0.04206115984906056,245.60071992874146,108.55634927749634,508.74695205688477,14377,1582,12795,12795,0,8,1690000.0
1690,1690999,22.168910411165683,38.44646861105229,0.04211980477005706,245.723317861557,108.62053632736206,509.0404586791992,14377,1582,12795,12795,0,8,1691000.0
1691,1691999,22.167737766110115,38.44521429428237,0.0421621948276697,245.87736105918884,108.68465757369995,509.24522399902344,14379,1583,12796,12796,0,8,1692000.0
1692,1692999,22.166781350371387,38.447748105654554,0.04221342559327368,246.06735801696777,108.74958038330078,509.4042167663574,14383,1585,12798,12798,0,8,1693000.0
1693,1693999,22.167994938080565,38.46271114689829,0.04221531658384359,246.25528049468994,108.81514143943787,509.58503341674805,14387,1587,12800,12800,0,8,1694000.0
1694,1694999,22.16852276164253,38.4672096779877,0.04227063152097932,246.52045249938965,108.88040709495544,509.6396141052246,14407,1591,12816,12816,0,8,1695000.0
1695,1695999,22.1716748136922,38.48091755203724,0.042335093543678814,246.688889503479,108.94470882415771,509.93580627441406,14437,1592,12845,12845,0,8,1696000.0
1696,1696999,22.173666870773452,38.48911859046657,0.042415015169979364,246.85049414634705,109.00862407684326,510.0284538269043,14440,1593,12847,12847,0,8,1697000.0
1697,1697999,22.174307249786853,38.49393610223387,0.042488534148665824,247.07022976875305,109.07307291030884,510.100528717041,14447,1596,12851,12851,0,8,1698000.0
1698,1698999,22.176374275127134,38.50172553560771,0.04253215363836815,247.2268660068512,109.1372389793396,510.3373374938965,14462,1597,12865,12865,0,8,1699000.0
1699,1699999,22.179465092193816,38.5137037756402,0.04254463683877496,247.3850769996643,109.2027337551117,510.6724662780762,14468,1598,12870,12870,0,8,1700000.0
1700,1700999,22.18157849525121,38.51926915441942,0.04259777002023146,247.5473210811615,109.26782202720642,510.95083236694336,14472,1599,12873,12873,0,8,1701000.0
1701,1701999,22.184625804255,38.525424020952336,0.042660488248881356,247.6672613620758,109.33134961128235,511.1324119567871,14472,1599,12873,12873,0,8,1702000.0
1702,1702999,22.188224693851954,38.532038966966304,0.04268388914892873,247.82637548446655,109.39532589912415,511.2267265319824,14474,1600,12874,12874,0,8,1703000.0
1703,1703999,22.189958988515052,38.53352031331428,0.04273453357027723,247.98568177223206,109.4597487449646,511.4651069641113,14479,1601,12878,12878,0,8,1704000.0
1704,1704999,22.19205456099555,38.546511640777794,0.042691612742905116,248.2019386291504,109.5237808227539,511.5738868713379,14500,1604,12896,12896,0,8,1705000.0
1705,1705999,22.190472847869277,38.54792284071095,0.042648673963138206,248.32451605796814,109.58752131462097,512.3410339355469,14508,1604,12904,12904,0,8,1706000.0
1706,1706999,22.186852656453816,38.54108118729531,0.042645150131171206,248.51608657836914,109.65167903900146,512.697322845459,14514,1606,12908,12908,0,8,1707000.0
1707,1707999,22.18303007441029,38.533913959777394,0.04265970239283001,248.69521021842957,109.7172257900238,513.0712394714355,14517,1607,12910,12910,0,8,1708000.0
1708,1708999,22.180179085669806,38.532567526524694,0.04264646725515653,248.82119464874268,109.78193688392639,513.545467376709,14518,1607,12911,12911,0,8,1709000.0
1709,1709999,22.17739925320973,38.52788474075882,0.0426407542377687,248.938303232193,109.84538340568542,513.8961296081543,14519,1607,12912,12912,0,8,1710000.0
1710,1710999,22.174626792953337,38.522893786907375,0.04262765923538403,249.16352820396423,109.91012167930603,514.1646156311035,14538,1610,12928,12928,0,8,1711000.0
1711,1711999,22.172885535157636,38.518671497870486,0.0426162149027306,249.2821490764618,109.97405934333801,514.7214508056641,14538,1610,12928,12928,0,8,1712000.0
1712,1712999,22.171535264312144,38.5147770267984,0.04260564055121607,249.3991093635559,110.03830766677856,515.0712242126465,14538,1610,12928,12928,0,8,1713000.0
1713,1713999,22.17043065098086,38.510997528202516,0.042581459612423544,249.58749103546143,110.1022264957428,515.2248039245605,14545,1612,12933,12933,0,8,1714000.0
1714,1714999,22.16946606362059,38.52245082824461,0.0425235848061879,249.7461802959442,110.1668746471405,515.5749626159668,14549,1613,12936,12936,0,8,1715000.0
1715,1715999,22.16970833390503,38.52182475185561,0.042502038834882905,249.91540622711182,110.23076152801514,515.907283782959,14554,1614,12940,12940,0,8,1716000.0
1716,1716999,22.169735133163186,38.521224271478644,0.04246999105900118,250.09427547454834,110.2944540977478,516.0537376403809,14558,1616,12942,12942,0,8,1717000.0
1717,1717999,22.171084496313266,38.52956385920366,0.04242893440249362,250.2154734134674,110.35876703262329,516.4071426391602,14560,1616,12944,12944,0,8,1718000.0
1718,1718999,22.172772143846785,38.53344878954859,0.042421802017869825,250.40750312805176,110.42346906661987,516.5614051818848,14566,1618,12948,12948,0,8,1719000.0
1719,1719999,22.174611609252743,38.53686053570576,0.04240841060056755,250.60658717155457,110.48757982254028,516.8837928771973,14574,1620,12954,12954,0,8,1720000.0
1720,1720999,22.17887078559918,38.54499914750972,0.042384381586179076,250.72548508644104,110.55179238319397,517.2056159973145,14574,1620,12954,12954,0,8,1721000.0
1721,1721999,22.183840778961272,38.56027082552579,0.042340730349051836,250.84352707862854,110.61600136756897,517.596809387207,14575,1620,12955,12955,0,8,1722000.0
1722,1722999,22.18875195350682,38.57446559173709,0.04233146421771483,251.04422283172607,110.68053245544434,517.771297454834,14579,1622,12957,12957,0,8,1723000.0
1723,1723999,22.192327783471395,38.58133565154481,0.042316501523487204,251.23181748390198,110.74411749839783,518.0271034240723,14585,1624,12961,12961,0,8,1724000.0
1724,1724999,22.196539753733354,38.589258664923356,0.04231982289692471,251.3833086490631,110.80846810340881,518.3745422363281,14588,1625,12963,12963,0,8,1725000.0
1725,1725999,22.197292848800505,38.58935317090914,0.04229717816928458,253.09366106987,110.87329912185669,518.9604644775391,14588,1625,12963,12963,0,8,1726000.0
1726,1726999,22.19339263415477,38.583040005158864,0.04230285470381345,253.2181031703949,110.93719434738159,519.4159851074219,14591,1625,12966,12966,0,8,1727000.0
1727,1727999,22.189496627033794,38.57784653100106,0.042311611094235424,253.4020481109619,111.00661993026733,519.8134613037109,14609,1626,12983,12983,0,8,1728000.0
1728,1728999,22.18624073473569,38.576993494329265,0.04230641093835563,253.6693730354309,111.07175397872925,520.1451835632324,14631,1630,13001,13001,0,8,1729000.0
1729,1729999,22.18312593277805,38.57323308066387,0.04230561728877791,253.86185884475708,111.13828921318054,520.4088134765625,14665,1632,13033,13033,0,8,1730000.0
1730,1730999,22.18095295333078,38.56949627959068,0.04229024982604379,254.026269197464,111.20316433906555,520.7755279541016,14668,1633,13035,13035,0,8,1731000.0
1731,1731999,22.178001815548008,38.56413916309326,0.04229095578454878,254.23108053207397,111.27032732963562,521.0998115539551,14672,1635,13037,13037,0,8,1732000.0
1732,1732999,22.175021758566558,38.55922630476627,0.04227940646862549,254.36474776268005,111.33453369140625,521.3724784851074,14672,1635,13037,13037,0,8,1733000.0
1733,1733999,22.172563127012545,38.554791545151296,0.04226308147644953,254.55669832229614,111.39906907081604,521.6069107055664,14678,1637,13041,13041,0,8,1734000.0
1734,1734999,22.1720276850886,38.55468978825667,0.04223235268389802,254.8063840866089,111.49550890922546,521.8333930969238,14682,1639,13043,13043,0,8,1735000.0
1735,1735999,22.171789629468254,38.55522034421016,0.042194979013864486,254.976300239563,111.55998682975769,522.0236587524414,14696,1640,13056,13056,0,8,1736000.0
1736,1736999,22.172061083937493,38.56887053434808,0.04213487955704409,255.16843032836914,111.62547135353088,522.2241325378418,14703,1642,13061,13061,0,8,1737000.0
1737,1737999,22.17220900732626,38.56940733473614,0.04209811091463511,255.3641755580902,111.68992018699646,522.4520378112793,14722,1644,13078,13078,0,8,1738000.0
1738,1738999,22.172760820787072,38.57042276510459,0.04206887535817838,255.56194972991943,111.75516128540039,522.9087791442871,14727,1646,13081,13081,0,8,1739000.0
1739,1739999,22.172988342164537,38.57100520148551,0.04203267339165162,255.72261118888855,111.81967425346375,523.3309478759766,14743,1647,13096,13096,0,8,1740000.0
1740,1740999,22.17473257128603,38.57411498477458,0.04200509421179133,255.89512467384338,111.88592004776001,523.7796897888184,14746,1648,13098,13098,0,8,1741000.0
1741,1741999,22.17670780538269,38.578471425414946,0.04199427112132492,256.0629644393921,111.95021653175354,524.0539817810059,14748,1649,13099,13099,0,8,1742000.0
1742,1742999,22.180514243504838,38.58766699178915,0.04198140085125668,256.2572727203369,112.01492142677307,524.4792213439941,14753,1651,13102,13102,0,8,1743000.0
1743,1743999,22.185286292155645,38.608173284873466,0.041934028138529866,256.44917821884155,112.07940578460693,524.7715110778809,14759,1653,13106,13106,0,8,1744000.0
1744,1744999,22.18863550855077,38.616387551703404,0.04191239638908684,256.57992458343506,112.14505314826965,525.0498847961426,14759,1653,13106,13106,0,8,1745000.0
1745,1745999,22.190839960523203,38.62022413558719,0.041878228408540386,256.73588824272156,112.20946979522705,525.4158706665039,14765,1654,13111,13111,0,8,1746000.0
1746,1746999,22.189812320689587,38.619480102527255,0.04187164180056635,256.8710014820099,112.27391386032104,526.293529510498,14770,1654,13116,13116,0,8,1747000.0
1747,1747999,22.189012579062698,38.62015771998905,0.04189736784229414,257.0652277469635,112.33836388587952,526.9469795227051,14837,1656,13181,13181,0,8,1748000.0
1748,1748999,22.186612035955232,38.61688602928341,0.04189953923524703,257.22375535964966,112.4044418334961,527.2738418579102,14840,1657,13183,13183,0,8,1749000.0
1749,1749999,22.184919526026523,38.616398245285176,0.04189899714293355,257.3557176589966,112.46864533424377,527.7535743713379,14841,1657,13184,13184,0,8,1750000.0
1750,1750999,22.18339130390562,38.61521434038705,0.04190541938017489,257.5286645889282,112.53329038619995,528.1321029663086,14850,1658,13192,13192,0,8,1751000.0
1751,1751999,22.18247622912872,38.61690693347608,0.04189541008443787,257.8266952037811,112.59919261932373,528.3429756164551,14861,1663,13198,13198,0,8,1752000.0
1752,1752999,22.181875064992084,38.61697354543371,0.041882092751101,258.01434659957886,112.66363978385925,528.6732978820801,14876,1665,13211,13211,0,8,1753000.0
1753,1753999,22.180846918165255,38.61474119436467,0.04187646806256784,258.1720905303955,112.72788882255554,528.9389877319336,14878,1666,13212,13212,0,8,1754000.0
1754,1754999,22.180094563515308,38.61351626714384,0.04187623303047261,258.4401636123657,112.79455828666687,529.0505294799805,14891,1670,13221,13221,0,8,1755000.0
1755,1755999,22.18000775006093,38.61288229671521,0.04186904858107443,258.56588101387024,112.8590955734253,529.3009414672852,14891,1670,13221,13221,0,8,1756000.0
1756,1756999,22.17911734640822,38.612201767641196,0.04185716263741457,258.730256319046,112.9241726398468,529.7106056213379,14908,1671,13237,13237,0,8,1757000.0
1757,1757999,22.18003619173062,38.61996173215627,0.04186771349567364,258.92312145233154,112.98877906799316,530.0983848571777,14916,1673,13243,13243,0,8,1758000.0
1758,1758999,22.18004850727642,38.61831628013818,0.04186441372284133,259.15549516677856,113.05380129814148,530.4773445129395,14938,1676,13262,13262,0,8,1759000.0
1759,1759999,22.180871058405774,38.61772945151286,0.041869466276125755,259.41687750816345,113.11905336380005,530.7099227905273,14965,1680,13285,13285,0,8,1760000.0
1760,1760999,22.181712841282152,38.61683848678064,0.0418773963415453,259.5821032524109,113.18507957458496,531.238037109375,14970,1681,13289,13289,0,8,1761000.0
1761,1761999,22.184331943474003,38.618999624945936,0.041892043147784164,259.7420711517334,113.25168800354004,531.7668190002441,14974,1682,13292,13292,0,8,1762000.0
1762,1762999,22.185273638723483,38.618795591538515,0.04189503847784348,260.0073525905609,113.31759524345398,531.9985160827637,14990,1686,13304,13304,0,8,1763000.0
1763,1763999,22.187263607199185,38.62348725613877,0.04189649369612869,260.19730257987976,113.38343524932861,532.3344650268555,14994,1688,13306,13306,0,8,1764000.0
1764,1764999,22.186881802021635,38.619712894374864,0.041821465321103424,260.3852243423462,113.44940900802612,533.0043754577637,15003,1690,13313,13313,0,8,1765000.0
1765,1765999,22.186889236008795,38.61732278596032,0.041726378523480934,260.6381325721741,113.52117729187012,533.4736404418945,15026,1693,13333,13333,0,8,1766000.0
1766,1766999,22.187612674999603,38.616083657008474,0.041636568062519586,260.7601041793823,113.58628296852112,533.8436965942383,15029,1693,13336,13336,0,8,1767000.0
1767,1767999,22.187596130750975,38.61396944820922,0.04157327139112055,260.8792748451233,113.65017533302307,534.3001556396484,15031,1693,13338,13338,0,8,1768000.0
1768,1768999,22.18778627694535,38.61181098947657,0.04149309304528548,261.0410692691803,113.71424913406372,534.6277694702148,15036,1694,13342,13342,0,8,1769000.0
1769,1769999,22.187907711166694,38.60830885892317,0.04140560837294327,261.16793036460876,113.77932643890381,535.0115852355957,15037,1694,13343,13343,0,8,1770000.0
1770,1770999,22.18824753749517,38.60491214529421,0.041293432465768776,261.28580379486084,113.84373927116394,535.3690490722656,15037,1694,13343,13343,0,8,1771000.0
1771,1771999,22.188747511119114,38.604176323659225,0.04121500989494187,261.4440815448761,113.90801453590393,535.6338424682617,15040,1695,13345,13345,0,8,1772000.0
1772,1772999,22.189410060470315,38.60215891382627,0.04111501653306937,261.6131362915039,113.97303199768066,535.947021484375,15043,1696,13347,13347,0,8,1773000.0
1773,1773999,22.189594811369002,38.599801627137005,0.04107648921776674,261.83718514442444,114.03723073005676,536.1025466918945,15050,1699,13351,13351,0,8,1774000.0
1774,1774999,22.19033799354078,38.596947833500344,0.04103421027116427,261.99177861213684,114.10114026069641,536.3899154663086,15052,1700,13352,13352,0,8,1775000.0
1775,1775999,22.191884177475984,38.59723898673933,0.041004289055046717,262.12124276161194,114.16626524925232,536.6233520507812,15054,1700,13354,13354,0,8,1776000.0
1776,1776999,22.19470613277073,38.60099405487287,0.04097021692490688,262.3521749973297,114.23028874397278,536.669605255127,15066,1703,13363,13363,0,8,1777000.0
1777,1777999,22.196517770227278,38.60043506575873,0.040977974906538206,262.54055094718933,114.2947313785553,536.8561172485352,15070,1705,13365,13365,0,8,1778000.0
1778,1778999,22.20112013545454,38.60542552975158,0.04098011107498023,262.65968680381775,114.35858678817749,537.154224395752,15071,1705,13366,13366,0,8,1779000.0
1779,1779999,22.205557095896456,38.608956789625395,0.041019185452514595,262.78100419044495,114.42182397842407,537.4253196716309,15071,1705,13366,13366,0,8,1780000.0
1780,1780999,22.21223377610355,38.61795077396549,0.04104670449418146,262.89983344078064,114.485586643219,537.6821403503418,15072,1705,13367,13367,0,8,1781000.0
1781,1781999,22.21905056542191,38.62835766863154,0.041102274961991814,263.06250381469727,114.54948019981384,537.9058494567871,15076,1706,13370,13370,0,8,1782000.0
1782,1782999,22.22565937911344,38.638823156537406,0.04114416960779754,263.1874303817749,114.61402630805969,538.1303176879883,15078,1706,13372,13372,0,8,1783000.0
1783,1783999,22.23027362974093,38.642544351278026,0.04112909223849881,263.41483068466187,114.6779351234436,538.2481994628906,15087,1709,13378,13378,0,8,1784000.0
1784,1784999,22.230994232300084,38.63980343478533,0.04107186532910978,263.56770873069763,114.74217414855957,538.9422760009766,15125,1710,13415,13415,0,8,1785000.0
1785,1785999,22.23048446033181,38.63758343939411,0.041010880628298496,263.7321481704712,114.80686902999878,539.3384895324707,15130,1711,13419,13419,0,8,1786000.0
1786,1786999,22.22952820838835,38.63388997334799,0.040934556515476284,263.9625973701477,114.87668085098267,539.502799987793,15142,1714,13428,13428,0,8,1787000.0
1787,1787999,22.2293035572518,38.63195151931152,0.040874505978427234,264.1552937030792,114.94093418121338,539.7574348449707,15174,1716,13458,13458,0,8,1788000.0
1788,1788999,22.228813987260114,38.62955983213225,0.04085594292319805,264.28674387931824,115.00568342208862,540.0132293701172,15174,1716,13458,13458,0,8,1789000.0
1789,1789999,22.22873937646337,38.626921369253516,0.04082254168316657,264.4094440937042,115.0695481300354,540.3845748901367,15174,1716,13458,13458,0,8,1790000.0
1790,1790999,22.22791136976581,38.621732859562485,0.040772673410243154,264.5348479747772,115.13371014595032,540.7195281982422,15174,1716,13458,13458,0,8,1791000.0
1791,1791999,22.227821842589464,38.61844312533038,0.04073540169364431,264.6583170890808,115.19826412200928,541.0355682373047,15175,1716,13459,13459,0,8,1792000.0
1792,1792999,22.227352608023395,38.613360242881875,0.04068912587476825,264.8458659648895,115.26209449768066,541.1896629333496,15179,1718,13461,13461,0,8,1793000.0
1793,1793999,22.228538651211785,38.62073171207816,0.040602242543904876,264.9792172908783,115.32603740692139,541.5448036193848,15179,1718,13461,13461,0,8,1794000.0
1794,1794999,22.230068723755984,38.619131237696635,0.04054742263871669,265.1737401485443,115.39107728004456,541.6229934692383,15184,1720,13464,13464,0,8,1795000.0
1795,1795999,22.2310072168601,38.61520257067925,0.040483587508496566,265.3266999721527,115.45522046089172,541.9383659362793,15187,1721,13466,13466,0,8,1796000.0
1796,1796999,22.231948365703715,38.61263266498948,0.04044525293720491,265.51419019699097,115.51942300796509,542.1255989074707,15193,1723,13470,13470,0,8,1797000.0
1797,1797999,22.232538883404104,38.60859660510322,0.0404185728990607,265.7620487213135,115.58353924751282,542.100715637207,15203,1727,13476,13476,0,8,1798000.0
1798,1798999,22.23323657440616,38.60527135785815,0.04038589415308014,265.92752861976624,115.64746499061584,542.3257293701172,15206,1728,13478,13478,0,8,1799000.0
1799,1799999,22.235162887569434,38.60293048379047,0.040358829504534954,266.0449240207672,115.71143412590027,542.6251335144043,15206,1728,13478,13478,0,8,1800000.0
1800,1800999,22.237079786984935,38.609395986676105,0.04032173284696994,266.1843240261078,115.77637600898743,542.8215560913086,15206,1728,13478,13478,0,8,1801000.0
1801,1801999,22.238842106665572,38.607330383689,0.04027302922955789,266.3436939716339,115.84003710746765,543.0522766113281,15211,1729,13482,13482,0,8,1802000.0
1802,1802999,22.240346018905896,38.60455395482544,0.040248452236371524,266.4951066970825,115.90389490127563,543.2466316223145,15215,1730,13485,13485,0,8,1803000.0
1803,1803999,22.24056954634814,38.600575421920446,0.04023623521581565,266.62195920944214,115.96846747398376,543.4505348205566,15215,1730,13485,13485,0,8,1804000.0
1804,1804999,22.24006643055458,38.595727623827614,0.04022688377524841,266.78502106666565,116.03267550468445,543.7129211425781,15222,1731,13491,13491,0,8,1805000.0
1805,1805999,22.23822064718918,38.59176262069984,0.040206957398754906,266.9380371570587,116.09609937667847,544.1504135131836,15224,1732,13492,13492,0,8,1806000.0
1806,1806999,22.23492202148605,38.58631041010787,0.040213840983600035,267.1299481391907,116.16015768051147,544.2894592285156,15235,1734,13501,13501,0,8,1807000.0
1807,1807999,22.233298054185656,38.58484189865771,0.04021328340615238,267.3531975746155,116.22473883628845,544.4004554748535,15244,1737,13507,13507,0,8,1808000.0
1808,1808999,22.233076385130357,38.58692511846469,0.04023900632153954,267.49198174476624,116.28935647010803,544.696403503418,15244,1737,13507,13507,0,8,1809000.0
1809,1809999,22.231858080385134,38.58778626939902,0.040244348811591224,267.6183271408081,116.35297083854675,544.8727226257324,15244,1737,13507,13507,0,8,1810000.0
1810,1810999,22.23193251906052,38.58958790642486,0.04027306854548662,267.7522749900818,116.41764402389526,545.0714530944824,15245,1737,13508,13508,0,8,1811000.0
1811,1811999,22.233396304409553,38.59305215674693,0.040274229102550296,267.90264868736267,116.48181533813477,545.3084983825684,15246,1737,13509,13509,0,8,1812000.0
1812,1812999,22.234220765488946,38.593217890613595,0.04029329427987827,268.02470207214355,116.54574823379517,545.5283584594727,15246,1737,13509,13509,0,8,1813000.0
1813,1813999,22.234062229409794,38.59188438294898,0.040297646258819375,268.1927251815796,116.60996627807617,545.6386528015137,15248,1738,13510,13510,0,8,1814000.0
1814,1814999,22.234455465544638,38.59285739614458,0.040286415810861675,268.3859488964081,116.6748194694519,545.6903991699219,15265,1740,13525,13525,0,8,1815000.0
1815,1815999,22.235758453874837,38.596585490689336,0.040318526820625644,268.56119775772095,116.73933482170105,545.8911247253418,15268,1741,13527,13527,0,8,1816000.0
1816,1816999,22.23622642815783,38.59545393273204,0.040324759847706004,268.6769366264343,116.80227851867676,546.081184387207,15268,1741,13527,13527,0,8,1817000.0
1817,1817999,22.23611455526273,38.593611543411,0.04032406756757878,268.877183675766,116.86714339256287,546.203742980957,15274,1743,13531,13531,0,8,1818000.0
1818,1818999,22.238096087285218,38.600885650852135,0.04032521654094956,269.0820288658142,116.93138241767883,546.2775764465332,15292,1745,13547,13547,0,8,1819000.0
1819,1819999,22.23899885016825,38.59993309192437,0.04033156151983042,269.2071907520294,116.99471020698547,546.4857292175293,15292,1745,13547,13547,0,8,1820000.0
1820,1820999,22.23976340916613,38.59884935392147,0.040358013258586234,269.3755142688751,117.05835723876953,546.6828842163086,15306,1746,13560,13560,0,8,1821000.0
1821,1821999,22.242065773739778,38.60158641196749,0.040353313333211016,269.49744272232056,117.12277603149414,547.0491790771484,15307,1746,13561,13561,0,8,1822000.0
1822,1822999,22.243755865236174,38.601467836936614,0.04035670904826372,269.62040615081787,117.18651723861694,547.3462867736816,15308,1746,13562,13562,0,8,1823000.0
1823,1823999,22.248273933251273,38.60665075392547,0.04038671890657897,269.7828986644745,117.25097417831421,547.5556449890137,15327,1747,13580,13580,0,8,1824000.0
1824,1824999,22.25061665287843,38.60751915064794,0.04038636630788628,269.93732142448425,117.31537532806396,547.8321990966797,15345,1748,13597,13597,0,8,1825000.0
1825,1825999,22.249136553467906,38.603643224536675,0.04039390678508048,270.0992774963379,117.37965250015259,548.6063613891602,15374,1749,13625,13625,0,8,1826000.0
1826,1826999,22.24561459771798,38.59969442319106,0.04039009692908302,270.21937704086304,117.44347858428955,549.1708068847656,15379,1749,13630,13630,0,8,1827000.0
1827,1827999,22.242186079136097,38.59490089019823,0.04039487540260911,270.4374921321869,117.50705337524414,549.2751731872559,15390,1752,13638,13638,0,8,1828000.0
1828,1828999,22.240344189456543,38.59423044125129,0.04039756224431379,270.56451296806335,117.57105803489685,549.5375595092773,15391,1752,13639,13639,0,8,1829000.0
1829,1829999,22.236776611728654,38.58768952489183,0.040389207317527376,270.73222851753235,117.63455176353455,549.6952896118164,15422,1753,13669,13669,0,8,1830000.0
1830,1830999,22.234787594319496,38.59510357428045,0.040350556079073896,270.89370107650757,117.69804906845093,549.8230323791504,15424,1754,13670,13670,0,8,1831000.0
1831,1831999,22.232828523743525,38.59078972675974,0.04034479238104782,271.0190100669861,117.76264095306396,550.0288391113281,15424,1754,13670,13670,0,8,1832000.0
1832,1832999,22.23160992970201,38.58938014179399,0.04034399891724294,271.1378116607666,117.82599925994873,550.2450714111328,15425,1754,13671,13671,0,8,1833000.0
1833,1833999,22.230590917234032,38.586560503886446,0.04033097613326575,271.34918093681335,117.88965106010437,550.3361015319824,15438,1756,13682,13682,0,8,1834000.0
1834,1834999,22.230466596458143,38.585589916704734,0.04032326151224774,271.47702383995056,117.95317816734314,550.5389442443848,15438,1756,13682,13682,0,8,1835000.0
1835,1835999,22.23209686161834,38.587357834909206,0.04032286975846344,271.64813590049744,118.01686835289001,550.6447563171387,15440,1757,13683,13683,0,8,1836000.0
1836,1836999,22.233718025331356,38.59036419848373,0.040323706331575115,271.81025552749634,118.08034062385559,550.8318099975586,15454,1758,13696,13696,0,8,1837000.0
1837,1837999,22.236158066937147,38.59355679128767,0.04034240025367308,272.0069410800934,118.14402174949646,550.9048728942871,15459,1760,13699,13699,0,8,1838000.0
1838,1838999,22.23870166698599,38.596357066686316,0.0403594473787936,272.17021799087524,118.20839500427246,551.0211296081543,15461,1761,13700,13700,0,8,1839000.0
1839,1839999,22.24256284305181,38.60206232500002,0.040370634421867835,272.32622480392456,118.27189302444458,551.1969184875488,15463,1762,13701,13701,0,8,1840000.0
1840,1840999,22.247130798102273,38.61042832205044,0.0403930989002238,272.4473776817322,118.33519840240479,551.4501686096191,15463,1762,13701,13701,0,8,1841000.0
1841,1841999,22.25300876521941,38.618812308867874,0.04046485424784485,272.587673664093,118.3989315032959,551.6233329772949,15463,1762,13701,13701,0,8,1842000.0
1842,1842999,22.258691707313982,38.62667180269044,0.04047407578053375,272.70759987831116,118.46218419075012,551.8688316345215,15464,1762,13702,13702,0,8,1843000.0
1843,1843999,22.265909915814685,38.637260714391196,0.04052998645671002,272.8298885822296,118.5252947807312,552.0683403015137,15466,1762,13704,13704,0,8,1844000.0
1844,1844999,22.27277006134367,38.65672153947384,0.0405896352662829,272.9559988975525,118.58833742141724,552.2389335632324,15467,1762,13705,13705,0,8,1845000.0
1845,1845999,22.277219905278557,38.662381162037065,0.04060083370224088,273.09147453308105,118.65133285522461,552.3817710876465,15467,1762,13705,13705,0,8,1846000.0
1846,1846999,22.276156639182037,38.65893425115679,0.04062847585098195,273.28098797798157,118.71534371376038,552.7698287963867,15481,1764,13717,13717,0,8,1847000.0
1847,1847999,22.27254033118232,38.65366596472276,0.04063467111190899,273.40829634666443,118.77900791168213,553.1177406311035,15486,1764,13722,13722,0,8,1848000.0
1848,1848999,22.26933153507339,38.64753185077235,0.040620008875833835,273.5347480773926,118.842360496521,553.298095703125,15486,1764,13722,13722,0,8,1849000.0
1849,1849999,22.266275072649787,38.64369351856389,0.04061622625520567,273.6958544254303,118.90730118751526,553.5382881164551,15498,1765,13733,13733,0,8,1850000.0
1850,1850999,22.263608672812293,38.638377673719766,0.040614590155503616,273.825443983078,118.9703061580658,553.6399536132812,15498,1765,13733,13733,0,8,1851000.0
1851,1851999,22.261222927956428,38.63256288978727,0.04061161848755379,273.98963260650635,119.03426504135132,553.7762489318848,15501,1766,13735,13735,0,8,1852000.0
1852,1852999,22.258698192928257,38.62706358002613,0.04060392792569856,274.10775232315063,119.09796810150146,553.9438171386719,15501,1766,13735,13735,0,8,1853000.0
1853,1853999,22.25674131497059,38.6220344726166,0.04059326742370317,274.2379267215729,119.16133236885071,554.0823974609375,15501,1766,13735,13735,0,8,1854000.0
1854,1854999,22.255116928150997,38.61710548992956,0.04058132343759957,274.3631081581116,119.22450923919678,554.1959991455078,15501,1766,13735,13735,0,8,1855000.0
1855,1855999,22.25444906480262,38.614123649287585,0.040575326728857775,274.5281729698181,119.287593126297,554.2817916870117,15503,1767,13736,13736,0,8,1856000.0
1856,1856999,22.253344363816467,38.61036248278558,0.0405665058373047,274.6647205352783,119.35075378417969,554.3960342407227,15503,1767,13736,13736,0,8,1857000.0
1857,1857999,22.25318169352606,38.608815243369264,0.04059109202171951,274.82047033309937,119.41406273841858,554.518856048584,15509,1768,13741,13741,0,8,1858000.0
1858,1858999,22.253921142929773,38.60784786194936,0.04059392126784733,275.0378692150116,119.4777410030365,554.5591735839844,15513,1770,13743,13743,0,8,1859000.0
1859,1859999,22.255469190217195,38.60992341268395,0.04062857877212689,275.1964888572693,119.54164338111877,554.6946067810059,15544,1771,13773,13773,0,8,1860000.0
1860,1860999,22.25686868200572,38.609751028682425,0.04066162703273213,275.313458442688,119.60563230514526,554.8328170776367,15544,1771,13773,13773,0,8,1861000.0
1861,1861999,22.259777642028943,38.61287306985327,0.04072084128854514,275.4811408519745,119.66917014122009,554.9273567199707,15560,1772,13788,13788,0,8,1862000.0
1862,1862999,22.262364349995707,38.61494327659296,0.04076429019995209,275.60553526878357,119.73208713531494,555.0778732299805,15560,1772,13788,13788,0,8,1863000.0
1863,1863999,22.265707868539405,38.61712849593077,0.04079083126019112,275.7209873199463,119.7953417301178,555.2512474060059,15561,1772,13789,13789,0,8,1864000.0
1864,1864999,22.269101981388822,38.61997900539912,0.040837220507187966,275.843820810318,119.85877513885498,555.4316787719727,15562,1772,13790,13790,0,8,1865000.0
1865,1865999,22.27202104260663,38.62160275317346,0.040872615855214844,276.0044641494751,119.92298340797424,555.5460662841797,15567,1773,13794,13794,0,8,1866000.0
1866,1866999,22.272835354730585,38.62006023167378,0.04089812814616056,276.2244384288788,119.98682713508606,555.7190742492676,15595,1775,13820,13820,0,8,1867000.0
1867,1867999,22.27095973886176,38.62049054227291,0.040885371356296996,276.410763502121,120.05016493797302,556.2827568054199,15618,1777,13841,13841,0,8,1868000.0
1868,1868999,22.266245810034626,38.61292384642392,0.04089387277431189,276.58019828796387,120.11428380012512,556.5273628234863,15621,1778,13843,13843,0,8,1869000.0
1869,1869999,22.262591732142187,38.61071245555197,0.04090529575235613,276.70074558258057,120.17810392379761,556.8218002319336,15621,1778,13843,13843,0,8,1870000.0
1870,1870999,22.258807344901534,38.60457615387349,0.04092414920994836,276.8533134460449,120.24159646034241,556.9596405029297,15637,1779,13858,13858,0,8,1871000.0
1871,1871999,22.25513109630383,38.597995298119905,0.040931095536612894,277.04362297058105,120.30523157119751,556.9762420654297,15643,1781,13862,13862,0,8,1872000.0
1872,1872999,22.25164630971689,38.59189921874024,0.04092763716729397,277.19973731040955,120.36926221847534,557.1119766235352,15645,1782,13863,13863,0,8,1873000.0
1873,1873999,22.24881717324209,38.58542086698772,0.0409348097677702,277.3544166088104,120.43278646469116,557.3032531738281,15661,1783,13878,13878,0,8,1874000.0
1874,1874999,22.24643851281229,38.58111547623735,0.040923592135752807,277.49678802490234,120.49669599533081,557.4804916381836,15661,1783,13878,13878,0,8,1875000.0
1875,1875999,22.24424043177799,38.57584591839974,0.04093038951312156,277.6291015148163,120.56104135513306,557.6454238891602,15661,1783,13878,13878,0,8,1876000.0
1876,1876999,22.242428357356644,38.57227459422497,0.04092769695964793,277.8216669559479,120.62484622001648,557.7382354736328,15667,1785,13882,13882,0,8,1877000.0
1877,1877999,22.24075417675556,38.570275821488856,0.04092315984512773,278.03431820869446,120.6904513835907,557.7705192565918,15678,1787,13891,13891,0,8,1878000.0
1878,1878999,22.23978826406131,38.56815305433878,0.04093324884562921,278.2235059738159,120.7543683052063,557.8688545227051,15683,1789,13894,13894,0,8,1879000.0
1879,1879999,22.239255608039958,38.566183224807276,0.040934888406576886,278.38758969306946,120.81816744804382,558.0196800231934,15687,1790,13897,13897,0,8,1880000.0
1880,1880999,22.239160662399957,38.570096199665684,0.04093371555433489,278.6167502403259,120.88210248947144,557.9946937561035,15695,1793,13902,13902,0,8,1881000.0
1881,1881999,22.23913999878725,38.568616043022836,0.04093275713225131,278.74593019485474,120.94627213478088,558.2880401611328,15695,1793,13902,13902,0,8,1882000.0
1882,1882999,22.2402874538878,38.568191163064284,0.040952062862359306,278.90087151527405,121.01021027565002,558.4547729492188,15698,1794,13904,13904,0,8,1883000.0
1883,1883999,22.240792960823896,38.5669788309256,0.04097585099343426,279.06101155281067,121.0740556716919,558.6342964172363,15701,1795,13906,13906,0,8,1884000.0
1884,1884999,22.242943367580583,38.569000709034846,0.040996066814433796,279.2224326133728,121.13822960853577,558.8266639709473,15708,1796,13912,13912,0,8,1885000.0
1885,1885999,22.244410349289222,38.56898209372179,0.041016437110140136,279.37684655189514,121.20180773735046,559.0013122558594,15711,1797,13914,13914,0,8,1886000.0
1886,1886999,22.244994747322277,38.56729790780663,0.04103771699146863,279.57005429267883,121.2661464214325,559.0325393676758,15732,1799,13933,13933,0,8,1887000.0
1887,1887999,22.24571340745157,38.565561685200414,0.041048257370232544,279.85346150398254,121.33267521858215,559.123592376709,15760,1803,13957,13957,0,8,1888000.0
1888,1888999,22.24350405182156,38.5600460097391,0.04103361534129735,279.9765636920929,121.39680099487305,559.8640670776367,15770,1803,13967,13967,0,8,1889000.0
1889,1889999,22.240248120494254,38.5537104116666,0.041029901220665965,280.1051733493805,121.46033263206482,560.2336349487305,15774,1803,13971,13971,0,8,1890000.0
1890,1890999,22.238233956845345,38.550004413399044,0.04104331451147869,280.2307140827179,121.52387070655823,560.4461708068848,15774,1803,13971,13971,0,8,1891000.0
1891,1891999,22.235366576495412,38.543955483311244,0.04105476632091232,280.3524124622345,121.58833980560303,560.6850357055664,15774,1803,13971,13971,0,8,1892000.0
1892,1892999,22.232603834771613,38.53763439884843,0.04106156669356675,280.51972007751465,121.65205430984497,560.8146324157715,15777,1804,13973,13973,0,8,1893000.0
1893,1893999,22.230568653643893,38.533239401611084,0.04106467022071958,280.6453688144684,121.71589088439941,561.0338020324707,15777,1804,13973,13973,0,8,1894000.0
1894,1894999,22.228548241004212,38.530847491342996,0.04105850400562494,280.80326747894287,121.77955412864685,561.2308692932129,15780,1805,13975,13975,0,8,1895000.0
1895,1895999,22.22703854005231,38.52828037831599,0.041043900629775254,281.0258274078369,121.84424376487732,561.3099899291992,15793,1808,13985,13985,0,8,1896000.0
1896,1896999,22.225162435499403,38.52347422221931,0.0410299114001178,281.14480996131897,121.90832090377808,561.5689125061035,15793,1808,13985,13985,0,8,1897000.0
1897,1897999,22.222904890150726,38.518330778231125,0.041015421354916315,281.3142948150635,121.97223663330078,561.6359901428223,15796,1809,13987,13987,0,8,1898000.0
1898,1898999,22.221419594976055,38.51472383131638,0.04101027542562152,281.482932806015,122.0362401008606,561.8188552856445,15800,1810,13990,13990,0,8,1899000.0
1899,1899999,22.219856055572556,38.512739591078905,0.04098678942791001,281.65809655189514,122.10092782974243,561.9467658996582,15815,1811,14004,14004,0,8,1900000.0
1900,1900999,22.217708561069802,38.50695465717561,0.04097072324742901,281.82831835746765,122.16572642326355,562.2631950378418,15824,1812,14012,14012,0,8,1901000.0
1901,1901999,22.216303755435884,38.50203937900055,0.04095953351621362,281.95387530326843,122.22969055175781,562.4566116333008,15824,1812,14012,14012,0,8,1902000.0
1902,1902999,22.215304890315075,38.49777362965685,0.04095078934004426,282.1191267967224,122.29301571846008,562.6678581237793,15839,1813,14026,14026,0,8,1903000.0
1903,1903999,22.215302755576964,38.49441374118711,0.040940044736340386,282.3056719303131,122.35679936408997,562.822437286377,15848,1815,14033,14033,0,8,1904000.0
1904,1904999,22.214165698458736,38.48960619922763,0.040932601127122714,282.422563791275,122.42041969299316,562.9995002746582,15848,1815,14033,14033,0,8,1905000.0
1905,1905999,22.213147898674578,38.485138507939,0.04091164529041236,282.6627914905548,122.48436880111694,563.0364799499512,15864,1818,14046,14046,0,8,1906000.0
1906,1906999,22.210562374638403,38.47991853313705,0.04091139527592502,282.7916753292084,122.54798913002014,563.5106163024902,15871,1818,14053,14053,0,8,1907000.0
1907,1907999,22.20650638390783,38.474552808596115,0.04093325157347627,282.95103454589844,122.61210680007935,563.8029899597168,15905,1819,14086,14086,0,8,1908000.0
1908,1908999,22.202647471034435,38.46944615206242,0.04095772804472464,283.11889362335205,122.67617702484131,563.9489974975586,15921,1820,14101,14101,0,8,1909000.0
1909,1909999,22.19885525204608,38.46377691054369,0.04098830155830757,283.2756185531616,122.74019932746887,564.0787391662598,15924,1821,14103,14103,0,8,1910000.0
1910,1910999,22.195171428535524,38.45769710701262,0.04101708050871444,283.47557187080383,122.80460500717163,564.2247161865234,15945,1823,14122,14122,0,8,1911000.0
1911,1911999,22.19182204708955,38.451248102826625,0.04104103418148741,283.59556913375854,122.86859464645386,564.4618606567383,15945,1823,14122,14122,0,8,1912000.0
1912,1912999,22.18784721277862,38.44405162623674,0.041061684483230776,283.7285327911377,122.93221712112427,564.6853294372559,15945,1823,14122,14122,0,8,1913000.0
1913,1913999,22.184341881746253,38.43782384787769,0.041086618483298976,283.85813069343567,122.99583435058594,564.8575210571289,15945,1823,14122,14122,0,8,1914000.0
1914,1914999,22.18136064734863,38.43691278164485,0.04108674124951828,284.0227656364441,123.0611526966095,565.0161514282227,15948,1824,14124,14124,0,8,1915000.0
1915,1915999,22.178647723284907,38.433125875956975,0.04109358339645519,284.20518016815186,123.12572526931763,565.2035598754883,15951,1825,14126,14126,0,8,1916000.0
1916,1916999,22.175581267260053,38.42769772988251,0.04110379969821687,284.39575123786926,123.18943905830383,565.266487121582,15969,1827,14142,14142,0,8,1917000.0
1917,1917999,22.17297622435039,38.42292951501089,0.041130849139611514,284.53211784362793,123.25345921516418,565.4613914489746,15969,1827,14142,14142,0,8,1918000.0
1918,1918999,22.170887878049655,38.43082204635093,0.04110883313549951,284.65295338630676,123.31802296638489,565.5928153991699,15969,1827,14142,14142,0,8,1919000.0
1919,1919999,22.169431734007734,38.42786505734847,0.04110655239101568,284.8217034339905,123.38190031051636,565.7550048828125,15972,1828,14144,14144,0,8,1920000.0
1920,1920999,22.168596616623212,38.426484851395,0.04110774833839381,284.95421409606934,123.44553136825562,565.9683570861816,15972,1828,14144,14144,0,8,1921000.0
1921,1921999,22.167517575898838,38.425791660206585,0.041095824258994496,285.1582109928131,123.50959134101868,566.1353569030762,15996,1830,14166,14166,0,8,1922000.0
1922,1922999,22.165734588082042,38.420755270128616,0.04109740883329416,285.28120279312134,123.57325839996338,566.4514961242676,15997,1830,14167,14167,0,8,1923000.0
1923,1923999,22.16442542360672,38.41722333808564,0.04111022025679045,285.45240783691406,123.63754153251648,566.7025451660156,16029,1831,14198,14198,0,8,1924000.0
1924,1924999,22.162072552735573,38.41226156000238,0.04111530111310879,285.5750353336334,123.70128607749939,566.977970123291,16031,1831,14200,14200,0,8,1925000.0
1925,1925999,22.159687338979328,38.407163878199746,0.041125127531139505,285.7750914096832,123.76492929458618,567.1969795227051,16039,1833,14206,14206,0,8,1926000.0
1926,1926999,22.156181468212537,38.40388647805088,0.041132842284454574,285.9681615829468,123.83009147644043,567.7933654785156,16062,1835,14227,14227,0,8,1927000.0
1927,1927999,22.15105927202405,38.39878735632152,0.04116788450203002,286.1626069545746,123.89423108100891,568.1897811889648,16077,1837,14240,14240,0,8,1928000.0
1928,1928999,22.146251071369413,38.392343690334364,0.04117547851770087,286.3230314254761,123.9585554599762,568.5014305114746,16080,1838,14242,14242,0,8,1929000.0
1929,1929999,22.142447500997704,38.38834455325231,0.04118458491679444,286.45576095581055,124.02317214012146,568.8010673522949,16080,1838,14242,14242,0,8,1930000.0
1930,1930999,22.138237591169766,38.38151882648701,0.04120710915698822,286.5828595161438,124.0868330001831,569.0134735107422,16080,1838,14242,14242,0,8,1931000.0
1931,1931999,22.133940664272107,38.374409794705514,0.04122704807375854,286.7020254135132,124.1514344215393,569.2981910705566,16080,1838,14242,14242,0,8,1932000.0
1932,1932999,22.129987522856904,38.36749222318903,0.04123836138532555,286.8238685131073,124.2150251865387,569.5542602539062,16080,1838,14242,14242,0,8,1933000.0
1933,1933999,22.12605955466225,38.36126522710017,0.04125221039432192,286.98678040504456,124.27934265136719,569.803524017334,16091,1839,14252,14252,0,8,1934000.0
1934,1934999,22.122654399438897,38.35579318623132,0.04125417060601677,287.2581522464752,124.34482026100159,569.8856086730957,16103,1843,14260,14260,0,8,1935000.0
1935,1935999,22.11870406369353,38.34928818164448,0.0412725423302841,287.43089628219604,124.40901970863342,570.1211242675781,16106,1844,14262,14262,0,8,1936000.0
1936,1936999,22.1154513373209,38.343400728764905,0.04128439341015222,287.6004557609558,124.47366786003113,570.3489685058594,16109,1845,14264,14264,0,8,1937000.0
1937,1937999,22.11315097092358,38.340579451056094,0.04128351896123861,287.72455739974976,124.53841495513916,570.5954360961914,16110,1845,14265,14265,0,8,1938000.0
1938,1938999,22.109764246378127,38.335100366232744,0.04129141861752261,287.8906464576721,124.602792263031,570.7624244689941,16113,1846,14267,14267,0,8,1939000.0
1939,1939999,22.106947328466404,38.32944767168702,0.04129625445272367,288.01338028907776,124.66668319702148,570.9377555847168,16113,1846,14267,14267,0,8,1940000.0
1940,1940999,22.104335331466128,38.32519940009166,0.041292787925549246,288.1423239707947,124.73019123077393,571.1792869567871,16113,1846,14267,14267,0,8,1941000.0
1941,1941999,22.10237028357339,38.321520625087174,0.04128775734971757,288.27516770362854,124.79401659965515,571.4110450744629,16113,1846,14267,14267,0,8,1942000.0
1942,1942999,22.100081324135473,38.31616292441492,0.04128994998086055,288.39661931991577,124.857994556427,571.6139755249023,16113,1846,14267,14267,0,8,1943000.0
1943,1943999,22.0985128075443,38.31543044404441,0.041276519922644805,288.51446509361267,124.92192053794861,571.8172264099121,16114,1846,14268,14268,0,8,1944000.0
1944,1944999,22.096397307329784,38.310043909995656,0.04128511394101564,288.67436122894287,124.98649740219116,571.9832534790039,16118,1847,14271,14271,0,8,1945000.0
1945,1945999,22.09401227896892,38.304727028414625,0.04128199963121648,288.8712010383606,125.05098605155945,572.1823120117188,16124,1849,14275,14275,0,8,1946000.0
1946,1946999,22.091289835494422,38.29901222318878,0.041272654134637765,289.07090640068054,125.1153633594513,572.3567962646484,16131,1851,14280,14280,0,8,1947000.0
1947,1947999,22.08733862514159,38.292922399894124,0.041299715178364504,289.1929910182953,125.1797308921814,572.7980918884277,16131,1851,14280,14280,0,8,1948000.0
1948,1948999,22.081634525381492,38.28610538737212,0.04133973289057591,289.4596834182739,125.24415755271912,572.8449211120605,16152,1855,14297,14297,0,8,1949000.0
1949,1949999,22.076367817840207,38.27939045967657,0.041373365128112516,289.6196599006653,125.30852508544922,572.9864120483398,16155,1856,14299,14299,0,8,1950000.0
1950,1950999,22.071929253271026,38.274987107423264,0.04138736166097756,289.7388939857483,125.37220191955566,573.2978134155273,16157,1856,14301,14301,0,8,1951000.0
1951,1951999,22.067276025406752,38.267985424422584,0.041407487747675886,289.8693382740021,125.43607902526855,573.5032501220703,16158,1856,14302,14302,0,8,1952000.0
1952,1952999,22.062935699015807,38.26139737337561,0.04142036975392005,289.9978549480438,125.50005555152893,573.6529693603516,16158,1856,14302,14302,0,8,1953000.0
1953,1953999,22.05856651372496,38.25491017163757,0.04143874121093982,290.13091564178467,125.56385517120361,573.868782043457,16158,1856,14302,14302,0,8,1954000.0
1954,1954999,22.05397669131523,38.247569516844216,0.041458507671481515,290.2866003513336,125.62763214111328,574.0005531311035,16161,1857,14304,14304,0,8,1955000.0
1955,1955999,22.04968563569214,38.24250447473361,0.04146100891431781,290.4460427761078,125.69141244888306,574.1720924377441,16191,1858,14333,14333,0,8,1956000.0
1956,1956999,22.045603729804935,38.23692648209746,0.04147767813142034,290.5726206302643,125.75536870956421,574.3933601379395,16191,1858,14333,14333,0,8,1957000.0
1957,1957999,22.042526159605497,38.233729446376664,0.04148091171004875,290.77984070777893,125.82024836540222,574.4927673339844,16202,1860,14342,14342,0,8,1958000.0
1958,1958999,22.038744648939268,38.23047193790144,0.0414833867752602,290.9016275405884,125.8847873210907,574.7110748291016,16202,1860,14342,14342,0,8,1959000.0
1959,1959999,22.03546725259267,38.22635228117098,0.041481454920169525,291.02458930015564,125.9485445022583,574.9304656982422,16202,1860,14342,14342,0,8,1960000.0
1960,1960999,22.032224072275053,38.22090498214358,0.04147875602953677,291.20142221450806,126.01343870162964,575.0029296875,16207,1861,14346,14346,0,8,1961000.0
1961,1961999,22.029249984644732,38.21513407320459,0.041480789891558456,291.3573887348175,126.07704019546509,575.1801643371582,16221,1862,14359,14359,0,8,1962000.0
1962,1962999,22.026952144559388,38.21144306409014,0.041473776579506905,291.55715560913086,126.14215230941772,575.3576278686523,16246,1864,14382,14382,0,8,1963000.0
1963,1963999,22.025008421168465,38.20768572142165,0.04146255004274846,291.7224311828613,126.20598483085632,575.5488433837891,16262,1865,14397,14397,0,8,1964000.0
1964,1964999,22.02238001336183,38.20233703691992,0.04145753490980564,291.883394241333,126.27013754844666,575.722297668457,16265,1866,14399,14399,0,8,1965000.0
1965,1965999,22.02069472298458,38.20170842376476,0.04145626176417616,292.00865387916565,126.3337390422821,576.085823059082,16268,1866,14402,14402,0,8,1966000.0
1966,1966999,22.017880616540765,38.196129853979734,0.04145402688059552,292.2045772075653,126.39787292480469,576.3743476867676,16283,1868,14415,14415,0,8,1967000.0
1967,1967999,22.01587258711363,38.19161468147681,0.04145681176036664,292.36498951911926,126.46161794662476,576.781307220459,16294,1869,14425,14425,0,8,1968000.0
1968,1968999,22.014304181234092,38.193846139353354,0.04144792305743761,292.4880714416504,126.52561044692993,577.3778266906738,16303,1869,14434,14434,0,8,1969000.0
1969,1969999,22.013556117982507,38.20118506260666,0.041456792370240914,292.6967771053314,126.59184432029724,577.6354789733887,16312,1871,14441,14441,0,8,1970000.0
1970,1970999,22.01286428031783,38.20253040297188,0.041496438994137574,292.85452580451965,126.65688633918762,577.8625869750977,16323,1872,14451,14451,0,8,1971000.0
1971,1971999,22.013961299807637,38.20850585062685,0.041487680665724946,293.0149681568146,126.72181487083435,578.1570205688477,16326,1873,14453,14453,0,8,1972000.0
1972,1972999,22.015107393720157,38.214877389731285,0.04146768067473172,293.1467957496643,126.7859525680542,578.4296569824219,16327,1873,14454,14454,0,8,1973000.0
1973,1973999,22.019089122129074,38.231310467254914,0.04143440999927028,293.26729011535645,126.85006141662598,578.648078918457,16327,1873,14454,14454,0,8,1974000.0
1974,1974999,22.02261209457654,38.244789326024026,0.04142765542806903,293.39434576034546,126.91413307189941,578.8194808959961,16327,1873,14454,14454,0,8,1975000.0
1975,1975999,22.025798383592956,38.25650875645803,0.04143026661284632,293.55380630493164,126.97873401641846,578.9837532043457,16332,1874,14458,14458,0,8,1976000.0
1976,1976999,22.028782337842262,38.26685406206153,0.04139425308128475,293.76281690597534,127.04307508468628,579.0698051452637,16338,1876,14462,14462,0,8,1977000.0
1977,1977999,22.032596647235977,38.27929490705429,0.04137079478143768,293.980916261673,127.10720539093018,579.1752395629883,16373,1878,14495,14495,0,8,1978000.0
1978,1978999,22.036751988459912,38.292131320678735,0.04134618726842376,294.1269414424896,127.1711733341217,579.3754348754883,16373,1878,14495,14495,0,8,1979000.0
1979,1979999,22.040563918523805,38.30826795355223,0.041339242128601184,294.2932550907135,127.23579025268555,579.4910621643066,16387,1879,14508,14508,0,8,1980000.0
1980,1980999,22.043861812846778,38.316832830107636,0.04131368675283642,294.4304475784302,127.30009508132935,579.699592590332,16388,1879,14509,14509,0,8,1981000.0
1981,1981999,22.046632694876063,38.3217652321747,0.0413175810404145,294.592910528183,127.36381673812866,579.8424758911133,16390,1880,14510,14510,0,8,1982000.0
1982,1982999,22.051352855251327,38.331836086012636,0.041321015064708644,294.7543978691101,127.42779588699341,580.0407562255859,16404,1881,14523,14523,0,8,1983000.0
1983,1983999,22.05515496753939,38.34046416388957,0.041342061253972884,294.8879327774048,127.49291849136353,580.2221870422363,16404,1881,14523,14523,0,8,1984000.0
1984,1984999,22.05933392880799,38.34906735990696,0.041311014875210605,295.01492619514465,127.55724334716797,580.4245376586914,16405,1881,14524,14524,0,8,1985000.0
1985,1985999,22.064258410849334,38.360456036476386,0.041318772167526885,295.1418442726135,127.62135124206543,580.6388931274414,16406,1881,14525,14525,0,8,1986000.0
1986,1986999,22.068454704003994,38.3653041092289,0.04132035125702371,295.2643201351166,127.68527817726135,580.900089263916,16407,1881,14526,14526,0,8,1987000.0
1987,1987999,22.07016377409729,38.36521242491754,0.041328457190640044,295.4278862476349,127.74938607215881,581.1558113098145,16410,1882,14528,14528,0,8,1988000.0
1988,1988999,22.067689496148887,38.36361060680261,0.041299965382561976,295.63065481185913,127.81529688835144,581.7654685974121,16467,1884,14583,14583,0,8,1989000.0
1989,1989999,22.0650984149608,38.35895955425369,0.04129680275815251,295.78535413742065,127.87962794303894,582.0684432983398,16473,1885,14588,14588,0,8,1990000.0
1990,1990999,22.06425129958511,38.358732763839356,0.041296729034286606,295.9428286552429,127.94424414634705,582.2110443115234,16477,1886,14591,14591,0,8,1991000.0
1991,1991999,22.06276306502262,38.355337550726375,0.041281410225390114,296.06839871406555,128.0102298259735,582.4910011291504,16477,1886,14591,14591,0,8,1992000.0
1992,1992999,22.063343246876595,38.3562072289246,0.041250832867831044,296.1964282989502,128.07533502578735,582.7283172607422,16477,1886,14591,14591,0,8,1993000.0
1993,1993999,22.06409464615651,38.35711449566321,0.04123252583901882,296.3562660217285,128.1397488117218,582.8731880187988,16481,1887,14594,14594,0,8,1994000.0
1994,1994999,22.065850802909694,38.359787842161566,0.04121831797881215,296.5116391181946,128.2039954662323,583.0537147521973,16489,1888,14601,14601,0,8,1995000.0
1995,1995999,22.067938329577053,38.36227327314476,0.041213005054242635,296.6353244781494,128.26802706718445,583.245964050293,16490,1888,14602,14602,0,8,1996000.0
1996,1996999,22.071839471009707,38.36928065139556,0.041199777833725526,296.83810019493103,128.33304738998413,583.3585052490234,16499,1890,14609,14609,0,8,1997000.0
1997,1997999,22.075126385029414,38.37555167276475,0.041185155374124816,297.01982831954956,128.39784359931946,583.4742736816406,16502,1891,14611,14611,0,8,1998000.0
1998,1998999,22.079674696246137,38.385567047794396,0.041225505868252466,297.1913688182831,128.4626362323761,583.6681327819824,16534,1892,14642,14642,0,8,1999000.0
1999,1999999,22.0845479197359,38.39515559052002,0.04123516280209849,297.34715723991394,128.5265016555786,583.7494812011719,16538,1893,14645,14645,0,8,2000000.0
2000,2000999,22.090936277435397,38.40787599326612,0.04126265060968026,297.4842298030853,128.59074568748474,583.9959602355957,16538,1893,14645,14645,0,8,2001000.0
2001,2001999,22.09740025116682,38.420047578590264,0.04130700334936599,297.6460208892822,128.6548192501068,584.1552429199219,16540,1894,14646,14646,0,8,2002000.0
2002,2002999,22.103272455016175,38.4297110446869,0.04134544525033401,297.77449345588684,128.7188537120819,584.3614196777344,16540,1894,14646,14646,0,8,2003000.0
2003,2003999,22.109750590994487,38.44645092412025,0.04138013640530136,297.9018259048462,128.78257536888123,584.4784812927246,16540,1894,14646,14646,0,8,2004000.0
2004,2004999,22.11581817222437,38.45446441319078,0.041417052046005876,298.0633041858673,128.84679675102234,584.5809936523438,16545,1895,14650,14650,0,8,2005000.0
2005,2005999,22.122258384258256,38.46424738291366,0.04146377505082399,298.19315242767334,128.91174578666687,584.7499084472656,16546,1895,14651,14651,0,8,2006000.0
2006,2006999,22.129711097601326,38.475527410944274,0.0415625822059722,298.3195912837982,128.97536826133728,584.8958320617676,16547,1895,14652,14652,0,8,2007000.0
2007,2007999,22.134323130330042,38.48086714713785,0.04160751584035782,298.45111441612244,129.03928089141846,585.0382041931152,16547,1895,14652,14652,0,8,2008000.0
2008,2008999,22.135019962434956,38.48409406884998,0.04157478543978421,298.57965993881226,129.10339760780334,585.768627166748,16559,1895,14664,14664,0,8,2009000.0
2009,2009999,22.131649329372053,38.481962210462896,0.04157216635852379,298.69732213020325,129.16720366477966,586.1254997253418,16562,1895,14667,14667,0,8,2010000.0
2010,2010999,22.128360416749913,38.47669910033299,0.04158864194622447,298.81538558006287,129.23096370697021,586.3275718688965,16562,1895,14667,14667,0,8,2011000.0
2011,2011999,22.125874650927738,38.47250590534819,0.04157471130990964,298.9433732032776,129.29502511024475,586.6350708007812,16562,1895,14667,14667,0,8,2012000.0
2012,2012999,22.12323775835398,38.479570323268234,0.04153888257135485,299.1576101779938,129.3595485687256,586.724292755127,16567,1897,14670,14670,0,8,2013000.0
2013,2013999,22.120047942605822,38.47312043404563,0.041536032393813205,299.3150706291199,129.42429780960083,586.9305191040039,16570,1898,14672,14672,0,8,2014000.0
2014,2014999,22.117312097401932,38.46793494498182,0.04153493282748599,299.4352226257324,129.4891803264618,587.1486587524414,16570,1898,14672,14672,0,8,2015000.0
2015,2015999,22.114739949413423,38.462653493071464,0.041531344607383724,299.5674264431,129.55372714996338,587.339916229248,16570,1898,14672,14672,0,8,2016000.0
2016,2016999,22.112042461758843,38.457262976946744,0.041529418418620234,299.76598381996155,129.61777138710022,587.4572601318359,16602,1900,14702,14702,0,8,2017000.0
2017,2017999,22.11041469494461,38.45555663283824,0.041523422451768544,299.9376447200775,129.68197917938232,587.5925483703613,16604,1901,14703,14703,0,8,2018000.0
2018,2018999,22.10904407838411,38.45218292807406,0.04150874989830067,300.11328506469727,129.75181818008423,587.6651878356934,16607,1902,14705,14705,0,8,2019000.0
2019,2019999,22.108374185773034,38.44993571460559,0.04150887347482579,300.2446880340576,129.8159317970276,587.8867797851562,16607,1902,14705,14705,0,8,2020000.0
2020,2020999,22.108249356018984,38.44754012762781,0.041524135771423554,300.3695824146271,129.88021111488342,588.092399597168,16608,1902,14706,14706,0,8,2021000.0
2021,2021999,22.108691909633038,38.44732804016245,0.04155727945229515,300.6771819591522,129.94520664215088,587.9681358337402,16620,1907,14713,14713,0,8,2022000.0
2022,2022999,22.11012377215604,38.44874121553448,0.04157063241066283,300.8803791999817,130.00993275642395,588.0770111083984,16627,1909,14718,14718,0,8,2023000.0
2023,2023999,22.1132261000418,38.45461820840539,0.041665603279258945,301.16979718208313,130.07536005973816,588.1625518798828,16644,1913,14731,14731,0,8,2024000.0
2024,2024999,22.118604534623792,38.46672483281407,0.04177786741852085,301.4010558128357,130.1399974822998,588.3013763427734,16659,1916,14743,14743,0,8,2025000.0
2025,2025999,22.12525336505076,38.47833690784554,0.041898467045015764,301.5629708766937,130.20491075515747,588.4740180969238,16663,1917,14746,14746,0,8,2026000.0
2026,2026999,22.131282232293884,38.49222437245573,0.041928299547320025,301.7013945579529,130.27022790908813,588.6877632141113,16665,1917,14748,14748,0,8,2027000.0
2027,2027999,22.134856351965173,38.49677205252851,0.041990195384431495,301.829345703125,130.33418321609497,588.8731155395508,16666,1917,14749,14749,0,8,2028000.0
2028,2028999,22.135778967778997,38.496976971006774,0.04203643873328122,301.99035477638245,130.39848709106445,589.0814437866211,16669,1918,14751,14751,0,8,2029000.0
2029,2029999,22.13557603489867,38.50055463041536,0.041805503067631644,302.1591007709503,130.46303153038025,589.7982711791992,16689,1919,14770,14770,0,8,2030000.0
2030,2030999,22.134309835851166,38.4980508865234,0.04175557609514968,302.2853524684906,130.5277705192566,590.1468048095703,16690,1919,14771,14771,0,8,2031000.0
2031,2031999,22.13239774080636,38.49460206971688,0.04172507877788234,302.4553623199463,130.5922749042511,590.3814353942871,16693,1920,14773,14773,0,8,2032000.0
2032,2032999,22.13187295559088,38.49555662624396,0.04169757101562521,302.61404252052307,130.65663981437683,590.4760818481445,16697,1921,14776,14776,0,8,2033000.0
2033,2033999,22.130252168088788,38.49157541813103,0.04165896368338329,302.8425843715668,130.72095680236816,590.5962600708008,16734,1924,14810,14810,0,8,2034000.0
2034,2034999,22.12919612838627,38.48776854578995,0.04162711460156421,302.9613881111145,130.78504395484924,590.8226776123047,16734,1924,14810,14810,0,8,2035000.0
2035,2035999,22.12881160504329,38.48480422792345,0.041589537038198565,303.16686272621155,130.85016083717346,590.963249206543,16739,1926,14813,14813,0,8,2036000.0
2036,2036999,22.128045016468445,38.48551700253823,0.041555156991644915,303.37392258644104,130.91484212875366,591.0669898986816,16744,1928,14816,14816,0,8,2037000.0
2037,2037999,22.12766861335019,38.484077879595795,0.04149820148743322,303.6550476551056,130.98012161254883,591.096435546875,16756,1932,14824,14824,0,8,2038000.0
2038,2038999,22.127805719493107,38.48676581735455,0.04145484689109469,303.8344671726227,131.04616856575012,591.2729721069336,16760,1933,14827,14827,0,8,2039000.0
2039,2039999,22.128303084640596,38.48968650060281,0.0414016269657248,303.97099566459656,131.1102545261383,591.426887512207,16760,1933,14827,14827,0,8,2040000.0
2040,2040999,22.127254687915173,38.485295776238026,0.0413588763524666,304.1842749118805,131.17502450942993,591.7056465148926,16779,1935,14844,14844,0,8,2041000.0
2041,2041999,22.12698048057054,38.48213217335481,0.04133450819172202,304.3863925933838,131.23947191238403,591.8512840270996,16785,1937,14848,14848,0,8,2042000.0
2042,2042999,22.12714333715624,38.47915731344849,0.04130292683328152,304.54861092567444,131.30392837524414,592.0538749694824,16787,1938,14849,14849,0,8,2043000.0
2043,2043999,22.12792070109819,38.47969048961725,0.04124774960287936,304.6729073524475,131.36753964424133,592.2445945739746,16788,1938,14850,14850,0,8,2044000.0
2044,2044999,22.128286744157705,38.47985481445022,0.04120233756994551,304.8321440219879,131.43226981163025,592.3740997314453,16792,1939,14853,14853,0,8,2045000.0
2045,2045999,22.127929590377153,38.475798781070914,0.0411705869324176,304.95961022377014,131.49714756011963,592.5826225280762,16792,1939,14853,14853,0,8,2046000.0
2046,2046999,22.126452142893633,38.47058932675528,0.041152420471364026,305.13073348999023,131.56113815307617,592.8092384338379,16807,1940,14867,14867,0,8,2047000.0
2047,2047999,22.125626626413464,38.46649066352438,0.04107253319973725,305.2941253185272,131.6290328502655,593.443302154541,16823,1941,14882,14882,0,8,2048000.0
2048,2048999,22.126032595168176,38.46760789632261,0.04098135092164701,305.4598078727722,131.6935954093933,593.7179756164551,16839,1942,14897,14897,0,8,2049000.0
2049,2049999,22.126056164723213,38.46479805920493,0.04092573928866561,305.5837082862854,131.759135723114,594.0044441223145,16839,1942,14897,14897,0,8,2050000.0
2050,2050999,22.126269095782536,38.46324451648039,0.04085147404753353,305.71375942230225,131.82309246063232,594.2397422790527,16839,1942,14897,14897,0,8,2051000.0
2051,2051999,22.12601868206652,38.45996467925654,0.04080201364454894,305.9124460220337,131.8875653743744,594.3232345581055,16856,1944,14912,14912,0,8,2052000.0
2052,2052999,22.126307883768515,38.461251283885645,0.04073406450110617,306.04261302948,131.95137667655945,594.5218620300293,16856,1944,14912,14912,0,8,2053000.0
2053,2053999,22.128035685456403,38.46459966817312,0.04070295636864374,306.1701364517212,132.01625657081604,594.7120742797852,16857,1944,14913,14913,0,8,2054000.0
2054,2054999,22.129342959966955,38.46743425470877,0.04070375595957232,306.3867485523224,132.0862693786621,594.7582702636719,16867,1946,14921,14921,0,8,2055000.0
2055,2055999,22.13099142919686,38.46780614559204,0.04068429561941178,306.7055175304413,132.15092396736145,594.7099609375,16895,1951,14944,14944,0,8,2056000.0
2056,2056999,22.13405019808049,38.474147825457806,0.04070765879092719,306.87275195121765,132.21589279174805,594.994701385498,16900,1952,14948,14948,0,8,2057000.0
2057,2057999,22.13672221359036,38.48240838581067,0.04072175660248756,307.08122539520264,132.28256821632385,595.0706100463867,16905,1954,14951,14951,0,8,2058000.0
2058,2058999,22.140824256234122,38.489459502417425,0.04083902506656101,307.23544001579285,132.34690499305725,595.2818794250488,16909,1955,14954,14954,0,8,2059000.0
2059,2059999,22.14524876857121,38.49976280027364,0.040958198719854066,307.3623197078705,132.41110062599182,595.4869117736816,16909,1955,14954,14954,0,8,2060000.0
2060,2060999,22.14926303855124,38.50558805954744,0.041081475939862666,307.52588152885437,132.4751374721527,595.6365699768066,16913,1956,14957,14957,0,8,2061000.0
2061,2061999,22.152630177207286,38.50838017521017,0.04115271897289041,307.7557029724121,132.5403027534485,595.6261444091797,16923,1959,14964,14964,0,8,2062000.0
2062,2062999,22.15843164610819,38.51785808034982,0.04126993581944449,307.9168462753296,132.60479879379272,595.7571792602539,16926,1960,14966,14966,0,8,2063000.0
2063,2063999,22.163037320801184,38.52938381614601,0.04142633375135385,308.08131766319275,132.66880345344543,595.9436874389648,16929,1961,14968,14968,0,8,2064000.0
2064,2064999,22.167959371549724,38.53712541745778,0.04149614500821719,308.20694851875305,132.7328758239746,596.2258758544922,16931,1961,14970,14970,0,8,2065000.0
2065,2065999,22.170752355781328,38.54394734847647,0.04142415686264933,308.3375825881958,132.79666233062744,596.5258712768555,16931,1961,14970,14970,0,8,2066000.0
2066,2066999,22.172058809466836,38.55431567477183,0.041333395827186314,308.540314912796,132.86316442489624,596.9144897460938,16941,1963,14978,14978,0,8,2067000.0
2067,2067999,22.171586414650946,38.55331480567493,0.04132526539612036,308.7008535861969,132.92725920677185,597.1630897521973,16947,1964,14983,14983,0,8,2068000.0
2068,2068999,22.171444599939253,38.55091264873065,0.041316736820644406,308.9460668563843,132.99178647994995,597.1279907226562,16956,1967,14989,14989,0,8,2069000.0
2069,2069999,22.171532269236515,38.55028108735019,0.041308335572382116,309.1117572784424,133.05600905418396,597.3620529174805,16958,1968,14990,14990,0,8,2070000.0
2070,2070999,22.17236852167989,38.55419474300377,0.041293322359068685,309.23456931114197,133.12075090408325,597.5577163696289,16958,1968,14990,14990,0,8,2071000.0
2071,2071999,22.172714564886704,38.55271591685578,0.041315098641949044,309.40266251564026,133.18568181991577,597.7141876220703,16964,1969,14995,14995,0,8,2072000.0
2072,2072999,22.173486921501457,38.55185800673369,0.04132184300353592,309.5260934829712,133.25050258636475,597.9288787841797,16964,1969,14995,14995,0,8,2073000.0
2073,2073999,22.175131396837575,38.5523906858374,0.041387041580284945,309.665331363678,133.31466245651245,598.1436004638672,16964,1969,14995,14995,0,8,2074000.0
2074,2074999,22.176277708581512,38.55185893705027,0.0414213462408054,309.83130168914795,133.37863779067993,598.2078018188477,16968,1970,14998,14998,0,8,2075000.0
2075,2075999,22.17884651343724,38.55560482995126,0.04148772644866716,310.0009412765503,133.44265484809875,598.2609786987305,16970,1971,14999,14999,0,8,2076000.0
2076,2076999,22.182451884783298,38.562563508170534,0.041534351913625756,310.16860127449036,133.50707364082336,598.4393348693848,16975,1972,15003,15003,0,8,2077000.0
2077,2077999,22.184888549509008,38.56500129822611,0.04161555291960295,310.2977228164673,133.57113575935364,598.5774154663086,16975,1972,15003,15003,0,8,2078000.0
2078,2078999,22.18754767437692,38.56766367886873,0.041696078437636896,310.4164788722992,133.6354398727417,598.7030334472656,16975,1972,15003,15003,0,8,2079000.0
2079,2079999,22.19080894360469,38.574618710978946,0.041744648049586885,310.5789906978607,133.69930124282837,598.7275543212891,16977,1973,15004,15004,0,8,2080000.0
2080,2080999,22.192966417138937,38.57557709535242,0.04179389933382871,310.745578289032,133.76532340049744,598.8873062133789,16980,1974,15006,15006,0,8,2081000.0
2081,2081999,22.19595383681041,38.57769918002548,0.04184610780208009,310.90472173690796,133.82977056503296,598.923152923584,16984,1975,15009,15009,0,8,2082000.0
2082,2082999,22.198971050611394,38.58480444113325,0.04185395562868732,311.025817155838,133.89395952224731,599.1025009155273,16985,1975,15010,15010,0,8,2083000.0
2083,2083999,22.201328294715807,38.58589483491462,0.04189097985674739,311.1885976791382,133.95813298225403,599.2984008789062,17001,1976,15025,15025,0,8,2084000.0
2084,2084999,22.203695917715418,38.586294196336375,0.041924402741250644,311.31041049957275,134.02237510681152,599.502685546875,17001,1976,15025,15025,0,8,2085000.0
2085,2085999,22.205397494760984,38.590299965908976,0.041951425475898474,311.4471986293793,134.08750581741333,599.6928024291992,17001,1976,15025,15025,0,8,2086000.0
2086,2086999,22.204492156114803,38.58769509251315,0.04191907551979579,311.65904545783997,134.15178751945496,600.1678161621094,17032,1978,15054,15054,0,8,2087000.0
2087,2087999,22.202170482639463,38.58335846639612,0.04187752125211641,311.8232967853546,134.21615505218506,600.3739318847656,17036,1979,15057,15057,0,8,2088000.0
2088,2088999,22.20008015533782,38.577583052767835,0.04185075520669512,311.98971009254456,134.28019642829895,600.4710502624512,17041,1980,15061,15061,0,8,2089000.0
2089,2089999,22.198799239255973,38.574567419202715,0.04179819684084174,312.3014426231384,134.34524655342102,600.5065498352051,17084,1985,15099,15099,0,8,2090000.0
2090,2090999,22.19664562028534,38.56920949131811,0.04179493688267244,312.42505621910095,134.40944480895996,600.6571388244629,17084,1985,15099,15099,0,8,2091000.0
2091,2091999,22.194100259050412,38.56337866338695,0.0417680856630922,312.5819239616394,134.47347450256348,600.7822532653809,17090,1986,15104,15104,0,8,2092000.0
2092,2092999,22.19211505962397,38.558181323087226,0.04175011826743602,312.7460551261902,134.53948497772217,600.9070816040039,17094,1987,15107,15107,0,8,2093000.0
2093,2093999,22.189907755407635,38.552808726351,0.04173286602191795,312.9288156032562,134.60457968711853,601.1753311157227,17096,1988,15108,15108,0,8,2094000.0
2094,2094999,22.188110624860734,38.54795602339788,0.04172946990104065,313.1386845111847,134.66909980773926,601.3675537109375,17117,1990,15127,15127,0,8,2095000.0
2095,2095999,22.18662755652789,38.54314473852522,0.041719717528516775,313.3446078300476,134.734313249588,601.4796676635742,17124,1992,15132,15132,0,8,2096000.0
2096,2096999,22.186077836616736,38.54021924286723,0.04171867217419478,313.4637701511383,134.7983558177948,601.6582450866699,17124,1992,15132,15132,0,8,2097000.0
2097,2097999,22.18567739362065,38.53739684278748,0.04172248736168538,313.58799982070923,134.86256575584412,601.8196868896484,17124,1992,15132,15132,0,8,2098000.0
2098,2098999,22.185745734465115,38.535820763442295,0.04173360900983658,313.79935479164124,134.92737412452698,601.8495292663574,17129,1994,15135,15135,0,8,2099000.0
2099,2099999,22.186199366375494,38.53469261411303,0.041747506413559954,313.9267010688782,134.99231958389282,602.0406951904297,17129,1994,15135,15135,0,8,2100000.0
2100,2100999,22.18641371964372,38.53314428781377,0.04178790910355368,314.1990895271301,135.05679559707642,602.0487403869629,17142,1998,15144,15144,0,8,2101000.0
2101,2101999,22.188237655559846,38.5342983285544,0.04182920921068689,314.41709780693054,135.1213903427124,602.1802368164062,17148,2000,15148,15148,0,8,2102000.0
2102,2102999,22.191307459710472,38.53725353196635,0.04189943690646769,314.53972721099854,135.18517661094666,602.3995513916016,17150,2000,15150,15150,0,8,2103000.0
2103,2103999,22.194556035685828,38.54066352950395,0.04196677539225968,314.7420630455017,135.25082802772522,602.5669136047363,17187,2002,15185,15185,0,8,2104000.0
2104,2104999,22.19699633601328,38.5428216543035,0.04203397058760927,314.9782061576843,135.31537199020386,602.5957145690918,17195,2005,15190,15190,0,9,2105000.0
2105,2105999,22.198124865295384,38.54250344851871,0.042097547503902266,315.1054165363312,135.37971186637878,602.861701965332,17196,2005,15191,15191,0,9,2106000.0
2106,2106999,22.197065914698953,38.53839855138282,0.04208958282149855,315.31225514411926,135.44410300254822,603.2785186767578,17224,2007,15217,15217,0,9,2107000.0
2107,2107999,22.19432461044447,38.5337727083161,0.04208661503052691,315.47570395469666,135.5087730884552,603.6613960266113,17231,2008,15223,15223,0,9,2108000.0
2108,2108999,22.19239385371102,38.52981736934396,0.04205920489886339,315.6502630710602,135.57348203659058,603.9428977966309,17239,2009,15230,15230,0,9,2109000.0
2109,2109999,22.191146366218934,38.53087488555877,0.04204173331818717,315.7892277240753,135.63822484016418,604.2237319946289,17239,2009,15230,15230,0,9,2110000.0
2110,2110999,22.18815279615936,38.52494333589437,0.04203316915668165,315.91792821884155,135.70255613327026,604.4246788024902,17240,2009,15231,15231,0,9,2111000.0
2111,2111999,22.186441454548355,38.522338310364084,0.04203140334944899,316.09267568588257,135.768381357193,604.5697784423828,17242,2010,15232,15232,0,9,2112000.0
2112,2112999,22.183335758099332,38.51639568198508,0.0420278763694335,316.2666356563568,135.8332211971283,604.7411994934082,17244,2011,15233,15233,0,9,2113000.0
2113,2113999,22.181174708323564,38.511322274347755,0.04202308816128808,316.40135312080383,135.89765119552612,604.9930877685547,17245,2011,15234,15234,0,9,2114000.0
2114,2114999,22.178836981478963,38.50620856342495,0.042009880142514056,316.5684823989868,135.96329164505005,605.1309509277344,17247,2012,15235,15235,0,9,2115000.0
2115,2115999,22.17710305210095,38.50164720802937,0.04200370214102933,316.7434821128845,136.0284218788147,605.2886085510254,17249,2013,15236,15236,0,9,2116000.0
2116,2116999,22.175393307967905,38.49677482951977,0.04199539621185311,316.86136174201965,136.09231686592102,605.4937629699707,17249,2013,15236,15236,0,9,2117000.0
2117,2117999,22.173908117359208,38.49285372717238,0.0419834263478327,317.02274560928345,136.15662550926208,605.6233024597168,17280,2014,15266,15266,0,9,2118000.0
2118,2118999,22.173205671258852,38.49053266391208,0.04198634933779244,317.16111612319946,136.22073650360107,605.8058738708496,17281,2014,15267,15267,0,9,2119000.0
2119,2119999,22.17262972171586,38.487402998581814,0.04197112576968054,317.4127552509308,136.2853400707245,605.6734962463379,17289,2017,15272,15272,0,9,2120000.0
2120,2120999,22.17210456512904,38.48408581309034,0.0419665902712798,317.5447142124176,136.3502676486969,605.8808479309082,17289,2017,15272,15272,0,9,2121000.0
2121,2121999,22.17207436822183,38.48242654608334,0.04196188293079728,317.6631283760071,136.4136483669281,606.0341148376465,17289,2017,15272,15272,0,9,2122000.0
2122,2122999,22.172275275008687,38.47964920554755,0.04196257918026114,317.8340151309967,136.47753429412842,606.1572074890137,17291,2018,15273,15273,0,9,2123000.0
2123,2123999,22.172621148841685,38.4778062814705,0.041962404950951715,318.00388979911804,136.5420536994934,606.2946128845215,17306,2019,15287,15287,0,9,2124000.0
2124,2124999,22.173164120177415,38.476235692087194,0.042008981148668356,318.12895226478577,136.6070966720581,606.5694313049316,17308,2019,15289,15289,0,9,2125000.0
2125,2125999,22.173453214388104,38.47424448885009,0.04202999080192038,318.2528781890869,136.6708025932312,606.8056564331055,17309,2019,15290,15290,0,9,2126000.0
2126,2126999,22.172286243787326,38.47041111505717,0.04203421051280176,318.4218475818634,136.73471474647522,606.9059371948242,17313,2020,15293,15293,0,9,2127000.0
2127,2127999,22.169456582929396,38.46410722050149,0.042033679816194214,318.59114170074463,136.80056238174438,607.4954948425293,17323,2021,15302,15302,0,9,2128000.0
2128,2128999,22.16584637634846,38.45763485512203,0.04204102230134332,318.7607035636902,136.86555647850037,607.8781814575195,17330,2022,15308,15308,0,9,2129000.0
2129,2129999,22.1627214584699,38.452261499541464,0.042046783201194704,318.8888931274414,136.93025422096252,608.0583648681641,17330,2022,15308,15308,0,9,2130000.0
2130,2130999,22.160085962276078,38.4481912414894,0.042049555105133085,319.0131776332855,136.9943380355835,608.3165588378906,17330,2022,15308,15308,0,9,2131000.0
2131,2131999,22.157679880253358,38.44328781225779,0.04204066852526789,319.18382573127747,137.059020280838,608.5216636657715,17333,2023,15310,15310,0,9,2132000.0
2132,2132999,22.155064852488064,38.437501272817244,0.042038593516860345,319.3209466934204,137.12484741210938,608.7054176330566,17333,2023,15310,15310,0,9,2133000.0
2133,2133999,22.152435130581758,38.43252288294256,0.04203094329433221,319.5364902019501,137.19048070907593,608.8731651306152,17338,2025,15313,15313,0,9,2134000.0
2134,2134999,22.149304661154247,38.4263121161721,0.042027319877649294,319.69937348365784,137.25432181358337,609.1115913391113,17344,2026,15318,15318,0,9,2135000.0
2135,2135999,22.146604803080503,38.42076283922963,0.04202317351120677,319.8349759578705,137.32829999923706,609.3347206115723,17344,2026,15318,15318,0,9,2136000.0
2136,2136999,22.14403644582092,38.41481624133023,0.04202060322163448,319.9648494720459,137.3939549922943,609.5809211730957,17344,2026,15318,15318,0,9,2137000.0
2137,2137999,22.14132486380134,38.4086620937541,0.042016539039561374,320.08400678634644,137.45756006240845,609.7680206298828,17345,2026,15319,15319,0,9,2138000.0
2138,2138999,22.13848821759316,38.402762599078585,0.042011878786619716,320.20593881607056,137.52160048484802,609.920051574707,17345,2026,15319,15319,0,9,2139000.0
2139,2139999,22.136758744055133,38.39826447928233,0.042002415684221805,320.32182931900024,137.58536982536316,610.1090393066406,17346,2026,15320,15320,0,9,2140000.0
2140,2140999,22.134647904441724,38.39299088034611,0.04198685076693187,320.4996249675751,137.64950561523438,610.1915435791016,17348,2027,15321,15321,0,9,2141000.0
2141,2141999,22.133273759030725,38.38854381079636,0.04198046972274594,320.6585280895233,137.7134566307068,610.311580657959,17350,2028,15322,15322,0,9,2142000.0
2142,2142999,22.131774439376233,38.383835291284484,0.04197301132456799,320.82149028778076,137.77746319770813,610.4782829284668,17355,2029,15326,15326,0,9,2143000.0
2143,2143999,22.131113119502576,38.38016183549758,0.041953770200432894,320.9944257736206,137.8416965007782,610.5805282592773,17358,2030,15328,15328,0,9,2144000.0
2144,2144999,22.130095797141763,38.37561438211005,0.041932853279209925,321.11554741859436,137.90562534332275,610.7385482788086,17358,2030,15328,15328,0,9,2145000.0
2145,2145999,22.129490113926497,38.37222617062961,0.04192413380548732,321.2477433681488,137.97035551071167,610.9225578308105,17360,2030,15330,15330,0,9,2146000.0
2146,2146999,22.12827651028097,38.36805195520561,0.04191296775464992,321.4145863056183,138.0345048904419,611.0270919799805,17376,2031,15345,15345,0,9,2147000.0
2147,2147999,22.12609925457214,38.362784196444025,0.041896417576741674,321.5711462497711,138.0980818271637,611.1515121459961,17379,2032,15347,15347,0,9,2148000.0
2148,2148999,22.12163940225507,38.35587076335174,0.04193175677570715,321.8015487194061,138.16243362426758,611.4656295776367,17390,2035,15355,15355,0,9,2149000.0
2149,2149999,22.117050424765413,38.3490420541793,0.041964854376261296,321.9591176509857,138.2266824245453,611.6707077026367,17393,2036,15357,15357,0,9,2150000.0
2150,2150999,22.112949522175697,38.3430534842777,0.04199429508492758,322.15421986579895,138.29127049446106,611.7863235473633,17426,2038,15388,15388,0,9,2151000.0
2151,2151999,22.10920971265878,38.33862100953191,0.04201637027255578,322.2769968509674,138.35513496398926,611.9917449951172,17426,2038,15388,15388,0,9,2152000.0
2152,2152999,22.105464346298145,38.33565064732339,0.04202994268819249,322.40873289108276,138.41957831382751,612.1778755187988,17427,2038,15389,15389,0,9,2153000.0
2153,2153999,22.102016739723656,38.33087314811977,0.042046182171127766,322.62319564819336,138.48525953292847,612.2182083129883,17433,2040,15393,15393,0,9,2154000.0
2154,2154999,22.09824668568692,38.32515115863311,0.04205830058345428,322.79067373275757,138.54987692832947,612.3841400146484,17435,2041,15394,15394,0,9,2155000.0
2155,2155999,22.094872130902324,38.32089410244367,0.04206918231970769,323.0178747177124,138.62236666679382,612.5140419006348,17442,2043,15399,15399,0,9,2156000.0
2156,2156999,22.091326419011622,38.31528164880744,0.042083925339061135,323.1875560283661,138.6865029335022,612.6444892883301,17444,2044,15400,15400,0,9,2157000.0
2157,2157999,22.087932849280033,38.309265479653156,0.042093842192037934,323.3578119277954,138.75083565711975,612.8407821655273,17446,2045,15401,15401,0,9,2158000.0
2158,2158999,22.08430269380443,38.30298425191844,0.04210364546814516,323.4857919216156,138.81478238105774,613.032829284668,17446,2045,15401,15401,0,9,2159000.0
2159,2159999,22.081319823714814,38.298067800310726,0.042114786793152614,323.61093497276306,138.87850713729858,613.1375350952148,17446,2045,15401,15401,0,9,2160000.0
2160,2160999,22.078418972329295,38.293306998436826,0.042123606945623004,323.77428698539734,138.9428117275238,613.1689949035645,17448,2046,15402,15402,0,9,2161000.0
2161,2161999,22.07581060910503,38.289146170548484,0.04213098750729172,323.9167103767395,139.01299262046814,613.2744674682617,17448,2046,15402,15402,0,9,2162000.0
2162,2162999,22.074240412621755,38.2956832213777,0.04210996424705116,324.0531167984009,139.07645273208618,613.3699836730957,17448,2046,15402,15402,0,9,2163000.0
2163,2163999,22.072280014101647,38.29209967703913,0.04212300190896123,324.1814053058624,139.1407768726349,613.5261535644531,17449,2046,15403,15403,0,9,2164000.0
2164,2164999,22.070144920794288,38.287441751253105,0.042124598268414304,324.3872525691986,139.20506715774536,613.5335693359375,17462,2048,15414,15414,0,9,2165000.0
2165,2165999,22.068508637787726,38.28389260747162,0.04211222365431544,324.5806243419647,139.26915645599365,613.5789489746094,17466,2050,15416,15416,0,9,2166000.0
2166,2166999,22.066688849654675,38.279511772268066,0.04211451738926986,324.7036316394806,139.33309507369995,613.7846374511719,17467,2050,15417,15417,0,9,2167000.0
2167,2167999,22.06482964509277,38.27505366073116,0.04210333348113582,324.86354422569275,139.39694166183472,613.8487701416016,17469,2051,15418,15418,0,9,2168000.0
2168,2168999,22.06186586778445,38.26943259318169,0.04210723196224064,325.0312330722809,139.46089148521423,613.9568023681641,17481,2052,15429,15429,0,9,2169000.0
2169,2169999,22.060519034758507,38.26590156805588,0.0420664624806627,325.1932547092438,139.5253221988678,614.5124359130859,17505,2053,15452,15452,0,9,2170000.0
2170,2170999,22.058630045057377,38.26119826235613,0.04204852403329673,325.3202874660492,139.5892210006714,614.7889251708984,17507,2053,15454,15454,0,9,2171000.0
2171,2171999,22.056535304203923,38.25605946522331,0.04205783844900424,325.552964925766,139.65385627746582,615.0012588500977,17520,2056,15464,15464,0,9,2172000.0
2172,2172999,22.055381308206442,38.253072861074266,0.042038640028930985,325.69448161125183,139.71829891204834,615.247802734375,17521,2056,15465,15465,0,9,2173000.0
2173,2173999,22.055354856465073,38.25060331357699,0.04198327692670978,325.8178822994232,139.78315997123718,615.476749420166,17522,2056,15466,15466,0,9,2174000.0
2174,2174999,22.055156248637545,38.24828386055122,0.041932627291626945,326.0708956718445,139.84854364395142,615.5907783508301,17532,2059,15473,15473,0,9,2175000.0
2175,2175999,22.05500113651956,38.24611279378908,0.0418684391735048,326.20070600509644,139.91279482841492,615.8478546142578,17533,2059,15474,15474,0,9,2176000.0
2176,2176999,22.053984680026268,38.242474102121825,0.04183629306085235,326.3687992095947,139.9772322177887,615.9697914123535,17535,2060,15475,15475,0,9,2177000.0
2177,2177999,22.053756947872994,38.23920372834933,0.04178544355980618,326.5452449321747,140.04490113258362,616.1162872314453,17539,2061,15478,15478,0,9,2178000.0
2178,2178999,22.054054847059778,38.236649617352015,0.04168644941333355,326.7980418205261,140.11093831062317,616.1831283569336,17553,2064,15489,15489,0,9,2179000.0
2179,2179999,22.05520393641007,38.234659384254066,0.041586548500204046,326.95394802093506,140.1757173538208,616.322624206543,17556,2065,15491,15491,0,9,2180000.0
2180,2180999,22.055588422899017,38.23158566661709,0.04150960431341899,327.0895125865936,140.24012351036072,616.5350570678711,17556,2065,15491,15491,0,9,2181000.0
2181,2181999,22.05596546169328,38.228243878801194,0.041450200205105925,327.2551772594452,140.30432081222534,616.6460113525391,17558,2066,15492,15492,0,9,2182000.0
2182,2182999,22.056646413539273,38.22506256060253,0.04136570971345599,327.38295555114746,140.36920285224915,616.886100769043,17559,2066,15493,15493,0,9,2183000.0
2183,2183999,22.05729629953008,38.22213403038516,0.04130603600319438,327.50679445266724,140.4332504272461,617.0997886657715,17560,2066,15494,15494,0,9,2184000.0
2184,2184999,22.056935986461877,38.218302595891345,0.04127536746930416,327.6711673736572,140.49724411964417,617.2435455322266,17565,2067,15498,15498,0,9,2185000.0
2185,2185999,22.05620110575232,38.21395689974783,0.041237932946146416,327.8369059562683,140.5614879131317,617.416130065918,17567,2068,15499,15499,0,9,2186000.0
2186,2186999,22.054517782597312,38.20923031023714,0.04121574854679999,328.0069971084595,140.62518692016602,617.5877265930176,17569,2069,15500,15500,0,9,2187000.0
2187,2187999,22.053880845008557,38.20746422957384,0.04118435806797771,328.1383407115936,140.68948817253113,618.0090713500977,17573,2069,15504,15504,0,9,2188000.0
2188,2188999,22.053067649938015,38.20640581600114,0.041145247639147176,328.31456899642944,140.7546031475067,618.1610832214355,17579,2070,15509,15509,0,9,2189000.0
2189,2189999,22.05206854735789,38.20333715612237,0.04111421331200227,328.45002913475037,140.81915187835693,618.4459991455078,17580,2070,15510,15510,0,9,2190000.0
2190,2190999,22.050914137480568,38.199007678023186,0.041079246272014425,328.5882980823517,140.88366031646729,618.6656913757324,17581,2070,15511,15511,0,9,2191000.0
2191,2191999,22.049559441363453,38.19408733169576,0.04104549934250079,328.7116537094116,140.94766569137573,618.8915061950684,17582,2070,15512,15512,0,9,2192000.0
2192,2192999,22.048676771610975,38.19244422383219,0.04099392013855818,328.9250819683075,141.01365494728088,618.980297088623,17590,2072,15518,15518,0,9,2193000.0
2193,2193999,22.0472532184082,38.18728778609829,0.04095134768851605,329.131982088089,141.07826328277588,619.1552314758301,17613,2074,15539,15539,0,9,2194000.0
2194,2194999,22.046186479005037,38.1831489922288,0.040909804278641215,329.31017208099365,141.14362287521362,619.4155120849609,17627,2075,15552,15552,0,9,2195000.0
2195,2195999,22.04508198658138,38.178477718549246,0.04086399001514707,329.42918491363525,141.2075972557068,619.6892776489258,17627,2075,15552,15552,0,9,2196000.0
2196,2196999,22.044592426904213,38.174571785436925,0.040813166752858954,329.5499074459076,141.2719075679779,619.9603157043457,17628,2075,15553,15553,0,9,2197000.0
2197,2197999,22.044857316047224,38.176808134669905,0.0407592745902835,329.71901202201843,141.33654117584229,620.0839195251465,17639,2076,15563,15563,0,9,2198000.0
2198,2198999,22.04463853427316,38.1733038573575,0.040717614740598096,329.85002183914185,141.40048670768738,620.317138671875,17640,2076,15564,15564,0,9,2199000.0
2199,2199999,22.044982848710994,38.171011379191185,0.0406914478192022,330.05863761901855,143.37558007240295,620.361946105957,17658,2078,15580,15580,0,9,2200000.0
2200,2200999,22.044985865092716,38.168914953333555,0.04065778221465155,330.18279671669006,143.44046115875244,620.5578422546387,17659,2078,15581,15581,0,9,2201000.0
2201,2201999,22.045722432855122,38.17094915783981,0.040604224676103806,330.3065605163574,143.50460577011108,620.7517051696777,17659,2078,15581,15581,0,9,2202000.0
2202,2202999,22.04709099004982,38.17114609893201,0.04056574134223667,330.52676796913147,143.56920838356018,620.8175163269043,17664,2080,15584,15584,0,9,2203000.0
2203,2203999,22.047079114876247,38.168490486713985,0.04053337219671538,330.6595516204834,143.63352632522583,621.0409126281738,17666,2080,15586,15586,0,9,2204000.0
2204,2204999,22.047059550489447,38.16936238304006,0.040501989348776135,330.82882022857666,143.69808912277222,621.176441192627,17670,2081,15589,15589,0,9,2205000.0
2205,2205999,22.046251188082326,38.165665576627916,0.040475758145125496,330.9949197769165,143.76412510871887,621.4236030578613,17677,2082,15595,15595,0,9,2206000.0
2206,2206999,22.044378947264907,38.161283538784915,0.040480163852752105,331.16715717315674,143.82878923416138,621.8760566711426,17696,2083,15613,15613,0,9,2207000.0
2207,2207999,22.0408827518903,38.15789763156937,0.04050033193570368,331.33544921875,143.89542508125305,622.2715873718262,17707,2084,15623,15623,0,9,2208000.0
2208,2208999,22.037034820917444,38.15283798227058,0.04051706497254026,331.4637656211853,143.96040868759155,622.5796318054199,17709,2084,15625,15625,0,9,2209000.0
2209,2209999,22.033255969347735,38.14713240351653,0.04053814045052828,331.6354959011078,144.02536034584045,622.8395156860352,17726,2085,15641,15641,0,9,2210000.0
2210,2210999,22.02975814361952,38.14428366210057,0.040548632754953795,331.7566146850586,144.09165215492249,623.0835762023926,17727,2085,15642,15642,0,9,2211000.0
2211,2211999,22.026240332236565,38.138144970907625,0.04056148543505711,331.93202209472656,144.15686678886414,623.2309684753418,17729,2086,15643,15643,0,9,2212000.0
2212,2212999,22.022540832014617,38.13243846739685,0.04057115185644988,332.0735511779785,144.2218632698059,623.487979888916,17730,2086,15644,15644,0,9,2213000.0
2213,2213999,22.018567572812227,38.125784417683434,0.040596197412684165,332.2055265903473,144.2863883972168,623.6459083557129,17730,2086,15644,15644,0,9,2214000.0
2214,2214999,22.014857793096652,38.119891530612044,0.04062168952073697,332.33801460266113,144.35123443603516,623.8605117797852,17730,2086,15644,15644,0,9,2215000.0
2215,2215999,22.011282943484794,38.113900789125026,0.04063698736066501,332.5085096359253,144.4162037372589,624.0207138061523,17737,2087,15650,15650,0,9,2216000.0
2216,2216999,22.008150748304704,38.10815175341385,0.040649654143704805,332.71380639076233,144.4812159538269,624.0733985900879,17761,2089,15672,15672,0,9,2217000.0
2217,2217999,22.0051146799102,38.10247281905123,0.04066042270403614,332.9656491279602,144.5467357635498,624.2419357299805,17782,2092,15690,15690,0,9,2218000.0
2218,2218999,22.002351171716175,38.09774705960189,0.04066784107434851,333.08621430397034,144.61312174797058,624.4158325195312,17782,2092,15690,15690,0,9,2219000.0
2219,2219999,21.9997847562865,38.09400545737702,0.04066799274696664,333.2571861743927,144.6783561706543,624.594482421875,17788,2093,15695,15695,0,9,2220000.0
2220,2220999,21.997440167078363,38.088958571882415,0.04068334257390638,333.47544384002686,144.74346542358398,624.7096519470215,17794,2095,15699,15699,0,9,2221000.0
2221,2221999,21.995699455131263,38.085930312837746,0.04066642309687052,333.674259185791,144.80782771110535,624.8364944458008,17799,2097,15702,15702,0,9,2222000.0
2222,2222999,21.994129033886868,38.08177877821549,0.04065955940443333,333.80204820632935,144.87398290634155,625.0423202514648,17800,2097,15703,15703,0,9,2223000.0
2223,2223999,21.992261572465992,38.07678620340307,0.040654083786300865,334.0141775608063,144.938871383667,625.1421241760254,17809,2099,15710,15710,0,9,2224000.0
2224,2224999,21.99094606408519,38.07773172146377,0.0406364304451865,334.1826870441437,145.00367856025696,625.2702827453613,17814,2100,15714,15714,0,9,2225000.0
2225,2225999,21.989257075718413,38.07380446247685,0.040628760772892236,334.34674096107483,145.068115234375,625.4325828552246,17816,2101,15715,15715,0,9,2226000.0
2226,2226999,21.98726453004777,38.068854495456556,0.040614554793128144,334.4744863510132,145.13473558425903,625.6346969604492,17816,2101,15715,15715,0,9,2227000.0
2227,2227999,21.984577230675225,38.06363399567671,0.04061410267408949,334.6128439903259,145.19910049438477,626.069206237793,17821,2101,15720,15720,0,9,2228000.0
2228,2228999,21.981108725851804,38.05991540091344,0.0406245008800894,334.7537000179291,145.26551032066345,626.4076232910156,17823,2101,15722,15722,0,9,2229000.0
2229,2229999,21.977744747160372,38.05547138785518,0.04064348610782886,335.05413818359375,145.33117651939392,626.443115234375,17849,2105,15744,15744,0,9,2230000.0
2230,2230999,21.974078101238643,38.04971368615291,0.04066572196638918,335.1877567768097,145.39626669883728,626.8334770202637,17851,2105,15746,15746,0,9,2231000.0
2231,2231999,21.971156337808722,38.046341419152604,0.04067101911729565,335.43691968917847,145.46131420135498,626.8748359680176,17889,2108,15781,15781,0,9,2232000.0
2232,2232999,21.96774150624766,38.040330705548925,0.04067997593391226,335.56346702575684,145.5258812904358,627.1817779541016,17890,2108,15782,15782,0,9,2233000.0
2233,2233999,21.964653905420338,38.034462765974524,0.04068737902849939,335.7003893852234,145.59061980247498,627.3755645751953,17891,2108,15783,15783,0,9,2234000.0
2234,2234999,21.961920294958322,38.02949648867168,0.04070592421720187,335.9068548679352,145.655663728714,627.5171928405762,17897,2110,15787,15787,0,9,2235000.0
2235,2235999,21.958901236294892,38.023854546149536,0.040714144038049294,336.11722683906555,145.72229599952698,627.6312980651855,17904,2112,15792,15792,0,9,2236000.0
2236,2236999,21.95644747149072,38.018790031691545,0.040727987445935754,336.2935218811035,145.7872383594513,627.7730293273926,17910,2113,15797,15797,0,9,2237000.0
2237,2237999,21.954965977498837,38.01562809010272,0.04072652944187238,336.4628629684448,145.85285425186157,628.004566192627,17912,2114,15798,15798,0,9,2238000.0
2238,2238999,21.954675730334642,38.01449828340078,0.040726505920651856,336.59097623825073,145.9171872138977,628.2707748413086,17912,2114,15798,15798,0,9,2239000.0
2239,2239999,21.955061843442067,38.022254045230625,0.04072762820335496,336.80229783058167,145.98224997520447,628.3802452087402,17917,2116,15801,15801,0,9,2240000.0
2240,2240999,21.955652551461224,38.03389227735986,0.04069287428721646,336.9734003543854,146.04726552963257,628.4534187316895,17922,2117,15805,15805,0,9,2241000.0
2241,2241999,21.956527145679306,38.0471474928332,0.04067514496230473,337.144371509552,146.11182641983032,628.6332893371582,17928,2118,15810,15810,0,9,2242000.0
2242,2242999,21.959090058244932,38.063302131077606,0.040632187186044666,337.30991530418396,146.17794179916382,628.8108673095703,17932,2119,15813,15813,0,9,2243000.0
2243,2243999,21.96069873619762,38.067805852022886,0.04061242899137618,337.493923664093,146.2472403049469,629.0050430297852,17937,2120,15817,15817,0,9,2244000.0
2244,2244999,21.961220122324182,38.07296402436755,0.04060615008372981,337.6756958961487,146.31237721443176,629.1902160644531,17943,2121,15822,15822,0,9,2245000.0
2245,2245999,21.961062279280373,38.07335256720343,0.040590541619875964,337.8586711883545,146.37702417373657,629.3513069152832,17946,2122,15824,15824,0,9,2246000.0
2246,2246999,21.960702637622408,38.07279716166515,0.04058492032462535,338.0484664440155,146.45295977592468,629.5341873168945,17949,2123,15826,15826,0,9,2247000.0
2247,2247999,21.959280210253265,38.070957909579406,0.040587510791684656,338.17738342285156,146.51842880249023,630.3668746948242,17967,2123,15844,15844,0,9,2248000.0
2248,2248999,21.95793381648357,38.071662365719384,0.04058313107530853,338.30442357063293,146.5834276676178,630.8745079040527,17973,2123,15850,15850,0,9,2249000.0
2249,2249999,21.957473269355518,38.07319733336285,0.04059708076098156,338.55830812454224,146.65060544013977,630.9567527770996,17984,2126,15858,15858,0,9,2250000.0
2250,2250999,21.956538438294633,38.07281417413889,0.04059046664566801,338.7666656970978,146.71668124198914,631.2421646118164,17993,2128,15865,15865,0,9,2251000.0
2251,2251999,21.95740349064001,38.075658204801144,0.040597055340837795,338.93036580085754,146.78148341178894,631.5222930908203,17998,2129,15869,15869,0,9,2252000.0
2252,2252999,21.959123303207168,38.07974771974807,0.04060349421950793,339.0605900287628,146.8482859134674,631.7488822937012,17998,2129,15869,15869,0,9,2253000.0
2253,2253999,21.960642698789933,38.082987359776915,0.04063129244379837,339.2258188724518,146.9133665561676,631.975414276123,18002,2130,15872,15872,0,9,2254000.0
2254,2254999,21.963954113320217,38.09124659732178,0.04064641398093982,339.356910943985,146.97826385498047,632.2832946777344,18003,2130,15873,15873,0,9,2255000.0
2255,2255999,21.96628901335665,38.094909694631106,0.040665870434406726,339.5200695991516,147.04313683509827,632.4733734130859,18009,2131,15878,15878,0,9,2256000.0
2256,2256999,21.970032235531363,38.10430924537406,0.04071573929937189,339.80437898635864,147.10878801345825,632.5468406677246,18020,2135,15885,15885,0,9,2257000.0
2257,2257999,21.97436873594113,38.11519510009721,0.04076184654763537,339.97140431404114,147.17367339134216,632.8030548095703,18024,2136,15888,15888,0,9,2258000.0
2258,2258999,21.97787373098457,38.121913184085564,0.04083670910088866,340.1351044178009,147.24027109146118,632.9580879211426,18027,2137,15890,15890,0,9,2259000.0
2259,2259999,21.980409238952742,38.12645797350438,0.040914351683537964,340.343537569046,147.30564975738525,633.2036972045898,18046,2139,15907,15907,0,9,2260000.0
2260,2260999,21.983226390790804,38.132423055734684,0.04092567528667823,340.63179874420166,147.37122797966003,633.2592926025391,18059,2143,15916,15916,0,9,2261000.0
2261,2261999,21.9863976525542,38.13783506596709,0.040978335260202114,340.76210832595825,147.4387664794922,633.5492248535156,18060,2143,15917,15917,0,9,2262000.0
2262,2262999,21.989202487736865,38.14249972941453,0.04105104486188649,340.87991094589233,147.5029332637787,633.7532730102539,18060,2143,15917,15917,0,9,2263000.0
2263,2263999,21.99208483976553,38.14468407189733,0.041092351289873874,341.1333613395691,147.5680956840515,633.7772102355957,18073,2146,15927,15927,0,9,2264000.0
2264,2264999,21.99414732987132,38.14558053733756,0.04110390908151329,341.306432723999,147.6349654197693,633.983959197998,18077,2147,15930,15930,0,9,2265000.0
2265,2265999,21.996325996769542,38.14647947287426,0.04110695814231258,341.47563886642456,147.7000093460083,634.1959953308105,18081,2148,15933,15933,0,9,2266000.0
2266,2266999,21.99639105236793,38.14362189445125,0.041108531348712285,341.63574957847595,147.76409220695496,634.3116607666016,18083,2149,15934,15934,0,9,2267000.0
2267,2267999,21.99441125829505,38.14134347000945,0.04109289408064887,341.80311727523804,147.82951760292053,634.9221534729004,18100,2150,15950,15950,0,9,2268000.0
2268,2268999,21.991518083044056,38.13671622886538,0.041089008621270295,342.00185656547546,147.89419889450073,635.1528282165527,18106,2152,15954,15954,0,9,2269000.0
2269,2269999,21.988997845578144,38.13231987013041,0.04107800211561641,342.2523190975189,147.96101999282837,635.3686790466309,18128,2155,15973,15973,0,9,2270000.0
2270,2270999,21.986707771941074,38.128876424590885,0.04107076105072971,342.45328521728516,148.02648901939392,635.640567779541,18134,2157,15977,15977,0,9,2271000.0
2271,2271999,21.984309465790513,38.124306845373525,0.04105982685737408,342.61820793151855,148.09092020988464,635.8726615905762,18149,2158,15991,15991,0,9,2272000.0
2272,2272999,21.982221551947347,38.12025496272769,0.041057403590306185,342.85978960990906,148.1569573879242,635.8852500915527,18157,2161,15996,15996,0,9,2273000.0
2273,2273999,21.980197527727004,38.116772596000914,0.04106539177485036,343.0632767677307,148.22168517112732,636.0439109802246,18161,2163,15998,15998,0,9,2274000.0
2274,2274999,21.979422800181037,38.11585112489655,0.04107406369513866,343.27703762054443,148.28726410865784,636.2269477844238,18170,2165,16005,16005,0,9,2275000.0
2275,2275999,21.979116387657676,38.12280924982616,0.041055016551520995,343.5297746658325,148.35214352607727,636.2628784179688,18206,2168,16038,16038,0,9,2276000.0
2276,2276999,21.97909343151205,38.12455350750594,0.041088347154875415,343.73774909973145,148.4181227684021,636.4864921569824,18214,2170,16044,16044,0,9,2277000.0
2277,2277999,21.980129810146053,38.12903923032649,0.041114414112049524,343.9030306339264,148.48257160186768,636.7435302734375,18219,2171,16048,16048,0,9,2278000.0
2278,2278999,21.982760424077387,38.138210098838734,0.04111312374754783,344.0276689529419,148.54795098304749,636.9944839477539,18221,2171,16050,16050,0,9,2279000.0
2279,2279999,21.984878905092287,38.14521361258242,0.04111562112600231,344.1510844230652,148.61218643188477,637.246166229248,18221,2171,16050,16050,0,9,2280000.0
2280,2280999,21.987394645591063,38.150133768130814,0.04114936029055394,344.48056149482727,148.67815351486206,637.318977355957,18245,2176,16069,16069,0,9,2281000.0
2281,2281999,21.990759864960125,38.16023359271095,0.0411859239302792,344.60187435150146,148.7421190738678,637.5549507141113,18245,2176,16069,16069,0,9,2282000.0
2282,2282999,21.99418018208923,38.16708580822216,0.04126401841806926,344.8074998855591,148.8070569038391,637.6720809936523,18255,2178,16077,16077,0,9,2283000.0
2283,2283999,21.996897229935033,38.170162361638205,0.04130163663996389,345.11516785621643,148.87503457069397,637.8326072692871,18272,2182,16090,16090,0,9,2284000.0
2284,2284999,22.0012983772197,38.17686303228521,0.04137021842307964,345.2817008495331,148.94035291671753,638.1575927734375,18276,2183,16093,16093,0,9,2285000.0
2285,2285999,22.005058303378537,38.18135102728415,0.04141809526546891,345.44891834259033,149.0056710243225,638.3297309875488,18280,2184,16096,16096,0,9,2286000.0
2286,2286999,22.007536647348267,38.18231468776209,0.04142343393099879,345.61576867103577,149.07066679000854,638.5800743103027,18284,2185,16099,16099,0,9,2287000.0
2287,2287999,22.006493044462307,38.17947463111262,0.04141549598666783,345.7819266319275,149.1351821422577,639.0382232666016,18297,2186,16111,16111,0,9,2288000.0
2288,2288999,22.00268948724512,38.173939123096616,0.041416933345922335,345.99127888679504,149.20050978660583,639.2903022766113,18304,2188,16116,16116,0,9,2289000.0
2289,2289999,21.99973375364313,38.16929927760725,0.04142872180824397,346.131352186203,149.265305519104,639.5521583557129,18305,2188,16117,16117,0,9,2290000.0
2290,2290999,21.998251892172334,38.16687175726671,0.041422367754699985,346.2946376800537,149.32998847961426,639.802734375,18309,2189,16120,16120,0,9,2291000.0
2291,2291999,21.997401246694196,38.1666201941484,0.04140874275724571,346.42021346092224,149.39770913124084,640.0041160583496,18311,2189,16122,16122,0,9,2292000.0
2292,2292999,21.996685032288,38.16623321433892,0.04140625644766438,346.67280864715576,149.46540689468384,640.0721588134766,18325,2192,16133,16133,0,9,2293000.0
2293,2293999,21.995510194270118,38.16307036737909,0.04140851737750617,346.7981233596802,149.52989053726196,640.3090515136719,18327,2192,16135,16135,0,9,2294000.0
2294,2294999,21.995039819145436,38.161713944352414,0.04140085883425826,346.9302134513855,149.59403157234192,640.4777793884277,18327,2192,16135,16135,0,9,2295000.0
2295,2295999,21.994980570654118,38.16143867921924,0.04142139780929832,347.14186906814575,149.65856766700745,640.5080947875977,18332,2194,16138,16138,0,9,2296000.0
2296,2296999,21.99516918529864,38.161807699513425,0.04141383513864827,347.31079483032227,149.72343254089355,640.6618461608887,18334,2195,16139,16139,0,9,2297000.0
2297,2297999,21.995354716885892,38.16213389364853,0.0414229391607942,347.48425221443176,149.78819799423218,640.7736396789551,18339,2196,16143,16143,0,9,2298000.0
2298,2298999,21.99548840079929,38.16168867085868,0.04142780078962449,347.61644530296326,149.85287976264954,641.0126304626465,18339,2196,16143,16143,0,9,2299000.0
2299,2299999,21.996288034353512,38.161890530730204,0.041428119346952896,347.78319478034973,149.91749334335327,641.2392883300781,18353,2197,16156,16156,0,9,2300000.0
2300,2300999,21.99782730592086,38.1648922737527,0.04144047663795214,347.9473259449005,149.98247718811035,641.3733215332031,18355,2198,16157,16157,0,9,2301000.0
2301,2301999,21.99921388074073,38.16648270957278,0.04143313535094806,348.0938296318054,150.04731369018555,641.5187149047852,18355,2198,16157,16157,0,9,2302000.0
2302,2302999,22.001046635947127,38.16991227072595,0.0414654931731363,348.29964232444763,150.11182689666748,641.5746383666992,18363,2200,16163,16163,0,9,2303000.0
2303,2303999,22.002798529961865,38.17199336880692,0.041490167562927116,348.51106357574463,150.1763653755188,641.6709251403809,18369,2202,16167,16167,0,9,2304000.0
2304,2304999,22.005362614450743,38.18158204046702,0.04147182185899989,348.7147705554962,150.24089455604553,641.7254219055176,18373,2204,16169,16169,0,9,2305000.0
2305,2305999,22.00737172351003,38.18379955034851,0.04147575217307009,348.84216141700745,150.3062686920166,641.9338531494141,18374,2204,16170,16170,0,9,2306000.0
2306,2306999,22.009579688261528,38.18929639998237,0.04147353885215832,348.9739353656769,150.37027668952942,642.0930633544922,18374,2204,16170,16170,0,9,2307000.0
2307,2307999,22.01018597174257,38.18820393256445,0.041481299085340706,349.1041977405548,150.43492364883423,642.3052978515625,18374,2204,16170,16170,0,9,2308000.0
2308,2308999,22.009031227462234,38.18568306810787,0.041493154517088904,349.2278411388397,150.50056672096252,642.9606170654297,18380,2204,16176,16176,0,9,2309000.0
2309,2309999,22.00682692291287,38.1837947069439,0.041507866564241214,349.3605327606201,150.565612077713,643.3556365966797,18383,2204,16179,16179,0,9,2310000.0
2310,2310999,22.004502467308054,38.17900714593288,0.0415163844266514,349.57143354415894,150.63064336776733,643.6145858764648,18390,2206,16184,16184,0,9,2311000.0
2311,2311999,22.00190598197926,38.1739659036574,0.04153222860092365,349.78161334991455,150.69617629051208,643.8544120788574,18435,2208,16227,16227,0,9,2312000.0
2312,2312999,21.999833607036756,38.169118419018744,0.04153341759429263,349.9555811882019,150.7606782913208,644.168285369873,18437,2209,16228,16228,0,9,2313000.0
2313,2313999,21.997798388173457,38.164075237647054,0.04153356897603089,350.1142966747284,150.8249752521515,644.4326591491699,18439,2210,16229,16229,0,9,2314000.0
2314,2314999,21.99541541159937,38.15873547156055,0.04153887431157277,350.3289062976837,150.8899862766266,644.7062873840332,18452,2212,16240,16240,0,9,2315000.0
2315,2315999,21.993358173103566,38.153722813982036,0.04154538119854134,350.53390288352966,150.95570421218872,644.9010009765625,18456,2214,16242,16242,0,9,2316000.0
2316,2316999,21.99132101460664,38.14859685073885,0.04155022333124969,350.7032845020294,151.02024054527283,645.1096878051758,18462,2215,16247,16247,0,9,2317000.0
2317,2317999,21.989150883794895,38.143485641317774,0.04154968686862848,350.82647824287415,151.08437943458557,645.3757667541504,18462,2215,16247,16247,0,9,2318000.0
2318,2318999,21.98751260381329,38.13912196180382,0.04153548885760883,350.9516808986664,151.14926671981812,645.5221786499023,18462,2215,16247,16247,0,9,2319000.0
2319,2319999,21.986531019240765,38.13555542014573,0.041513111254455115,351.12497878074646,151.21372747421265,645.7091445922852,18464,2216,16248,16248,0,9,2320000.0
2320,2320999,21.98596229935539,38.13210069184766,0.04149368626906036,351.2885220050812,151.2780475616455,645.8795623779297,18467,2217,16250,16250,0,9,2321000.0
2321,2321999,21.98540611204832,38.12914376906364,0.0414705679562265,351.41978454589844,151.34202671051025,646.0897903442383,18467,2217,16250,16250,0,9,2322000.0
2322,2322999,21.984397655856235,38.12514197505306,0.04146785937905306,351.5816504955292,151.4067850112915,646.223258972168,18472,2218,16254,16254,0,9,2323000.0
2323,2323999,21.983148118142143,38.120730359029054,0.04147269308422341,351.78474164009094,151.47113156318665,646.3262329101562,18479,2220,16259,16259,0,9,2324000.0
2324,2324999,21.981918066615933,38.11618469632545,0.04147792967201602,351.96298241615295,151.53575658798218,646.5335922241211,18485,2221,16264,16264,0,9,2325000.0
2325,2325999,21.980304532917227,38.111633378483276,0.04148009324767199,352.1222276687622,151.59938311576843,646.746467590332,18497,2222,16275,16275,0,9,2326000.0
2326,2326999,21.97866880586529,38.11120306676276,0.04145695977800379,352.2538368701935,151.66461324691772,647.2361526489258,18503,2222,16281,16281,0,9,2327000.0
2327,2327999,21.977085837797684,38.10984838653912,0.04146629535570234,352.4727029800415,151.729336977005,647.43896484375,18526,2224,16302,16302,0,9,2328000.0
2328,2328999,21.975072814767703,38.10493610755253,0.04148099019605955,352.59651374816895,151.7939646244049,647.7954216003418,18528,2224,16304,16304,0,9,2329000.0
2329,2329999,21.973157042456528,38.100171381525115,0.041486769188130435,352.7343318462372,151.8593761920929,648.0220069885254,18529,2224,16305,16305,0,9,2330000.0
2330,2330999,21.971001434024636,38.09506761085663,0.04150154367934045,352.8603765964508,151.9238510131836,648.2874183654785,18530,2224,16306,16306,0,9,2331000.0
2331,2331999,21.96898126517703,38.09034676827576,0.0414993518030603,353.03969264030457,151.98839950561523,648.5517234802246,18561,2225,16336,16336,0,9,2332000.0
2332,2332999,21.966760516256628,38.08580035161221,0.041499281371129904,353.2034206390381,152.05291199684143,648.7204856872559,18566,2226,16340,16340,0,9,2333000.0
2333,2333999,21.964598026055498,38.08086248135704,0.0415024422262521,353.32150053977966,152.11674118041992,648.8878288269043,18567,2226,16341,16341,0,9,2334000.0
2334,2334999,21.963082525037777,38.07891973541691,0.04148932872385114,353.5314748287201,152.1809332370758,649.0101509094238,18586,2228,16358,16358,0,9,2335000.0
2335,2335999,21.961680242205375,38.07592994584581,0.04147294930001533,353.7059075832367,152.24514150619507,649.1659889221191,18588,2229,16359,16359,0,9,2336000.0
2336,2336999,21.960509720157287,38.0721517657718,0.04145785782598055,353.9278223514557,152.30955719947815,649.2673759460449,18592,2231,16361,16361,0,9,2337000.0
2337,2337999,21.95988012883722,38.076003315476086,0.04141975926747932,354.1361119747162,152.37391090393066,649.3527679443359,18596,2233,16363,16363,0,9,2338000.0
2338,2338999,21.959197118305678,38.07269909007244,0.041400235085988,354.3067202568054,152.439870595932,649.6060066223145,18599,2234,16365,16365,0,9,2339000.0
2339,2339999,21.957707179547896,38.06836059508843,0.041384942051918894,354.5083112716675,152.50435709953308,649.6842918395996,18603,2236,16367,16367,0,9,2340000.0
2340,2340999,21.956894068684036,38.065613449252474,0.04137209959699517,354.6833038330078,152.56903171539307,649.8980865478516,18617,2237,16380,16380,0,9,2341000.0
2341,2341999,21.95588530148534,38.0614472745868,0.04135310953459592,354.8600318431854,152.6333451271057,650.1397590637207,18622,2238,16384,16384,0,9,2342000.0
2342,2342999,21.95542540356806,38.06302259985453,0.04133400980880009,355.01868295669556,152.69874453544617,650.2480773925781,18624,2239,16385,16385,0,9,2343000.0
2343,2343999,21.954696786447002,38.05949951113333,0.04129838778691597,355.28394198417664,152.76328110694885,650.4004821777344,18643,2242,16401,16401,0,9,2344000.0
2344,2344999,21.953221395790198,38.05576125877592,0.041280435437113794,355.44422817230225,152.8272614479065,650.6186103820801,18661,2243,16418,16418,0,9,2345000.0
2345,2345999,21.9503736889351,38.05010021836602,0.04127930314032946,355.57357573509216,152.89215421676636,650.8888473510742,18662,2243,16419,16419,0,9,2346000.0
2346,2346999,21.948245987784563,38.0504538385986,0.04129104329681221,355.7489709854126,152.9567723274231,651.452507019043,18672,2244,16428,16428,0,9,2347000.0
2347,2347999,21.94496729215951,38.04542913314614,0.04130138906577452,355.93260407447815,153.02211165428162,651.8015632629395,18677,2245,16432,16432,0,9,2348000.0
2348,2348999,21.941497224499585,38.039296345921166,0.04131930109109461,356.0575590133667,153.08772206306458,652.0052452087402,18677,2245,16432,16432,0,9,2349000.0
2349,2349999,21.938618804155844,38.034585497716286,0.0413348455022875,356.1861765384674,153.15218877792358,652.2924842834473,18679,2245,16434,16434,0,9,2350000.0
2350,2350999,21.935626226225583,38.02894935546571,0.04134344805124923,356.3668122291565,153.2166588306427,652.5512962341309,18681,2246,16435,16435,0,9,2351000.0
2351,2351999,21.932733202161444,38.023884025694855,0.04135145707369192,356.50469756126404,153.28143286705017,652.7447204589844,18681,2246,16435,16435,0,9,2352000.0
2352,2352999,21.929536928580706,38.01791927793824,0.041362206266752355,356.67332792282104,153.34632897377014,652.9988708496094,18684,2247,16437,16437,0,9,2353000.0
2353,2353999,21.926721440539175,38.01285164657813,0.04137142144060324,356.8055307865143,153.41124606132507,653.2812271118164,18685,2247,16438,16438,0,9,2354000.0
2354,2354999,21.924416973081094,38.00834781968349,0.041377171252455214,356.9288868904114,153.4754958152771,653.4602928161621,18685,2247,16438,16438,0,9,2355000.0
2355,2355999,21.921954567311936,38.00344422520688,0.041375339316586324,357.1391386985779,153.540030002594,653.5761108398438,18690,2249,16441,16441,0,9,2356000.0
2356,2356999,21.919794383113313,37.999094562905285,0.041379336796429356,357.3540270328522,153.6047523021698,653.7164421081543,18701,2251,16450,16450,0,9,2357000.0
2357,2357999,21.918157168566545,37.99520690348094,0.04138226892123953,357.52911472320557,153.66911697387695,653.8000183105469,18703,2252,16451,16451,0,9,2358000.0
2358,2358999,21.916852607410643,37.992729989832476,0.04137611662814111,357.7051284313202,153.73341464996338,653.9688301086426,18718,2253,16465,16465,0,9,2359000.0
2359,2359999,21.91525623202877,37.98922174877303,0.04138545805948335,357.8725473880768,153.79767894744873,654.0360069274902,18720,2254,16466,16466,0,9,2360000.0
2360,2360999,21.914785490675172,37.987356769092905,0.04138076083361086,358.0153617858887,153.8615620136261,654.2359733581543,18721,2254,16467,16467,0,9,2361000.0
2361,2361999,21.914609388455187,37.98606119965906,0.04137604995558264,358.24023938179016,153.92619490623474,654.2366561889648,18725,2256,16469,16469,0,9,2362000.0
2362,2362999,21.914437676268705,37.9844758168947,0.04136098557066503,358.45072627067566,153.9916000366211,654.3636703491211,18732,2258,16474,16474,0,9,2363000.0
2363,2363999,21.914903960318746,37.983745236980745,0.0413740610342358,358.5789387226105,154.055983543396,654.6110458374023,18732,2258,16474,16474,0,9,2364000.0
2364,2364999,21.914555348006296,37.98249600070628,0.041360335495112865,358.74218821525574,154.11975169181824,654.745849609375,18737,2259,16478,16478,0,9,2365000.0
2365,2365999,21.913571045550082,37.978738581953934,0.04135273065864409,358.8696970939636,154.1836040019989,654.9481010437012,18737,2259,16478,16478,0,9,2366000.0
2366,2366999,21.9121698927844,37.97563151198835,0.04134281633059256,359.00659823417664,154.24835681915283,655.3493194580078,18742,2259,16483,16483,0,9,2367000.0
2367,2367999,21.911084904032553,37.97185031014442,0.04128193444243877,359.21740794181824,154.31284427642822,655.6256446838379,18754,2261,16493,16493,0,9,2368000.0
2368,2368999,21.909748184868246,37.97050896687168,0.041245601779932195,359.3428201675415,154.3784487247467,655.9685974121094,18757,2261,16496,16496,0,9,2369000.0
2369,2369999,21.908151164514138,37.96560065491273,0.041203367051940054,359.46714186668396,154.44278717041016,656.2205505371094,18759,2261,16498,16498,0,9,2370000.0
2370,2370999,21.906638931891838,37.961305672970106,0.04116984237315924,359.5903136730194,154.50744009017944,656.4690742492676,18763,2261,16502,16502,0,9,2371000.0
2371,2371999,21.905427306646864,37.957419287682164,0.04112568713304077,359.76197123527527,154.57264971733093,656.6740341186523,18768,2262,16506,16506,0,9,2372000.0
2372,2372999,21.90479597901379,37.95568970949614,0.04106831381697296,359.8975901603699,154.63700079917908,656.8629570007324,18769,2262,16507,16507,0,9,2373000.0
2373,2373999,21.903710993492936,37.9514447318872,0.041013701321684026,360.07186102867126,154.70181345939636,657.0539703369141,18773,2263,16510,16510,0,9,2374000.0
2374,2374999,21.902987583211758,37.94736819813724,0.04096171439602048,360.2802405357361,154.76651906967163,657.1251335144043,18778,2265,16513,16513,0,9,2375000.0
2375,2375999,21.902001318451223,37.94310044425305,0.04091851232997712,360.4009037017822,154.8313500881195,657.3837814331055,18779,2265,16514,16514,0,9,2376000.0
2376,2376999,21.901139237952393,37.93909918144092,0.0408693300124805,360.61716175079346,154.89610242843628,657.4525680541992,18787,2267,16520,16520,0,9,2377000.0
2377,2377999,21.90124377010762,37.936196722784814,0.04080788791262413,360.7846612930298,154.96054816246033,657.5600051879883,18789,2268,16521,16521,0,9,2378000.0
2378,2378999,21.900758321671482,37.932734120209524,0.0407677956096153,360.9524223804474,155.02465200424194,657.7336730957031,18793,2269,16524,16524,0,9,2379000.0
2379,2379999,21.9014945864906,37.93181464640459,0.04071004380175969,361.12813425064087,155.088449716568,657.838680267334,18796,2270,16526,16526,0,9,2380000.0
2380,2380999,21.90336571921577,37.93882727962999,0.04068464350054113,361.30104207992554,155.15288662910461,658.0547332763672,18799,2271,16528,16528,0,9,2381000.0
2381,2381999,21.906136806747302,37.940882442794766,0.04066571475666381,361.41941690444946,155.2164511680603,658.2116279602051,18799,2271,16528,16528,0,9,2382000.0
2382,2382999,21.90886730942865,37.94274510997032,0.040647091752119446,361.5851535797119,155.28037357330322,658.3106880187988,18801,2272,16529,16529,0,9,2383000.0
2383,2383999,21.912361765201858,37.94724343166975,0.040603381010095085,361.7891836166382,155.3452889919281,658.4255981445312,18806,2274,16532,16532,0,9,2384000.0
2384,2384999,21.915723206287677,37.94963106000204,0.04055735633175339,361.9070439338684,155.40892219543457,658.6775856018066,18808,2274,16534,16534,0,9,2385000.0
2385,2385999,21.91885305526373,37.95143531390772,0.040524054673672594,362.120530128479,155.47276878356934,658.7759170532227,18823,2276,16547,16547,0,9,2386000.0
2386,2386999,21.92066955950421,37.951708221406676,0.04050277985059836,362.2415461540222,155.53600597381592,659.0168380737305,18825,2276,16549,16549,0,9,2387000.0
2387,2387999,21.918762905768503,37.94739599089778,0.040469117817090505,362.4183669090271,155.60087990760803,659.695125579834,18847,2277,16570,16570,0,9,2388000.0
2388,2388999,21.916330124299197,37.943157767933094,0.040459460032235106,362.5392282009125,155.66563749313354,660.0570602416992,18850,2277,16573,16573,0,9,2389000.0
2389,2389999,21.91485881552351,37.941117545947705,0.04043600928118518,362.71540355682373,155.73804116249084,660.2396583557129,18853,2278,16575,16575,0,9,2390000.0
2390,2390999,21.913061009070606,37.937292585727086,0.040418059923924554,362.87813568115234,155.8020942211151,660.3881874084473,18860,2279,16581,16581,0,9,2391000.0
2391,2391999,21.910942646828055,37.932603282157814,0.04040420516829646,363.00608921051025,155.86595678329468,660.6349258422852,18860,2279,16581,16581,0,9,2392000.0
2392,2392999,21.909161577337848,37.927962733476654,0.04038614547040764,363.131356716156,155.92971515655518,660.7814674377441,18860,2279,16581,16581,0,9,2393000.0
2393,2393999,21.90760493530929,37.92338244917256,0.04036783322144122,363.29606914520264,155.99374961853027,660.9091186523438,18864,2280,16584,16584,0,9,2394000.0
2394,2394999,21.90626488607438,37.91871673723663,0.04034464475579835,363.50150895118713,156.0579674243927,661.0437049865723,18872,2282,16590,16590,0,9,2395000.0
2395,2395999,21.905019505841636,37.91486633029527,0.04032570026053106,363.6700248718262,156.1242413520813,661.182975769043,18874,2283,16591,16591,0,9,2396000.0
2396,2396999,21.903882727627245,37.91204250388749,0.040293752712112996,363.82921600341797,156.18910574913025,661.365852355957,18876,2284,16592,16592,0,9,2397000.0
2397,2397999,21.903145126671546,37.908272616421094,0.04025535387439494,363.9529519081116,156.25320768356323,661.5880012512207,18877,2284,16593,16593,0,9,2398000.0
2398,2398999,21.902597305244583,37.90504175236317,0.04023501421263487,364.07556343078613,156.3171637058258,661.7290840148926,18877,2284,16593,16593,0,9,2399000.0
2399,2399999,21.902564284262425,37.90309387942174,0.040213259688581804,364.25334072113037,156.38174200057983,661.8829612731934,18882,2285,16597,16597,0,9,2400000.0
2400,2400999,21.903245860452376,37.90237606717733,0.040221393059167165,364.4608964920044,156.4458589553833,661.9856262207031,18890,2287,16603,16603,0,9,2401000.0
2401,2401999,21.90384684783394,37.900689842498785,0.04020964868741128,364.5854127407074,156.50978469848633,662.1057167053223,18890,2287,16603,16603,0,9,2402000.0
2402,2402999,21.90507073556721,37.90001330025232,0.04018948748121054,364.7064507007599,156.57334280014038,662.2287368774414,18890,2287,16603,16603,0,9,2403000.0
2403,2403999,21.908807342751278,37.90566098887006,0.040186976293695165,364.87327098846436,156.63733673095703,662.3374176025391,18893,2288,16605,16605,0,9,2404000.0
2404,2404999,21.911859605449642,37.9117136306482,0.04019394705602186,365.05853486061096,156.70273780822754,662.4782447814941,18896,2289,16607,16607,0,9,2405000.0
2405,2405999,21.91515121915588,37.91602066245337,0.0402119626331906,365.22832703590393,156.76751327514648,662.5938758850098,18900,2290,16610,16610,0,9,2406000.0
2406,2406999,21.917403781533576,37.91748268995617,0.04022630309602904,365.3900489807129,156.8309133052826,662.7451515197754,18903,2291,16612,16612,0,9,2407000.0
2407,2407999,21.916509601301996,37.917394238475474,0.04021111936303545,365.50648832321167,156.89434909820557,663.2103462219238,18909,2291,16618,16618,0,9,2408000.0
2408,2408999,21.91465661065943,37.926005729176374,0.040187969191733064,365.76314520835876,156.95910120010376,663.5566024780273,18944,2294,16650,16650,0,9,2409000.0
2409,2409999,21.912348035538045,37.92270043717749,0.04017236126703716,365.9015955924988,157.02389454841614,664.0005569458008,18945,2294,16651,16651,0,9,2410000.0
2410,2410999,21.910193100881724,37.91884226954502,0.04017125471280514,366.03733468055725,157.0883345603943,664.3549575805664,18946,2294,16652,16652,0,9,2411000.0
2411,2411999,21.907844426639024,37.91473566624817,0.0401644973114611,366.1589391231537,157.15246295928955,664.5926513671875,18947,2294,16653,16653,0,9,2412000.0
2412,2412999,21.90608169551094,37.911301451611386,0.040146636656003265,366.3377969264984,157.21758389472961,664.9052772521973,18961,2295,16666,16666,0,9,2413000.0
2413,2413999,21.903951856333208,37.90663428670454,0.040131746112271216,366.46115350723267,157.2816517353058,665.1998863220215,18961,2295,16666,16666,0,9,2414000.0
2414,2414999,21.90261029045589,37.90289731848379,0.04011421737904519,366.5895025730133,157.3458433151245,665.5454216003418,18963,2295,16668,16668,0,9,2415000.0
2415,2415999,21.9009429528149,37.89930569060485,0.0401006482396008,366.75958585739136,157.40994477272034,665.7971725463867,18967,2296,16671,16671,0,9,2416000.0
2416,2416999,21.899167299004656,37.89526968516078,0.040079193760834464,366.87969303131104,157.47384929656982,666.1948204040527,18968,2296,16672,16672,0,9,2417000.0
2417,2417999,21.897947877102425,37.892306932558,0.04005742759878428,367.0141177177429,157.53748774528503,666.4159393310547,18969,2296,16673,16673,0,9,2418000.0
2418,2418999,21.896353099647197,37.88852568715843,0.0400236409680933,367.1336205005646,157.60135769844055,666.7525825500488,18970,2296,16674,16674,0,9,2419000.0
2419,2419999,21.89551674665366,37.88705182585188,0.040005143541377075,367.2570655345917,157.66468977928162,666.9598426818848,18970,2296,16674,16674,0,9,2420000.0
2420,2420999,21.895041557808323,37.885957640348074,0.03997816334655957,367.4005584716797,157.72908544540405,667.1759147644043,18971,2296,16675,16675,0,9,2421000.0
2421,2421999,21.896090873088337,37.88824797969646,0.039950528434952615,367.5250961780548,157.79301691055298,667.4026107788086,18971,2296,16675,16675,0,9,2422000.0
2422,2422999,21.89693305938344,37.890638915476536,0.039937272311223904,367.65381622314453,157.85684847831726,667.650749206543,18972,2296,16676,16676,0,9,2423000.0
2423,2423999,21.89939379993085,37.894560503934,0.039938781519936684,367.81839656829834,157.9206919670105,667.7783432006836,18979,2297,16682,16682,0,9,2424000.0
2424,2424999,21.901956480864232,37.8992659792331,0.03993157439977224,367.98159098625183,157.98674702644348,668.0677909851074,18987,2298,16689,16689,0,9,2425000.0
2425,2425999,21.905054415368593,37.905492648982204,0.039893148270417345,368.1162645816803,158.05046677589417,668.3564910888672,18989,2298,16691,16691,0,9,2426000.0
2426,2426999,21.906380873231665,37.90682846796955,0.03986937655150535,368.24174213409424,158.11398243904114,668.5361938476562,18990,2298,16692,16692,0,9,2427000.0
2427,2427999,21.9082130278455,37.91161970726667,0.03982766466175114,368.3566267490387,158.17712092399597,668.7765960693359,18991,2298,16693,16693,0,9,2428000.0
2428,2428999,21.90664709782926,37.90980585353536,0.03980910701105589,368.5669753551483,158.2407524585724,669.1212921142578,19009,2300,16709,16709,0,9,2429000.0
2429,2429999,21.904514093949008,37.90882071539644,0.039800828403332655,368.69581389427185,158.3047811985016,669.4199523925781,19011,2300,16711,16711,0,9,2430000.0
2430,2430999,21.902478252714513,37.90631913099785,0.03979352684061588,368.8662383556366,158.36935186386108,669.4467315673828,19029,2301,16728,16728,0,9,2431000.0
2431,2431999,21.900215587017303,37.90230164267793,0.03978799266104016,368.9925410747528,158.4334750175476,669.6608619689941,19029,2301,16728,16728,0,9,2432000.0
2432,2432999,21.898019863734444,37.89856465475416,0.039773329196768015,369.12325739860535,158.497252702713,669.8412284851074,19029,2301,16728,16728,0,9,2433000.0
2433,2433999,21.896507494840765,37.89713096865959,0.03975430434459637,369.2912826538086,158.56109166145325,670.0056228637695,19045,2302,16743,16743,0,9,2434000.0
2434,2434999,21.894501221596133,37.89478492373986,0.03974560496651203,369.42382764816284,158.62626099586487,670.2287063598633,19045,2302,16743,16743,0,9,2435000.0
2435,2435999,21.892499609362297,37.89077575189462,0.039730376524717115,369.5618784427643,158.690438747406,670.4352378845215,19045,2302,16743,16743,0,9,2436000.0
2436,2436999,21.89061031979274,37.886443478406726,0.03971696864717644,369.71971011161804,158.75390028953552,670.5250358581543,19047,2303,16744,16744,0,9,2437000.0
2437,2437999,21.888906960533735,37.882249802990046,0.03970445559447522,369.85384607315063,158.81733202934265,670.7453880310059,19047,2303,16744,16744,0,9,2438000.0
2438,2438999,21.887051524324832,37.878258028826494,0.03969406230486028,370.0130286216736,158.88110518455505,670.8232727050781,19060,2304,16756,16756,0,9,2439000.0
2439,2439999,21.885607619762293,37.87448104164375,0.03967920746429254,370.1332607269287,158.94545102119446,671.1094207763672,19062,2304,16758,16758,0,9,2440000.0
2440,2440999,21.884294963422622,37.87145814026651,0.039666867345534484,370.30395221710205,159.00915908813477,671.2629661560059,19066,2305,16761,16761,0,9,2441000.0
2441,2441999,21.88357401957319,37.86904489152637,0.039651182590036416,370.4277853965759,159.07241892814636,671.4067993164062,19066,2305,16761,16761,0,9,2442000.0
2442,2442999,21.882347661393467,37.86501783643306,0.039638099920424,370.5515730381012,159.13623428344727,671.5943717956543,19066,2305,16761,16761,0,9,2443000.0
2443,2443999,21.882070092100886,37.86253361215412,0.039619828740918406,370.681179523468,159.20120406150818,671.8117446899414,19068,2305,16763,16763,0,9,2444000.0
2444,2444999,21.881566670323014,37.85937963908454,0.03959951405320761,370.8096823692322,159.26445150375366,671.9644355773926,19068,2305,16763,16763,0,9,2445000.0
2445,2445999,21.881559951885215,37.85696281238059,0.03956934866618467,371.0220363140106,159.32819652557373,672.0768547058105,19079,2307,16772,16772,0,9,2446000.0
2446,2446999,21.881103300329517,37.85412759630525,0.0395506349569249,371.14927220344543,159.3916459083557,672.2728652954102,19080,2307,16773,16773,0,9,2447000.0
2447,2447999,21.881118426002445,37.85117723036465,0.03952816302497497,371.3120276927948,159.4550976753235,672.4237747192383,19111,2308,16803,16803,0,9,2448000.0
2448,2448999,21.880971299577247,37.85112788897706,0.03949645427724202,371.4776110649109,159.51925349235535,672.5654449462891,19113,2309,16804,16804,0,9,2449000.0
2449,2449999,21.88003667716536,37.85156308745728,0.03947924652583412,371.603476524353,159.58353638648987,673.1498031616211,19119,2309,16810,16810,0,9,2450000.0
2450,2450999,21.877956366149146,37.84783405737946,0.039472828062335985,371.73724722862244,159.64719772338867,673.5103569030762,19124,2309,16815,16815,0,9,2451000.0
2451,2451999,21.87642212481126,37.84431369094004,0.03946715397323308,371.90524888038635,159.7113790512085,673.6803703308105,19126,2310,16816,16816,0,9,2452000.0
2452,2452999,21.874688648518966,37.84058608418914,0.03947149745412315,372.03879594802856,159.7757546901703,673.9203567504883,19128,2310,16818,16818,0,9,2453000.0
2453,2453999,21.873427327932973,37.83838441802639,0.039458327465731524,372.21188616752625,159.84011507034302,674.1101608276367,19134,2311,16823,16823,0,9,2454000.0
2454,2454999,21.872687677202595,37.837282990226875,0.0394551105111034,372.40571546554565,159.90505933761597,674.2608184814453,19138,2312,16826,16826,0,9,2455000.0
2455,2455999,21.871427918866928,37.83374367661312,0.03945159538799914,372.62850522994995,159.96979546546936,674.389892578125,19169,2314,16855,16855,0,9,2456000.0
2456,2456999,21.87082180402191,37.832220447535114,0.039440422824074006,372.79369926452637,160.033212184906,674.5063285827637,19171,2315,16856,16856,0,9,2457000.0
2457,2457999,21.869709799765335,37.82938121411972,0.03943599494405192,372.9600479602814,160.09738445281982,674.6544990539551,19182,2316,16866,16866,0,9,2458000.0
2458,2458999,21.868428378213217,37.82555750849834,0.03942718582969296,373.12246465682983,160.16130995750427,674.798526763916,19186,2317,16869,16869,0,9,2459000.0
2459,2459999,21.868083091325442,37.82328180335388,0.039413926318252024,373.24653816223145,160.22516536712646,674.9580230712891,19187,2317,16870,16870,0,9,2460000.0
2460,2460999,21.86760045123474,37.82501639857838,0.03939309765334942,373.4055824279785,160.2891616821289,675.0562705993652,19191,2318,16873,16873,0,9,2461000.0
2461,2461999,21.867753237368674,37.823395193235555,0.03938074645402634,373.626264333725,160.35350370407104,675.130069732666,19208,2320,16888,16888,0,9,2462000.0
2462,2462999,21.867844364645087,37.82046574652727,0.03935169711125441,373.7467167377472,160.41797614097595,675.3047714233398,19208,2320,16888,16888,0,9,2463000.0
2463,2463999,21.867784553782116,37.81755138139516,0.039333065515699484,373.9211628437042,160.48161959648132,675.3790855407715,19210,2321,16889,16889,0,9,2464000.0
2464,2464999,21.868236324796253,37.81528142685466,0.039303473000109945,374.05666518211365,160.54550576210022,675.5918273925781,19212,2321,16891,16891,0,9,2465000.0
2465,2465999,21.867322550668327,37.81133651079282,0.03928951114544288,374.1836643218994,160.6095039844513,675.8049011230469,19213,2321,16892,16892,0,9,2466000.0
2466,2466999,21.86664870123043,37.80779787255986,0.03925726012161068,374.3107316493988,160.67373085021973,676.0367584228516,19214,2321,16893,16893,0,9,2467000.0
2467,2467999,21.86535355070778,37.80772739965871,0.039231997753685244,374.4597053527832,160.73896861076355,676.8743782043457,19231,2321,16910,16910,0,9,2468000.0
2468,2468999,21.86388918720094,37.80603911004734,0.0392316460009996,374.62435722351074,160.80362796783447,677.319034576416,19236,2322,16914,16914,0,9,2469000.0
2469,2469999,21.862141235007428,37.80386836566299,0.03923817973154087,374.7914652824402,160.87024307250977,677.6441764831543,19251,2323,16928,16928,0,9,2470000.0
2470,2470999,21.86064114747718,37.801201252187305,0.039232308370694025,374.91720962524414,160.93407344818115,677.910083770752,19251,2323,16928,16928,0,9,2471000.0
2471,2471999,21.859461319879657,37.798607767803524,0.03922796097758685,375.053405046463,160.9983594417572,678.1735763549805,19251,2323,16928,16928,0,9,2472000.0
2472,2472999,21.857596920612302,37.7950289882513,0.03919547109534216,375.31794786453247,161.0628800392151,678.3235969543457,19273,2326,16947,16947,0,9,2473000.0
2473,2473999,21.857398896836155,37.79402595850024,0.039189322344940325,375.5263216495514,161.12779188156128,678.5158538818359,19280,2328,16952,16952,0,9,2474000.0
2474,2474999,21.856000630098496,37.791028973593285,0.03917514219898954,375.73510551452637,161.19237518310547,678.5940818786621,19286,2330,16956,16956,0,9,2475000.0
2475,2475999,21.85546868111174,37.79640268596437,0.039143404839204976,375.9043016433716,161.25710320472717,678.8522148132324,19293,2331,16962,16962,0,9,2476000.0
2476,2476999,21.854546073932383,37.7941611706581,0.03912397283334923,376.02296209335327,161.32244229316711,679.0955200195312,19293,2331,16962,16962,0,9,2477000.0
2477,2477999,21.854596436607746,37.796464342858044,0.03910059854386072,376.14413046836853,161.38607358932495,679.2275314331055,19293,2331,16962,16962,0,9,2478000.0
2478,2478999,21.854436192316925,37.794836984884014,0.039090588728690534,376.2646896839142,161.44978308677673,679.4781608581543,19294,2331,16963,16963,0,9,2479000.0
2479,2479999,21.855367509449355,37.79498569565571,0.039074488784414774,376.445405960083,161.5146996974945,679.6089553833008,19298,2332,16966,16966,0,9,2480000.0
2480,2480999,21.85614782102337,37.79473600107734,0.03905382760868048,376.61571073532104,161.5797266960144,679.7525291442871,19302,2333,16969,16969,0,9,2481000.0
2481,2481999,21.858001686652553,37.79631471133053,0.03904754615594752,376.73370599746704,161.6439344882965,679.9910926818848,19303,2333,16970,16970,0,9,2482000.0
2482,2482999,21.860102442380366,37.80406563613357,0.039005135130464885,376.86229515075684,161.70859742164612,680.221004486084,19305,2333,16972,16972,0,9,2483000.0
2483,2483999,21.862046248161136,37.806746272867734,0.03899031473536574,377.07166051864624,161.77292609214783,680.2726173400879,19309,2335,16974,16974,0,9,2484000.0
2484,2484999,21.863398052519106,37.80645879277247,0.0389769507527743,377.2868449687958,161.8379247188568,680.4730911254883,19321,2337,16984,16984,0,9,2485000.0
2485,2485999,21.86538012795872,37.80955814859875,0.038947719152642724,377.4572820663452,161.90270566940308,680.7616653442383,19329,2338,16991,16991,0,9,2486000.0
2486,2486999,21.86470395271283,37.8066090284005,0.0389498513060591,377.5789363384247,161.9660575389862,681.0514640808105,19331,2338,16993,16993,0,9,2487000.0
2487,2487999,21.862597848795193,37.80419925413233,0.03894954076372492,377.70831871032715,162.03004145622253,681.5920066833496,19344,2338,17006,17006,0,9,2488000.0
2488,2488999,21.86051325485629,37.80238591083737,0.03895169493120021,377.8412301540375,162.0946502685547,681.922248840332,19348,2338,17010,17010,0,9,2489000.0
2489,2489999,21.858805105165935,37.80030647668612,0.03895286017912769,378.0139846801758,162.15884804725647,682.0468826293945,19350,2339,17011,17011,0,9,2490000.0
2490,2490999,21.857595729023306,37.79872876728896,0.03895491247617511,378.1838228702545,162.22274661064148,682.2143669128418,19381,2340,17041,17041,0,9,2491000.0
2491,2491999,21.855582753380077,37.79710044723789,0.0389566107620779,378.3293023109436,162.28674268722534,682.3995323181152,19381,2340,17041,17041,0,9,2492000.0
2492,2492999,21.85390489444205,37.79416338157496,0.03895227615557573,378.4585921764374,162.35196161270142,682.5586776733398,19381,2340,17041,17041,0,9,2493000.0
2493,2493999,21.852147803699904,37.791274363287094,0.03894649067645872,378.62577056884766,162.41594696044922,682.662410736084,19384,2341,17043,17043,0,9,2494000.0
2494,2494999,21.85023151276173,37.78744191605856,0.03894308594520657,378.75593185424805,162.47981476783752,682.8462524414062,19384,2341,17043,17043,0,9,2495000.0
2495,2495999,21.848968547337027,37.7865174581904,0.03893264486914805,378.8910071849823,162.5438904762268,682.9616889953613,19384,2341,17043,17043,0,9,2496000.0
2496,2496999,21.846909590566288,37.78160763744262,0.03892703391256502,379.0308208465576,162.6074583530426,683.0508270263672,19384,2341,17043,17043,0,9,2497000.0
2497,2497999,21.845427313831276,37.78220833600937,0.0389181864726631,379.2034134864807,162.67124223709106,683.1461029052734,19389,2342,17047,17047,0,9,2498000.0
2498,2498999,21.84405405286956,37.778889843266526,0.03891473626848252,379.33549523353577,162.735369682312,683.2434844970703,19389,2342,17047,17047,0,9,2499000.0
2499,2499999,21.842537972373,37.7749229246606,0.03891484529132638,379.4555151462555,162.79995918273926,683.3690032958984,19389,2342,17047,17047,0,9,2500000.0
2500,2500999,21.84169974537866,37.77331036816474,0.03890512188038342,379.5903904438019,162.8634524345398,683.4733657836914,19389,2342,17047,17047,0,9,2501000.0
2501,2501999,21.840528201690653,37.769413322048074,0.038896360512154615,379.70562624931335,162.92677450180054,683.5711975097656,19389,2342,17047,17047,0,9,2502000.0
2502,2502999,21.839471536913848,37.76568342803015,0.03888746786697572,379.9600167274475,162.99135732650757,683.5909118652344,19425,2345,17080,17080,0,9,2503000.0
2503,2503999,21.83882469030239,37.7621671451461,0.03888164983788467,380.1327950954437,163.05576038360596,683.7027053833008,19431,2346,17085,17085,0,9,2504000.0
2504,2504999,21.837568519223,37.75794051152429,0.038878780094453,380.3429527282715,163.11979842185974,683.7674331665039,19437,2348,17089,17089,0,9,2505000.0
2505,2505999,21.83654643363844,37.75410859467751,0.03887031433714572,380.46754145622253,163.18488121032715,683.9809074401855,19438,2348,17090,17090,0,9,2506000.0
2506,2506999,21.835555624495726,37.75016236183113,0.038861512683886046,380.5858528614044,163.24826312065125,684.1389427185059,19438,2348,17090,17090,0,9,2507000.0
2507,2507999,21.83339743000269,37.74586171130205,0.03885475096118729,380.72953724861145,163.31239485740662,684.4497222900391,19443,2348,17095,17095,0,9,2508000.0
2508,2508999,21.829698658379364,37.73978707960416,0.03888352970620779,380.85385036468506,163.37667417526245,684.9649047851562,19448,2348,17100,17100,0,9,2509000.0
2509,2509999,21.82663719723662,37.73567123678776,0.03891796765018174,380.98278737068176,163.44070672988892,685.234920501709,19448,2348,17100,17100,0,9,2510000.0
2510,2510999,21.82361897510242,37.73134628430371,0.03895114884043116,381.1149458885193,163.50506067276,685.4733734130859,19449,2348,17101,17101,0,9,2511000.0
2511,2511999,21.821130067128205,37.73056627248522,0.038970493992772415,381.2409210205078,163.57019090652466,685.7318420410156,19450,2348,17102,17102,0,9,2512000.0
2512,2512999,21.817755429780124,37.72521536053739,0.03900056756505732,381.4182424545288,163.63489723205566,685.9094505310059,19465,2349,17116,17116,0,9,2513000.0
2513,2513999,21.81501830826189,37.72112264599411,0.039025158819936734,381.5593023300171,163.69943022727966,686.0886573791504,19465,2349,17116,17116,0,9,2514000.0
2514,2514999,21.811599443403672,37.71553814057113,0.0390472504601318,381.7369978427887,163.76384329795837,686.2298355102539,19475,2350,17125,17125,0,9,2515000.0
2515,2515999,21.808277530792118,37.71162731145541,0.03907259604493907,381.9048717021942,163.82845973968506,686.4120445251465,19479,2351,17128,17128,0,9,2516000.0
2516,2516999,21.80513384644508,37.706190827449554,0.039091712116537614,382.0820746421814,163.89283990859985,686.5102462768555,19482,2352,17130,17130,0,9,2517000.0
2517,2517999,21.80277321056206,37.70167083261457,0.039105705031247884,382.249294757843,163.9570438861847,686.5626945495605,19487,2353,17134,17134,0,9,2518000.0
2518,2518999,21.80017973779418,37.69741755569798,0.039119226837946,382.3762249946594,164.02118587493896,686.7409934997559,19487,2353,17134,17134,0,9,2519000.0
2519,2519999,21.797658371661118,37.69229889340812,0.03913104902811959,382.5079674720764,164.08506894111633,686.8670234680176,19487,2353,17134,17134,0,9,2520000.0
2520,2520999,21.794825363324197,37.68693235760286,0.03914514931060886,382.72638845443726,164.14905667304993,686.8861503601074,19496,2355,17141,17141,0,9,2521000.0
2521,2521999,21.79235758948348,37.68232282391997,0.039155680489010525,382.85388946533203,164.21413683891296,687.0292091369629,19496,2355,17141,17141,0,9,2522000.0
2522,2522999,21.790318173094093,37.67803988586593,0.03916269350139068,383.0278911590576,164.2787790298462,687.1891975402832,19510,2356,17154,17154,0,9,2523000.0
2523,2523999,21.788643209413596,37.67451481478226,0.03916784260882433,383.1938672065735,164.34238839149475,687.2918319702148,19514,2357,17157,17157,0,9,2524000.0
2524,2524999,21.787083843844538,37.67031345084749,0.039173894100938744,383.37671399116516,164.4065237045288,687.3734016418457,19517,2358,17159,17159,0,9,2525000.0
2525,2525999,21.78534205482591,37.66624697621778,0.03917365988837351,383.5547242164612,164.4703094959259,687.5060386657715,19520,2359,17161,17161,0,9,2526000.0
2526,2526999,21.783264080620153,37.66178398988781,0.03917843761535156,383.6800765991211,164.53486680984497,687.6824340820312,19521,2359,17162,17162,0,9,2527000.0
2527,2527999,21.78159694186882,37.65803847997907,0.03915784243098719,383.845773935318,164.59905862808228,687.8256340026855,19523,2360,17163,17163,0,9,2528000.0
2528,2528999,21.77873082146509,37.65318296872599,0.039182432404477496,383.9791567325592,164.6636257171631,688.4072113037109,19539,2360,17179,17179,0,9,2529000.0
2529,2529999,21.775433316571174,37.64943649421119,0.039208295264772874,384.11150765419006,164.72817945480347,688.7401542663574,19542,2360,17182,17182,0,9,2530000.0
2530,2530999,21.772329345356948,37.64568937205887,0.03918143470423796,384.28065371513367,164.79290986061096,688.9212608337402,19557,2361,17196,17196,0,9,2531000.0
2531,2531999,21.769622285881436,37.64470277922516,0.039192723015460174,384.45261120796204,164.85781836509705,689.1585273742676,19567,2362,17205,17205,0,9,2532000.0
2532,2532999,21.76652859003598,37.64009944678899,0.039206937537453634,384.576434135437,164.92210459709167,689.3618240356445,19567,2362,17205,17205,0,9,2533000.0
2533,2533999,21.76430145851468,37.6362371036471,0.039228421433215366,384.75475573539734,164.98704195022583,689.553050994873,19570,2363,17207,17207,0,9,2534000.0
2534,2534999,21.761616642915964,37.63125704385318,0.03924469285242982,384.88082551956177,165.0513985157013,689.7382736206055,19570,2363,17207,17207,0,9,2535000.0
2535,2535999,21.758553876209803,37.62614477980398,0.03926222706823457,385.0499310493469,165.11656141281128,689.933277130127,19587,2364,17223,17223,0,9,2536000.0
2536,2536999,21.756288742951167,37.62219385133003,0.039275479436446936,385.1797044277191,165.1800525188446,690.0948104858398,19587,2364,17223,17223,0,9,2537000.0
2537,2537999,21.753558878081606,37.617032108799414,0.0392865738001128,385.3039128780365,165.24382281303406,690.300048828125,19588,2364,17224,17224,0,9,2538000.0
2538,2538999,21.751300593672177,37.612877843762476,0.03929092418882685,385.42960381507874,165.3077356815338,690.454216003418,19588,2364,17224,17224,0,9,2539000.0
2539,2539999,21.74886364929834,37.60799155427095,0.03929856420297173,385.60452246665955,165.3730320930481,690.5455360412598,19592,2365,17227,17227,0,9,2540000.0
2540,2540999,21.746547888755533,37.60368066316562,0.03930713351570014,385.73336577415466,165.43757510185242,690.692554473877,19592,2365,17227,17227,0,9,2541000.0
2541,2541999,21.74477924973585,37.600311869173474,0.03930691448496848,385.9136576652527,165.5023856163025,690.7817268371582,19596,2366,17230,17230,0,9,2542000.0
2542,2542999,21.744561725099206,37.602918115068256,0.039309104052092536,386.04094767570496,165.56635117530823,690.9751663208008,19598,2366,17232,17232,0,9,2543000.0
2543,2543999,21.744866120459168,37.603051840177244,0.0393266519939639,386.2184464931488,165.63102960586548,691.1276702880859,19603,2367,17236,17236,0,9,2544000.0
2544,2544999,21.745158873693885,37.60354869311256,0.039328825862615546,386.394145488739,165.69625186920166,691.273136138916,19635,2368,17267,17267,0,9,2545000.0
2545,2545999,21.746148376468025,37.60734945127374,0.03932890082526819,386.5239522457123,165.76008415222168,691.445613861084,19636,2368,17268,17268,0,9,2546000.0
2546,2546999,21.747165624076253,37.60851438449789,0.0393158785919816,386.7312157154083,165.82441878318787,691.6552543640137,19649,2370,17279,17279,0,9,2547000.0
2547,2547999,21.74674657311111,37.60605265545971,0.03930785057093511,386.8963620662689,165.8884711265564,691.8957176208496,19652,2371,17281,17281,0,9,2548000.0
2548,2548999,21.74548886933903,37.60330953298243,0.039303923848941436,387.06040358543396,165.9531602859497,692.0749740600586,19654,2372,17282,17282,0,9,2549000.0
2549,2549999,21.74222668737187,37.60015895450528,0.039324528640922285,387.19422578811646,166.0173270702362,692.6859245300293,19663,2372,17291,17291,0,9,2550000.0
2550,2550999,21.73935284098644,37.597159899349315,0.03934342550329262,387.32707691192627,166.08172750473022,693.1267890930176,19668,2372,17296,17296,0,9,2551000.0
2551,2551999,21.736253613517313,37.59229870914965,0.03936716928541417,387.504745721817,166.14631915092468,693.2916107177734,19670,2373,17297,17297,0,9,2552000.0
2552,2552999,21.73328133961088,37.58745330599614,0.03938407311878822,387.6287577152252,166.21041655540466,693.5592651367188,19671,2373,17298,17298,0,9,2553000.0
2553,2553999,21.731461519691265,37.58554264413161,0.03937947355567151,387.75815653800964,166.27571058273315,693.8259201049805,19671,2373,17298,17298,0,9,2554000.0
2554,2554999,21.729351939744426,37.5820357367083,0.03938508261431417,387.88447666168213,166.34018540382385,693.9783935546875,19671,2373,17298,17298,0,9,2555000.0
2555,2555999,21.72766519736986,37.58125926330566,0.0393772317970259,388.0941970348358,166.40486931800842,694.0972061157227,19687,2375,17312,17312,0,9,2556000.0
2556,2556999,21.72653509467145,37.586878167524,0.03935884415121371,388.27478194236755,166.4734103679657,694.3212928771973,19690,2376,17314,17314,0,9,2557000.0
2557,2557999,21.725481136831363,37.58571111302253,0.039357707582075796,388.45004415512085,166.53760266304016,694.5101776123047,19693,2377,17316,17316,0,9,2558000.0
2558,2558999,21.72384719823078,37.58299828270817,0.03937232226361376,388.62382984161377,166.6016788482666,694.709716796875,19699,2378,17321,17321,0,9,2559000.0
2559,2559999,21.723775986749665,37.58381449712321,0.039361524951136095,388.7439377307892,166.66577553749084,694.9818572998047,19700,2378,17322,17322,0,9,2560000.0
2560,2560999,21.72319208136854,37.582934696588694,0.03936415533955773,388.8638958930969,166.7292594909668,695.1415176391602,19700,2378,17322,17322,0,9,2561000.0
2561,2561999,21.724056328765702,37.58514361286242,0.0393655141863557,388.99445700645447,166.7935230731964,695.3777809143066,19701,2378,17323,17323,0,9,2562000.0
2562,2562999,21.72580526496703,37.58999787118026,0.03938702421830731,389.13011407852173,166.85694098472595,695.5490074157715,19701,2378,17323,17323,0,9,2563000.0
2563,2563999,21.727729318777705,37.59272133298851,0.0393838120211204,389.26505517959595,166.92139077186584,695.7084732055664,19701,2378,17323,17323,0,9,2564000.0
2564,2564999,21.730653221983577,37.59810546017847,0.039398605231851236,389.4079258441925,166.98961997032166,695.8793716430664,19701,2378,17323,17323,0,9,2565000.0
2565,2565999,21.734482423506357,37.60465444769521,0.03939266107483963,389.5380640029907,167.05972456932068,696.0448989868164,19702,2378,17324,17324,0,9,2566000.0
2566,2566999,21.739821743876913,37.61517482712473,0.039375425515276286,389.66669034957886,167.1236138343811,696.2216682434082,19704,2378,17326,17326,0,9,2567000.0
2567,2567999,21.743627338818968,37.62423161733239,0.03934790207059102,389.8376052379608,167.1872627735138,696.3591575622559,19706,2379,17327,17327,0,9,2568000.0
2568,2568999,21.74880739799388,37.634188373063296,0.039338620700759885,389.9569957256317,167.25147080421448,696.5598182678223,19707,2379,17328,17328,0,9,2569000.0
2569,2569999,21.750005789722305,37.6397878433834,0.039327673725586654,390.0743713378906,167.31463718414307,696.9152641296387,19714,2379,17335,17335,0,9,2570000.0
2570,2570999,21.747519626258125,37.63634292260943,0.03932350503994386,390.2489709854126,167.37879180908203,697.2097930908203,19731,2380,17351,17351,0,9,2571000.0
2571,2571999,21.745182671199306,37.63340708692685,0.039330847010659475,390.3979027271271,167.44419836997986,697.4474983215332,19733,2380,17353,17353,0,9,2572000.0
2572,2572999,21.7434639339748,37.63337431042203,0.03933306751380561,390.5306122303009,167.50830817222595,697.6601905822754,19733,2380,17353,17353,0,9,2573000.0
2573,2573999,21.741683864005452,37.62992803689939,0.03933287515256678,390.6981678009033,167.5724241733551,697.802188873291,19737,2381,17356,17356,0,9,2574000.0
2574,2574999,21.74009461650448,37.62706227116683,0.03932214386655908,390.8618896007538,167.63637471199036,697.9630279541016,19740,2382,17358,17358,0,9,2575000.0
2575,2575999,21.738487770407286,37.62378758040953,0.03931736759918314,390.9877257347107,167.7001473903656,698.1325950622559,19740,2382,17358,17358,0,9,2576000.0
2576,2576999,21.7370236201881,37.62015091504441,0.039312349634110455,391.12909984588623,167.77139115333557,698.2897186279297,19740,2382,17358,17358,0,9,2577000.0
2577,2577999,21.73603403629571,37.61717116482286,0.039309186655529404,391.2946755886078,167.83530473709106,698.4329719543457,19744,2383,17361,17361,0,9,2578000.0
2578,2578999,21.73519880908444,37.61583850384817,0.03929531523623997,391.4320330619812,167.8989336490631,698.5829658508301,19745,2383,17362,17362,0,9,2579000.0
2579,2579999,21.734049825698175,37.61259331576386,0.03928626395803192,391.5610671043396,167.96320223808289,698.6958618164062,19745,2383,17362,17362,0,9,2580000.0
2580,2580999,21.73380162478556,37.61115634593685,0.039278332741020994,391.69404649734497,168.02668404579163,698.8610534667969,19745,2383,17362,17362,0,9,2581000.0
2581,2581999,21.73371568258077,37.609904872327306,0.03927452057065017,391.82000064849854,168.0899999141693,698.9507026672363,19745,2383,17362,17362,0,9,2582000.0
2582,2582999,21.733575791312447,37.608801081500296,0.03929240083549124,391.94244933128357,168.1540596485138,699.0763664245605,19745,2383,17362,17362,0,9,2583000.0
2583,2583999,21.73406078534031,37.60910107420796,0.039294408754502075,392.07954692840576,168.21805262565613,699.2112922668457,19745,2383,17362,17362,0,9,2584000.0
2584,2584999,21.73479600257777,37.609564761332194,0.03929864491236168,392.2636535167694,168.28245377540588,699.310115814209,19750,2384,17366,17366,0,9,2585000.0
2585,2585999,21.735924934423743,37.60982987303971,0.039281118506534596,392.43498063087463,168.34619331359863,699.3428802490234,19754,2385,17369,17369,0,9,2586000.0
2586,2586999,21.737936146745454,37.61103670095284,0.03926881907529978,392.56076288223267,168.40977096557617,699.4714698791504,19754,2385,17369,17369,0,9,2587000.0
2587,2587999,21.7394254757395,37.61168740471857,0.03926434505329324,392.70491075515747,168.47488021850586,699.6166076660156,19755,2385,17370,17370,0,9,2588000.0
2588,2588999,21.742051355893288,37.614199113921856,0.039242487331776266,392.8281207084656,168.53845739364624,699.7187347412109,19755,2385,17370,17370,0,9,2589000.0
2589,2589999,21.745077950802557,37.61940627558924,0.03922106249128876,392.99530935287476,168.60152792930603,699.7824325561523,19757,2386,17371,17371,0,9,2590000.0
2590,2590999,21.744894822400326,37.61756768218705,0.0392044905625597,393.16685700416565,168.6656527519226,700.3383140563965,19807,2387,17420,17420,0,9,2591000.0
2591,2591999,21.74310546103834,37.615373358860126,0.039192290487731984,393.31833696365356,168.7357738018036,700.697395324707,19813,2387,17426,17426,0,9,2592000.0
2592,2592999,21.741352756943282,37.61265457310528,0.03919171053384718,393.4421212673187,168.79957056045532,700.8737411499023,19813,2387,17426,17426,0,9,2593000.0
2593,2593999,21.73950293382328,37.608557390418696,0.03918404894251115,393.56902050971985,168.8640697002411,701.112003326416,19815,2387,17428,17428,0,9,2594000.0
2594,2594999,21.73764301421955,37.604157431874754,0.03917532523607825,393.6946794986725,168.92783093452454,701.2976226806641,19815,2387,17428,17428,0,9,2595000.0
2595,2595999,21.7361033981367,37.60007470796909,0.03916570996772695,393.8272888660431,168.99241495132446,701.4611740112305,19815,2387,17428,17428,0,9,2596000.0
2596,2596999,21.73441543552267,37.59570438477572,0.039145654672140595,393.9548602104187,169.05657267570496,701.588077545166,19815,2387,17428,17428,0,9,2597000.0
2597,2597999,21.73323273093262,37.59206177877223,0.039122393696212066,394.119544506073,169.12065482139587,701.7351570129395,19822,2388,17434,17434,0,9,2598000.0
2598,2598999,21.732346042694648,37.588798102915604,0.03910129937727869,394.34692311286926,169.18502521514893,701.7978324890137,19828,2390,17438,17438,0,9,2599000.0
2599,2599999,21.731330894094178,37.58475597122714,0.03908315872665291,394.46687388420105,169.24934816360474,701.9034004211426,19828,2390,17438,17438,0,9,2600000.0
2600,2600999,21.730853862641705,37.582030380208245,0.039055879022613094,394.5998282432556,169.31350445747375,702.0536727905273,19828,2390,17438,17438,0,9,2601000.0
2601,2601999,21.73083862372921,37.57936224819922,0.03902498345969274,394.7396767139435,169.38577342033386,702.1836700439453,19828,2390,17438,17438,0,9,2602000.0
2602,2602999,21.730914126484063,37.57754727520905,0.03899787970248647,394.8629369735718,169.44951677322388,702.3305320739746,19829,2390,17439,17439,0,9,2603000.0
2603,2603999,21.73136376225666,37.57557249031035,0.038964048572076804,394.9840269088745,169.51321506500244,702.4578628540039,19829,2390,17439,17439,0,9,2604000.0
2604,2604999,21.732776578012263,37.57488410512524,0.03891492441759714,395.1042380332947,169.57745027542114,702.6168746948242,19829,2390,17439,17439,0,9,2605000.0
2605,2605999,21.73475798183974,37.574956507147895,0.038873971861657974,395.22513031959534,169.64105010032654,702.791934967041,19831,2390,17441,17441,0,9,2606000.0
2606,2606999,21.735709224069513,37.5745398228825,0.038837020231737074,395.35811591148376,169.7051043510437,702.9772033691406,19832,2390,17442,17442,0,9,2607000.0
2607,2607999,21.737130334737174,37.573682030150906,0.03881114693364163,395.48456931114197,169.76941895484924,703.1471977233887,19833,2390,17443,17443,0,9,2608000.0
2608,2608999,21.73540464801303,37.57012595002554,0.03880678886720301,395.66615891456604,169.8345091342926,703.6808891296387,19863,2391,17472,17472,0,9,2609000.0
2609,2609999,21.73292275102924,37.56567159368378,0.03881750817092822,395.8306710720062,169.89891242980957,704.0822067260742,19885,2392,17493,17493,0,9,2610000.0
2610,2610999,21.730749118125605,37.56205408745643,0.038823497399104845,395.9565176963806,169.9644901752472,704.4316253662109,19888,2392,17496,17496,0,9,2611000.0
2611,2611999,21.727881221130417,37.55676714342151,0.0388445430065697,396.1250309944153,170.02891969680786,704.5643119812012,19890,2393,17497,17497,0,9,2612000.0
2612,2612999,21.725402136847904,37.55238067361827,0.03885939339889466,396.33754897117615,170.09383010864258,704.8943634033203,19915,2395,17520,17520,0,9,2613000.0
2613,2613999,21.722888313244965,37.54733942671206,0.038871240161647,396.46668219566345,170.15912008285522,705.146541595459,19917,2395,17522,17522,0,9,2614000.0
2614,2614999,21.720159365117407,37.54296456862825,0.03888376319276854,396.6382586956024,170.22337174415588,705.3178062438965,19921,2396,17525,17525,0,9,2615000.0
2615,2615999,21.717548217101058,37.53816769114899,0.038897095299502804,396.8605852127075,170.28943967819214,705.4031295776367,19941,2398,17543,17543,0,9,2616000.0
2616,2616999,21.71501013189187,37.53297218378876,0.03890568228868674,397.0016098022461,170.3537402153015,705.6750717163086,19944,2398,17546,17546,0,9,2617000.0
2617,2617999,21.7127001292487,37.52866352836089,0.03890979558529706,397.16953778266907,170.4186818599701,705.8541145324707,19949,2399,17550,17550,0,9,2618000.0
2618,2618999,21.710737805406833,37.52438427230467,0.03889754757841868,397.33543372154236,170.4830813407898,706.0808143615723,19952,2400,17552,17552,0,9,2619000.0
2619,2619999,21.70963767892371,37.52180423316419,0.03888469182939214,397.4564599990845,170.54695963859558,706.3487854003906,19954,2400,17554,17554,0,9,2620000.0
2620,2620999,21.708745491231706,37.51961124814468,0.03888519832907833,397.62224864959717,170.6111843585968,706.4686470031738,19958,2401,17557,17557,0,9,2621000.0
2621,2621999,21.708274079936114,37.51796274500486,0.038880026940703694,397.88169598579407,170.6757528781891,706.6546325683594,19996,2404,17592,17592,0,9,2622000.0
2622,2622999,21.70980845765914,37.52313490825392,0.03886804100532415,398.10277676582336,170.74112153053284,706.8912010192871,20004,2406,17598,17598,0,9,2623000.0
2623,2623999,21.710851995067234,37.52288986844246,0.03885557077789914,398.2732779979706,170.8060863018036,707.1290588378906,20010,2407,17603,17603,0,9,2624000.0
2624,2624999,21.712223588766474,37.52337153322932,0.03883286125471097,398.48525524139404,170.87084889411926,707.2505798339844,20017,2409,17608,17608,0,9,2625000.0
2625,2625999,21.712985649630976,37.52307808310696,0.038818905304006,398.6171839237213,170.93480515480042,707.5964202880859,20020,2409,17611,17611,0,9,2626000.0
2626,2626999,21.71319994928765,37.521020047238665,0.038801032223014675,398.7417502403259,171.0003147125244,707.8785705566406,20023,2409,17614,17614,0,9,2627000.0
2627,2627999,21.7121117115527,37.51759658863852,0.03878875604551291,398.91562509536743,171.064120054245,708.0696144104004,20028,2410,17618,17618,0,9,2628000.0
2628,2628999,21.709775634887393,37.51281714850813,0.03876962495603298,399.04848647117615,171.1285276412964,708.868839263916,20048,2410,17638,17638,0,9,2629000.0
2629,2629999,21.706949548573863,37.50994346569835,0.03875445511080888,399.17011165618896,171.19355392456055,709.3587532043457,20055,2410,17645,17645,0,9,2630000.0
2630,2630999,21.704056908111955,37.50499694214025,0.038752561466211755,399.3439111709595,171.258141040802,709.531795501709,20061,2411,17650,17650,0,9,2631000.0
2631,2631999,21.701698926252963,37.500721997160866,0.038750188590383816,399.56261444091797,171.32606673240662,709.714672088623,20068,2413,17655,17655,0,9,2632000.0
2632,2632999,21.69936636030747,37.49614370357058,0.03873868821615056,399.69212317466736,171.39092659950256,709.9448013305664,20069,2413,17656,17656,0,9,2633000.0
2633,2633999,21.69724271243426,37.49236738128273,0.03872648831899794,399.82469940185547,171.4584379196167,710.116455078125,20069,2413,17656,17656,0,9,2634000.0
2634,2634999,21.69476783429111,37.48810224564312,0.03871276001509216,399.951459646225,171.5281364917755,710.2936210632324,20070,2413,17657,17657,0,9,2635000.0
2635,2635999,21.692334846859314,37.483234086477104,0.03870280715912777,400.0751438140869,171.59202337265015,710.4825782775879,20072,2413,17659,17659,0,9,2636000.0
2636,2636999,21.69046463624116,37.48123085267645,0.038679880411295,400.29766726493835,171.65644598007202,710.646541595459,20105,2415,17690,17690,0,9,2637000.0
2637,2637999,21.68854723425541,37.477263468174485,0.038664436416682824,400.4261803627014,171.72043204307556,710.8928718566895,20106,2415,17691,17691,0,9,2638000.0
2638,2638999,21.686566548863244,37.47298845516567,0.03864042506724075,400.59714460372925,171.78498601913452,710.9981880187988,20111,2416,17695,17695,0,9,2639000.0
2639,2639999,21.684942929142014,37.470276385740085,0.03861663041941832,400.71666836738586,171.84862184524536,711.1383590698242,20112,2416,17696,17696,0,9,2640000.0
2640,2640999,21.683248693544297,37.46616321756573,0.03860900218454677,400.8890857696533,171.9129548072815,711.2870559692383,20116,2417,17699,17699,0,9,2641000.0
2641,2641999,21.682005572575303,37.46301748939044,0.038591995537720414,401.02540612220764,171.97808980941772,711.4212875366211,20116,2417,17699,17699,0,9,2642000.0
2642,2642999,21.6814461767728,37.46073819701154,0.03856978663677646,401.21498560905457,172.0434935092926,711.5446624755859,20121,2418,17703,17703,0,9,2643000.0
2643,2643999,21.68100386963053,37.45806804247519,0.03855553601555273,401.33563899993896,172.1071994304657,711.7254409790039,20121,2418,17703,17703,0,9,2644000.0
2644,2644999,21.68072030661457,37.4558426312315,0.038553653696874246,401.49842143058777,172.17122650146484,711.8349075317383,20124,2419,17705,17705,0,9,2645000.0
2645,2645999,21.68253112249559,37.45664230331522,0.038545240052556884,401.6762661933899,172.23519587516785,711.9403877258301,20126,2420,17706,17706,0,9,2646000.0
2646,2646999,21.683498823163834,37.45547374638758,0.03854828847845515,401.89598774909973,172.2994623184204,712.0702896118164,20131,2422,17709,17709,0,9,2647000.0
2647,2647999,21.685160805659326,37.45642244623501,0.0385574331066213,402.1181831359863,172.36481976509094,712.1360778808594,20149,2424,17725,17725,0,9,2648000.0
2648,2648999,21.68536943278668,37.456015481397806,0.038557034139862445,402.3401312828064,172.429673910141,712.3541603088379,20169,2426,17743,17743,0,9,2649000.0
2649,2649999,21.68450089360332,37.45358592846677,0.03848528329350065,402.47496914863586,172.49565029144287,713.0072898864746,20183,2426,17757,17757,0,9,2650000.0
2650,2650999,21.6827868568968,37.450226918539926,0.038434174475987404,402.685017824173,172.56205534934998,713.3486480712891,20191,2428,17763,17763,0,9,2651000.0
2651,2651999,21.68124181290194,37.44651850790197,0.03838410993001229,402.85244607925415,172.6270670890808,713.568790435791,20194,2429,17765,17765,0,9,2652000.0
2652,2652999,21.680152420471057,37.44357791425618,0.038334490785229214,402.98630237579346,172.69155526161194,713.8043746948242,20195,2429,17766,17766,0,9,2653000.0
2653,2653999,21.679328898442133,37.44111759362027,0.03828116742073051,403.1079366207123,172.7560269832611,713.9883499145508,20195,2429,17766,17766,0,9,2654000.0
2654,2654999,21.67883970801744,37.43914862439331,0.03822159919662149,403.274475812912,172.82136249542236,714.1236343383789,20198,2430,17768,17768,0,9,2655000.0
2655,2655999,21.678108540636835,37.4360760269108,0.03818885360559432,403.40291023254395,172.8853690624237,714.2935256958008,20198,2430,17768,17768,0,9,2656000.0
2656,2656999,21.677637568283565,37.43307604766141,0.0381427416577369,403.6399531364441,172.95761251449585,714.319580078125,20208,2432,17776,17776,0,9,2657000.0
2657,2657999,21.677694112476118,37.431215037205,0.03809982301476755,403.8146553039551,173.02233004570007,714.5488204956055,20213,2433,17780,17780,0,9,2658000.0
2658,2658999,21.678467021832844,37.43043681218131,0.03805731140015278,403.9462625980377,173.08800625801086,714.8025894165039,20215,2433,17782,17782,0,9,2659000.0
2659,2659999,21.680298939441673,37.4322515509131,0.03806607011781982,404.11747694015503,173.15226912498474,714.932373046875,20220,2434,17786,17786,0,9,2660000.0
2660,2660999,21.683053916694462,37.43532213579739,0.03808574878151494,404.3268711566925,173.2164146900177,714.9651832580566,20226,2436,17790,17790,0,9,2661000.0
2661,2661999,21.68601351602489,37.43922576637106,0.038126214316299256,404.50004148483276,173.28141403198242,715.1597518920898,20229,2437,17792,17792,0,9,2662000.0
2662,2662999,21.690616581854925,37.44995754827266,0.03818516166810493,404.66755986213684,173.34676933288574,715.3317604064941,20234,2438,17796,17796,0,9,2663000.0
2663,2663999,21.69613630330367,37.464366071184166,0.03824863302170389,404.87993454933167,173.4114944934845,715.4371528625488,20244,2440,17804,17804,0,9,2664000.0
2664,2664999,21.701225624082145,37.47517004779647,0.038346857383801725,405.0033280849457,173.4755928516388,715.6115379333496,20244,2440,17804,17804,0,9,2665000.0
2665,2665999,21.705460853404105,37.47938689709059,0.03844658612477425,405.1372401714325,173.54019117355347,715.8113441467285,20245,2440,17805,17805,0,9,2666000.0
2666,2666999,21.711816904968224,37.48968468164083,0.03856331704331961,405.30686950683594,173.60534024238586,716.0107002258301,20255,2441,17814,17814,0,9,2667000.0
2667,2667999,21.715871229563326,37.4932140465655,0.03864242601568202,405.4693534374237,173.66918969154358,716.167610168457,20258,2442,17816,17816,0,9,2668000.0
2668,2668999,21.719564802924083,37.49854573998389,0.03864370659473837,405.5930299758911,173.73332953453064,716.4279365539551,20260,2442,17818,17818,0,9,2669000.0
2669,2669999,21.718907349748427,37.498883532400164,0.03858639677125586,405.77197003364563,173.7978036403656,717.0229797363281,20278,2443,17835,17835,0,9,2670000.0
2670,2670999,21.718000432172893,37.49904972159399,0.038564299160840365,405.89420533180237,173.86235857009888,717.3848686218262,20281,2443,17838,17838,0,9,2671000.0
2671,2671999,21.71617195139631,37.495503056876125,0.038548809197007095,406.07719826698303,173.92748475074768,717.5467910766602,20283,2444,17839,17839,0,9,2672000.0
2672,2672999,21.714738038998338,37.492752959585275,0.03851447042200129,406.24845123291016,173.99174857139587,717.7256240844727,20286,2445,17841,17841,0,9,2673000.0
2673,2673999,21.713675147314117,37.4901960821645,0.03846659196596891,406.39093685150146,174.06534028053284,717.9768295288086,20286,2445,17841,17841,0,9,2674000.0
2674,2674999,21.71206694249635,37.4864866659179,0.03843593435318138,406.60521364212036,174.12986040115356,718.0560722351074,20295,2447,17848,17848,0,9,2675000.0
2675,2675999,21.710425617906537,37.482387138579746,0.03840517452342662,406.7280216217041,174.19411635398865,718.3161506652832,20298,2447,17851,17851,0,9,2676000.0
2676,2676999,21.709670069283117,37.4803269254252,0.038382523955294845,406.90330028533936,174.25949025154114,718.4792251586914,20314,2448,17866,17866,0,9,2677000.0
2677,2677999,21.708688058569837,37.4777326956231,0.03836359734252337,407.06633973121643,174.32345247268677,718.5790634155273,20316,2449,17867,17867,0,9,2678000.0
2678,2678999,21.708413521345555,37.47729368999037,0.038360155935050266,407.18925762176514,174.38751077651978,718.7314758300781,20316,2449,17867,17867,0,9,2679000.0
2679,2679999,21.709610615612643,37.48310240073253,0.03838243854327972,407.4534361362457,174.45237827301025,718.6997375488281,20336,2452,17884,17884,0,9,2680000.0
2680,2680999,21.712371987280317,37.49105615684062,0.038440019995745756,407.6478364467621,174.5174744129181,718.9451179504395,20341,2453,17888,17888,0,9,2681000.0
2681,2681999,21.715307686374793,37.49827194971014,0.03850579451736358,407.830757856369,174.58237099647522,719.1576538085938,20343,2454,17889,17889,0,9,2682000.0
2682,2682999,21.720530256197986,37.51409479709884,0.03863220832495884,408.0526797771454,174.64680767059326,719.283805847168,20347,2456,17891,17891,0,9,2683000.0
2683,2683999,21.725366926562913,37.526317916953595,0.038745790238780664,408.2698838710785,174.71267986297607,719.3387985229492,20354,2458,17896,17896,0,9,2684000.0
2684,2684999,21.731119681891602,37.53859255924068,0.038937148107581976,408.43749928474426,174.77723860740662,719.6396789550781,20356,2459,17897,17897,0,9,2685000.0
2685,2685999,21.738254714139245,37.55417901324238,0.03907985498715105,408.613872051239,174.8447368144989,719.8491172790527,20362,2460,17902,17902,0,9,2686000.0
2686,2686999,21.745779198516605,37.569158775981045,0.03925843691227837,408.83324790000916,174.9103639125824,720.0422172546387,20367,2462,17905,17905,0,9,2687000.0
2687,2687999,21.752259961569585,37.5829820756728,0.03938050849837993,408.9521005153656,174.9740490913391,720.2241325378418,20367,2462,17905,17905,0,9,2688000.0
2688,2688999,21.75813487999424,37.59480974552356,0.03946521020525484,409.11404514312744,175.03801679611206,720.3962020874023,20378,2463,17915,17915,0,9,2689000.0
2689,2689999,21.758845480398193,37.594696698016094,0.039473355865298876,409.28039503097534,175.1024181842804,720.9458084106445,20396,2464,17932,17932,0,9,2690000.0
2690,2690999,21.757492796286453,37.5958991407204,0.0394407981787428,409.40050315856934,175.1666178703308,721.3453063964844,20403,2464,17939,17939,0,9,2691000.0
2691,2691999,21.755686286222303,37.59244595147414,0.03940807964306581,409.52720856666565,175.2311737537384,721.5909576416016,20405,2464,17941,17941,0,9,2692000.0
2692,2692999,21.754312821350403,37.589749891961226,0.03938366414778183,409.6461546421051,175.29501605033875,721.7427558898926,20405,2464,17941,17941,0,9,2693000.0
2693,2693999,21.752471990406498,37.58612573346001,0.03936697951498802,409.7761526107788,175.35908317565918,721.854061126709,20405,2464,17941,17941,0,9,2694000.0
2694,2694999,21.750702586440127,37.58258518680286,0.03933426157894193,409.91562962532043,175.42348337173462,722.0254211425781,20405,2464,17941,17941,0,9,2695000.0
2695,2695999,21.74924825166048,37.58062690985738,0.03932089101185254,410.03835010528564,175.48783493041992,722.1561546325684,20405,2464,17941,17941,0,9,2696000.0
2696,2696999,21.747572168114537,37.577049984586985,0.039295319122670036,410.21995091438293,175.5521800518036,722.2618713378906,20408,2465,17943,17943,0,9,2697000.0
2697,2697999,21.7458504833516,37.57289608364987,0.0392701517514652,410.40071392059326,175.6176540851593,722.3174743652344,20410,2466,17944,17944,0,9,2698000.0
2698,2698999,21.744106024521187,37.56887112866774,0.03924887270678912,410.52835869789124,175.68142890930176,722.4830932617188,20411,2466,17945,17945,0,9,2699000.0
2699,2699999,21.742876824534676,37.56673332131881,0.039224049882756296,410.69321298599243,175.7451331615448,722.5583038330078,20416,2467,17949,17949,0,9,2700000.0
2700,2700999,21.74138788019909,37.56310364851212,0.03922568314266894,410.91085934638977,175.8096957206726,722.6089057922363,20433,2469,17964,17964,0,9,2701000.0
2701,2701999,21.740110538559936,37.559671562864956,0.03920776546553406,411.0835542678833,175.87418389320374,722.714469909668,20437,2470,17967,17967,0,9,2702000.0
2702,2702999,21.738652177621546,37.556211282767684,0.03919955390833385,411.22037959098816,175.93817782402039,722.8306579589844,20437,2470,17967,17967,0,9,2703000.0
2703,2703999,21.738064230802284,37.558134542246535,0.03918106839354141,411.3492531776428,176.00224947929382,723.0176277160645,20438,2470,17968,17968,0,9,2704000.0
2704,2704999,21.73751794216907,37.55576184775828,0.03915828347402217,411.47406911849976,176.06626892089844,723.1800880432129,20439,2470,17969,17969,0,9,2705000.0
2705,2705999,21.736466147543975,37.55246977357406,0.03914123262935887,411.60072922706604,176.12977004051208,723.3065528869629,20439,2470,17969,17969,0,9,2706000.0
2706,2706999,21.736202715020838,37.54985929064575,0.03912353318232298,411.8179564476013,176.19453287124634,723.4404525756836,20445,2472,17973,17973,0,9,2707000.0
2707,2707999,21.735821693887566,37.54788418019736,0.03912184661100393,411.9413814544678,176.25939226150513,723.6550445556641,20447,2472,17975,17975,0,9,2708000.0
2708,2708999,21.735052569868273,37.5446295562994,0.03911105324756303,412.07054567337036,176.32342720031738,723.8222579956055,20447,2472,17975,17975,0,9,2709000.0
2709,2709999,21.73398655027371,37.54126850227626,0.039086710385150436,412.20124101638794,176.387859582901,723.9824409484863,20448,2472,17976,17976,0,9,2710000.0
2710,2710999,21.73188813123184,37.536934638903325,0.03907342456796703,412.3822617530823,176.4518346786499,724.3337211608887,20459,2473,17986,17986,0,9,2711000.0
2711,2711999,21.72922076380386,37.53282516807686,0.03906103031007491,412.50197744369507,176.51580142974854,724.6688194274902,20460,2473,17987,17987,0,9,2712000.0
2712,2712999,21.726303544604992,37.52774022197004,0.03905731688768843,412.7137167453766,176.580331325531,724.7446479797363,20465,2475,17990,17990,0,9,2713000.0
2713,2713999,21.72367735253834,37.52316236912492,0.0390641326822585,412.84350085258484,176.6449899673462,724.9148368835449,20465,2475,17990,17990,0,9,2714000.0
2714,2714999,21.72113917809111,37.51915542509955,0.03906787126088984,413.0161120891571,176.70933651924133,725.0356597900391,20477,2476,18001,18001,0,9,2715000.0
2715,2715999,21.718430746484977,37.51460306591407,0.03906372831528271,413.24691891670227,176.7748589515686,725.2310638427734,20510,2478,18032,18032,0,9,2716000.0
2716,2716999,21.716178963812524,37.51216724411739,0.03906222165351925,413.37143874168396,176.8391523361206,725.4487648010254,20510,2478,18032,18032,0,9,2717000.0
2717,2717999,21.714184916385666,37.50847213387881,0.03906358756524819,413.54780077934265,176.90370273590088,725.6666870117188,20512,2479,18033,18033,0,9,2718000.0
2718,2718999,21.71247948702896,37.505182599485146,0.03906766712433829,413.7222125530243,176.96811604499817,725.8440895080566,20514,2480,18034,18034,0,9,2719000.0
2719,2719999,21.710566522306845,37.50156579894976,0.03906898819195803,413.8907902240753,177.03281378746033,726.1280746459961,20522,2481,18041,18041,0,9,2720000.0
2720,2720999,21.708895684307727,37.49789151554307,0.03907071964205244,414.05717277526855,177.09721183776855,726.2854614257812,20524,2482,18042,18042,0,9,2721000.0
2721,2721999,21.707792115726704,37.494968167755815,0.03910169472260716,414.18661761283875,177.1624300479889,726.5104484558105,20524,2482,18042,18042,0,9,2722000.0
2722,2722999,21.707158251231018,37.49371154996898,0.03911926904308749,414.3127031326294,177.2265133857727,726.6440658569336,20524,2482,18042,18042,0,9,2723000.0
2723,2723999,21.706950289746356,37.49202856895881,0.039138591991686456,414.439608335495,177.29123640060425,726.8424835205078,20524,2482,18042,18042,0,9,2724000.0
2724,2724999,21.706927965996066,37.49082978968994,0.03915578562663957,414.5640182495117,177.35553526878357,726.9782333374023,20524,2482,18042,18042,0,9,2725000.0
2725,2725999,21.706969080621054,37.48945747744146,0.03918886506206454,414.75115871429443,177.4204614162445,727.1531524658203,20529,2483,18046,18046,0,9,2726000.0
2726,2726999,21.70721114217904,37.488712729522845,0.03921679801112976,414.9244430065155,177.48535013198853,727.245735168457,20531,2484,18047,18047,0,9,2727000.0
2727,2727999,21.70767064562517,37.488350916389834,0.039233285636753545,415.09575510025024,177.5498435497284,727.3136520385742,20536,2485,18051,18051,0,9,2728000.0
2728,2728999,21.708785755966602,37.48881448654677,0.0392670318896049,415.2232735157013,177.61400723457336,727.4963531494141,20538,2485,18053,18053,0,9,2729000.0
2729,2729999,21.709468490804475,37.488346811246785,0.03929077502070488,415.40025329589844,177.6784427165985,727.6204833984375,20540,2486,18054,18054,0,9,2730000.0
2730,2730999,21.70930495906192,37.48691556910714,0.03931122192102843,415.580867767334,177.74264097213745,727.7248954772949,20555,2487,18068,18068,0,9,2731000.0
2731,2731999,21.707725768406437,37.48417620216171,0.03932378839635542,415.79982566833496,177.80702257156372,727.9915008544922,20567,2489,18078,18078,0,9,2732000.0
2732,2732999,21.70519893210689,37.48064488090571,0.039327662459698653,415.9738688468933,177.87245416641235,728.267993927002,20587,2490,18097,18097,0,9,2733000.0
2733,2733999,21.70323428381256,37.47904857762892,0.039332178253331795,416.1047978401184,177.93667364120483,728.4520797729492,20588,2490,18098,18098,0,9,2734000.0
2734,2734999,21.700677087168593,37.47436112935165,0.03934733355433828,416.24113368988037,178.00174498558044,728.6538238525391,20591,2490,18101,18101,0,9,2735000.0
2735,2735999,21.698516627965613,37.47023593196622,0.039361670703846,416.45857882499695,178.06634664535522,728.713020324707,20595,2492,18103,18103,0,9,2736000.0
2736,2736999,21.69664988550851,37.46695894807849,0.03936586779048801,416.58399748802185,178.1305387020111,728.9682006835938,20596,2492,18104,18104,0,9,2737000.0
2737,2737999,21.69490504698818,37.46368949645477,0.039373672078062194,416.7387089729309,178.19898867607117,729.1360282897949,20596,2492,18104,18104,0,9,2738000.0
2738,2738999,21.69300119046442,37.460278289908445,0.03937455075192231,416.95926237106323,178.26439929008484,729.3285484313965,20608,2494,18114,18114,0,9,2739000.0
2739,2739999,21.69150089711663,37.45724176705692,0.039371524055236584,417.0810079574585,178.32864236831665,729.55615234375,20608,2494,18114,18114,0,9,2740000.0
2740,2740999,21.689827799330814,37.453646753948284,0.03937297705525311,417.2066659927368,178.39278292655945,729.6419067382812,20608,2494,18114,18114,0,9,2741000.0
2741,2741999,21.688385520841813,37.450308126221856,0.03937455820753899,417.3865683078766,178.45723915100098,729.6836166381836,20627,2495,18132,18132,0,9,2742000.0
2742,2742999,21.687112136807528,37.44768110986979,0.039377379763913645,417.55741786956787,178.52185893058777,729.8944549560547,20639,2496,18143,18143,0,9,2743000.0
2743,2743999,21.686524267186726,37.44599200936104,0.03936998659536295,417.728458404541,178.58618831634521,730.0701675415039,20641,2497,18144,18144,0,9,2744000.0
2744,2744999,21.685623663472487,37.44275713113449,0.039371424162504054,417.904545545578,178.6502456665039,730.2482223510742,20643,2498,18145,18145,0,9,2745000.0
2745,2745999,21.685311611790357,37.44111082380005,0.03936627743749754,418.07871437072754,178.71464657783508,730.556339263916,20647,2499,18148,18148,0,9,2746000.0
2746,2746999,21.684713467791347,37.43790548322727,0.039356127283091236,418.2548682689667,178.77878880500793,730.7416534423828,20653,2500,18153,18153,0,9,2747000.0
2747,2747999,21.683989386579324,37.4345026147874,0.03935051244577792,418.3913502693176,178.85186576843262,731.0146903991699,20654,2500,18154,18154,0,9,2748000.0
2748,2748999,21.682845083805162,37.431043471036006,0.03934806844917271,418.5692300796509,178.91709733009338,731.2704429626465,20658,2501,18157,18157,0,9,2749000.0
2749,2749999,21.68040642797152,37.42721320078891,0.03935679617120358,418.7419481277466,178.98118424415588,731.6581115722656,20668,2502,18166,18166,0,9,2750000.0
2750,2750999,21.676870897154963,37.42243721003921,0.0393909977171375,418.96434140205383,179.0460946559906,731.8856658935547,20678,2504,18174,18174,0,9,2751000.0
2751,2751999,21.67341415680453,37.417097636880676,0.03942615478188338,419.1384778022766,179.1119680404663,731.9881477355957,20694,2505,18189,18189,0,9,2752000.0
2752,2752999,21.67026168890502,37.41259063422138,0.03945253073231736,419.2678713798523,179.1765637397766,732.1965713500977,20694,2505,18189,18189,0,9,2753000.0
2753,2753999,21.667437395959357,37.40831728773039,0.03948069899803386,419.54203629493713,179.24178886413574,732.3297805786133,20739,2508,18231,18231,0,9,2754000.0
2754,2754999,21.664535501848043,37.403893331757615,0.039500705160601224,419.6634681224823,179.30612778663635,732.4954605102539,20739,2508,18231,18231,0,9,2755000.0
2755,2755999,21.661731565787488,37.39996559948066,0.039517016069011146,419.83942317962646,179.37163925170898,732.6352233886719,20741,2509,18232,18232,0,9,2756000.0
2756,2756999,21.65893325608265,37.39598205423825,0.039531261796832085,420.06123065948486,179.4359130859375,732.6372299194336,20745,2511,18234,18234,0,9,2757000.0
2757,2757999,21.65630456401817,37.392094164795786,0.03954024490139796,420.2846751213074,179.5009958744049,732.783016204834,20756,2513,18243,18243,0,9,2758000.0
2758,2758999,21.653664893750694,37.38817669358529,0.0395448850447061,420.4031310081482,179.56507468223572,732.9124641418457,20756,2513,18243,18243,0,9,2759000.0
2759,2759999,21.65203601555179,37.392263159346264,0.03953738093767967,420.5464723110199,179.62945866584778,733.0367202758789,20756,2513,18243,18243,0,9,2760000.0
2760,2760999,21.64983805271491,37.38887879678912,0.03954144042916674,420.73129749298096,179.69382762908936,733.0946655273438,20758,2514,18244,18244,0,9,2761000.0
2761,2761999,21.648043692765384,37.38587017615873,0.039546319522645756,420.9042158126831,179.75793528556824,733.1740264892578,20763,2515,18248,18248,0,9,2762000.0
2762,2762999,21.646437405657963,37.38318659870089,0.03954458163952468,421.0806133747101,179.82222390174866,733.3227958679199,20771,2516,18255,18255,0,9,2763000.0
2763,2763999,21.64631531144406,37.382727827829626,0.039545362124542516,421.21897077560425,179.886470079422,733.453800201416,20772,2516,18256,18256,0,9,2764000.0
2764,2764999,21.645397360485244,37.380892886694745,0.039545407046884584,421.34894132614136,179.95071053504944,733.5333518981934,20772,2516,18256,18256,0,9,2765000.0
2765,2765999,21.644717148812965,37.379474479297706,0.03955277532584134,421.52484130859375,180.01482892036438,733.6459159851074,20778,2517,18261,18261,0,9,2766000.0
2766,2766999,21.644080513169246,37.3780231564157,0.039548159097764435,421.69406843185425,180.07942700386047,733.7738990783691,20784,2518,18266,18266,0,9,2767000.0
2767,2767999,21.643288708056005,37.375648452865455,0.03954032053401002,421.90867280960083,180.14341139793396,733.8059577941895,20790,2520,18270,18270,0,9,2768000.0
2768,2768999,21.642019219748967,37.37275792098443,0.039533797480937216,422.036244392395,180.20739150047302,734.0118865966797,20792,2520,18272,18272,0,9,2769000.0
2769,2769999,21.63993824166304,37.36959848977813,0.03952180294191798,422.1542091369629,180.2710349559784,734.4563636779785,20800,2520,18280,18280,0,9,2770000.0
2770,2770999,21.6374832445479,37.36512773437982,0.039509547436114345,422.29460310935974,180.33621668815613,734.6892127990723,20801,2520,18281,18281,0,9,2771000.0
2771,2771999,21.63514130824668,37.36126701634545,0.039493961013788104,422.42708706855774,180.4006175994873,734.910213470459,20803,2520,18283,18283,0,9,2772000.0
2772,2772999,21.6323553085119,37.35753339624031,0.039494850180693764,422.62965059280396,180.46608114242554,735.0523948669434,20810,2521,18289,18289,0,9,2773000.0
2773,2773999,21.630211187702198,37.354333332994,0.03948311492331236,422.75750970840454,180.53088998794556,735.2314834594727,20810,2521,18289,18289,0,9,2774000.0
2774,2774999,21.6280407979617,37.35065113779102,0.03945586931070444,422.9293940067291,180.59629201889038,735.3622169494629,20815,2522,18293,18293,0,9,2775000.0
2775,2775999,21.626099450857478,37.34628178720249,0.039440877482254555,423.0978670120239,180.66099643707275,735.4826202392578,20819,2523,18296,18296,0,9,2776000.0
2776,2776999,21.62381571426842,37.34173630711421,0.03942538930709871,423.2744164466858,180.72549271583557,735.595458984375,20821,2524,18297,18297,0,9,2777000.0
2777,2777999,21.622167864137904,37.33792897173773,0.03939787401375472,423.4080402851105,180.7899088859558,735.8387336730957,20821,2524,18297,18297,0,9,2778000.0
2778,2778999,21.620252182889995,37.333701400837086,0.03938140952568303,423.58523654937744,180.85420775413513,735.9008140563965,20823,2525,18298,18298,0,9,2779000.0
2779,2779999,21.618383731721114,37.329569380795405,0.039354814347630884,423.7729208469391,180.91849446296692,735.9435653686523,20825,2526,18299,18299,0,9,2780000.0
2780,2780999,21.61764727088348,37.327163645207555,0.03931383981735315,423.9040093421936,180.98373699188232,736.0963554382324,20826,2526,18300,18300,0,9,2781000.0
2781,2781999,21.616487790646076,37.323724666372705,0.03928298368046801,424.0448212623596,181.0478551387787,736.2139167785645,20826,2526,18300,18300,0,9,2782000.0
2782,2782999,21.615549836203122,37.32082951266376,0.0392554411588818,424.1680197715759,181.1116144657135,736.3177757263184,20826,2526,18300,18300,0,9,2783000.0
2783,2783999,21.614507184557073,37.31764099226773,0.03921978690155126,424.3386151790619,181.1757516860962,736.424186706543,20857,2527,18330,18330,0,9,2784000.0
2784,2784999,21.613717186846355,37.31458802119341,0.039183011021382885,424.51723623275757,181.24017572402954,736.4570579528809,20862,2528,18334,18334,0,9,2785000.0
2785,2785999,21.612983833279518,37.31199513344424,0.039160214219896905,424.7055118083954,181.30435371398926,736.492073059082,20867,2529,18338,18338,0,9,2786000.0
2786,2786999,21.611905556078987,37.30853847286748,0.039144896784267025,424.83247923851013,181.36849236488342,736.6869087219238,20869,2529,18340,18340,0,9,2787000.0
2787,2787999,21.611246450056452,37.307492022612685,0.03910868241857235,424.96553206443787,181.43225264549255,736.8189277648926,20870,2529,18341,18341,0,9,2788000.0
2788,2788999,21.609896800392715,37.30423975052421,0.03909155626163119,425.17983293533325,181.4966175556183,736.8477478027344,20880,2531,18349,18349,0,9,2789000.0
2789,2789999,21.608107950548067,37.30024957149986,0.039079161733786005,425.31363677978516,181.56040239334106,736.9382057189941,20880,2531,18349,18349,0,9,2790000.0
2790,2790999,21.608081210887867,37.30433069756847,0.039046529594083834,425.5317528247833,181.62446284294128,737.065673828125,20885,2533,18352,18352,0,9,2791000.0
2791,2791999,21.60772983437701,37.3052729010519,0.03903450848177781,425.6630744934082,181.68990302085876,737.3381156921387,20888,2533,18355,18355,0,9,2792000.0
2792,2792999,21.606404780146846,37.3039414731916,0.039039293238922745,425.84285712242126,181.7550630569458,737.5287780761719,20898,2534,18364,18364,0,9,2793000.0
2793,2793999,21.605669223878067,37.30381010970148,0.03902583552984851,425.96350717544556,181.81920909881592,737.7202262878418,20899,2534,18365,18365,0,9,2794000.0
2794,2794999,21.60473982120096,37.30288904399113,0.03901040777326181,426.1466181278229,181.88370966911316,737.7958793640137,20904,2535,18369,18369,0,9,2795000.0
2795,2795999,21.604843358697412,37.305184661284706,0.03899260036570995,426.3742527961731,181.94897389411926,737.8880767822266,20914,2537,18377,18377,0,9,2796000.0
2796,2796999,21.603857117196995,37.30346504178605,0.03897367444066446,426.54740047454834,182.01383757591248,738.0461082458496,20920,2538,18382,18382,0,9,2797000.0
2797,2797999,21.603409928572898,37.30343563345219,0.038975008301209924,426.73719024658203,182.07851219177246,738.207389831543,20933,2539,18394,18394,0,9,2798000.0
2798,2798999,21.603448619069376,37.303721247303265,0.03895546846216469,426.9285337924957,182.14339971542358,738.2971572875977,20938,2540,18398,18398,0,9,2799000.0
2799,2799999,21.60356792091387,37.30915317862602,0.038921426153894934,427.05564522743225,182.20852899551392,738.4982986450195,20940,2540,18400,18400,0,9,2800000.0
2800,2800999,21.603475089849006,37.30826966101109,0.03891296117010368,427.18144822120667,182.2734534740448,738.6536407470703,20941,2540,18401,18401,0,9,2801000.0
2801,2801999,21.603258080601528,37.30696928392542,0.038901214173671206,427.320951461792,182.33753442764282,738.7683334350586,20941,2540,18401,18401,0,9,2802000.0
2802,2802999,21.603321091722034,37.306586576125014,0.03890094272411959,427.4415216445923,182.4017791748047,738.9125289916992,20942,2540,18402,18402,0,9,2803000.0
2803,2803999,21.603237810232308,37.30601875694319,0.03888023816180919,427.56558990478516,182.46584558486938,739.0441818237305,20943,2540,18403,18403,0,9,2804000.0
2804,2804999,21.6029921717529,37.30432175435957,0.038865553717798984,427.73937249183655,182.52993512153625,739.1167640686035,20948,2541,18407,18407,0,9,2805000.0
2805,2805999,21.603115033431067,37.30283790907542,0.0388491561785389,428.0220878124237,182.59524583816528,739.148811340332,20968,2544,18424,18424,0,9,2806000.0
2806,2806999,21.603797669492042,37.30196354408843,0.038825724076739565,428.2371838092804,182.6595778465271,739.2170104980469,20983,2546,18437,18437,0,9,2807000.0
2807,2807999,21.605003346366264,37.308704042104075,0.03878935242278725,428.406259059906,182.72368168830872,739.2846145629883,20985,2547,18438,18438,0,9,2808000.0
2808,2808999,21.60521731119829,37.307049987531954,0.038777804089258905,428.58610224723816,182.7881646156311,739.4980812072754,20991,2548,18443,18443,0,9,2809000.0
2809,2809999,21.60510578132939,37.30502767155431,0.03876117669569923,428.7117714881897,182.85218501091003,739.7454795837402,20993,2548,18445,18445,0,9,2810000.0
2810,2810999,21.603687740569985,37.30114017868881,0.03875080274666809,428.8432660102844,182.91747403144836,739.9639434814453,20997,2548,18449,18449,0,9,2811000.0
2811,2811999,21.600589428432457,37.29683228486596,0.03875719241799935,429.0730290412903,182.98319673538208,740.5647926330566,21058,2550,18508,18508,0,9,2812000.0
2812,2812999,21.597316812636524,37.292406123291684,0.038775753970890614,429.2576150894165,183.04897499084473,740.911792755127,21074,2551,18523,18523,0,9,2813000.0
2813,2813999,21.59409817519717,37.28821307989754,0.03879176898884773,429.43865990638733,183.1140375137329,741.0459671020508,21079,2552,18527,18527,0,9,2814000.0
2814,2814999,21.590968042275254,37.28346115467681,0.03880933626347083,429.5623242855072,183.17856001853943,741.3044013977051,21080,2552,18528,18528,0,9,2815000.0
2815,2815999,21.588055669172796,37.27886646038546,0.03882244266746826,429.7368543148041,183.24417662620544,741.4767799377441,21088,2553,18535,18535,0,9,2816000.0
2816,2816999,21.58545252208165,37.2754405933498,0.03883212733946528,429.9577145576477,183.3097803592682,741.5999526977539,21100,2555,18545,18545,0,9,2817000.0
2817,2817999,21.582757068803677,37.27167893404068,0.038837248303933536,430.08662700653076,183.37434577941895,741.7889175415039,21100,2555,18545,18545,0,9,2818000.0
2818,2818999,21.579893994887573,37.26737199528449,0.038848905653197985,430.26457118988037,183.4397521018982,741.9506340026855,21104,2556,18548,18548,0,9,2819000.0
2819,2819999,21.57714035877065,37.26276151703867,0.038848379410450606,430.3889944553375,183.50540471076965,742.1257171630859,21104,2556,18548,18548,0,9,2820000.0
2820,2820999,21.574636202286474,37.258304096553395,0.03885272181014732,430.5667016506195,183.5701653957367,742.2218170166016,21109,2557,18552,18552,0,9,2821000.0
2821,2821999,21.572515450639624,37.25488125468275,0.038856829288703265,430.8381884098053,183.63507676124573,742.193603515625,21117,2560,18557,18557,0,9,2822000.0
2822,2822999,21.571672586141023,37.26130967593013,0.03883703002081662,431.0627417564392,183.69984245300293,742.2480354309082,21121,2562,18559,18559,0,9,2823000.0
2823,2823999,21.571206832250745,37.261032165341526,0.03883600401377718,431.19147062301636,183.7651162147522,742.4648742675781,21121,2562,18559,18559,0,9,2824000.0
2824,2824999,21.57079662724439,37.26065487173417,0.03884038776680088,431.33461570739746,183.8299479484558,742.7081832885742,21122,2562,18560,18560,0,9,2825000.0
2825,2825999,21.571311760453565,37.262253093414834,0.03884377996813393,431.4743368625641,183.9135046005249,742.870906829834,21123,2562,18561,18561,0,9,2826000.0
2826,2826999,21.57157135481776,37.262092335282304,0.0388645412048817,431.6604995727539,183.9973840713501,742.9954795837402,21129,2563,18566,18566,0,9,2827000.0
2827,2827999,21.57133099181335,37.26034601935075,0.03886997792623215,431.83411264419556,184.06223702430725,743.1511878967285,21133,2564,18569,18569,0,9,2828000.0
2828,2828999,21.572506424371582,37.261324981409835,0.0389008017070982,431.9569089412689,184.12654185295105,743.3973922729492,21135,2564,18571,18571,0,9,2829000.0
2829,2829999,21.57291044591875,37.26071426049175,0.038922070805615716,432.0993661880493,184.1910102367401,743.5768585205078,21136,2564,18572,18572,0,9,2830000.0
2830,2830999,21.572846066882576,37.25895621690243,0.03891494883892688,432.2250258922577,184.2551691532135,743.8564262390137,21137,2564,18573,18573,0,9,2831000.0
2831,2831999,21.57160049033791,37.25616096647074,0.03890653356225715,432.44627690315247,184.3209114074707,744.3316040039062,21166,2566,18600,18600,0,9,2832000.0
2832,2832999,21.569192080593965,37.25319537771961,0.03890396462187107,432.71739053726196,184.38651514053345,744.6487236022949,21179,2569,18610,18610,0,9,2833000.0
2833,2833999,21.566434672229867,37.249889157848784,0.038918387227864004,432.9452772140503,184.4516932964325,744.920841217041,21191,2571,18620,18620,0,9,2834000.0
2834,2834999,21.563455560909507,37.24498285870032,0.03892846242682091,433.163311958313,184.51701736450195,745.0694351196289,21197,2573,18624,18624,0,9,2835000.0
2835,2835999,21.561215096348597,37.241213747936804,0.038933569720933425,433.3379981517792,184.5821738243103,745.2871398925781,21199,2574,18625,18625,0,9,2836000.0
2836,2836999,21.559505436528358,37.23898189354583,0.03892863233487287,433.49340629577637,184.65638494491577,745.5251312255859,21199,2574,18625,18625,0,9,2837000.0
2837,2837999,21.55800209105871,37.237416204006884,0.038932892154915244,435.95568442344666,184.72151494026184,745.6829719543457,21199,2574,18625,18625,0,9,2838000.0
2838,2838999,21.557080502713312,37.23686096690046,0.03893600991584978,436.0826966762543,184.7868173122406,745.8691368103027,21201,2574,18627,18627,0,9,2839000.0
2839,2839999,21.556715516040374,37.23846141944691,0.03894321417904234,436.3024206161499,184.8516447544098,745.9585075378418,21207,2576,18631,18631,0,9,2840000.0
2840,2840999,21.556795263924517,37.24063431857001,0.038944594825130685,436.4385817050934,184.91660118103027,746.1435356140137,21207,2576,18631,18631,0,9,2841000.0
2841,2841999,21.55745731662958,37.24375041362321,0.03895474363167595,436.68031215667725,184.98191237449646,746.1537132263184,21213,2578,18635,18635,0,9,2842000.0
2842,2842999,21.559341992668337,37.24978131048677,0.03899382831194498,436.95987725257874,185.04798650741577,746.1930046081543,21234,2581,18653,18653,0,9,2843000.0
2843,2843999,21.56296450989249,37.2647630351273,0.03904832101315203,437.1020529270172,185.11443543434143,746.50048828125,21236,2581,18655,18655,0,9,2844000.0
2844,2844999,21.56536199468303,37.272009869446876,0.03912660325408923,437.23361110687256,185.1794171333313,746.6997413635254,21236,2581,18655,18655,0,9,2845000.0
2845,2845999,21.57001026429251,37.286417222941914,0.03913649309906608,437.35837173461914,185.2440264225006,746.9290313720703,21237,2581,18656,18656,0,9,2846000.0
2846,2846999,21.574952357887295,37.29812472678278,0.039184124459127,437.545156955719,185.30910062789917,747.1219711303711,21254,2582,18672,18672,0,9,2847000.0
2847,2847999,21.580030085751194,37.31271150381822,0.039217171431727316,437.68574714660645,185.37491488456726,747.3349151611328,21254,2582,18672,18672,0,9,2848000.0
2848,2848999,21.585076086655548,37.32583916566524,0.039248002277119776,437.86565232276917,185.44049549102783,747.553955078125,21258,2583,18675,18675,0,9,2849000.0
2849,2849999,21.588580789133655,37.33392715759931,0.03929302396648349,438.1569197177887,185.51497268676758,747.6984558105469,21268,2586,18682,18682,0,9,2850000.0
2850,2850999,21.59341354899026,37.344613012657796,0.03934856999485847,438.3836863040924,185.58043813705444,747.8784637451172,21273,2588,18685,18685,0,9,2851000.0
2851,2851999,21.596022168611597,37.34960272259741,0.039347402074430105,438.5177671909332,185.64577746391296,748.1012763977051,21273,2588,18685,18685,0,9,2852000.0
2852,2852999,21.594395559066854,37.34693729726309,0.03935059587762346,438.7781472206116,185.71433544158936,748.7754783630371,21301,2590,18711,18711,0,9,2853000.0
2853,2853999,21.592198759200482,37.343838265389245,0.03934878984633727,438.955194234848,185.78178763389587,749.1944580078125,21308,2591,18717,18717,0,9,2854000.0
2854,2854999,21.5898030558617,37.33948953396828,0.03934792934379161,439.12963819503784,185.84780645370483,749.4071006774902,21322,2592,18730,18730,0,9,2855000.0
2855,2855999,21.588932953440853,37.34214206294202,0.039343881690393046,439.39679431915283,185.91436648368835,749.4965286254883,21341,2595,18746,18746,0,9,2856000.0
2856,2856999,21.58710019463887,37.338816082446606,0.03933405981967941,439.5258228778839,185.98047518730164,749.6958961486816,21341,2595,18746,18746,0,9,2857000.0
2857,2857999,21.585904393982098,37.33613012348563,0.03931623619306168,439.75577878952026,186.04796266555786,749.8060455322266,21348,2597,18751,18751,0,9,2858000.0
2858,2858999,21.58421229994229,37.33236281762976,0.03930244731203525,439.94597244262695,186.12131237983704,750.0307693481445,21355,2598,18757,18757,0,9,2859000.0
2859,2859999,21.583086899196115,37.33033712188981,0.039290718224144316,440.06955003738403,186.1863603591919,750.2821006774902,21355,2598,18757,18757,0,9,2860000.0
2860,2860999,21.582688070456552,37.3294156532653,0.03926557558292498,440.3145670890808,186.2534544467926,750.2695808410645,21365,2600,18765,18765,0,9,2861000.0
2861,2861999,21.58208514085072,37.32738275375238,0.03924256467113607,440.45027780532837,186.3188979625702,750.5888824462891,21369,2600,18769,18769,0,9,2862000.0
2862,2862999,21.58117211306172,37.32510496858639,0.03923683442133896,440.6241774559021,186.38410305976868,750.7571220397949,21373,2601,18772,18772,0,9,2863000.0
2863,2863999,21.581176381870808,37.32467277171476,0.039213425367405796,440.89991664886475,186.450035572052,750.788631439209,21381,2604,18777,18777,0,9,2864000.0
2864,2864999,21.580960382483514,37.32291025824052,0.03920064210079566,441.0285675525665,186.5170397758484,750.9954147338867,21383,2604,18779,18779,0,9,2865000.0
2865,2865999,21.58088996604408,37.32223964450062,0.039191419663584304,441.2560269832611,186.58285117149353,751.0962257385254,21389,2606,18783,18783,0,9,2866000.0
2866,2866999,21.581155633129757,37.321370765482634,0.039180151311146605,441.4818012714386,186.648184299469,751.258602142334,21397,2608,18789,18789,0,9,2867000.0
2867,2867999,21.58132587335834,37.32135954542497,0.03918173376348333,441.71982765197754,186.71370005607605,751.3514175415039,21409,2610,18799,18799,0,9,2868000.0
2868,2868999,21.581289890091178,37.32022308108325,0.03918129762907219,441.8891181945801,186.78060030937195,751.5202903747559,21414,2611,18803,18803,0,9,2869000.0
2869,2869999,21.5817109753327,37.31958684653247,0.03917659630427328,442.0284478664398,186.84668827056885,751.791862487793,21416,2611,18805,18805,0,9,2870000.0
2870,2870999,21.58184392517999,37.31791117735496,0.03916893659517828,442.25015926361084,186.91210317611694,751.905460357666,21424,2613,18811,18811,0,9,2871000.0
2871,2871999,21.582027258903295,37.31630915013787,0.03915444625824105,442.56603360176086,186.97748184204102,751.917064666748,21450,2617,18833,18833,0,9,2872000.0
2872,2872999,21.581186972134773,37.31333687837873,0.039152618515507775,442.847309589386,187.04762411117554,751.9978981018066,21461,2620,18841,18841,0,9,2873000.0
2873,2873999,21.57893788583243,37.30905623265639,0.03915384946732425,443.0759184360504,187.1156735420227,752.6670455932617,21487,2622,18865,18865,0,9,2874000.0
2874,2874999,21.57632740781026,37.30499710262722,0.03915455471647533,443.30846762657166,187.184828042984,753.1339340209961,21499,2624,18875,18875,0,9,2875000.0
2875,2875999,21.574195968096383,37.30287586772452,0.03914486622706581,443.6441071033478,187.25120449066162,753.2452621459961,21556,2628,18928,18928,0,9,2876000.0
2876,2876999,21.571884576949863,37.2993230646345,0.03914591825495728,443.7745361328125,187.31653022766113,753.5312767028809,21557,2628,18929,18929,0,9,2877000.0
2877,2877999,21.569516991098816,37.29503214971113,0.039147552884450154,443.9524574279785,187.38204860687256,753.7563934326172,21562,2629,18933,18933,0,9,2878000.0
2878,2878999,21.56744303003028,37.29170832821689,0.03914281718021351,444.13170075416565,187.447772026062,753.9617195129395,21564,2630,18934,18934,0,9,2879000.0
2879,2879999,21.565228966823586,37.287792903624,0.03914386275561421,444.2593455314636,187.51439547538757,754.1540489196777,21564,2630,18934,18934,0,9,2880000.0
2880,2880999,21.563738983689536,37.2846972594291,0.039136651952952684,444.6413986682892,187.58083772659302,754.1432876586914,21586,2635,18951,18951,0,9,2881000.0
2881,2881999,21.562054837681,37.28154621647021,0.03914280116939495,444.8224608898163,187.6466202735901,754.4179611206055,21591,2636,18955,18955,0,9,2882000.0
2882,2882999,21.561178824694313,37.279670195321586,0.03914573642949026,444.9589195251465,187.714781999588,754.657054901123,21591,2636,18955,18955,0,9,2883000.0
2883,2883999,21.56107716577084,37.27819191525648,0.039130077891756376,445.09619307518005,187.78011274337769,754.9398956298828,21592,2636,18956,18956,0,9,2884000.0
2884,2884999,21.56153835173647,37.27855438004446,0.03911125658289594,445.3736038208008,187.8464286327362,755.0251045227051,21601,2639,18962,18962,0,9,2885000.0
2885,2885999,21.562432183215602,37.27784362665817,0.03910305992683094,445.54892206192017,187.91385960578918,755.2915687561035,21604,2640,18964,18964,0,9,2886000.0
2886,2886999,21.56359517983464,37.27807329079257,0.03911826849220024,445.772353887558,187.9792675971985,755.3960151672363,21608,2642,18966,18966,0,9,2887000.0
2887,2887999,21.565056394459393,37.278112134037045,0.03913152389885821,445.9048352241516,188.04422616958618,755.6478805541992,21609,2642,18967,18967,0,9,2888000.0
2888,2888999,21.56634247074097,37.27770249610783,0.03912109704270894,446.07841086387634,188.1093134880066,755.842399597168,21616,2643,18973,18973,0,9,2889000.0
2889,2889999,21.56658701658463,37.2759636803928,0.0391312868117778,446.2074406147003,188.17699337005615,756.2101974487305,21620,2643,18977,18977,0,9,2890000.0
2890,2890999,21.566290281636824,37.27331448803304,0.03912867389881847,446.4329779148102,188.24221634864807,756.400390625,21643,2645,18998,18998,0,9,2891000.0
2891,2891999,21.564696528688785,37.274369844447335,0.03912663678941086,446.65895438194275,188.3078670501709,756.9019165039062,21663,2647,19016,19016,0,9,2892000.0
2892,2892999,21.562397739043142,37.27129695006869,0.039148812133089184,446.84554266929626,188.373064994812,757.180549621582,21675,2648,19027,19027,0,9,2893000.0
2893,2893999,21.56047986618624,37.26716390068945,0.03916170767300642,446.97945523262024,188.43912649154663,757.4431343078613,21675,2648,19027,19027,0,9,2894000.0
2894,2894999,21.559221087523348,37.265097181770486,0.039191400716159785,447.1691801548004,188.5042130947113,757.6496124267578,21682,2649,19033,19033,0,9,2895000.0
2895,2895999,21.557753622956433,37.26209317293484,0.03919667044209185,447.3475639820099,188.56951904296875,757.8354339599609,21685,2650,19035,19035,0,9,2896000.0
2896,2896999,21.556179011870565,37.258823368014085,0.039204848264664416,447.4847676753998,188.63447499275208,758.0268745422363,21686,2650,19036,19036,0,9,2897000.0
2897,2897999,21.554280408576197,37.255006281532914,0.03920968510439804,447.71556878089905,188.69958186149597,758.0987129211426,21696,2652,19044,19044,0,9,2898000.0
2898,2898999,21.552757097619217,37.251706129519675,0.03921184841685155,447.9384229183197,188.7645983695984,758.1948547363281,21714,2654,19060,19060,0,9,2899000.0
2899,2899999,21.55127922413819,37.249138325626376,0.03920900622431256,448.0649149417877,188.82971835136414,758.3728866577148,21714,2654,19060,19060,0,9,2900000.0
2900,2900999,21.550434171023404,37.247315966550865,0.039195364526986354,448.2559447288513,188.89506340026855,758.4892768859863,21716,2655,19061,19061,0,9,2901000.0
2901,2901999,21.549204203831643,37.24458732418608,0.039192781056268,448.3880364894867,188.96147227287292,758.6252975463867,21716,2655,19061,19061,0,9,2902000.0
2902,2902999,21.54862771776363,37.242725894519914,0.03918516244226844,448.5251407623291,189.02610397338867,758.782054901123,21716,2655,19061,19061,0,9,2903000.0
2903,2903999,21.54838254848712,37.24402083888078,0.0391805820211254,448.71706342697144,189.09195804595947,758.8707656860352,21718,2656,19062,19062,0,9,2904000.0
2904,2904999,21.548262660371336,37.242402566522,0.0391659327314412,448.85208678245544,189.15674209594727,759.0392913818359,21719,2656,19063,19063,0,9,2905000.0
2905,2905999,21.54820522817101,37.24120718255578,0.03916335221559886,448.98433470726013,189.22140836715698,759.21923828125,21720,2656,19064,19064,0,9,2906000.0
2906,2906999,21.548414615513977,37.240629381989706,0.03915702436582147,449.21159076690674,189.28813099861145,759.3302230834961,21729,2658,19071,19071,0,9,2907000.0
2907,2907999,21.54770013410854,37.24041105956127,0.039141768468453186,449.3893654346466,189.3531813621521,759.5230941772461,21732,2659,19073,19073,0,9,2908000.0
2908,2908999,21.545375892209456,37.23605123376305,0.03915291024823331,449.51824736595154,189.4176459312439,759.952033996582,21736,2659,19077,19077,0,9,2909000.0
2909,2909999,21.543326103502846,37.23360142623105,0.03916944618780871,449.8427515029907,189.48324298858643,760.0874671936035,21752,2663,19089,19089,0,9,2910000.0
2910,2910999,21.541407762448035,37.23072929444683,0.03918594125086283,449.97412490844727,189.54861998558044,760.3936500549316,21756,2663,19093,19093,0,9,2911000.0
2911,2911999,21.539550928941257,37.22803213313012,0.039200263548503034,450.21318674087524,189.61424016952515,760.5414237976074,21777,2665,19112,19112,0,9,2912000.0
2912,2912999,21.537351195239555,37.224197300902645,0.03922234483074449,450.3376648426056,189.67876362800598,760.7718544006348,21781,2665,19116,19116,0,9,2913000.0
2913,2913999,21.535206326133764,37.22050022332132,0.039237113802175094,450.4602744579315,189.7432632446289,760.9260101318359,21781,2665,19116,19116,0,9,2914000.0
2914,2914999,21.533347994007013,37.21723714241511,0.03923613876242793,450.5953152179718,189.8081660270691,761.1303863525391,21784,2665,19119,19119,0,9,2915000.0
2915,2915999,21.53237894087718,37.21715105059224,0.03922648129185313,450.7772858142853,189.87322354316711,761.2309875488281,21788,2666,19122,19122,0,9,2916000.0
2916,2916999,21.531953584788937,37.21745778872375,0.039221390993773086,450.9048044681549,189.93750596046448,761.4321594238281,21788,2666,19122,19122,0,9,2917000.0
2917,2917999,21.531709919384525,37.2185213833327,0.039195347318448315,451.09330534935,190.00243306159973,761.5334053039551,21794,2667,19127,19127,0,9,2918000.0
2918,2918999,21.532311194194797,37.220029650083696,0.03917495233035262,451.2601161003113,190.06680750846863,761.5921859741211,21796,2668,19128,19128,0,9,2919000.0
2919,2919999,21.532092135713274,37.22001658996356,0.03915484985012829,451.483074426651,190.1316659450531,761.6753311157227,21803,2670,19133,19133,0,9,2920000.0
2920,2920999,21.532503057185714,37.22082999308645,0.03912438433905152,451.6070261001587,190.19608283042908,761.8446159362793,21803,2670,19133,19133,0,9,2921000.0
2921,2921999,21.532652711500603,37.220374927330816,0.03910542206894552,451.84219455718994,190.26176261901855,761.8406219482422,21815,2672,19143,19143,0,9,2922000.0
2922,2922999,21.532866016203126,37.22008778640258,0.03908605732982784,451.98269176483154,190.327534198761,762.0143814086914,21816,2672,19144,19144,0,9,2923000.0
2923,2923999,21.533236592736902,37.22246093618493,0.039063247949588265,452.1599154472351,190.39229083061218,762.2040405273438,21820,2673,19147,19147,0,9,2924000.0
2924,2924999,21.533781603039433,37.222346319522075,0.03904619605816029,452.2911834716797,190.45637488365173,762.381160736084,21820,2673,19147,19147,0,9,2925000.0
2925,2925999,21.533252370016694,37.21985658710249,0.03902458316023927,452.4586389064789,190.52076530456543,762.5550804138184,21827,2674,19153,19153,0,9,2926000.0
2926,2926999,21.532556056318573,37.21776182754023,0.039007452392180175,452.62993574142456,190.58517813682556,762.6694297790527,21829,2675,19154,19154,0,9,2927000.0
2927,2927999,21.530717899138235,37.21434772939827,0.03899693317681485,452.8645703792572,190.64942169189453,762.7905883789062,21835,2677,19158,19158,0,9,2928000.0
2928,2928999,21.528312178093046,37.21040802092875,0.039001049028806856,453.0418326854706,190.71412801742554,763.2280044555664,21840,2678,19162,19162,0,9,2929000.0
2929,2929999,21.525195095328936,37.20639138822377,0.039004456067095794,453.26519417762756,190.77894377708435,763.4113693237305,21882,2680,19202,19202,0,9,2930000.0
2930,2930999,21.522148730504316,37.201504557045226,0.0390223020251369,453.39015078544617,190.8436644077301,763.6083106994629,21882,2680,19202,19202,0,9,2931000.0
2931,2931999,21.51958754681281,37.19766521960634,0.039031529614909855,453.5360450744629,190.90839886665344,763.8878021240234,21883,2680,19203,19203,0,9,2932000.0
2932,2932999,21.517048154426096,37.19328723788149,0.03903983712535597,453.6577858924866,190.9726939201355,764.101261138916,21883,2680,19203,19203,0,9,2933000.0
2933,2933999,21.514645897652805,37.18904046087272,0.03904678260143801,453.78384160995483,191.03760266304016,764.2431755065918,21884,2680,19204,19204,0,9,2934000.0
2934,2934999,21.51237774067039,37.18538695896838,0.03905303620069378,453.95854902267456,191.10222864151,764.3820762634277,21886,2681,19205,19205,0,9,2935000.0
2935,2935999,21.510144952947897,37.18130271686205,0.03905249739993644,454.1301968097687,191.16700506210327,764.5434646606445,21888,2682,19206,19206,0,9,2936000.0
2936,2936999,21.508191989020666,37.17852444433331,0.0390458922694743,454.3537600040436,191.23174953460693,764.5674819946289,21892,2684,19208,19208,0,9,2937000.0
2937,2937999,21.507066538408953,37.17787430708082,0.03904444898204107,454.576388835907,191.29625177383423,764.6206283569336,21896,2686,19210,19210,0,9,2938000.0
2938,2938999,21.507077395826272,37.179930557293694,0.039033750383775434,454.7588005065918,191.36099195480347,764.7436561584473,21898,2687,19211,19211,0,9,2939000.0
2939,2939999,21.50769692395568,37.18956145318996,0.039004710796008424,454.9349932670593,191.425678730011,764.879280090332,21900,2688,19212,19212,0,9,2940000.0
2940,2940999,21.50872019505174,37.19517379763192,0.03900337765037998,455.06137347221375,191.49015545845032,765.102970123291,21900,2688,19212,19212,0,9,2941000.0
2941,2941999,21.509791522427342,37.19862540290216,0.03900954559045888,455.24616837501526,191.55474948883057,765.3411331176758,21914,2689,19225,19225,0,9,2942000.0
2942,2942999,21.509816543787327,37.19927175987335,0.0390153022699371,455.3689408302307,191.61972832679749,765.5148887634277,21915,2689,19226,19226,0,9,2943000.0
2943,2943999,21.510844733303216,37.20118481306542,0.03902570961185625,455.55280685424805,191.68983244895935,765.6770401000977,21917,2690,19227,19227,0,9,2944000.0
2944,2944999,21.511172198417356,37.201552915335434,0.03903076668451111,455.7299404144287,191.75430917739868,765.8490715026855,21920,2691,19229,19229,0,9,2945000.0
2945,2945999,21.51253023958311,37.20433525735866,0.03904785825912527,455.85596442222595,191.81906151771545,766.0556526184082,21920,2691,19229,19229,0,9,2946000.0
2946,2946999,21.512236092012316,37.20358142119137,0.03905350774684124,456.0364668369293,191.88326406478882,766.2425880432129,21925,2692,19233,19233,0,9,2947000.0
2947,2947999,21.51201263573884,37.20249385699328,0.039065465845099734,456.1625769138336,191.94688177108765,766.4580497741699,21926,2692,19234,19234,0,9,2948000.0
2948,2948999,21.511184226539807,37.20446042323922,0.039069422450873637,456.33646845817566,192.01081466674805,766.7649993896484,21931,2693,19238,19238,0,9,2949000.0
2949,2949999,21.5087825750339,37.203195759261824,0.03908401298359543,456.52261209487915,192.07676124572754,767.1029472351074,21939,2694,19245,19245,0,9,2950000.0
2950,2950999,21.506517294940828,37.20178906773704,0.03909062181834955,456.650465965271,192.1415662765503,767.4056434631348,21942,2694,19248,19248,0,9,2951000.0
2951,2951999,21.504798249656947,37.200834986114664,0.039098863084141344,456.7728958129883,192.2069056034088,767.6295280456543,21942,2694,19248,19248,0,9,2952000.0
2952,2952999,21.50396644262087,37.20204259701812,0.03911051233194418,456.9518241882324,192.27161407470703,767.792293548584,21958,2695,19263,19263,0,9,2953000.0
2953,2953999,21.50443386166393,37.20470405012579,0.03913830357486925,457.0957305431366,192.33632922172546,767.9638366699219,21958,2695,19263,19263,0,9,2954000.0
2954,2954999,21.50414861266832,37.20521936701231,0.03915340103101561,457.2711555957794,192.4009304046631,768.0788612365723,21960,2696,19264,19264,0,9,2955000.0
2955,2955999,21.503865514727707,37.205619326000075,0.03916137706117029,457.4142909049988,192.46578645706177,768.2826232910156,21961,2696,19265,19265,0,9,2956000.0
2956,2956999,21.503892366330845,37.21195431954692,0.039147936024150454,457.5393810272217,192.52997398376465,768.4322509765625,21961,2696,19265,19265,0,9,2957000.0
2957,2957999,21.5035020010338,37.21142420183982,0.03916400904668571,457.7118730545044,192.5943500995636,768.6125259399414,21963,2697,19266,19266,0,9,2958000.0
2958,2958999,21.503161475613293,37.21102295201701,0.03917455958738203,457.8390371799469,192.65944480895996,768.8220176696777,21963,2697,19266,19266,0,9,2959000.0
2959,2959999,21.502434807003947,37.20929304885761,0.039179768873612075,457.97137570381165,192.72401523590088,768.9276504516602,21963,2697,19266,19266,0,9,2960000.0
2960,2960999,21.502719397500965,37.20950344237139,0.03918264261724336,458.20104694366455,192.78921222686768,768.9098434448242,21967,2699,19268,19268,0,9,2961000.0
2961,2961999,21.503488496077,37.21333722263514,0.03919179281496077,458.3272089958191,192.85412549972534,769.0311965942383,21967,2699,19268,19268,0,9,2962000.0
2962,2962999,21.504070381041803,37.2132865554172,0.03921039358376155,458.4603958129883,192.9183542728424,769.1787948608398,21967,2699,19268,19268,0,9,2963000.0
2963,2963999,21.505433127786628,37.21478578777387,0.03924694668657669,458.58271765708923,192.98212122917175,769.3140830993652,21967,2699,19268,19268,0,9,2964000.0
2964,2964999,21.506698004951996,37.216014079208136,0.03927099990249161,458.76511549949646,193.04692602157593,769.4225463867188,21972,2700,19272,19272,0,9,2965000.0
2965,2965999,21.50875204397299,37.21800179426725,0.03929582911344609,458.90359687805176,193.1111936569214,769.5508155822754,21972,2700,19272,19272,0,9,2966000.0
2966,2966999,21.509822963941062,37.218361349098494,0.03932099512618936,459.0788893699646,193.1754641532898,769.656078338623,21975,2701,19274,19274,0,9,2967000.0
2967,2967999,21.510450378517874,37.21729945397385,0.03933523080015355,459.21331548690796,193.24066638946533,769.8392372131348,21976,2701,19275,19275,0,9,2968000.0
2968,2968999,21.509918676026498,37.21529974972111,0.03934212394478742,459.33744978904724,193.30420851707458,769.9510345458984,21976,2701,19275,19275,0,9,2969000.0
2969,2969999,21.50787135327019,37.211049747307655,0.039346051620730904,459.460825920105,193.36826491355896,770.6034126281738,21981,2701,19280,19280,0,9,2970000.0
2970,2970999,21.505674355294524,37.20830805546734,0.03934119124733537,459.6814296245575,193.4340465068817,770.9743537902832,21993,2703,19290,19290,0,9,2971000.0
2971,2971999,21.50352572012624,37.205066349590375,0.03934510843968175,459.86782360076904,193.49920415878296,771.2576599121094,21996,2704,19292,19292,0,9,2972000.0
2972,2972999,21.501790518944905,37.204249036448935,0.03933928362206163,460.040399312973,193.56459498405457,771.572021484375,22004,2705,19299,19299,0,9,2973000.0
2973,2973999,21.49989850799404,37.201247945651836,0.039333909142073686,460.2218096256256,193.62945938110352,771.8439064025879,22006,2706,19300,19300,0,9,2974000.0
2974,2974999,21.498139979363536,37.20386882055459,0.03932258735982852,460.3507981300354,193.69449949264526,772.0759620666504,22006,2706,19300,19300,0,9,2975000.0
2975,2975999,21.49595007355105,37.2001139523425,0.039321972418770446,460.4739570617676,193.75870656967163,772.3768844604492,22006,2706,19300,19300,0,9,2976000.0
2976,2976999,21.49384790592192,37.196082075114546,0.03932459389579801,460.69552397727966,193.8230640888214,772.5800971984863,22012,2708,19304,19304,0,9,2977000.0
2977,2977999,21.49209377288529,37.192490310876515,0.03931569315888661,460.8242311477661,193.88871598243713,772.8666725158691,22012,2708,19304,19304,0,9,2978000.0
2978,2978999,21.490882039933176,37.19014784756219,0.03929661577338839,460.99711894989014,193.9527235031128,773.0317840576172,22014,2709,19305,19305,0,9,2979000.0
2979,2979999,21.489650906713155,37.187627754513905,0.03930383837788165,461.2681965827942,194.01733231544495,773.1216278076172,22032,2712,19320,19320,0,9,2980000.0
2980,2980999,21.48913491952464,37.186405575993156,0.03930222756252921,461.4089500904083,194.0824432373047,773.4428215026855,22035,2712,19323,19323,0,9,2981000.0
2981,2981999,21.488746819116244,37.18546307592218,0.039322836265316075,461.5396132469177,194.1464991569519,773.6425361633301,22035,2712,19323,19323,0,9,2982000.0
2982,2982999,21.48899977474057,37.185237013452785,0.03934070015625446,461.7128691673279,194.2105963230133,773.7542686462402,22037,2713,19324,19324,0,9,2983000.0
2983,2983999,21.48938761918693,37.18494276336098,0.03933865142750792,461.93976879119873,194.2748942375183,773.8683280944824,22046,2715,19331,19331,0,9,2984000.0
2984,2984999,21.490281114049914,37.18491561173517,0.039382876589588944,462.20930671691895,194.33921360969543,773.9588317871094,22053,2718,19335,19335,0,9,2985000.0
2985,2985999,21.492326132542747,37.187444816011414,0.03938859052904775,462.38588857650757,194.40316224098206,774.2136917114258,22058,2719,19339,19339,0,9,2986000.0
2986,2986999,21.493655179683753,37.188699088107626,0.03938852029767981,462.51228737831116,194.46745133399963,774.4666976928711,22061,2719,19342,19342,0,9,2987000.0
2987,2987999,21.495436562575364,37.19062901828426,0.03942605798696719,462.69418501853943,194.53279781341553,774.7382354736328,22066,2720,19346,19346,0,9,2988000.0
2988,2988999,21.498171798589244,37.19610947212182,0.03944860862914157,462.827832698822,194.5971338748932,775.0185127258301,22068,2720,19348,19348,0,9,2989000.0
2989,2989999,21.4988581559985,37.19840135472673,0.039483509672286976,462.96517300605774,194.6606900691986,775.3287315368652,22068,2720,19348,19348,0,9,2990000.0
2990,2990999,21.498105726601064,37.1982566271867,0.03945491017691216,463.09367513656616,194.7256464958191,776.0407676696777,22082,2720,19362,19362,0,9,2991000.0
2991,2991999,21.496698201999546,37.19768359033039,0.039446815213549646,463.2360816001892,194.79079627990723,776.4736633300781,22088,2720,19368,19368,0,9,2992000.0
2992,2992999,21.49493770954624,37.193899480270055,0.03942752168969099,463.466392993927,194.85625839233398,776.6675987243652,22098,2722,19376,19376,0,9,2993000.0
2993,2993999,21.493381765389348,37.19128630345536,0.0394142421061805,463.5937738418579,194.92093133926392,776.9255561828613,22102,2722,19380,19380,0,9,2994000.0
2994,2994999,21.492226365391684,37.18915432180165,0.039393143537359454,463.7699086666107,194.98645949363708,777.1158180236816,22110,2723,19387,19387,0,9,2995000.0
2995,2995999,21.49076114191545,37.1855217501067,0.039379273307020846,463.9417390823364,195.0506317615509,777.2612037658691,22116,2724,19392,19392,0,9,2996000.0
2996,2996999,21.48988179698025,37.18306158035325,0.039356182718513155,464.0639488697052,195.11460328102112,777.4843254089355,22119,2724,19395,19395,0,9,2997000.0
2997,2997999,21.488984279238217,37.180107563384226,0.03933146354798567,464.282329082489,195.17924427986145,777.5885696411133,22140,2726,19414,19414,0,9,2998000.0
2998,2998999,21.48793976974801,37.17710769118643,0.03931470899796807,464.4163029193878,195.24312138557434,777.7387847900391,22140,2726,19414,19414,0,9,2999000.0
2999,2999999,21.487835710458715,37.17520424895952,0.03928060301899061,464.5451714992523,195.30713820457458,777.9369087219238,22143,2726,19417,19417,0,9,3000000.0
3000,3000999,21.48764877795389,37.17350624669538,0.03926841508959655,464.71797132492065,195.3711063861847,777.9752502441406,22145,2727,19418,19418,0,9,3001000.0
3001,3001999,21.487407114583085,37.17117393461509,0.03925033847616177,464.8599305152893,195.43525385856628,778.1014556884766,22145,2727,19418,19418,0,9,3002000.0
3002,3002999,21.487605679306807,37.171006068499096,0.03922894810059496,465.0315456390381,195.49985527992249,778.2323455810547,22151,2728,19423,19423,0,9,3003000.0
3003,3003999,21.48882692760663,37.172810766997394,0.03925476639349357,465.197713136673,195.56492614746094,778.3476905822754,22153,2729,19424,19424,0,9,3004000.0
3004,3004999,21.491533736031396,37.17797969929755,0.03929030144130519,465.4304630756378,195.62966656684875,778.4648857116699,22166,2731,19435,19435,0,9,3005000.0
3005,3005999,21.495425506254538,37.186992995783974,0.03936339750424023,465.6560125350952,195.6939778327942,778.6039352416992,22174,2733,19441,19441,0,9,3006000.0
3006,3006999,21.50022592793451,37.19558994680254,0.03943035923258953,465.791800737381,195.7579743862152,778.8178291320801,22174,2733,19441,19441,0,9,3007000.0
3007,3007999,21.506196736337277,37.207706197969564,0.03952090880968151,466.07712030410767,195.8229787349701,778.8745307922363,22190,2736,19454,19454,0,9,3008000.0
3008,3008999,21.512854890015703,37.223520724239144,0.03961374762159853,466.25190806388855,195.88688135147095,779.0286865234375,22196,2737,19459,19459,0,9,3009000.0
3009,3009999,21.519507703172692,37.234664301248365,0.03968757337198925,466.4749846458435,195.95089745521545,779.1267242431641,22200,2739,19461,19461,0,9,3010000.0
3010,3010999,21.522659852754444,37.23958353203296,0.03972123797266647,466.608247756958,196.01415586471558,779.3617706298828,22201,2739,19462,19462,0,9,3011000.0
3011,3011999,21.52230245454436,37.24260096005594,0.039669534355872726,466.7319669723511,196.07852029800415,780.0406646728516,22219,2739,19480,19480,0,9,3012000.0
3012,3012999,21.521153549981953,37.241874233067335,0.039649456597359856,466.9154920578003,196.1435468196869,780.3625450134277,22225,2740,19485,19485,0,9,3013000.0
3013,3013999,21.520283867474514,37.239866575948085,0.039636524461783895,467.03954124450684,196.20728421211243,780.5470695495605,22226,2740,19486,19486,0,9,3014000.0
3014,3014999,21.519134381935206,37.23791601869613,0.0396226175755795,467.2173979282379,196.27214527130127,780.6854782104492,22232,2741,19491,19491,0,9,3015000.0
3015,3015999,21.51807728821936,37.23679685231793,0.03961590179674079,467.39227533340454,196.33655333518982,780.8487129211426,22237,2742,19495,19495,0,9,3016000.0
3016,3016999,21.516589336525186,37.23415687342142,0.03960593782942823,467.5139493942261,196.40048933029175,781.0564727783203,22238,2742,19496,19496,0,9,3017000.0
3017,3017999,21.51573352226737,37.231357486713435,0.03959052059050627,467.6821165084839,196.46437335014343,781.1861534118652,22244,2743,19501,19501,0,9,3018000.0
3018,3018999,21.514681060769544,37.228656723564775,0.03957843553522111,467.90693640708923,196.5292272567749,781.2126121520996,22251,2745,19506,19506,0,9,3019000.0
3019,3019999,21.513564062275098,37.22561504736068,0.03956371076567444,468.09137630462646,196.5933060646057,781.3276176452637,22256,2746,19510,19510,0,9,3020000.0
3020,3020999,21.512663776036252,37.222796888506586,0.039556245470825036,468.2268617153168,196.6571078300476,781.4879875183105,22257,2746,19511,19511,0,9,3021000.0
3021,3021999,21.51222647591912,37.2208994170631,0.039544689455911164,468.3990912437439,196.72106266021729,781.496898651123,22262,2747,19515,19515,0,9,3022000.0
3022,3022999,21.512614480778776,37.22073292525313,0.039534523149117096,468.58137941360474,196.78670454025269,781.6748275756836,22265,2748,19517,19517,0,9,3023000.0
3023,3023999,21.513981799366007,37.22147630682037,0.039521081649305345,468.75707817077637,196.850683927536,781.8164596557617,22279,2749,19530,19530,0,9,3024000.0
3024,3024999,21.51471642681786,37.220494196179175,0.039514438126799334,468.989492893219,196.91470098495483,781.8825416564941,22284,2751,19533,19533,0,9,3025000.0
3025,3025999,21.515905793537318,37.22354666321228,0.03949097533729784,469.1142816543579,196.97861123085022,782.0820960998535,22286,2751,19535,19535,0,9,3026000.0
3026,3026999,21.51698808551831,37.22307706786923,0.039476389408876766,469.29242968559265,197.04256987571716,782.2502365112305,22296,2752,19544,19544,0,9,3027000.0
3027,3027999,21.51706458720572,37.22085421468838,0.03945275721824992,469.42105436325073,197.10655093193054,782.5115242004395,22298,2752,19546,19546,0,9,3028000.0
3028,3028999,21.51618556808488,37.21772457779742,0.03943626868526473,469.5570480823517,197.1702961921692,782.9454612731934,22303,2752,19551,19551,0,9,3029000.0
3029,3029999,21.515293853892647,37.21932670857868,0.03943354215102035,469.6794271469116,197.23543620109558,783.3646430969238,22309,2752,19557,19557,0,9,3030000.0
3030,3030999,21.51416355360525,37.217625798374556,0.039433820379997986,469.85986828804016,197.30007529258728,783.6003952026367,22315,2753,19562,19562,0,9,3031000.0
3031,3031999,21.51400929856201,37.217683067489894,0.03944707016073612,470.0377404689789,197.36439275741577,783.7410583496094,22321,2754,19567,19567,0,9,3032000.0
3032,3032999,21.51406111710145,37.21750078410427,0.03946174220039744,470.16004157066345,197.4295370578766,783.9423828125,22322,2754,19568,19568,0,9,3033000.0
3033,3033999,21.51416645703685,37.21727688616673,0.039459374162707395,470.34588861465454,197.49389672279358,784.0083541870117,22328,2755,19573,19573,0,9,3034000.0
3034,3034999,21.513968141920426,37.21678755595685,0.039464087086128474,470.5290141105652,197.55829310417175,784.234733581543,22343,2756,19587,19587,0,9,3035000.0
3035,3035999,21.51464820943548,37.217032874133665,0.039475207543865576,470.7039968967438,197.62358117103577,784.5057640075684,22355,2757,19598,19598,0,9,3036000.0
3036,3036999,21.515182805732127,37.21655996764803,0.0394802382824303,470.88000535964966,197.68874835968018,784.6942367553711,22364,2758,19606,19606,0,9,3037000.0
3037,3037999,21.516131200083777,37.218564970727876,0.039490075403137426,471.01598620414734,197.75304245948792,784.9185829162598,22366,2758,19608,19608,0,9,3038000.0
3038,3038999,21.518020896658587,37.22449464818295,0.03952334930523438,471.1917088031769,197.81658673286438,784.9913558959961,22380,2759,19621,19621,0,9,3039000.0
3039,3039999,21.52026205590695,37.22851273333034,0.03955752534067747,471.4285976886749,197.88176798820496,785.2529983520508,22392,2761,19631,19631,0,9,3040000.0
3040,3040999,21.521956059107872,37.23059023317985,0.039605345498599176,471.60988783836365,197.94575309753418,785.4496002197266,22408,2762,19646,19646,0,9,3041000.0
3041,3041999,21.52500522505265,37.237601374662596,0.03963598514257083,471.7336196899414,198.00933599472046,785.6536254882812,22409,2762,19647,19647,0,9,3042000.0
3042,3042999,21.529487114350417,37.25291865039903,0.03965992357465453,472.0200321674347,198.07356095314026,785.6931381225586,22425,2765,19660,19660,0,9,3043000.0
3043,3043999,21.533739692974304,37.261821893057245,0.039701021516393986,472.15755796432495,198.1387186050415,785.9574089050293,22430,2765,19665,19665,0,9,3044000.0
3044,3044999,21.537632678862334,37.267616812394174,0.03975034494596841,472.28334760665894,198.20220923423767,786.1372375488281,22432,2765,19667,19667,0,9,3045000.0
3045,3045999,21.541695234344967,37.272399377426225,0.039821072420078596,472.40274596214294,198.26589441299438,786.3509178161621,22434,2765,19669,19669,0,9,3046000.0
3046,3046999,21.546141981987958,37.27853265018423,0.0398788939330158,472.5758898258209,198.33017706871033,786.4977989196777,22441,2766,19675,19675,0,9,3047000.0
3047,3047999,21.55014269314707,37.28595502977711,0.039907217093751,472.75752449035645,198.39426445960999,786.709300994873,22446,2767,19679,19679,0,9,3048000.0
3048,3048999,21.549990150659088,37.284807850311324,0.039905894063787084,472.98685121536255,198.46263480186462,787.1525535583496,22470,2769,19701,19701,0,9,3049000.0
3049,3049999,21.548385593633515,37.28368139853777,0.03989476399976244,473.1138014793396,198.5273458957672,787.4937553405762,22472,2769,19703,19703,0,9,3050000.0
3050,3050999,21.54681009462667,37.282571746433995,0.0398969684251721,473.2889196872711,198.5913863182068,787.6901206970215,22476,2770,19706,19706,0,9,3051000.0
3051,3051999,21.545479549132597,37.28013666730015,0.03989351669424546,473.4156632423401,198.6554524898529,787.8939933776855,22477,2770,19707,19707,0,9,3052000.0
3052,3052999,21.544115778993444,37.27859349755412,0.039888779007399844,473.5474865436554,198.71948647499084,788.0290031433105,22477,2770,19707,19707,0,9,3053000.0
3053,3053999,21.54273610360281,37.27571798272879,0.03988837782653232,473.6774113178253,198.78412437438965,788.1870727539062,22479,2770,19709,19709,0,9,3054000.0
3054,3054999,21.541725775030045,37.27380556661946,0.039883321926401205,473.8586950302124,198.84816074371338,788.239559173584,22486,2771,19715,19715,0,9,3055000.0
3055,3055999,21.540962660743585,37.2715391643825,0.03988298563317316,473.99227356910706,198.91357374191284,788.355827331543,22486,2771,19715,19715,0,9,3056000.0
3056,3056999,21.540481537448215,37.26986194479766,0.039882046591070086,474.1790380477905,198.97822666168213,788.4437065124512,22494,2772,19722,19722,0,9,3057000.0
3057,3057999,21.54047763457227,37.269177526498936,0.039877322943559945,474.34984135627747,199.04213976860046,788.5986328125,22501,2773,19728,19728,0,9,3058000.0
3058,3058999,21.54129981980261,37.26934456773481,0.03988602183875134,474.4824469089508,199.10568809509277,788.7036323547363,22501,2773,19728,19728,0,9,3059000.0
3059,3059999,21.54414279637404,37.27438548746641,0.039909345768734394,474.623717546463,199.1702790260315,788.9150886535645,22503,2773,19730,19730,0,9,3060000.0
3060,3060999,21.54652141256625,37.278371501325154,0.0399325526158304,474.80149126052856,199.23407173156738,788.987678527832,22505,2774,19731,19731,0,9,3061000.0
3061,3061999,21.5493023931791,37.28307094236683,0.03995267189412888,474.97473907470703,199.2976622581482,789.0704231262207,22507,2775,19732,19732,0,9,3062000.0
3062,3062999,21.55312397983819,37.29276498280391,0.03997509505026031,475.10126066207886,199.36131262779236,789.2351837158203,22508,2775,19733,19733,0,9,3063000.0
3063,3063999,21.55855846855473,37.30467716131102,0.04002500425224431,475.247358083725,199.42530465126038,789.3957901000977,22508,2775,19733,19733,0,9,3064000.0
3064,3064999,21.56331166253163,37.31339721166239,0.040056571748874226,475.41834592819214,199.48866844177246,789.4882469177246,22516,2776,19740,19740,0,9,3065000.0
3065,3065999,21.56738432103346,37.319907441536415,0.040081687319532544,475.64749908447266,199.55257487297058,789.5669746398926,22520,2778,19742,19742,0,9,3066000.0
3066,3066999,21.571333630009285,37.32592020046222,0.04012382823998395,475.781254529953,199.61606311798096,789.7288360595703,22521,2778,19743,19743,0,9,3067000.0
3067,3067999,21.574737251025763,37.330114250891896,0.04016166912618291,475.908659696579,199.68017315864563,789.8755264282227,22521,2778,19743,19743,0,9,3068000.0
3068,3068999,21.576012050128398,37.330822035257135,0.04015016394112736,476.08590388298035,199.74335265159607,790.0111923217773,22552,2779,19773,19773,0,9,3069000.0
3069,3069999,21.574524259600608,37.33062748457287,0.04014928381168248,476.2088236808777,199.80724835395813,790.4054260253906,22559,2779,19780,19780,0,9,3070000.0
3070,3070999,21.572629230650158,37.328842824312666,0.04015064051502515,476.38917994499207,199.8715558052063,790.5781288146973,22566,2780,19786,19786,0,9,3071000.0
3071,3071999,21.570989300688048,37.32665903209785,0.04014203814370132,476.5673985481262,199.93658351898193,790.7322616577148,22574,2781,19793,19793,0,9,3072000.0
3072,3072999,21.569623535148498,37.326103888753934,0.04012636131216052,476.69659399986267,200.00030732154846,790.9184455871582,22574,2781,19793,19793,0,9,3073000.0
3073,3073999,21.567700603194112,37.32243384926797,0.040127149644438864,476.8289351463318,200.06430625915527,791.0993194580078,22574,2781,19793,19793,0,9,3074000.0
3074,3074999,21.566302170884747,37.32131345040504,0.040128742479827784,477.0590054988861,200.12857365608215,791.1493110656738,22596,2783,19813,19813,0,9,3075000.0
3075,3075999,21.565067549352833,37.3191981092037,0.040113598685141305,477.1819598674774,200.19282031059265,791.2831192016602,22597,2783,19814,19814,0,9,3076000.0
3076,3076999,21.564077114051646,37.31702687696995,0.040102457005266046,477.3135144710541,200.25690269470215,791.3862686157227,22597,2783,19814,19814,0,9,3077000.0
3077,3077999,21.56297155165966,37.314675865763,0.04009854215713349,477.4466390609741,200.32070207595825,791.4904556274414,22597,2783,19814,19814,0,9,3078000.0
3078,3078999,21.562650867567022,37.3141098754599,0.04009053077653568,477.5814175605774,200.38435292243958,791.5869827270508,22597,2783,19814,19814,0,9,3079000.0
3079,3079999,21.562344220486207,37.31294222542036,0.04009491769987428,477.773565530777,200.4487066268921,791.6527938842773,22614,2784,19830,19830,0,9,3080000.0
3080,3080999,21.56249155938689,37.31255636367564,0.040095772847256406,477.9539177417755,200.51234126091003,791.6875801086426,22619,2785,19834,19834,0,9,3081000.0
3081,3081999,21.562066743562347,37.3110915977414,0.04009165699319861,478.14335203170776,200.57799577713013,791.8291625976562,22633,2786,19847,19847,0,9,3082000.0
3082,3082999,21.562568627019502,37.31148665653501,0.04009944230385243,478.2725865840912,200.6418216228485,792.0346641540527,22633,2786,19847,19847,0,9,3083000.0
3083,3083999,21.562885210483554,37.31117432548359,0.0401042649724479,478.4060583114624,200.70521926879883,792.1643829345703,22634,2786,19848,19848,0,9,3084000.0
3084,3084999,21.56318357334452,37.31008386315856,0.04010651283452049,478.5914626121521,200.768634557724,792.2253875732422,22641,2787,19854,19854,0,9,3085000.0
3085,3085999,21.564160599795695,37.3101439562325,0.04009863309318673,478.77611684799194,200.83301734924316,792.3654518127441,22647,2788,19859,19859,0,9,3086000.0
3086,3086999,21.564471825628203,37.30930325045049,0.040096916280335404,478.99186420440674,200.89786338806152,792.4717559814453,22693,2790,19903,19903,0,9,3087000.0
3087,3087999,21.564257636242807,37.30734069942642,0.040091329500483,479.16334772109985,200.96139001846313,792.5339813232422,22697,2791,19906,19906,0,9,3088000.0
3088,3088999,21.563897594456183,37.30512111720466,0.04008383144965377,479.3443093299866,201.0253381729126,792.6644973754883,22704,2792,19912,19912,0,9,3089000.0
3089,3089999,21.562706753994703,37.30168959556425,0.04007735047162464,479.53157091140747,201.09006452560425,793.3106460571289,22732,2793,19939,19939,0,9,3090000.0
3090,3090999,21.56059006046161,37.29853753582399,0.0400679990893521,479.652414560318,201.1544051170349,793.7675323486328,22738,2793,19945,19945,0,9,3091000.0
3091,3091999,21.55817769065794,37.29496060884929,0.040072792676358104,480.0900948047638,201.22031235694885,793.8499145507812,22807,2799,20008,20008,0,9,3092000.0
3092,3092999,21.55633523944636,37.29353232344053,0.04006895489192486,480.26622772216797,201.28503966331482,794.1783714294434,22823,2800,20023,20023,0,9,3093000.0
3093,3093999,21.554153481639357,37.29008408026365,0.04006727509651298,480.510400056839,201.35015964508057,794.326473236084,22845,2802,20043,20043,0,9,3094000.0
3094,3094999,21.55212416440922,37.28718823404709,0.040053085777224884,480.6377122402191,201.41528391838074,794.5871238708496,22845,2802,20043,20043,0,9,3095000.0
3095,3095999,21.54993671258555,37.283521466089034,0.0400391496204936,480.7658278942108,201.47986912727356,794.9210052490234,22847,2802,20045,20045,0,9,3096000.0
3096,3096999,21.54871182940496,37.28293453472619,0.04000575207642598,480.8837330341339,201.54387974739075,795.1800804138184,22848,2802,20046,20046,0,9,3097000.0
3097,3097999,21.54746687523765,37.28165831038032,0.040001959840252455,481.072731256485,201.60901427268982,795.4027214050293,22853,2803,20050,20050,0,9,3098000.0
3098,3098999,21.546396050822402,37.27930599173677,0.03999508543675645,481.30067014694214,201.67383933067322,795.5517272949219,22878,2805,20073,20073,0,9,3099000.0
3099,3099999,21.545330883059982,37.2772361762082,0.03997495908336457,481.4770543575287,201.7382366657257,795.804801940918,22880,2806,20074,20074,0,9,3100000.0
3100,3100999,21.5449555900313,37.27658632046911,0.03997031800502948,481.65916085243225,201.80292201042175,796.0076560974121,22882,2807,20075,20075,0,9,3101000.0
3101,3101999,21.545173994427557,37.27772394602572,0.03996207132530705,481.8379399776459,201.86712384223938,796.2437858581543,22899,2808,20091,20091,0,9,3102000.0
3102,3102999,21.54568279005642,37.27808669020606,0.03995236888402365,482.01986932754517,201.93717288970947,796.4848518371582,22901,2809,20092,20092,0,9,3103000.0
3103,3103999,21.546086081188577,37.27873186508213,0.039931320751764976,482.1987943649292,202.0021951198578,796.6737174987793,22906,2810,20096,20096,0,9,3104000.0
3104,3104999,21.54628566492497,37.27806289771776,0.03990799102067977,482.52524280548096,202.06713223457336,796.7756538391113,22924,2814,20110,20110,0,9,3105000.0
3105,3105999,21.54718574410782,37.27882843478795,0.03989689791881135,482.7563545703888,202.13188457489014,797.0035972595215,22929,2816,20113,20113,0,9,3106000.0
3106,3106999,21.547897221634788,37.27927573693126,0.039883143819904654,482.98121070861816,202.19839763641357,797.2327575683594,22940,2818,20122,20122,0,9,3107000.0
3107,3107999,21.54925449999394,37.281114564349444,0.03987470396595372,483.1649212837219,202.26310014724731,797.5003509521484,22944,2819,20125,20125,0,9,3108000.0
3108,3108999,21.55025475432108,37.28138939913135,0.03986809502327793,483.2928235530853,202.32876920700073,797.8555068969727,22946,2819,20127,20127,0,9,3109000.0
3109,3109999,21.550748895895648,37.28055730811575,0.03986436326768317,483.52038979530334,202.39304494857788,798.1192245483398,22953,2821,20132,20132,0,9,3110000.0
3110,3110999,21.54922352137019,37.27842886016258,0.03985346558796954,483.6949214935303,202.4579336643219,798.6954154968262,22971,2822,20149,20149,0,9,3111000.0
3111,3111999,21.54669628786754,37.274889189088526,0.03985432159609181,483.9220504760742,202.5227620601654,799.0995712280273,23041,2824,20217,20217,0,9,3112000.0
3112,3112999,21.54450195297235,37.27220399194827,0.03985831385407923,484.1584756374359,202.5879361629486,799.30029296875,23063,2826,20237,20237,0,9,3113000.0
3113,3113999,21.5422626609423,37.268782524798915,0.03986361226127477,484.3343334197998,202.65254664421082,799.4936752319336,23065,2827,20238,20238,0,9,3114000.0
3114,3114999,21.540047854851483,37.26504107225968,0.03986706878919344,484.4606943130493,202.7165825366974,799.6770515441895,23065,2827,20238,20238,0,9,3115000.0
3115,3115999,21.538273785684677,37.26339464351439,0.03986075491271701,484.6874794960022,202.78109526634216,799.7999076843262,23074,2829,20245,20245,0,9,3116000.0
3116,3116999,21.53670730507081,37.26141593461408,0.03986341540705918,484.8709828853607,202.84519386291504,799.9459915161133,23076,2830,20246,20246,0,9,3117000.0
3117,3117999,21.53524068510327,37.2589573996451,0.039871489942376215,485.0500602722168,202.90947651863098,800.1027412414551,23085,2831,20254,20254,0,9,3118000.0
3118,3118999,21.534096106562508,37.2570986074134,0.03987029456960678,485.2321979999542,202.97356939315796,800.2284812927246,23091,2832,20259,20259,0,9,3119000.0
3119,3119999,21.533434704127565,37.25585946757071,0.039879215500479015,485.36477303504944,203.03755474090576,800.3725700378418,23091,2832,20259,20259,0,9,3120000.0
3120,3120999,21.533435736075585,37.2568265577082,0.03987886124743534,485.5480237007141,203.10146307945251,800.4747009277344,23096,2833,20263,20263,0,9,3121000.0
3121,3121999,21.53328913512075,37.25630868836651,0.03988630833344986,485.7248122692108,203.16684556007385,800.5992393493652,23102,2834,20268,20268,0,9,3122000.0
3122,3122999,21.533543889925376,37.257403202684046,0.03988659069645428,485.9121165275574,203.23122119903564,800.7072257995605,23104,2835,20269,20269,0,9,3123000.0
3123,3123999,21.534188008165717,37.259044681449815,0.039888659235045476,486.0347738265991,203.2947883605957,800.8276443481445,23104,2835,20269,20269,0,9,3124000.0
3124,3124999,21.5348944114389,37.260215848263066,0.03988234330145868,486.21120977401733,203.35865449905396,800.9415550231934,23106,2836,20270,20270,0,9,3125000.0
3125,3125999,21.535877685054484,37.2620129422059,0.03988709660107348,486.44349479675293,203.42276740074158,801.0673027038574,23139,2838,20301,20301,0,9,3126000.0
3126,3126999,21.5363509264837,37.26198713366985,0.03988263910364498,486.78491139411926,203.48877835273743,801.123607635498,23198,2842,20356,20356,0,9,3127000.0
3127,3127999,21.536878555119745,37.26149399371529,0.039883761916264526,487.12419605255127,203.55366492271423,801.2649421691895,23214,2846,20368,20368,0,9,3128000.0
3128,3128999,21.537614161854492,37.26144670587552,0.03987660355148159,487.2995958328247,203.61764812469482,801.487117767334,23220,2847,20373,20373,0,9,3129000.0
3129,3129999,21.537537777173014,37.26014238132714,0.03987573945602374,487.43028116226196,203.68251538276672,801.7745742797852,23222,2847,20375,20375,0,9,3130000.0
3130,3130999,21.536773187385368,37.2578615027864,0.039875653700094826,487.55327320098877,203.7458372116089,802.0309982299805,23225,2847,20378,20378,0,9,3131000.0
3131,3131999,21.535204494204056,37.259536253803816,0.03986466028732072,487.72343587875366,203.8107488155365,802.7284889221191,23245,2848,20397,20397,0,9,3132000.0
3132,3132999,21.53230467161198,37.255868589779105,0.03987008324506536,487.9127244949341,203.87647938728333,803.0669746398926,23265,2849,20416,20416,0,9,3133000.0
3133,3133999,21.52962361301924,37.25252443153988,0.03987412428945336,488.03615403175354,203.94036078453064,803.3230895996094,23266,2849,20417,20417,0,9,3134000.0
3134,3134999,21.527563842852047,37.251352441889075,0.039868379762203365,488.16234707832336,204.00481271743774,803.5961227416992,23268,2849,20419,20419,0,9,3135000.0
3135,3135999,21.526235326069852,37.25025445164001,0.039853550659146086,488.2861521244049,204.0686490535736,803.7912521362305,23268,2849,20419,20419,0,9,3136000.0
3136,3136999,21.525005496476133,37.248952440552785,0.039840796786414945,488.45973086357117,204.1332459449768,803.9539794921875,23273,2850,20423,20423,0,9,3137000.0
3137,3137999,21.52392769866455,37.247592371014896,0.039822756547830185,488.58555006980896,204.19745302200317,804.1621208190918,23274,2850,20424,20424,0,9,3138000.0
3138,3138999,21.52318548691144,37.24734425173867,0.03980115140705032,488.8226590156555,204.26314568519592,804.2347869873047,23296,2852,20444,20444,0,9,3139000.0
3139,3139999,21.523329559582134,37.247714114951954,0.03977453213939608,489.01255798339844,204.32748007774353,804.4501762390137,23301,2853,20448,20448,0,9,3140000.0
3140,3140999,21.524815148050937,37.25609820413857,0.0397299872604967,489.21169209480286,204.39223313331604,804.6688652038574,23306,2854,20452,20452,0,9,3141000.0
3141,3141999,21.528622587130144,37.26550142953094,0.03969292368445798,489.34443759918213,204.45627522468567,804.8976364135742,23306,2854,20452,20452,0,9,3142000.0
3142,3142999,21.53543397039347,37.28261263128959,0.039633014553862256,489.4820897579193,204.52114629745483,805.1018218994141,23307,2854,20453,20453,0,9,3143000.0
3143,3143999,21.543262750042132,37.314034741452176,0.03959424197961747,489.61398696899414,204.58533191680908,805.3303489685059,23308,2854,20454,20454,0,9,3144000.0
3144,3144999,21.551972985336533,37.34247251249568,0.03956831362379787,489.73975253105164,204.64920282363892,805.5684127807617,23310,2854,20456,20456,0,9,3145000.0
3145,3145999,21.563088347370332,37.380999716194346,0.03949322988168169,489.8652534484863,204.7130606174469,805.835506439209,23310,2854,20456,20456,0,9,3146000.0
3146,3146999,21.576449346121503,37.42486948908678,0.039455996158952455,490.05013847351074,204.7775661945343,806.0634498596191,23318,2855,20463,20463,0,9,3147000.0
3147,3147999,21.588732873642797,37.46470112741299,0.03945891130181878,490.29026532173157,204.84210729599,806.2590026855469,23339,2857,20482,20482,0,9,3148000.0
3148,3148999,21.59949752336521,37.493203087168084,0.039461011587048955,490.42034888267517,204.9062533378601,806.4394454956055,23339,2857,20482,20482,0,9,3149000.0
3149,3149999,21.610662572000898,37.524261710847256,0.0395091047926015,490.55728554725647,204.9703712463379,806.6838645935059,23341,2857,20484,20484,0,9,3150000.0
3150,3150999,21.622005338813896,37.55446014237986,0.03953996491445444,490.7354049682617,205.03443098068237,806.8751182556152,23359,2858,20501,20501,0,9,3151000.0
3151,3151999,21.628613537233573,37.57213902758539,0.03950364127840411,490.92150378227234,205.098876953125,807.4223480224609,23371,2859,20512,20512,0,9,3152000.0
3152,3152999,21.627600674728562,37.57666723583915,0.0394786884706857,491.0525677204132,205.16354632377625,807.9398422241211,23382,2859,20523,20523,0,9,3153000.0
3153,3153999,21.62606458498326,37.57535128286534,0.0394765473962827,491.22462272644043,205.22815561294556,808.2072677612305,23387,2860,20527,20527,0,9,3154000.0
3154,3154999,21.62485945755837,37.57469859180091,0.039468760411475845,491.40513944625854,205.29274439811707,808.3882522583008,23406,2861,20545,20545,0,9,3155000.0
3155,3155999,21.62346243242564,37.57343562696587,0.03946217682944686,491.5312805175781,205.3580870628357,808.606575012207,23406,2861,20545,20545,0,9,3156000.0
3156,3156999,21.622185716512227,37.57186627655941,0.039458163904627974,491.65590381622314,205.42299127578735,808.7728652954102,23407,2861,20546,20546,0,9,3157000.0
3157,3157999,21.620556081608,37.5690955827533,0.03945802988555036,491.78567695617676,205.48700308799744,808.956428527832,23408,2861,20547,20547,0,9,3158000.0
3158,3158999,21.619819483854915,37.57319619986521,0.039436926607564704,491.91830039024353,205.55112385749817,809.156494140625,23409,2861,20548,20548,0,9,3159000.0
3159,3159999,21.61839044700224,37.570841152921716,0.039432796662859815,492.04034447669983,205.61609268188477,809.3290328979492,23410,2861,20549,20549,0,9,3160000.0
3160,3160999,21.617500586972,37.56925679806584,0.039416293131452895,492.17562532424927,205.6806538105011,809.4795837402344,23410,2861,20549,20549,0,9,3161000.0
3161,3161999,21.616343498158404,37.567458127078844,0.03940917187056292,492.3020238876343,205.74496412277222,809.6204147338867,23410,2861,20549,20549,0,9,3162000.0
3162,3162999,21.615880676457735,37.56731502418048,0.03939625359720922,492.43966484069824,205.8089485168457,809.7637596130371,23411,2861,20550,20550,0,9,3163000.0
3163,3163999,21.615576785136724,37.56697865358249,0.03937976550683142,492.67324447631836,205.87358808517456,809.9091758728027,23421,2863,20558,20558,0,9,3164000.0
3164,3164999,21.61538790582522,37.56636561204007,0.03937385686392736,492.7992675304413,205.93880319595337,810.1499137878418,23421,2863,20558,20558,0,9,3165000.0
3165,3165999,21.61498315825982,37.56479752489612,0.03937168916417344,492.97997879981995,206.00349855422974,810.2919044494629,23426,2864,20562,20562,0,9,3166000.0
3166,3166999,21.61457457616957,37.56288402658559,0.03936234474069,493.15435218811035,206.0677011013031,810.4765396118164,23433,2865,20568,20568,0,9,3167000.0
3167,3167999,21.614261301891723,37.561571463122945,0.03936389567906429,493.3835427761078,206.13205671310425,810.6355590820312,23444,2867,20577,20577,0,9,3168000.0
3168,3168999,21.614116915255753,37.56000655162344,0.03935647433847822,493.5158326625824,206.19616723060608,810.9419937133789,23448,2867,20581,20581,0,9,3169000.0
3169,3169999,21.613054695832634,37.55861545548138,0.03935564909720812,493.70563793182373,206.26594710350037,811.1909103393555,23455,2868,20587,20587,0,9,3170000.0
3170,3170999,21.611270240673306,37.55563931334607,0.03935716894198693,493.82691502571106,206.33094000816345,811.8083610534668,23465,2868,20597,20597,0,9,3171000.0
3171,3171999,21.608801758611747,37.552289926786905,0.0393653864002349,493.9561221599579,206.39564752578735,812.1447525024414,23467,2868,20599,20599,0,9,3172000.0
3172,3172999,21.606378475000465,37.54892096356523,0.03937721020369778,494.09061646461487,206.46000695228577,812.3664741516113,23468,2868,20600,20600,0,9,3173000.0
3173,3173999,21.603488898365626,37.544385497163944,0.039394419392813074,494.21714973449707,206.5242862701416,812.533763885498,23468,2868,20600,20600,0,9,3174000.0
3174,3174999,21.60115166716529,37.54057721097175,0.039401068121178606,494.4592533111572,206.58900499343872,812.5992889404297,23474,2870,20604,20604,0,9,3175000.0
3175,3175999,21.598807884672684,37.53773476016867,0.0394082264894241,494.6495728492737,206.65462946891785,812.7030143737793,23478,2871,20607,20607,0,9,3176000.0
3176,3176999,21.59616568434771,37.533693902946794,0.03941610830456177,494.8329977989197,206.71924090385437,812.8056564331055,23480,2872,20608,20608,0,9,3177000.0
3177,3177999,21.593819352333018,37.52982643702231,0.03941825787506725,494.96335911750793,206.78314924240112,812.9185333251953,23480,2872,20608,20608,0,9,3178000.0
3178,3178999,21.59169675968699,37.52758149603598,0.03941314587737099,495.09492015838623,206.8483440876007,813.0555419921875,23481,2872,20609,20609,0,9,3179000.0
3179,3179999,21.58973550071099,37.52472289076466,0.039412029359851664,495.2776231765747,206.91288948059082,813.1134605407715,23484,2873,20611,20611,0,9,3180000.0
3180,3180999,21.587657801569176,37.52119275902221,0.03941963663498638,495.40022110939026,206.97726583480835,813.236888885498,23484,2873,20611,20611,0,9,3181000.0
3181,3181999,21.585748839180294,37.51785995604029,0.03942179182291383,495.69053411483765,207.0422863960266,813.2127799987793,23510,2876,20634,20634,0,9,3182000.0
3182,3182999,21.58422007121357,37.51458950957916,0.039418718248268925,495.83803272247314,207.106586933136,813.3280410766602,23511,2876,20635,20635,0,9,3183000.0
3183,3183999,21.58338749305496,37.512825277012894,0.03941109957258093,495.96274757385254,207.1705560684204,813.4771270751953,23511,2876,20635,20635,0,9,3184000.0
3184,3184999,21.583195464903827,37.51467646968348,0.039398316485941276,496.1440329551697,207.23465156555176,813.5341300964355,23513,2877,20636,20636,0,9,3185000.0
3185,3185999,21.583272805297614,37.5149212471819,0.03939404761085841,496.2776312828064,207.29938387870789,813.6544799804688,23513,2877,20636,20636,0,9,3186000.0
3186,3186999,21.58311090138952,37.514243456859255,0.03939328131101105,496.3950629234314,207.36331987380981,813.8460235595703,23515,2877,20638,20638,0,9,3187000.0
3187,3187999,21.58350121715116,37.514671658055576,0.03938975863016192,496.5224678516388,207.42823791503906,814.0196914672852,23516,2877,20639,20639,0,9,3188000.0
3188,3188999,21.583957890704404,37.51525593844308,0.039382994511303115,496.64282298088074,207.492329120636,814.1662101745605,23517,2877,20640,20640,0,9,3189000.0
3189,3189999,21.584048787883006,37.514280551216984,0.03937455650742261,496.7782213687897,207.55627489089966,814.3880996704102,23519,2877,20642,20642,0,9,3190000.0
3190,3190999,21.58340309190948,37.51380747928324,0.039364479409309205,496.9527289867401,207.61991930007935,814.7693710327148,23530,2878,20652,20652,0,9,3191000.0
3191,3191999,21.58082961326261,37.50950665741605,0.03936837343731314,497.0763728618622,207.684654712677,815.0766181945801,23534,2878,20656,20656,0,9,3192000.0
3192,3192999,21.578542014783018,37.50661938383612,0.03937436637204461,497.21166372299194,207.75003862380981,815.3252334594727,23536,2878,20658,20658,0,9,3193000.0
3193,3193999,21.576729954004186,37.50397375745608,0.03937378214261189,497.3998918533325,207.81505584716797,815.4324111938477,23553,2879,20674,20674,0,9,3194000.0
3194,3194999,21.574736424736475,37.501670851672266,0.039370190373492764,497.5310754776001,207.87975811958313,815.602466583252,23553,2879,20674,20674,0,9,3195000.0
3195,3195999,21.57267757889631,37.499751911652424,0.03936433336370104,497.6610667705536,207.94423937797546,815.7586669921875,23553,2879,20674,20674,0,9,3196000.0
3196,3196999,21.570636100952562,37.496026908357514,0.03935861528121187,497.8001444339752,208.0087971687317,815.9143524169922,23554,2879,20675,20675,0,9,3197000.0
3197,3197999,21.568660667528434,37.492460063764035,0.039357901397110706,497.97187852859497,208.07362842559814,815.9693298339844,23556,2880,20676,20676,0,9,3198000.0
3198,3198999,21.567182616368044,37.49101963123008,0.03935138871555466,498.1070625782013,208.13813185691833,816.140266418457,23556,2880,20676,20676,0,9,3199000.0
3199,3199999,21.565544226941466,37.48770376895031,0.039349388136544095,498.24592757225037,208.20244145393372,816.3062171936035,23556,2880,20676,20676,0,9,3200000.0
3200,3200999,21.564417140749295,37.486048055025684,0.039344246560138796,498.3679528236389,208.26632142066956,816.4111442565918,23556,2880,20676,20676,0,9,3201000.0
3201,3201999,21.563897343583506,37.48572754959271,0.039341504049993925,498.5585443973541,208.33081102371216,816.4961242675781,23559,2881,20678,20678,0,9,3202000.0
3202,3202999,21.56318152768407,37.484802816593685,0.0393509012555896,498.6977183818817,208.39654874801636,816.6500053405762,23560,2881,20679,20679,0,9,3203000.0
3203,3203999,21.564446974789842,37.48862622152388,0.03937993482379776,498.83480310440063,208.4612009525299,816.8807983398438,23561,2881,20680,20680,0,9,3204000.0
3204,3204999,21.56693275857482,37.49444080925925,0.03944047206291379,498.96546816825867,208.5257477760315,817.1940040588379,23565,2881,20684,20684,0,9,3205000.0
3205,3205999,21.569573892020376,37.50408787051742,0.03949666058927048,499.1046884059906,208.5901997089386,817.3958320617676,23566,2881,20685,20685,0,9,3206000.0
3206,3206999,21.573319810754636,37.51138971641283,0.03954820009036353,499.29095363616943,208.65576243400574,817.5628318786621,23569,2882,20687,20687,0,9,3207000.0
3207,3207999,21.577657564638997,37.519382472109505,0.039599897218032254,499.47113847732544,208.7202341556549,817.7351036071777,23573,2883,20690,20690,0,9,3208000.0
3208,3208999,21.581756230059703,37.5272440898204,0.0396764478229914,499.6012089252472,208.7841022014618,817.9722633361816,23576,2883,20693,20693,0,9,3209000.0
3209,3209999,21.58554757259668,37.535318672787774,0.03971229696171508,499.7451882362366,208.84781169891357,818.1217384338379,23576,2883,20693,20693,0,9,3210000.0
3210,3210999,21.589824336775063,37.543187879583456,0.0397918005784299,499.9728362560272,208.9125325679779,818.2558326721191,23607,2885,20722,20722,0,9,3211000.0
3211,3211999,21.59279369312093,37.555039307947936,0.03981746637618433,500.0990037918091,208.97645807266235,818.7699813842773,23619,2885,20734,20734,0,9,3212000.0
3212,3212999,21.590979140871404,37.55275167937092,0.03980337058865391,500.2270395755768,209.04108905792236,819.1469459533691,23627,2885,20742,20742,0,9,3213000.0
3213,3213999,21.588845705909026,37.54945434948737,0.03980027455304591,500.367835521698,209.10585284233093,819.3957672119141,23627,2885,20742,20742,0,9,3214000.0
3214,3214999,21.58696065096459,37.546137881229136,0.03979582173800278,500.4963171482086,209.17025542259216,819.5632667541504,23627,2885,20742,20742,0,9,3215000.0
3215,3215999,21.585207280573904,37.5429668823025,0.039796117386204144,500.62487864494324,209.23430347442627,819.7082214355469,23627,2885,20742,20742,0,9,3216000.0
3216,3216999,21.583812369279777,37.54092495716949,0.03978404266691582,500.82090401649475,209.29961133003235,819.8007049560547,23629,2886,20743,20743,0,9,3217000.0
3217,3217999,21.582418550786915,37.539171859989324,0.03978013688376969,500.94923853874207,209.363849401474,819.956428527832,23630,2886,20744,20744,0,9,3218000.0
3218,3218999,21.58125939233514,37.53768335977522,0.03977429374097963,501.07267141342163,209.4280412197113,820.0838356018066,23630,2886,20744,20744,0,9,3219000.0
3219,3219999,21.5807357059759,37.53771179296072,0.039772933616402883,501.26092863082886,209.49315857887268,820.1470794677734,23635,2887,20748,20748,0,9,3220000.0
3220,3220999,21.580885663755325,37.54146556534852,0.03977955802091271,501.4966866970062,209.55806350708008,820.2407722473145,23656,2889,20767,20767,0,9,3221000.0
3221,3221999,21.582050496305904,37.545998301993784,0.03978500523293893,501.62358117103577,209.6220121383667,820.3297119140625,23656,2889,20767,20767,0,9,3222000.0
3222,3222999,21.58550296836335,37.55648566247102,0.03981867052889987,501.7598855495453,209.68634462356567,820.469913482666,23657,2889,20768,20768,0,9,3223000.0
3223,3223999,21.58937852398047,37.57005988729613,0.039853536007487644,501.93989610671997,209.75014686584473,820.5158958435059,23663,2890,20773,20773,0,9,3224000.0
3224,3224999,21.594947049949347,37.58568224154708,0.039968661688354,502.06342339515686,209.81430196762085,820.7015342712402,23665,2890,20775,20775,0,9,3225000.0
3225,3225999,21.60156055684474,37.60440703583452,0.040087425083686234,502.1910071372986,209.87844061851501,820.900218963623,23666,2890,20776,20776,0,9,3226000.0
3226,3226999,21.60745926595677,37.620513342615475,0.04015486301973292,502.3173289299011,209.94252276420593,821.0666275024414,23667,2890,20777,20777,0,9,3227000.0
3227,3227999,21.614991633089478,37.64169116413363,0.04027439533454935,502.4494230747223,210.00636625289917,821.2181930541992,23668,2890,20778,20778,0,9,3228000.0
3228,3228999,21.62220648585658,37.66270456355389,0.04034473642070624,502.6299879550934,210.0707938671112,821.3078918457031,23671,2891,20780,20780,0,9,3229000.0
3229,3229999,21.629947419790938,37.682056108666124,0.0404313895399907,502.8095922470093,210.13509559631348,821.4610481262207,23677,2892,20785,20785,0,9,3230000.0
3230,3230999,21.6396379863569,37.70928956901169,0.04056732447989164,502.93704986572266,210.19884085655212,821.6424255371094,23678,2892,20786,20786,0,9,3231000.0
3231,3231999,21.644907372252835,37.72116339158524,0.0406068047308189,503.339049577713,210.2647659778595,821.6468849182129,23716,2897,20819,20819,0,9,3232000.0
3232,3232999,21.645534110471104,37.72259450378412,0.04059857867165717,503.51763439178467,210.32962131500244,822.3675117492676,23743,2898,20845,20845,0,9,3233000.0
3233,3233999,21.643828230940986,37.72053706462734,0.04059834111254168,503.65228939056396,210.39436078071594,822.8207130432129,23750,2898,20852,20852,0,9,3234000.0
3234,3234999,21.64244236775895,37.722980787638605,0.040580073171729625,503.8884747028351,210.45956468582153,822.9156112670898,23771,2900,20871,20871,0,9,3235000.0
3235,3235999,21.64135131926134,37.72154695579651,0.040578256831519166,504.01589798927307,210.5249307155609,823.2406845092773,23772,2900,20872,20872,0,9,3236000.0
3236,3236999,21.640068536773587,37.71967946291106,0.040566005420673346,504.30215287208557,210.5907998085022,823.3835983276367,23790,2903,20887,20887,0,9,3237000.0
3237,3237999,21.638706416847686,37.71730201772235,0.04057227769287863,504.4864921569824,210.65608644485474,823.5509185791016,23802,2904,20898,20898,0,9,3238000.0
3238,3238999,21.636840684414356,37.71372885351877,0.04057500622792887,504.6644971370697,210.721355676651,823.7223472595215,23808,2905,20903,20903,0,9,3239000.0
3239,3239999,21.63530070371528,37.71076943740433,0.0405733906072866,504.90399646759033,210.78773713111877,823.9197387695312,23821,2907,20914,20914,0,9,3240000.0
3240,3240999,21.634012830152646,37.70824036197874,0.04057958830868902,505.107070684433,210.85292291641235,824.1169891357422,23826,2908,20918,20918,0,9,3241000.0
3241,3241999,21.63320992509885,37.7062171595522,0.04058350437379166,505.2330005168915,210.91744422912598,824.35791015625,23828,2908,20920,20920,0,9,3242000.0
3242,3242999,21.632416903986755,37.703984387684926,0.04057900540267889,505.3553237915039,210.9811134338379,824.5756797790527,23829,2908,20921,20921,0,9,3243000.0
3243,3243999,21.633105028644643,37.705630180381156,0.040586418000781554,505.4896140098572,211.04577016830444,824.7671356201172,23830,2908,20922,20922,0,9,3244000.0
3244,3244999,21.63402170876593,37.7070046123292,0.04060076136945301,505.72381472587585,211.11083936691284,824.917797088623,23841,2910,20931,20931,0,9,3245000.0
3245,3245999,21.636254620913558,37.712297988567,0.04065093744392889,505.89734172821045,211.17513012886047,825.1164588928223,23844,2911,20933,20933,0,9,3246000.0
3246,3246999,21.639723081217312,37.724037444062525,0.04068853129966621,506.07365441322327,211.24017667770386,825.3107986450195,23850,2912,20938,20938,0,9,3247000.0
3247,3247999,21.644232688902516,37.73309676609528,0.040714234464302224,506.25179958343506,211.30446648597717,825.5176734924316,23856,2913,20943,20943,0,9,3248000.0
3248,3248999,21.64946309178236,37.74401069623241,0.04076336078470644,506.3798134326935,211.36984705924988,825.8846015930176,23859,2913,20946,20946,0,9,3249000.0
3249,3249999,21.653984484480503,37.75357663116629,0.04079893976829496,506.5118110179901,211.43408226966858,826.1262626647949,23859,2913,20946,20946,0,9,3250000.0
3250,3250999,21.65845570222339,37.76051814038681,0.04087152072464906,506.6933228969574,211.4988660812378,826.425537109375,23867,2914,20953,20953,0,9,3251000.0
3251,3251999,21.663935154160193,37.76891919541441,0.04096005159961691,506.87659788131714,211.56414151191711,826.7533645629883,23877,2915,20962,20962,0,9,3252000.0
3252,3252999,21.6667177313104,37.77461727891127,0.040984009575249836,507.0447807312012,211.62803864479065,826.9446334838867,23882,2916,20966,20966,0,9,3253000.0
3253,3253999,21.66497951986303,37.77194483077695,0.04097860329510572,507.35410499572754,211.69412207603455,827.6825218200684,23941,2919,21022,21022,0,9,3254000.0
3254,3254999,21.66295353616776,37.76888057709816,0.0409664836998207,507.48466897010803,211.75954914093018,828.122184753418,23946,2919,21027,21027,0,9,3255000.0
3255,3255999,21.661357664257114,37.769936949669976,0.04096527336248812,507.6169295310974,211.82449555397034,828.4169883728027,23947,2919,21028,21028,0,9,3256000.0
3256,3256999,21.659727468356557,37.76690541983069,0.04096180463964094,507.74391627311707,211.8894543647766,828.7169494628906,23948,2919,21029,21029,0,9,3257000.0
3257,3257999,21.658336832688203,37.76571861944824,0.04095191067939363,507.8877201080322,211.95487761497498,828.9069671630859,23948,2919,21029,21029,0,9,3258000.0
3258,3258999,21.65734951931362,37.764096930289796,0.040940930760651084,508.11988711357117,212.01984429359436,829.0072593688965,23955,2921,21034,21034,0,9,3259000.0
3259,3259999,21.656040048896873,37.76315731600021,0.040926911414721934,508.24853587150574,212.08456420898438,829.24658203125,23956,2921,21035,21035,0,9,3260000.0
3260,3260999,21.654349082641694,37.760175597688836,0.04093234793774325,508.43261337280273,212.1496284008026,829.457893371582,23963,2922,21041,21041,0,9,3261000.0
3261,3261999,21.653086488617266,37.75753778163827,0.04092053663229589,508.61878657341003,212.21463751792908,829.635929107666,23965,2923,21042,21042,0,9,3262000.0
3262,3262999,21.65219284765039,37.755835826363985,0.04091549459544608,508.7998399734497,212.27921223640442,829.8123092651367,23968,2924,21044,21044,0,9,3263000.0
3263,3263999,21.65135964031042,37.755112588264815,0.040901095151043565,508.9352054595947,212.3436725139618,830.0406646728516,23969,2924,21045,21045,0,9,3264000.0
3264,3264999,21.651173584020867,37.75386407792008,0.04091327108058329,509.1142656803131,212.4083411693573,830.1838264465332,23974,2925,21049,21049,0,9,3265000.0
3265,3265999,21.65096845383119,37.752583316463195,0.040939050297715274,509.2461621761322,212.47306108474731,830.432991027832,23976,2925,21051,21051,0,9,3266000.0
3266,3266999,21.651565145386506,37.752427898999215,0.04098378487316379,509.53148889541626,212.5385730266571,830.4738502502441,23989,2928,21061,21061,0,9,3267000.0
3267,3267999,21.65363075490952,37.75502892794736,0.04101673398164274,509.66213297843933,212.6039593219757,830.7375144958496,23990,2928,21062,21062,0,9,3268000.0
3268,3268999,21.65610428560487,37.75792573122366,0.04104867164190629,509.85040807724,212.66950058937073,830.908763885498,23995,2929,21066,21066,0,9,3269000.0
3269,3269999,21.658898767584052,37.76168222483777,0.041094420758821415,510.10296297073364,212.73554706573486,831.039680480957,24007,2931,21076,21076,0,9,3270000.0
3270,3270999,21.66213852459696,37.765665700535614,0.04114144929344021,510.2336513996124,212.80058336257935,831.287425994873,24008,2931,21077,21077,0,9,3271000.0
3271,3271999,21.664672254739585,37.767502434797166,0.041192244457824545,510.3602886199951,212.86466765403748,831.5189895629883,24010,2931,21079,21079,0,9,3272000.0
3272,3272999,21.667370874931027,37.76955439863094,0.04121025293250935,510.4844563007355,212.92951583862305,831.729175567627,24012,2931,21081,21081,0,9,3273000.0
3273,3273999,21.66912648642138,37.77060751727315,0.04123416636688215,510.7141852378845,212.99375820159912,831.819034576416,24020,2933,21087,21087,0,9,3274000.0
3274,3274999,21.66866049247815,37.76851285800913,0.041208737558398933,510.90225982666016,213.05891466140747,832.5399513244629,24057,2934,21123,21123,0,9,3275000.0
3275,3275999,21.667377609864236,37.76584215295929,0.04117518579600721,511.0332338809967,213.12366795539856,833.0400886535645,24064,2934,21130,21130,0,9,3276000.0
3276,3276999,21.6660402955134,37.76318896438746,0.04115202776439275,511.2096667289734,213.1897988319397,833.2415390014648,24069,2935,21134,21134,0,9,3277000.0
3277,3277999,21.66520084601035,37.76069301984113,0.041121163534579064,511.3909704685211,213.25459456443787,833.4510841369629,24074,2936,21138,21138,0,9,3278000.0
3278,3278999,21.66401074270581,37.75733642199211,0.04109848362569013,511.5807378292084,213.31984543800354,833.5797576904297,24079,2937,21142,21142,0,9,3279000.0
3279,3279999,21.66364285162906,37.758716700563134,0.041056767278500605,511.8135781288147,213.38495707511902,833.7326583862305,24090,2939,21151,21151,0,9,3280000.0
3280,3280999,21.66241607706856,37.75592763705717,0.04103416832487661,512.008784532547,213.4500858783722,833.9387245178223,24122,2940,21182,21182,0,9,3281000.0
3281,3281999,21.661326311153623,37.752963696810184,0.04100297813027587,512.1293041706085,213.51538705825806,834.1471939086914,24122,2940,21182,21182,0,9,3282000.0
3282,3282999,21.660326876830574,37.750104434250545,0.040972071862504955,512.3672778606415,213.58082270622253,834.2536659240723,24156,2942,21214,21214,0,9,3283000.0
3283,3283999,21.659702374270786,37.747354361787544,0.04094487660067181,512.5483021736145,213.64656329154968,834.6613693237305,24161,2943,21218,21218,0,9,3284000.0
3284,3284999,21.65935373408125,37.74599237714631,0.04093573779553061,512.729866027832,213.7113139629364,834.8044395446777,24172,2944,21228,21228,0,9,3285000.0
3285,3285999,21.65957892085502,37.74474289705999,0.04091029989736772,512.9151039123535,213.77568554878235,834.9475135803223,24175,2945,21230,21230,0,9,3286000.0
3286,3286999,21.660008746335635,37.743476785230264,0.040909200578030935,513.0967423915863,213.84051275253296,835.1388702392578,24179,2946,21233,21233,0,9,3287000.0
3287,3287999,21.66047758871414,37.74270783269997,0.04091584245077884,513.2274103164673,213.90470051765442,835.3352699279785,24179,2946,21233,21233,0,9,3288000.0
3288,3288999,21.661900747752142,37.74311433600956,0.04089203579848588,513.4134519100189,213.96903347969055,835.4432754516602,24181,2947,21234,21234,0,9,3289000.0
3289,3289999,21.66340587238097,37.74329921928097,0.04086353981734736,513.593106508255,214.03420209884644,835.6525573730469,24188,2948,21240,21240,0,9,3290000.0
3290,3290999,21.664818876119682,37.7428890676459,0.04083558333392223,513.7155139446259,214.0988631248474,835.8182334899902,24188,2948,21240,21240,0,9,3291000.0
3291,3291999,21.666002478434017,37.742114713609524,0.040824870749692765,513.9092671871185,214.17323684692383,835.9475860595703,24194,2949,21245,21245,0,9,3292000.0
3292,3292999,21.66810719572607,37.74491045508343,0.0407877676055316,514.0972578525543,214.23885250091553,836.0623550415039,24200,2950,21250,21250,0,9,3293000.0
3293,3293999,21.669677788566,37.75071081370202,0.04075660642956713,514.2326619625092,214.30326509475708,836.1824836730957,24200,2950,21250,21250,0,9,3294000.0
3294,3294999,21.670352279048664,37.749272688558456,0.04074035153295541,514.4214696884155,214.36808443069458,836.3698577880859,24206,2951,21255,21255,0,9,3295000.0
3295,3295999,21.66967021529846,37.74812794009543,0.040717916711209834,514.6651034355164,214.43314480781555,836.8848075866699,24241,2953,21288,21288,0,9,3296000.0
3296,3296999,21.669844170679827,37.75020412953709,0.04057429601256046,514.7848267555237,214.49783396720886,837.3858299255371,24251,2953,21298,21298,0,9,3297000.0
3297,3297999,21.669409527368465,37.74853984187574,0.04056348097466589,514.9709882736206,214.56354308128357,837.6539192199707,24260,2954,21306,21306,0,9,3298000.0
3298,3298999,21.669217653928282,37.74726769759141,0.04053643080103142,515.213846206665,214.62830758094788,837.7744407653809,24265,2956,21309,21309,0,9,3299000.0
3299,3299999,21.669244435939394,37.746717407017165,0.04051169526960974,515.3470656871796,214.69292974472046,838.0203475952148,24266,2956,21310,21310,0,9,3300000.0
3300,3300999,21.669042099987884,37.74553671790024,0.040498088731358295,515.4716539382935,214.75736093521118,838.2117729187012,24266,2956,21310,21310,0,9,3301000.0
3301,3301999,21.669381750143284,37.745317751463816,0.04047200265326478,515.6507349014282,214.82295846939087,838.4384231567383,24272,2957,21315,21315,0,9,3302000.0
3302,3302999,21.6699372467951,37.744666723374905,0.04043465170007421,515.8019738197327,214.8950662612915,838.6697654724121,24273,2957,21316,21316,0,9,3303000.0
3303,3303999,21.671283407257636,37.74713964741376,0.04043300600456701,515.9229168891907,214.95927119255066,838.817569732666,24273,2957,21316,21316,0,9,3304000.0
3304,3304999,21.672561561840993,37.74937914937004,0.04041360882825695,516.1115503311157,215.0244357585907,838.9558143615723,24275,2958,21317,21317,0,9,3305000.0
3305,3305999,21.67524513192152,37.76017049511618,0.04041605257837366,516.2379388809204,215.08883094787598,839.1651229858398,24275,2958,21317,21317,0,9,3306000.0
3306,3306999,21.679638075070226,37.771602685729334,0.04045916602730926,516.423258304596,215.15455722808838,839.2531814575195,24278,2959,21319,21319,0,9,3307000.0
3307,3307999,21.683535527032923,37.77988574163807,0.040507099854037554,516.6102576255798,215.2194800376892,839.339916229248,24280,2960,21320,21320,0,9,3308000.0
3308,3308999,21.68745543744794,37.78772543645534,0.04059753215008588,516.7451701164246,215.2835488319397,839.497745513916,24280,2960,21320,21320,0,9,3309000.0
3309,3309999,21.69140513269271,37.79477852188797,0.04065307460855638,516.9289770126343,215.34882950782776,839.6539611816406,24282,2961,21321,21321,0,9,3310000.0
3310,3310999,21.694804872241857,37.79980577127545,0.0406954622232214,517.1640400886536,215.4133644104004,839.7399826049805,24287,2963,21324,21324,0,9,3311000.0
3311,3311999,21.699169948735037,37.807718751410675,0.0407372737629107,517.3547029495239,215.4779040813446,839.9787101745605,24293,2964,21329,21329,0,9,3312000.0
3312,3312999,21.702216349673684,37.811878485717685,0.04077257723840866,517.582551240921,215.54265356063843,840.078052520752,24304,2966,21338,21338,0,9,3313000.0
3313,3313999,21.704487398458408,37.81371720044945,0.04079850540360497,517.7148711681366,215.60670709609985,840.2690162658691,24305,2966,21339,21339,0,9,3314000.0
3314,3314999,21.70448950021592,37.814123318797236,0.040790837642505795,517.9911787509918,215.67137455940247,840.6824722290039,24361,2969,21392,21392,0,9,3315000.0
3315,3315999,21.70349240276625,37.813256485367184,0.04078807283915553,518.1221363544464,215.73640775680542,841.1061363220215,24367,2969,21398,21398,0,9,3316000.0
3316,3316999,21.702467634289253,37.81163209443909,0.04078842027935181,518.2645719051361,215.8010995388031,841.375373840332,24369,2969,21400,21400,0,9,3317000.0
3317,3317999,21.70182338291733,37.81193667323751,0.04080355261252544,518.3933515548706,215.86564373970032,841.5578918457031,24369,2969,21400,21400,0,9,3318000.0
3318,3318999,21.702033338612896,37.81196464766658,0.04081897802078749,518.5781645774841,215.93028688430786,841.652717590332,24372,2970,21402,21402,0,9,3319000.0
3319,3319999,21.70228236684338,37.813649312968955,0.040817182197231405,518.714191198349,215.99479222297668,841.8189392089844,24372,2970,21402,21402,0,9,3320000.0
3320,3320999,21.702533114503606,37.81517541573722,0.040820901032851964,518.8899898529053,216.05891346931458,841.9005355834961,24390,2971,21419,21419,0,9,3321000.0
3321,3321999,21.70376162451137,37.81770763036782,0.04081902534896775,519.0739567279816,216.1233286857605,841.9581146240234,24392,2972,21420,21420,0,9,3322000.0
3322,3322999,21.70464523752069,37.818339866792925,0.040829293068325834,519.1969385147095,216.18767523765564,842.1932525634766,24394,2972,21422,21422,0,9,3323000.0
3323,3323999,21.706335171026044,37.82126699026072,0.040839223144169656,519.3240728378296,216.25142121315002,842.3486061096191,24394,2972,21422,21422,0,9,3324000.0
3324,3324999,21.708134621254587,37.824238321072414,0.040856041870270365,519.5237874984741,216.31668519973755,842.4607467651367,24401,2973,21428,21428,0,9,3325000.0
3325,3325999,21.71030862711817,37.82711098264182,0.040873855086451916,519.7123200893402,216.38236165046692,842.5124053955078,24406,2974,21432,21432,0,9,3326000.0
3326,3326999,21.71297004430367,37.8367961017301,0.04087550298909792,519.8971436023712,216.44721913337708,842.5817680358887,24408,2975,21433,21433,0,9,3327000.0
3327,3327999,21.71525195570579,37.842524955623404,0.04090562241013873,520.0731666088104,216.51222109794617,842.7481918334961,24414,2976,21438,21438,0,9,3328000.0
3328,3328999,21.718137172256625,37.85038462013352,0.04092381613454532,520.2515859603882,216.5769431591034,842.8732223510742,24420,2977,21443,21443,0,9,3329000.0
3329,3329999,21.7204995997183,37.853773670744914,0.04093472686016986,520.3836786746979,216.64147901535034,843.0051040649414,24421,2977,21444,21444,0,9,3330000.0
3330,3330999,21.72353904964988,37.86004452128413,0.04095044058223307,520.5847282409668,216.70637726783752,843.1691589355469,24427,2978,21449,21449,0,9,3331000.0
3331,3331999,21.72573414300992,37.86316078600922,0.04096784551298471,520.7630767822266,216.77095866203308,843.3231086730957,24431,2979,21452,21452,0,9,3332000.0
3332,3332999,21.728395628996005,37.86888199532096,0.04099046938475159,520.8859395980835,216.8347008228302,843.4615859985352,24431,2979,21452,21452,0,9,3333000.0
3333,3333999,21.73038833621329,37.870904846240585,0.041009547091737764,521.0147187709808,216.89877009391785,843.6701965332031,24434,2979,21455,21455,0,9,3334000.0
3334,3334999,21.731114186718848,37.87497984952384,0.041008960708443065,521.1369171142578,216.96338653564453,844.1273002624512,24443,2979,21464,21464,0,9,3335000.0
3335,3335999,21.72953910169082,37.87344582797729,0.0409946598945915,521.2653815746307,217.02946305274963,844.4313850402832,24447,2979,21468,21468,0,9,3336000.0
3336,3336999,21.727394157242024,37.87014554110604,0.04099727463598202,521.4535009860992,217.095938205719,844.6765975952148,24454,2980,21474,21474,0,9,3337000.0
3337,3337999,21.72551347504324,37.86679590095265,0.04099054792164658,521.5898725986481,217.16073966026306,844.8754043579102,24455,2980,21475,21475,0,9,3338000.0
3338,3338999,21.724241626969388,37.865293878460655,0.04097131928117981,521.7615904808044,217.22517776489258,845.017505645752,24459,2981,21478,21478,0,9,3339000.0
3339,3339999,21.72256750469203,37.86209488169019,0.040955391993635515,521.9488270282745,217.2909381389618,845.1772041320801,24462,2982,21480,21480,0,9,3340000.0
3340,3340999,21.72127794677806,37.86068014755641,0.04094792697670713,522.1334111690521,217.35701727867126,845.2782325744629,24469,2983,21486,21486,0,9,3341000.0
3341,3341999,21.71990539146847,37.858110144831834,0.04094091440487335,522.2660419940948,217.42190861701965,845.4888916015625,24470,2983,21487,21487,0,9,3342000.0
3342,3342999,21.718920565864778,37.85583951137142,0.04092586442510271,522.4415507316589,217.4866442680359,845.6420822143555,24476,2984,21492,21492,0,9,3343000.0
3343,3343999,21.718445246454266,37.85552819176852,0.0409243063483089,522.6894795894623,217.55187368392944,845.7536277770996,24486,2986,21500,21500,0,9,3344000.0
3344,3344999,21.718261150460854,37.85474668936845,0.040916200690528925,522.8276362419128,217.61614537239075,845.905101776123,24487,2986,21501,21501,0,9,3345000.0
3345,3345999,21.719131622758503,37.857498585843764,0.04092588811903475,523.0218665599823,217.6824586391449,846.0814094543457,24490,2987,21503,21503,0,9,3346000.0
3346,3346999,21.72110010295252,37.86252123566808,0.04093863364777961,523.1500422954559,217.74711728096008,846.2491416931152,24490,2987,21503,21503,0,9,3347000.0
3347,3347999,21.72318777315587,37.86649018515188,0.04095997886904423,523.278701543808,217.81188106536865,846.4406318664551,24492,2987,21505,21505,0,9,3348000.0
3348,3348999,21.72571877254362,37.87153823437186,0.04099382570235455,523.4056046009064,217.87585473060608,846.5983772277832,24492,2987,21505,21505,0,9,3349000.0
3349,3349999,21.72931475625358,37.879992454187615,0.041028245310296474,523.5996942520142,217.9411106109619,846.6849975585938,24494,2988,21506,21506,0,9,3350000.0
3350,3350999,21.733769985966646,37.88926106395216,0.04104783227501996,523.792172908783,218.00560760498047,846.8257598876953,24497,2989,21508,21508,0,9,3351000.0
3351,3351999,21.738567897621188,37.90536992777236,0.041065705717655554,523.9762790203094,218.0705282688141,846.9667015075684,24502,2990,21512,21512,0,9,3352000.0
3352,3352999,21.742237015337345,37.912537880957096,0.041085892760211795,524.1655204296112,218.13534116744995,847.1316680908203,24510,2991,21519,21519,0,9,3353000.0
3353,3353999,21.746366179061198,37.92044185644317,0.04109797931927173,524.3408925533295,218.20102262496948,847.3806915283203,24543,2992,21551,21551,0,9,3354000.0
3354,3354999,21.748984770465164,37.92305347995561,0.04111229834020713,524.4693720340729,218.26525044441223,847.5961418151855,24545,2992,21553,21553,0,9,3355000.0
3355,3355999,21.749936637994708,37.92406353219266,0.04111166922941256,524.6104245185852,218.32942509651184,847.9806060791016,24552,2992,21560,21560,0,9,3356000.0
3356,3356999,21.748206871477937,37.921976280890426,0.0411187684696378,524.7406544685364,218.39493656158447,848.3869247436523,24557,2992,21565,21565,0,9,3357000.0
3357,3357999,21.746724430744763,37.92233828748759,0.041122089332673695,524.9934413433075,218.46093940734863,848.5815010070801,24577,2994,21583,21583,0,9,3358000.0
3358,3358999,21.745222702162277,37.92091104731492,0.041118417519813044,525.1710917949677,218.52581596374512,848.7448501586914,24579,2995,21584,21584,0,9,3359000.0
3359,3359999,21.743463066444836,37.91789481876518,0.04110909953392905,525.4077498912811,218.59075474739075,848.8972358703613,24588,2997,21591,21591,0,9,3360000.0
3360,3360999,21.74198550938594,37.91529104879069,0.04109541462794586,525.5405435562134,218.65568041801453,849.127368927002,24588,2997,21591,21591,0,9,3361000.0
3361,3361999,21.741186842389464,37.913692410055056,0.041079313616259605,525.7232015132904,218.72070741653442,849.3482933044434,24616,2998,21618,21618,0,9,3362000.0
3362,3362999,21.740014753805923,37.91136429019222,0.04107638296205951,525.8561589717865,218.7857689857483,849.5338325500488,24616,2998,21618,21618,0,9,3363000.0
3363,3363999,21.7389684950698,37.91058874980681,0.041091429570115356,525.9888911247253,218.85039687156677,849.7642707824707,24617,2998,21619,21619,0,9,3364000.0
3364,3364999,21.737790651209988,37.908917844461094,0.041082764515210424,526.1737284660339,218.914897441864,849.9131011962891,24623,2999,21624,21624,0,9,3365000.0
3365,3365999,21.737122922460305,37.90748352040422,0.041082113122462016,526.2966768741608,218.979106426239,850.0473899841309,24624,2999,21625,21625,0,9,3366000.0
3366,3366999,21.73772671678726,37.913977667265065,0.041059707953955304,526.4223012924194,219.04312014579773,850.18310546875,24624,2999,21625,21625,0,9,3367000.0
3367,3367999,21.73985773327908,37.92337594066437,0.04103399795634688,526.6234245300293,219.10747408866882,850.2844657897949,24630,3000,21630,21630,0,9,3368000.0
3368,3368999,21.74331430355809,37.93126042153249,0.041045530852976686,526.7516179084778,219.17199540138245,850.4352073669434,24631,3000,21631,21631,0,9,3369000.0
3369,3369999,21.74716092365546,37.942689533302286,0.041067792331402675,526.9820640087128,219.23668503761292,850.5035285949707,24639,3002,21637,21637,0,9,3370000.0
3370,3370999,21.75358131756052,37.96306964850719,0.041110493139198234,527.1635775566101,219.30163168907166,850.6870384216309,24646,3003,21643,21643,0,9,3371000.0
3371,3371999,21.76276141854618,37.98995188283858,0.04115165193328452,527.2826561927795,219.36595153808594,850.9004173278809,24647,3003,21644,21644,0,9,3372000.0
3372,3372999,21.771688422573344,38.01697963599973,0.04124280574451755,527.4692466259003,219.43199944496155,851.0603370666504,24650,3004,21646,21646,0,9,3373000.0
3373,3373999,21.780338953843813,38.0403774360733,0.041282801043522666,527.6516644954681,219.4962751865387,851.2882537841797,24656,3005,21651,21651,0,9,3374000.0
3374,3374999,21.78881989679817,38.0598929748753,0.04135421277018514,527.8314843177795,219.560729265213,851.4169807434082,24659,3006,21653,21653,0,9,3375000.0
3375,3375999,21.79686769944717,38.077723141118554,0.041383599323272624,527.9819104671478,219.62569332122803,851.7211532592773,24662,3006,21656,21656,0,9,3376000.0
3376,3376999,21.799836725148158,38.085624955764104,0.04138004451574262,528.1101634502411,219.69056844711304,852.2944984436035,24669,3006,21663,21663,0,9,3377000.0
3377,3377999,21.79863511561763,38.085624217699554,0.04137818010864747,528.2968714237213,219.7565336227417,852.6580390930176,24678,3007,21671,21671,0,9,3378000.0
3378,3378999,21.79782476557726,38.086564253897016,0.04136396681460974,528.4422836303711,219.82133603096008,852.908317565918,24679,3007,21672,21672,0,9,3379000.0
3379,3379999,21.798712940861297,38.091822611325675,0.04131946392841923,528.6291198730469,219.88620400428772,853.061595916748,24682,3008,21674,21674,0,9,3380000.0
3380,3380999,21.799437821664206,38.099209032439525,0.04127870543682477,528.8670978546143,219.9513123035431,853.1902008056641,24698,3010,21688,21688,0,9,3381000.0
3381,3381999,21.79964674291037,38.100019151377246,0.0412531254114743,529.0591759681702,220.017475605011,853.4970169067383,24703,3011,21692,21692,0,9,3382000.0
3382,3382999,21.800741399693283,38.102897370893444,0.0412249836665568,529.1830632686615,220.08219718933105,853.6555213928223,24703,3011,21692,21692,0,9,3383000.0
3383,3383999,21.801587934925003,38.104567397768136,0.04119467188496084,529.3187479972839,220.14662623405457,853.8372268676758,24705,3011,21694,21694,0,9,3384000.0
3384,3384999,21.802131337570955,38.105912452539464,0.0411691519924986,529.4443664550781,220.21087670326233,854.0089492797852,24705,3011,21694,21694,0,9,3385000.0
3385,3385999,21.802072162567523,38.106417990475954,0.04115068532561739,529.5741467475891,220.2750072479248,854.1767272949219,24706,3011,21695,21695,0,9,3386000.0
3386,3386999,21.803013592526476,38.10805243096486,0.041142116442045684,529.7705669403076,220.3398118019104,854.2491569519043,24708,3012,21696,21696,0,9,3387000.0
3387,3387999,21.803386925533083,38.10793845636677,0.041124606285162235,529.9122157096863,220.41021537780762,854.3468818664551,24708,3012,21696,21696,0,9,3388000.0
3388,3388999,21.804257023667546,38.11004500426506,0.04111281363332453,530.0480766296387,220.47759985923767,854.4859085083008,24709,3012,21697,21697,0,9,3389000.0
3389,3389999,21.805092727334806,38.11174197912566,0.04111303904148911,530.1766169071198,220.5417070388794,854.615104675293,24710,3012,21698,21698,0,9,3390000.0
3390,3390999,21.805759782822637,38.1122964716269,0.041104019007736414,530.4219307899475,220.60646510124207,854.6447677612305,24726,3014,21712,21712,0,9,3391000.0
3391,3391999,21.806912811717268,38.11634079050478,0.041101187096704295,530.6033148765564,220.67177557945251,854.7613983154297,24729,3015,21714,21714,0,9,3392000.0
3392,3392999,21.808065471987906,38.11777740804625,0.04108474137444473,530.7257792949677,220.7359402179718,854.8523216247559,24729,3015,21714,21714,0,9,3393000.0
3393,3393999,21.80897363561298,38.11911153205633,0.04106824705261014,530.8623869419098,220.79997396469116,855.0688438415527,24730,3015,21715,21715,0,9,3394000.0
3394,3394999,21.809434167958223,38.11908979331376,0.04106212701147782,531.051825761795,220.86426067352295,855.2700233459473,24737,3016,21721,21721,0,9,3395000.0
3395,3395999,21.810290518214984,38.11883626470741,0.04105114872731275,531.2345519065857,220.92823457717896,855.4259643554688,24744,3017,21727,21727,0,9,3396000.0
3396,3396999,21.810379201231072,38.120236736695425,0.041037830712169376,531.4188067913055,220.99343609809875,855.584114074707,24750,3018,21732,21732,0,9,3397000.0
3397,3397999,21.80964240653109,38.12281022527722,0.0410237347744159,531.5662758350372,221.05767393112183,856.0291748046875,24760,3018,21742,21742,0,9,3398000.0
3398,3398999,21.807813397658496,38.122131896109586,0.041028704970058394,531.745986700058,221.1225085258484,856.3297920227051,24767,3019,21748,21748,0,9,3399000.0
3399,3399999,21.805422408117852,38.1185698596522,0.04103413010703827,531.8947308063507,221.1873083114624,856.5572929382324,24769,3019,21750,21750,0,9,3400000.0
3400,3400999,21.803157216936167,38.115841713638034,0.04103810154181631,532.0783126354218,221.25199389457703,856.6869621276855,24776,3020,21756,21756,0,9,3401000.0
3401,3401999,21.801096176900614,38.112495791003006,0.041037928556793335,532.2021286487579,221.31650185585022,856.8337020874023,24776,3020,21756,21756,0,9,3402000.0
3402,3402999,21.799488917122076,38.110603916318865,0.04102760355092849,532.3577930927277,221.38195252418518,856.9628982543945,24776,3020,21756,21756,0,9,3403000.0
3403,3403999,21.79745170473883,38.106965815737546,0.041028609302786956,532.4855535030365,221.4495451450348,857.1171379089355,24776,3020,21756,21756,0,9,3404000.0
3404,3404999,21.795562443923036,38.10336871176017,0.04102481104034783,532.6256394386292,221.51413655281067,857.2211265563965,24776,3020,21756,21756,0,9,3405000.0
3405,3405999,21.79361989956501,38.099547845327514,0.041015091641210866,532.762286901474,221.58865427970886,857.3406143188477,24777,3020,21757,21757,0,9,3406000.0
3406,3406999,21.792661164451346,38.09839309456517,0.04099937976670265,532.9799818992615,221.65990138053894,857.3486862182617,24782,3021,21761,21761,0,9,3407000.0
3407,3407999,21.791647937358164,38.09586189616446,0.040987429329048974,533.2242522239685,221.7242922782898,857.3060722351074,24790,3023,21767,21767,0,9,3408000.0
3408,3408999,21.790745566741712,38.09341256125173,0.04097668804160004,533.4750003814697,221.78912734985352,857.3479652404785,24795,3025,21770,21770,0,9,3409000.0
3409,3409999,21.79065608160628,38.09400212377525,0.040959937824337156,533.608583688736,221.85336422920227,857.4988861083984,24795,3025,21770,21770,0,9,3410000.0
3410,3410999,21.78991722605991,38.09224636411362,0.040950573350767905,533.7384679317474,221.91767740249634,857.6186828613281,24795,3025,21770,21770,0,9,3411000.0
3411,3411999,21.789957708075487,38.09159714619135,0.040959945492831884,533.9288351535797,221.98250102996826,857.7247505187988,24801,3026,21775,21775,0,9,3412000.0
3412,3412999,21.790995880352337,38.09703433488974,0.040956561251409784,534.0625896453857,222.04694032669067,857.875804901123,24802,3026,21776,21776,0,9,3413000.0
3413,3413999,21.79299700508914,38.10234808503284,0.040962662175490716,534.1846492290497,222.11105394363403,858.0361785888672,24802,3026,21776,21776,0,9,3414000.0
3414,3414999,21.796481809561737,38.11411514285881,0.040947534446334255,534.3120400905609,222.1753888130188,858.2556800842285,24805,3026,21779,21779,0,9,3415000.0
3415,3415999,21.799803691843657,38.12124721848417,0.04098267554574275,534.4951436519623,222.24079179763794,858.4718132019043,24821,3027,21794,21794,0,9,3416000.0
3416,3416999,21.803298115537736,38.130109598420546,0.040999306785095224,534.611035823822,222.3044741153717,858.6734237670898,24821,3027,21794,21794,0,9,3417000.0
3417,3417999,21.806971112435786,38.13852079410447,0.040999788490294176,534.8053410053253,222.3685646057129,858.7934837341309,24836,3028,21808,21808,0,9,3418000.0
3418,3418999,21.808234132438955,38.140721259111345,0.041004424902072345,534.9982869625092,222.43333268165588,859.1525802612305,24842,3029,21813,21813,0,9,3419000.0
3419,3419999,21.80668751096587,38.139655103334626,0.04099538068572439,535.2034213542938,222.49816393852234,859.4187393188477,24857,3030,21827,21827,0,9,3420000.0
3420,3420999,21.804685745127045,38.13863827591808,0.04099451988709035,535.3343875408173,222.56274604797363,859.7546730041504,24859,3030,21829,21829,0,9,3421000.0
3421,3421999,21.80322499255247,38.13744148301365,0.04098551996078792,535.5247595310211,222.6279935836792,859.8979988098145,24863,3031,21832,21832,0,9,3422000.0
3422,3422999,21.801329755126936,38.13456819243156,0.04098218515905472,535.6546452045441,222.6928689479828,860.0249481201172,24863,3031,21832,21832,0,9,3423000.0
3423,3423999,21.79954452590204,38.13158450812481,0.0409740489482614,535.843405008316,222.75746130943298,860.1310043334961,24871,3032,21839,21839,0,9,3424000.0
3424,3424999,21.797668772594925,38.12836413646122,0.04097296367079584,536.0832860469818,222.8224606513977,860.225959777832,24876,3034,21842,21842,0,9,3425000.0
3425,3425999,21.796008409045747,38.125416559161025,0.04096410181147847,536.312805891037,222.8886160850525,860.3831520080566,24885,3036,21849,21849,0,9,3426000.0
3426,3426999,21.79464633942782,38.123603166912645,0.04095210438463026,536.4990060329437,222.9537889957428,860.7033996582031,24891,3037,21854,21854,0,9,3427000.0
3427,3427999,21.79322560539648,38.120641541782426,0.0409563491227638,536.6368162631989,223.01839566230774,860.943489074707,24894,3037,21857,21857,0,9,3428000.0
3428,3428999,21.792346479143294,38.12230801093961,0.040943168525826246,536.7708492279053,223.0825092792511,861.1526298522949,24895,3037,21858,21858,0,9,3429000.0
3429,3429999,21.791752275851785,38.12075523998367,0.0409366715261511,536.9554579257965,223.14813923835754,861.2903327941895,24901,3038,21863,21863,0,9,3430000.0
3430,3430999,21.79089851880856,38.11853433895717,0.04094023771988542,537.1373620033264,223.21250200271606,861.372486114502,24916,3039,21877,21877,0,9,3431000.0
3431,3431999,21.790710050737136,38.11781237001978,0.04095129279557819,537.3133585453033,223.2768955230713,861.561351776123,24919,3040,21879,21879,0,9,3432000.0
3432,3432999,21.791586471739095,38.12089787871804,0.04094530506805749,537.5035328865051,223.3418619632721,861.7846832275391,24927,3041,21886,21886,0,9,3433000.0
3433,3433999,21.79257420004672,38.12314023010773,0.04095600328408566,537.6865725517273,223.40674901008606,861.9197158813477,24932,3042,21890,21890,0,9,3434000.0
3434,3434999,21.79391779043728,38.12427054248537,0.04095490761049814,537.8722875118256,223.47075867652893,862.0581474304199,24936,3043,21893,21893,0,9,3435000.0
3435,3435999,21.795161285132192,38.124935010188345,0.0409603651779491,538.1157457828522,223.53593182563782,862.1826782226562,24956,3045,21911,21911,0,9,3436000.0
3436,3436999,21.797051120595775,38.126804150342615,0.04095878898545513,538.2929220199585,223.6001856327057,862.3087539672852,24961,3046,21915,21915,0,9,3437000.0
3437,3437999,21.799077816633893,38.13099545190762,0.040957231640369796,538.4727253913879,223.6645405292511,862.6007652282715,24978,3047,21931,21931,0,9,3438000.0
3438,3438999,21.800639333967965,38.13146041744448,0.04096045185291863,538.7192938327789,223.72925686836243,862.7736167907715,25003,3049,21954,21954,0,9,3439000.0
3439,3439999,21.800941053274155,38.13013793375324,0.04095265553416061,538.8521242141724,223.7932150363922,863.0396881103516,25004,3049,21955,21955,0,9,3440000.0
3440,3440999,21.798943865901993,38.12718846228451,0.040954362951450496,539.0917656421661,223.85833621025085,863.6402969360352,25030,3051,21979,21979,0,9,3441000.0
3441,3441999,21.796384976152044,38.12343473268212,0.040968204797186436,539.2317497730255,223.9232304096222,864.041748046875,25034,3051,21983,21983,0,9,3442000.0
3442,3442999,21.793976625533737,38.11975329649099,0.04098107888339275,539.3686060905457,223.98865675926208,864.2231101989746,25034,3051,21983,21983,0,9,3443000.0
3443,3443999,21.791408345123475,38.11598238083842,0.04099560009517633,539.494069814682,224.0533483028412,864.399715423584,25034,3051,21983,21983,0,9,3444000.0
3444,3444999,21.789256427449153,38.11342888513281,0.0409917712655723,539.6817770004272,224.11880445480347,864.5581932067871,25036,3052,21984,21984,0,9,3445000.0
3445,3445999,21.787158818390257,38.11142556550146,0.040991593487337497,539.8028287887573,224.18350887298584,864.7471084594727,25036,3052,21984,21984,0,9,3446000.0
3446,3446999,21.784854790431993,38.108178214351575,0.04100047452668776,539.9344701766968,224.24811553955078,864.968505859375,25037,3052,21985,21985,0,9,3447000.0
3447,3447999,21.782728249075824,38.10735119696392,0.04099620778377444,540.1222565174103,224.31300401687622,865.0567626953125,25043,3053,21990,21990,0,9,3448000.0
3448,3448999,21.78123995852209,38.10895267341986,0.04098626349756562,540.3557775020599,224.37760138511658,865.1363639831543,25053,3055,21998,21998,0,9,3449000.0
3449,3449999,21.779603666918394,38.1075554048682,0.04098122682869931,540.4828662872314,224.44190382957458,865.3073310852051,25053,3055,21998,21998,0,9,3450000.0
3450,3450999,21.778337534694494,38.11045801157086,0.04097066200455046,540.7780179977417,224.5071702003479,865.2739334106445,25065,3058,22007,22007,0,9,3451000.0
3451,3451999,21.776912417167352,38.10774916430413,0.040971017942730725,541.0168673992157,224.57370781898499,865.3554153442383,25069,3060,22009,22009,0,9,3452000.0
3452,3452999,21.775756407689684,38.10540947801768,0.04096983337745885,541.1407766342163,224.63792181015015,865.502311706543,25069,3060,22009,22009,0,9,3453000.0
3453,3453999,21.77483441700261,38.1031753668116,0.040965253536745516,541.3386855125427,224.70274448394775,865.6420059204102,25072,3061,22011,22011,0,9,3454000.0
3454,3454999,21.773596683765437,38.100290284905896,0.04096319271240578,541.5303633213043,224.76784682273865,865.8527374267578,25075,3062,22013,22013,0,9,3455000.0
3455,3455999,21.772485026148964,38.09719855791771,0.040958332972351186,541.7145676612854,224.83335781097412,866.0566787719727,25079,3063,22016,22016,0,9,3456000.0
3456,3456999,21.771343831404284,38.09446991779689,0.04095536460502647,541.9001936912537,224.89798021316528,866.254955291748,25085,3064,22021,22021,0,9,3457000.0
3457,3457999,21.770364850900496,38.09148398196652,0.04095294795534077,542.0896430015564,224.96252012252808,866.4438591003418,25105,3065,22040,22040,0,9,3458000.0
3458,3458999,21.76898638622167,38.08855338132679,0.04094884369937657,542.270763874054,225.02760004997253,866.7706718444824,25116,3066,22050,22050,0,9,3459000.0
3459,3459999,21.76730969530099,38.08652846596195,0.04093317386520967,542.3968513011932,225.09378933906555,867.5259857177734,25133,3066,22067,22067,0,9,3460000.0
3460,3460999,21.766023966390424,38.08725177566535,0.04092641840858269,542.6558966636658,225.16000270843506,867.8143539428711,25140,3068,22072,22072,0,9,3461000.0
3461,3461999,21.76413937744404,38.084251159864316,0.040937884732400676,542.8496117591858,225.22605395317078,868.0195655822754,25142,3069,22073,22073,0,9,3462000.0
3462,3462999,21.762235447998332,38.080682396370605,0.04094005265286138,542.9917063713074,225.29172134399414,868.2182540893555,25142,3069,22073,22073,0,9,3463000.0
3463,3463999,21.760828180232746,38.07956915563814,0.040937614459158445,543.1722311973572,225.35663533210754,868.3961753845215,25144,3070,22074,22074,0,9,3464000.0
3464,3464999,21.759124694481418,38.07695132114838,0.040934588212175216,543.3090085983276,225.42165112495422,868.6461906433105,25145,3070,22075,22075,0,9,3465000.0
3465,3465999,21.757345264997014,38.074315795237844,0.04093395357015639,543.4400391578674,225.48658776283264,868.8456382751465,25145,3070,22075,22075,0,9,3466000.0
3466,3466999,21.756010619658866,38.07169060494577,0.04092805431445079,543.7451133728027,225.55311059951782,868.9053611755371,25155,3073,22082,22082,0,9,3467000.0
3467,3467999,21.754946332267142,38.06905399006556,0.04092075557524477,543.9333522319794,225.61828446388245,869.0962982177734,25158,3074,22084,22084,0,9,3468000.0
3468,3468999,21.753719340286846,38.06653010085104,0.04090789472536316,544.1232664585114,225.6838300228119,869.231616973877,25166,3075,22091,22091,0,9,3469000.0
3469,3469999,21.753299484666687,38.06863626754596,0.04089173371336685,544.2581844329834,225.74874186515808,869.4411544799805,25166,3075,22091,22091,0,9,3470000.0
3470,3470999,21.752860055009364,38.068498416231776,0.04086997858854069,544.4469699859619,225.8147521018982,869.5484733581543,25168,3076,22092,22092,0,9,3471000.0
3471,3471999,21.752472372808842,38.06729273796251,0.04083682699347235,544.6397907733917,225.88064217567444,869.819091796875,25181,3077,22104,22104,0,9,3472000.0
3472,3472999,21.75209278156055,38.06528875416928,0.04082277864727313,544.7832691669464,225.94615197181702,870.0379600524902,25181,3077,22104,22104,0,9,3473000.0
3473,3473999,21.75174225970185,38.063975521053955,0.04079177366613207,545.1371884346008,226.01179718971252,870.0885047912598,25202,3081,22121,22121,0,9,3474000.0
3474,3474999,21.75164195505457,38.06288007693386,0.04077986023588587,545.3205633163452,226.07800483703613,870.2340087890625,25204,3082,22122,22122,0,9,3475000.0
3475,3475999,21.751969828315392,38.06248777153748,0.040768904539112305,545.4482259750366,226.142422914505,870.4134216308594,25204,3082,22122,22122,0,9,3476000.0
3476,3476999,21.752153151110143,38.06136550721453,0.04075299369211571,545.58309674263,226.2070653438568,870.6625518798828,25207,3082,22125,22125,0,9,3477000.0
3477,3477999,21.752605625700884,38.060494744027054,0.04072819569293584,545.7109003067017,226.27262592315674,870.9451332092285,25210,3082,22128,22128,0,9,3478000.0
3478,3478999,21.75209653088595,38.058352375865816,0.040718150140458875,545.9624562263489,226.33809328079224,871.0863189697266,25220,3084,22136,22136,0,9,3479000.0
3479,3479999,21.750569496219523,38.055658666751285,0.040712201902838974,546.0940628051758,226.40343952178955,871.8475761413574,25243,3084,22159,22159,0,9,3480000.0
3480,3480999,21.748100344829897,38.05197465649048,0.04071177299639894,546.2770459651947,226.46925044059753,872.2552528381348,25251,3085,22166,22166,0,9,3481000.0
3481,3481999,21.745902720447305,38.048829759564065,0.040716100430562396,546.4608125686646,226.53456830978394,872.5232048034668,25254,3086,22168,22168,0,9,3482000.0
3482,3482999,21.744240966096104,38.04683930913798,0.040716143296610996,546.7207930088043,226.6095790863037,872.6530799865723,25261,3088,22173,22173,0,9,3483000.0
3483,3483999,21.74236976746595,38.04561782022465,0.040715148418685176,546.9688258171082,226.67508935928345,872.7193756103516,25273,3090,22183,22183,0,9,3484000.0
3484,3484999,21.74084924590147,38.04421810560378,0.04071579663069369,547.0975222587585,226.73979020118713,872.9714469909668,25273,3090,22183,22183,0,9,3485000.0
3485,3485999,21.739659906954216,38.041694282163945,0.04072422151515698,547.2756321430206,226.8047845363617,873.2351341247559,25277,3091,22186,22186,0,9,3486000.0
3486,3486999,21.73934658321321,38.041517490947975,0.04072919479715098,547.4607298374176,226.86987257003784,873.4576797485352,25283,3092,22191,22191,0,9,3487000.0
3487,3487999,21.739460705266215,38.04174293436592,0.040755039075150434,547.6971304416656,226.93479752540588,873.5770225524902,25291,3094,22197,22197,0,9,3488000.0
3488,3488999,21.74088117715928,38.04436006896801,0.040798090507914386,547.9565742015839,227.00649428367615,873.865364074707,25302,3096,22206,22206,0,9,3489000.0
3489,3489999,21.74345110652571,38.05030222305333,0.04083323130476546,548.1920726299286,227.07168126106262,874.0184059143066,25310,3098,22212,22212,0,9,3490000.0
3490,3490999,21.7466999790472,38.05706753148737,0.04085285217477841,548.4853184223175,227.13727736473083,874.19140625,25324,3101,22223,22223,0,9,3491000.0
3491,3491999,21.750983620742243,38.06503780061706,0.040936036668367204,548.6669969558716,227.20366716384888,874.5364837646484,25329,3102,22227,22227,0,9,3492000.0
3492,3492999,21.755676568420952,38.07280845993019,0.041081012855137766,548.9114682674408,227.26985812187195,874.7178268432617,25333,3104,22229,22229,0,9,3493000.0
3493,3493999,21.76079823634602,38.08124683670071,0.0411613935210805,549.2174818515778,227.33704018592834,874.9009552001953,25359,3107,22252,22252,0,9,3494000.0
3494,3494999,21.767365289442065,38.09443981086955,0.04130831287238734,549.3433666229248,227.40187644958496,875.2489852905273,25363,3107,22256,22256,0,9,3495000.0
3495,3495999,21.774984998662354,38.109142731600045,0.041464519006759515,549.5218238830566,227.46704626083374,875.5447998046875,25371,3108,22263,22263,0,9,3496000.0
3496,3496999,21.7819510714697,38.121784166433095,0.04163378991735733,549.7630167007446,227.53314661979675,875.7274894714355,25379,3110,22269,22269,0,9,3497000.0
3497,3497999,21.787138845621424,38.13211953765697,0.04174239261221546,549.9481534957886,227.59878969192505,875.9115524291992,25382,3111,22271,22271,0,9,3498000.0
3498,3498999,21.793686504152234,38.143177823602514,0.041871528602586916,550.0656907558441,227.66361594200134,876.2047882080078,25385,3111,22274,22274,0,9,3499000.0
3499,3499999,21.79895036424121,38.15308951071644,0.04197852237912714,550.2472150325775,227.7287881374359,876.4237785339355,25389,3112,22277,22277,0,9,3500000.0
3500,3500999,21.797704563476884,38.15170092807937,0.04193987891991968,550.4278748035431,227.79499745368958,877.2316703796387,25412,3113,22299,22299,0,9,3501000.0
3501,3501999,21.79607475901025,38.14992394715352,0.04193257948135409,550.6821663379669,227.8605637550354,877.5828094482422,25423,3115,22308,22308,0,9,3502000.0
3502,3502999,21.79507725617186,38.14923024611371,0.04192092375452283,550.8124871253967,227.92599868774414,877.8222579956055,25424,3115,22309,22309,0,9,3503000.0
3503,3503999,21.794219362572633,38.14819522030556,0.04190556203565399,550.9936299324036,227.99125814437866,878.0395355224609,25427,3116,22311,22311,0,9,3504000.0
3504,3504999,21.792748709531967,38.14645769789408,0.04190122648623873,551.1771123409271,228.05643367767334,878.21484375,25433,3117,22316,22316,0,9,3505000.0
3505,3505999,21.791603778236603,38.144246737336594,0.04190885002632405,551.46901512146,228.12175393104553,878.2839012145996,25443,3120,22323,22323,0,9,3506000.0
3506,3506999,21.790767219361506,38.14539912402687,0.04189282825767382,551.6134369373322,228.19727301597595,878.5508079528809,25443,3120,22323,22323,0,9,3507000.0
3507,3507999,21.79020804497708,38.14495889651425,0.04189187850371323,551.9082109928131,228.2628879547119,878.7118186950684,25456,3123,22333,22333,0,9,3508000.0
3508,3508999,21.789507339685013,38.14395403450216,0.04189717914563673,552.1492354869843,228.32844996452332,878.9084014892578,25460,3125,22335,22335,0,9,3509000.0
3509,3509999,21.791126067661768,38.15027224933231,0.04195106185862829,552.386931180954,228.39390206336975,879.2339668273926,25483,3127,22356,22356,0,9,3510000.0
3510,3510999,21.79412499431206,38.15990965828153,0.042056887176831315,552.6191544532776,228.45986461639404,879.4685249328613,25489,3129,22360,22360,0,9,3511000.0
3511,3511999,21.79948694861891,38.17831640818901,0.04221942421607927,552.8499729633331,228.5251760482788,879.6995048522949,25513,3131,22382,22382,0,9,3512000.0
3512,3512999,21.804385628526916,38.190644496273585,0.042313628583175444,553.0956444740295,228.5907371044159,879.8946189880371,25521,3133,22388,22388,0,9,3513000.0
3513,3513999,21.810234959870527,38.206593633166854,0.04239695447142322,553.2973997592926,228.66371154785156,880.2497177124023,25536,3134,22402,22402,0,9,3514000.0
3514,3514999,21.815787270507194,38.22605044216053,0.04248233281931768,553.4838399887085,228.72944521903992,880.5681457519531,25546,3135,22411,22411,0,9,3515000.0
3515,3515999,21.820288471416983,38.23514977638147,0.04258141628588874,553.6146681308746,228.79578804969788,880.8146553039551,25546,3135,22411,22411,0,9,3516000.0
3516,3516999,21.82576953703671,38.24739048404735,0.04264366084439297,553.9161295890808,228.86142587661743,880.9965400695801,25567,3138,22429,22429,0,9,3517000.0
3517,3517999,21.831049658039777,38.257874773455555,0.042726624384564205,554.0350031852722,228.92626905441284,881.3720359802246,25571,3138,22433,22433,0,9,3518000.0
3518,3518999,21.835775907264917,38.26476229455873,0.04281632954275372,554.1590311527252,228.9921796321869,881.7494583129883,25576,3138,22438,22438,0,9,3519000.0
3519,3519999,21.83879382765658,38.268758033852244,0.042843016001287704,554.2851881980896,229.05658888816833,882.0856475830078,25577,3138,22439,22439,0,9,3520000.0
3520,3520999,21.83795550651016,38.26804115080402,0.04283604274516328,554.4147906303406,229.1213357448578,882.7336616516113,25590,3138,22452,22452,0,9,3521000.0
3521,3521999,21.8363519282377,38.267120244635215,0.042829024209751765,554.650759935379,229.18665599822998,883.0595703125,25616,3140,22476,22476,0,9,3522000.0
3522,3522999,21.835038882357686,38.26723289272241,0.04282277093615017,554.7813441753387,229.25118112564087,883.2993659973145,25616,3140,22476,22476,0,9,3523000.0
3523,3523999,21.834590429781763,38.269952929163,0.04280930810474026,554.910649061203,229.3157663345337,883.5342788696289,25617,3140,22477,22477,0,9,3524000.0
3524,3524999,21.833589949446246,38.268501789582835,0.04279598836776266,555.1632790565491,229.380628824234,883.5845375061035,25624,3142,22482,22482,0,9,3525000.0
3525,3525999,21.832812451376693,38.26789319089463,0.04278644038699431,555.2894744873047,229.44515323638916,883.7657585144043,25624,3142,22482,22482,0,9,3526000.0
3526,3526999,21.831542851762915,38.265820903352974,0.042781387222570744,555.4146413803101,229.50971722602844,883.9441070556641,25624,3142,22482,22482,0,9,3527000.0
3527,3527999,21.83080447474705,38.264724276559896,0.04277618941327188,555.5482270717621,229.57452011108398,884.1660346984863,25626,3142,22484,22484,0,9,3528000.0
3528,3528999,21.83092177481352,38.26632282767422,0.04278501823048275,555.7257082462311,229.63902807235718,884.2181816101074,25629,3143,22486,22486,0,9,3529000.0
3529,3529999,21.83305174770403,38.274958616269615,0.04280254732902766,555.922340631485,229.70338249206543,884.4049606323242,25645,3144,22501,22501,0,9,3530000.0
3530,3530999,21.83578534732875,38.2827979177857,0.042836794478821716,556.1053659915924,229.76856184005737,884.5654335021973,25666,3145,22521,22521,0,9,3531000.0
3531,3531999,21.841059760051667,38.29982711365588,0.04282819824173356,556.2244758605957,229.83265924453735,884.7170524597168,25666,3145,22521,22521,0,9,3532000.0
3532,3532999,21.84769083617763,38.318309619376656,0.04286165966634525,556.3560123443604,229.8971164226532,884.9175491333008,25666,3145,22521,22521,0,9,3533000.0
3533,3533999,21.85547940460276,38.34324484952221,0.04291939418519375,556.4807031154633,229.96169114112854,885.0960311889648,25666,3145,22521,22521,0,9,3534000.0
3534,3534999,21.865194599909128,38.376671272257674,0.0429802856556557,556.6754615306854,230.0266134738922,885.230354309082,25668,3146,22522,22522,0,9,3535000.0
3535,3535999,21.877144057369815,38.420027192830766,0.043057168426762216,556.8627262115479,230.0908796787262,885.3434600830078,25670,3147,22523,22523,0,9,3536000.0
3536,3536999,21.88895916331785,38.460121890732125,0.04313447818381211,557.1042416095734,230.1557891368866,885.4966239929199,25689,3149,22540,22540,0,9,3537000.0
3537,3537999,21.901257631174442,38.495672930137026,0.04332544278869355,557.2873980998993,230.2205753326416,885.741943359375,25693,3150,22543,22543,0,9,3538000.0
3538,3538999,21.915077798521672,38.533029054380854,0.04349560428008248,557.4292166233063,230.28608393669128,886.057201385498,25694,3150,22544,22544,0,9,3539000.0
3539,3539999,21.921403863301457,38.54715852036009,0.043541867125708955,557.5708665847778,230.35283970832825,886.4376449584961,25698,3150,22548,22548,0,9,3540000.0
3540,3540999,21.920114509603533,38.54717942478942,0.04350671453224131,557.8782212734222,230.42016553878784,886.7290878295898,25721,3153,22568,22568,0,9,3541000.0
3541,3541999,21.919330140576744,38.551138359462236,0.04347253313716004,558.1274707317352,230.4855511188507,887.0688400268555,25769,3155,22614,22614,0,9,3542000.0
3542,3542999,21.91910938548219,38.553776373064274,0.04345366903190018,558.247575044632,230.54986476898193,887.3172988891602,25770,3155,22615,22615,0,9,3543000.0
3543,3543999,21.919030748127817,38.55554314218596,0.04343777078657929,558.3800904750824,230.61441040039062,887.5322074890137,25770,3155,22615,22615,0,9,3544000.0
3544,3544999,21.919404613462042,38.55856142707906,0.043415112028870384,558.5629546642303,230.6789515018463,887.6844749450684,25776,3156,22620,22620,0,9,3545000.0
3545,3545999,21.918879329812064,38.557833380550186,0.0433958585291121,558.6993019580841,230.74764227867126,887.8675804138184,25776,3156,22620,22620,0,9,3546000.0
3546,3546999,21.919081494816343,38.55960959483783,0.043370293185631015,558.8317546844482,230.8118953704834,888.044548034668,25777,3156,22621,22621,0,9,3547000.0
3547,3547999,21.91936567688644,38.560873040750074,0.04335167944407459,558.9550747871399,230.8757712841034,888.203742980957,25777,3156,22621,22621,0,9,3548000.0
3548,3548999,21.920940758028276,38.56463693919985,0.04332420282773197,559.0859017372131,230.94063019752502,888.3898010253906,25779,3156,22623,22623,0,9,3549000.0
3549,3549999,21.92293445845506,38.56768633099989,0.04332280703921809,559.2189581394196,231.00454545021057,888.5285339355469,25779,3156,22623,22623,0,9,3550000.0
3550,3550999,21.925460877301646,38.57596309063687,0.043292865994356444,559.3509974479675,231.06899333000183,888.7302207946777,25781,3156,22625,22625,0,9,3551000.0
3551,3551999,21.92936645007859,38.58579551587847,0.04329324628481512,559.5516984462738,231.1341691017151,888.824031829834,25787,3157,22630,22630,0,9,3552000.0
3552,3552999,21.933715171080294,38.594849405021876,0.04331217169597745,559.7967388629913,231.199077129364,888.8713226318359,25795,3159,22636,22636,0,9,3553000.0
3553,3553999,21.938599765147075,38.60551235402276,0.04334521739178854,559.9173007011414,231.2627592086792,889.0862197875977,25796,3159,22637,22637,0,9,3554000.0
3554,3554999,21.94439075002355,38.62358667054564,0.043362206715621965,560.0398564338684,231.32675647735596,889.2680892944336,25798,3159,22639,22639,0,9,3555000.0
3555,3555999,21.952078229067748,38.64315616296892,0.04338841946783789,560.2428615093231,231.39154839515686,889.4215965270996,25801,3160,22641,22641,0,9,3556000.0
3556,3556999,21.960042542860492,38.66564241269802,0.043400757269362544,560.3877339363098,231.45627546310425,889.616268157959,25801,3160,22641,22641,0,9,3557000.0
3557,3557999,21.96699925118192,38.68248402714941,0.04341495594840972,560.52747631073,231.52588367462158,889.8521499633789,25803,3160,22643,22643,0,9,3558000.0
3558,3558999,21.977817034676857,38.711461904917606,0.043471526012162864,560.6602914333344,231.58973836898804,890.0953102111816,25804,3160,22644,22644,0,9,3559000.0
3559,3559999,21.985213194163737,38.72801494956327,0.04350634380272678,560.7916131019592,231.65340662002563,890.3012084960938,25804,3160,22644,22644,0,9,3560000.0
3560,3560999,21.984333330074097,38.72856794724034,0.04348833200910829,560.9892392158508,231.71904397010803,890.6136245727539,25811,3161,22650,22650,0,9,3561000.0
3561,3561999,21.98269357862619,38.72875019313575,0.04347715255567197,561.1392636299133,231.783842086792,890.9306144714355,25815,3161,22654,22654,0,9,3562000.0
3562,3562999,21.98158820538939,38.72895399004275,0.043457129973597075,561.3301753997803,231.84853863716125,891.0626525878906,25818,3162,22656,22656,0,9,3563000.0
3563,3563999,21.981048428241444,38.735847307744656,0.04342530372929754,561.4534132480621,231.91312098503113,891.241283416748,25819,3162,22657,22657,0,9,3564000.0
3564,3564999,21.979673599824597,38.734368160560116,0.043408843713795386,561.5822613239288,231.97816348075867,891.4038505554199,25819,3162,22657,22657,0,9,3565000.0
3565,3565999,21.978693072749557,38.732872479532965,0.043397170996847145,561.7032246589661,232.04219317436218,891.5400733947754,25819,3162,22657,22657,0,9,3566000.0
3566,3566999,21.97732934704538,38.7322891659155,0.04338131977852522,561.8324630260468,232.106520652771,891.7389984130859,25819,3162,22657,22657,0,9,3567000.0
3567,3567999,21.976400961383472,38.730252332974594,0.043373310825315814,562.0272195339203,232.17161989212036,891.8814010620117,25821,3163,22658,22658,0,9,3568000.0
3568,3568999,21.975559379578808,38.72828299811728,0.043364551172966226,562.2110283374786,232.23767828941345,892.042896270752,25832,3164,22668,22668,0,9,3569000.0
3569,3569999,21.97566448577489,38.730427276854485,0.043343774290791504,562.4547963142395,232.3026638031006,892.1648788452148,25837,3166,22671,22671,0,9,3570000.0
3570,3570999,21.975671682643604,38.72961142271513,0.04332568888969213,562.6953041553497,232.3673574924469,892.2734298706055,25841,3168,22673,22673,0,9,3571000.0
3571,3571999,21.975595351724998,38.72875147474713,0.043313612865102824,562.8301682472229,232.43151712417603,892.4152412414551,25841,3168,22673,22673,0,9,3572000.0
3572,3572999,21.976926498221427,38.73274526554871,0.043295889791491016,563.0197646617889,232.49601554870605,892.5118980407715,25843,3169,22674,22674,0,9,3573000.0
3573,3573999,21.978859479234465,38.73786521115388,0.0432954943052396,563.1660339832306,232.57047152519226,892.6857872009277,25843,3169,22674,22674,0,9,3574000.0
3574,3574999,21.981068839516706,38.74181461268381,0.043281784215197794,563.3488264083862,232.63451313972473,892.7523002624512,25845,3170,22675,22675,0,9,3575000.0
3575,3575999,21.983781848651965,38.74452241659346,0.04329629870788243,563.5422756671906,232.6988604068756,892.9145050048828,25848,3171,22677,22677,0,9,3576000.0
3576,3576999,21.987620847826744,38.753682528346715,0.04327867717981282,563.6629877090454,232.7631208896637,893.1015853881836,25848,3171,22677,22677,0,9,3577000.0
3577,3577999,21.991558436829074,38.75994163553745,0.043302806117421766,563.8513579368591,232.82738161087036,893.164909362793,25850,3172,22678,22678,0,9,3578000.0
3578,3578999,21.994730575713287,38.764268278067966,0.04329552621189259,563.9890732765198,232.89198231697083,893.342845916748,25852,3172,22680,22680,0,9,3579000.0
3579,3579999,21.999007479384954,38.77102545936631,0.04330090893198735,564.169753074646,232.955988407135,893.4956741333008,25867,3173,22694,22694,0,9,3580000.0
3580,3580999,22.00166455716301,38.777557992404354,0.043279582145970386,564.3020856380463,233.01954293251038,893.655632019043,25867,3173,22694,22694,0,9,3581000.0
3581,3581999,22.000302287760213,38.775023880077576,0.043280886363815,564.4957580566406,233.0840630531311,894.0291557312012,25889,3174,22715,22715,0,9,3582000.0
3582,3582999,21.99829654269665,38.77222697184796,0.043284260975976596,564.8103203773499,233.14989638328552,894.2961807250977,25899,3177,22722,22722,0,9,3583000.0
3583,3583999,21.996528800927745,38.77004679242701,0.04329329795944059,564.939962387085,233.21454524993896,894.510929107666,25900,3177,22723,22723,0,9,3584000.0
3584,3584999,21.994699328123975,38.76705269078163,0.04329580470813976,565.0754950046539,233.27919721603394,894.6794967651367,25900,3177,22723,22723,0,9,3585000.0
3585,3585999,21.993433718372817,38.76622149187112,0.04328726888680079,565.2657277584076,233.34401726722717,894.833625793457,25903,3178,22725,22725,0,9,3586000.0
3586,3586999,21.99213891505074,38.764308745405096,0.04328366612004553,565.5144062042236,233.40934562683105,894.9939460754395,25920,3180,22740,22740,0,9,3587000.0
3587,3587999,21.99059102203973,38.761964250641384,0.04327889492750647,565.7044365406036,233.4743263721466,895.1263160705566,25923,3181,22742,22742,0,9,3588000.0
3588,3588999,21.989592739258313,38.76121248412831,0.04327552993651429,565.8470475673676,233.54030323028564,895.3105888366699,25923,3181,22742,22742,0,9,3589000.0
3589,3589999,21.9886739806186,38.75929734040098,0.04327851217020606,565.9896790981293,233.6101267337799,895.4858207702637,25923,3181,22742,22742,0,9,3590000.0
3590,3590999,21.988447774113805,38.76245621768545,0.04327686913123974,566.2397270202637,233.67548251152039,895.5770835876465,25941,3183,22758,22758,0,9,3591000.0
3591,3591999,21.988838552154302,38.76283065369864,0.043270455805919705,566.3737497329712,233.7399036884308,895.7595748901367,25942,3183,22759,22759,0,9,3592000.0
3592,3592999,21.989277286443343,38.762944699289875,0.043280401081105646,566.5558800697327,233.8043134212494,895.8712959289551,25944,3184,22760,22760,0,9,3593000.0
3593,3593999,21.990478621373462,38.76401395419002,0.04329066539039317,566.7480947971344,233.86882376670837,895.9561042785645,25946,3185,22761,22761,0,9,3594000.0
3594,3594999,21.991239422222897,38.76679256428693,0.04329737638940667,566.8898882865906,236.73287320137024,896.1286125183105,25946,3185,22761,22761,0,9,3595000.0
3595,3595999,21.993004718889956,38.77366585032943,0.043309666220341936,567.0393078327179,236.80630683898926,896.2958755493164,25946,3185,22761,22761,0,9,3596000.0
3596,3596999,21.994593437938097,38.77771945273331,0.04331451186742974,567.2429306507111,236.87375020980835,896.4511528015137,25951,3186,22765,22765,0,9,3597000.0
3597,3597999,21.995520133347895,38.77878669965018,0.04331830933402936,567.4292380809784,236.93818831443787,896.6683921813965,25968,3187,22781,22781,0,9,3598000.0
3598,3598999,21.996947779084635,38.78058169627552,0.04332060621239231,567.571994304657,237.0031259059906,896.9680633544922,25973,3187,22786,22786,0,9,3599000.0
3599,3599999,21.99962647796318,38.784414398276354,0.04330131663650816,567.7097506523132,237.06689047813416,897.2690010070801,25974,3187,22787,22787,0,9,3600000.0
3600,3600999,21.998595574378008,38.78294367463356,0.04328004058022994,567.8959214687347,237.13291335105896,897.9139404296875,25993,3188,22805,22805,0,9,3601000.0
3601,3601999,21.99729128348116,38.78186000670312,0.043263039524243485,568.0845220088959,237.2004520893097,898.2857933044434,26001,3189,22812,22812,0,9,3602000.0
3602,3602999,21.995954098586406,38.778955796939535,0.04326203792615735,568.2217814922333,237.26627230644226,898.5817527770996,26008,3189,22819,22819,0,9,3603000.0
3603,3603999,21.994741159139213,38.77701954058954,0.043255846354787963,568.5399672985077,237.3324589729309,898.7127113342285,26020,3192,22828,22828,0,9,3604000.0
3604,3604999,21.993824871631883,38.77508963563548,0.0432511893746238,568.6793563365936,237.3975281715393,899.0149841308594,26024,3192,22832,22832,0,9,3605000.0
3605,3605999,21.993163685773453,38.773785253940225,0.043239883782395516,568.8056781291962,237.46233224868774,899.2781715393066,26026,3192,22834,22834,0,9,3606000.0
3606,3606999,21.9925607581162,38.773381975609304,0.04322553848716848,569.0066332817078,237.53201627731323,899.5138359069824,26047,3193,22854,22854,0,9,3607000.0
3607,3607999,21.99245100130948,38.77322186236433,0.04321509710859395,569.1380455493927,237.59667778015137,899.7229232788086,26048,3193,22855,22855,0,9,3608000.0
3608,3608999,21.993173718903414,38.77405855047684,0.04320578234755468,569.3943915367126,237.66205072402954,899.9376983642578,26068,3195,22873,22873,0,9,3609000.0
3609,3609999,21.994038620283987,38.776306111319755,0.043204347592178505,569.5359675884247,237.72760319709778,900.206714630127,26070,3195,22875,22875,0,9,3610000.0
3610,3610999,21.996559335566047,38.78089854103394,0.04320428683536326,569.6643614768982,237.79227304458618,900.4036979675293,26070,3195,22875,22875,0,9,3611000.0
3611,3611999,21.999464449655587,38.79040008134101,0.04324596169191797,569.8582711219788,237.85753965377808,900.5600662231445,26072,3196,22876,22876,0,9,3612000.0
3612,3612999,22.003459032088983,38.800079571453104,0.04328764389842654,569.9914345741272,237.92208528518677,900.7921409606934,26075,3196,22879,22879,0,9,3613000.0
3613,3613999,22.007174787816627,38.80930223922317,0.0433154084290619,570.1298968791962,237.98824667930603,900.9895858764648,26075,3196,22879,22879,0,9,3614000.0
3614,3614999,22.01221628771207,38.82842055868416,0.043363283012553655,570.3839838504791,238.05312967300415,901.1184616088867,26080,3198,22882,22882,0,9,3615000.0
3615,3615999,22.01738146752167,38.83946391461455,0.043422270700901766,570.624059677124,238.11816930770874,901.3066673278809,26093,3200,22893,22893,0,9,3616000.0
3616,3616999,22.02232224612258,38.852556127790606,0.043478428217171294,570.9513494968414,238.18402218818665,901.3465042114258,26103,3203,22900,22900,0,9,3617000.0
3617,3617999,22.02685464890612,38.86190906898771,0.04350676026603939,571.1374168395996,238.25122547149658,901.5270538330078,26105,3204,22901,22901,0,9,3618000.0
3618,3618999,22.03055869978511,38.86683296755244,0.043562553362391454,571.3232762813568,238.31586265563965,901.680492401123,26111,3205,22906,22906,0,9,3619000.0
3619,3619999,22.033846901989286,38.872733050828344,0.04364895936925406,571.5300436019897,238.38119053840637,901.9971008300781,26121,3206,22915,22915,0,9,3620000.0
3620,3620999,22.03263491394958,38.87074940070641,0.0436418577328902,571.7233593463898,238.44898653030396,902.537425994873,26142,3207,22935,22935,0,9,3621000.0
3621,3621999,22.031144458234007,38.86978098515523,0.04363614833346252,571.9739317893982,238.51430416107178,902.7770919799805,26158,3209,22949,22949,0,9,3622000.0
3622,3622999,22.030113904918977,38.869371012681874,0.0436364925628987,572.101788520813,238.5815303325653,902.9654350280762,26160,3209,22951,22951,0,9,3623000.0
3623,3623999,22.02907666263501,38.86777672984772,0.04364534336414794,572.3016231060028,238.64621710777283,903.1347541809082,26167,3210,22957,22957,0,9,3624000.0
3624,3624999,22.027839514738645,38.8655795844214,0.04365037848519482,572.4914398193359,238.7115170955658,903.3232917785645,26170,3211,22959,22959,0,9,3625000.0
3625,3625999,22.02684220504417,38.863703038967316,0.0436577228894095,572.6766536235809,238.77620601654053,903.5473022460938,26175,3212,22963,22963,0,9,3626000.0
3626,3626999,22.025852641519847,38.861946350662045,0.04366260157007695,572.8149752616882,238.84229278564453,903.7695350646973,26176,3212,22964,22964,0,9,3627000.0
3627,3627999,22.025325268044156,38.861019031742146,0.04367205113183059,572.9396662712097,238.90643668174744,903.9844436645508,26177,3212,22965,22965,0,9,3628000.0
3628,3628999,22.025883527523433,38.86303287391989,0.04367214537198605,573.0731918811798,238.97058129310608,904.2005767822266,26177,3212,22965,22965,0,9,3629000.0
3629,3629999,22.026508849137766,38.868395908187374,0.04366777016315315,573.2608127593994,239.03474640846252,904.2735023498535,26179,3213,22966,22966,0,9,3630000.0
3630,3630999,22.027884640200554,38.87135747067999,0.04365669711414888,573.448657989502,239.0996036529541,904.3738059997559,26181,3214,22967,22967,0,9,3631000.0
3631,3631999,22.02953950585038,38.87412413031271,0.0436536408636764,573.6362974643707,239.16391897201538,904.4106674194336,26184,3215,22969,22969,0,9,3632000.0
3632,3632999,22.031117539950234,38.876081908506464,0.04365238558172657,573.7655329704285,239.22881078720093,904.6229553222656,26185,3215,22970,22970,0,9,3633000.0
3633,3633999,22.033162652475777,38.87918760411288,0.043659932125821754,573.9543242454529,239.29303884506226,904.7510528564453,26191,3216,22975,22975,0,9,3634000.0
3634,3634999,22.03575601923659,38.88665696349471,0.043646808445591656,574.2631888389587,239.3582842350006,904.8173561096191,26207,3219,22988,22988,0,9,3635000.0
3635,3635999,22.0379220748297,38.88867283372153,0.043667747482239894,574.6454703807831,239.4278872013092,904.7219696044922,26227,3223,23004,23004,0,9,3636000.0
3636,3636999,22.040264805492086,38.8914494765312,0.04368634989111053,574.7824094295502,239.49279594421387,904.9773597717285,26228,3223,23005,23005,0,9,3637000.0
3637,3637999,22.041756726762024,38.89375255495321,0.04369402938117606,575.0883927345276,239.55747270584106,905.001838684082,26243,3226,23017,23017,0,9,3638000.0
3638,3638999,22.04354932170907,38.89676634940532,0.04370561724005195,575.3438937664032,239.62213253974915,905.115161895752,26253,3228,23025,23025,0,9,3639000.0
3639,3639999,22.044442277144025,38.902030493079174,0.04369939528584588,575.53595495224,239.6862871646881,905.2598266601562,26259,3229,23030,23030,0,9,3640000.0
3640,3640999,22.043664533642932,38.89959562542977,0.043687653906295254,575.8359520435333,239.7513735294342,905.527416229248,26271,3232,23039,23039,0,9,3641000.0
3641,3641999,22.042053953832248,38.89656055985055,0.043694501814274256,576.0838878154755,239.81817483901978,905.7854385375977,26282,3234,23048,23048,0,9,3642000.0
3642,3642999,22.040525159464092,38.893544486687176,0.04369860478040488,576.2805514335632,239.88311004638672,905.9402389526367,26286,3235,23051,23051,0,9,3643000.0
3643,3643999,22.03924151942788,38.89023764089757,0.04370659869194904,576.4830408096313,239.9480640888214,906.0975074768066,26302,3236,23066,23066,0,9,3644000.0
3644,3644999,22.03804797186162,38.88741425745694,0.04370194898043023,576.7989909648895,240.01370573043823,906.1392707824707,26320,3239,23081,23081,0,9,3645000.0
3645,3645999,22.03696954905393,38.884820942829606,0.04370559774479332,576.9447069168091,240.08835887908936,906.2934722900391,26321,3239,23082,23082,0,9,3646000.0
3646,3646999,22.03569268072273,38.88155182922743,0.04370215461981697,577.0681586265564,240.1545639038086,906.4770011901855,26321,3239,23082,23082,0,9,3647000.0
3647,3647999,22.034522491410556,38.880095000366545,0.043692162132977,577.324821472168,240.21959733963013,906.5491943359375,26343,3241,23102,23102,0,9,3648000.0
3648,3648999,22.033313517590013,38.876897083939674,0.04369157398568346,577.4598987102509,240.29215359687805,906.7511329650879,26343,3241,23102,23102,0,9,3649000.0
3649,3649999,22.03261521578376,38.874571644830766,0.04368483456394989,577.6550273895264,240.35698008537292,906.9031143188477,26345,3242,23103,23103,0,9,3650000.0
3650,3650999,22.031466357936004,38.871374003760735,0.04367524327555339,577.7866644859314,240.42336869239807,907.1494216918945,26346,3242,23104,23104,0,9,3651000.0
3651,3651999,22.030855807347585,38.86897208448145,0.04367314422170643,577.9066333770752,240.48755955696106,907.3178405761719,26347,3242,23105,23105,0,9,3652000.0
3652,3652999,22.030528213777856,38.86711424681798,0.043683454343036776,578.1550555229187,240.55268120765686,907.3830184936523,26357,3244,23113,23113,0,9,3653000.0
3653,3653999,22.03136343845805,38.86759977722474,0.04370233321063055,578.2804107666016,240.61690998077393,907.5887107849121,26358,3244,23114,23114,0,9,3654000.0
3654,3654999,22.031999115597525,38.86681391047605,0.04370774327908744,578.5338225364685,240.68161463737488,907.5634994506836,26369,3246,23123,23123,0,9,3655000.0
3655,3655999,22.033336093805854,38.86763091054584,0.0436987126738807,578.7232277393341,240.7457094192505,907.6701278686523,26374,3247,23127,23127,0,9,3656000.0
3656,3656999,22.035017695537032,38.869832419554676,0.04368802644950098,578.9218535423279,240.81420612335205,907.792308807373,26381,3248,23133,23133,0,9,3657000.0
3657,3657999,22.035980563451048,38.87036872936925,0.043682107671549675,579.1249060630798,240.879061460495,907.9804420471191,26385,3249,23136,23136,0,9,3658000.0
3658,3658999,22.037317569530895,38.87206908799637,0.043657972426934366,579.3134217262268,240.94387936592102,908.1977233886719,26391,3250,23141,23141,0,9,3659000.0
3659,3659999,22.03754138008614,38.87066833162978,0.0436461586991741,579.5747330188751,241.00862073898315,908.2501258850098,26402,3252,23150,23150,0,9,3660000.0
3660,3660999,22.03662400592579,38.86933898615769,0.043635301275957716,579.8973369598389,241.07391214370728,908.425968170166,26419,3255,23164,23164,0,9,3661000.0
3661,3661999,22.035168561289005,38.86696460889259,0.04364792939960982,580.0824806690216,241.1385624408722,908.6557655334473,26423,3256,23167,23167,0,9,3662000.0
3662,3662999,22.033995942760466,38.86498368216726,0.043658881574490827,580.2754852771759,241.20367765426636,908.9273834228516,26438,3257,23181,23181,0,9,3663000.0
3663,3663999,22.03267408056827,38.861803720813384,0.04366619219525425,580.4624922275543,241.26799535751343,909.0381240844727,26442,3258,23184,23184,0,9,3664000.0
3664,3664999,22.031585268469488,38.85882626954579,0.0436717634318049,580.5937502384186,241.3323459625244,909.1661491394043,26442,3258,23184,23184,0,9,3665000.0
3665,3665999,22.030558942837615,38.85597029374249,0.04367538866870435,580.7822456359863,241.3964705467224,909.2715187072754,26448,3259,23189,23189,0,9,3666000.0
3666,3666999,22.029479740669625,38.85295492157775,0.043679816004002836,580.9049198627472,241.46043467521667,909.4275932312012,26449,3259,23190,23190,0,9,3667000.0
3667,3667999,22.028543650720806,38.85024232316429,0.04368664788904686,581.1075401306152,241.52448964118958,909.5079727172852,26452,3260,23192,23192,0,9,3668000.0
3668,3668999,22.02819264985552,38.85299708230553,0.04366900298386889,581.2928273677826,241.58862924575806,909.6030540466309,26459,3261,23198,23198,0,9,3669000.0
3669,3669999,22.02770890781598,38.85054189087367,0.04365657481902274,581.4741070270538,241.65270566940308,909.6908988952637,26466,3262,23204,23204,0,9,3670000.0
3670,3670999,22.027499749134066,38.84811278563364,0.043643937304373104,581.663985490799,241.71726202964783,909.7357330322266,26471,3263,23208,23208,0,9,3671000.0
3671,3671999,22.027004822323267,38.84544240116913,0.0436345839827742,581.849143743515,241.78132939338684,909.816333770752,26473,3264,23209,23209,0,9,3672000.0
3672,3672999,22.02724182663633,38.84565790422026,0.04362017490059289,581.9753060340881,241.84499144554138,909.9701347351074,26473,3264,23209,23209,0,9,3673000.0
3673,3673999,22.027501667635445,38.84359541508003,0.04360639240511488,582.2267715930939,241.9094967842102,909.9892692565918,26485,3266,23219,23219,0,9,3674000.0
3674,3674999,22.02806563522246,38.8414715024058,0.04358496463800221,582.3576714992523,241.97360563278198,910.1895332336426,26485,3266,23219,23219,0,9,3675000.0
3675,3675999,22.028668621553756,38.83977688849619,0.04356174157273707,582.6605100631714,242.0383472442627,910.2312278747559,26509,3269,23240,23240,0,9,3676000.0
3676,3676999,22.02943963628686,38.84112854257228,0.04352873382877975,582.8406362533569,242.10453009605408,910.5053215026855,26515,3270,23245,23245,0,9,3677000.0
3677,3677999,22.028524302487007,38.83793029895569,0.04351814512413954,583.0888845920563,242.1688268184662,910.7834129333496,26520,3272,23248,23248,0,9,3678000.0
3678,3678999,22.02641871140766,38.83449736899147,0.04352243513513521,583.2799205780029,242.23359513282776,911.0545768737793,26540,3273,23267,23267,0,9,3679000.0
3679,3679999,22.024053864174476,38.830894879134625,0.043530122348980016,583.4162044525146,242.29989171028137,911.2899017333984,26540,3273,23267,23267,0,9,3680000.0
3680,3680999,22.022050004981374,38.82743291593661,0.04353629231886036,583.5546021461487,242.36512851715088,911.4938583374023,26540,3273,23267,23267,0,9,3681000.0
3681,3681999,22.020187371897467,38.823878862249984,0.04354176233147611,583.8209664821625,242.43048214912415,911.5721206665039,26561,3275,23286,23286,0,9,3682000.0
3682,3682999,22.01862751006249,38.82186325387361,0.04354090136512356,584.0716869831085,242.49499607086182,911.6290588378906,26571,3277,23294,23294,0,9,3683000.0
3683,3683999,22.01674381407579,38.81824849355919,0.04354192089421971,584.2067489624023,242.55965971946716,911.8211822509766,26571,3277,23294,23294,0,9,3684000.0
3684,3684999,22.01549725751342,38.81571141893744,0.04353990300402588,584.4627552032471,242.62426209449768,911.9195671081543,26579,3279,23300,23300,0,9,3685000.0
3685,3685999,22.014146139542046,38.81294062498647,0.043541440404451404,584.6574437618256,242.6890914440155,911.9574928283691,26586,3280,23306,23306,0,9,3686000.0
3686,3686999,22.013019965350395,38.81119698409459,0.043541048207611954,584.8444917201996,242.7535490989685,912.1304397583008,26593,3281,23312,23312,0,9,3687000.0
3687,3687999,22.012241288663176,38.809006479119176,0.043534334562179144,584.9679129123688,242.81737780570984,912.274097442627,26593,3281,23312,23312,0,9,3688000.0
3688,3688999,22.011907116009162,38.80781740142971,0.0435280583346197,585.1035313606262,242.88120126724243,912.4062347412109,26593,3281,23312,23312,0,9,3689000.0
3689,3689999,22.01212773778132,38.80932396115845,0.04351439497085041,585.2352206707001,242.94516587257385,912.5673713684082,26593,3281,23312,23312,0,9,3690000.0
3690,3690999,22.012260132769672,38.80873096937414,0.04350035185647938,585.477281332016,243.00915908813477,912.5494384765625,26601,3283,23318,23318,0,9,3691000.0
3691,3691999,22.01257163448388,38.8085950132079,0.04349480691387819,585.610648393631,243.07285928726196,912.7032508850098,26601,3283,23318,23318,0,9,3692000.0
3692,3692999,22.01327854404765,38.80823932310735,0.043493225981272476,585.7425351142883,243.1372585296631,912.9062538146973,26602,3283,23319,23319,0,9,3693000.0
3693,3693999,22.014229366414447,38.81036372495362,0.04349001230005056,585.9330623149872,243.20274758338928,913.0769996643066,26609,3284,23325,23325,0,9,3694000.0
3694,3694999,22.014674768451435,38.80945873957417,0.04348980529961355,586.0548663139343,243.26623439788818,913.2463035583496,26609,3284,23325,23325,0,9,3695000.0
3695,3695999,22.0152414709698,38.8082624438001,0.0434879072705161,586.26194190979,243.3303346633911,913.3163070678711,26611,3285,23326,23326,0,9,3696000.0
3696,3696999,22.015330590815,38.80713170029249,0.043483616037652384,586.3826758861542,243.3937211036682,913.4532089233398,26611,3285,23326,23326,0,9,3697000.0
3697,3697999,22.0140892974554,38.804854806379474,0.04348084243271255,586.5674681663513,243.4578685760498,914.1598014831543,26642,3286,23356,23356,0,9,3698000.0
3698,3698999,22.011608874506607,38.80081329681829,0.04348721111835574,586.7034437656403,243.52236676216125,914.6609497070312,26646,3286,23360,23360,0,9,3699000.0
3699,3699999,22.009440442756883,38.797920345006645,0.04349429375483771,586.824038028717,243.58684372901917,914.9627723693848,26648,3286,23362,23362,0,9,3700000.0
3700,3700999,22.007401531101376,38.79426410728536,0.04350404251592599,587.0827579498291,243.6522240638733,915.0723762512207,26669,3288,23381,23381,0,9,3701000.0
3701,3701999,22.005325108472192,38.791793502346486,0.043504054208231224,587.275130033493,243.71691060066223,915.2137222290039,26675,3289,23386,23386,0,9,3702000.0
3702,3702999,22.00340848782031,38.7881468573772,0.043510109192374746,587.5196621417999,243.78311729431152,915.3519248962402,26688,3291,23397,23397,0,9,3703000.0
3703,3703999,22.00157199854459,38.78453018594747,0.043520112138381806,587.7141606807709,243.84811115264893,915.6484336853027,26696,3292,23404,23404,0,9,3704000.0
3704,3704999,22.000405830924144,38.78300247918012,0.04351315968339342,587.8929181098938,243.91256594657898,915.9076042175293,26708,3293,23415,23415,0,9,3705000.0
3705,3705999,21.999690892316277,38.78458965448195,0.04350781191232189,588.0295729637146,243.97773933410645,916.1757049560547,26708,3293,23415,23415,0,9,3706000.0
3706,3706999,21.99896401247513,38.783241269546764,0.04350226269895807,588.2687659263611,244.04249739646912,916.4168434143066,26713,3295,23418,23418,0,9,3707000.0
3707,3707999,21.999367989937543,38.78395360066816,0.04349153409608664,588.3918669223785,244.10709357261658,916.6798248291016,26713,3295,23418,23418,0,9,3708000.0
3708,3708999,22.00010085918301,38.785468839873985,0.043468337272738355,588.5776805877686,244.17147946357727,916.7651481628418,26715,3296,23419,23419,0,9,3709000.0
3709,3709999,22.001310208199428,38.791993753774435,0.04344235594502077,588.9505243301392,244.23700332641602,916.852783203125,26743,3300,23443,23443,0,9,3710000.0
3710,3710999,22.00222926147745,38.79283613565916,0.04342531062744959,589.1348257064819,244.30155563354492,917.0915069580078,26751,3301,23450,23450,0,9,3711000.0
3711,3711999,22.003227436242916,38.79438757564244,0.04341728311066173,589.3174993991852,244.3675820827484,917.3488960266113,26759,3302,23457,23457,0,9,3712000.0
3712,3712999,22.00412962173982,38.79454672982958,0.043404292988050375,589.501918554306,244.43237471580505,917.6345367431641,26763,3303,23460,23460,0,9,3713000.0
3713,3713999,22.005804607413577,38.7981877118945,0.04337992019769865,589.6880629062653,244.4969482421875,917.9161758422852,26767,3304,23463,23463,0,9,3714000.0
3714,3714999,22.007286115108563,38.799438821404,0.043362948226566944,589.8112685680389,244.5620014667511,918.0748481750488,26767,3304,23463,23463,0,9,3715000.0
3715,3715999,22.00857434755653,38.799715083515345,0.043354042401549386,590.0591056346893,244.62669491767883,918.2596015930176,26780,3306,23474,23474,0,9,3716000.0
3716,3716999,22.009492794057742,38.799486319259174,0.04334002423612138,590.2387886047363,244.6910057067871,918.5034866333008,26788,3307,23481,23481,0,9,3717000.0
3717,3717999,22.009083669143088,38.7976327260451,0.04333503718672482,590.3572342395782,244.75594878196716,918.7740287780762,26789,3307,23482,23482,0,9,3718000.0
3718,3718999,22.007568002828982,38.79661704623823,0.04333221062803683,590.4845361709595,244.8200662136078,919.2639350891113,26803,3307,23496,23496,0,9,3719000.0
3719,3719999,22.0057237658484,38.79376171584122,0.04333304177465369,590.7033522129059,244.8956437110901,919.4924392700195,26823,3308,23515,23515,0,9,3720000.0
3720,3720999,22.003754254356135,38.79041621855093,0.043342844889503906,591.0270748138428,244.96111917495728,919.5331649780273,26858,3311,23547,23547,0,9,3721000.0
3721,3721999,22.00217314732285,38.787401324821055,0.04335362415709598,591.2166268825531,245.0254726409912,919.6673431396484,26864,3312,23552,23552,0,9,3722000.0
3722,3722999,22.000372227343338,38.78409354544256,0.043357846423866864,591.5446293354034,245.09758281707764,919.7236251831055,26888,3315,23573,23573,0,9,3723000.0
3723,3723999,21.999092416974396,38.781621543842284,0.04335959541407075,591.8514544963837,245.16471815109253,919.8890037536621,26902,3318,23584,23584,0,9,3724000.0
3724,3724999,21.997507319168843,38.778545537458285,0.043363983976493214,592.0361425876617,245.22952795028687,920.0915107727051,26908,3319,23589,23589,0,9,3725000.0
3725,3725999,21.99604455332277,38.77608885037905,0.04336401863627093,592.1777091026306,245.2943925857544,920.2425270080566,26908,3319,23589,23589,0,9,3726000.0
3726,3726999,21.995314033282003,38.774743334355016,0.04335840086377574,592.4319612979889,245.35868763923645,920.4208183288574,26921,3321,23600,23600,0,9,3727000.0
3727,3727999,21.994137401618218,38.77219505636314,0.04335516411278939,592.6824703216553,245.42415523529053,920.4150772094727,26930,3323,23607,23607,0,9,3728000.0
3728,3728999,21.9931366918137,38.7697970545748,0.04334928137438476,592.8111047744751,245.48842525482178,920.6809272766113,26930,3323,23607,23607,0,9,3729000.0
3729,3729999,21.992711890827565,38.76848860466824,0.04334086684004723,592.943826675415,245.5534064769745,920.8277130126953,26930,3323,23607,23607,0,9,3730000.0
3730,3730999,21.992052770483355,38.766104635350274,0.04333609579422859,593.0673403739929,245.61718368530273,920.9640350341797,26930,3323,23607,23607,0,9,3731000.0
3731,3731999,21.991612019014156,38.76481028755117,0.04332762581264149,593.2582497596741,245.681560754776,921.0922584533691,26932,3324,23608,23608,0,9,3732000.0
3732,3732999,21.990860121332297,38.76250380203591,0.043320427901825,593.3826212882996,245.74518418312073,921.2906532287598,26933,3324,23609,23609,0,9,3733000.0
3733,3733999,21.990774474993326,38.76346152085361,0.043304089388091604,593.5145561695099,245.81054139137268,921.5387763977051,26936,3324,23612,23612,0,9,3734000.0
3734,3734999,21.990176610236546,38.76123326346299,0.043298680491660746,593.6347756385803,245.87416791915894,921.7967948913574,26937,3324,23613,23613,0,9,3735000.0
3735,3735999,21.989515291909665,38.758700506610275,0.04329669702081895,593.7667300701141,245.93831610679626,921.9710235595703,26937,3324,23613,23613,0,9,3736000.0
3736,3736999,21.988582154975163,38.7575572428417,0.04328016843719029,593.9469828605652,246.0015754699707,922.1093330383301,26943,3325,23618,23618,0,9,3737000.0
3737,3737999,21.986500392045667,38.75446937559223,0.043289785424773575,594.0750801563263,246.0657057762146,922.6286735534668,26956,3325,23631,23631,0,9,3738000.0
3738,3738999,21.98432295265869,38.75176760377319,0.043297399313113494,594.2634174823761,246.1298863887787,922.8549766540527,26974,3326,23648,23648,0,9,3739000.0
3739,3739999,21.98227528430941,38.74811466653913,0.043312145237245026,594.4026112556458,246.19430303573608,923.1430473327637,26975,3326,23649,23649,0,9,3740000.0
3740,3740999,21.980690271891728,38.7455880987797,0.043315786882832774,594.5299489498138,246.25850343704224,923.2827606201172,26975,3326,23649,23649,0,9,3741000.0
3741,3741999,21.97941811711159,38.74525937908313,0.043313364128370835,594.6603829860687,246.3224139213562,923.4506645202637,26976,3326,23650,23650,0,9,3742000.0
3742,3742999,21.977943432293525,38.74279572399021,0.04331108439133047,594.8480219841003,246.3867485523224,923.608226776123,26979,3327,23652,23652,0,9,3743000.0
3743,3743999,21.976431763605785,38.74096221004768,0.04330841281632791,594.987676858902,246.4509139060974,923.7419586181641,26980,3327,23653,23653,0,9,3744000.0
3744,3744999,21.975736846287965,38.73997491418188,0.04329688864781622,595.1809494495392,246.51492977142334,923.79931640625,26982,3328,23654,23654,0,9,3745000.0
3745,3745999,21.9751498129898,38.74338529882025,0.043283259644157246,595.4399650096893,246.5794062614441,923.7739295959473,26999,3330,23669,23669,0,9,3746000.0
3746,3746999,21.975375149290244,38.74318565698552,0.043285836342885076,595.5638384819031,246.6437919139862,923.9134292602539,26999,3330,23669,23669,0,9,3747000.0
3747,3747999,21.975896717081927,38.744374336445986,0.04328657971735128,595.6892595291138,246.70776987075806,924.0525093078613,26999,3330,23669,23669,0,9,3748000.0
3748,3748999,21.976545383700646,38.74459104799011,0.04328960487532274,595.8246426582336,246.7730724811554,924.1487998962402,26999,3330,23669,23669,0,9,3749000.0
3749,3749999,21.978181340421344,38.74837218254623,0.043281499515344435,595.9476275444031,246.83683156967163,924.2395553588867,26999,3330,23669,23669,0,9,3750000.0
3750,3750999,21.98031206342683,38.75553788318708,0.04326421009909831,596.0712234973907,246.90127086639404,924.3535118103027,26999,3330,23669,23669,0,9,3751000.0
3751,3751999,21.982623685962793,38.76172126364018,0.04326155852551239,596.1917593479156,246.96499371528625,924.4822463989258,26999,3330,23669,23669,0,9,3752000.0
3752,3752999,21.984159137161164,38.76519416744602,0.04325895817869485,596.3859105110168,247.02854204177856,924.4219436645508,27006,3331,23675,23675,0,9,3753000.0
3753,3753999,21.986609462385047,38.77239244878383,0.043251209704021076,596.5276148319244,247.10191774368286,924.5606269836426,27007,3331,23676,23676,0,9,3754000.0
3754,3754999,21.988693947589006,38.77445770457592,0.04325221829309056,596.746294260025,247.17296743392944,924.633487701416,27025,3332,23693,23693,0,9,3755000.0
3755,3755999,21.990675074670694,38.779163422603304,0.04322874009349331,596.875287771225,247.23652124404907,924.7216186523438,27025,3332,23693,23693,0,9,3756000.0
3756,3756999,21.991377132381494,38.778706101254265,0.04322578811622457,597.05393242836,247.30003786087036,924.7865409851074,27031,3333,23698,23698,0,9,3757000.0
3757,3757999,21.989959228216037,38.775725281563254,0.043228702159617494,597.2329363822937,247.36389207839966,925.1758766174316,27045,3334,23711,23711,0,9,3758000.0
3758,3758999,21.98766586728144,38.7731008641268,0.04323612413448441,597.3677890300751,247.42842745780945,925.4571266174316,27048,3334,23714,23714,0,9,3759000.0
3759,3759999,21.985334855635312,38.76999034015325,0.04324696643627002,597.5550711154938,247.49307131767273,925.5674095153809,27054,3335,23719,23719,0,9,3760000.0
3760,3760999,21.983439498677544,38.767919002866066,0.0432486977811285,597.6857869625092,247.5584056377411,925.7566032409668,27054,3335,23719,23719,0,9,3761000.0
3761,3761999,21.982294884620522,38.76941425860335,0.043239685970377195,597.815990447998,247.62267327308655,925.8691635131836,27054,3335,23719,23719,0,9,3762000.0
3762,3762999,21.980927097639015,38.76720818149863,0.04323514463101741,597.9560222625732,247.68708157539368,925.9824295043945,27054,3335,23719,23719,0,9,3763000.0
3763,3763999,21.979832108950077,38.76697278498596,0.04322475034715789,598.1549096107483,247.75225591659546,926.0900726318359,27068,3336,23732,23732,0,9,3764000.0
3764,3764999,21.978613233511098,38.76518622261825,0.04321944852058823,598.2876703739166,247.81683778762817,926.2533493041992,27068,3336,23732,23732,0,9,3765000.0
3765,3765999,21.97744735634938,38.76322025240017,0.043219888689158936,598.4153242111206,247.88092827796936,926.3624305725098,27068,3336,23732,23732,0,9,3766000.0
3766,3766999,21.976797335125674,38.762561818024714,0.043210917628205836,598.6609771251678,247.94630217552185,926.4247589111328,27092,3338,23754,23754,0,9,3767000.0
3767,3767999,21.97634045854339,38.76183055307756,0.04320083680893305,598.7954561710358,248.0103120803833,926.5717010498047,27092,3338,23754,23754,0,9,3768000.0
3768,3768999,21.97684610845056,38.76307339820218,0.043193460048603805,598.9800910949707,248.07436347007751,926.6239738464355,27094,3339,23755,23755,0,9,3769000.0
3769,3769999,21.978943531583795,38.77034129661661,0.04318020311069548,599.1708068847656,248.13890862464905,926.6951332092285,27102,3340,23762,23762,0,9,3770000.0
3770,3770999,21.98175800702396,38.77763251954559,0.04320172283729462,599.424970626831,248.20384740829468,926.8452949523926,27128,3342,23786,23786,0,9,3771000.0
3771,3771999,21.986048058086745,38.79142356641336,0.04317430518567633,599.6054649353027,248.26969242095947,927.0287666320801,27133,3343,23790,23790,0,9,3772000.0
3772,3772999,21.989636963394116,38.800011877804145,0.04316870060564393,599.7414271831512,248.33386659622192,927.2108764648438,27133,3343,23790,23790,0,9,3773000.0
3773,3773999,21.994486248004247,38.813280015457515,0.043166166555656305,599.9398055076599,248.39828491210938,927.3351097106934,27140,3344,23796,23796,0,9,3774000.0
3774,3774999,21.999490596530972,38.82628096596153,0.043146151192343996,600.1325707435608,248.4627685546875,927.5287284851074,27149,3345,23804,23804,0,9,3775000.0
3775,3775999,22.003334195863005,38.83308284000969,0.043142387504607305,600.3182644844055,248.52722215652466,927.5736846923828,27156,3346,23810,23810,0,9,3776000.0
3776,3776999,22.00788329888119,38.84102098744473,0.04313792740715461,600.626837015152,248.59292936325073,927.5549850463867,27162,3349,23813,23813,0,9,3777000.0
3777,3777999,22.01045337554766,38.84432474298036,0.043133719843505336,600.8673567771912,248.65754199028015,927.7087669372559,27175,3351,23824,23824,0,9,3778000.0
3778,3778999,22.01016082074979,38.843564596028365,0.04312844847562214,600.9961919784546,248.72136926651,928.1302947998047,27182,3351,23831,23831,0,9,3779000.0
3779,3779999,22.0081816759019,38.844737503564495,0.043117162479931026,601.1272187232971,248.78567242622375,928.3947563171387,27184,3351,23833,23833,0,9,3780000.0
3780,3780999,22.00639663845082,38.84352658240154,0.04311035021303111,601.3432631492615,248.8599762916565,928.427677154541,27191,3352,23839,23839,0,9,3781000.0
3781,3781999,22.00476145821318,38.84141940172972,0.04311843269132931,601.5281012058258,248.92505860328674,928.5748558044434,27193,3353,23840,23840,0,9,3782000.0
3782,3782999,22.003286313338915,38.839892186468134,0.0431135647919163,601.8364589214325,248.99020195007324,928.5552673339844,27212,3356,23856,23856,0,9,3783000.0
3783,3783999,22.00187930185002,38.83742254814767,0.04310710409262519,602.0253019332886,249.05510592460632,928.6613464355469,27217,3357,23860,23860,0,9,3784000.0
3784,3784999,22.000424414158182,38.8363733855349,0.043096591744932966,602.1507081985474,249.1196072101593,928.8339538574219,27217,3357,23860,23860,0,9,3785000.0
3785,3785999,21.99931565397832,38.83491271733124,0.04308553577292584,602.3401474952698,249.18456435203552,928.8950653076172,27221,3358,23863,23863,0,9,3786000.0
3786,3786999,21.997992379987473,38.83287762144361,0.04308006207094339,602.5821771621704,249.24939131736755,928.9646148681641,27225,3360,23865,23865,0,9,3787000.0
3787,3787999,21.99786037593842,38.835348874758076,0.04306237553720549,602.7258832454681,249.31400799751282,929.1404838562012,27225,3360,23865,23865,0,9,3788000.0
3788,3788999,21.999527152808792,38.84168521693192,0.04306312557267333,602.8557634353638,249.3786449432373,929.2529754638672,27225,3360,23865,23865,0,9,3789000.0
3789,3789999,22.00383667660389,38.85552406950364,0.04306591546909233,602.9797358512878,249.44291973114014,929.4298667907715,27227,3360,23867,23867,0,9,3790000.0
3790,3790999,22.008759985091597,38.87439020663264,0.043085462124546,603.3041703701019,249.50781655311584,929.3764190673828,27253,3363,23890,23890,0,9,3791000.0
3791,3791999,22.01510980440465,38.89313492744289,0.043116928633730844,603.4906125068665,249.57245635986328,929.4956321716309,27257,3364,23893,23893,0,9,3792000.0
3792,3792999,22.02224375019097,38.909941695664436,0.043165643244123975,603.7365202903748,249.6372790336609,929.5891914367676,27271,3366,23905,23905,0,9,3793000.0
3793,3793999,22.03042064191202,38.93001305297977,0.043248851505701125,603.9869389533997,249.7020606994629,929.7061576843262,27295,3368,23927,23927,0,9,3794000.0
3794,3794999,22.038922652486438,38.94956976547864,0.04332896076422421,604.2324805259705,249.76781368255615,929.7389030456543,27308,3370,23938,23938,0,9,3795000.0
3795,3795999,22.047681233966294,38.96952269468192,0.04340217193197504,604.5464844703674,249.83244562149048,929.6475677490234,27326,3373,23953,23953,0,9,3796000.0
3796,3796999,22.05576212154393,38.985596336297064,0.0434727051490863,604.7919614315033,249.8972043991089,929.666748046875,27334,3375,23959,23959,0,9,3797000.0
3797,3797999,22.064560991307058,39.00292411964676,0.043555705955535595,604.9842426776886,249.96193933486938,929.8638572692871,27343,3376,23967,23967,0,9,3798000.0
3798,3798999,22.069578720770814,39.01124897098657,0.04360827336638473,605.1024022102356,250.02564668655396,930.0509300231934,27345,3376,23969,23969,0,9,3799000.0
3799,3799999,22.0692864655851,39.011069834413945,0.043603378290728245,605.2328686714172,250.08994483947754,930.4487190246582,27353,3376,23977,23977,0,9,3800000.0
3800,3800999,22.067415145817478,39.00862738424985,0.04359867967161557,605.428201675415,250.15488743782043,930.5495185852051,27360,3377,23983,23983,0,9,3801000.0
3801,3801999,22.066164209925425,39.00725961431234,0.0435897036717775,605.5763247013092,250.22876167297363,930.6830062866211,27360,3377,23983,23983,0,9,3802000.0
3802,3802999,22.066138090719576,39.009227506330305,0.043570643489744265,605.8514635562897,250.30221128463745,930.726806640625,27372,3379,23993,23993,0,9,3803000.0
3803,3803999,22.065274318497064,39.00771725703423,0.04356772823106658,606.1179163455963,250.36830234527588,930.7328147888184,27381,3381,24000,24000,0,9,3804000.0
3804,3804999,22.06438614403008,39.005878993909995,0.043558242709470174,606.384877204895,250.43341302871704,930.7410659790039,27385,3383,24002,24002,0,9,3805000.0
3805,3805999,22.063575381142982,39.00501833519849,0.04355700006508678,606.5853087902069,250.49923372268677,930.8768997192383,27387,3384,24003,24003,0,9,3806000.0
3806,3806999,22.063280881040708,39.0039725740145,0.043552490589774395,606.8402037620544,250.56680178642273,930.7817649841309,27399,3386,24013,24013,0,9,3807000.0
3807,3807999,22.063245528840877,39.007687813858624,0.04355719859593277,606.967080116272,250.63105368614197,930.899112701416,27399,3386,24013,24013,0,9,3808000.0
3808,3808999,22.063763200629992,39.00773889906333,0.043591462857200614,607.1651661396027,250.69555711746216,931.0097694396973,27403,3387,24016,24016,0,9,3809000.0
3809,3809999,22.06420441226073,39.00854127438614,0.04359389610543052,607.3561840057373,250.7603120803833,931.1033554077148,27409,3388,24021,24021,0,9,3810000.0
3810,3810999,22.066192704376544,39.01632258505661,0.043608873837015394,607.4824614524841,250.8259527683258,931.2085380554199,27409,3388,24021,24021,0,9,3811000.0
3811,3811999,22.06880400017766,39.02120620990724,0.04360885644245138,607.6615743637085,250.8904104232788,931.3063316345215,27412,3389,24023,24023,0,9,3812000.0
3812,3812999,22.071189656123636,39.0242109637584,0.04364678274102174,607.846821308136,250.95487189292908,931.4139137268066,27424,3390,24034,24034,0,9,3813000.0
3813,3813999,22.074683843739706,39.03014168902261,0.043702687153311603,608.0372681617737,251.0193042755127,931.4872360229492,27432,3391,24041,24041,0,9,3814000.0
3814,3814999,22.079057678948118,39.039961543757045,0.043766481007289304,608.1598858833313,251.0830898284912,931.5994720458984,27432,3391,24041,24041,0,9,3815000.0
3815,3815999,22.08367058241138,39.049045194995934,0.043827030962073965,608.3617427349091,251.14779114723206,931.6867027282715,27438,3392,24046,24046,0,9,3816000.0
3816,3816999,22.08749597750279,39.055259788423264,0.043870105432811224,608.6204071044922,251.2130355834961,931.6639060974121,27452,3394,24058,24058,0,9,3817000.0
3817,3817999,22.091597809124035,39.06211285561808,0.043907836685355806,609.0651614665985,251.2801206111908,931.548698425293,27488,3399,24089,24089,0,9,3818000.0
3818,3818999,22.095137834879296,39.06612163437068,0.0439586203950727,609.2510559558868,251.34495759010315,931.9007110595703,27491,3400,24091,24091,0,9,3819000.0
3819,3819999,22.09619579750041,39.0660607647043,0.04397254479126922,609.4351892471313,251.41134333610535,932.2784042358398,27508,3401,24107,24107,0,9,3820000.0
3820,3820999,22.09462665268861,39.06426295710726,0.04396172341165172,609.5670795440674,251.4758529663086,932.5599098205566,27514,3401,24113,24113,0,9,3821000.0
3821,3821999,22.093083859380886,39.06197801116623,0.04395350143975196,609.8266549110413,251.5411298274994,932.663459777832,27522,3403,24119,24119,0,9,3822000.0
3822,3822999,22.092038250514864,39.06040463963915,0.04394889200184737,610.139865398407,251.60636019706726,932.6839714050293,27541,3406,24135,24135,0,9,3823000.0
3823,3823999,22.090426357706523,39.057492259768495,0.043949991651077935,610.2751445770264,251.6707775592804,932.8197479248047,27541,3406,24135,24135,0,9,3824000.0
3824,3824999,22.088848454231304,39.05453592083743,0.04394240333070776,610.4692273139954,251.7355978488922,932.9668922424316,27551,3407,24144,24144,0,9,3825000.0
3825,3825999,22.087227349520482,39.05110841483399,0.043938053327314375,610.6554729938507,251.80056977272034,933.0935592651367,27553,3408,24145,24145,0,9,3826000.0
3826,3826999,22.085962677998698,39.04818289182846,0.043933309716500446,610.9176580905914,251.87463665008545,933.1115264892578,27565,3410,24155,24155,0,9,3827000.0
3827,3827999,22.084912024652112,39.04605603632808,0.04392122049303537,611.1777293682098,251.94139289855957,933.2394638061523,27591,3412,24179,24179,0,9,3828000.0
3828,3828999,22.08357137980202,39.04305554984642,0.0439134443633068,611.4323008060455,252.0069558620453,933.3470649719238,27600,3414,24186,24186,0,9,3829000.0
3829,3829999,22.08276915228292,39.04137112019458,0.043900122690442855,611.8175845146179,252.0723888874054,933.2910270690918,27610,3418,24192,24192,0,9,3830000.0
3830,3830999,22.082018258403046,39.03952447019173,0.04388147448223889,611.9377062320709,252.1368432044983,933.5391578674316,27610,3418,24192,24192,0,9,3831000.0
3831,3831999,22.081686557961756,39.03816386704391,0.04386646106629122,612.2450399398804,252.20180940628052,933.5330924987793,27628,3421,24207,24207,0,9,3832000.0
3832,3832999,22.081161366105558,39.0365631867528,0.043857993488579994,612.4426691532135,252.26642203330994,933.6842956542969,27634,3422,24212,24212,0,9,3833000.0
3833,3833999,22.080688732328532,39.03430909361134,0.04385022907440539,612.7490839958191,252.33152270317078,933.7891502380371,27664,3425,24239,24239,0,9,3834000.0
3834,3834999,22.080644897229064,39.03281133325949,0.04383347004874538,612.9353878498077,252.39593410491943,933.9016990661621,27682,3426,24256,24256,0,9,3835000.0
3835,3835999,22.080902128553344,39.03141708836751,0.04382306176186834,613.130117893219,252.46160984039307,934.0416374206543,27688,3427,24261,24261,0,9,3836000.0
3836,3836999,22.081404817003023,39.03052987474574,0.04381317281170649,613.249805688858,252.52586388587952,934.225772857666,27688,3427,24261,24261,0,9,3837000.0
3837,3837999,22.081792011334954,39.029584602164874,0.0438035974304436,613.450076341629,252.59041929244995,934.4791221618652,27716,3428,24288,24288,0,9,3838000.0
3838,3838999,22.082033476718056,39.02813630685268,0.043793525723704096,613.5812077522278,252.65457248687744,934.664379119873,27716,3428,24288,24288,0,9,3839000.0
3839,3839999,22.082663548170576,39.02687148132337,0.04378852906520103,613.7781393527985,252.71872901916504,934.7535552978516,27718,3429,24289,24289,0,9,3840000.0
3840,3840999,22.08229514357416,39.02463176174063,0.043780788257826386,613.9041321277618,252.78264045715332,934.9279708862305,27718,3429,24289,24289,0,9,3841000.0
3841,3841999,22.080748259990607,39.022205660249085,0.04377436864528339,614.0280356407166,252.8483166694641,935.5583381652832,27737,3429,24308,24308,0,9,3842000.0
3842,3842999,22.079099426011805,39.020625163362716,0.04377042567879319,614.1557841300964,252.91314578056335,936.0049095153809,27743,3429,24314,24314,0,9,3843000.0
3843,3843999,22.07726945009641,39.01792861415625,0.04377390903382983,614.3486824035645,252.97866773605347,936.1783256530762,27764,3430,24334,24334,0,9,3844000.0
3844,3844999,22.075361653480673,39.01499836645584,0.04377558346827537,614.6535816192627,253.04388570785522,936.3392601013184,27796,3433,24363,24363,0,9,3845000.0
3845,3845999,22.073327025471688,39.01144518646175,0.043776253357628914,614.9029779434204,253.11001825332642,936.429443359375,27818,3435,24383,24383,0,9,3846000.0
3846,3846999,22.071814451262885,39.00868692638691,0.04377885692985628,615.1519062519073,253.17545294761658,936.564510345459,27834,3437,24397,24397,0,9,3847000.0
3847,3847999,22.07015023807649,39.00560246263423,0.043784318590290194,615.341432094574,253.2401568889618,936.851749420166,27842,3438,24404,24404,0,9,3848000.0
3848,3848999,22.068267467838275,39.00219302766639,0.04379364668166075,615.5385572910309,253.30500626564026,937.0287246704102,27845,3439,24406,24406,0,9,3849000.0
3849,3849999,22.066756045389184,38.99923977113319,0.04379663921088883,615.7318952083588,253.37110304832458,937.201042175293,27847,3440,24407,24407,0,9,3850000.0
3850,3850999,22.065481753787193,38.99681919682248,0.04379840916796984,616.0469107627869,253.43646121025085,937.3311996459961,27868,3443,24425,24425,0,9,3851000.0
3851,3851999,22.064479246562023,38.99487228975354,0.04379382874782256,616.3064022064209,253.50163292884827,937.4882507324219,27881,3445,24436,24436,0,9,3852000.0
3852,3852999,22.063858207561836,38.99444996786542,0.04378700250501821,616.5548746585846,253.56779837608337,937.6845550537109,27906,3447,24459,24459,0,9,3853000.0
3853,3853999,22.063159937319703,38.99312119944625,0.04378389814312178,616.7388153076172,253.63229894638062,937.8735084533691,27913,3448,24465,24465,0,9,3854000.0
3854,3854999,22.063083204936692,38.99752523154434,0.04376353420023804,617.064715385437,253.69798469543457,937.9170265197754,27933,3451,24482,24482,0,9,3855000.0
3855,3855999,22.062488956285737,38.99523376030781,0.04375211377862964,617.3141641616821,253.76299905776978,938.0587844848633,27937,3453,24484,24484,0,9,3856000.0
3856,3856999,22.062573694371707,38.99383159767574,0.04373936793870292,617.5012257099152,253.82853627204895,938.2718696594238,27945,3454,24491,24491,0,9,3857000.0
3857,3857999,22.062444789188092,38.992835012968875,0.04372946249135379,617.6421692371368,253.89311861991882,938.5129280090332,27945,3454,24491,24491,0,9,3858000.0
3858,3858999,22.063234204363624,38.992920715809205,0.04370892874649679,617.7659194469452,253.95753049850464,938.7956237792969,27946,3454,24492,24492,0,9,3859000.0
3859,3859999,22.063484357670813,38.99169757755943,0.043683368636269204,617.9585700035095,254.02231311798096,938.9857330322266,27950,3455,24495,24495,0,9,3860000.0
3860,3860999,22.06395515413054,38.990724849020204,0.04365742058588229,618.0867784023285,254.08675694465637,939.1960067749023,27950,3455,24495,24495,0,9,3861000.0
3861,3861999,22.063899441119112,38.98891662874492,0.04364098236497638,618.2723076343536,254.1517791748047,939.4756126403809,27957,3456,24501,24501,0,9,3862000.0
3862,3862999,22.063120281963,38.98800977368127,0.043634279263385256,618.5168857574463,254.2171220779419,939.8411560058594,27979,3458,24521,24521,0,9,3863000.0
3863,3863999,22.06115379517581,38.98511831734412,0.04363632278911744,618.6419150829315,254.282457113266,940.427490234375,27991,3458,24533,24533,0,9,3864000.0
3864,3864999,22.059420965081767,38.9826470499885,0.043642054735216984,618.888237953186,254.34718656539917,940.6122207641602,28005,3460,24545,24545,0,9,3865000.0
3865,3865999,22.057951241380394,38.98136027419578,0.043644096617504013,619.0098419189453,254.41150069236755,940.8705940246582,28006,3460,24546,24546,0,9,3866000.0
3866,3866999,22.05628769928738,38.97885545564224,0.04364600568656751,619.1457135677338,254.47607326507568,941.0518112182617,28006,3460,24546,24546,0,9,3867000.0
3867,3867999,22.05467609661471,38.976722576730616,0.04364696605069518,619.351925611496,254.5441918373108,941.2513656616211,28009,3461,24548,24548,0,9,3868000.0
3868,3868999,22.052842824479285,38.9732137565822,0.04364591427042175,619.4871098995209,254.60929083824158,941.5061302185059,28010,3461,24549,24549,0,9,3869000.0
3869,3869999,22.05220463411008,38.97319669866,0.043633054670437654,619.6165156364441,254.6740300655365,941.7016792297363,28011,3461,24550,24550,0,9,3870000.0
3870,3870999,22.051848455342288,38.97211662038491,0.04363025907935347,619.80597448349,254.73829579353333,941.8243026733398,28013,3462,24551,24551,0,9,3871000.0
3871,3871999,22.052062666994573,38.972891584032375,0.04361123908291753,620.0626947879791,254.8030722141266,941.9704971313477,28034,3464,24570,24570,0,9,3872000.0
3872,3872999,22.05242570590254,38.972744459403756,0.0435984375895051,620.3245437145233,254.86825919151306,941.9852294921875,28048,3466,24582,24582,0,9,3873000.0
3873,3873999,22.052802604601155,38.971949658899845,0.04358445868444594,620.5163781642914,254.93275499343872,942.0955390930176,28050,3467,24583,24583,0,9,3874000.0
3874,3874999,22.0536904081944,38.972438806007965,0.04356111378769034,620.6474149227142,254.9984233379364,942.4274673461914,28055,3467,24588,24588,0,9,3875000.0
3875,3875999,22.054259051403694,38.97177694961953,0.043547155108560553,620.8301939964294,255.06286525726318,942.5984306335449,28059,3468,24591,24591,0,9,3876000.0
3876,3876999,22.054635740547557,38.97086845481176,0.04353068604004762,620.9574460983276,255.1271915435791,942.8055229187012,28060,3468,24592,24592,0,9,3877000.0
3877,3877999,22.055397413084474,38.97013015981729,0.043506494924953176,621.099636554718,255.1913423538208,943.0373077392578,28061,3468,24593,24593,0,9,3878000.0
3878,3878999,22.05626347383309,38.9695185062561,0.043486260674518884,621.2865705490112,255.25637459754944,943.1927223205566,28064,3469,24595,24595,0,9,3879000.0
3879,3879999,22.056894381852896,38.969026430057625,0.04346631550189062,621.4710605144501,255.32078099250793,943.3873329162598,28078,3470,24608,24608,0,9,3880000.0
3880,3880999,22.057341915738093,38.967594523087634,0.043450826039746704,621.5963046550751,255.38490080833435,943.6575622558594,28080,3470,24610,24610,0,9,3881000.0
3881,3881999,22.05638635676035,38.964663550454134,0.043441058602742944,621.7206406593323,255.44928169250488,944.1785049438477,28096,3470,24626,24626,0,9,3882000.0
3882,3882999,22.054745010216422,38.96158737597226,0.043428425731305564,621.9142079353333,255.5155348777771,944.6634292602539,28120,3471,24649,24649,0,9,3883000.0
3883,3883999,22.05342444356169,38.959067396593085,0.043411808406121244,622.1085066795349,255.58121395111084,944.9093475341797,28124,3472,24652,24652,0,9,3884000.0
3884,3884999,22.052104191716758,38.95644938221343,0.04340523893248183,622.4401960372925,255.64797520637512,944.9712944030762,28136,3475,24661,24661,0,9,3885000.0
3885,3885999,22.05131169264959,38.9544037718061,0.043387847684309366,622.6285665035248,255.7127034664154,945.1562538146973,28150,3476,24674,24674,0,9,3886000.0
3886,3886999,22.050544684381673,38.95294305472351,0.04337350704419818,622.7502856254578,255.7781846523285,945.3570251464844,28151,3476,24675,24675,0,9,3887000.0
3887,3887999,22.049442513787042,38.95013036571517,0.04337542337454625,622.9946801662445,255.84283542633057,945.530876159668,28187,3478,24709,24709,0,9,3888000.0
3888,3888999,22.048570968323414,38.947616143811054,0.04336468139210703,623.1299760341644,255.9077754020691,945.7130699157715,28187,3478,24709,24709,0,9,3889000.0
3889,3889999,22.048173215176526,38.94610705028866,0.043358846025081776,623.2534112930298,255.97169661521912,945.8654327392578,28189,3478,24711,24711,0,9,3890000.0
3890,3890999,22.047897147890428,38.94551539027433,0.04334478324811675,623.4450154304504,256.0363919734955,946.0720481872559,28196,3479,24717,24717,0,9,3891000.0
3891,3891999,22.04808198923687,38.94521138964172,0.04333233277096482,623.6374523639679,256.10110235214233,946.2345390319824,28202,3480,24722,24722,0,9,3892000.0
3892,3892999,22.048483464089703,38.94520956435904,0.04333545028230135,624.01216340065,256.16636538505554,946.1486320495605,28215,3484,24731,24731,0,9,3893000.0
3893,3893999,22.04910500208307,38.94819203825055,0.043323864246975985,624.1391010284424,256.23059129714966,946.4793281555176,28217,3484,24733,24733,0,9,3894000.0
3894,3894999,22.050001271004625,38.94800870602311,0.04333030861628173,624.2689743041992,256.296578168869,946.7425651550293,28218,3484,24734,24734,0,9,3895000.0
3895,3895999,22.051177392684153,38.94861751952028,0.043352099324577176,624.5218892097473,256.3616051673889,946.7314147949219,28235,3486,24749,24749,0,9,3896000.0
3896,3896999,22.052859785897983,38.95106926833765,0.04337014406317896,624.651585817337,256.42603635787964,946.9865455627441,28236,3486,24750,24750,0,9,3897000.0
3897,3897999,22.05448337774069,38.953301761747696,0.043386857946938195,624.775149345398,256.49082493782043,947.1829490661621,28236,3486,24750,24750,0,9,3898000.0
3898,3898999,22.05597037287806,38.95582902700172,0.04340048569136368,625.0874602794647,256.5559413433075,947.2163429260254,28251,3489,24762,24762,0,9,3899000.0
3899,3899999,22.057428664516404,38.958859168297245,0.04342731462668159,625.286169052124,256.6203625202179,947.467472076416,28253,3490,24763,24763,0,9,3900000.0
3900,3900999,22.058762788522337,38.95894099440968,0.04345209630073432,625.4127740859985,256.6849739551544,947.7674789428711,28254,3490,24764,24764,0,9,3901000.0
3901,3901999,22.058921750789693,38.95738697314598,0.04345492141376617,625.5414817333221,256.7498424053192,947.9810676574707,28254,3490,24764,24764,0,9,3902000.0
3902,3902999,22.058276248812692,38.95879243144422,0.04341697874845463,625.669980764389,256.81439185142517,948.4488525390625,28269,3490,24779,24779,0,9,3903000.0
3903,3903999,22.056930622313505,38.95612509510935,0.04338739857087637,625.8105130195618,256.8796753883362,948.663444519043,28270,3490,24780,24780,0,9,3904000.0
3904,3904999,22.055767716217836,38.95344998260882,0.04336760227380443,625.9411470890045,256.9449870586395,948.7993774414062,28270,3490,24780,24780,0,9,3905000.0
3905,3905999,22.054749170509446,38.95219782251324,0.04334281699622977,626.1369066238403,257.00955724716187,948.9119453430176,28272,3491,24781,24781,0,9,3906000.0
3906,3906999,22.053626281182176,38.94965008468583,0.043327439801157386,626.2588903903961,257.0738570690155,949.0490570068359,28273,3491,24782,24782,0,9,3907000.0
3907,3907999,22.052624900291967,38.9472737980526,0.04330828925606356,626.4636788368225,257.1391050815582,949.118896484375,28288,3492,24796,24796,0,9,3908000.0
3908,3908999,22.05186611446011,38.94743539720844,0.043286230794924,626.713844537735,257.20424032211304,949.1660118103027,28298,3494,24804,24804,0,9,3909000.0
3909,3909999,22.051171144593134,38.944915808838005,0.043259979030580875,626.8329932689667,257.26849818229675,949.3050193786621,28298,3494,24804,24804,0,9,3910000.0
3910,3910999,22.050937284078167,38.94357907621793,0.0432470895381627,627.0259368419647,257.33306980133057,949.3572120666504,28305,3495,24810,24810,0,9,3911000.0
3911,3911999,22.050682302742427,38.941934160348836,0.043230943513735354,627.2763833999634,257.39898657798767,949.4514846801758,28317,3497,24820,24820,0,9,3912000.0
3912,3912999,22.050557407272976,38.94010178763991,0.0432134650746373,627.4737024307251,257.4639422893524,949.5348472595215,28319,3498,24821,24821,0,9,3913000.0
3913,3913999,22.05162201885937,38.94672049742637,0.043188783800504615,627.6570920944214,257.5285367965698,949.5893974304199,28321,3499,24822,24822,0,9,3914000.0
3914,3914999,22.05203684573468,38.94603945269458,0.04318002523290154,627.8506314754486,257.5981261730194,949.6591720581055,28323,3500,24823,24823,0,9,3915000.0
3915,3915999,22.05272974014128,38.94525905711723,0.04317227544994007,627.9856109619141,257.6622223854065,949.765567779541,28323,3500,24823,24823,0,9,3916000.0
3916,3916999,22.0536415658603,38.94496379070243,0.043174638046601266,628.1926441192627,257.7294535636902,949.9485321044922,28327,3501,24826,24826,0,9,3917000.0
3917,3917999,22.05464668194104,38.94531744555044,0.0431544348228351,628.3270211219788,257.7941360473633,950.1222648620605,28327,3501,24826,24826,0,9,3918000.0
3918,3918999,22.05611777743025,38.94600216821608,0.04315195010128092,628.4556844234467,257.8588676452637,950.2714500427246,28328,3501,24827,24827,0,9,3919000.0
3919,3919999,22.057371780767525,38.946453533674614,0.04315770433429311,628.5755081176758,257.92353343963623,950.4697608947754,28329,3501,24828,24828,0,9,3920000.0
3920,3920999,22.058204974927378,38.94632293856397,0.043152920144444495,628.8482446670532,257.9887249469757,950.5238723754883,28347,3503,24844,24844,0,9,3921000.0
3921,3921999,22.06024804105946,38.94997703764277,0.043162190434839376,629.0505530834198,258.0532548427582,950.6844329833984,28361,3504,24857,24857,0,9,3922000.0
3922,3922999,22.061400230800427,38.95011362265206,0.04315737184821322,629.2532238960266,258.12529158592224,950.9381370544434,28367,3505,24862,24862,0,9,3923000.0
3923,3923999,22.06118323191696,38.94871901131213,0.043147677543174834,629.3799242973328,258.1902825832367,951.3782653808594,28376,3505,24871,24871,0,9,3924000.0
3924,3924999,22.059400006790984,38.945559057510835,0.043143941733905344,629.5221276283264,258.25500321388245,951.6614723205566,28380,3505,24875,24875,0,9,3925000.0
3925,3925999,22.057892953511733,38.94321439603167,0.04313293060273182,630.0398998260498,258.3208911418915,951.5788497924805,28406,3511,24895,24895,0,9,3926000.0
3926,3926999,22.056755513715437,38.94153373756387,0.04312607257559398,630.3622667789459,258.38648438453674,951.6224517822266,28432,3514,24918,24918,0,9,3927000.0
3927,3927999,22.05558365065028,38.939388897736656,0.04311424926726681,630.5671985149384,258.451548576355,951.7185592651367,28434,3515,24919,24919,0,9,3928000.0
3928,3928999,22.05455956258321,38.9376479156643,0.04310103348065275,630.7561876773834,258.51752614974976,951.8243026733398,28436,3516,24920,24920,0,9,3929000.0
3929,3929999,22.053559875899833,38.93502656510335,0.04309374748819772,630.9487700462341,258.582626581192,951.9882278442383,28444,3517,24927,24927,0,9,3930000.0
3930,3930999,22.05265227590137,38.93261631996644,0.04308354951672988,631.221873998642,258.64751529693604,951.9604454040527,28448,3519,24929,24929,0,9,3931000.0
3931,3931999,22.051623894937407,38.929716715321604,0.0430787398486161,631.4133648872375,258.7121047973633,952.0726318359375,28452,3520,24932,24932,0,9,3932000.0
3932,3932999,22.050883139403354,38.927554284686934,0.04306362528836982,631.5432078838348,258.7769672870636,952.2468414306641,28453,3520,24933,24933,0,9,3933000.0
3933,3933999,22.05078032622332,38.929998791895365,0.043053823169833305,631.7379076480865,258.84128856658936,952.3314781188965,28457,3521,24936,24936,0,9,3934000.0
3934,3934999,22.050295869838774,38.928210095892894,0.04304214278386509,631.8740980625153,258.90711736679077,952.5256042480469,28458,3521,24937,24937,0,9,3935000.0
3935,3935999,22.05038807893083,38.92775448256446,0.04302710168671953,632.0061504840851,258.9712998867035,952.6022872924805,28458,3521,24937,24937,0,9,3936000.0
3936,3936999,22.05094909183265,38.92744843246769,0.043024732694132095,632.1310436725616,259.0363154411316,952.7351722717285,28459,3521,24938,24938,0,9,3937000.0
3937,3937999,22.052017081971194,38.92807696538109,0.043035210868644924,632.3963088989258,259.101056098938,952.8686637878418,28498,3523,24975,24975,0,9,3938000.0
3938,3938999,22.052669299333903,38.92767576348725,0.0430381759664088,632.5891530513763,259.165420293808,952.9720268249512,28501,3524,24977,24977,0,9,3939000.0
3939,3939999,22.054229875776052,38.9287222081861,0.04304477324167222,632.7195677757263,259.22914004325867,953.1208763122559,28501,3524,24977,24977,0,9,3940000.0
3940,3940999,22.05584951977758,38.92980897825856,0.04305226216173508,632.8444938659668,259.29319310188293,953.3465270996094,28504,3524,24980,24980,0,9,3941000.0
3941,3941999,22.057723474961364,38.93083858539972,0.04305966884183232,633.1093583106995,259.35787558555603,953.3689804077148,28518,3526,24992,24992,0,9,3942000.0
3942,3942999,22.058559822120632,38.93033966226113,0.04305599988854025,633.3036994934082,259.42227697372437,953.4761009216309,28520,3527,24993,24993,0,9,3943000.0
3943,3943999,22.05943666728851,38.92985102182627,0.043057159589071525,633.4925155639648,259.48668789863586,953.7456398010254,28535,3528,25007,25007,0,9,3944000.0
3944,3944999,22.059059311620278,38.92790396346165,0.04305822507600188,633.6201214790344,259.552574634552,954.1135787963867,28543,3528,25015,25015,0,9,3945000.0
3945,3945999,22.057986576577772,38.927276003175706,0.0430512984059922,633.809327840805,259.6170816421509,954.2816963195801,28547,3529,25018,25018,0,9,3946000.0
3946,3946999,22.05688659472992,38.9268091895462,0.04305172588991146,634.0065762996674,259.68200492858887,954.4719123840332,28562,3530,25032,25032,0,9,3947000.0
3947,3947999,22.056353745456132,38.92867365475693,0.04305975684308805,634.2608263492584,259.74817180633545,954.5488395690918,28569,3532,25037,25037,0,9,3948000.0
3948,3948999,22.056515050597913,38.93143010067546,0.04309115373918715,634.4719259738922,259.8134150505066,954.7278823852539,28573,3533,25040,25040,0,9,3949000.0
3949,3949999,22.056998363368457,38.93639746665996,0.04310760510478773,634.6676380634308,259.87915873527527,954.8705024719238,28575,3534,25041,25041,0,9,3950000.0
3950,3950999,22.057028035473728,38.93797185608356,0.04311871502222753,634.864588022232,259.9443039894104,955.00244140625,28577,3535,25042,25042,0,9,3951000.0
3951,3951999,22.05734329965229,38.94079072734479,0.04312395110484668,634.990574836731,260.00852513313293,955.1602897644043,28578,3535,25043,25043,0,9,3952000.0
3952,3952999,22.058172790353503,38.94326937808782,0.04314301600210302,635.1874108314514,260.0746567249298,955.2239837646484,28586,3536,25050,25050,0,9,3953000.0
3953,3953999,22.05913357050196,38.94817485778667,0.043159602880598946,635.3242735862732,260.1390001773834,955.3814086914062,28586,3536,25050,25050,0,9,3954000.0
3954,3954999,22.06021797157441,38.951293531215754,0.04317940604753634,635.4624545574188,260.20357298851013,955.5021934509277,28586,3536,25050,25050,0,9,3955000.0
3955,3955999,22.061783563503923,38.95543465269,0.043218410580786015,635.856157541275,260.26930928230286,955.3777809143066,28603,3540,25063,25063,0,9,3956000.0
3956,3956999,22.062729173101427,38.95823939406863,0.04325235479451783,636.0470757484436,260.3336868286133,955.4647560119629,28621,3541,25080,25080,0,9,3957000.0
3957,3957999,22.064056272385866,38.959792124521144,0.04330302821802379,636.2336750030518,260.3982162475586,955.5576362609863,28623,3542,25081,25081,0,9,3958000.0
3958,3958999,22.065682173483243,38.96241742819603,0.043351347813135765,636.4155025482178,260.4635615348816,955.6247940063477,28643,3543,25100,25100,0,9,3959000.0
3959,3959999,22.067587045826947,38.96504606611112,0.04339771036688245,636.5453414916992,260.5282304286957,955.7900733947754,28644,3543,25101,25101,0,9,3960000.0
3960,3960999,22.070214253806533,38.9691617570409,0.043448272178641445,636.7440299987793,260.5926923751831,955.8175354003906,28650,3544,25106,25106,0,9,3961000.0
3961,3961999,22.074615280632955,38.985434480816124,0.04355883936358451,636.9304144382477,260.6567659378052,955.917724609375,28661,3545,25116,25116,0,9,3962000.0
3962,3962999,22.077930458430416,38.992214587191235,0.04365270339009886,637.3322808742523,260.72244238853455,955.8830680847168,28679,3549,25130,25130,0,9,3963000.0
3963,3963999,22.081496288972538,39.000304211773305,0.0437257918255447,637.5947856903076,260.7874081134796,955.9288635253906,28683,3551,25132,25132,0,9,3964000.0
3964,3964999,22.08454611626762,39.004660813882865,0.043765190569762136,637.7870631217957,260.8520390987396,956.0844116210938,28689,3552,25137,25137,0,9,3965000.0
3965,3965999,22.08487694647747,39.00787303834191,0.04377555045189818,637.9095239639282,260.9157729148865,956.3234672546387,28690,3552,25138,25138,0,9,3966000.0
3966,3966999,22.08354277323665,39.00773700072546,0.04377990017602795,638.1121702194214,260.9809069633484,956.4977340698242,28695,3553,25142,25142,0,9,3967000.0
3967,3967999,22.082697777240323,39.00783541602033,0.043781554452965055,638.2497713565826,261.045615196228,956.7177734375,28697,3553,25144,25144,0,9,3968000.0
3968,3968999,22.082392006879395,39.00930677828998,0.043778305105620086,638.5027112960815,261.1105160713196,956.739574432373,28703,3555,25148,25148,0,9,3969000.0
3969,3969999,22.082225281435033,39.00959956978705,0.04378599888959156,638.6972031593323,261.1753635406494,956.8059272766113,28710,3556,25154,25154,0,9,3970000.0
3970,3970999,22.08264750906324,39.01076974155876,0.04378592853959229,638.8880913257599,261.2405321598053,956.9012756347656,28712,3557,25155,25155,0,9,3971000.0
3971,3971999,22.083211405790312,39.011688834972276,0.04379659996623286,639.0138404369354,261.30557584762573,957.0623588562012,28712,3557,25155,25155,0,9,3972000.0
3972,3972999,22.08473968348766,39.015384171858976,0.04380562050890946,639.2668459415436,261.3704123497009,957.1219596862793,28724,3559,25165,25165,0,9,3973000.0
3973,3973999,22.086547632729484,39.01925257472578,0.043826015013901154,639.3965923786163,261.43568992614746,957.251335144043,28724,3559,25165,25165,0,9,3974000.0
3974,3974999,22.088821334829515,39.02344924179058,0.04384693910439874,639.582850933075,261.4997935295105,957.2876014709473,28726,3560,25166,25166,0,9,3975000.0
3975,3975999,22.093006936633603,39.03260015102359,0.04388406402866318,639.7748312950134,261.5640399456024,957.347827911377,28733,3561,25172,25172,0,9,3976000.0
3976,3976999,22.098292429451153,39.049858861991936,0.04390506204295863,640.0358791351318,261.62903022766113,957.3862037658691,28742,3563,25179,25179,0,9,3977000.0
3977,3977999,22.10388432754762,39.060502798010326,0.04398324831748057,640.2954485416412,261.6936242580414,957.3001899719238,28754,3565,25189,25189,0,9,3978000.0
3978,3978999,22.109891690463424,39.07172964463274,0.0441030539626609,640.5631172657013,261.7644190788269,957.4733390808105,28767,3567,25200,25200,0,9,3979000.0
3979,3979999,22.115627440351233,39.08410510921764,0.044206482469627884,640.7670879364014,261.83006262779236,957.549690246582,28774,3568,25206,25206,0,9,3980000.0
3980,3980999,22.1233929014428,39.10259268108683,0.04436152784221148,641.1543822288513,261.89677596092224,957.4653472900391,28799,3572,25227,25227,0,9,3981000.0
3981,3981999,22.130007267122135,39.11576238860323,0.0445039647400044,641.4774193763733,261.96210980415344,957.6065063476562,28813,3575,25238,25238,0,9,3982000.0
3982,3982999,22.137253647417655,39.13007427974505,0.04462456959754901,641.6720976829529,262.0264117717743,957.736141204834,28819,3576,25243,25243,0,9,3983000.0
3983,3983999,22.143422070285308,39.139485699909805,0.044778193600596095,642.0615537166595,262.09132409095764,957.6294898986816,28846,3580,25266,25266,0,9,3984000.0
3984,3984999,22.1498416875101,39.1515737958046,0.044933142557783246,642.5747411251068,262.1577422618866,957.7287940979004,28875,3586,25289,25289,0,9,3985000.0
3985,3985999,22.154654808043176,39.161524591661944,0.04504154842789654,642.7595627307892,262.2218511104584,958.045524597168,28885,3587,25298,25298,0,9,3986000.0
3986,3986999,22.153116373589786,39.16020279660391,0.045040172290086056,642.9477386474609,262.28628516197205,958.2622680664062,28890,3588,25302,25302,0,9,3987000.0
3987,3987999,22.15154907000175,39.158270073846445,0.04503733208347305,643.155900478363,262.3519058227539,958.3846015930176,28910,3589,25321,25321,0,9,3988000.0
3988,3988999,22.150463666698087,39.15677616262197,0.045036560725970176,643.3460447788239,262.4166657924652,958.4588661193848,28916,3590,25326,25326,0,9,3989000.0
3989,3989999,22.149602858791596,39.15668522403555,0.045027121578205986,643.6174283027649,262.4815661907196,958.5083961486816,28924,3592,25332,25332,0,9,3990000.0
3990,3990999,22.148265934928393,39.154442969332614,0.04502382154638529,643.8140194416046,262.5464994907379,958.5878791809082,28927,3593,25334,25334,0,9,3991000.0
3991,3991999,22.147034168926798,39.15209338197973,0.045020936097341036,644.0101017951965,262.61111783981323,958.637378692627,28933,3594,25339,25339,0,9,3992000.0
3992,3992999,22.14629511225974,39.150764438032596,0.04500974587872264,644.1428573131561,262.6752495765686,958.7767295837402,28933,3594,25339,25339,0,9,3993000.0
3993,3993999,22.145855916443818,39.14983133090999,0.04499458627426378,644.2786130905151,262.7398991584778,958.9303169250488,28935,3594,25341,25341,0,9,3994000.0
3994,3994999,22.145154824364965,39.148396699301685,0.04499119925614481,644.4081819057465,262.80412220954895,959.0338478088379,28935,3594,25341,25341,0,9,3995000.0
3995,3995999,22.144732233972196,39.14731839452616,0.04497976161599426,644.5401165485382,262.867956161499,959.1756896972656,28936,3594,25342,25342,0,9,3996000.0
3996,3996999,22.14495445968873,39.14731585270447,0.04496972592710713,644.7301275730133,262.93228912353516,959.2447166442871,28938,3595,25343,25343,0,9,3997000.0
3997,3997999,22.145550310566264,39.147203420131284,0.04495942177879331,644.8482220172882,262.99631237983704,959.3542366027832,28938,3595,25343,25343,0,9,3998000.0
3998,3998999,22.147036923925302,39.149495362766245,0.044949644948929945,645.0437605381012,263.0607602596283,959.3994674682617,28945,3596,25349,25349,0,9,3999000.0
3999,3999999,22.148090039295788,39.15029045861148,0.0449483868853382,645.2518112659454,263.12578415870667,959.4026832580566,28951,3597,25354,25354,0,9,4000000.0
4000,4000999,22.14932112064853,39.15172318374034,0.044947232211956956,645.5097894668579,263.1913902759552,959.3457298278809,28964,3599,25365,25365,0,9,4001000.0
4001,4001999,22.150854155761245,39.15290525672955,0.04493750666991281,645.7849268913269,263.2598133087158,959.2970848083496,28986,3601,25385,25385,0,9,4002000.0
4002,4002999,22.15167537758523,39.15263683034432,0.04493661460815135,645.9032833576202,263.32388186454773,959.4290237426758,28987,3601,25386,25386,0,9,4003000.0
4003,4003999,22.152894214426123,39.1531981972003,0.04493996045647464,646.1596872806549,263.38846468925476,959.4395942687988,29000,3603,25397,25397,0,9,4004000.0
4004,4004999,22.15378210210095,39.15324578053175,0.044940095640779054,646.2931632995605,263.4531536102295,959.6169281005859,29001,3603,25398,25398,0,9,4005000.0
4005,4005999,22.154874686075942,39.153413949214624,0.04494128953427812,646.4156317710876,263.5172953605652,959.8189544677734,29003,3603,25400,25400,0,9,4006000.0
4006,4006999,22.154777411191557,39.15210031087852,0.04495023834608569,646.7969317436218,263.5820281505585,959.7600860595703,29024,3607,25417,25417,0,9,4007000.0
4007,4007999,22.153040295215742,39.14900240031812,0.04495109414323206,646.9267017841339,263.64619159698486,960.19140625,29032,3607,25425,25425,0,9,4008000.0
4008,4008999,22.151571466662464,39.147019104213506,0.04494830041136111,647.1904406547546,263.71127557754517,960.3869552612305,29037,3609,25428,25428,0,9,4009000.0
4009,4009999,22.150135507490912,39.14726904183525,0.04494399893711376,647.3154559135437,263.77569460868835,960.5724868774414,29038,3609,25429,25429,0,9,4010000.0
4010,4010999,22.148518723038666,39.14452595259454,0.04494526429966128,647.5776860713959,263.84130930900574,960.7174530029297,29048,3611,25437,25437,0,9,4011000.0
4011,4011999,22.147079827102964,39.14168999605057,0.04494147551137784,647.7279222011566,263.90601897239685,960.9501838684082,29048,3611,25437,25437,0,9,4012000.0
4012,4012999,22.145670336356392,39.138891833122145,0.04493842886018018,647.8562550544739,263.97052216529846,961.1524848937988,29048,3611,25437,25437,0,9,4013000.0
4013,4013999,22.144302164064047,39.13622702788911,0.04493360609140884,647.9817342758179,264.0348742008209,961.3152694702148,29048,3611,25437,25437,0,9,4014000.0
4014,4014999,22.143251596497826,39.13448036747985,0.04492356407531395,648.115914106369,264.0990171432495,961.4795799255371,29048,3611,25437,25437,0,9,4015000.0
4015,4015999,22.14199253520164,39.1317240787039,0.04492100144248734,648.2591023445129,264.16391825675964,961.6058006286621,29048,3611,25437,25437,0,9,4016000.0
4016,4016999,22.141007536709836,39.13096697529145,0.044909870015146014,648.518399477005,264.2286856174469,961.6070671081543,29052,3613,25439,25439,0,9,4017000.0
4017,4017999,22.14021362069534,39.12874460045094,0.044898336582344545,648.7202439308167,264.2930178642273,961.707878112793,29054,3614,25440,25440,0,9,4018000.0
4018,4018999,22.139348055505813,39.12645916259123,0.04489049641259579,648.9117424488068,264.35856676101685,961.7969932556152,29056,3615,25441,25441,0,9,4019000.0
4019,4019999,22.13945952955676,39.13164059189616,0.04486325620457132,649.1042239665985,264.4265491962433,961.8836097717285,29063,3616,25447,25447,0,9,4020000.0
4020,4020999,22.139333098403597,39.131167101744055,0.04484860857969997,649.2392265796661,264.49061393737793,962.1003379821777,29064,3616,25448,25448,0,9,4021000.0
4021,4021999,22.140016300492224,39.1329316086442,0.04482715491043143,649.4422183036804,264.5563850402832,962.2512512207031,29067,3617,25450,25450,0,9,4022000.0
4022,4022999,22.140440237206857,39.131700479957765,0.04482397123019788,649.5742695331573,264.62214732170105,962.4924583435059,29068,3617,25451,25451,0,9,4023000.0
4023,4023999,22.14131426304635,39.132902266106306,0.044799851668395174,649.7042100429535,264.6864380836487,962.7175521850586,29070,3617,25453,25453,0,9,4024000.0
4024,4024999,22.14211630925899,39.13220398655803,0.04477848213689961,649.9053618907928,264.7515742778778,962.896110534668,29075,3618,25457,25457,0,9,4025000.0
4025,4025999,22.141668129051038,39.13036456683149,0.04476405439710229,650.110835313797,264.8163275718689,962.9266471862793,29082,3619,25463,25463,0,9,4026000.0
4026,4026999,22.140474824268605,39.12801443927224,0.0447575476959895,650.2371335029602,264.8814630508423,963.2701988220215,29087,3619,25468,25468,0,9,4027000.0
4027,4027999,22.139279006119633,39.127056818253216,0.04474956084498771,650.4344348907471,264.94658184051514,963.4340744018555,29090,3620,25470,25470,0,9,4028000.0
4028,4028999,22.137820974182148,39.123984792902796,0.0447549540102673,650.7580139636993,265.01249861717224,963.4905738830566,29100,3623,25477,25477,0,9,4029000.0
4029,4029999,22.136433161295873,39.121401016433616,0.0447528611223551,650.9657742977142,265.0777802467346,963.6143493652344,29107,3624,25483,25483,0,9,4030000.0
4030,4030999,22.135234136674303,39.11984458013362,0.04474613451275211,651.0944814682007,265.1435663700104,963.8094863891602,29108,3624,25484,25484,0,9,4031000.0
4031,4031999,22.133782641564054,39.11657777984215,0.04474354931868518,651.2237045764923,265.2085585594177,964.029655456543,29109,3624,25485,25485,0,9,4032000.0
4032,4032999,22.132685552692553,39.11493087612777,0.044731739810057625,651.3622305393219,265.2727439403534,964.2269592285156,29112,3624,25488,25488,0,9,4033000.0
4033,4033999,22.131857085083755,39.11827508474919,0.04471474276848919,651.4879143238068,265.33706617355347,964.3888664245605,29113,3624,25489,25489,0,9,4034000.0
4034,4034999,22.13113165309931,39.11665082236591,0.044702636349023606,651.6172070503235,265.4025127887726,964.6501998901367,29116,3624,25492,25492,0,9,4035000.0
4035,4035999,22.130424521050884,39.1152297498475,0.04468785939307274,651.816547870636,265.467001914978,964.7451972961426,29124,3625,25499,25499,0,9,4036000.0
4036,4036999,22.130001133989037,39.11595273753741,0.044672364319834235,652.0096530914307,265.53143429756165,964.8808822631836,29142,3626,25516,25516,0,9,4037000.0
4037,4037999,22.129677678504947,39.11429310610911,0.04466122750203416,652.1408596038818,265.5960307121277,965.0337867736816,29143,3626,25517,25517,0,9,4038000.0
4038,4038999,22.12940250459913,39.11348344769202,0.044651603988191235,652.4233269691467,265.6609845161438,964.9999160766602,29147,3628,25519,25519,0,9,4039000.0
4039,4039999,22.129575530038785,39.1146845054495,0.04463228323139268,652.5626087188721,265.73175859451294,965.2471656799316,29150,3628,25522,25522,0,9,4040000.0
4040,4040999,22.12954167152136,39.113293218163605,0.044618022550775516,652.7574961185455,265.79750418663025,965.345832824707,29157,3629,25528,25528,0,9,4041000.0
4041,4041999,22.13043815217039,39.11308287022824,0.04460588801557985,653.013688325882,265.8618824481964,965.4351539611816,29168,3631,25537,25537,0,9,4042000.0
4042,4042999,22.130854873957315,39.112053418712755,0.04459157835928684,653.2817158699036,265.93006229400635,965.4828605651855,29176,3633,25543,25543,0,9,4043000.0
4043,4043999,22.131854936278746,39.11173942647829,0.04457831036745563,653.6115984916687,265.9964563846588,965.5798568725586,29190,3636,25554,25554,0,9,4044000.0
4044,4044999,22.132733900297026,39.11130757967699,0.04456882858852562,653.8736479282379,266.06233978271484,965.6580505371094,29204,3638,25566,25566,0,9,4045000.0
4045,4045999,22.133060025937365,39.11000036748411,0.04456052123010301,654.0598728656769,266.1268558502197,965.7851905822754,29206,3639,25567,25567,0,9,4046000.0
4046,4046999,22.13218813674858,39.108525489021325,0.04455941004124209,654.1917154788971,266.19121527671814,966.2320785522461,29218,3639,25579,25579,0,9,4047000.0
4047,4047999,22.130102761984244,39.10723292013559,0.044565855832366164,654.3998756408691,266.259174823761,966.4987030029297,29225,3640,25585,25585,0,9,4048000.0
4048,4048999,22.12807727610178,39.104228028443124,0.04457365548021197,654.529287815094,266.32397270202637,966.7254219055176,29225,3640,25585,25585,0,9,4049000.0
4049,4049999,22.126213764774164,39.10178067571188,0.04458046862192411,654.6689732074738,266.38871574401855,966.945873260498,29225,3640,25585,25585,0,9,4050000.0
4050,4050999,22.124408097436334,39.09861361566572,0.044590353780339265,654.8784596920013,266.454478263855,967.063117980957,29227,3641,25586,25586,0,9,4051000.0
4051,4051999,22.122841491387224,39.09578664727511,0.044598533578451005,655.0002110004425,266.51892924308777,967.1898880004883,29227,3641,25586,25586,0,9,4052000.0
4052,4052999,22.12184577960759,39.09406788281655,0.04460050076093003,655.1923604011536,266.5843937397003,967.3029861450195,29230,3642,25588,25588,0,9,4053000.0
4053,4053999,22.12107660736009,39.092429181920146,0.04460421309157758,655.3312728404999,266.64957213401794,967.4393768310547,29230,3642,25588,25588,0,9,4054000.0
4054,4054999,22.1203189930902,39.091015746196184,0.04461132306254645,655.4545524120331,266.7139000892639,967.5837097167969,29231,3642,25589,25589,0,9,4055000.0
4055,4055999,22.12008239711026,39.09069397153669,0.04461018263674388,655.585363149643,266.77816557884216,967.7037887573242,29232,3642,25590,25590,0,9,4056000.0
4056,4056999,22.120316323863594,39.09146929088721,0.044617146471459646,655.8486609458923,266.84300231933594,967.6754913330078,29236,3644,25592,25592,0,9,4057000.0
4057,4057999,22.120792102490842,39.09258295434678,0.044621163005829745,655.984493970871,266.90757417678833,967.8171424865723,29236,3644,25592,25592,0,9,4058000.0
4058,4058999,22.121396675458215,39.0943885279599,0.0446353229022971,656.2033681869507,266.97250390052795,967.8214721679688,29238,3645,25593,25593,0,9,4059000.0
4059,4059999,22.122303993736136,39.09582430575544,0.044645966274966864,656.3322696685791,267.0368809700012,967.9285087585449,29238,3645,25593,25593,0,9,4060000.0
4060,4060999,22.1232817454857,39.09682018136323,0.04464403430995889,656.6718842983246,267.1023600101471,967.9037666320801,29253,3648,25605,25605,0,9,4061000.0
4061,4061999,22.124902935890287,39.09919505837994,0.044650775717028135,656.9327802658081,267.16740703582764,968.0226097106934,29258,3650,25608,25608,0,9,4062000.0
4062,4062999,22.12669797167919,39.101286863952055,0.04467738639302332,657.0577325820923,267.23151087760925,968.2174263000488,29258,3650,25608,25608,0,9,4063000.0
4063,4063999,22.12860357632417,39.10295168098895,0.044683404131584004,657.4421772956848,267.29742074012756,968.2324256896973,29287,3654,25633,25633,0,9,4064000.0
4064,4064999,22.129887262678686,39.10364548083607,0.04470445472066864,657.7089104652405,267.3631384372711,968.2513999938965,29300,3656,25644,25644,0,9,4065000.0
4065,4065999,22.13190188600292,39.10545895498758,0.0446823177745066,657.969343662262,267.42844414711,968.290943145752,29304,3658,25646,25646,0,9,4066000.0
4066,4066999,22.132963594487705,39.10518845566095,0.04469194669570009,658.2267684936523,267.49339962005615,968.390022277832,29328,3660,25668,25668,0,9,4067000.0
4067,4067999,22.134023046074535,39.10757937844895,0.04469187868515323,658.489176273346,267.56100153923035,968.8944435119629,29366,3662,25704,25704,0,9,4068000.0
4068,4068999,22.132054338143657,39.10421431807415,0.044701200818246356,658.6225752830505,267.62624526023865,969.3114471435547,29371,3662,25709,25709,0,9,4069000.0
4069,4069999,22.130209709172068,39.10175200331173,0.04470822102535654,658.759687423706,267.6914985179901,969.6086502075195,29372,3662,25710,25710,0,9,4070000.0
4070,4070999,22.128752101036138,39.101497351654196,0.04471381210128389,658.9594700336456,267.75708770751953,969.7547607421875,29374,3663,25711,25711,0,9,4071000.0
4071,4071999,22.12690175290903,39.09830319243862,0.04472497468716852,659.0947182178497,267.822633266449,969.9139976501465,29374,3663,25711,25711,0,9,4072000.0
4072,4072999,22.12538660579069,39.095863427842836,0.04472250836040259,659.2894852161407,267.8878798484802,970.0063400268555,29376,3664,25712,25712,0,9,4073000.0
4073,4073999,22.12401591811146,39.093900583376254,0.044728994175300074,659.4227511882782,267.9530985355377,970.1501312255859,29376,3664,25712,25712,0,9,4074000.0
4074,4074999,22.12241461039411,39.090743648575895,0.04473288136296538,659.5463099479675,268.01799416542053,970.3345794677734,29377,3664,25713,25713,0,9,4075000.0
4075,4075999,22.121151590414318,39.08845400883655,0.04473427401824759,659.8169403076172,268.08342599868774,970.3981628417969,29381,3666,25715,25715,0,9,4076000.0
4076,4076999,22.119569300067337,39.08532490880926,0.04473485215595896,659.9474484920502,268.14851212501526,970.5778923034668,29382,3666,25716,25716,0,9,4077000.0
4077,4077999,22.118438854518466,39.08302215488266,0.04473057049012252,660.0909447669983,268.2141408920288,970.6827011108398,29382,3666,25716,25716,0,9,4078000.0
4078,4078999,22.11726791681908,39.080459421327774,0.04472480483228558,660.3553891181946,268.2796998023987,970.7763404846191,29401,3668,25733,25733,0,9,4079000.0
4079,4079999,22.116336934057305,39.07826073017383,0.044710547305157444,660.5550787448883,268.345397233963,970.8625373840332,29403,3669,25734,25734,0,9,4080000.0
4080,4080999,22.11574149785806,39.07672366195791,0.04469046239691754,660.7546977996826,268.4107072353363,970.9188194274902,29410,3670,25740,25740,0,9,4081000.0
4081,4081999,22.115003752752887,39.07445895953035,0.044668623995548606,660.9446856975555,268.47605538368225,971.1036682128906,29417,3671,25746,25746,0,9,4082000.0
4082,4082999,22.114658439146023,39.07605598969381,0.04464836602456712,661.2117359638214,268.5429971218109,971.2117156982422,29434,3673,25761,25761,0,9,4083000.0
4083,4083999,22.11441053895898,39.07490191818918,0.044632835862430054,661.4808533191681,268.608345746994,971.3873062133789,29446,3675,25771,25771,0,9,4084000.0
4084,4084999,22.11404299195187,39.073215640234565,0.044624832680528526,661.6221606731415,268.6729836463928,971.5150947570801,29446,3675,25771,25771,0,9,4085000.0
4085,4085999,22.113446347559943,39.071002508143394,0.04461931796054386,661.8154618740082,268.73764276504517,971.5869636535645,29448,3676,25772,25772,0,9,4086000.0
4086,4086999,22.113022794739766,39.06885431284518,0.04460791924699925,662.0190114974976,268.8032739162445,971.7093276977539,29455,3677,25778,25778,0,9,4087000.0
4087,4087999,22.11270854874955,39.06663770979521,0.04459679377654702,662.223265171051,268.87001633644104,971.8366355895996,29457,3678,25779,25779,0,9,4088000.0
4088,4088999,22.111797513189845,39.06416408601581,0.04459023842330312,662.413610458374,268.9348089694977,971.9767608642578,29464,3679,25785,25785,0,9,4089000.0
4089,4089999,22.10980368763001,39.06067715977015,0.04459666842815713,662.6848664283752,269.00182914733887,972.6462478637695,29502,3681,25821,25821,0,9,4090000.0
4090,4090999,22.10775727723098,39.057078886234386,0.04460297146328884,662.8132812976837,269.06709909439087,973.189567565918,29506,3681,25825,25825,0,9,4091000.0
4091,4091999,22.105602002262227,39.053738422511195,0.04460956013525408,663.0098733901978,269.13262486457825,973.4422760009766,29513,3682,25831,25831,0,9,4092000.0
4092,4092999,22.103979381985674,39.0506238859255,0.04461542766734505,663.1402525901794,269.1979281902313,973.7163772583008,29514,3682,25832,25832,0,9,4093000.0
4093,4093999,22.10267323848244,39.04813267095514,0.044610354923602435,663.3966429233551,269.2633521556854,973.8353881835938,29518,3684,25834,25834,0,9,4094000.0
4094,4094999,22.101272794005805,39.04543673215754,0.04461482326955679,663.7248020172119,269.3294234275818,973.8950233459473,29544,3687,25857,25857,0,9,4095000.0
4095,4095999,22.099684701290407,39.042240880805814,0.04461606685106445,663.9261567592621,269.3959963321686,974.2091331481934,29552,3688,25864,25864,0,9,4096000.0
4096,4096999,22.098440372675384,39.039486367276645,0.04461619357509772,664.0518505573273,269.4609806537628,974.4760551452637,29553,3688,25865,25865,0,9,4097000.0
4097,4097999,22.09730152806251,39.037585470765585,0.044611280625109995,664.2427067756653,269.527086019516,974.6349258422852,29555,3689,25866,25866,0,9,4098000.0
4098,4098999,22.09633075950707,39.03570464540759,0.04461006116359978,664.5064771175385,269.5929992198944,974.8984680175781,29563,3691,25872,25872,0,9,4099000.0
4099,4099999,22.095490573438056,39.03398461696618,0.044596084714690565,664.7000772953033,269.65819215774536,975.1422920227051,29566,3692,25874,25874,0,9,4100000.0
4100,4100999,22.095124000202425,39.0324939541897,0.044579479169252534,664.9629492759705,269.7240514755249,975.3298683166504,29576,3694,25882,25882,0,9,4101000.0
4101,4101999,22.095465171658034,39.03630955907265,0.04456099588081486,665.091340303421,269.78919529914856,975.5837516784668,29579,3694,25885,25885,0,9,4102000.0
4102,4102999,22.095698757656823,39.03496841470233,0.04454196078355921,665.4166741371155,269.856885433197,975.611759185791,29589,3697,25892,25892,0,9,4103000.0
4103,4103999,22.096133609553462,39.034309825394246,0.04452733250555896,665.6702165603638,269.92403841018677,975.8763160705566,29599,3699,25900,25900,0,9,4104000.0
4104,4104999,22.096557548194124,39.03374641604508,0.04451755959935633,665.9879832267761,269.989750623703,976.0461730957031,29611,3702,25909,25909,0,9,4105000.0
4105,4105999,22.097058910946032,39.03306030587964,0.04450067792091572,666.1185932159424,270.05502820014954,976.4070129394531,29614,3702,25912,25912,0,9,4106000.0
4106,4106999,22.097870091661218,39.03254657620113,0.044487027003164425,666.2718307971954,270.13013768196106,976.7749443054199,29616,3702,25914,25914,0,9,4107000.0
4107,4107999,22.09869409168277,39.032103608490054,0.04446741645840868,666.4657294750214,270.1952495574951,976.9326591491699,29621,3703,25918,25918,0,9,4108000.0
4108,4108999,22.099615686722906,39.03155504060002,0.04446300957551508,666.6667366027832,270.26087069511414,977.0721626281738,29625,3704,25921,25921,0,9,4109000.0
4109,4109999,22.099849332714268,39.029959758467804,0.044459488308538964,666.8631482124329,270.32701110839844,977.231071472168,29632,3705,25927,25927,0,9,4110000.0
4110,4110999,22.099230462602154,39.02828383983535,0.04445687486864058,666.9894549846649,270.3928301334381,977.9661560058594,29654,3705,25949,25949,0,9,4111000.0
4111,4111999,22.097665285358435,39.02576127396121,0.044457696440843075,667.1802544593811,270.458153963089,978.3747138977051,29659,3706,25953,25953,0,9,4112000.0
4112,4112999,22.096890648606223,39.02421733642814,0.044465246614243115,667.3097038269043,270.52299284935,978.6752090454102,29660,3706,25954,25954,0,9,4113000.0
4113,4113999,22.09687211873238,39.02435748983978,0.04447415558241219,667.4394316673279,270.58917927742004,978.9044342041016,29660,3706,25954,25954,0,9,4114000.0
4114,4114999,22.09681256157843,39.02454515420336,0.04447393194257865,667.6415410041809,270.65458726882935,979.0750312805176,29663,3707,25956,25956,0,9,4115000.0
4115,4115999,22.09688996918942,39.02396916334797,0.04447308088271329,667.8309631347656,270.7193925380707,979.2531127929688,29666,3708,25958,25958,0,9,4116000.0
4116,4116999,22.0972132912864,39.02380791464194,0.04446743087313676,668.0836489200592,270.784788608551,979.3914680480957,29695,3710,25985,25985,0,9,4117000.0
4117,4117999,22.09733079441884,39.02432298748151,0.04445894418754304,668.3490312099457,270.8500316143036,979.4969520568848,29707,3712,25995,25995,0,9,4118000.0
4118,4118999,22.097551010836174,39.02751321405738,0.04445525042511034,668.562441110611,270.92347717285156,979.7481117248535,29709,3713,25996,25996,0,9,4119000.0
4119,4119999,22.098367861251806,39.028313533601214,0.044432906782378545,668.8210732936859,270.98871207237244,979.9860420227051,29715,3715,26000,26000,0,9,4120000.0
4120,4120999,22.099078673939044,39.028751825577366,0.044432680055325635,669.0790691375732,271.0540635585785,980.1964149475098,29720,3717,26003,26003,0,9,4121000.0
4121,4121999,22.100076133150758,39.02985248000776,0.0444306569023557,669.2780237197876,271.12032198905945,980.4188690185547,29724,3718,26006,26006,0,9,4122000.0
4122,4122999,22.101704760084537,39.0312243434879,0.04443848524658289,669.5420227050781,271.18672704696655,980.5341529846191,29732,3720,26012,26012,0,9,4123000.0
4123,4123999,22.103289749922425,39.03278737048533,0.04445958766671676,669.6755127906799,271.2519872188568,980.7604827880859,29733,3720,26013,26013,0,9,4124000.0
4124,4124999,22.105400254793242,39.037086596451296,0.04446391928715787,669.7947356700897,271.31678557395935,981.000244140625,29733,3720,26013,26013,0,9,4125000.0
4125,4125999,22.107145152768798,39.0387063829738,0.044487046135866515,669.917849779129,271.38173937797546,981.2577781677246,29734,3720,26014,26014,0,9,4126000.0
4126,4126999,22.10956517237551,39.04166928693609,0.04452782494818808,670.1858878135681,271.4481692314148,981.3708877563477,29742,3722,26020,26020,0,9,4127000.0
4127,4127999,22.111636722305864,39.04354290570866,0.04455894091025914,670.4442319869995,271.5135691165924,981.5593605041504,29759,3724,26035,26035,0,9,4128000.0
4128,4128999,22.114792975957116,39.05169573352497,0.04460605749646285,670.5746574401855,271.57907915115356,981.823600769043,29761,3724,26037,26037,0,9,4129000.0
4129,4129999,22.117203819191083,39.05371733249194,0.04464904750867127,670.8413560390472,271.6460418701172,982.014591217041,29765,3726,26039,26039,0,9,4130000.0
4130,4130999,22.11893569182967,39.054512233847824,0.04468708810992206,671.1042320728302,271.71145510673523,982.3206062316895,29787,3728,26059,26059,0,9,4131000.0
4131,4131999,22.119186027421662,39.05604269935184,0.04468529005472999,671.2308375835419,271.77746415138245,982.7889747619629,29796,3728,26068,26068,0,9,4132000.0
4132,4132999,22.118167270839855,39.05579669593491,0.04467456882298626,671.5029530525208,271.84295439720154,983.024055480957,29806,3730,26076,26076,0,9,4133000.0
4133,4133999,22.11687203182692,39.05448295246947,0.04466263519271163,671.6592540740967,271.91549038887024,983.2666320800781,29806,3730,26076,26076,0,9,4134000.0
4134,4134999,22.115647288678012,39.05335394468201,0.04465453811563669,671.9233498573303,271.9810001850128,983.3305473327637,29818,3732,26086,26086,0,9,4135000.0
4135,4135999,22.114780076958652,39.05301521393874,0.04464452615869552,672.1167900562286,272.04603457450867,983.4461975097656,29824,3733,26091,26091,0,9,4136000.0
4136,4136999,22.113706156800884,39.050932367286606,0.044637586634851845,672.3857505321503,272.1111385822296,983.5366592407227,29828,3735,26093,26093,0,9,4137000.0
4137,4137999,22.11247761615175,39.04846764845258,0.04463559210774248,672.5121474266052,272.17577600479126,983.6691360473633,29828,3735,26093,26093,0,9,4138000.0
4138,4138999,22.111319654234585,39.046197357127035,0.044629102601759674,672.7076876163483,272.24116706848145,983.7254867553711,29830,3736,26094,26094,0,9,4139000.0
4139,4139999,22.110205519728055,39.044559760292074,0.04462202219283218,672.837812423706,272.3065855503082,983.9124450683594,29832,3736,26096,26096,0,9,4140000.0
4140,4140999,22.10918343491787,39.04236883432603,0.04461538329925907,673.0423562526703,272.3723497390747,983.9660835266113,29835,3737,26098,26098,0,9,4141000.0
4141,4141999,22.108442442070196,39.04174181936319,0.04461206239408633,673.3841631412506,272.4375021457672,983.9046363830566,29841,3740,26101,26101,0,9,4142000.0
4142,4142999,22.108308767990128,39.04128459072124,0.04461042781035396,673.5768218040466,272.50255274772644,984.0884857177734,29843,3741,26102,26102,0,9,4143000.0
4143,4143999,22.109101414565053,39.046827571647235,0.044609003594697216,673.7096772193909,272.5674960613251,984.1914215087891,29843,3741,26102,26102,0,9,4144000.0
4144,4144999,22.110256949170743,39.049034824201236,0.044620180894396455,673.836177110672,272.63156604766846,984.2956962585449,29843,3741,26102,26102,0,9,4145000.0
4145,4145999,22.112319591070715,39.057244970906886,0.044624692329469196,673.9796068668365,272.6963138580322,984.412239074707,29843,3741,26102,26102,0,9,4146000.0
4146,4146999,22.11522917147656,39.06731836009202,0.044652046283246816,674.2388753890991,272.7609078884125,984.4445762634277,29847,3743,26104,26104,0,9,4147000.0
4147,4147999,22.120987583655452,39.082801523583306,0.04473932920209134,674.3746075630188,272.8254280090332,984.5747375488281,29847,3743,26104,26104,0,9,4148000.0
4148,4148999,22.126755953313673,39.0982237197747,0.04481650616812216,674.5710799694061,272.8899939060211,984.6821060180664,29854,3744,26110,26110,0,9,4149000.0
4149,4149999,22.131885101471852,39.108768249688055,0.04486729288173896,674.7794909477234,272.95501828193665,984.7781639099121,29862,3745,26117,26117,0,9,4150000.0
4150,4150999,22.138057740807614,39.12316802788337,0.044921200733930244,674.9132070541382,273.01960158348083,984.9104919433594,29862,3745,26117,26117,0,9,4151000.0
4151,4151999,22.14405868391249,39.13504467135447,0.04497070512379042,675.040207862854,273.0837781429291,985.057315826416,29862,3745,26117,26117,0,9,4152000.0
4152,4152999,22.14633083735117,39.1387052754123,0.0449871516069239,675.2374892234802,273.1484942436218,985.2037696838379,29874,3746,26128,26128,0,9,4153000.0
4153,4153999,22.14479403799045,39.13650132729947,0.04499038887292006,675.379739522934,273.213791847229,985.477653503418,29878,3746,26132,26132,0,9,4154000.0
4154,4154999,22.14349298385899,39.134767022280485,0.044987732804855685,675.6466729640961,273.2789068222046,985.5484809875488,29882,3748,26134,26134,0,9,4155000.0
4155,4155999,22.1426622162363,39.135059525850146,0.04499275321174323,675.7804553508759,273.34422063827515,985.7195777893066,29883,3748,26135,26135,0,9,4156000.0
4156,4156999,22.141922715669853,39.133788606579806,0.04498341175811038,675.9841299057007,273.4090039730072,985.8304252624512,29886,3749,26137,26137,0,9,4157000.0
4157,4157999,22.140641902862836,39.13110192599425,0.04497970066208401,676.1103234291077,273.4736647605896,985.9658012390137,29887,3749,26138,26138,0,9,4158000.0
4158,4158999,22.139394321667258,39.12905114777384,0.04497405193903503,676.2347002029419,273.53855562210083,986.0853042602539,29887,3749,26138,26138,0,9,4159000.0
4159,4159999,22.138389671692757,39.127062386195156,0.04496746484001679,676.3621091842651,273.60322070121765,986.2136383056641,29887,3749,26138,26138,0,9,4160000.0
4160,4160999,22.137603995151142,39.12577035582141,0.04496298977172841,676.6507878303528,273.66842460632324,986.2439079284668,29894,3751,26143,26143,0,9,4161000.0
4161,4161999,22.136955347732677,39.124488728995146,0.04495487149280286,676.7846992015839,273.73350262641907,986.3518524169922,29894,3751,26143,26143,0,9,4162000.0
4162,4162999,22.136821456993818,39.123719461074984,0.04495334133915807,676.922033071518,273.79805183410645,986.4417152404785,29894,3751,26143,26143,0,9,4163000.0
4163,4163999,22.13693128807421,39.123072023037516,0.044953187072482526,677.109644651413,273.86259031295776,986.4581985473633,29902,3752,26150,26150,0,9,4164000.0
4164,4164999,22.137730118268223,39.12386989936403,0.04495462977247722,677.2286393642426,273.9249176979065,986.5650596618652,29902,3752,26150,26150,0,9,4165000.0
4165,4165999,22.138248549855344,39.1238770671755,0.04495196058278139,677.3580074310303,273.98922538757324,986.6799240112305,29903,3752,26151,26151,0,9,4166000.0
4166,4166999,22.13985919796988,39.129676879150196,0.044938553481183474,677.4951586723328,274.0534858703613,986.7926063537598,29903,3752,26151,26151,0,9,4167000.0
4167,4167999,22.140368753405568,39.12946627292508,0.04493417975746483,677.6160850524902,274.1175014972687,986.8972816467285,29904,3752,26152,26152,0,9,4168000.0
4168,4168999,22.14102072218111,39.129236982191784,0.044924861663875215,677.8682560920715,274.17899441719055,986.8465957641602,29916,3754,26162,26162,0,9,4169000.0
4169,4169999,22.141721891314095,39.12913217667467,0.04492030796645585,678.2737016677856,274.2443823814392,986.7238693237305,29935,3758,26177,26177,0,9,4170000.0
4170,4170999,22.141971766000694,39.12837391098601,0.044916031020834635,678.3913698196411,274.3064820766449,986.9203338623047,29935,3758,26177,26177,0,9,4171000.0
4171,4171999,22.140747788318592,39.1256574828894,0.0449086014417468,678.649938583374,274.36852383613586,987.00830078125,29939,3760,26179,26179,0,9,4172000.0
4172,4172999,22.1390131763876,39.122565385858124,0.0449145612012416,678.7732148170471,274.4328601360321,987.179328918457,29939,3760,26179,26179,0,9,4173000.0
4173,4173999,22.137550712218797,39.12105692924551,0.04491545966416144,678.9085147380829,274.4972565174103,987.3299369812012,29939,3760,26179,26179,0,9,4174000.0
4174,4174999,22.136334779900004,39.11897268327712,0.04491806559445011,679.054193019867,274.5594048500061,987.4289283752441,29939,3760,26179,26179,0,9,4175000.0
4175,4175999,22.13541290104513,39.11695299473947,0.04491681569454731,679.1791994571686,274.6215512752533,987.5221900939941,29939,3760,26179,26179,0,9,4176000.0
4176,4176999,22.134430804761436,39.1150772964283,0.044912446454247856,679.3064396381378,274.6851019859314,987.6663284301758,29939,3760,26179,26179,0,9,4177000.0
4177,4177999,22.133378814914646,39.113745354210735,0.044913313599889815,679.4269170761108,274.74909472465515,987.7807006835938,29940,3760,26180,26180,0,9,4178000.0
4178,4178999,22.13370115053688,39.116673234927354,0.04492932379648784,679.6243822574615,274.81136870384216,987.8453559875488,29946,3761,26185,26185,0,9,4179000.0
4179,4179999,22.136958947982123,39.12906870707897,0.04490397279543268,679.8140115737915,274.8728518486023,988.0014572143555,29949,3762,26187,26187,0,9,4180000.0
4180,4180999,22.14063240008036,39.14089672053873,0.04491637542293925,679.9387793540955,274.93399238586426,988.137279510498,29950,3762,26188,26188,0,9,4181000.0
4181,4181999,22.146650012319952,39.16351116978816,0.044979508253371714,680.190191745758,274.9978768825531,988.2209434509277,29957,3764,26193,26193,0,9,4182000.0
4182,4182999,22.15355683405759,39.18413307940704,0.045043185124412854,680.5110604763031,275.0614318847656,988.2713241577148,29968,3767,26201,26201,0,9,4183000.0
4183,4183999,22.16147415311099,39.20852366597407,0.045090633609795594,680.7682428359985,275.1236274242401,988.2701835632324,29981,3769,26212,26212,0,9,4184000.0
4184,4184999,22.168887214097875,39.228580712145785,0.04514882846901058,680.9527971744537,275.18548703193665,988.3788986206055,29987,3770,26217,26217,0,9,4185000.0
4185,4185999,22.177490366557368,39.24975796232283,0.04522897822764782,681.2097005844116,275.24826097488403,988.3953742980957,29999,3772,26227,26227,0,9,4186000.0
4186,4186999,22.187020853447855,39.2785763929753,0.04531664532192392,681.3291916847229,275.3094410896301,988.5620269775391,29999,3772,26227,26227,0,9,4187000.0
4187,4187999,22.194431888133632,39.29478714408184,0.04537715681572463,681.5123841762543,275.37081384658813,988.6559906005859,30005,3773,26232,26232,0,9,4188000.0
4188,4188999,22.203332933983425,39.318481814141535,0.045438142960531835,681.7016713619232,275.4322307109833,988.6653213500977,30007,3774,26233,26233,0,9,4189000.0
4189,4189999,22.211259422856973,39.33514946555575,0.04552469663435932,682.0176866054535,275.495489358902,988.6157035827637,30025,3777,26248,26248,0,9,4190000.0
4190,4190999,22.21485140180943,39.34289098286129,0.04555311057956113,682.20485496521,275.5583620071411,988.8024749755859,30031,3778,26253,26253,0,9,4191000.0
4191,4191999,22.21410400472965,39.34458561742183,0.04553686929398393,682.4602563381195,275.6208076477051,988.9004211425781,30039,3780,26259,26259,0,9,4192000.0
4192,4192999,22.213852766294604,39.34743223591034,0.04552574543172183,682.6615929603577,275.6839237213135,989.0184593200684,30043,3781,26262,26262,0,9,4193000.0
4193,4193999,22.21377565612903,39.34845537794344,0.045511175264261294,682.7823169231415,275.7458653450012,989.187931060791,30043,3781,26262,26262,0,9,4194000.0
4194,4194999,22.21373843118282,39.348934127460566,0.04550061384630577,683.0400953292847,275.8084011077881,989.2071342468262,30047,3783,26264,26264,0,9,4195000.0
4195,4195999,22.213325555966627,39.34823875434707,0.045486301658454686,683.1687769889832,275.8697090148926,989.3216552734375,30047,3783,26264,26264,0,9,4196000.0
4196,4196999,22.21268840430247,39.347251272007824,0.04548171947068702,683.3018908500671,275.9344148635864,989.4876899719238,30047,3783,26264,26264,0,9,4197000.0
4197,4197999,22.212437254154672,39.34670089512719,0.04547388606821978,683.493124961853,275.9964532852173,989.5935821533203,30050,3784,26266,26266,0,9,4198000.0
4198,4198999,22.21241244530669,39.34716083014986,0.0454719492740806,683.6923699378967,276.05902123451233,989.6634941101074,30065,3785,26280,26280,0,9,4199000.0
4199,4199999,22.212542894900228,39.34774886087887,0.04547502176419882,683.9593544006348,276.12436604499817,989.7398910522461,30083,3787,26296,26296,0,9,4200000.0
4200,4200999,22.213269700709542,39.34943680875444,0.04549657529938822,684.1564843654633,276.1890504360199,989.857837677002,30097,3788,26309,26309,0,9,4201000.0
4201,4201999,22.214223458028222,39.35172656931379,0.045502395731959244,684.2837357521057,276.2504737377167,990.0143737792969,30098,3788,26310,26310,0,9,4202000.0
4202,4202999,22.21596471330354,39.35476931471944,0.0455197127650665,684.4743659496307,276.31469917297363,990.1266212463379,30115,3789,26326,26326,0,9,4203000.0
4203,4203999,22.217752512127205,39.357895058622006,0.04555398551976486,684.6037073135376,276.3785674571991,990.2500190734863,30115,3789,26326,26326,0,9,4204000.0
4204,4204999,22.220031133462406,39.360603165683195,0.045574390326327374,684.8602900505066,276.440269947052,990.2874946594238,30126,3791,26335,26335,0,9,4205000.0
4205,4205999,22.22321147144095,39.366156887570014,0.04559109458321764,685.0545952320099,276.5036430358887,990.3659400939941,30128,3792,26336,26336,0,9,4206000.0
4206,4206999,22.226080046692214,39.370249143284305,0.0456049357207865,685.3240892887115,276.56596159935,990.4015998840332,30140,3794,26346,26346,0,9,4207000.0
4207,4207999,22.229383305901745,39.37587255910616,0.04561972579463469,685.6040663719177,276.6301643848419,990.4844741821289,30150,3796,26354,26354,0,9,4208000.0
4208,4208999,22.232131015723205,39.379184705453284,0.045623920979663724,685.9268271923065,276.6926965713501,990.4550857543945,30166,3799,26367,26367,0,9,4209000.0
4209,4209999,22.235290637074943,39.38321182961539,0.04565123939047144,686.1264538764954,276.7550778388977,990.5817260742188,30169,3800,26369,26369,0,9,4210000.0
4210,4210999,22.237077168748954,39.384112906051655,0.04566572043937256,686.3813076019287,276.8179111480713,990.7452011108398,30181,3802,26379,26379,0,9,4211000.0
4211,4211999,22.23742194597494,39.38415911343507,0.04566984250260642,686.5349264144897,276.8995888233185,991.0822715759277,30183,3802,26381,26381,0,9,4212000.0
4212,4212999,22.235763452013753,39.38259784428145,0.04567107725159825,686.7279970645905,276.9633090496063,991.3634452819824,30189,3803,26386,26386,0,9,4213000.0
4213,4213999,22.23411922903536,39.379936947448144,0.04567504357834795,686.9198884963989,277.02841567993164,991.5356483459473,30192,3804,26388,26388,0,9,4214000.0
4214,4214999,22.232762528139425,39.37747370873056,0.04567927391765825,687.11718916893,277.0914936065674,991.601432800293,30212,3805,26407,26407,0,9,4215000.0
4215,4215999,22.23137811521861,39.3748984343436,0.045677274670914314,687.3070828914642,277.15369725227356,991.8019027709961,30215,3806,26409,26409,0,9,4216000.0
4216,4216999,22.230090721848256,39.37307138363589,0.045670572522055974,687.5004949569702,277.2154026031494,991.955883026123,30217,3807,26410,26410,0,9,4217000.0
4217,4217999,22.228664117373906,39.37039503992131,0.045675249868033285,687.6965141296387,277.27787733078003,992.1568145751953,30224,3808,26416,26416,0,9,4218000.0
4218,4218999,22.227151187241976,39.367618752262736,0.04567433144961841,687.9566450119019,277.34144377708435,992.2576103210449,30240,3810,26430,26430,0,9,4219000.0
4219,4219999,22.22616720706137,39.36630059465254,0.04567461476592505,688.0858561992645,277.4061315059662,992.519401550293,30240,3810,26430,26430,0,9,4220000.0
4220,4220999,22.225203526405288,39.3648158856531,0.045674470605441164,688.281044960022,277.4682123661041,992.7164421081543,30243,3811,26432,26432,0,9,4221000.0
4221,4221999,22.224215630530054,39.36266891552421,0.04566947598282822,688.5449604988098,277.53104615211487,992.8350677490234,30250,3813,26437,26437,0,9,4222000.0
4222,4222999,22.223704545056258,39.3613966332784,0.04566679564850129,688.6794319152832,277.59316301345825,993.0678329467773,30252,3813,26439,26439,0,9,4223000.0
4223,4223999,22.224732908512575,39.36320794492808,0.04567837565038668,688.8068034648895,277.6582317352295,993.2766647338867,30254,3813,26441,26441,0,9,4224000.0
4224,4224999,22.225658282875518,39.3649024480077,0.045689539044912686,688.9954810142517,277.7204840183258,993.4383506774902,30257,3814,26443,26443,0,9,4225000.0
4225,4225999,22.22747298843764,39.36711836595692,0.045703885027620794,689.1895031929016,277.78482151031494,993.5875663757324,30260,3815,26445,26445,0,9,4226000.0
4226,4226999,22.228919296751975,39.36989710907046,0.045706496440983346,689.4449717998505,277.8479149341583,993.6559448242188,30265,3817,26448,26448,0,9,4227000.0
4227,4227999,22.231030098519227,39.37676462875505,0.045706629297677215,689.6453533172607,277.9106273651123,993.7700309753418,30268,3818,26450,26450,0,9,4228000.0
4228,4228999,22.233500481965777,39.38125005823963,0.045708658064507635,689.8384020328522,277.9736759662628,993.9256324768066,30282,3819,26463,26463,0,9,4229000.0
4229,4229999,22.23524590049737,39.38466519458829,0.04570507010378888,690.0417773723602,278.0377938747406,994.1418952941895,30285,3820,26465,26465,0,9,4230000.0
4230,4230999,22.236817935924172,39.3856740131396,0.04570645548693375,690.2313041687012,278.1015133857727,994.2953834533691,30288,3821,26467,26467,0,9,4231000.0
4231,4231999,22.238470887134508,39.38675183403316,0.04569466484620299,690.3586390018463,278.16257548332214,994.5333709716797,30290,3821,26469,26469,0,9,4232000.0
4232,4232999,22.23831815159531,39.385335871585866,0.045693552379504676,690.551308631897,278.2257697582245,994.869815826416,30302,3822,26480,26480,0,9,4233000.0
4233,4233999,22.23712579726129,39.38292786023483,0.04568190375577763,690.8030114173889,278.28909492492676,995.5665588378906,30340,3824,26516,26516,0,9,4234000.0
4234,4234999,22.235478215504976,39.38071831049156,0.04568264820327528,690.9246435165405,278.3517327308655,996.0619621276855,30350,3824,26526,26526,0,9,4235000.0
4235,4235999,22.23383629857027,39.37788724148382,0.04567234075890003,691.0521795749664,278.41477155685425,996.404239654541,30354,3824,26530,26530,0,9,4236000.0
4236,4236999,22.23246846111458,39.375291005701115,0.04566784508427513,691.3123202323914,278.47695899009705,996.6917457580566,30373,3826,26547,26547,0,9,4237000.0
4237,4237999,22.231755463860026,39.37408825556484,0.0456534408677477,691.4379577636719,278.54265213012695,997.0456008911133,30377,3826,26551,26551,0,9,4238000.0
4238,4238999,22.230796318510148,39.371704961756215,0.04564237015316497,691.5573778152466,278.60412430763245,997.3410377502441,30383,3826,26557,26557,0,9,4239000.0
4239,4239999,22.22998840870956,39.36989671421146,0.04563023059101379,691.760204076767,278.66643595695496,997.6056747436523,30402,3827,26575,26575,0,9,4240000.0
4240,4240999,22.22941170485032,39.36819093932317,0.04562066561246081,691.880288362503,278.72681617736816,997.8900032043457,30405,3827,26578,26578,0,9,4241000.0
4241,4241999,22.229252078917717,39.36816245646432,0.04561252202877497,692.141758441925,278.78874349594116,997.9813804626465,30412,3829,26583,26583,0,9,4242000.0
4242,4242999,22.229432079124397,39.367650204355556,0.0456011068954435,692.395845413208,278.85258436203003,998.2178688049316,30430,3831,26599,26599,0,9,4243000.0
4243,4243999,22.22945731760479,39.36666041820566,0.045595374562537594,692.664776802063,278.9187891483307,998.4072914123535,30440,3833,26607,26607,0,9,4244000.0
4244,4244999,22.23039344736269,39.36694781213007,0.0456024092307008,692.7915706634521,278.97991490364075,998.5701026916504,30440,3833,26607,26607,0,9,4245000.0
4245,4245999,22.2319054945176,39.37048554311104,0.0456203548679065,693.058806180954,279.04230213165283,998.6833343505859,30455,3835,26620,26620,0,9,4246000.0
4246,4246999,22.23405714650213,39.372791348275264,0.04564389434902005,693.1896216869354,279.10701608657837,998.8824996948242,30457,3835,26622,26622,0,9,4247000.0
4247,4247999,22.235821943621957,39.37439925511323,0.04565129601754081,693.3719666004181,279.1691858768463,999.0005760192871,30465,3836,26629,26629,0,9,4248000.0
4248,4248999,22.23871514351339,39.37813998659822,0.04567218131542394,693.5639386177063,279.23210644721985,999.2404365539551,30474,3837,26637,26637,0,9,4249000.0
4249,4249999,22.241494958023576,39.38106514194616,0.045668636223686,693.6888661384583,279.29610228538513,999.5311393737793,30476,3837,26639,26639,0,9,4250000.0
4250,4250999,22.24417657135546,39.38407492656463,0.04567637475602526,693.8839535713196,279.3575847148895,999.6760444641113,30484,3838,26646,26646,0,9,4251000.0
4251,4251999,22.246567011810882,39.38612095566217,0.04567869537193414,694.1446866989136,279.4202950000763,999.8709678649902,30508,3840,26668,26668,0,9,4252000.0
4252,4252999,22.24886499959489,39.38773650031191,0.045681718357038825,694.3953444957733,279.4809482097626,1000.060791015625,30520,3842,26678,26678,0,9,4253000.0
4253,4253999,22.250005062375873,39.389372331115325,0.045682108891896944,694.7232027053833,279.54702591896057,1000.2298049926758,30540,3845,26695,26695,0,9,4254000.0
4254,4254999,22.248677162388798,39.38670836734281,0.04567180151331829,694.9082152843475,279.60991191864014,1001.002986907959,30576,3846,26730,26730,0,9,4255000.0
4255,4255999,22.246868899798052,39.384214833742554,0.045674925484690876,695.0982296466827,279.6716558933258,1001.3110198974609,30583,3847,26736,26736,0,9,4256000.0
4256,4256999,22.24538101611886,39.38190755878162,0.04567423303809259,695.368330001831,279.73448038101196,1001.5218505859375,30595,3849,26746,26746,0,9,4257000.0
4257,4257999,22.24404122771954,39.38008457751572,0.045678437487449375,695.5632758140564,279.79799365997314,1001.7661552429199,30599,3850,26749,26749,0,9,4258000.0
4258,4258999,22.243110364840216,39.3794091948125,0.045667774602683675,695.6918070316315,279.8596975803375,1002.0149040222168,30600,3850,26750,26750,0,9,4259000.0
4259,4259999,22.24184969724893,39.378096646337355,0.04566989707774993,695.8135769367218,279.92142820358276,1002.2136611938477,30601,3850,26751,26751,0,9,4260000.0
4260,4260999,22.240447399975064,39.375519755666986,0.04566473071338917,695.9303495883942,279.98336029052734,1002.4408493041992,30603,3850,26753,26753,0,9,4261000.0
4261,4261999,22.239204638668138,39.37305327862239,0.04566121838446591,696.1178524494171,280.0447940826416,1002.596004486084,30612,3851,26761,26761,0,9,4262000.0
4262,4262999,22.23805717413099,39.370737984462714,0.04565760333398727,696.438467502594,280.10635781288147,1002.6174049377441,30624,3854,26770,26770,0,9,4263000.0
4263,4263999,22.237609002855958,39.370050536469094,0.04564686702545717,696.7069611549377,280.1684834957123,1002.716609954834,30629,3856,26773,26773,0,9,4264000.0
4264,4264999,22.23678558355713,39.367834024463484,0.045639997604503324,696.9640491008759,280.23237586021423,1002.8583793640137,30637,3858,26779,26779,0,9,4265000.0
4265,4265999,22.235947851800645,39.36600876327642,0.04563754074562343,697.1542961597443,280.29640674591064,1002.9644889831543,30639,3859,26780,26780,0,9,4266000.0
4266,4266999,22.23618611347344,39.36706448213179,0.04562561557440459,697.292144536972,280.35775923728943,1003.1860313415527,30640,3859,26781,26781,0,9,4267000.0
4267,4267999,22.23559024495485,39.36499798674149,0.04562662187533373,697.4207282066345,280.4200510978699,1003.3325729370117,30640,3859,26781,26781,0,9,4268000.0
4268,4268999,22.235575375099852,39.36433341762172,0.045619493779184506,697.540470123291,280.4810061454773,1003.5759010314941,30642,3859,26783,26783,0,9,4269000.0
4269,4269999,22.23587010906292,39.364659483136705,0.0456134785169825,697.6685116291046,280.54528856277466,1003.7752571105957,30643,3859,26784,26784,0,9,4270000.0
4270,4270999,22.235874639948488,39.36401390144046,0.04560522277657575,697.9211173057556,280.60733580589294,1003.8287658691406,30662,3861,26801,26801,0,9,4271000.0
4271,4271999,22.236369271384476,39.366336148461926,0.04559931153257013,698.1119544506073,280.66872572898865,1003.9854850769043,30670,3862,26808,26808,0,9,4272000.0
4272,4272999,22.236115977892958,39.3644050630867,0.045590173122309396,698.2469806671143,280.7314076423645,1004.2712249755859,30674,3862,26812,26812,0,9,4273000.0
4273,4273999,22.236248310834583,39.36300337440842,0.045584955410581496,698.433098077774,280.793249130249,1004.4221992492676,30681,3863,26818,26818,0,9,4274000.0
4274,4274999,22.235632964737825,39.360788486605834,0.04558132010724969,698.6189887523651,280.8545684814453,1004.594295501709,30689,3864,26825,26825,0,9,4275000.0
4275,4275999,22.23446052662547,39.35860886249424,0.045579924353866375,698.8100249767303,280.9158194065094,1005.0942611694336,30706,3865,26841,26841,0,9,4276000.0
4276,4276999,22.23262255311553,39.356283078105704,0.04558687573550402,699.0068833827972,280.9779691696167,1005.4648590087891,30725,3866,26859,26859,0,9,4277000.0
4277,4277999,22.23068253503223,39.352955268218366,0.04558683168270006,699.1980578899384,281.0399398803711,1005.774341583252,30734,3867,26867,26867,0,9,4278000.0
4278,4278999,22.22908025829262,39.35036727202718,0.045589298499220665,699.583765745163,281.1032235622406,1005.9048538208008,30764,3871,26893,26893,0,9,4279000.0
4279,4279999,22.228007927730765,39.34952190597205,0.04558759340403762,699.9101803302765,281.1655476093292,1005.98193359375,30775,3874,26901,26901,0,9,4280000.0
4280,4280999,22.226562420302567,39.34654372361755,0.045584496426081644,700.1628615856171,281.22719502449036,1006.1417198181152,30789,3876,26913,26913,0,9,4281000.0
4281,4281999,22.22515548894489,39.34401578383004,0.04558078006045163,700.2848875522614,281.2891318798065,1006.3612976074219,30790,3876,26914,26914,0,9,4282000.0
4282,4282999,22.223921112977735,39.34147754080542,0.04557796695328853,700.4783172607422,281.3507125377655,1006.4662437438965,30797,3877,26920,26920,0,9,4283000.0
4283,4283999,22.22285296450741,39.33988782947778,0.04557201778924347,700.6630165576935,281.41200399398804,1006.602611541748,30799,3878,26921,26921,0,9,4284000.0
4284,4284999,22.22166712639135,39.337123497446846,0.0455716385582452,700.929431438446,281.4745101928711,1006.6841278076172,30804,3880,26924,26924,0,9,4285000.0
4285,4285999,22.220965990699614,39.33532759117267,0.04556468932386204,701.1197996139526,281.53645849227905,1006.7765235900879,30811,3881,26930,26930,0,9,4286000.0
4286,4286999,22.220948413300302,39.33612071525432,0.045560303446599004,701.2485616207123,281.5982463359833,1007.0826416015625,30814,3881,26933,26933,0,9,4287000.0
4287,4287999,22.22070056190338,39.33502073202366,0.0455578557907228,701.3799121379852,281.6629390716553,1007.2200355529785,30814,3881,26933,26933,0,9,4288000.0
4288,4288999,22.220482088294226,39.3336928292241,0.045560543650155605,701.5707488059998,281.72638034820557,1007.3655166625977,30820,3882,26938,26938,0,9,4289000.0
4289,4289999,22.22146492710718,39.33621363154438,0.04555538070403442,701.7635369300842,281.7905352115631,1007.4872589111328,30825,3883,26942,26942,0,9,4290000.0
4290,4290999,22.222494914623947,39.33756796600931,0.04556473305587505,701.8810532093048,281.85304164886475,1007.6440773010254,30826,3883,26943,26943,0,9,4291000.0
4291,4291999,22.224006169981028,39.339820838295026,0.045560915266701585,702.2130882740021,281.9174635410309,1007.6778564453125,30857,3886,26971,26971,0,9,4292000.0
4292,4292999,22.22616021982273,39.34348991938205,0.04554566677281113,702.4178137779236,281.98110938072205,1007.894718170166,30860,3887,26973,26973,0,9,4293000.0
4293,4293999,22.228956419194894,39.35057775758699,0.045552667842754024,702.5417127609253,282.04287910461426,1008.1217460632324,30863,3887,26976,26976,0,9,4294000.0
4294,4294999,22.232356538765625,39.36095033505635,0.04556740379978064,702.6710274219513,282.10745191574097,1008.300422668457,30863,3887,26976,26976,0,9,4295000.0
4295,4295999,22.234649227374074,39.364970620979264,0.045571640483859754,702.8708825111389,282.17210054397583,1008.4412879943848,30871,3888,26983,26983,0,9,4296000.0
4296,4296999,22.23563283901147,39.36724420306683,0.045566881750052746,702.9927413463593,282.2357883453369,1008.8362197875977,30880,3888,26992,26992,0,9,4297000.0
4297,4297999,22.23413268260749,39.365661714964645,0.045564595190678125,703.1909065246582,282.2977101802826,1009.257495880127,30906,3889,27017,27017,0,9,4298000.0
4298,4298999,22.232409429880555,39.36403130250249,0.04556707938062121,703.3937790393829,282.3615119457245,1009.5031623840332,30918,3890,27028,27028,0,9,4299000.0
4299,4299999,22.231179620345067,39.36310517506188,0.0455661069480352,703.5145518779755,282.4227855205536,1009.7052764892578,30918,3890,27028,27028,0,9,4300000.0
4300,4300999,22.229540221720946,39.360908565287495,0.04557010966019581,703.6369578838348,282.48688197135925,1009.8463554382324,30918,3890,27028,27028,0,9,4301000.0
4301,4301999,22.227922969102742,39.358331302424986,0.04557464832541902,703.8253548145294,282.5501856803894,1009.9950370788574,30922,3891,27031,27031,0,9,4302000.0
4302,4302999,22.22640550430509,39.35616966002311,0.04557151912899704,704.0793385505676,282.61200761795044,1010.1453819274902,30928,3893,27035,27035,0,9,4303000.0
4303,4303999,22.225332686907674,39.35446049261168,0.04556715191416316,704.262857913971,282.67320680618286,1010.3115310668945,30935,3894,27041,27041,0,9,4304000.0
4304,4304999,22.224080859201212,39.35216403730482,0.04556427310949096,704.5229046344757,282.73506140708923,1010.3524322509766,30949,3896,27053,27053,0,9,4305000.0
4305,4305999,22.22331824234545,39.35046622341428,0.0455564562751678,704.6548840999603,282.7963035106659,1010.5024337768555,30950,3896,27054,27054,0,9,4306000.0
4306,4306999,22.222611177178432,39.348748606625904,0.045552458961013564,704.8534288406372,282.85757780075073,1010.6344680786133,30958,3897,27061,27061,0,9,4307000.0
4307,4307999,22.222209697442807,39.3478076975874,0.04554153329575972,704.9844381809235,282.9182114601135,1010.7548522949219,30958,3897,27061,27061,0,9,4308000.0
4308,4308999,22.221363442849192,39.345639256728205,0.045532883472835795,705.1041634082794,282.9787154197693,1010.865234375,30958,3897,27061,27061,0,9,4309000.0
4309,4309999,22.221051546902732,39.34413471477512,0.0455207260442233,705.3689897060394,283.04107761383057,1010.8981552124023,30970,3899,27071,27071,0,9,4310000.0
4310,4310999,22.221322081459636,39.349995308005965,0.045495342410270534,705.6258585453033,283.10321736335754,1010.9671325683594,30979,3901,27078,27078,0,9,4311000.0
4311,4311999,22.221341863925804,39.34890089408956,0.0454815747935321,705.7535603046417,283.16630840301514,1011.1627655029297,30979,3901,27078,27078,0,9,4312000.0
4312,4312999,22.221304936376626,39.34744855764553,0.04546588209241609,705.8731834888458,283.22911834716797,1011.4517631530762,30981,3901,27080,27080,0,9,4313000.0
4313,4313999,22.221270000126825,39.346102980695555,0.0454511301595768,706.2040388584137,283.29058289527893,1011.4131851196289,30998,3904,27094,27094,0,9,4314000.0
4314,4314999,22.220943582200935,39.344497683605475,0.04543932384972349,706.4760828018188,283.3546941280365,1011.6058158874512,31020,3906,27114,27114,0,9,4315000.0
4315,4315999,22.219716670262187,39.342109709152425,0.04543902734482652,706.6010358333588,283.4155385494232,1012.1044464111328,31031,3906,27125,27125,0,9,4316000.0
4316,4316999,22.218522815167546,39.34056911239655,0.045437581830059526,706.7229700088501,283.4802165031433,1012.5493202209473,31040,3906,27134,27134,0,9,4317000.0
4317,4317999,22.217980943274984,39.34053243753964,0.04544271393067112,706.9882771968842,283.54284715652466,1012.7313919067383,31057,3908,27149,27149,0,9,4318000.0
4318,4318999,22.217308499535264,39.34007140149248,0.045441491700342396,707.1146261692047,283.60622549057007,1012.8771362304688,31057,3908,27149,27149,0,9,4319000.0
4319,4319999,22.216709359450597,39.338638823932314,0.04544124887561696,707.2452208995819,283.66728377342224,1013.0615615844727,31058,3908,27150,27150,0,9,4320000.0
4320,4320999,22.21649943298069,39.33839332228186,0.045440130020434455,707.3614287376404,283.72972798347473,1013.2149353027344,31058,3908,27150,27150,0,9,4321000.0
4321,4321999,22.21640374210208,39.33756704761061,0.045432914459328066,707.7014155387878,283.793657541275,1013.2179412841797,31080,3911,27169,27169,0,9,4322000.0
4322,4322999,22.216123593045953,39.3367493372323,0.04542663580517381,707.8944363594055,283.85491728782654,1013.258975982666,31086,3912,27174,27174,0,9,4323000.0
4323,4323999,22.215791722897542,39.33572651879681,0.04542265571114357,708.2375996112823,283.91660737991333,1013.2936782836914,31106,3915,27191,27191,0,9,4324000.0
4324,4324999,22.215727953438403,39.33493229868055,0.045421685730396955,708.3564848899841,283.9775688648224,1013.482593536377,31106,3915,27191,27191,0,9,4325000.0
4325,4325999,22.215875693094787,39.33442779319247,0.04541693493784893,708.5495626926422,284.03870964050293,1013.678394317627,31115,3916,27199,27199,0,9,4326000.0
4326,4326999,22.21656558460668,39.33591583947802,0.04541695538293544,708.6686599254608,284.1005206108093,1013.7733535766602,31115,3916,27199,27199,0,9,4327000.0
4327,4327999,22.21680317127826,39.335792058595075,0.04541580064884487,708.8562331199646,284.1616940498352,1013.8406028747559,31120,3917,27203,27203,0,9,4328000.0
4328,4328999,22.217295762161815,39.33554861412423,0.04542313091715677,709.0408725738525,284.2225329875946,1013.8976745605469,31122,3918,27204,27204,0,9,4329000.0
4329,4329999,22.218690382843235,39.339620395470114,0.0454125783113869,709.1620514392853,284.2856900691986,1014.0152244567871,31122,3918,27204,27204,0,9,4330000.0
4330,4330999,22.220204648789156,39.341174406905786,0.0454196193925418,709.2904679775238,284.34682512283325,1014.2246398925781,31124,3918,27206,27206,0,9,4331000.0
4331,4331999,22.222835552994127,39.3450569449524,0.04544368932619636,709.4139258861542,284.40838408470154,1014.4557228088379,31126,3918,27208,27208,0,9,4332000.0
4332,4332999,22.22522674689562,39.348593665650014,0.04546963207808097,709.612131357193,284.47174978256226,1014.5407371520996,31129,3919,27210,27210,0,9,4333000.0
4333,4333999,22.227716651975918,39.35171060320402,0.04549508186937512,709.7325820922852,284.5351300239563,1014.722297668457,31129,3919,27210,27210,0,9,4334000.0
4334,4334999,22.230363954282378,39.35493617992166,0.04550285147005262,709.8555505275726,284.59573912620544,1014.9486770629883,31131,3919,27212,27212,0,9,4335000.0
4335,4335999,22.231422425459236,39.355662974649476,0.04549644103662631,709.9842293262482,284.6568305492401,1015.3075370788574,31141,3919,27222,27222,0,9,4336000.0
4336,4336999,22.229843137080483,39.35442384095412,0.0454831869388832,710.1713008880615,284.71915793418884,1015.9655151367188,31174,3920,27254,27254,0,9,4337000.0
4337,4337999,22.22851757194604,39.35640639282447,0.045463551771443234,710.4336216449738,284.7843041419983,1016.2305488586426,31180,3922,27258,27258,0,9,4338000.0
4338,4338999,22.226957247129498,39.3543147160128,0.045458470526381745,710.683979511261,284.8464117050171,1016.4034843444824,31202,3924,27278,27278,0,9,4339000.0
4339,4339999,22.225722402729684,39.35284815180185,0.04545344773632798,710.8720364570618,284.9104154109955,1016.6047592163086,31214,3925,27289,27289,0,9,4340000.0
4340,4340999,22.22418463689516,39.350488986233245,0.04545063517187764,710.9876389503479,284.97180128097534,1016.7906265258789,31214,3925,27289,27289,0,9,4341000.0
4341,4341999,22.22295838677182,39.34968596007404,0.04544939698683559,711.1061449050903,285.0343885421753,1017.0331497192383,31217,3925,27292,27292,0,9,4342000.0
4342,4342999,22.222209231057587,39.34945525487345,0.04543850503795921,711.2302322387695,285.0962402820587,1017.2903137207031,31218,3925,27293,27293,0,9,4343000.0
4343,4343999,22.22136496549289,39.347867981214094,0.04543518484442155,711.4861307144165,285.15875267982483,1017.4524230957031,31244,3927,27317,27317,0,9,4344000.0
4344,4344999,22.22065492993356,39.34597879475323,0.04543594663091788,711.6832439899445,285.22093629837036,1017.5351028442383,31246,3928,27318,27318,0,9,4345000.0
4345,4345999,22.22100883369543,39.34667407453308,0.04543591800033331,711.8754258155823,285.28341031074524,1017.7565269470215,31255,3929,27326,27326,0,9,4346000.0
4346,4346999,22.221352770356834,39.34713255425949,0.04544091677537532,712.2627470493317,285.34616780281067,1017.8770217895508,31277,3933,27344,27344,0,9,4347000.0
4347,4347999,22.22176357265776,39.34759310839836,0.04544856062304092,712.4543759822845,285.4087369441986,1017.9960594177246,31283,3934,27349,27349,0,9,4348000.0
4348,4348999,22.22253390457273,39.348867664561475,0.04544911800761897,712.8659391403198,285.47565150260925,1017.9694786071777,31303,3938,27365,27365,0,9,4349000.0
4349,4349999,22.224228063696156,39.3534357213588,0.04545059312105493,713.0776641368866,285.5493428707123,1018.2440338134766,31310,3939,27371,27371,0,9,4350000.0
4350,4350999,22.225985486397,39.36054761383964,0.045462445352529746,713.1916017532349,285.61158061027527,1018.4929542541504,31310,3939,27371,27371,0,9,4351000.0
4351,4351999,22.22834513104179,39.36379153128859,0.0454831677439137,713.3728625774384,285.67316794395447,1018.8141593933105,31321,3940,27381,27381,0,9,4352000.0
4352,4352999,22.23058094826031,39.366447390164694,0.045506561435470716,713.574606180191,285.73783349990845,1019.0976028442383,31327,3941,27386,27386,0,9,4353000.0
4353,4353999,22.23296871261598,39.36942891046652,0.04552572484860662,713.912853717804,285.8032486438751,1019.1330833435059,31344,3944,27400,27400,0,9,4354000.0
4354,4354999,22.235079063963607,39.37159909467593,0.04554208107206159,714.102935552597,285.8657386302948,1019.3909111022949,31353,3945,27408,27408,0,9,4355000.0
4355,4355999,22.237792190234526,39.374733506262196,0.0455715742052184,714.252607345581,285.9380741119385,1019.7048759460449,31357,3945,27412,27412,0,9,4356000.0
4356,4356999,22.23839598913697,39.37403691152839,0.045581228041162714,714.3707137107849,285.999472618103,1019.8814353942871,31357,3945,27412,27412,0,9,4357000.0
4357,4357999,22.236758991097524,39.37180554822555,0.04558380477924506,714.5974085330963,286.06619119644165,1020.5088233947754,31391,3946,27445,27445,0,9,4358000.0
4358,4358999,22.235184753496362,39.37164316682368,0.04558498845490411,714.7194442749023,286.1302716732025,1020.9545516967773,31398,3946,27452,27452,0,9,4359000.0
4359,4359999,22.23405353188098,39.37086481772332,0.045592672351876584,714.923362493515,286.19533824920654,1021.1125831604004,31406,3947,27459,27459,0,9,4360000.0
4360,4360999,22.23332124407265,39.36999848506003,0.04560075341532732,715.1069524288177,286.256227016449,1021.3444023132324,31415,3948,27467,27467,0,9,4361000.0
4361,4361999,22.23335124414614,39.371683330810164,0.045592498342617804,715.2969031333923,286.3165318965912,1021.4819221496582,31423,3949,27474,27474,0,9,4362000.0
4362,4362999,22.233137280554423,39.37189233104668,0.04558995894694984,715.4143214225769,286.3785490989685,1021.6651878356934,31423,3949,27474,27474,0,9,4363000.0
4363,4363999,22.232485306953574,39.37049336213735,0.04558975724335479,715.6084303855896,286.4409248828888,1021.8462257385254,31432,3950,27482,27482,0,9,4364000.0
4364,4364999,22.232112267405114,39.36979119908271,0.04559023433017062,715.7888774871826,286.50049662590027,1021.9492721557617,31439,3951,27488,27488,0,9,4365000.0
4365,4365999,22.23140659545384,39.368237062324205,0.04558865745911589,715.9779613018036,286.5614683628082,1022.0873527526855,31444,3952,27492,27492,0,9,4366000.0
4366,4366999,22.23137100945642,39.3678591189379,0.04558771364478209,716.3703305721283,286.6217155456543,1022.0662002563477,31461,3956,27505,27505,0,9,4367000.0
4367,4367999,22.230903401408938,39.36687118312938,0.045589754281532,716.502551317215,286.6837878227234,1022.2734298706055,31462,3956,27506,27506,0,9,4368000.0
4368,4368999,22.231092105780156,39.36692740327574,0.04557658173006163,716.7793455123901,286.7463483810425,1022.3083267211914,31473,3958,27515,27515,0,9,4369000.0
4369,4369999,22.231302642811528,39.36741780209328,0.045573982406275415,717.0468139648438,286.80900049209595,1022.408203125,31490,3960,27530,27530,0,9,4370000.0
4370,4370999,22.231456131326304,39.36708528479652,0.0455798049499182,717.2325203418732,286.86926436424255,1022.5229911804199,31492,3961,27531,27531,0,9,4371000.0
4371,4371999,22.231591252925913,39.366552440905906,0.04557605184548441,717.3482367992401,286.93048763275146,1022.6787223815918,31493,3961,27532,27532,0,9,4372000.0
4372,4372999,22.2323528836151,39.36740693283369,0.045576005413954235,717.472286939621,286.9918828010559,1022.8533248901367,31494,3961,27533,27533,0,9,4373000.0
4373,4373999,22.233087884318003,39.36776376526338,0.04557238830870647,717.7292609214783,287.0546553134918,1022.9499053955078,31500,3963,27537,27537,0,9,4374000.0
4374,4374999,22.23355434352081,39.36850238369481,0.04557021733955857,717.9101202487946,287.11579418182373,1023.1300735473633,31502,3964,27538,27538,0,9,4375000.0
4375,4375999,22.234140268928506,39.36909112903383,0.04556727976496733,718.0378332138062,287.17952036857605,1023.3498382568359,31503,3964,27539,27539,0,9,4376000.0
4376,4376999,22.234597525267727,39.36855202215036,0.04556651250810628,718.164891242981,287.24080300331116,1023.5892791748047,31506,3964,27542,27542,0,9,4377000.0
4377,4377999,22.234533898531865,39.36829657358742,0.0455615357164465,718.2868361473083,287.30264353752136,1023.7930488586426,31506,3964,27542,27542,0,9,4378000.0
4378,4378999,22.234123244443257,39.36825548795108,0.04555273025265749,718.4823095798492,287.364399433136,1024.2642860412598,31522,3965,27557,27557,0,9,4379000.0
4379,4379999,22.23324873343899,39.36907137740389,0.04554077764902864,718.6677119731903,287.42754578590393,1024.565128326416,31536,3966,27570,27570,0,9,4380000.0
4380,4380999,22.232289197874525,39.367870968598034,0.04554374854699483,718.9353034496307,287.48988461494446,1024.7271003723145,31551,3968,27583,27583,0,9,4381000.0
4381,4381999,22.231871310181777,39.36760775880569,0.045540198588790104,719.0528590679169,287.551340341568,1024.9790382385254,31553,3968,27585,27585,0,9,4382000.0
4382,4382999,22.23162108206685,39.36734685219738,0.04553950081651359,719.1797060966492,287.6150891780853,1025.1355628967285,31554,3968,27586,27586,0,9,4383000.0
4383,4383999,22.23197253989838,39.377736312652104,0.045510202260427346,719.3062541484833,287.67722487449646,1025.2966079711914,31554,3968,27586,27586,0,9,4384000.0
4384,4384999,22.23147792293346,39.377334626654395,0.04550161888691706,719.4993116855621,287.7387673854828,1025.4603309631348,31563,3969,27594,27594,0,9,4385000.0
4385,4385999,22.231452639869254,39.377519636882525,0.045497321517075306,719.6953659057617,287.80004501342773,1025.5605964660645,31571,3970,27601,27601,0,9,4386000.0
4386,4386999,22.231107326276256,39.37735077651271,0.04549136147492994,719.9575543403625,287.86138558387756,1025.56884765625,31585,3972,27613,27613,0,9,4387000.0
4387,4387999,22.230944709951007,39.3773037819239,0.0454918510349801,720.3550364971161,287.92320370674133,1025.453052520752,31605,3976,27629,27629,0,9,4388000.0
4388,4388999,22.231163229660325,39.377879418327296,0.045490792737048036,720.6313166618347,287.98799538612366,1025.5277671813965,31620,3978,27642,27642,0,9,4389000.0
4389,4389999,22.231230812615326,39.37756634093777,0.0455025026155218,720.8284828662872,288.05057525634766,1025.6286392211914,31626,3979,27647,27647,0,9,4390000.0
4390,4390999,22.231606347050047,39.37878354860212,0.04551502330895152,721.0979652404785,288.1122763156891,1025.6905670166016,31638,3981,27657,27657,0,9,4391000.0
4391,4391999,22.232034144435165,39.37919366354184,0.04552314018070236,721.2175974845886,288.1737639904022,1025.7983169555664,31638,3981,27657,27657,0,9,4392000.0
4392,4392999,22.23276840672468,39.37990180146998,0.04552121932316877,721.3364396095276,288.2349479198456,1025.9163436889648,31638,3981,27657,27657,0,9,4393000.0
4393,4393999,22.233735378935073,39.380652095165864,0.04552316941691137,721.5269603729248,288.29918575286865,1025.9799461364746,31646,3982,27664,27664,0,9,4394000.0
4394,4394999,22.235485045214233,39.38692320134422,0.04552380573332493,721.6429464817047,288.36006712913513,1026.1081848144531,31647,3982,27665,27665,0,9,4395000.0
4395,4395999,22.23661033859256,39.3889487042314,0.04552692617584908,721.765426158905,288.42256259918213,1026.2378578186035,31647,3982,27665,27665,0,9,4396000.0
4396,4396999,22.237729465205607,39.39064681146784,0.04552250921769185,721.9720816612244,288.48753666877747,1026.3628845214844,31650,3983,27667,27667,0,9,4397000.0
4397,4397999,22.23888213532523,39.39303553470334,0.04552061532808904,722.3096992969513,288.54950618743896,1026.3250579833984,31668,3986,27682,27682,0,9,4398000.0
4398,4398999,22.239214863319337,39.39220119796449,0.04552383577384567,722.5071761608124,288.611536026001,1026.4296417236328,31670,3987,27683,27683,0,9,4399000.0
4399,4399999,22.238123445717573,39.38999301143814,0.04552742069055893,722.6983428001404,288.6746642589569,1026.9629211425781,31690,3988,27702,27702,0,9,4400000.0
4400,4400999,22.23620385508617,39.38940837341929,0.04553250249185492,722.9557354450226,288.7374179363251,1027.397747039795,31724,3990,27734,27734,0,9,4401000.0
4401,4401999,22.234247858472845,39.387340654957896,0.04553862974925926,723.0821845531464,288.7996244430542,1027.6598510742188,31726,3990,27736,27736,0,9,4402000.0
4402,4402999,22.23256683845896,39.38549310835146,0.04554032976960076,723.2803874015808,288.8636758327484,1027.8164329528809,31743,3991,27752,27752,0,9,4403000.0
4403,4403999,22.23073133524275,39.382602329662824,0.04555214066243274,723.4776799678802,288.9269142150879,1027.9940757751465,31751,3992,27759,27759,0,9,4404000.0
4404,4404999,22.22936562644848,39.380619519043734,0.0455495875751617,723.6644430160522,288.98847579956055,1028.1348495483398,31758,3993,27765,27765,0,9,4405000.0
4405,4405999,22.227786132001004,39.37764899988961,0.04556100139503716,723.7869710922241,289.05012679100037,1028.3851432800293,31761,3993,27768,27768,0,9,4406000.0
4406,4406999,22.22687684492841,39.37626012753759,0.04555560802962466,724.0564818382263,289.11655855178833,1028.519027709961,31779,3995,27784,27784,0,9,4407000.0
4407,4407999,22.226144013786246,39.37574661867712,0.04555898702262229,724.2456216812134,289.17833399772644,1028.6739692687988,31786,3996,27790,27790,0,9,4408000.0
4408,4408999,22.22634192178518,39.37805239087534,0.04555620489091117,724.4448070526123,289.2406268119812,1028.8594970703125,31794,3997,27797,27797,0,9,4409000.0
4409,4409999,22.22843712788305,39.38525537088819,0.045555655264715944,724.6352007389069,289.30296778678894,1029.0290031433105,31803,3998,27805,27805,0,9,4410000.0
4410,4410999,22.23161773860779,39.396331828252954,0.04555267387418416,724.9027509689331,289.36505913734436,1029.1484870910645,31813,4000,27813,27813,0,9,4411000.0
4411,4411999,22.235787101013013,39.413636844102356,0.04557520930302139,725.2449266910553,289.4292938709259,1029.2249717712402,31841,4003,27838,27838,0,9,4412000.0
4412,4412999,22.240096795952418,39.42667486981037,0.04558315834860216,725.4428133964539,289.4943642616272,1029.4485969543457,31850,4004,27846,27846,0,9,4413000.0
4413,4413999,22.245178374764663,39.44337849040162,0.04557954056174929,725.6477115154266,289.5628116130829,1029.690330505371,31862,4005,27857,27857,0,9,4414000.0
4414,4414999,22.250840518215064,39.46246435551574,0.04558598865504848,725.8352007865906,289.62426137924194,1029.8759994506836,31870,4006,27864,27864,0,9,4415000.0
4415,4415999,22.25736160076798,39.484553425036424,0.045612129255229394,726.0312688350677,289.6861310005188,1030.1696510314941,31883,4007,27876,27876,0,9,4416000.0
4416,4416999,22.263937715310732,39.50096738213858,0.04564137891221931,726.35871052742,289.748831987381,1030.2997970581055,31900,4010,27890,27890,0,9,4417000.0
4417,4417999,22.270402194726675,39.517954909954376,0.04570303205080539,726.6134042739868,289.8117501735687,1030.5648651123047,31911,4012,27899,27899,0,9,4418000.0
4418,4418999,22.278328985512545,39.537691179147814,0.04575454641909227,726.802836894989,289.87314200401306,1030.7644271850586,31921,4013,27908,27908,0,9,4419000.0
4419,4419999,22.28376663082838,39.55085306150921,0.04584590720867199,726.9911599159241,289.9344847202301,1031.0145835876465,31932,4014,27918,27918,0,9,4420000.0
4420,4420999,22.28339239005961,39.551112780422045,0.04584542607218689,727.3878891468048,289.9978530406952,1031.5077781677246,31977,4018,27959,27959,0,9,4421000.0
4421,4421999,22.281519616058038,39.54863727949868,0.04584707930258014,727.5284087657928,290.07349371910095,1031.858901977539,31982,4018,27964,27964,0,9,4422000.0
4422,4422999,22.280001037120208,39.54630980160995,0.04584364604566449,727.7251603603363,290.1356372833252,1032.077724456787,31988,4019,27969,27969,0,9,4423000.0
4423,4423999,22.279190169394923,39.55017558823368,0.04583414808335151,727.9985706806183,290.2009208202362,1032.2182731628418,32003,4021,27982,27982,0,9,4424000.0
4424,4424999,22.27854195194297,39.54985167204552,0.04582450026032647,728.1239037513733,290.265202999115,1032.4039306640625,32003,4021,27982,27982,0,9,4425000.0
4425,4425999,22.277408560881707,39.548496877565064,0.04582108403570628,728.3163468837738,290.32977533340454,1032.5521926879883,32012,4022,27990,27990,0,9,4426000.0
4426,4426999,22.276196633131722,39.54629087238033,0.045819640663665506,728.6582338809967,290.3922965526581,1032.5658111572266,32033,4025,28008,28008,0,9,4427000.0
4427,4427999,22.27528062341936,39.54437021914992,0.04582305647969798,728.9117622375488,290.45403265953064,1032.6025848388672,32047,4027,28020,28020,0,9,4428000.0
4428,4428999,22.27453180322884,39.542855436812935,0.0458239487371761,729.2451603412628,290.5162670612335,1032.567367553711,32066,4030,28036,28036,0,9,4429000.0
4429,4429999,22.27458407431465,39.546258363431065,0.04581857932456401,729.5076456069946,290.5782377719879,1032.6659355163574,32081,4032,28049,28049,0,9,4430000.0
4430,4430999,22.2751689154584,39.547147401696165,0.045826321640216605,729.8393867015839,290.64161109924316,1032.6519241333008,32104,4035,28069,28069,0,9,4431000.0
4431,4431999,22.27569603149953,39.547952010718994,0.04585377564221882,730.0367901325226,290.70316100120544,1032.7741661071777,32111,4036,28075,28075,0,9,4432000.0
4432,4432999,22.27649394239035,39.54923445998416,0.045865014112885905,730.451516866684,290.7661306858063,1032.7482795715332,32130,4040,28090,28090,0,9,4433000.0
4433,4433999,22.27762681620175,39.55064756164333,0.04589072554349627,730.5676250457764,290.82732462882996,1032.888759613037,32130,4040,28090,28090,0,9,4434000.0
4434,4434999,22.279187380456364,39.55377839721411,0.045917322111158954,730.7545876502991,290.889000415802,1033.145793914795,32137,4041,28096,28096,0,9,4435000.0
4435,4435999,22.281667608183955,39.55810445645545,0.04594418514334997,731.1687333583832,290.9531874656677,1033.2105102539062,32173,4045,28128,28128,0,9,4436000.0
4436,4436999,22.28353525919608,39.56469549391013,0.045962898157644094,731.4303953647614,291.0162830352783,1033.3977165222168,32188,4047,28141,28141,0,9,4437000.0
4437,4437999,22.28554475213109,39.56728504620426,0.045995757237251356,731.6889846324921,291.07805490493774,1033.4622802734375,32196,4049,28147,28147,0,9,4438000.0
4438,4438999,22.287749268164347,39.57154254181388,0.04602404163896656,731.8084723949432,291.1393506526947,1033.7557830810547,32198,4049,28149,28149,0,9,4439000.0
4439,4439999,22.29039102322342,39.57652920472459,0.04605773494406329,731.9385895729065,291.2033483982086,1033.9529914855957,32200,4049,28151,28151,0,9,4440000.0
4440,4440999,22.2917913321479,39.57780192101266,0.04609773028502684,732.1345205307007,291.2655348777771,1034.102897644043,32207,4050,28157,28157,0,9,4441000.0
4441,4441999,22.291512183458174,39.57655594007133,0.04610883604230065,732.3274919986725,291.3275263309479,1034.6110572814941,32231,4051,28180,28180,0,9,4442000.0
4442,4442999,22.29006488271196,39.57452459221385,0.04610768361263362,732.4448418617249,291.3892855644226,1035.1220397949219,32244,4051,28193,28193,0,9,4443000.0
4443,4443999,22.288517652833,39.573141156957526,0.046112171557851966,732.6469476222992,291.45203971862793,1035.3609352111816,32251,4052,28199,28199,0,9,4444000.0
4444,4444999,22.286837834185725,39.57082512477327,0.04611813597814096,732.8377006053925,291.51365995407104,1035.5494346618652,32258,4053,28205,28205,0,9,4445000.0
4445,4445999,22.285483179093085,39.56833157841943,0.04611981589625458,732.9605436325073,291.5765223503113,1035.7817039489746,32258,4053,28205,28205,0,9,4446000.0
4446,4446999,22.283993233707207,39.56585123290677,0.046120990491283376,733.1585359573364,291.64024567604065,1035.8715476989746,32265,4054,28211,28211,0,9,4447000.0
4447,4447999,22.28266011537251,39.56353270338458,0.04612312634674032,733.3494818210602,291.70285749435425,1036.0110473632812,32272,4055,28217,28217,0,9,4448000.0
4448,4448999,22.281463871096037,39.560954054439456,0.04612644700507329,733.6908855438232,291.76498007774353,1036.0205574035645,32289,4058,28231,28231,0,9,4449000.0
4449,4449999,22.280330171305057,39.55852669227074,0.04612608499908255,733.8979015350342,291.82989263534546,1036.1737213134766,32297,4059,28238,28238,0,9,4450000.0
4450,4450999,22.279317963911105,39.55662174193222,0.04612483759521535,734.29736328125,291.8925771713257,1036.0678520202637,32321,4063,28258,28258,0,9,4451000.0
4451,4451999,22.278458962483608,39.55427879164046,0.0461275003564553,734.4907763004303,291.95571637153625,1036.306869506836,32336,4064,28272,28272,0,9,4452000.0
4452,4452999,22.27780660387079,39.552772742201384,0.0461304600566933,734.7512738704681,292.0173215866089,1036.3569641113281,32351,4066,28285,28285,0,9,4453000.0
4453,4453999,22.276825998625796,39.55028222658809,0.046131398809735824,735.0170931816101,292.07893085479736,1036.3914108276367,32360,4068,28292,28292,0,9,4454000.0
4454,4454999,22.276238525863683,39.54828773700441,0.04612745483910474,735.2888820171356,292.1413643360138,1036.3962440490723,32369,4070,28299,28299,0,9,4455000.0
4455,4455999,22.27593801365847,39.54626816254052,0.04611726987726683,735.4072732925415,292.2029871940613,1036.5977478027344,32369,4070,28299,28299,0,9,4456000.0
4456,4456999,22.275863404576025,39.54460454068205,0.04610625523180467,735.5284311771393,292.26407861709595,1036.7750968933105,32370,4070,28300,28300,0,9,4457000.0
4457,4457999,22.275618818941616,39.542740663596504,0.04609768228668587,735.7269878387451,292.32600116729736,1036.807228088379,32377,4071,28306,28306,0,9,4458000.0
4458,4458999,22.27528823325337,39.54074365264626,0.046089472142004206,735.8547763824463,292.38735842704773,1037.033103942871,32378,4071,28307,28307,0,9,4459000.0
4459,4459999,22.27497144422015,39.539268208151064,0.046073500600207096,736.0460135936737,292.4484214782715,1037.2117042541504,32387,4072,28315,28315,0,9,4460000.0
4460,4460999,22.274046858722716,39.53799675794535,0.0460626915536434,736.2393527030945,292.51065707206726,1037.9113273620605,32420,4073,28347,28347,0,9,4461000.0
4461,4461999,22.272358187129488,39.53543141096307,0.0460632964985096,736.4447476863861,292.57379364967346,1038.3357696533203,32434,4074,28360,28360,0,9,4462000.0
4462,4462999,22.2710211802998,39.53387053561483,0.04606531372951728,736.575567483902,292.63621187210083,1038.6202659606934,32437,4074,28363,28363,0,9,4463000.0
4463,4463999,22.269448241321463,39.531256819970885,0.04607474661878941,736.836847782135,292.6984188556671,1038.7667655944824,32447,4076,28371,28371,0,9,4464000.0
4464,4464999,22.2682877126642,39.52938852629663,0.04607231564912162,737.1011798381805,292.76124000549316,1038.8462448120117,32462,4078,28384,28384,0,9,4465000.0
4465,4465999,22.26713536951985,39.52773876123007,0.046076085021001356,737.3702790737152,292.8236835002899,1038.9903564453125,32470,4080,28390,28390,0,9,4466000.0
4466,4466999,22.266003734371346,39.52922780411454,0.04606554238512495,737.7121014595032,292.8862729072571,1039.0057678222656,32489,4083,28406,28406,0,9,4467000.0
4467,4467999,22.26468092296122,39.526524014119715,0.04606269617626868,737.908524274826,292.94801592826843,1039.212287902832,32497,4084,28413,28413,0,9,4468000.0
4468,4468999,22.26365285331131,39.524060841053554,0.0460598136742848,738.2365410327911,293.0114450454712,1039.315086364746,32528,4087,28441,28441,0,9,4469000.0
4469,4469999,22.26268938295603,39.5217052558509,0.046057054078654125,738.5006678104401,293.073034286499,1039.3751029968262,32539,4089,28450,28450,0,9,4470000.0
4470,4470999,22.261966162727713,39.51987675863904,0.046048402418005785,738.761402130127,293.1348021030426,1039.5173072814941,32555,4091,28464,28464,0,9,4471000.0
4471,4471999,22.261677409295054,39.51840834494055,0.04603565669022058,738.8907220363617,293.19631242752075,1039.692440032959,32555,4091,28464,28464,0,9,4472000.0
4472,4472999,22.26142658139807,39.51743528992225,0.04602256871777177,739.0156517028809,293.25875639915466,1039.8815460205078,32556,4091,28465,28465,0,9,4473000.0
4473,4473999,22.261195547532473,39.516147587631856,0.04601286863468723,739.1323554515839,293.3195803165436,1040.0843696594238,32558,4091,28467,28467,0,9,4474000.0
4474,4474999,22.261024956904386,39.51484446028555,0.045998419759629816,739.3191702365875,293.3811225891113,1040.1960334777832,32573,4092,28481,28481,0,9,4475000.0
4475,4475999,22.26127740581677,39.51342642469517,0.04598495107064704,739.455747127533,293.4428894519806,1040.3387489318848,32574,4092,28482,28482,0,9,4476000.0
4476,4476999,22.26139205867684,39.511870968459945,0.04596759884553414,739.7975916862488,293.50475668907166,1040.4283256530762,32637,4095,28542,28542,0,9,4477000.0
4477,4477999,22.26197855991366,39.511322988902535,0.04595177224516378,739.9197134971619,293.56451892852783,1040.591323852539,32638,4095,28543,28543,0,9,4478000.0
4478,4478999,22.262354994596173,39.51014239965468,0.04593898850834266,740.0357844829559,293.6257679462433,1040.7339134216309,32638,4095,28543,28543,0,9,4479000.0
4479,4479999,22.262401886814803,39.50883648846041,0.04592681273647159,740.2361400127411,293.6856379508972,1040.9704933166504,32649,4096,28553,28553,0,9,4480000.0
4480,4480999,22.2620118775711,39.50764193836244,0.045919304228667635,740.4892885684967,293.746942281723,1041.165870666504,32664,4098,28566,28566,0,9,4481000.0
4481,4481999,22.260188945036404,39.50557830708956,0.04592254740844781,740.6160564422607,293.81013894081116,1042.198040008545,32697,4098,28599,28599,0,9,4482000.0
4482,4482999,22.258654620115017,39.50617084481341,0.045918938763458206,740.881751537323,293.8723785877228,1042.5132369995117,32721,4100,28621,28621,0,9,4483000.0
4483,4483999,22.25692056438177,39.50377281387729,0.045923792331747815,741.0039675235748,293.9348683357239,1042.9126472473145,32722,4100,28622,28622,0,9,4484000.0
4484,4484999,22.2556549735265,39.50302358111946,0.04592042614986336,741.2060403823853,293.9972321987152,1043.2735862731934,32732,4101,28631,28631,0,9,4485000.0
4485,4485999,22.254094056250793,39.500493567886515,0.04592010291889104,741.4682157039642,294.05975222587585,1043.430892944336,32741,4103,28638,28638,0,9,4486000.0
4486,4486999,22.25261007760926,39.49795145623599,0.04592142688808665,741.5875403881073,294.122474193573,1043.6066589355469,32741,4103,28638,28638,0,9,4487000.0
4487,4487999,22.250876269384225,39.495183642633556,0.045922609990307506,741.7135062217712,294.1840364933014,1043.9480171203613,32744,4103,28641,28641,0,9,4488000.0
4488,4488999,22.249685767665042,39.49313249241611,0.04592238095584422,741.8365426063538,294.2456669807434,1044.1929321289062,32745,4103,28642,28642,0,9,4489000.0
4489,4489999,22.2483409560594,39.49037480024295,0.045921085038231224,742.103622674942,294.3067979812622,1044.2999725341797,32756,4105,28651,28651,0,9,4490000.0
4490,4490999,22.24701025823493,39.48782235421865,0.04591978492169135,742.2196316719055,294.36815786361694,1044.5603218078613,32757,4105,28652,28652,0,9,4491000.0
4491,4491999,22.246124375880346,39.485997264256184,0.045916017533845443,742.3444964885712,294.429655790329,1044.8288841247559,32760,4105,28655,28655,0,9,4492000.0
4492,4492999,22.245719364631803,39.485414654687226,0.045898857806509374,742.4664325714111,294.490371465683,1045.0267868041992,32760,4105,28655,28655,0,9,4493000.0
4493,4493999,22.245505374986188,39.484378637774526,0.045891074805046395,742.5857803821564,294.55039525032043,1045.2199249267578,32762,4105,28657,28657,0,9,4494000.0
4494,4494999,22.24534058610309,39.483383081980996,0.045876138238613695,742.7774167060852,294.611709356308,1045.3240776062012,32777,4106,28671,28671,0,9,4495000.0
4495,4495999,22.24547498292259,39.48272051703405,0.04586211088295766,742.9841415882111,294.6762013435364,1045.468349456787,32790,4107,28683,28683,0,9,4496000.0
4496,4496999,22.24553334648414,39.481238380846634,0.045843882722588325,743.172102689743,294.738242149353,1045.6627883911133,32799,4108,28691,28691,0,9,4497000.0
4497,4497999,22.24564961622752,39.480112048434826,0.045815944841747225,743.2906010150909,294.7989068031311,1045.9297409057617,32802,4108,28694,28694,0,9,4498000.0
4498,4498999,22.246010820454046,39.479192898111705,0.04579745713337291,743.5650815963745,294.8615264892578,1046.0321159362793,32807,4110,28697,28697,0,9,4499000.0
4499,4499999,22.246080642666524,39.47773634853688,0.04577211087094557,743.7546226978302,294.92324018478394,1046.2883758544922,32826,4111,28715,28715,0,9,4500000.0
4500,4500999,22.24631488795251,39.47811816736579,0.045758135628622076,744.0185313224792,294.98966670036316,1046.6790237426758,32846,4113,28733,28733,0,9,4501000.0
4501,4501999,22.245942700216567,39.47640885993589,0.045748736257189004,744.1358096599579,295.05081963539124,1047.0005645751953,32848,4113,28735,28735,0,9,4502000.0
4502,4502999,22.24526395930323,39.47568834602411,0.04574039772497018,744.2668211460114,295.1168794631958,1047.7282218933105,32873,4113,28760,28760,0,9,4503000.0
4503,4503999,22.243966168033953,39.47556515075762,0.04572989463858346,744.3969249725342,295.1800274848938,1048.1133728027344,32879,4113,28766,28766,0,9,4504000.0
4504,4504999,22.24255547378253,39.4730607671056,0.045733335519669294,744.5866982936859,295.24171900749207,1048.313404083252,32883,4114,28769,28769,0,9,4505000.0
4505,4505999,22.241464109373332,39.47101076708514,0.045735151198235346,744.7054173946381,295.30260252952576,1048.5493125915527,32885,4114,28771,28771,0,9,4506000.0
4506,4506999,22.24027074458926,39.468341477274315,0.04573073145648299,744.9670743942261,295.36468958854675,1048.6298294067383,32909,4116,28793,28793,0,9,4507000.0
4507,4507999,22.239478665398355,39.4669217350698,0.04573206565146959,745.1683557033539,295.4264919757843,1048.8122749328613,32912,4117,28795,28795,0,9,4508000.0
4508,4508999,22.238885911391588,39.46509569145104,0.045734088813392915,745.4407801628113,295.4917702674866,1048.948471069336,32923,4119,28804,28804,0,9,4509000.0
4509,4509999,22.23830376718519,39.46331338720256,0.04573562232610551,745.5766913890839,295.553359746933,1049.1736183166504,32924,4119,28805,28805,0,9,4510000.0
4510,4510999,22.237551051471716,39.461198975534245,0.04573527028667368,745.8520526885986,295.6181447505951,1049.2392120361328,32934,4121,28813,28813,0,9,4511000.0
4511,4511999,22.237092387482978,39.45987366811114,0.04573093721252497,746.055549621582,295.6819841861725,1049.4837684631348,32944,4122,28822,28822,0,9,4512000.0
4512,4512999,22.236940750058757,39.45819258524772,0.04572317486721911,746.1731343269348,295.7435460090637,1049.615852355957,32945,4122,28823,28823,0,9,4513000.0
4513,4513999,22.23681385946426,39.45721662080991,0.04571637378121585,746.4268524646759,295.8036425113678,1049.6353378295898,32951,4124,28827,28827,0,9,4514000.0
4514,4514999,22.236779310196724,39.456132679098275,0.04570969576543715,746.5536284446716,295.86547446250916,1049.919620513916,32955,4124,28831,28831,0,9,4515000.0
4515,4515999,22.236789301450365,39.45518435571529,0.04569812629860803,746.7635853290558,295.931045293808,1050.0653953552246,32971,4125,28846,28846,0,9,4516000.0
4516,4516999,22.236634867976026,39.453539781511644,0.04569019885658254,746.9517703056335,295.9928710460663,1050.4028663635254,32980,4126,28854,28854,0,9,4517000.0
4517,4517999,22.236781059763487,39.452282859036146,0.04568280779601808,747.1581807136536,296.05501413345337,1050.6034698486328,32984,4127,28857,28857,0,9,4518000.0
4518,4518999,22.23661728090239,39.450640513842664,0.045680899400097785,747.5608038902283,296.11693120002747,1050.6159324645996,33022,4131,28891,28891,0,9,4519000.0
4519,4519999,22.23709388046782,39.449949196474705,0.04566779741791238,747.7614579200745,296.17940497398376,1050.8234062194824,33024,4132,28892,28892,0,9,4520000.0
4520,4520999,22.237428391664643,39.448996809149314,0.04565780197298741,747.8904278278351,296.2432825565338,1051.0628700256348,33025,4132,28893,28893,0,9,4521000.0
4521,4521999,22.237503534673785,39.44742591499679,0.04565280292611684,748.0098476409912,296.3074617385864,1051.2489166259766,33026,4132,28894,28894,0,9,4522000.0
4522,4522999,22.237564651643495,39.44620121681001,0.04564425094426572,748.1351647377014,296.3684742450714,1051.5147705078125,33028,4132,28896,28896,0,9,4523000.0
4523,4523999,22.23681403632394,39.444355944252145,0.04563521120806846,748.2585744857788,296.430951833725,1052.1172142028809,33050,4132,28918,28918,0,9,4524000.0
4524,4524999,22.235452949518002,39.44270580230158,0.04563054144175005,748.3792369365692,296.49333357810974,1052.716079711914,33063,4132,28931,28931,0,9,4525000.0
4525,4525999,22.234200998479906,39.44041124298376,0.04562514112499505,748.5188298225403,296.5588114261627,1053.173900604248,33071,4132,28939,28939,0,9,4526000.0
4526,4526999,22.232817838543912,39.43792486982489,0.045619466950793885,748.7105603218079,296.62061405181885,1053.3955039978027,33078,4133,28945,28945,0,9,4527000.0
4527,4527999,22.231833840417757,39.437135037860735,0.04561178145554068,748.9367277622223,296.69136452674866,1053.4896430969238,33086,4134,28952,28952,0,9,4528000.0
4528,4528999,22.230962195774314,39.435049681221976,0.04559986880544675,749.0572783946991,296.75359177589417,1053.6884651184082,33086,4134,28952,28952,0,9,4529000.0
4529,4529999,22.22971399208832,39.43221323366726,0.04559491508846647,749.3288300037384,296.8169012069702,1053.8416023254395,33097,4136,28961,28961,0,9,4530000.0
4530,4530999,22.22851002396883,39.429532164221094,0.045589081989636404,749.4480586051941,296.8784565925598,1054.0215911865234,33097,4136,28961,28961,0,9,4531000.0
4531,4531999,22.227539523834814,39.42746576124929,0.04558084524123551,749.5716779232025,296.939905166626,1054.1867027282715,33098,4136,28962,28962,0,9,4532000.0
4532,4532999,22.226680420626174,39.42526936693456,0.045565709393467047,749.8435573577881,297.0036778450012,1054.3969650268555,33111,4138,28973,28973,0,9,4533000.0
4533,4533999,22.225956525271073,39.423118860964266,0.045552119438422745,749.9584269523621,297.0648970603943,1054.610122680664,33112,4138,28974,28974,0,9,4534000.0
4534,4534999,22.225333479225892,39.42131626209245,0.04553954266275484,750.0772840976715,297.12701296806335,1054.8264274597168,33113,4138,28975,28975,0,9,4535000.0
4535,4535999,22.225387290687635,39.42129810640839,0.04552129809346028,750.5110578536987,297.19006180763245,1054.730339050293,33132,4142,28990,28990,0,9,4536000.0
4536,4536999,22.22503396659174,39.41980974771816,0.04551006698517668,750.7177755832672,297.2530665397644,1055.0204048156738,33150,4143,29007,29007,0,9,4537000.0
4537,4537999,22.22492692163154,39.41828723183891,0.04549202168666777,750.9151563644409,297.3148784637451,1055.1977577209473,33154,4144,29010,29010,0,9,4538000.0
4538,4538999,22.225001640405818,39.41693242260871,0.045474625689006176,751.1081991195679,297.3764262199402,1055.2503776550293,33156,4145,29011,29011,0,9,4539000.0
4539,4539999,22.225339695023813,39.415942185795586,0.04546054943486111,751.3000319004059,297.438015460968,1055.4796867370605,33166,4146,29020,29020,0,9,4540000.0
4540,4540999,22.22585844901206,39.41538729727933,0.045446082158039025,751.4222781658173,297.5009915828705,1055.7324295043945,33168,4146,29022,29022,0,9,4541000.0
4541,4541999,22.226565391005682,39.41501623429966,0.04543813826708187,751.6237359046936,297.5631945133209,1055.8820724487305,33181,4147,29034,29034,0,9,4542000.0
4542,4542999,22.227367011347745,39.41475424924825,0.04543954978436959,751.8163754940033,297.62515139579773,1056.1638069152832,33190,4148,29042,29042,0,9,4543000.0
4543,4543999,22.2285969896585,39.41482779247861,0.045420748173799486,751.9380240440369,297.6864674091339,1056.4391441345215,33194,4148,29046,29046,0,9,4544000.0
4544,4544999,22.228457077254458,39.41310642467765,0.045411405034905594,752.0554673671722,297.7480847835541,1056.6735382080078,33196,4148,29048,29048,0,9,4545000.0
4545,4545999,22.227077283273413,39.41027787319173,0.04540147739132938,755.6661467552185,297.8116829395294,1057.3181228637695,33219,4148,29071,29071,0,9,4546000.0
4546,4546999,22.226082783079733,39.40902296498087,0.045381041840941716,755.7990787029266,297.87437415122986,1057.7011260986328,33226,4148,29078,29078,0,9,4547000.0
4547,4547999,22.22495763158159,39.40866509939512,0.04536413027603603,756.1449670791626,297.9371566772461,1057.7950744628906,33269,4151,29118,29118,0,9,4548000.0
4548,4548999,22.22438618773517,39.40728838092165,0.045344735665378666,756.4282765388489,297.99970626831055,1057.9487342834473,33290,4153,29137,29137,0,9,4549000.0
4549,4549999,22.22419647186058,39.40703775621378,0.04533463606179622,756.5626718997955,298.0620799064636,1058.209300994873,33291,4153,29138,29138,0,9,4550000.0
4550,4550999,22.223789645957876,39.40593954732946,0.04533257132567625,756.7820193767548,298.1258599758148,1058.404109954834,33308,4154,29154,29154,0,9,4551000.0
4551,4551999,22.223430865624902,39.40561147267054,0.0453215591594438,757.1211869716644,298.18702697753906,1058.5614700317383,33326,4157,29169,29169,0,9,4552000.0
4552,4552999,22.223642472383496,39.40637546107709,0.04531026251609227,757.3291826248169,298.2515182495117,1058.8508758544922,33341,4158,29183,29183,0,9,4553000.0
4553,4553999,22.224099561834084,39.407226886200355,0.04530907850320898,757.5401902198792,298.31557512283325,1058.9483795166016,33349,4159,29190,29190,0,9,4554000.0
4554,4554999,22.22470855506659,39.40824623294845,0.04531103236272571,757.6667640209198,298.3778715133667,1059.2405166625977,33349,4159,29190,29190,0,9,4555000.0
4555,4555999,22.22546621676896,39.40965311386722,0.0453209683937873,757.7923021316528,298.44015288352966,1059.46870803833,33350,4159,29191,29191,0,9,4556000.0
4556,4556999,22.226578100253917,39.41070607357618,0.045334103145012294,757.9219417572021,298.5024628639221,1059.6274375915527,33350,4159,29191,29191,0,9,4557000.0
4557,4557999,22.22784472846196,39.412869755022,0.04533991469062082,758.2836678028107,298.567489862442,1059.5450744628906,33356,4162,29194,29194,0,9,4558000.0
4558,4558999,22.230085481521233,39.41648031050669,0.045354927309789295,758.4084603786469,298.629656791687,1059.816390991211,33358,4162,29196,29196,0,9,4559000.0
4559,4559999,22.23217058934578,39.41917912225942,0.04538681725822691,758.6743597984314,298.69097208976746,1059.9330368041992,33362,4164,29198,29198,0,9,4560000.0
4560,4560999,22.234289782601348,39.42160896983498,0.045421294670276446,758.805059671402,298.7560043334961,1060.2098922729492,33363,4164,29199,29199,0,9,4561000.0
4561,4561999,22.236979352104665,39.424726509434244,0.045459384787571167,759.0028576850891,298.8207392692566,1060.5655326843262,33369,4165,29204,29204,0,9,4562000.0
4562,4562999,22.239468910742676,39.42847095893037,0.04549924822320217,759.2742419242859,298.88394355773926,1060.6999435424805,33383,4167,29216,29216,0,9,4563000.0
4563,4563999,22.242329567399963,39.43245083856628,0.04556147714243741,759.3941795825958,298.946590423584,1061.0335845947266,33385,4167,29218,29218,0,9,4564000.0
4564,4564999,22.245219897840443,39.4359606176715,0.04562845679542893,759.6813533306122,299.0106599330902,1061.3276329040527,33397,4169,29228,29228,0,9,4565000.0
4565,4565999,22.247396197311662,39.43811993179154,0.04566648311108945,760.0410966873169,299.07430768013,1061.4247703552246,33422,4172,29250,29250,0,9,4566000.0
4566,4566999,22.246412653615415,39.43572105717881,0.04565482430018819,760.2441384792328,299.1396656036377,1061.9955711364746,33459,4173,29286,29286,0,9,4567000.0
4567,4567999,22.245211094408194,39.434145639938954,0.04564844242024235,760.532913684845,299.2032926082611,1062.3299751281738,33486,4175,29311,29311,0,9,4568000.0
4568,4568999,22.244006037514396,39.43289792255172,0.04564402862616912,760.8276958465576,299.2668435573578,1062.4564056396484,33502,4177,29325,29325,0,9,4569000.0
4569,4569999,22.242811788316473,39.43018862146782,0.045639132544733174,760.9652709960938,299.33098888397217,1062.6954460144043,33502,4177,29325,29325,0,9,4570000.0
4570,4570999,22.241569609873476,39.4275459973298,0.045631626551243865,761.0927872657776,299.39323687553406,1062.870979309082,33502,4177,29325,29325,0,9,4571000.0
4571,4571999,22.240384126578913,39.42537608691774,0.045627298197809085,761.2942066192627,299.4555969238281,1062.9150848388672,33509,4178,29331,29331,0,9,4572000.0
4572,4572999,22.23923182903787,39.42355482937813,0.04562614331098702,761.4304585456848,299.51786708831787,1063.1540489196777,33509,4178,29331,29331,0,9,4573000.0
4573,4573999,22.238276518252185,39.42186881239235,0.04562077250162744,761.701911687851,299.5801479816437,1063.2293090820312,33518,4180,29338,29338,0,9,4574000.0
4574,4574999,22.237264447684858,39.42024835341139,0.04561229603498651,762.0568604469299,299.64317178726196,1063.2562217712402,33533,4183,29350,29350,0,9,4575000.0
4575,4575999,22.236725914008424,39.419107888132196,0.04560957148413347,762.2570719718933,299.70600605010986,1063.4765396118164,33543,4184,29359,29359,0,9,4576000.0
4576,4576999,22.236544725610866,39.42319692419071,0.045594780196240414,762.3858375549316,299.7708034515381,1063.7407341003418,33545,4184,29361,29361,0,9,4577000.0
4577,4577999,22.23727591297175,39.425527875869165,0.04561591995991643,762.5102503299713,299.83554673194885,1063.9019737243652,33545,4184,29361,29361,0,9,4578000.0
4578,4578999,22.23938557864601,39.432029623824405,0.045640029028791274,762.7182402610779,299.8987958431244,1064.035068511963,33548,4185,29363,29363,0,9,4579000.0
4579,4579999,22.241880557837945,39.43841732884107,0.045679339544585806,762.932121515274,299.96094822883606,1064.1875610351562,33552,4186,29366,29366,0,9,4580000.0
4580,4580999,22.244851876485782,39.44692703087877,0.0457227017768419,763.1384959220886,300.02475786209106,1064.3872528076172,33554,4187,29367,29367,0,9,4581000.0
4581,4581999,22.249521000245295,39.45922263450327,0.04577712920897048,763.2660291194916,300.0874755382538,1064.6679763793945,33556,4187,29369,29369,0,9,4582000.0
4582,4582999,22.25403464641525,39.46998536794777,0.045843841167505395,763.534987449646,300.14990854263306,1064.8705978393555,33573,4189,29384,29384,0,9,4583000.0
4583,4583999,22.259095833408637,39.48358238104898,0.04591136019973796,763.7399213314056,300.2122070789337,1065.0050086975098,33594,4190,29404,29404,0,9,4584000.0
4584,4584999,22.263051398818217,39.49168697444823,0.04595350567027823,763.9438631534576,300.2744779586792,1065.2748985290527,33604,4191,29413,29413,0,9,4585000.0
4585,4585999,22.26776716235319,39.50043522189396,0.04603617240432878,764.1396698951721,300.3369174003601,1065.4743537902832,33613,4192,29421,29421,0,9,4586000.0
4586,4586999,22.269600524653626,39.503294576543446,0.04607048377593981,764.351184129715,300.4020314216614,1065.79154586792,33626,4193,29433,29433,0,9,4587000.0
4587,4587999,22.268671298457047,39.50253379313259,0.04605860215374913,764.5567388534546,300.4648275375366,1066.308162689209,33647,4194,29453,29453,0,9,4588000.0
4588,4588999,22.267663068252297,39.50191097071689,0.046054457764925005,764.6888799667358,300.5282175540924,1066.673740386963,33653,4194,29459,29459,0,9,4589000.0
4589,4589999,22.26672451050543,39.50022399244063,0.04604559189688384,764.8176081180573,300.5907711982727,1066.9323348999023,33656,4194,29462,29462,0,9,4590000.0
4590,4590999,22.265555369647366,39.49793638873075,0.04604543672147843,764.9433250427246,300.652761220932,1067.0704193115234,33656,4194,29462,29462,0,9,4591000.0
4591,4591999,22.264370868129483,39.496376681353304,0.04605341294117027,765.2260503768921,300.71594738960266,1067.1399993896484,33660,4196,29464,29464,0,9,4592000.0
4592,4592999,22.263289246986684,39.49519603080716,0.04604650559214429,765.4263617992401,300.78096079826355,1067.297924041748,33662,4197,29465,29465,0,9,4593000.0
4593,4593999,22.26211695694592,39.49281103703516,0.0460452383334673,765.6297364234924,300.8436698913574,1067.47318649292,33670,4198,29472,29472,0,9,4594000.0
4594,4594999,22.260995619854615,39.490574877053774,0.04604430064731324,765.9142339229584,300.9083843231201,1067.5807991027832,33685,4200,29485,29485,0,9,4595000.0
4595,4595999,22.26024098569284,39.488710900994775,0.0460459134129072,766.0466117858887,300.97308897972107,1067.792350769043,33685,4200,29485,29485,0,9,4596000.0
4596,4596999,22.259895575815825,39.48761656791417,0.04603928959542791,766.3269169330597,301.0354607105255,1067.9275398254395,33700,4202,29498,29498,0,9,4597000.0
4597,4597999,22.259703335070622,39.48738436371949,0.04603126729214624,766.4838128089905,301.0981755256653,1068.023681640625,33700,4202,29498,29498,0,9,4598000.0
4598,4598999,22.25963340416472,39.48615276886442,0.04602749652484417,766.7623775005341,301.1609945297241,1068.0239486694336,33705,4204,29501,29501,0,9,4599000.0
4599,4599999,22.259884313012243,39.485711808837415,0.04601765966372362,766.8819484710693,301.2227795124054,1068.1706771850586,33705,4204,29501,29501,0,9,4600000.0
4600,4600999,22.260769561500947,39.48917531334013,0.04599978198034915,767.2287609577179,301.2851276397705,1068.2079391479492,33714,4207,29507,29507,0,9,4601000.0
4601,4601999,22.261287134444157,39.490011929149226,0.04599097158648424,767.5901441574097,301.34813165664673,1068.2570495605469,33736,4210,29526,29526,0,9,4602000.0
4602,4602999,22.26245715195189,39.491499654712065,0.045974377540729305,767.7943601608276,301.4108591079712,1068.444938659668,33745,4211,29534,29534,0,9,4603000.0
4603,4603999,22.263176706291752,39.49284235962575,0.04595963288331162,767.9969980716705,301.4732530117035,1068.7011756896973,33762,4212,29550,29550,0,9,4604000.0
4604,4604999,22.263778575361865,39.49220062896725,0.0459466665608349,768.2825636863708,301.53648924827576,1068.8750457763672,33772,4214,29558,29558,0,9,4605000.0
4605,4605999,22.263479644151182,39.491243335319645,0.04593324982196245,768.4073524475098,301.5991609096527,1069.5336723327637,33793,4214,29579,29579,0,9,4606000.0
4606,4606999,22.262580591377226,39.49097237839324,0.04593618531829258,768.5383167266846,301.6640627384186,1069.9765243530273,33800,4214,29586,29586,0,9,4607000.0
4607,4607999,22.261360698433872,39.48929189613646,0.04593799105872254,768.7449955940247,301.72746658325195,1070.1892547607422,33810,4215,29595,29595,0,9,4608000.0
4608,4608999,22.26042004443021,39.48747698449447,0.045936015975257205,768.8641712665558,301.78935742378235,1070.3696403503418,33810,4215,29595,29595,0,9,4609000.0
4609,4609999,22.26028968723509,39.4887903351012,0.04592971074116481,769.0688281059265,301.8527202606201,1070.5228309631348,33818,4216,29602,29602,0,9,4610000.0
4610,4610999,22.260941703323333,39.490132646041445,0.04591928381896204,769.3662779331207,301.9165184497833,1070.6231727600098,33835,4218,29617,29617,0,9,4611000.0
4611,4611999,22.26181695266301,39.491026342823474,0.04591860486681765,769.4900772571564,301.97850608825684,1070.8808898925781,33838,4218,29620,29620,0,9,4612000.0
4612,4612999,22.26274705276335,39.49349355667494,0.045927839152695604,769.7669262886047,302.04338550567627,1070.9778060913086,33853,4220,29633,29633,0,9,4613000.0
4613,4613999,22.26320191830218,39.49348368396938,0.04593701237799719,770.1241190433502,302.1066052913666,1071.1430625915527,33867,4223,29644,29644,0,9,4614000.0
4614,4614999,22.264534416197485,39.49529275736,0.045938209992016366,770.332629442215,302.16952776908875,1071.2716522216797,33875,4224,29651,29651,0,9,4615000.0
4615,4615999,22.266496308546152,39.49873326798287,0.045951750466812546,770.5267579555511,302.2318289279938,1071.4535369873047,33884,4225,29659,29659,0,9,4616000.0
4616,4616999,22.26859613196291,39.501717531475755,0.04597075262969297,770.893728017807,302.2959518432617,1071.572422027588,33901,4228,29673,29673,0,9,4617000.0
4617,4617999,22.27017116057455,39.50340869650333,0.045982011038904425,771.3203003406525,302.36198115348816,1071.6391220092773,33920,4232,29688,29688,0,9,4618000.0
4618,4618999,22.272231703186403,39.50638456766924,0.04599557824894185,771.6959919929504,302.425892829895,1071.7623138427734,33944,4235,29709,29709,0,9,4619000.0
4619,4619999,22.27474444796012,39.511292736354676,0.04601754867253538,771.8937811851501,302.4899516105652,1071.9383964538574,33950,4236,29714,29714,0,9,4620000.0
4620,4620999,22.276869874489872,39.51455917654662,0.04605241063730081,772.3939435482025,302.5550334453583,1071.9578094482422,33984,4241,29743,29743,0,9,4621000.0
4621,4621999,22.279706882814672,39.51991663385668,0.04607300271218151,772.7466354370117,302.6180901527405,1072.1395797729492,34003,4244,29759,29759,0,9,4622000.0
4622,4622999,22.282610871349608,39.52398848710892,0.04612492645799038,773.0995607376099,302.6808006763458,1072.1937828063965,34018,4247,29771,29771,0,9,4623000.0
4623,4623999,22.284906181976893,39.52672393929151,0.04614908876686341,773.300500869751,302.74349570274353,1072.494773864746,34026,4248,29778,29778,0,9,4624000.0
4624,4624999,22.287131274710774,39.530138002326346,0.04616513262290689,773.5768268108368,302.8061611652374,1072.7685737609863,34044,4250,29794,29794,0,9,4625000.0
4625,4625999,22.287725280312788,39.53019319326443,0.046166282857423524,773.7766184806824,302.86843395233154,1073.2326583862305,34065,4251,29814,29814,0,9,4626000.0
4626,4626999,22.286291501768616,39.52889555567122,0.04616654021694189,773.9820861816406,302.9311306476593,1073.5488662719727,34085,4252,29833,29833,0,9,4627000.0
4627,4627999,22.28508650727828,39.527181203555955,0.046171936027238125,774.2786054611206,302.99593138694763,1073.75297164917,34098,4254,29844,29844,0,9,4628000.0
4628,4628999,22.284031618133074,39.52544886835856,0.0461742221761986,774.4064464569092,303.05870723724365,1074.073055267334,34101,4254,29847,29847,0,9,4629000.0
4629,4629999,22.28350994757248,39.524525018906445,0.04617178218945617,774.6897041797638,303.1212594509125,1074.1245574951172,34113,4256,29857,29857,0,9,4630000.0
4630,4630999,22.283290208070635,39.52497806082837,0.04617114429176172,774.9847373962402,303.18413043022156,1074.1755599975586,34124,4258,29866,29866,0,9,4631000.0
4631,4631999,22.283029961012726,39.524702626864695,0.04617321653639561,775.1279973983765,303.24911522865295,1074.3886833190918,34125,4258,29867,29867,0,9,4632000.0
4632,4632999,22.282680296708715,39.523577593407666,0.04617321369723648,775.246440410614,303.31105947494507,1074.5476531982422,34125,4258,29867,29867,0,9,4633000.0
4633,4633999,22.28251752828247,39.522832769441244,0.04617750486522554,775.6122152805328,303.3747124671936,1074.5853576660156,34150,4261,29889,29889,0,9,4634000.0
4634,4634999,22.282941347824305,39.5257625629386,0.046179351562072535,775.9829933643341,303.4403760433197,1074.6828651428223,34167,4264,29903,29903,0,9,4635000.0
4635,4635999,22.2830392086445,39.52563047005716,0.04620049979049967,776.1128742694855,303.50619864463806,1074.9350051879883,34168,4264,29904,29904,0,9,4636000.0
4636,4636999,22.28451578626793,39.52908174116027,0.04621328537288483,776.3212149143219,303.57196068763733,1075.2060813903809,34172,4265,29907,29907,0,9,4637000.0
4637,4637999,22.286309063469773,39.53284883115403,0.04624476838938962,776.5196175575256,303.63490176200867,1075.4112586975098,34183,4266,29917,29917,0,9,4638000.0
4638,4638999,22.287753131132092,39.534827803365715,0.046266672051130664,776.7371070384979,303.6989891529083,1075.6072731018066,34214,4267,29947,29947,0,9,4639000.0
4639,4639999,22.289775701296914,39.53842770631532,0.04628667833189826,777.0192141532898,303.7617070674896,1075.7940864562988,34227,4269,29958,29958,0,9,4640000.0
4640,4640999,22.29232427957382,39.54237730149517,0.04631319842531845,777.2207300662994,303.8256630897522,1075.918556213379,34234,4270,29964,29964,0,9,4641000.0
4641,4641999,22.294930176407334,39.54659190312871,0.04633734717762994,777.4303646087646,303.8880214691162,1076.0753173828125,34258,4271,29987,29987,0,9,4642000.0
4642,4642999,22.29796931214353,39.55361348643652,0.04635326350904867,777.6372468471527,303.9505121707916,1076.2792930603027,34266,4272,29994,29994,0,9,4643000.0
4643,4643999,22.301206375179625,39.56218479835516,0.046380714841376736,778.0121140480042,304.0147340297699,1076.370204925537,34303,4275,30028,30028,0,9,4644000.0
4644,4644999,22.303754867280887,39.56635840766808,0.046411206231540825,778.3698627948761,304.0781831741333,1076.3831367492676,34334,4278,30056,30056,0,9,4645000.0
4645,4645999,22.30584767501948,39.56891935309157,0.04642435190628946,778.6547338962555,304.14491176605225,1076.5870475769043,34345,4280,30065,30065,0,9,4646000.0
4646,4646999,22.3056053364478,39.568743090651694,0.04643714190551851,778.8499853610992,304.20604062080383,1077.0292663574219,34362,4281,30081,30081,0,9,4647000.0
4647,4647999,22.30441608845902,39.56801800654505,0.046436214928921804,779.204779624939,304.268919467926,1077.1586570739746,34391,4284,30107,30107,0,9,4648000.0
4648,4648999,22.30320387188693,39.566363170076244,0.046442212787655035,779.4123537540436,304.3318917751312,1077.453971862793,34399,4285,30114,30114,0,9,4649000.0
4649,4649999,22.302296968400366,39.564891180771305,0.04644837566802684,779.5475780963898,304.3942587375641,1077.7257080078125,34402,4285,30117,30117,0,9,4650000.0
4650,4650999,22.301670154877502,39.564243193117946,0.04645353780820893,779.7554354667664,304.45619320869446,1077.7863082885742,34409,4286,30123,30123,0,9,4651000.0
4651,4651999,22.30129997687307,39.56320481230198,0.04644829120181626,779.8845298290253,304.5170361995697,1077.998622894287,34410,4286,30124,30124,0,9,4652000.0
4652,4652999,22.30075092741694,39.56221795902041,0.046446736070453576,780.1757209300995,304.5871500968933,1078.0830726623535,34430,4288,30142,30142,0,9,4653000.0
4653,4653999,22.30011100319997,39.560520399648375,0.046449831525869456,780.3068916797638,304.64964056015015,1078.2200469970703,34430,4288,30142,30142,0,9,4654000.0
4654,4654999,22.300126722893722,39.560673518560414,0.04645374175825745,780.4360129833221,304.7125861644745,1078.377555847168,34431,4288,30143,30143,0,9,4655000.0
4655,4655999,22.30040249048296,39.561301658362176,0.04646498642377317,780.7297930717468,304.7748792171478,1078.383071899414,34436,4290,30146,30146,0,9,4656000.0
4656,4656999,22.30086861356628,39.56204699998461,0.04647122076352783,781.0843126773834,304.83885884284973,1078.3876876831055,34449,4293,30156,30156,0,9,4657000.0
4657,4657999,22.301928688054364,39.56595039521409,0.046498831958142084,781.4496359825134,304.90141892433167,1078.3711700439453,34482,4296,30186,30186,0,9,4658000.0
4658,4658999,22.302546481361365,39.567169942117694,0.046528719474057234,781.5881037712097,304.9641706943512,1078.579402923584,34482,4296,30186,30186,0,9,4659000.0
4659,4659999,22.3030917253276,39.56745193987867,0.046543455007513,781.8788242340088,305.0286281108856,1078.675479888916,34501,4298,30203,30203,0,9,4660000.0
4660,4660999,22.30372456193809,39.568144007915315,0.046557011147647764,782.0778267383575,305.09065294265747,1078.9691734313965,34503,4299,30204,30204,0,9,4661000.0
4661,4661999,22.30549636211322,39.5705619442812,0.046596609237648745,782.2157101631165,305.15296745300293,1079.305751800537,34506,4299,30207,30207,0,9,4662000.0
4662,4662999,22.307351372241744,39.57377246953658,0.04663454050378679,782.3491678237915,305.2149062156677,1079.5880165100098,34507,4299,30208,30208,0,9,4663000.0
4663,4663999,22.308814033197727,39.57511319634614,0.046660078370104885,782.4663751125336,305.2777817249298,1079.7384071350098,34507,4299,30208,30208,0,9,4664000.0
4664,4664999,22.310181253792294,39.575720726909765,0.04667142621778664,782.6688296794891,305.3422996997833,1080.0709648132324,34516,4300,30216,30216,0,9,4665000.0
4665,4665999,22.31173561490119,39.57703213296469,0.04667943812042341,782.802362203598,305.40411615371704,1080.3417854309082,34518,4300,30218,30218,0,9,4666000.0
4666,4666999,22.31225143567027,39.576425891666766,0.04668228149310927,782.924676656723,305.4654440879822,1080.6391258239746,34524,4300,30224,30224,0,9,4667000.0
4667,4667999,22.31105341084587,39.57457414302966,0.04668438300693967,783.2697103023529,305.5281569957733,1080.9639129638672,34542,4303,30239,30239,0,9,4668000.0
4668,4668999,22.309696607876067,39.57243540783965,0.04668459777004941,783.5480849742889,305.5917627811432,1081.1694602966309,34555,4305,30250,30250,0,9,4669000.0
4669,4669999,22.30828404897446,39.56981527393624,0.046693260533840486,783.6774230003357,305.65682315826416,1081.360164642334,34555,4305,30250,30250,0,9,4670000.0
4670,4670999,22.307198562064805,39.56858266423713,0.04669250990215257,783.8079385757446,305.72053575515747,1081.5219993591309,34555,4305,30250,30250,0,9,4671000.0
4671,4671999,22.305930006077805,39.56597406327779,0.046695493373403396,784.0106661319733,305.7849154472351,1081.6207084655762,34558,4306,30252,30252,0,9,4672000.0
4672,4672999,22.304494113656084,39.56308033844086,0.04670006362860324,784.3060615062714,305.853013753891,1081.7475624084473,34573,4308,30265,30265,0,9,4673000.0
4673,4673999,22.303763269618322,39.56214981969842,0.04670232179483358,784.4335033893585,305.9165027141571,1081.899814605713,34573,4308,30265,30265,0,9,4674000.0
4674,4674999,22.30284763062246,39.55981965897116,0.04670527627634591,784.5596675872803,305.9783115386963,1082.1237297058105,34576,4308,30268,30268,0,9,4675000.0
4675,4675999,22.30211104737131,39.55800185097285,0.04670673067556008,784.7590816020966,306.0404281616211,1082.3558464050293,34587,4309,30278,30278,0,9,4676000.0
4676,4676999,22.30150162151589,39.55655775220347,0.04671157869761611,784.9600031375885,306.10248160362244,1082.508014678955,34590,4310,30280,30280,0,9,4677000.0
4677,4677999,22.30132875945714,39.55551355662314,0.046712220252065784,785.0874056816101,306.16460251808167,1082.7451629638672,34593,4310,30283,30283,0,9,4678000.0
4678,4678999,22.301483056889367,39.55760521563656,0.046715942902173735,785.2932403087616,306.226687669754,1082.8290824890137,34595,4311,30284,30284,0,9,4679000.0
4679,4679999,22.301316958247888,39.55654400512258,0.04672056229815613,785.4918117523193,306.28899693489075,1082.9536933898926,34604,4312,30292,30292,0,9,4680000.0
4680,4680999,22.3017491985843,39.556524780804786,0.04672016218052999,785.7727906703949,306.35167837142944,1083.1008071899414,34618,4314,30304,30304,0,9,4681000.0
4681,4681999,22.302538050888078,39.55718970224278,0.046721717405276975,785.9683456420898,306.41217827796936,1083.2426643371582,34627,4315,30312,30312,0,9,4682000.0
4682,4682999,22.30348037155157,39.55751003563743,0.04673048106419064,786.1795001029968,306.4745852947235,1083.3932075500488,34635,4316,30319,30319,0,9,4683000.0
4683,4683999,22.305821199171362,39.56948197582022,0.046724865455343156,786.3827962875366,306.5373344421387,1083.6168937683105,34650,4317,30333,30333,0,9,4684000.0
4684,4684999,22.30717577247696,39.570714497092446,0.04673212936832227,786.5818855762482,306.59972977638245,1083.7939910888672,34657,4318,30339,30339,0,9,4685000.0
4685,4685999,22.308689547823235,39.57386193933174,0.04674231577820109,786.9559092521667,306.6653907299042,1083.927806854248,34664,4321,30343,30343,0,9,4686000.0
4686,4686999,22.310159846741268,39.57515364753175,0.04674936031440258,787.0850195884705,306.7291057109833,1084.2258262634277,34667,4321,30346,30346,0,9,4687000.0
4687,4687999,22.30976423814312,39.57402989862401,0.04675383747931783,787.2156267166138,306.79330468177795,1084.7854270935059,34685,4321,30364,30364,0,9,4688000.0
4688,4688999,22.308426056668733,39.57295728536473,0.04675597106985552,787.5693271160126,306.85722732543945,1085.231918334961,34719,4324,30395,30395,0,9,4689000.0
4689,4689999,22.30730384368963,39.573630421156395,0.04675846300590125,787.8438057899475,306.9218649864197,1085.5633926391602,34741,4326,30415,30415,0,9,4690000.0
4690,4690999,22.306194970863405,39.572452502689224,0.04675918914888144,788.0390853881836,306.9840669631958,1085.786880493164,34748,4327,30421,30421,0,9,4691000.0
4691,4691999,22.304706169211492,39.5700230777754,0.046764546930984086,788.1700661182404,307.0464279651642,1086.0212097167969,34748,4327,30421,30421,0,9,4692000.0
4692,4692999,22.30363308874801,39.56834146896418,0.046764019252519495,788.4570353031158,307.1100764274597,1086.1205215454102,34763,4329,30434,30434,0,9,4693000.0
4693,4693999,22.30289918917555,39.56776662440043,0.04676075679434022,788.5873990058899,307.17323112487793,1086.3565139770508,34763,4329,30434,30434,0,9,4694000.0
4694,4694999,22.301888190109906,39.565767332906546,0.04676289725258054,788.9403305053711,307.236736536026,1086.394329071045,34774,4332,30442,30442,0,9,4695000.0
4695,4695999,22.30112906268296,39.565101213431355,0.04676588431479034,789.075353384018,307.30307054519653,1086.6704177856445,34776,4332,30444,30444,0,9,4696000.0
4696,4696999,22.300952167340014,39.56561568913056,0.046768722413400465,789.356999874115,307.3666205406189,1086.8344268798828,34792,4334,30458,30458,0,9,4697000.0
4697,4697999,22.301001347107434,39.56716461854074,0.04678906497260671,789.5544466972351,307.42877888679504,1086.985019683838,34795,4335,30460,30460,0,9,4698000.0
4698,4698999,22.301439366194455,39.56868893523618,0.0468105863228373,789.9029681682587,307.49148869514465,1087.061092376709,34818,4338,30480,30480,0,9,4699000.0
4699,4699999,22.302628101584574,39.57369368263105,0.04683851121536531,790.2109522819519,307.5621316432953,1087.3070068359375,34824,4340,30484,30484,0,9,4700000.0
4700,4700999,22.304106865973647,39.57790238262023,0.04685901907435064,790.4412412643433,307.6328148841858,1087.554916381836,34834,4341,30493,30493,0,9,4701000.0
4701,4701999,22.306195207428814,39.585384988261914,0.04684673968821018,790.5680224895477,307.6951141357422,1087.8773803710938,34838,4341,30497,30497,0,9,4702000.0
4702,4702999,22.30912964796469,39.593723138398985,0.046862665482797605,790.7623875141144,307.7570643424988,1088.118522644043,34842,4342,30500,30500,0,9,4703000.0
4703,4703999,22.312620330620085,39.6048290981007,0.046864079606325215,791.1372299194336,307.82345485687256,1088.3308448791504,34853,4345,30508,30508,0,9,4704000.0
4704,4704999,22.316595453964883,39.615306523661594,0.04688494226387652,791.2569155693054,307.8857798576355,1088.6405944824219,34854,4345,30509,30509,0,9,4705000.0
4705,4705999,22.320026348392986,39.62547971986179,0.046901298640217415,791.4677250385284,307.9549674987793,1088.9863204956055,34865,4346,30519,30519,0,9,4706000.0
4706,4706999,22.32434118455278,39.636563092006654,0.046917139358923166,791.6012387275696,308.01964473724365,1089.2639427185059,34867,4346,30521,30521,0,9,4707000.0
4707,4707999,22.326645048972708,39.641532199778126,0.04692661991253877,791.7367835044861,308.0896828174591,1089.872184753418,34888,4346,30542,30542,0,9,4708000.0
4708,4708999,22.324723370968957,39.63850282444618,0.04693594584971783,791.8646039962769,308.1531226634979,1090.4309310913086,34901,4346,30555,30555,0,9,4709000.0
4709,4709999,22.32373688017213,39.63843326128042,0.04691774122868109,791.9933984279633,308.2161226272583,1090.7927169799805,34904,4346,30558,30558,0,9,4710000.0
4710,4710999,22.32278068610327,39.637663535217534,0.04691478542681726,792.1157038211823,308.2791121006012,1090.995174407959,34904,4346,30558,30558,0,9,4711000.0
4711,4711999,22.321747394367033,39.6362419719521,0.04690619683725428,792.2407021522522,308.341392993927,1091.1424674987793,34904,4346,30558,30558,0,9,4712000.0
4712,4712999,22.32088697530022,39.63476378757006,0.04690342476764797,792.4374613761902,308.4023244380951,1091.2587966918945,34906,4347,30559,30559,0,9,4713000.0
4713,4713999,22.319914345136286,39.63244574961757,0.046902483016518115,792.5771956443787,308.4673984050751,1091.4309997558594,34906,4347,30559,30559,0,9,4714000.0
4714,4714999,22.318982416053313,39.630458786280656,0.046901049074337786,792.8529634475708,308.53003573417664,1091.4612617492676,34938,4349,30589,30589,0,9,4715000.0
4715,4715999,22.318214812793794,39.628934411282074,0.0468957539969731,792.9808156490326,308.59197211265564,1091.6169815063477,34938,4349,30589,30589,0,9,4716000.0
4716,4716999,22.317569200166815,39.62899233624243,0.046888034597844186,793.1933526992798,308.6554515361786,1091.7676734924316,34941,4350,30591,30591,0,9,4717000.0
4717,4717999,22.317426086655896,39.62851191787999,0.0468782398075106,793.3263485431671,308.7185249328613,1091.929843902588,34941,4350,30591,30591,0,9,4718000.0
4718,4718999,22.317495125588877,39.62843829609505,0.04687485455015927,793.540534734726,308.78253698349,1092.1070709228516,34945,4351,30594,30594,0,9,4719000.0
4719,4719999,22.317686876579838,39.62891480172098,0.04687905321660779,793.6768074035645,308.84668612480164,1092.3380699157715,34946,4351,30595,30595,0,9,4720000.0
4720,4720999,22.31856747115517,39.630390636552214,0.046876113509283446,793.955677986145,308.909481048584,1092.4300231933594,34962,4353,30609,30609,0,9,4721000.0
4721,4721999,22.320464710206064,39.634082965805675,0.04686451748191678,794.0943551063538,308.97352385520935,1092.730209350586,34964,4353,30611,30611,0,9,4722000.0
4722,4722999,22.323163785538195,39.64035032019005,0.04687003174100701,794.2144598960876,309.03705620765686,1093.0224075317383,34969,4353,30616,30616,0,9,4723000.0
4723,4723999,22.327209464378743,39.6486073584158,0.04687969727968777,794.4169836044312,309.1001183986664,1093.290641784668,34973,4354,30619,30619,0,9,4724000.0
4724,4724999,22.33058806917738,39.653837353929134,0.04691807383995272,794.7000417709351,309.16266441345215,1093.4893112182617,34985,4356,30629,30629,0,9,4725000.0
4725,4725999,22.334312011684116,39.660462648056814,0.04697402465057443,794.8192088603973,309.22559452056885,1093.7868309020996,34988,4356,30632,30632,0,9,4726000.0
4726,4726999,22.338887025218188,39.67056104479925,0.04705479826709402,794.9453973770142,309.28767800331116,1094.0081939697266,34990,4356,30634,30634,0,9,4727000.0
4727,4727999,22.342340200045253,39.67769464155859,0.04710672156187756,795.080263376236,309.34961342811584,1094.2102699279785,34992,4356,30636,30636,0,9,4728000.0
4728,4728999,22.343023431218157,39.67839862602932,0.04711822883044803,795.2134258747101,309.413348197937,1095.092643737793,35025,4356,30669,30669,0,9,4729000.0
4729,4729999,22.342518764783307,39.6790379469215,0.04710847777168692,795.3368806838989,309.47640800476074,1095.8634796142578,35044,4356,30688,30688,0,9,4730000.0
4730,4730999,22.3421255925205,39.67910851786699,0.047095743279405244,795.4697785377502,309.54270243644714,1096.2248344421387,35048,4356,30692,30692,0,9,4731000.0
4731,4731999,22.342191221125344,39.67962231839549,0.047085377891814995,795.5907909870148,309.60540533065796,1096.5655364990234,35049,4356,30693,30693,0,9,4732000.0
4732,4732999,22.34221967009654,39.68033866307202,0.04707742665250758,795.8576591014862,309.66871452331543,1096.7023391723633,35059,4358,30701,30701,0,9,4733000.0
4733,4733999,22.341715358213538,39.67953217707394,0.04706347660999277,796.063782453537,309.7327399253845,1096.9443664550781,35068,4359,30709,30709,0,9,4734000.0
4734,4734999,22.34129628674826,39.67908055504087,0.047059637304658675,796.1887164115906,309.79761028289795,1097.24418258667,35069,4359,30710,30710,0,9,4735000.0
4735,4735999,22.340725496415402,39.67811030121698,0.047059419040831774,796.4882438182831,309.8653953075409,1097.431224822998,35084,4361,30723,30723,0,9,4736000.0
4736,4736999,22.340563900498015,39.67766507236129,0.04706703490757924,796.6926512718201,309.9285590648651,1097.7602844238281,35090,4362,30728,30728,0,9,4737000.0
4737,4737999,22.34071617137034,39.67790385478618,0.04706196329005308,796.8127694129944,309.99099946022034,1098.0392799377441,35091,4362,30729,30729,0,9,4738000.0
4738,4738999,22.340782791692828,39.67723518141307,0.047061514284603145,796.9408891201019,310.05301547050476,1098.3279762268066,35093,4362,30731,30731,0,9,4739000.0
4739,4739999,22.341243717150295,39.67703773091902,0.04706144975978033,797.3866319656372,310.11858010292053,1098.504566192627,35127,4366,30761,30761,0,9,4740000.0
4740,4740999,22.341562199743244,39.67686092898041,0.0470635901958264,797.6565065383911,310.18132734298706,1098.7902336120605,35137,4368,30769,30769,0,9,4741000.0
4741,4741999,22.3425333458301,39.67802509469099,0.04708206554503147,797.775910615921,310.24431347846985,1099.0405921936035,35137,4368,30769,30769,0,9,4742000.0
4742,4742999,22.344422625895035,39.681315296564314,0.04708349504545761,797.9942650794983,310.31009316444397,1099.246753692627,35146,4369,30777,30777,0,9,4743000.0
4743,4743999,22.346102430903287,39.68303664831643,0.04707860045333889,798.1115393638611,310.3720717430115,1099.7349700927734,35152,4369,30783,30783,0,9,4744000.0
4744,4744999,22.347461121562723,39.684664841562984,0.04708429104580536,798.2995023727417,310.4339325428009,1099.9490509033203,35155,4370,30785,30785,0,9,4745000.0
4745,4745999,22.349218629952343,39.68788958214994,0.04706641396820921,798.5854167938232,310.49645948410034,1100.198631286621,35169,4372,30797,30797,0,9,4746000.0
4746,4746999,22.349518858865093,39.690304300588494,0.04705161548811232,798.7091317176819,310.559033870697,1101.0404739379883,35195,4372,30823,30823,0,9,4747000.0
4747,4747999,22.348252675219232,39.68891841414059,0.04706218697592779,799.049708366394,310.62058544158936,1101.5047607421875,35233,4375,30858,30858,0,9,4748000.0
4748,4748999,22.34680316990545,39.68621877677207,0.047073246833941984,799.2469923496246,310.68520522117615,1101.9442253112793,35254,4376,30878,30878,0,9,4749000.0
4749,4749999,22.34554267025768,39.684579991870145,0.04707991205575868,799.3638143539429,310.7468726634979,1102.2425498962402,35256,4376,30880,30880,0,9,4750000.0
4750,4750999,22.344428107472375,39.68237156795539,0.04707891313336798,799.4901540279388,310.80947947502136,1102.6570358276367,35260,4376,30884,30884,0,9,4751000.0
4751,4751999,22.34347765177219,39.68061147354543,0.04707664600199113,799.6889176368713,310.87204599380493,1102.9676513671875,35264,4377,30887,30887,0,9,4752000.0
4752,4752999,22.342194978703088,39.67783797632268,0.04708104599991403,799.9629657268524,310.93442583084106,1103.088077545166,35276,4379,30897,30897,0,9,4753000.0
4753,4753999,22.340994949116606,39.67553759206564,0.047080072290485386,800.0864584445953,310.99706387519836,1103.4766426086426,35278,4379,30899,30899,0,9,4754000.0
4754,4754999,22.33995781600085,39.67342045855659,0.047072747943377236,800.450620174408,311.0602412223816,1103.7578086853027,35292,4382,30910,30910,0,9,4755000.0
4755,4755999,22.33896085509051,39.67117550548429,0.04706187621265068,800.6482343673706,311.12239170074463,1104.064842224121,35296,4383,30913,30913,0,9,4756000.0
4756,4756999,22.3387722616299,39.670099947719436,0.04703987498990847,800.843088388443,311.18485927581787,1104.3902168273926,35305,4384,30921,30921,0,9,4757000.0
4757,4757999,22.338732722776626,39.669076267290464,0.047022881750452106,801.1279449462891,311.24807476997375,1104.6255912780762,35311,4386,30925,30925,0,9,4758000.0
4758,4758999,22.338710398806274,39.667717250612775,0.04700270834783726,801.4112193584442,311.3109486103058,1104.833812713623,35315,4388,30927,30927,0,9,4759000.0
4759,4759999,22.339760769884176,39.66811864710776,0.046985860585693984,801.6059594154358,311.37359380722046,1105.0749320983887,35323,4389,30934,30934,0,9,4760000.0
4760,4760999,22.341149766184635,39.67006872859452,0.04696717269814754,801.816618680954,311.4362177848816,1105.3338737487793,35327,4390,30937,30937,0,9,4761000.0
4761,4761999,22.34253611861947,39.67060505861338,0.0469476531952846,801.9523453712463,311.5007185935974,1105.5626182556152,35328,4390,30938,30938,0,9,4762000.0
4762,4762999,22.344303097646556,39.67369438488558,0.04692606109765041,802.231303691864,311.56322860717773,1105.7880554199219,35350,4392,30958,30958,0,9,4763000.0
4763,4763999,22.34541713831218,39.67403453821879,0.04693230867007958,802.3573608398438,311.6254389286041,1106.170310974121,35355,4392,30963,30963,0,9,4764000.0
4764,4764999,22.345984497726,39.673053345830915,0.04693385087717583,802.5616099834442,311.6874406337738,1106.4060897827148,35367,4393,30974,30974,0,9,4765000.0
4765,4765999,22.346446456610153,39.672013833022795,0.046928207509461806,802.6884229183197,311.75031542778015,1106.8723754882812,35373,4393,30980,30980,0,9,4766000.0
4766,4766999,22.346752912646053,39.674677116477035,0.046919660939288343,802.8824145793915,311.81255865097046,1107.448184967041,35400,4394,31006,31006,0,9,4767000.0
4767,4767999,22.345144663318237,39.672144694154646,0.04692423109839927,803.0176727771759,311.883718252182,1107.8611679077148,35408,4394,31014,31014,0,9,4768000.0
4768,4768999,22.34369539962921,39.669554374675144,0.04693042164539751,803.1416356563568,311.948096036911,1108.144214630127,35410,4394,31016,31016,0,9,4769000.0
4769,4769999,22.342498245356,39.66714657391541,0.046932647971087316,803.2756016254425,312.0120270252228,1108.419189453125,35415,4394,31021,31021,0,9,4770000.0
4770,4770999,22.34135274583315,39.664915329113384,0.046936192227385876,803.3944470882416,312.0734486579895,1108.6276550292969,35415,4394,31021,31021,0,9,4771000.0
4771,4771999,22.3403754482701,39.662416875535506,0.04693693354331574,803.670378446579,312.1354491710663,1108.7067680358887,35440,4396,31044,31044,0,9,4772000.0
4772,4772999,22.339249672928748,39.66022171823625,0.04693952418304481,803.8764531612396,312.1978509426117,1108.8198051452637,35448,4397,31051,31051,0,9,4773000.0
4773,4773999,22.338157051924966,39.657836424870204,0.04694116372303603,804.1573634147644,312.2607500553131,1108.8767433166504,35457,4399,31058,31058,0,9,4774000.0
4774,4774999,22.33755279736785,39.656291232583946,0.0469369414832802,804.592871427536,312.3248245716095,1108.9499397277832,35510,4403,31107,31107,0,9,4775000.0
4775,4775999,22.336676926062417,39.654214628896526,0.04693486447836215,804.8646943569183,312.38546323776245,1108.9818153381348,35514,4405,31109,31109,0,9,4776000.0
4776,4776999,22.335666768915438,39.651719621054085,0.04693251000276888,805.1332297325134,312.44593119621277,1109.06791305542,35518,4407,31111,31111,0,9,4777000.0
4777,4777999,22.335091914995015,39.649771942491164,0.04693634124048829,805.3339121341705,312.50859904289246,1109.2810859680176,35529,4408,31121,31121,0,9,4778000.0
4778,4778999,22.334249776056687,39.6474239894389,0.04692994343086798,805.6298408508301,312.57411646842957,1109.2651176452637,35550,4410,31140,31140,0,9,4779000.0
4779,4779999,22.333788846560278,39.646014225735634,0.04692335227981814,805.9121634960175,312.6381320953369,1109.3215560913086,35554,4412,31142,31142,0,9,4780000.0
4780,4780999,22.333663513094947,39.64447615372721,0.04691517856607619,806.114001750946,312.6999671459198,1109.446304321289,35562,4413,31149,31149,0,9,4781000.0
4781,4781999,22.33333775599288,39.642926131796564,0.04691889730587662,806.2403135299683,312.7602860927582,1109.571762084961,35562,4413,31149,31149,0,9,4782000.0
4782,4782999,22.333855848584626,39.64215523678502,0.046899080927827574,806.5279026031494,312.82296419143677,1109.6474723815918,35573,4415,31158,31158,0,9,4783000.0
4783,4783999,22.33435494579251,39.641517809598696,0.04688218326628646,806.7270205020905,312.88543486595154,1109.8672676086426,35587,4416,31171,31171,0,9,4784000.0
4784,4784999,22.33516847662235,39.64152911393538,0.046857119013373194,806.8529026508331,312.94823002815247,1109.99222946167,35587,4416,31171,31171,0,9,4785000.0
4785,4785999,22.335357911408902,39.64051202776653,0.04683990968885765,806.9697182178497,313.00963950157166,1110.2648162841797,35589,4416,31173,31173,0,9,4786000.0
4786,4786999,22.335696658883776,39.63920141125666,0.0468221727162339,807.1812870502472,313.07136392593384,1110.467514038086,35599,4417,31182,31182,0,9,4787000.0
4787,4787999,22.33538936417626,39.640848816486994,0.04680402226327929,807.3104109764099,313.13339853286743,1110.729419708252,35600,4417,31183,31183,0,9,4788000.0
4788,4788999,22.334254066531056,39.63961731180992,0.04680616934497517,807.5893087387085,313.1955900192261,1111.1131134033203,35626,4419,31207,31207,0,9,4789000.0
4789,4789999,22.332532045736833,39.63647341863742,0.04682029022308987,807.7202212810516,313.25822257995605,1111.4594688415527,35631,4419,31212,31212,0,9,4790000.0
4790,4790999,22.33120293660341,39.63465668312521,0.046826799033736766,807.9967083930969,313.3203670978546,1111.575382232666,35664,4421,31243,31243,0,9,4791000.0
4791,4791999,22.32991797599955,39.631885033402696,0.04683798554074403,808.1921534538269,313.38279008865356,1111.7986907958984,35671,4422,31249,31249,0,9,4792000.0
4792,4792999,22.32868540926768,39.62944384742568,0.046847839746632314,808.3976140022278,313.4446861743927,1111.9074096679688,35677,4423,31254,31254,0,9,4793000.0
4793,4793999,22.327511344437504,39.627203316842795,0.04685340484196432,808.5295741558075,313.50967478752136,1112.0687522888184,35678,4423,31255,31255,0,9,4794000.0
4794,4794999,22.32616109135955,39.62445887410842,0.04686104697073479,808.7410750389099,313.5739197731018,1112.165054321289,35685,4424,31261,31261,0,9,4795000.0
4795,4795999,22.324897628408085,39.621686434878725,0.04686552190772242,808.9445974826813,313.63699436187744,1112.3001136779785,35691,4425,31266,31266,0,9,4796000.0
4796,4796999,22.32368951391563,39.61901173778024,0.04687197514898522,809.1536004543304,313.6996433734894,1112.4720649719238,35701,4426,31275,31275,0,9,4797000.0
4797,4797999,22.322565796032702,39.61671748307572,0.04687607312406805,809.2763087749481,313.7642686367035,1112.6737976074219,35702,4426,31276,31276,0,9,4798000.0
4798,4798999,22.321689391620538,39.61426029417309,0.04687699573255377,809.4770338535309,313.82621455192566,1112.7897987365723,35712,4427,31285,31285,0,9,4799000.0
4799,4799999,22.320839098352433,39.61188613808154,0.04687432337728692,809.7585070133209,313.8884029388428,1112.8242645263672,35718,4429,31289,31289,0,9,4800000.0
4800,4800999,22.320163026344332,39.60996408719944,0.04686778220132948,810.0521149635315,313.95243287086487,1112.8521575927734,35733,4431,31302,31302,0,9,4801000.0
4801,4801999,22.319723693344514,39.60824814240247,0.04686159942697199,810.179253578186,314.01454877853394,1113.0263595581055,35735,4431,31304,31304,0,9,4802000.0
4802,4802999,22.319536892603967,39.606613263673246,0.04686115128226154,810.4598140716553,314.07726883888245,1113.1198997497559,35765,4433,31332,31332,0,9,4803000.0
4803,4803999,22.319520342222727,39.60483607830302,0.04685531977542856,810.5880343914032,314.1402792930603,1113.2268524169922,35766,4433,31333,31333,0,9,4804000.0
4804,4804999,22.319384440677606,39.60298577244159,0.046848807408881865,810.7807402610779,314.2032971382141,1113.4007759094238,35771,4434,31337,31337,0,9,4805000.0
4805,4805999,22.319615041123075,39.60309653429288,0.046832270070637616,810.9986774921417,314.26534938812256,1113.551586151123,35774,4435,31339,31339,0,9,4806000.0
4806,4806999,22.319307864184957,39.6009963274137,0.046824764632562355,811.1214394569397,314.3274259567261,1113.7412109375,35776,4435,31341,31341,0,9,4807000.0
4807,4807999,22.31887930649089,39.59882623414063,0.04681476679616825,811.2389314174652,314.38853216171265,1113.9532928466797,35778,4435,31343,31343,0,9,4808000.0
4808,4808999,22.31847988103031,39.59860176621492,0.046806417065879624,811.438223361969,314.45083260536194,1114.2691612243652,35813,4436,31377,31377,0,9,4809000.0
4809,4809999,22.317137730071178,39.59649970163967,0.04680975719090119,811.7306113243103,314.5161383152008,1114.576717376709,35845,4438,31407,31407,0,9,4810000.0
4810,4810999,22.31578049266031,39.593815011947434,0.04681188817258708,812.016768693924,314.58067512512207,1114.778408050537,35857,4440,31417,31417,0,9,4811000.0
4811,4811999,22.31479197788848,39.592933683848635,0.046816191533479046,812.3792688846588,314.64370942115784,1114.835594177246,35899,4443,31456,31456,0,9,4812000.0
4812,4812999,22.313718071929237,39.59062268201949,0.046812133043688475,812.5772273540497,314.7060627937317,1114.961009979248,35906,4444,31462,31462,0,9,4813000.0
4813,4813999,22.31262117518934,39.58844873906921,0.046810181729635914,812.6947059631348,314.76796412467957,1115.1440124511719,35907,4444,31463,31463,0,9,4814000.0
4814,4814999,22.31152377282551,39.586528817436296,0.04680906712589694,812.9754087924957,314.8308176994324,1115.2164154052734,35912,4446,31466,31466,0,9,4815000.0
4815,4815999,22.310421514244727,39.58411784967004,0.04680817579134944,813.2693874835968,314.89474630355835,1115.2481727600098,35926,4448,31478,31478,0,9,4816000.0
4816,4816999,22.309235210824585,39.581540700994005,0.04681312548804306,813.472532749176,314.95664143562317,1115.3816261291504,35929,4449,31480,31480,0,9,4817000.0
4817,4817999,22.308323871508584,39.57944461856918,0.04680769410166963,813.9097480773926,315.01948285102844,1115.3921089172363,35948,4453,31495,31495,0,9,4818000.0
4818,4818999,22.307846441682532,39.577732814319496,0.04679676331558835,814.1935384273529,315.0816400051117,1115.5097045898438,35962,4455,31507,31507,0,9,4819000.0
4819,4819999,22.307725927729855,39.57657577881923,0.04678015411894165,814.4730570316315,315.14581084251404,1115.6542472839355,35976,4457,31519,31519,0,9,4820000.0
4820,4820999,22.309011994122194,39.578035607273975,0.04678417480504915,814.6863813400269,315.21251225471497,1115.7393836975098,35983,4458,31525,31525,0,9,4821000.0
4821,4821999,22.310925770845063,39.57991032537107,0.04678873714145315,814.8894052505493,315.27531027793884,1115.8623695373535,35990,4459,31531,31531,0,9,4822000.0
4822,4822999,22.313277425259056,39.582741873257575,0.04681400356950671,815.0952525138855,315.3375289440155,1116.0092582702637,35996,4460,31536,31536,0,9,4823000.0
4823,4823999,22.315610107202524,39.58506976549496,0.04682951946769209,815.2092227935791,315.3988218307495,1116.1905097961426,35997,4460,31537,31537,0,9,4824000.0
4824,4824999,22.318212617614925,39.58770277143518,0.04685073209703905,815.582067489624,315.46177792549133,1116.2435607910156,36020,4463,31557,31557,0,9,4825000.0
4825,4825999,22.320461240574367,39.589368115431434,0.04686570443448279,815.9353258609772,315.5240087509155,1116.2928314208984,36042,4466,31576,31576,0,9,4826000.0
4826,4826999,22.322766910665848,39.59159881685442,0.04687865122624246,816.1346583366394,315.58599519729614,1116.4902267456055,36047,4467,31580,31580,0,9,4827000.0
4827,4827999,22.324671275654463,39.59397265470854,0.046887570685138824,816.2673561573029,315.65071296691895,1116.695167541504,36050,4467,31583,31583,0,9,4828000.0
4828,4828999,22.32596709675592,39.59419411767347,0.04689938628704382,816.3907623291016,315.71278190612793,1116.9009475708008,36050,4467,31583,31583,0,9,4829000.0
4829,4829999,22.32544308693443,39.59265207185376,0.046906542881695934,816.6697146892548,315.7744870185852,1117.2219848632812,36074,4469,31605,31605,0,9,4830000.0
4830,4830999,22.323893591587293,39.58986762212502,0.046913065578081614,816.977255821228,315.8451945781708,1117.5935096740723,36112,4471,31641,31641,0,9,4831000.0
4831,4831999,22.32248100903572,39.58732306124293,0.04691520285114792,817.3471245765686,315.9083652496338,1117.786708831787,36132,4474,31658,31658,0,9,4832000.0
4832,4832999,22.321279111509046,39.58502674436312,0.046916397278693345,817.5641915798187,315.9707820415497,1117.9912223815918,36138,4475,31663,31663,0,9,4833000.0
4833,4833999,22.320280210769376,39.58356459993494,0.046915963598548216,817.7642555236816,316.0337679386139,1118.1296424865723,36145,4476,31669,31669,0,9,4834000.0
4834,4834999,22.319086297359444,39.581301106233624,0.046914201294781965,817.8956072330475,316.0960638523102,1118.3178901672363,36145,4476,31669,31669,0,9,4835000.0
4835,4835999,22.31790673085005,39.57888434133846,0.04691523679908183,818.0353093147278,316.16525745391846,1118.5313415527344,36145,4476,31669,31669,0,9,4836000.0
4836,4836999,22.316720710274186,39.57671303974725,0.04691312300299211,818.2505574226379,316.2296054363251,1118.6437187194824,36158,4477,31681,31681,0,9,4837000.0
4837,4837999,22.315682409537114,39.57454582620574,0.046915625692083185,818.5460290908813,316.296267747879,1118.806167602539,36174,4479,31695,31695,0,9,4838000.0
4838,4838999,22.314674441495026,39.57191848053221,0.046914070686741915,818.7560629844666,316.3584337234497,1119.0040130615234,36176,4480,31696,31696,0,9,4839000.0
4839,4839999,22.313941937876056,39.570524898607886,0.046909517709528115,819.0298879146576,316.42091608047485,1119.0582389831543,36187,4482,31705,31705,0,9,4840000.0
4840,4840999,22.31330169700039,39.5685436248532,0.04690616394577418,819.1597909927368,316.4827663898468,1119.2911224365234,36189,4482,31707,31707,0,9,4841000.0
4841,4841999,22.31349784567658,39.56977460003879,0.046908230235206516,819.5247461795807,316.54524993896484,1119.330654144287,36205,4485,31720,31720,0,9,4842000.0
4842,4842999,22.31425989403506,39.57129112549085,0.046939603840156496,819.6489226818085,316.60913729667664,1119.5097999572754,36205,4485,31720,31720,0,9,4843000.0
4843,4843999,22.315652481801628,39.572930190867865,0.046972348864193214,819.7745320796967,316.6705992221832,1119.8414115905762,36209,4485,31724,31724,0,9,4844000.0
4844,4844999,22.31757146752161,39.57536639450264,0.04700812980384883,819.8991897106171,316.73481726646423,1120.102767944336,36211,4485,31726,31726,0,9,4845000.0
4845,4845999,22.320690719070722,39.58460182650726,0.04703257062440669,820.1282773017883,316.7994294166565,1120.3319282531738,36215,4486,31729,31729,0,9,4846000.0
4846,4846999,22.323017657351713,39.58764434575423,0.04706343223147491,820.478789806366,316.8620147705078,1120.4966659545898,36238,4489,31749,31749,0,9,4847000.0
4847,4847999,22.32502513039565,39.58993004269379,0.047085717041380204,820.6044170856476,316.9251160621643,1120.7682876586914,36240,4489,31751,31751,0,9,4848000.0
4848,4848999,22.327503797261446,39.59257259789081,0.04711393504123429,820.8825011253357,316.98602628707886,1120.910099029541,36264,4491,31773,31773,0,9,4849000.0
4849,4849999,22.329018705743483,39.59480889121285,0.04712694939169826,821.0882115364075,317.0499155521393,1121.091510772705,36274,4492,31782,31782,0,9,4850000.0
4850,4850999,22.32892418540858,39.59457783843657,0.04713325111373812,821.2925055027008,317.11220121383667,1121.4388809204102,36281,4493,31788,31788,0,9,4851000.0
4851,4851999,22.3275895407024,39.59230728966761,0.047138334814232685,821.4267284870148,317.18294310569763,1121.823989868164,36291,4493,31798,31798,0,9,4852000.0
4852,4852999,22.326260801998746,39.59028234840084,0.047140096852814284,821.6383221149445,317.244868516922,1122.018913269043,36305,4494,31811,31811,0,9,4853000.0
4853,4853999,22.325216750881022,39.58913435029435,0.047138702075649075,821.8465266227722,317.30972838401794,1122.1885414123535,36320,4495,31825,31825,0,9,4854000.0
4854,4854999,22.323959655703458,39.58712776860823,0.047141518856773645,821.966694355011,317.3710708618164,1122.341781616211,36320,4495,31825,31825,0,9,4855000.0
4855,4855999,22.322754139378485,39.585089613062614,0.047142167603667184,822.1766321659088,317.43286538124084,1122.5016288757324,36322,4496,31826,31826,0,9,4856000.0
4856,4856999,22.32147170488388,39.582732045958195,0.04714216385299663,822.3004293441772,317.4948034286499,1122.6847114562988,36322,4496,31826,31826,0,9,4857000.0
4857,4857999,22.32032188753738,39.58124262094564,0.04714310672773736,822.5836160182953,317.55626678466797,1122.7738494873047,36352,4498,31854,31854,0,9,4858000.0
4858,4858999,22.319272472650578,39.579444759761444,0.04714211284868641,822.8746917247772,317.61951899528503,1122.8617095947266,36370,4500,31870,31870,0,9,4859000.0
4859,4859999,22.318079476137672,39.576848977915205,0.04714700313209741,823.0024933815002,317.68125343322754,1123.1338272094727,36373,4500,31873,31873,0,9,4860000.0
4860,4860999,22.317402150636898,39.57558456880568,0.047150339384047,823.135279417038,317.7425525188446,1123.2900505065918,36374,4500,31874,31874,0,9,4861000.0
4861,4861999,22.31668586192138,39.574276168406705,0.047141563972752154,823.3411371707916,317.8044958114624,1123.488193511963,36379,4501,31878,31878,0,9,4862000.0
4862,4862999,22.316569781481693,39.57372069020785,0.04715114551364086,823.4660675525665,317.86679005622864,1123.6546363830566,36379,4501,31878,31878,0,9,4863000.0
4863,4863999,22.316463873513623,39.57301969295142,0.047150847171308574,823.6009502410889,317.92784810066223,1123.7915267944336,36379,4501,31878,31878,0,9,4864000.0
4864,4864999,22.316662623585827,39.57236475320351,0.047163372469255616,823.9737775325775,317.98977732658386,1123.8235473632812,36385,4504,31881,31881,0,9,4865000.0
4865,4865999,22.317655636648716,39.57333982611141,0.04717555617204028,824.2690029144287,318.0519845485687,1124.0041389465332,36402,4506,31896,31896,0,9,4866000.0
4866,4866999,22.31885188400099,39.5742611466037,0.047177237640324,824.6453204154968,318.11429715156555,1124.1326599121094,36412,4509,31903,31903,0,9,4867000.0
4867,4867999,22.32029601120036,39.57548910151819,0.04718837984069335,824.8566191196442,318.17792892456055,1124.3515625,36415,4510,31905,31905,0,9,4868000.0
4868,4868999,22.321674417732247,39.5766928419377,0.047191573843089585,824.9800081253052,318.23989272117615,1124.5656509399414,36416,4510,31906,31906,0,9,4869000.0
4869,4869999,22.32289728153832,39.57748161163784,0.047195677341876685,825.2647001743317,318.3001937866211,1124.709186553955,36444,4512,31932,31932,0,9,4870000.0
4870,4870999,22.323883521470258,39.57774683563519,0.04719815248438053,825.4694755077362,318.36172819137573,1124.9044723510742,36448,4513,31935,31935,0,9,4871000.0
4871,4871999,22.3239696468906,39.57688746579854,0.04719924801270203,825.5922713279724,318.4230852127075,1125.443286895752,36463,4513,31950,31950,0,9,4872000.0
4872,4872999,22.323175150021225,39.57519374235805,0.047193666172253845,825.797753572464,318.4867835044861,1126.2261657714844,36515,4514,32001,32001,0,9,4873000.0
4873,4873999,22.322277512541497,39.57597805530458,0.04719633290604175,825.9250843524933,318.54963541030884,1126.7849655151367,36531,4514,32017,32017,0,9,4874000.0
4874,4874999,22.321714682657586,39.57660766392488,0.047192671901551075,826.1289985179901,318.61233353614807,1127.120491027832,36543,4515,32028,32028,0,9,4875000.0
4875,4875999,22.32099137412471,39.58149720798479,0.04717841432039649,826.2443633079529,318.67262983322144,1127.5460243225098,36554,4515,32039,32039,0,9,4876000.0
4876,4876999,22.320381485162564,39.581431942429724,0.04717169475495586,826.3633768558502,318.73430585861206,1127.8105545043945,36555,4515,32040,32040,0,9,4877000.0
4877,4877999,22.319213196726427,39.578547553029075,0.047170845112950444,826.5699515342712,318.7968204021454,1128.0824508666992,36561,4516,32045,32045,0,9,4878000.0
4878,4878999,22.318240990825135,39.57602028794626,0.047171251878151965,826.7701284885406,318.89235162734985,1128.3384971618652,36573,4517,32056,32056,0,9,4879000.0
4879,4879999,22.317335132601276,39.57345239083777,0.04716778986323222,826.9689328670502,318.95390462875366,1128.5720863342285,36584,4518,32066,32066,0,9,4880000.0
4880,4880999,22.31655531461947,39.57115566120667,0.04716041368520263,827.1699194908142,319.0175955295563,1128.750400543213,36589,4519,32070,32070,0,9,4881000.0
4881,4881999,22.316228508247242,39.57149310555607,0.047142019210667074,827.2935898303986,319.0824863910675,1129.0415153503418,36591,4519,32072,32072,0,9,4882000.0
4882,4882999,22.316080256350567,39.56951004612591,0.047129417652293726,827.8135116100311,319.14473247528076,1129.004795074463,36612,4524,32088,32088,0,9,4883000.0
4883,4883999,22.316077699238928,39.56841407254028,0.047109086407815304,828.1782619953156,319.2085347175598,1129.042221069336,36626,4527,32099,32099,0,9,4884000.0
4884,4884999,22.31620794283268,39.567095528898285,0.04708994945031053,828.3017637729645,319.27410984039307,1129.3396072387695,36627,4527,32100,32100,0,9,4885000.0
4885,4885999,22.3166163670789,39.56570389353588,0.047062699780970774,828.4249730110168,319.33559560775757,1129.6507453918457,36630,4527,32103,32103,0,9,4886000.0
4886,4886999,22.31730499084594,39.564517428387745,0.04702773414058814,828.5553224086761,319.39684653282166,1129.9850845336914,36635,4527,32108,32108,0,9,4887000.0
4887,4887999,22.317454897418553,39.56271816629358,0.04700933935190066,828.6775932312012,319.45640301704407,1130.3471450805664,36642,4527,32115,32115,0,9,4888000.0
4888,4888999,22.317535485856272,39.56185246761237,0.046992832004939755,828.8943448066711,319.52019810676575,1130.91312789917,36673,4528,32145,32145,0,9,4889000.0
4889,4889999,22.317128072208547,39.56311848261325,0.04696359222447266,829.0908298492432,319.58274936676025,1131.6312828063965,36699,4529,32170,32170,0,9,4890000.0
4890,4890999,22.31639999437664,39.56164288414438,0.04697742382703918,829.2107899188995,319.64480233192444,1132.0850563049316,36708,4529,32179,32179,0,9,4891000.0
4891,4891999,22.31558101906742,39.56023220752583,0.046990319369782374,829.3295056819916,319.70711159706116,1132.4239654541016,36711,4529,32182,32182,0,9,4892000.0
4892,4892999,22.31442824179112,39.55742993080973,0.047012808863229893,829.4624352455139,319.7703158855438,1132.8115005493164,36720,4529,32191,32191,0,9,4893000.0
4893,4893999,22.313113213342874,39.554450087960596,0.04702998651131862,829.6642837524414,319.8316009044647,1133.0089149475098,36724,4530,32194,32194,0,9,4894000.0
4894,4894999,22.31221514982839,39.55214669440719,0.04703842214314857,829.7857265472412,319.8939609527588,1133.2890167236328,36727,4530,32197,32197,0,9,4895000.0
4895,4895999,22.31132500784829,39.54998745598783,0.04704588330752524,830.1575865745544,319.95594358444214,1133.361427307129,36740,4533,32207,32207,0,9,4896000.0
4896,4896999,22.310435984354108,39.547762137738324,0.047054329618988366,830.4493999481201,320.0180103778839,1133.470947265625,36756,4535,32221,32221,0,9,4897000.0
4897,4897999,22.309940478700447,39.54607033338798,0.04704998708935093,830.6510589122772,320.07856249809265,1133.600254058838,36759,4536,32223,32223,0,9,4898000.0
4898,4898999,22.30941735733094,39.54394677561067,0.04704987931539428,830.9552962779999,320.1434328556061,1133.8129692077637,36778,4538,32240,32240,0,9,4899000.0
4899,4899999,22.308919871430675,39.54164799501448,0.047052357443413295,831.0734972953796,320.20434165000916,1134.0550231933594,36780,4538,32242,32242,0,9,4900000.0
4900,4900999,22.308471098595753,39.539576703056106,0.04705403372379491,831.1900062561035,320.2650611400604,1134.2486114501953,36782,4538,32244,32244,0,9,4901000.0
4901,4901999,22.308423900170254,39.537917148308786,0.047055521077859486,831.4726929664612,320.3272635936737,1134.3499717712402,36799,4540,32259,32259,0,9,4902000.0
4902,4902999,22.308371456456257,39.535977415731544,0.04704991317736673,831.5898509025574,320.3878827095032,1134.6219520568848,36802,4540,32262,32262,0,9,4903000.0
4903,4903999,22.30772630258027,39.533608490692984,0.04705401570727075,831.8678131103516,320.4492371082306,1134.7845497131348,36810,4542,32268,32268,0,9,4904000.0
4904,4904999,22.30765382588638,39.53206477843814,0.04705300671314849,832.0675654411316,320.51107692718506,1135.0277824401855,36816,4543,32273,32273,0,9,4905000.0
4905,4905999,22.30698405423634,39.53034038544977,0.04705738763310052,832.2050786018372,320.5737805366516,1135.7236709594727,36838,4543,32295,32295,0,9,4906000.0
4906,4906999,22.30584986091629,39.52805868076509,0.04706474267835903,832.3359446525574,320.6385614871979,1136.1674308776855,36845,4543,32302,32302,0,9,4907000.0
4907,4907999,22.305270333278454,39.52850576861496,0.04707572076134314,832.4591212272644,320.70069313049316,1136.4777717590332,36852,4543,32309,32309,0,9,4908000.0
4908,4908999,22.304516815194475,39.526792588259475,0.047087490646590124,832.7432930469513,320.76271748542786,1136.7393417358398,36864,4545,32319,32319,0,9,4909000.0
4909,4909999,22.303601891853337,39.524259955506594,0.04709818144405564,833.0194654464722,320.8245632648468,1136.841464996338,36870,4547,32323,32323,0,9,4910000.0
4910,4910999,22.302612870993233,39.521934318460374,0.047106502110816795,833.3272912502289,320.8881206512451,1137.0599098205566,36883,4549,32334,32334,0,9,4911000.0
4911,4911999,22.301570323083464,39.51972332283213,0.047117362302100174,833.5427117347717,320.94982981681824,1137.174186706543,36890,4550,32340,32340,0,9,4912000.0
4912,4912999,22.300824990574082,39.51818753215629,0.04711243664588982,833.7554590702057,321.0119936466217,1137.364917755127,36897,4551,32346,32346,0,9,4913000.0
4913,4913999,22.300121210805,39.51696137184518,0.047113163592139684,833.9658868312836,321.0740704536438,1137.4892082214355,36901,4552,32349,32349,0,9,4914000.0
4914,4914999,22.299733384358905,39.51599512329234,0.04711234415094523,834.2515077590942,321.1364393234253,1137.5847244262695,36905,4554,32351,32351,0,9,4915000.0
4915,4915999,22.299448175937147,39.51468883934825,0.04710574677392321,834.4547960758209,321.19843006134033,1137.8418273925781,36922,4555,32367,32367,0,9,4916000.0
4916,4916999,22.299506330976254,39.51385930664599,0.04709955617510053,834.657794713974,321.25996923446655,1138.0102882385254,36926,4556,32370,32370,0,9,4917000.0
4917,4917999,22.299295740104668,39.51283839542737,0.04709361910109089,834.8553419113159,321.32119846343994,1138.1586265563965,36928,4557,32371,32371,0,9,4918000.0
4918,4918999,22.299812822997502,39.51284525606791,0.04707683616536806,834.9767985343933,321.3831169605255,1138.3697776794434,36931,4557,32374,32374,0,9,4919000.0
4919,4919999,22.299881213869533,39.51164355353866,0.04706326891555057,835.1859204769135,321.44604873657227,1138.480899810791,36934,4558,32376,32376,0,9,4920000.0
4920,4920999,22.300437030829503,39.512752331480606,0.047049456422151525,835.4720203876495,321.50781512260437,1138.6347770690918,36959,4560,32399,32399,0,9,4921000.0
4921,4921999,22.300826210795464,39.51211659527669,0.04703521184621684,835.6845486164093,321.5708487033844,1138.7578315734863,36964,4561,32403,32403,0,9,4922000.0
4922,4922999,22.30097567982399,39.511125113289125,0.04702544251369656,835.8241777420044,321.63294315338135,1138.9864692687988,36966,4561,32405,32405,0,9,4923000.0
4923,4923999,22.300997935928933,39.50966610210891,0.0470130459731517,836.0319232940674,321.6948232650757,1139.1516418457031,36975,4562,32413,32413,0,9,4924000.0
4924,4924999,22.301226547487047,39.5087593651386,0.04700349760061229,836.1622679233551,321.7587707042694,1139.3525848388672,36977,4562,32415,32415,0,9,4925000.0
4925,4925999,22.30034888690488,39.50638532225571,0.0470009153243518,836.2913112640381,321.81992506980896,1139.7549476623535,36988,4562,32426,32426,0,9,4926000.0
4926,4926999,22.298813309478582,39.50459182557684,0.04700626970110977,836.5054557323456,321.88472270965576,1140.235782623291,37013,4563,32450,32450,0,9,4927000.0
4927,4927999,22.296965369800684,39.50153906867062,0.04701640193330903,836.7858278751373,321.9463412761688,1140.4450492858887,37025,4565,32460,32460,0,9,4928000.0
4928,4928999,22.295334327263543,39.499101904893436,0.04702535511391759,836.992858171463,322.00836086273193,1140.60258102417,37028,4566,32462,32462,0,9,4929000.0
4929,4929999,22.293800338773018,39.49628139097174,0.04703944568492047,837.2057690620422,322.0736620426178,1140.680606842041,37037,4567,32470,32470,0,9,4930000.0
4930,4930999,22.29215578557197,39.49330754569834,0.047050274726953,837.3255972862244,322.1347625255585,1140.8838195800781,37037,4567,32470,32470,0,9,4931000.0
4931,4931999,22.290904961395857,39.49104579340967,0.04705731934625679,837.4528450965881,322.19682097435,1141.074234008789,37038,4567,32471,32471,0,9,4932000.0
4932,4932999,22.28966082585369,39.48853563946523,0.04706143394925866,837.8302960395813,322.2601969242096,1141.0896606445312,37047,4570,32477,32477,0,9,4933000.0
4933,4933999,22.28813645327809,39.486113763469284,0.047071139103633475,838.1174957752228,322.3223023414612,1141.171760559082,37064,4572,32492,32492,0,9,4934000.0
4934,4934999,22.28696321298098,39.4839433912863,0.0470752133798269,838.2454135417938,322.3837058544159,1141.3823547363281,37067,4572,32495,32495,0,9,4935000.0
4935,4935999,22.286027859960488,39.48170097898796,0.04708001418786689,838.4633793830872,322.4458589553833,1141.4412231445312,37076,4573,32503,32503,0,9,4936000.0
4936,4936999,22.285004841691148,39.479505388571376,0.04708309962491819,838.7465078830719,322.5084011554718,1141.54008102417,37093,4575,32518,32518,0,9,4937000.0
4937,4937999,22.28420045396745,39.47732895300066,0.047084549825940014,838.8723750114441,322.5694577693939,1141.7053871154785,37095,4575,32520,32520,0,9,4938000.0
4938,4938999,22.283486500648465,39.47562625557331,0.047081384122628744,839.0789256095886,322.6334912776947,1141.8194313049316,37104,4576,32528,32528,0,9,4939000.0
4939,4939999,22.283093826564475,39.47393316142044,0.04707504449437905,839.2052602767944,322.69737243652344,1142.036491394043,37106,4576,32530,32530,0,9,4940000.0
4940,4940999,22.282457065728707,39.47214576131529,0.04707176331264595,839.4955055713654,322.7589068412781,1142.1035690307617,37138,4578,32560,32560,0,9,4941000.0
4941,4941999,22.282211164787498,39.47055698325249,0.047061886595039404,839.7927205562592,322.820481300354,1142.159267425537,37155,4580,32575,32575,0,9,4942000.0
4942,4942999,22.2818970295316,39.46868125270501,0.047054444254779004,840.2482271194458,322.88241696357727,1142.0579261779785,37175,4584,32591,32591,0,9,4943000.0
4943,4943999,22.281835000418514,39.4674742662983,0.047048948835080484,840.4619235992432,322.94549322128296,1142.2474403381348,37183,4585,32598,32598,0,9,4944000.0
4944,4944999,22.281675760497805,39.466371862833,0.04704065030809723,840.674497127533,323.0073239803314,1142.3715896606445,37187,4586,32601,32601,0,9,4945000.0
4945,4945999,22.281320814376354,39.46460107856118,0.04703114501737804,840.7988612651825,323.06803727149963,1142.6443176269531,37189,4586,32603,32603,0,9,4946000.0
4946,4946999,22.280319137847776,39.46315407590772,0.04702889297777246,841.0052380561829,323.13009214401245,1143.1569938659668,37214,4587,32627,32627,0,9,4947000.0
4947,4947999,22.279414838615608,39.46170577072897,0.04702793118702686,841.1327962875366,323.1928782463074,1143.6180038452148,37226,4587,32639,32639,0,9,4948000.0
4948,4948999,22.278221851011534,39.45939486344944,0.047027999834417744,841.4114096164703,323.25565123558044,1143.8934326171875,37250,4589,32661,32661,0,9,4949000.0
4949,4949999,22.277042130763203,39.45700602867515,0.047037633346588836,841.5375466346741,323.31780219078064,1144.196922302246,37253,4589,32664,32664,0,9,4950000.0
4950,4950999,22.27610341851339,39.4549916052409,0.04704086348949987,841.6626183986664,323.38135600090027,1144.420093536377,37256,4589,32667,32667,0,9,4951000.0
4951,4951999,22.27489718776261,39.4523558538544,0.047045409017654416,841.80260014534,323.44601225852966,1144.632999420166,37256,4589,32667,32667,0,9,4952000.0
4952,4952999,22.273928815336927,39.45021833860722,0.0470524819325675,842.0077261924744,323.50768208503723,1144.8097534179688,37262,4590,32672,32672,0,9,4953000.0
4953,4953999,22.273018644465072,39.44792386486635,0.04705298074827846,842.1218154430389,323.5684747695923,1145.0149116516113,37264,4590,32674,32674,0,9,4954000.0
4954,4954999,22.27248573974939,39.45220369701527,0.047034792050643204,842.2486698627472,323.63206601142883,1145.129955291748,37264,4590,32674,32674,0,9,4955000.0
4955,4955999,22.271451148589954,39.44992827847988,0.047033569206179515,842.5424780845642,323.69506311416626,1145.2536659240723,37270,4592,32678,32678,0,9,4956000.0
4956,4956999,22.27072806816043,39.44825229912955,0.04702870647372637,842.6603515148163,323.7560737133026,1145.406566619873,37270,4592,32678,32678,0,9,4957000.0
4957,4957999,22.270013092205417,39.44611238092394,0.047023182120668805,842.7863776683807,323.81682682037354,1145.6223602294922,37272,4592,32680,32680,0,9,4958000.0
4958,4958999,22.26923941037827,39.44386136817352,0.047018172701892236,842.9857714176178,323.8776729106903,1145.7163887023926,37277,4593,32684,32684,0,9,4959000.0
4959,4959999,22.268523656514105,39.441867235931305,0.04701323544153424,843.2106199264526,323.9387378692627,1145.7779998779297,37296,4594,32702,32702,0,9,4960000.0
4960,4960999,22.267919871936293,39.4395550976887,0.0470105084005612,843.4193623065948,324.0002384185791,1145.867332458496,37298,4595,32703,32703,0,9,4961000.0
4961,4961999,22.26759872337961,39.437577411204856,0.04699964186294492,843.6161417961121,324.0613327026367,1146.0943069458008,37302,4596,32706,32706,0,9,4962000.0
4962,4962999,22.267340409633555,39.435667757067016,0.04699406164704567,843.7546150684357,324.12250423431396,1146.3545303344727,37305,4596,32709,32709,0,9,4963000.0
4963,4963999,22.267302033356973,39.4342970760212,0.046989969422661204,843.9681091308594,324.18391823768616,1146.4608421325684,37313,4597,32716,32716,0,9,4964000.0
4964,4964999,22.26691530946332,39.43241119299028,0.04698573254877747,844.1704747676849,324.24645161628723,1146.597469329834,37316,4598,32718,32718,0,9,4965000.0
4965,4965999,22.266339989026953,39.430142266151954,0.046978767319123094,844.2919161319733,324.3106813430786,1146.7620849609375,37317,4598,32719,32719,0,9,4966000.0
4966,4966999,22.265514719466456,39.427757037258175,0.04697539758937619,844.4142434597015,324.37185406684875,1147.0106735229492,37319,4598,32721,32721,0,9,4967000.0
4967,4967999,22.264179181493912,39.426765051096545,0.04698146240914991,844.5352356433868,324.4343569278717,1148.107250213623,37360,4598,32762,32762,0,9,4968000.0
4968,4968999,22.262558809938266,39.42515652945991,0.04698580540991426,844.6570146083832,324.4991765022278,1148.5771827697754,37367,4598,32769,32769,0,9,4969000.0
4969,4969999,22.26077677207247,39.422308171048996,0.046995108672311936,844.8597333431244,324.56379985809326,1148.800853729248,37387,4599,32788,32788,0,9,4970000.0
4970,4970999,22.25904437303808,39.419227343812075,0.04701102614393127,844.9883522987366,324.6282768249512,1149.092529296875,37388,4599,32789,32789,0,9,4971000.0
4971,4971999,22.257472445707727,39.416559392015316,0.047021350741304646,845.1964597702026,324.6902873516083,1149.247501373291,37396,4600,32796,32796,0,9,4972000.0
4972,4972999,22.25608340989742,39.413915389962646,0.04703044446482396,845.410237789154,324.75443863868713,1149.4069557189941,37405,4601,32804,32804,0,9,4973000.0
4973,4973999,22.254637342377833,39.41139069982259,0.04703725854880103,845.6115465164185,324.8162269592285,1149.667007446289,37422,4602,32820,32820,0,9,4974000.0
4974,4974999,22.253029232479292,39.408434402548004,0.04704431515491314,845.8161957263947,324.8791534900665,1149.922103881836,37433,4603,32830,32830,0,9,4975000.0
4975,4975999,22.25146541376718,39.40574856159804,0.04705208846935416,846.1033434867859,324.9419367313385,1150.0586471557617,37458,4605,32853,32853,0,9,4976000.0
4976,4976999,22.250072269696613,39.4035492264519,0.04705517721685515,846.394611120224,325.00552225112915,1150.4460220336914,37481,4607,32874,32874,0,9,4977000.0
4977,4977999,22.24903428219317,39.40130319122753,0.04705319919347861,846.5931794643402,325.0676188468933,1150.740348815918,37488,4608,32880,32880,0,9,4978000.0
4978,4978999,22.24791270468148,39.39872273962827,0.04704958858590136,846.8024308681488,325.13136529922485,1150.9600715637207,37497,4609,32888,32888,0,9,4979000.0
4979,4979999,22.246889523432785,39.39648906246535,0.04704840715696201,847.0020930767059,325.19327306747437,1151.1997833251953,37502,4610,32892,32892,0,9,4980000.0
4980,4980999,22.24623967421605,39.39492642722589,0.04704069436786129,847.2913858890533,325.2557578086853,1151.51664352417,37535,4612,32923,32923,0,9,4981000.0
4981,4981999,22.24616591605099,39.39470131685977,0.04702688715081915,847.5704998970032,325.3189024925232,1151.7787017822266,37547,4614,32933,32933,0,9,4982000.0
4982,4982999,22.246248774747098,39.39400210982389,0.04701313331326873,847.86172747612,325.3816375732422,1152.1302947998047,37562,4616,32946,32946,0,9,4983000.0
4983,4983999,22.24681664601122,39.394205982260885,0.04700743347114755,848.0664439201355,325.44512391090393,1152.4306526184082,37574,4617,32957,32957,0,9,4984000.0
4984,4984999,22.247501426889457,39.394288828507854,0.04700360544147841,848.268004655838,325.508136510849,1152.6530838012695,37582,4618,32964,32964,0,9,4985000.0
4985,4985999,22.24791954491942,39.393831973858354,0.04699300388141492,848.5508744716644,325.5701148509979,1152.876033782959,37604,4620,32984,32984,0,9,4986000.0
4986,4986999,22.24824999746574,39.3932062543223,0.046992654997248695,848.7566981315613,325.6340272426605,1153.2037620544434,37613,4621,32992,32992,0,9,4987000.0
4987,4987999,22.247984548227866,39.39273965670582,0.04698893348597566,848.8728404045105,325.6952471733093,1153.5463104248047,37613,4621,32992,32992,0,9,4988000.0
4988,4988999,22.246585863288704,39.39074018217906,0.046994445409473506,849.1690242290497,325.7579641342163,1154.2858238220215,37652,4623,33029,33029,0,9,4989000.0
4989,4989999,22.24455925106113,39.38752669754095,0.04701081414516506,849.2983205318451,325.8232638835907,1154.7145805358887,37660,4623,33037,33037,0,9,4990000.0
4990,4990999,22.243002048164985,39.385770195277615,0.04701933677071202,849.4145686626434,325.88453221321106,1154.909049987793,37660,4623,33037,33037,0,9,4991000.0
4991,4991999,22.241664581942302,39.38309058511925,0.0470300831593512,849.5284624099731,325.94582748413086,1155.2244491577148,37662,4623,33039,33039,0,9,4992000.0
4992,4992999,22.2403702354229,39.3809272900849,0.04703451352347432,849.6513366699219,326.0069808959961,1155.4226112365723,37663,4623,33040,33040,0,9,4993000.0
4993,4993999,22.239359355663133,39.379113235657634,0.0470421175790684,849.8554933071136,326.06962513923645,1155.5989799499512,37665,4624,33041,33041,0,9,4994000.0
4994,4994999,22.23849890316705,39.377292081704425,0.04704756177444103,850.0646011829376,326.13144850730896,1155.7897491455078,37692,4625,33067,33067,0,9,4995000.0
4995,4995999,22.237613938445335,39.37563108237437,0.0470553691686012,850.2734565734863,326.19288992881775,1155.9495010375977,37701,4626,33075,33075,0,9,4996000.0
4996,4996999,22.236996856319003,39.37415082717013,0.047063027216157516,850.5693316459656,326.25490164756775,1156.0464210510254,37707,4628,33079,33079,0,9,4997000.0
4997,4997999,22.23650540200681,39.37303980068599,0.04706801484376444,850.9406328201294,326.3167154788971,1156.179100036621,37715,4631,33084,33084,0,9,4998000.0
4998,4998999,22.236345252539962,39.37248617582198,0.04707470589256224,851.0556797981262,326.37835335731506,1156.510871887207,37717,4631,33086,33086,0,9,4999000.0
4999,4999999,22.23626895349928,39.37201093313165,0.047082971268552765,851.3499903678894,326.4406313896179,1156.6458358764648,37723,4633,33090,33090,0,9,5000000.0
5000,5000999,22.236185268583693,39.371364465316184,0.04709122926746345,851.5664892196655,326.5035057067871,1156.7980346679688,37730,4634,33096,33096,0,9,5001000.0
5001,5001999,22.236334130251795,39.37118461081447,0.04710354800988814,851.8020339012146,326.57245683670044,1156.8832473754883,37732,4635,33097,33097,0,9,5002000.0
5002,5002999,22.236799676414925,39.37136291546824,0.0471171558255985,851.9184203147888,326.6332492828369,1157.0218505859375,37732,4635,33097,33097,0,9,5003000.0
5003,5003999,22.23725084106281,39.3727622534315,0.04711556817069085,852.0415146350861,326.6948616504669,1157.208408355713,37733,4635,33098,33098,0,9,5004000.0
5004,5004999,22.237862201594194,39.373112316283404,0.04711208099311304,852.3351023197174,326.75666308403015,1157.3183708190918,37738,4637,33101,33101,0,9,5005000.0
5005,5005999,22.23835547004974,39.37254157591912,0.04711561508885942,852.4704694747925,326.8187692165375,1157.5130310058594,37739,4637,33102,33102,0,9,5006000.0
5006,5006999,22.238475898009607,39.371756359513704,0.04711750833648509,852.6799380779266,326.8799092769623,1157.6372985839844,37742,4638,33104,33104,0,9,5007000.0
5007,5007999,22.238368325243744,39.37043433963172,0.047124701013350756,852.8741345405579,326.94122862815857,1157.758358001709,37751,4639,33112,33112,0,9,5008000.0
5008,5008999,22.237760140007868,39.36869820596084,0.04713260838432565,852.9929294586182,327.0019781589508,1158.0640487670898,37757,4639,33118,33118,0,9,5009000.0
5009,5009999,22.2364249759169,39.36619959362647,0.04714259242836438,853.1238164901733,327.0652813911438,1158.9047164916992,37786,4639,33147,33147,0,9,5010000.0
5010,5010999,22.23525880202127,39.36463994156307,0.04714961390256067,853.5685737133026,327.1277012825012,1159.0510292053223,37821,4643,33178,33178,0,9,5011000.0
5011,5011999,22.233727735259045,39.36175335385193,0.04716772556064297,853.6904437541962,327.18941855430603,1159.386734008789,37823,4643,33180,33180,0,9,5012000.0
5012,5012999,22.232874828020694,39.360717730436356,0.04716787885351392,853.983639717102,327.25264501571655,1159.5929985046387,37842,4645,33197,33197,0,9,5013000.0
5013,5013999,22.23163757926134,39.35858332825542,0.047180176229848825,854.1093139648438,327.3139748573303,1159.8097229003906,37842,4645,33197,33197,0,9,5014000.0
5014,5014999,22.230567574788715,39.35647458100439,0.04718876082245205,854.2289361953735,327.37848830223083,1160.0338897705078,37843,4645,33198,33198,0,9,5015000.0
5015,5015999,22.22973735450302,39.35432491410647,0.047192467615902234,854.4398312568665,327.4397962093353,1160.2380485534668,37851,4646,33205,33205,0,9,5016000.0
5016,5016999,22.2286553530733,39.351852144795906,0.04719808467430764,854.5714786052704,327.5014581680298,1160.4942893981934,37851,4646,33205,33205,0,9,5017000.0
5017,5017999,22.228273257885,39.357424388297275,0.04717753996916074,854.864333152771,327.56359481811523,1160.5561180114746,37856,4648,33208,33208,0,9,5018000.0
5018,5018999,22.22761755204174,39.35533168610012,0.04717252170313224,855.1635196208954,327.62611532211304,1160.6923561096191,37862,4650,33212,33212,0,9,5019000.0
5019,5019999,22.226843634408215,39.3528592558211,0.04717476312928637,855.3766746520996,327.69217920303345,1160.93212890625,37871,4651,33220,33220,0,9,5020000.0
5020,5020999,22.2264126379616,39.35348475592336,0.04716778634668861,855.5926537513733,327.7545440196991,1161.0921745300293,37880,4652,33228,33228,0,9,5021000.0
5021,5021999,22.226034724592576,39.3516533693963,0.04716394672137825,855.7111866474152,327.8161551952362,1161.2856178283691,37881,4652,33229,33229,0,9,5022000.0
5022,5022999,22.22578281679157,39.3498791015587,0.04715840238493196,855.8258712291718,327.8768792152405,1161.4690170288086,37881,4652,33229,33229,0,9,5023000.0
5023,5023999,22.22576134481329,39.34817903829706,0.0471465007278109,856.1144330501556,327.9391531944275,1161.6135597229004,37899,4654,33245,33245,0,9,5024000.0
5024,5024999,22.225482269309317,39.34687142859183,0.04714187630882616,856.4071533679962,328.0018696784973,1161.8407936096191,37918,4656,33262,33262,0,9,5025000.0
5025,5025999,22.225227332771414,39.345124036239426,0.047130497005782424,856.6178641319275,328.06400775909424,1162.2092819213867,37928,4657,33271,33271,0,9,5026000.0
5026,5026999,22.223913791387506,39.34341754583651,0.04713793292447821,856.8249611854553,328.1276376247406,1163.0990257263184,37964,4658,33306,33306,0,9,5027000.0
5027,5027999,22.22235870762947,39.3407223874416,0.047153496985196885,857.0336894989014,328.19056224823,1163.4736251831055,37981,4659,33322,33322,0,9,5028000.0
5028,5028999,22.221109407333195,39.338563931158795,0.047161023631104415,857.1572597026825,328.25245666503906,1163.791748046875,37983,4659,33324,33324,0,9,5029000.0
5029,5029999,22.220005142339016,39.33707945032441,0.047172948040541396,857.5445590019226,328.31731700897217,1163.8397064208984,38018,4662,33356,33356,0,9,5030000.0
5030,5030999,22.218737245519375,39.33513637289227,0.04718044769294594,857.6670627593994,328.37930560112,1164.0660018920898,38018,4662,33356,33356,0,9,5031000.0
5031,5031999,22.217812934093036,39.33395451340092,0.047186997552024046,857.8790593147278,328.4429075717926,1164.3643951416016,38029,4663,33366,33366,0,9,5032000.0
5032,5032999,22.216771619090558,39.332278554518226,0.04719049311825774,858.0029337406158,328.50457191467285,1164.6451034545898,38031,4663,33368,33368,0,9,5033000.0
5033,5033999,22.2157317810437,39.330349036096294,0.047189393558367154,858.2194890975952,328.5665695667267,1164.8647232055664,38054,4664,33390,33390,0,9,5034000.0
5034,5034999,22.2149576418181,39.32845520560765,0.0471899126413472,858.4200584888458,328.62838411331177,1165.0363464355469,38062,4665,33397,33397,0,9,5035000.0
5035,5035999,22.214698837802448,39.32800031283252,0.04718440758465137,858.5465364456177,328.6901869773865,1165.3170127868652,38064,4665,33399,33399,0,9,5036000.0
5036,5036999,22.21480313554618,39.32815434692291,0.047183980719077256,858.8374192714691,328.75325894355774,1165.4355354309082,38080,4667,33413,33413,0,9,5037000.0
5037,5037999,22.21499379105032,39.32788286842392,0.04718441197804979,859.053156375885,328.81635308265686,1165.7149238586426,38086,4668,33418,33418,0,9,5038000.0
5038,5038999,22.215313580775597,39.32758744039278,0.04718790682482732,859.1823134422302,328.87988781929016,1166.0042991638184,38087,4668,33419,33419,0,9,5039000.0
5039,5039999,22.21554652458027,39.32723177328747,0.047186689320343644,859.3931906223297,328.9417507648468,1166.1548309326172,38089,4669,33420,33420,0,9,5040000.0
5040,5040999,22.21615230338165,39.32870487774931,0.0471716011727662,859.7692906856537,329.00479435920715,1166.3855895996094,38130,4672,33458,33458,0,9,5041000.0
5041,5041999,22.21636356114173,39.32820265319866,0.04716462363563001,860.0540051460266,329.0674216747284,1166.8640251159668,38146,4674,33472,33472,0,9,5042000.0
5042,5042999,22.21663799738318,39.32767681881136,0.047165800387385604,860.2585532665253,329.12961745262146,1167.1122436523438,38155,4675,33480,33480,0,9,5043000.0
5043,5043999,22.216651719105762,39.32634802243081,0.047157802611559996,860.4706087112427,329.1936538219452,1167.392677307129,38160,4676,33484,33484,0,9,5044000.0
5044,5044999,22.216699411989616,39.32501946321929,0.0471481309141869,860.6716721057892,329.2560193538666,1167.7552299499512,38173,4677,33496,33496,0,9,5045000.0
5045,5045999,22.216107951511123,39.32353608507845,0.04715183592279193,860.8734436035156,329.3200387954712,1168.5145378112793,38198,4678,33520,33520,0,9,5046000.0
5046,5046999,22.214642020159932,39.32126552810965,0.04715743853897958,860.9955689907074,329.38430404663086,1169.133430480957,38212,4678,33534,33534,0,9,5047000.0
5047,5047999,22.214046514239143,39.32250705324067,0.04716085070440312,861.1993606090546,329.44718194007874,1169.454948425293,38232,4679,33553,33553,0,9,5048000.0
5048,5048999,22.213559655223218,39.32263445853977,0.04716949896107847,861.3240602016449,329.512793302536,1169.8598442077637,38238,4679,33559,33559,0,9,5049000.0
5049,5049999,22.213379684191423,39.32291154579266,0.04716716225469386,861.7013411521912,329.57575273513794,1169.9697227478027,38276,4682,33594,33594,0,9,5050000.0
5050,5050999,22.214180806819297,39.33175068791689,0.04715433572895189,861.9069128036499,329.6390027999878,1170.1813468933105,38292,4683,33609,33609,0,9,5051000.0
5051,5051999,22.21418588873166,39.33263390653457,0.04714930835757147,862.2003877162933,329.70159792900085,1170.4078216552734,38311,4685,33626,33626,0,9,5052000.0
5052,5052999,22.214332630301357,39.33370760697175,0.04715268413741314,862.404360294342,329.7637119293213,1170.7195358276367,38322,4686,33636,33636,0,9,5053000.0
5053,5053999,22.215318599764196,39.33720640667237,0.04714405227130347,862.6910789012909,329.82707047462463,1170.8480758666992,38341,4688,33653,33653,0,9,5054000.0
5054,5054999,22.216072371980005,39.34404251824104,0.04712513478034175,863.0707855224609,329.88969707489014,1171.0704231262207,38361,4691,33670,33670,0,9,5055000.0
5055,5055999,22.216756994182536,39.34473653369975,0.04712402627710999,863.1946125030518,329.9520878791809,1171.3687705993652,38362,4691,33671,33671,0,9,5056000.0
5056,5056999,22.21725219687221,39.34541478616646,0.047129598954547824,863.4835600852966,330.0158450603485,1171.6003036499023,38381,4693,33688,33688,0,9,5057000.0
5057,5057999,22.21813569205125,39.34673435279004,0.04713557349653419,863.6896169185638,330.0780277252197,1171.8212585449219,38389,4694,33695,33695,0,9,5058000.0
5058,5058999,22.21862483617577,39.346634817607786,0.04714146716183054,864.1532938480377,330.1443440914154,1171.872314453125,38416,4698,33718,33718,0,9,5059000.0
5059,5059999,22.21962546525686,39.347412173930934,0.047137473492346205,864.2725479602814,330.20881962776184,1172.284610748291,38419,4698,33721,33721,0,9,5060000.0
5060,5060999,22.220679495874453,39.34828806782445,0.047140242835658874,864.4737179279327,330.27123260498047,1172.6956634521484,38432,4699,33733,33733,0,9,5061000.0
5061,5061999,22.22201061284483,39.349326606613054,0.04715160096501114,864.8465790748596,330.33394956588745,1172.8963432312012,38452,4702,33750,33750,0,9,5062000.0
5062,5062999,22.223302247918088,39.35029598329529,0.04716870702140852,865.147500038147,330.39629077911377,1173.0960998535156,38462,4704,33758,33758,0,9,5063000.0
5063,5063999,22.224407090897298,39.350774030276476,0.04718427967357075,865.4352140426636,330.4599051475525,1173.3697509765625,38480,4706,33774,33774,0,9,5064000.0
5064,5064999,22.225409161033323,39.35074527939879,0.047193060529354236,865.7995569705963,330.5223217010498,1173.5786781311035,38501,4709,33792,33792,0,9,5065000.0
5065,5065999,22.225518926904822,39.34988528477742,0.04719322123561098,866.0039813518524,330.58547258377075,1174.1379623413086,38524,4710,33814,33814,0,9,5066000.0
5066,5066999,22.2242179989803,39.34864738664486,0.047195021171029805,866.2212615013123,330.649311542511,1174.8390083312988,38567,4711,33856,33856,0,9,5067000.0
5067,5067999,22.222657289411963,39.346261755674924,0.047198455337767786,866.4234519004822,330.71162486076355,1175.2487983703613,38578,4712,33866,33866,0,9,5068000.0
5068,5068999,22.22120718765549,39.34465679822028,0.04721130413088748,866.6414730548859,330.7752718925476,1175.633285522461,38584,4713,33871,33871,0,9,5069000.0
5069,5069999,22.21985586576933,39.342145593414386,0.04721483399455284,866.7577905654907,330.83735752105713,1175.9870376586914,38585,4713,33872,33872,0,9,5070000.0
5070,5070999,22.21879110868856,39.33993645624887,0.04721317614117937,866.8753561973572,330.89939761161804,1176.2717018127441,38587,4713,33874,33874,0,9,5071000.0
5071,5071999,22.21776001971642,39.33785731270797,0.04721435353534864,867.1790955066681,330.96562576293945,1176.470371246338,38598,4715,33883,33883,0,9,5072000.0
5072,5072999,22.21721192219591,39.33719280894795,0.04721731479722224,867.309240102768,331.02767062187195,1176.7413368225098,38600,4715,33885,33885,0,9,5073000.0
5073,5073999,22.216946881272076,39.33673168864112,0.04723220723066446,867.4307055473328,331.0893189907074,1176.9584312438965,38600,4715,33885,33885,0,9,5074000.0
5074,5074999,22.217011841933306,39.33631089963176,0.047250603335928565,867.6454844474792,331.1519763469696,1177.2558212280273,38608,4716,33892,33892,0,9,5075000.0
5075,5075999,22.217227679014723,39.33643321729428,0.04725853591435314,867.9471881389618,331.21501660346985,1177.397144317627,38625,4718,33907,33907,0,9,5076000.0
5076,5076999,22.217676323770537,39.336997877197916,0.04726863121814129,868.3285899162292,331.2779667377472,1177.4716758728027,38644,4721,33923,33923,0,9,5077000.0
5077,5077999,22.218263331320887,39.33792574508956,0.047278396024793334,868.5353245735168,331.3413026332855,1177.664794921875,38648,4722,33926,33926,0,9,5078000.0
5078,5078999,22.21892496310637,39.33846868439312,0.047289981359533106,868.9199137687683,331.4051513671875,1177.707290649414,38675,4725,33950,33950,0,9,5079000.0
5079,5079999,22.219549992453842,39.338527590023055,0.047314334055434615,869.0458900928497,331.4696629047394,1178.0048904418945,38677,4725,33952,33952,0,9,5080000.0
5080,5080999,22.220678233938923,39.33902651713665,0.04733981626151851,869.1646695137024,331.53219199180603,1178.2673568725586,38678,4725,33953,33953,0,9,5081000.0
5081,5081999,22.22144379367991,39.3387184502031,0.047353614676237554,869.2929978370667,331.5941472053528,1178.5035095214844,38679,4725,33954,33954,0,9,5082000.0
5082,5082999,22.222307680552525,39.33858196749526,0.04736288970907743,869.4959309101105,331.65582728385925,1178.5971984863281,38687,4726,33961,33961,0,9,5083000.0
5083,5083999,22.22268756262187,39.337699095672825,0.047368427032568605,869.710666179657,331.7179419994354,1178.8139152526855,38704,4727,33977,33977,0,9,5084000.0
5084,5084999,22.223272499164068,39.336866118854765,0.04736851793965191,869.8402683734894,331.78313851356506,1179.1089706420898,38706,4727,33979,33979,0,9,5085000.0
5085,5085999,22.223305293559964,39.33597803683211,0.04735491944600234,870.0466072559357,331.8454670906067,1179.7210845947266,38735,4728,34007,34007,0,9,5086000.0
5086,5086999,22.222257881756025,39.336540857222886,0.04732706180965096,870.1673443317413,331.9081666469574,1180.3535346984863,38752,4728,34024,34024,0,9,5087000.0
5087,5087999,22.220542342278097,39.33364735092154,0.04733439809468776,870.4628746509552,331.97175669670105,1180.6740798950195,38769,4730,34039,34039,0,9,5088000.0
5088,5088999,22.21906835082688,39.33131367497503,0.047343158809494135,870.5833466053009,332.0339570045471,1180.9947547912598,38771,4730,34041,34041,0,9,5089000.0
5089,5089999,22.21763266887477,39.328798935404606,0.04735133753765264,870.7022988796234,332.0982117652893,1181.2261009216309,38771,4730,34041,34041,0,9,5090000.0
5090,5090999,22.216302612490853,39.326320891561565,0.04735678582419789,870.9992690086365,332.1621901988983,1181.366855621338,38788,4732,34056,34056,0,9,5091000.0
5091,5091999,22.21501388670111,39.323910577713775,0.0473593988519615,871.1296608448029,332.22492480278015,1181.592929840088,38788,4732,34056,34056,0,9,5092000.0
5092,5092999,22.213629020785824,39.321415638556566,0.0473645486305202,871.417512178421,332.287837266922,1181.876205444336,38808,4734,34074,34074,0,9,5093000.0
5093,5093999,22.21264784568094,39.319583914877256,0.047362307618661115,871.6185309886932,332.3504846096039,1182.1205558776855,38816,4735,34081,34081,0,9,5094000.0
5094,5094999,22.211710301999492,39.31762627156792,0.047362648153440046,872.0916974544525,332.41607189178467,1182.2201881408691,38840,4739,34101,34101,0,9,5095000.0
5095,5095999,22.211001772821184,39.31583872120163,0.04735983099745422,872.2220871448517,332.4805324077606,1182.4544410705566,38841,4739,34102,34102,0,9,5096000.0
5096,5096999,22.210128703097364,39.313579719043496,0.04735703746161024,872.3349709510803,332.54335284233093,1182.7792205810547,38843,4739,34104,34104,0,9,5097000.0
5097,5097999,22.209382870707724,39.31163747715603,0.047356256265336016,872.6256327629089,332.6053650379181,1182.8988189697266,38860,4741,34119,34119,0,9,5098000.0
5098,5098999,22.20877040264733,39.31006512104075,0.04735077268998922,872.9296162128448,332.66781973838806,1182.9470672607422,38876,4743,34133,34133,0,9,5099000.0
5099,5099999,22.208201892450408,39.30797485879276,0.04734659127390828,873.1385233402252,332.72995138168335,1183.158935546875,38886,4744,34142,34142,0,9,5100000.0
5100,5100999,22.207934724303815,39.30648669602005,0.04733486772709783,873.2628197669983,332.792542219162,1183.3581085205078,38886,4744,34142,34142,0,9,5101000.0
5101,5101999,22.207747168832984,39.30475531760747,0.04732313034884572,873.3952779769897,332.8542821407318,1183.5404891967773,38887,4744,34143,34143,0,9,5102000.0
5102,5102999,22.207767063111163,39.303624875955215,0.04731224486839947,873.5225265026093,332.9161500930786,1183.69722366333,38887,4744,34143,34143,0,9,5103000.0
5103,5103999,22.207255009618866,39.30140685134885,0.047299856709671184,873.7277994155884,332.97777700424194,1183.8364219665527,38893,4745,34148,34148,0,9,5104000.0
5104,5104999,22.207100971610675,39.29968419086327,0.047288865953279524,874.0177903175354,333.0417113304138,1183.8819999694824,38911,4747,34164,34164,0,9,5105000.0
5105,5105999,22.206790267384495,39.298270227514585,0.04727546473575572,874.1379640102386,333.103013753891,1184.112506866455,38911,4747,34164,34164,0,9,5106000.0
5106,5106999,22.20530185550397,39.295427072729055,0.047286995070190074,874.2663187980652,333.16631603240967,1185.12845993042,38947,4747,34200,34200,0,9,5107000.0
5107,5107999,22.203510621460172,39.29315782285779,0.047300034140208336,874.3860595226288,333.2298631668091,1185.653980255127,38958,4747,34211,34211,0,9,5108000.0
5108,5108999,22.201817395697365,39.2905334032945,0.04730292573236505,874.5173058509827,333.2935621738434,1185.9782218933105,38961,4747,34214,34214,0,9,5109000.0
5109,5109999,22.200180829330804,39.287869475335604,0.047312779035736496,874.8222863674164,333.3571126461029,1186.3691635131836,38989,4749,34240,34240,0,9,5110000.0
5110,5110999,22.198489253663098,39.28487820529594,0.04732060696721119,875.1174881458282,333.41975355148315,1186.6049575805664,38994,4751,34243,34243,0,9,5111000.0
5111,5111999,22.196889132278354,39.28200851962933,0.047324852119908556,875.2367973327637,333.4814832210541,1186.8559188842773,38994,4751,34243,34243,0,9,5112000.0
5112,5112999,22.195177725942933,39.279066854723055,0.047333848093248254,875.4546427726746,333.54456186294556,1187.1222953796387,39004,4752,34252,34252,0,9,5113000.0
5113,5113999,22.193610260031097,39.27671608319041,0.04734051741717715,875.5825879573822,333.6064693927765,1187.4731559753418,39008,4752,34256,34256,0,9,5114000.0
5114,5114999,22.192233693931183,39.27464709953935,0.04734327037813513,875.9899544715881,333.66912627220154,1187.524013519287,39033,4755,34278,34278,0,9,5115000.0
5115,5115999,22.190861609127424,39.27196033892076,0.04734873188168187,876.105465888977,333.73136591911316,1187.8546295166016,39035,4755,34280,34280,0,9,5116000.0
5116,5116999,22.189861050607863,39.270034525252065,0.04734836392840225,876.412661075592,333.79444789886475,1188.035099029541,39048,4757,34291,34291,0,9,5117000.0
5117,5117999,22.189700438155157,39.26924560155706,0.047341702780274275,876.6150162220001,333.8561191558838,1188.270320892334,39056,4758,34298,34298,0,9,5118000.0
5118,5118999,22.19006753952306,39.26868144187284,0.0473332158448454,876.7284259796143,333.91849279403687,1188.5324821472168,39058,4758,34300,34300,0,9,5119000.0
5119,5119999,22.191195291364952,39.27205714329985,0.0473200669817615,876.8628869056702,333.98054933547974,1188.7419929504395,39058,4758,34300,34300,0,9,5120000.0
5120,5120999,22.191734221455597,39.27254681514932,0.04732074127474717,876.9858202934265,334.0445258617401,1188.9282150268555,39059,4758,34301,34301,0,9,5121000.0
5121,5121999,22.192575160079016,39.2732128915732,0.047310581679383845,877.2033197879791,334.1069836616516,1189.1703071594238,39064,4759,34305,34305,0,9,5122000.0
5122,5122999,22.194046270329654,39.27479640392316,0.04730004312681846,877.4925100803375,334.169052362442,1189.3871765136719,39079,4761,34318,34318,0,9,5123000.0
5123,5123999,22.194923257841218,39.27539282709167,0.047291103757209685,877.7838070392609,334.23100757598877,1189.5205154418945,39089,4763,34326,34326,0,9,5124000.0
5124,5124999,22.19484983286357,39.27419134772033,0.04728481367313642,877.9020843505859,334.2923285961151,1189.876621246338,39093,4763,34330,34330,0,9,5125000.0
5125,5125999,22.195456979562152,39.273908910367794,0.04727841017603884,878.0166635513306,334.35359930992126,1190.1791305541992,39096,4763,34333,34333,0,9,5126000.0
5126,5126999,22.195764545212935,39.27337153654307,0.04728989125804672,878.1423218250275,334.41472125053406,1190.4188079833984,39097,4763,34334,34334,0,9,5127000.0
5127,5127999,22.19442527615809,39.27123163885834,0.047295247042936306,878.2672572135925,334.4777069091797,1191.3637428283691,39127,4763,34364,34364,0,9,5128000.0
5128,5128999,22.19291252538023,39.26906503739955,0.04729981648448833,878.4039540290833,334.54013776779175,1191.8062324523926,39134,4763,34371,34371,0,9,5129000.0
5129,5129999,22.19148041854365,39.26662229249341,0.047305520443762794,878.6159331798553,334.6025915145874,1191.9977645874023,39149,4764,34385,34385,0,9,5130000.0
5130,5130999,22.190186646315755,39.26493726028176,0.04731089941292721,878.7346143722534,334.66444993019104,1192.3580474853516,39153,4764,34389,34389,0,9,5131000.0
5131,5131999,22.189090227967657,39.26279338396756,0.047300953454779915,879.0452225208282,334.72988867759705,1192.4811820983887,39169,4766,34403,34403,0,9,5132000.0
5132,5132999,22.18808046667722,39.26098059128624,0.047298154747667076,879.4188573360443,334.7923653125763,1192.5758247375488,39179,4769,34410,34410,0,9,5133000.0
5133,5133999,22.186966444260722,39.258823968324464,0.047298370074434715,879.6252291202545,334.85279846191406,1192.837158203125,39190,4770,34420,34420,0,9,5134000.0
5134,5134999,22.18585754139959,39.25667071138236,0.04729817985203899,879.8246121406555,334.91494250297546,1193.137924194336,39195,4771,34424,34424,0,9,5135000.0
5135,5135999,22.184799656702474,39.25672107660793,0.04729553821507626,880.0385756492615,334.9773316383362,1193.2752227783203,39197,4772,34425,34425,0,9,5136000.0
5136,5136999,22.18409219301589,39.25534893881489,0.04729798719519851,880.2565495967865,335.0405902862549,1193.568416595459,39208,4773,34435,34435,0,9,5137000.0
5137,5137999,22.183809463795512,39.25474476574312,0.04730627729853254,880.3860363960266,335.1034240722656,1193.7762184143066,39209,4773,34436,34436,0,9,5138000.0
5138,5138999,22.183998166335016,39.25719495557945,0.04729968370653004,880.5912744998932,335.16441559791565,1193.7880172729492,39217,4774,34443,34443,0,9,5139000.0
5139,5139999,22.184886604256118,39.26115920741663,0.047300782115048734,880.8079435825348,335.22706031799316,1194.0838088989258,39230,4775,34455,34455,0,9,5140000.0
5140,5140999,22.186105054398016,39.26313510623583,0.04730645275516876,880.9299159049988,335.29023480415344,1194.2966423034668,39230,4775,34455,34455,0,9,5141000.0
5141,5141999,22.18775514100938,39.26614405831651,0.04731347932793861,881.2325458526611,335.3524703979492,1194.364372253418,39242,4777,34465,34465,0,9,5142000.0
5142,5142999,22.189561447682262,39.26888552870707,0.04734030451465787,881.441623210907,335.4143147468567,1194.7005004882812,39251,4778,34473,34473,0,9,5143000.0
5143,5143999,22.191861975374973,39.273345573612886,0.04737137638738653,881.6705377101898,335.4757630825043,1194.8840942382812,39259,4779,34480,34480,0,9,5144000.0
5144,5144999,22.19406861625274,39.277046714497985,0.04738272026075241,881.8822593688965,335.5425772666931,1194.998435974121,39268,4780,34488,34488,0,9,5145000.0
5145,5145999,22.195355663191627,39.27846560799559,0.04739400915104963,882.0057456493378,335.6066117286682,1195.1916999816895,39269,4780,34489,34489,0,9,5146000.0
5146,5146999,22.196940611366053,39.27995282987826,0.0474083037426728,882.2109577655792,335.6682062149048,1195.337703704834,39295,4781,34514,34514,0,9,5147000.0
5147,5147999,22.198599613492107,39.282461598638896,0.04742315451569379,882.3296139240265,335.7309396266937,1195.6693305969238,39301,4781,34520,34520,0,9,5148000.0
5148,5148999,22.197782544241004,39.28064921827883,0.04741373302384466,882.5371046066284,335.7951855659485,1196.72652053833,39339,4782,34557,34557,0,9,5149000.0
5149,5149999,22.19704077254161,39.279377456505024,0.04740273292021424,882.6581194400787,335.8603436946869,1197.2747383117676,39345,4782,34563,34563,0,9,5150000.0
5150,5150999,22.196094528671537,39.277294119609344,0.04740252925366306,882.7850065231323,335.9229564666748,1197.6118202209473,39346,4782,34564,34564,0,9,5151000.0
5151,5151999,22.19550109763947,39.27742255827572,0.04738972892003934,883.0015890598297,335.9887683391571,1197.83447265625,39350,4783,34567,34567,0,9,5152000.0
5152,5152999,22.194566352983955,39.278674795161194,0.047378363252856825,883.1269762516022,336.05098032951355,1198.0565376281738,39350,4783,34567,34567,0,9,5153000.0
5153,5153999,22.193498801757965,39.276122298302305,0.04737742198009032,883.3379628658295,336.1154627799988,1198.301383972168,39358,4784,34574,34574,0,9,5154000.0
5154,5154999,22.19283908394745,39.274432764118565,0.04736986405362398,883.5442938804626,336.17759251594543,1198.5541381835938,39367,4785,34582,34582,0,9,5155000.0
5155,5155999,22.19213604169525,39.27294915467642,0.04736199700966304,883.7579610347748,336.23939847946167,1198.7761840820312,39378,4786,34592,34592,0,9,5156000.0
5156,5156999,22.19147328107248,39.271188338939915,0.047356274549904875,884.051412820816,336.30227041244507,1198.918815612793,39388,4788,34600,34600,0,9,5157000.0
5157,5157999,22.191110978755503,39.26950922159803,0.047347374945503895,884.3429892063141,336.3643956184387,1199.0450057983398,39398,4790,34608,34608,0,9,5158000.0
5158,5158999,22.190962110901143,39.27018951307402,0.047328341398780616,884.4724056720734,336.4272086620331,1199.3017234802246,39400,4790,34610,34610,0,9,5159000.0
5159,5159999,22.190560701026094,39.26820387501447,0.04731828323031795,884.6759493350983,336.4899523258209,1199.4727210998535,39402,4791,34611,34611,0,9,5160000.0
5160,5160999,22.190577651470903,39.26686495831886,0.04730223322529037,884.9730839729309,336.5520706176758,1199.5884552001953,39413,4793,34620,34620,0,9,5161000.0
5161,5161999,22.190823376115222,39.26753788922361,0.0472764683226643,885.1828923225403,336.61372447013855,1199.8070068359375,39418,4794,34624,34624,0,9,5162000.0
5162,5162999,22.191031787338815,39.265977792439394,0.047252695868433836,885.3042252063751,336.67548060417175,1200.1044006347656,39420,4794,34626,34626,0,9,5163000.0
5163,5163999,22.19082485869084,39.26392751582386,0.04723880935162883,885.4173409938812,336.73679208755493,1200.3367729187012,39421,4794,34627,34627,0,9,5164000.0
5164,5164999,22.190723784799467,39.26296487320511,0.04721773154357345,885.540851354599,336.79894375801086,1200.6627769470215,39424,4794,34630,34630,0,9,5165000.0
5165,5165999,22.18967787967319,39.260451829861545,0.047210708769527265,885.6742746829987,336.8640739917755,1201.5556106567383,39451,4794,34657,34657,0,9,5166000.0
5166,5166999,22.18872387217078,39.25843067745382,0.047208155716216726,885.8820714950562,336.9263598918915,1201.8524017333984,39467,4795,34672,34672,0,9,5167000.0
5167,5167999,22.187982376815135,39.257359426762555,0.04719722705800533,886.0053734779358,336.9907569885254,1202.2061042785645,39469,4795,34674,34674,0,9,5168000.0
5168,5168999,22.187104137859336,39.254932566345204,0.047189905581615954,886.1219627857208,337.0532124042511,1202.4676322937012,39470,4795,34675,34675,0,9,5169000.0
5169,5169999,22.186389174256576,39.253186438325734,0.04718547169420806,886.4150404930115,337.11566829681396,1202.5733070373535,39490,4797,34693,34693,0,9,5170000.0
5170,5170999,22.185946736194605,39.251688891264195,0.047174051253683014,886.5400185585022,337.177738904953,1202.9471969604492,39494,4797,34697,34697,0,9,5171000.0
5171,5171999,22.18557271139792,39.251016472776705,0.04715979183534891,886.6740012168884,337.23951601982117,1203.150951385498,39494,4797,34697,34697,0,9,5172000.0
5172,5172999,22.18519116724357,39.24946827827797,0.047140615836847366,886.8793954849243,337.3014283180237,1203.3310508728027,39503,4798,34705,34705,0,9,5173000.0
5173,5173999,22.185169760184493,39.248630647017336,0.047116071811957316,887.0006635189056,337.36293840408325,1203.514980316162,39503,4798,34705,34705,0,9,5174000.0
5174,5174999,22.18498092447388,39.24715879965842,0.04709235332133199,887.1209490299225,337.4246106147766,1203.7783546447754,39504,4798,34706,34706,0,9,5175000.0
5175,5175999,22.185181417539948,39.246168536510666,0.047062412287423805,887.3332123756409,337.4874691963196,1203.9315071105957,39512,4799,34713,34713,0,9,5176000.0
5176,5176999,22.18566566168389,39.246146150885224,0.04703766737078108,887.6278040409088,337.5495104789734,1203.9145202636719,39530,4801,34729,34729,0,9,5177000.0
5177,5177999,22.186116123130404,39.245393891884476,0.04702012775500486,887.932023525238,337.6120767593384,1204.0879592895508,39555,4803,34752,34752,0,9,5178000.0
5178,5178999,22.1861462931207,39.24402222255146,0.046998745418221355,888.1486444473267,337.67451095581055,1204.1556968688965,39557,4804,34753,34753,0,9,5179000.0
5179,5179999,22.18703179210563,39.24393470217239,0.046964635814490396,888.4485428333282,337.73708415031433,1204.312297821045,39568,4806,34762,34762,0,9,5180000.0
5180,5180999,22.187313779968747,39.24275215708556,0.04693719287045095,888.7523670196533,337.80261397361755,1204.59663772583,39587,4808,34779,34779,0,9,5181000.0
5181,5181999,22.187601663794815,39.24152158098913,0.046906972934099955,889.0563943386078,337.8651361465454,1204.6938285827637,39609,4810,34799,34799,0,9,5182000.0
5182,5182999,22.18768705238403,39.24043714784347,0.046881698782840764,889.3581700325012,337.9283812046051,1205.0390548706055,39628,4812,34816,34816,0,9,5183000.0
5183,5183999,22.188246590536963,39.24303920144328,0.046845704579574154,889.4750034809113,337.99012184143066,1205.4302101135254,39631,4812,34819,34819,0,9,5184000.0
5184,5184999,22.188109433552526,39.24370847946659,0.04682427578208881,889.594340801239,338.0526657104492,1206.007438659668,39644,4812,34832,34832,0,9,5185000.0
5185,5185999,22.18718510667294,39.24207521942498,0.046815941321019516,889.7330181598663,338.1266369819641,1206.4773979187012,39656,4812,34844,34844,0,9,5186000.0
5186,5186999,22.185989929874104,39.240743220102125,0.046813070677211965,889.86541056633,338.18992805480957,1206.892967224121,39660,4812,34848,34848,0,9,5187000.0
5187,5187999,22.18500180922696,39.2398250064699,0.046811001599250224,889.9949798583984,338.25540566444397,1207.1921043395996,39662,4812,34850,34850,0,9,5188000.0
5188,5188999,22.184197487122535,39.23807438192909,0.04680566756186655,890.119332075119,338.3177182674408,1207.4061164855957,39664,4812,34852,34852,0,9,5189000.0
5189,5189999,22.183824411798902,39.23727700505533,0.04679252609842366,890.3473701477051,338.3803768157959,1207.541748046875,39683,4813,34870,34870,0,9,5190000.0
5190,5190999,22.183125366267838,39.235625151938095,0.046786460245841544,890.5620384216309,338.44315481185913,1207.7817993164062,39692,4814,34878,34878,0,9,5191000.0
5191,5191999,22.182491753710686,39.23387566808275,0.04677285470958714,890.7760565280914,338.50572752952576,1207.911994934082,39699,4815,34884,34884,0,9,5192000.0
5192,5192999,22.181739131922804,39.23181322700997,0.046764419786621714,890.9007294178009,338.56988310813904,1208.1829223632812,39702,4815,34887,34887,0,9,5193000.0
5193,5193999,22.181196342623082,39.23003311571955,0.046758435918618835,891.2157368659973,338.6331889629364,1208.3473281860352,39720,4817,34903,34903,0,9,5194000.0
5194,5194999,22.181074678019606,39.229605733319005,0.04674927207641699,891.340226650238,338.6944739818573,1208.565097808838,39720,4817,34903,34903,0,9,5195000.0
5195,5195999,22.180716242699223,39.22784009776825,0.04673498091522976,891.637841463089,338.7567253112793,1208.775405883789,39739,4819,34920,34920,0,9,5196000.0
5196,5196999,22.180611657552255,39.226737232596896,0.0467220174656644,891.8587713241577,338.8190727233887,1208.9357872009277,39754,4820,34934,34934,0,9,5197000.0
5197,5197999,22.18036971808094,39.22522159480107,0.046708865906912256,892.1855752468109,338.8844828605652,1209.0827903747559,39765,4822,34943,34943,0,9,5198000.0
5198,5198999,22.18048070965302,39.22654178435265,0.0466906372801259,892.3171226978302,338.9491546154022,1209.390338897705,39768,4822,34946,34946,0,9,5199000.0
5199,5199999,22.18027784563447,39.22489659335847,0.046674216781017575,892.4357349872589,339.0123896598816,1209.627571105957,39768,4822,34946,34946,0,9,5200000.0
5200,5200999,22.18005178782266,39.22323224416284,0.04665752953297442,892.6520960330963,339.07486867904663,1209.9199600219727,39774,4823,34951,34951,0,9,5201000.0
5201,5201999,22.180118094000598,39.222400667187834,0.04664413463486228,892.8627071380615,339.13705229759216,1210.222511291504,39779,4824,34955,34955,0,9,5202000.0
5202,5202999,22.179971048434382,39.220798132518674,0.046632274399224016,893.0746178627014,339.19903564453125,1210.397201538086,39787,4825,34962,34962,0,9,5203000.0
5203,5203999,22.17944080761402,39.21878795422009,0.04661702346409491,893.1922960281372,339.26026678085327,1210.6667556762695,39789,4825,34964,34964,0,9,5204000.0
5204,5204999,22.178781462595037,39.21665339923973,0.046604322274423016,893.3938629627228,339.32281374931335,1210.8882446289062,39800,4826,34974,34974,0,9,5205000.0
5205,5205999,22.178327768229636,39.214726218209066,0.04659549038481936,893.8682487010956,339.38537645339966,1211.324161529541,39831,4830,35001,35001,0,9,5206000.0
5206,5206999,22.177023637680342,39.212257533602596,0.046597836926069114,893.9989812374115,339.450398683548,1211.8264389038086,39842,4830,35012,35012,0,9,5207000.0
5207,5207999,22.175598853682683,39.209686564403505,0.04659909042838517,894.2110970020294,339.5129487514496,1212.129623413086,39851,4831,35020,35020,0,9,5208000.0
5208,5208999,22.174314141528026,39.207068693641574,0.04660450716991871,894.3463356494904,339.5791988372803,1212.427848815918,39855,4831,35024,35024,0,9,5209000.0
5209,5209999,22.173211297838165,39.20473538194253,0.04660308854399331,894.6409270763397,339.6418499946594,1212.5272750854492,39869,4833,35036,35036,0,9,5210000.0
5210,5210999,22.172388660674677,39.20372425316027,0.04659841900721473,894.85533452034,339.7041037082672,1212.7000350952148,39879,4834,35045,35045,0,9,5211000.0
5211,5211999,22.17121608805809,39.20127112484117,0.046600185904564384,895.0664639472961,339.7662889957428,1212.8532524108887,39895,4835,35060,35060,0,9,5212000.0
5212,5212999,22.170132538467374,39.19891543258333,0.04659873255144831,895.1990571022034,339.8305015563965,1213.1028861999512,39897,4835,35062,35062,0,9,5213000.0
5213,5213999,22.169378347736192,39.19675453523926,0.04659301911559821,895.4047677516937,339.8921890258789,1213.2499465942383,39906,4836,35070,35070,0,9,5214000.0
5214,5214999,22.16873712947968,39.19520740582196,0.04658833500987758,895.5270419120789,339.9565374851227,1213.5084114074707,39908,4836,35072,35072,0,9,5215000.0
5215,5215999,22.16814213099861,39.193499079645754,0.04658446594248822,895.6468176841736,340.0193541049957,1213.6742782592773,39909,4836,35073,35073,0,9,5216000.0
5216,5216999,22.167463607342146,39.191296829117576,0.04657465289447604,896.1375393867493,340.08303570747375,1213.6610298156738,39925,4840,35085,35085,0,9,5217000.0
5217,5217999,22.166918642998926,39.18913708145553,0.046564512485533616,896.3521947860718,340.1458668708801,1213.7946701049805,39927,4841,35086,35086,0,9,5218000.0
5218,5218999,22.166584425830354,39.18755456682148,0.046557136097449936,896.574450969696,340.2107503414154,1213.8375396728516,39929,4842,35087,35087,0,9,5219000.0
5219,5219999,22.16640680380615,39.186027852534586,0.046545625788651845,896.803252696991,340.276184797287,1214.0656852722168,39938,4843,35095,35095,0,9,5220000.0
5220,5220999,22.16649387167839,39.185395672537155,0.04653595976068203,897.0202524662018,340.34112787246704,1214.3428192138672,39952,4844,35108,35108,0,9,5221000.0
5221,5221999,22.16646138315839,39.18404010825063,0.04652398492572918,897.1436381340027,340.40551924705505,1214.6920356750488,39954,4844,35110,35110,0,9,5222000.0
5222,5222999,22.166524570420897,39.183067273656775,0.0465101161515038,897.6249513626099,340.46981143951416,1214.733943939209,39981,4848,35133,35133,0,9,5223000.0
5223,5223999,22.166356314420604,39.18274284769048,0.046496693058231564,897.9279401302338,340.5330400466919,1214.9334449768066,39988,4850,35138,35138,0,9,5224000.0
5224,5224999,22.16588831808654,39.18189335905959,0.04647898377155646,898.1421408653259,340.5949356555939,1215.184326171875,39993,4851,35142,35142,0,9,5225000.0
5225,5225999,22.165412066102935,39.17989071577651,0.04647168951456371,898.2746431827545,340.65790367126465,1215.7640266418457,40010,4851,35159,35159,0,9,5226000.0
5226,5226999,22.164406033244195,39.179054420964974,0.04646589003695034,898.482093334198,340.7206828594208,1216.3804893493652,40031,4852,35179,35179,0,9,5227000.0
5227,5227999,22.162890990787282,39.17643144749885,0.046471411772749605,898.6037549972534,340.78332567214966,1216.8236656188965,40040,4852,35188,35188,0,9,5228000.0
5228,5228999,22.161338582238198,39.17364862324908,0.04647558230536375,898.7274954319,340.8465769290924,1217.1149253845215,40040,4852,35188,35188,0,9,5229000.0
5229,5229999,22.160028586810036,39.17117992129089,0.046476628531217035,899.1199491024017,340.91094160079956,1217.1908493041992,40072,4855,35217,35217,0,9,5230000.0
5230,5230999,22.159019265358285,39.16934384505391,0.046476829928355445,899.4127058982849,340.9734354019165,1217.3842658996582,40112,4857,35255,35255,0,9,5231000.0
5231,5231999,22.157761158772335,39.16681137471609,0.046476578709128136,899.6186010837555,341.03675174713135,1217.6003150939941,40121,4858,35263,35263,0,9,5232000.0
5232,5232999,22.156753225821728,39.164953648814354,0.046472945534357546,900.092490196228,341.10028862953186,1217.7192611694336,40153,4862,35291,35291,0,9,5233000.0
5233,5233999,22.155863556499696,39.163274950230665,0.04646762443796637,900.2098393440247,341.16245341300964,1218.037998199463,40154,4862,35292,35292,0,9,5234000.0
5234,5234999,22.154888158922542,39.1609664243972,0.04646312258103913,900.335499048233,341.2251510620117,1218.305995941162,40156,4862,35294,35294,0,9,5235000.0
5235,5235999,22.15416405776122,39.15874498086153,0.04645597175139238,900.7215232849121,341.2875192165375,1218.328311920166,40173,4865,35308,35308,0,9,5236000.0
5236,5236999,22.153406235454433,39.157044768844884,0.04644811029399587,900.9338371753693,341.35041403770447,1218.7052040100098,40179,4866,35313,35313,0,9,5237000.0
5237,5237999,22.152626633574215,39.15517573383101,0.04644214261962609,901.0497200489044,341.41269278526306,1219.004062652588,40183,4866,35317,35317,0,9,5238000.0
5238,5238999,22.1518005584535,39.1530540595049,0.046436872644864624,901.5460865497589,341.4779989719391,1219.0615577697754,40206,4870,35336,35336,0,9,5239000.0
5239,5239999,22.151310203453622,39.1511475271243,0.046419175642648636,901.9279108047485,341.5405647754669,1219.2563705444336,40230,4873,35357,35357,0,9,5240000.0
5240,5240999,22.1510379305864,39.15070463153662,0.04638910257679707,902.1352307796478,341.6049237251282,1219.6031684875488,40237,4874,35363,35363,0,9,5241000.0
5241,5241999,22.15050909348314,39.14866132792399,0.046377240475661496,902.4337739944458,341.66761469841003,1219.8105545043945,40254,4876,35378,35378,0,9,5242000.0
5242,5242999,22.150293498561258,39.147066760640016,0.046355907260571816,902.8169896602631,341.7302768230438,1220.011157989502,40278,4879,35399,35399,0,9,5243000.0
5243,5243999,22.149809037931615,39.14507017139246,0.04633698914375761,902.9341158866882,341.79223799705505,1220.4045791625977,40281,4879,35402,35402,0,9,5244000.0
5244,5244999,22.149134954465886,39.14287902124123,0.04632021367644745,903.3995218276978,341.8550236225128,1220.52827835083,40302,4883,35419,35419,0,9,5245000.0
5245,5245999,22.14867451574823,39.14096850412301,0.0462976125116632,903.6021974086761,341.91789150238037,1220.8114891052246,40304,4884,35420,35420,0,9,5246000.0
5246,5246999,22.147447644483343,39.1383784670845,0.046302984251379575,903.7264122962952,341.9821000099182,1221.693675994873,40330,4884,35446,35446,0,9,5247000.0
5247,5247999,22.14563131680526,39.135569017455055,0.046312457089322856,903.8566632270813,342.0460886955261,1222.1770095825195,40341,4884,35457,35457,0,9,5248000.0
5248,5248999,22.144031053345497,39.132910268802476,0.046321295977142074,903.9837348461151,342.11010551452637,1222.4759330749512,40342,4884,35458,35458,0,9,5249000.0
5249,5249999,22.142525777719317,39.13021114822671,0.04633545802634298,904.2016105651855,342.17231965065,1222.7138633728027,40353,4885,35468,35468,0,9,5250000.0
5250,5250999,22.14122241909331,39.12772744607405,0.04634253922742693,904.3245060443878,342.2343752384186,1222.938102722168,40354,4885,35469,35469,0,9,5251000.0
5251,5251999,22.140113291515828,39.126429614626,0.04634577154407471,904.5324201583862,342.29743003845215,1223.1513061523438,40361,4886,35475,35475,0,9,5252000.0
5252,5252999,22.138816619610576,39.12454162580247,0.046350310945871165,904.7395887374878,342.35960721969604,1223.3257369995117,40381,4887,35494,35494,0,9,5253000.0
5253,5253999,22.137795082746877,39.12272284747028,0.04635563589974434,904.9621691703796,342.42719435691833,1223.5827026367188,40391,4888,35503,35503,0,9,5254000.0
5254,5254999,22.13677160125038,39.12065623922239,0.04635999258789669,905.1848659515381,342.49226570129395,1223.7212715148926,40393,4889,35504,35504,0,9,5255000.0
5255,5255999,22.135728917000545,39.11851871884838,0.046364282178957494,905.324709892273,342.55374026298523,1223.9488983154297,40394,4889,35505,35505,0,9,5256000.0
5256,5256999,22.13492483958308,39.11645434020274,0.046364556806653856,905.5342261791229,342.615971326828,1224.0821266174316,40399,4890,35509,35509,0,9,5257000.0
5257,5257999,22.133901833046707,39.11450038607901,0.046364401510476494,905.903538942337,342.67651438713074,1224.1624031066895,40407,4893,35514,35514,0,9,5258000.0
5258,5258999,22.133105469499665,39.11271624974536,0.04636696268169738,906.0250935554504,342.740375995636,1224.4657554626465,40409,4893,35516,35516,0,9,5259000.0
5259,5259999,22.1323559274464,39.1108056084684,0.0463588030606471,906.2536628246307,342.8101923465729,1224.6488914489746,40444,4894,35550,35550,0,9,5260000.0
5260,5260999,22.13202377734826,39.111423673382234,0.04635175860166685,906.5616433620453,342.87449073791504,1224.9625778198242,40457,4896,35561,35561,0,9,5261000.0
5261,5261999,22.13186457893327,39.111003561790575,0.04633802198356329,906.6911981105804,342.9371531009674,1225.3561363220215,40459,4896,35563,35563,0,9,5262000.0
5262,5262999,22.131443724254993,39.111142567731655,0.04633454725066333,906.8078901767731,342.9986615180969,1225.663402557373,40461,4896,35565,35565,0,9,5263000.0
5263,5263999,22.131300580712857,39.11020257821128,0.04633508807776654,907.1175138950348,343.06264209747314,1225.867042541504,40472,4898,35574,35574,0,9,5264000.0
5264,5264999,22.13124266510285,39.110299314886404,0.04631737267112035,907.3299536705017,343.12513995170593,1226.1125106811523,40476,4899,35577,35577,0,9,5265000.0
5265,5265999,22.130699450322876,39.108568252396296,0.0463114212851683,907.4529342651367,343.18669414520264,1226.4116172790527,40479,4899,35580,35580,0,9,5266000.0
5266,5266999,22.13001706005673,39.10678514396577,0.04630098761164825,907.5651030540466,343.2467679977417,1226.6603889465332,40479,4899,35580,35580,0,9,5267000.0
5267,5267999,22.128972853054567,39.10610584031016,0.0463015787735106,907.7778422832489,343.3102295398712,1227.3418884277344,40501,4900,35601,35601,0,9,5268000.0
5268,5268999,22.127405581721654,39.10371503896017,0.04630707502066145,907.9858758449554,343.37268805503845,1227.6819190979004,40511,4901,35610,35610,0,9,5269000.0
5269,5269999,22.126230684629693,39.10250502132116,0.04630984945627248,908.2089443206787,343.4437792301178,1227.83695602417,40513,4902,35611,35611,0,9,5270000.0
5270,5270999,22.125168659605528,39.1007379231554,0.04631346667477898,908.3341755867004,343.5071394443512,1228.1408233642578,40516,4902,35614,35614,0,9,5271000.0
5271,5271999,22.124476422228085,39.09935965333159,0.04630546327703566,908.4712100028992,343.56960225105286,1228.2944679260254,40516,4902,35614,35614,0,9,5272000.0
5272,5272999,22.123415508756263,39.09713371228132,0.04630532351807015,908.7753231525421,343.6323902606964,1228.3883819580078,40526,4904,35622,35622,0,9,5273000.0
5273,5273999,22.122431268988016,39.095766113947775,0.04630276935028421,908.919162273407,343.69469833374023,1228.545051574707,40527,4904,35623,35623,0,9,5274000.0
5274,5274999,22.12151431752204,39.09370692385825,0.04630780554013747,909.1476986408234,343.75696444511414,1228.6448287963867,40529,4905,35624,35624,0,9,5275000.0
5275,5275999,22.120530088159907,39.091555794448,0.04631244444618465,909.2683334350586,343.8186569213867,1228.77054977417,40529,4905,35624,35624,0,9,5276000.0
5276,5276999,22.119978951132353,39.092544950011636,0.04630606822670347,909.4870719909668,343.88048338890076,1228.9291954040527,40533,4906,35627,35627,0,9,5277000.0
5277,5277999,22.11904257632998,39.09028620596398,0.046306798585542985,909.8753213882446,343.9431231021881,1228.9309997558594,40552,4909,35643,35643,0,9,5278000.0
5278,5278999,22.118630174915594,39.08898609375501,0.046311277717326016,910.1862182617188,344.0052287578583,1228.9315567016602,40556,4911,35645,35645,0,9,5279000.0
5279,5279999,22.118266473808944,39.08745860591784,0.046311571819868,910.4852199554443,344.06738448143005,1228.9961891174316,40573,4913,35660,35660,0,9,5280000.0
5280,5280999,22.118274116529076,39.088622619703926,0.0463108750545671,910.7997765541077,344.1293661594391,1229.1280670166016,40585,4915,35670,35670,0,9,5281000.0
5281,5281999,22.118246485406722,39.087923781053995,0.04630782330906569,910.9185631275177,344.1911702156067,1229.3800773620605,40586,4915,35671,35671,0,9,5282000.0
5282,5282999,22.11842519124701,39.08722484920769,0.04630539281397372,911.0421311855316,344.25257110595703,1229.6057739257812,40588,4915,35673,35673,0,9,5283000.0
5283,5283999,22.118576963576416,39.08791097250932,0.046295311771880954,911.1609239578247,344.3142235279083,1229.826759338379,40590,4915,35675,35675,0,9,5284000.0
5284,5284999,22.118847862969474,39.0872066494094,0.046287364795157715,911.2989597320557,344.3759467601776,1229.9738388061523,40591,4915,35676,35676,0,9,5285000.0
5285,5285999,22.118947462429926,39.08621999535521,0.04627848762330411,911.4156196117401,344.4375500679016,1230.240322113037,40594,4915,35679,35679,0,9,5286000.0
5286,5286999,22.118963938544137,39.08488826094787,0.04626772387906264,911.535966873169,344.499046087265,1230.4298706054688,40595,4915,35680,35680,0,9,5287000.0
5287,5287999,22.11883211762382,39.08339359620671,0.046256293079673605,911.6641044616699,344.56055974960327,1230.5780601501465,40596,4915,35681,35681,0,9,5288000.0
5288,5288999,22.11798995068365,39.08191402991585,0.04625490662585041,911.9756693840027,344.62508511543274,1231.132942199707,40641,4917,35724,35724,0,9,5289000.0
5289,5289999,22.11694744720666,39.07993426267607,0.04625371741994588,912.1870424747467,344.6881287097931,1231.52396774292,40652,4918,35734,35734,0,9,5290000.0
5290,5290999,22.115837048118646,39.07756605512736,0.04626163813803286,912.3267199993134,344.75098156929016,1231.7617530822754,40653,4918,35735,35735,0,9,5291000.0
5291,5291999,22.11494709678974,39.0756034435724,0.046261879487895397,912.6371040344238,344.8140113353729,1231.8493728637695,40664,4920,35744,35744,0,9,5292000.0
5292,5292999,22.11403090976233,39.07349517511715,0.0462632294180475,912.8733758926392,344.8868451118469,1232.0610847473145,40673,4921,35752,35752,0,9,5293000.0
5293,5293999,22.11299257702664,39.07167308788686,0.046260417663572806,913.0993955135345,344.9520614147186,1232.2822265625,40680,4922,35758,35758,0,9,5294000.0
5294,5294999,22.11243606938115,39.070056667560515,0.0462574121103454,913.2252938747406,345.01599407196045,1232.608585357666,40684,4922,35762,35762,0,9,5295000.0
5295,5295999,22.11190698378512,39.06821233644254,0.04625573772450964,913.3503522872925,345.07782888412476,1232.8886985778809,40688,4922,35766,35766,0,9,5296000.0
5296,5296999,22.111332009602854,39.06622279912584,0.04625334712393725,913.4676294326782,345.1400258541107,1233.1328048706055,40688,4922,35766,35766,0,9,5297000.0
5297,5297999,22.1111504669322,39.06504335228651,0.04624951809724975,913.6770725250244,345.20451974868774,1233.3439674377441,40691,4923,35768,35768,0,9,5298000.0
5298,5298999,22.111276799987063,39.06375299467075,0.04624422135245532,913.8022773265839,345.2667016983032,1233.513370513916,40693,4923,35770,35770,0,9,5299000.0
5299,5299999,22.11112528099559,39.06216632528521,0.04624125817912483,914.0201618671417,345.32854771614075,1233.6715049743652,40708,4924,35784,35784,0,9,5300000.0
5300,5300999,22.111337406490204,39.061718760250145,0.04623573755040011,914.1397545337677,345.3912079334259,1233.9541091918945,40711,4924,35787,35787,0,9,5301000.0
5301,5301999,22.111409659211,39.06055689667876,0.04623332902061894,914.2750866413116,345.45570635795593,1234.2280197143555,40714,4924,35790,35790,0,9,5302000.0
5302,5302999,22.111470273489108,39.05932518617373,0.04622583216675502,914.5868997573853,345.51857352256775,1234.4630508422852,40723,4926,35797,35797,0,9,5303000.0
5303,5303999,22.111464001519412,39.057945493318144,0.046223603137834024,914.7045886516571,345.5812485218048,1234.7752380371094,40727,4926,35801,35801,0,9,5304000.0
5304,5304999,22.11130490434905,39.05604727078484,0.046216938857378875,914.9289653301239,345.6446816921234,1235.0302238464355,40732,4927,35805,35805,0,9,5305000.0
5305,5305999,22.110078168040694,39.055513540142705,0.04622409345209644,915.1705491542816,345.7089831829071,1235.8600540161133,40763,4928,35835,35835,0,9,5306000.0
5306,5306999,22.108730025221043,39.054914105057605,0.0462293744239618,915.2903044223785,345.7716145515442,1236.315040588379,40768,4928,35840,35840,0,9,5307000.0
5307,5307999,22.107311016867282,39.05239653555648,0.04624556618371467,915.5977773666382,345.83433723449707,1236.4700775146484,40784,4930,35854,35854,0,9,5308000.0
5308,5308999,22.106273045193998,39.05094810116568,0.04625860875840382,916.0140686035156,345.90310645103455,1236.5233345031738,40803,4933,35870,35870,0,9,5309000.0
5309,5309999,22.104976002089337,39.04839501584334,0.04627622510060048,916.2373826503754,345.96685576438904,1236.7448120117188,40807,4934,35873,35873,0,9,5310000.0
5310,5310999,22.103540916404917,39.04627806438095,0.0462865920053096,916.4474966526031,346.02955651283264,1236.9417457580566,40817,4935,35882,35882,0,9,5311000.0
5311,5311999,22.102298584628734,39.044725273251665,0.04628533926720235,916.6522755622864,346.091588973999,1237.1437492370605,40823,4936,35887,35887,0,9,5312000.0
5312,5312999,22.100922871356573,39.042586711654614,0.046292550523950204,916.957869052887,346.1550176143646,1237.2483825683594,40837,4938,35899,35899,0,9,5313000.0
5313,5313999,22.099938328341356,39.0407458537231,0.046288731578024156,917.2610988616943,346.2175374031067,1237.4097938537598,40854,4940,35914,35914,0,9,5314000.0
5314,5314999,22.099012573533432,39.03918838671072,0.04628787878628904,917.4755294322968,346.2803723812103,1237.5530242919922,40857,4941,35916,35916,0,9,5315000.0
5315,5315999,22.09832139318633,39.038769639545364,0.04627934532751832,917.5963754653931,346.34232091903687,1237.6921882629395,40857,4941,35916,35916,0,9,5316000.0
5316,5316999,22.09782225212595,39.03824927887656,0.04626952616989932,917.8928883075714,346.40572118759155,1237.8457527160645,40877,4943,35934,35934,0,9,5317000.0
5317,5317999,22.097258644741032,39.03713574847747,0.04625905883084225,918.4707260131836,346.4695289134979,1237.879337310791,40894,4948,35946,35946,0,9,5318000.0
5318,5318999,22.096471802767187,39.03544075869069,0.046255238045879055,918.5996141433716,346.5351650714874,1238.143081665039,40894,4948,35946,35946,0,9,5319000.0
5319,5319999,22.09598756815713,39.033919205963116,0.04624198870700924,918.8153483867645,346.5975127220154,1238.40962600708,40898,4949,35949,35949,0,9,5320000.0
5320,5320999,22.095840883444485,39.03295723361207,0.046236835237272955,919.0385513305664,346.66246914863586,1238.680995941162,40915,4950,35965,35965,0,9,5321000.0
5321,5321999,22.095614629599158,39.031916237138276,0.04622614492423838,919.3543047904968,346.7259840965271,1238.9833488464355,40925,4952,35973,35973,0,9,5322000.0
5322,5322999,22.095071566154527,39.03009156169849,0.04621732090547559,919.5752255916595,346.7887325286865,1239.270580291748,40933,4953,35980,35980,0,9,5323000.0
5323,5323999,22.09463100618463,39.028537053048844,0.04621062527571651,919.6927366256714,346.8511061668396,1239.54780960083,40935,4953,35982,35982,0,9,5324000.0
5324,5324999,22.093844175088112,39.02693155969571,0.04620532476772432,919.8186771869659,346.9128346443176,1239.9000549316406,40941,4953,35988,35988,0,9,5325000.0
5325,5325999,22.092611099423497,39.026009491264475,0.04620772727687317,919.9516544342041,346.9756588935852,1240.5533866882324,40959,4953,36006,36006,0,9,5326000.0
5326,5326999,22.09138702591318,39.024283327354546,0.0462098053548039,920.166303396225,347.0400433540344,1240.909984588623,40979,4954,36025,36025,0,9,5327000.0
5327,5327999,22.090126329727752,39.02236645601053,0.04621239397676857,920.3075838088989,347.10890674591064,1241.1088905334473,40980,4954,36026,36026,0,9,5328000.0
5328,5328999,22.089151140578082,39.020641115434714,0.04621149899407062,920.5270743370056,347.17152857780457,1241.290512084961,40985,4955,36030,36030,0,9,5329000.0
5329,5329999,22.08809629041159,39.01884255072894,0.04621167929316117,920.7640101909637,347.2344460487366,1241.4883308410645,40987,4956,36031,36031,0,9,5330000.0
5330,5330999,22.086993303087958,39.016494112086384,0.046213566321516186,920.8898191452026,347.2972676753998,1241.6817588806152,40989,4956,36033,36033,0,9,5331000.0
5331,5331999,22.085810088866864,39.01466420145008,0.04621615047379979,921.1038131713867,347.35828852653503,1241.7622184753418,41006,4957,36049,36049,0,9,5332000.0
5332,5332999,22.084705427465835,39.01241599834922,0.04621631816096805,921.3112487792969,347.42085218429565,1241.8989448547363,41015,4958,36057,36057,0,9,5333000.0
5333,5333999,22.083606114278293,39.01008906590216,0.04622153094121306,921.533210515976,347.4847021102905,1242.0326347351074,41017,4959,36058,36058,0,9,5334000.0
5334,5334999,22.082936535660853,39.00840519164065,0.046217997016639645,921.6637260913849,347.5470681190491,1242.2000350952148,41017,4959,36058,36058,0,9,5335000.0
5335,5335999,22.08201310980044,39.00645854291421,0.046218965118632216,921.885187625885,347.60963344573975,1242.3930320739746,41021,4960,36061,36061,0,9,5336000.0
5336,5336999,22.081450382005038,39.00462933463423,0.04621594582681865,922.1891722679138,347.67231464385986,1242.4236145019531,41037,4962,36075,36075,0,9,5337000.0
5337,5337999,22.080856442074822,39.002928687672366,0.046193719916050036,922.3274283409119,347.7354018688202,1242.6556015014648,41037,4962,36075,36075,0,9,5338000.0
5338,5338999,22.080499722004923,39.001777064508616,0.04618757701316367,922.4460768699646,347.79753971099854,1242.932632446289,41039,4962,36077,36077,0,9,5339000.0
5339,5339999,22.080174397423622,39.0005668239867,0.04615944045469289,922.6618719100952,347.85999941825867,1243.081558227539,41055,4963,36092,36092,0,9,5340000.0
5340,5340999,22.0799874595607,38.99940162452007,0.04614974574711306,922.7993354797363,347.9244158267975,1243.447151184082,41060,4963,36097,36097,0,9,5341000.0
5341,5341999,22.079701162564387,38.99791380202792,0.046146056330968244,923.0149416923523,347.9864590167999,1243.658992767334,41063,4964,36099,36099,0,9,5342000.0
5342,5342999,22.079822593450892,38.998502564191554,0.04613511546085791,923.1455783843994,348.0485215187073,1243.8457641601562,41063,4964,36099,36099,0,9,5343000.0
5343,5343999,22.079560155965392,38.99689956643092,0.04612671648999611,923.2841556072235,348.11106848716736,1244.114242553711,41065,4964,36101,36101,0,9,5344000.0
5344,5344999,22.07878108279777,38.99467678492801,0.0461216376968514,923.4103727340698,348.1754479408264,1244.3403015136719,41067,4964,36103,36103,0,9,5345000.0
5345,5345999,22.078039080733713,38.99252216295567,0.04612215036532441,923.5362529754639,348.23781061172485,1245.0232009887695,41090,4964,36126,36126,0,9,5346000.0
5346,5346999,22.07646933124122,38.99037133677439,0.046134238745709544,923.9415812492371,348.3018503189087,1245.5984649658203,41127,4967,36160,36160,0,9,5347000.0
5347,5347999,22.07462492591018,38.987386611943094,0.046142480127700725,924.0625174045563,348.36456871032715,1246.0493507385254,41133,4967,36166,36166,0,9,5348000.0
5348,5348999,22.073024043105274,38.9846813433391,0.04615157086388144,924.1903941631317,348.4280757904053,1246.4021644592285,41137,4967,36170,36170,0,9,5349000.0
5349,5349999,22.071717032347426,38.982788508701105,0.046152043336791904,924.4058773517609,348.4919147491455,1246.637825012207,41141,4968,36173,36173,0,9,5350000.0
5350,5350999,22.070490894899837,38.98087111083518,0.04615117227755694,924.9935338497162,348.55700969696045,1246.7284088134766,41184,4973,36211,36211,0,9,5351000.0
5351,5351999,22.06937385647921,38.97865147524948,0.0461557242974413,925.2136945724487,348.620801448822,1247.0461311340332,41196,4974,36222,36222,0,9,5352000.0
5352,5352999,22.068239290827375,38.97686864087707,0.046158561888313354,925.4268319606781,348.685928106308,1247.3195686340332,41213,4975,36238,36238,0,9,5353000.0
5353,5353999,22.06872218003742,38.97956865690167,0.046146731546301334,925.6366608142853,348.74812936782837,1247.5135955810547,41218,4976,36242,36242,0,9,5354000.0
5354,5354999,22.068961563904665,38.98018867788607,0.046146717334774046,925.9472963809967,348.8126902580261,1247.8551177978516,41228,4978,36250,36250,0,9,5355000.0
5355,5355999,22.069377114059826,38.9810167375736,0.04615283932136349,926.1545715332031,348.8752908706665,1248.185562133789,41237,4979,36258,36258,0,9,5356000.0
5356,5356999,22.070684739153364,38.98294290778545,0.04614273564253679,926.2727725505829,348.9381878376007,1248.523094177246,41238,4979,36259,36259,0,9,5357000.0
5357,5357999,22.07197500620254,38.98487675262472,0.04614686273697821,926.3965220451355,349.001362323761,1248.8908615112305,41243,4979,36264,36264,0,9,5358000.0
5358,5358999,22.07370065722175,38.98735443868038,0.04616440810830158,926.5196847915649,349.06406354904175,1249.280963897705,41248,4979,36269,36269,0,9,5359000.0
5359,5359999,22.07560619134419,38.99013024832022,0.04617557862506716,926.7389624118805,349.1278955936432,1249.4817733764648,41256,4980,36276,36276,0,9,5360000.0
5360,5360999,22.077481196735985,38.99214356327484,0.046191140720765134,926.8545296192169,349.19045782089233,1249.880989074707,41261,4980,36281,36281,0,9,5361000.0
5361,5361999,22.079244331242432,38.99439394368122,0.04619094166497684,926.9766516685486,349.2534170150757,1250.307746887207,41266,4980,36286,36286,0,9,5362000.0
5362,5362999,22.081540724858503,38.99685760537093,0.046186349351539646,927.1875820159912,349.3155698776245,1250.569522857666,41275,4981,36294,36294,0,9,5363000.0
5363,5363999,22.083091017714906,38.99803736166739,0.046181296178514186,927.4066324234009,349.37812209129333,1250.728401184082,41285,4982,36303,36303,0,9,5364000.0
5364,5364999,22.083760326088537,38.997526962015556,0.046181753192975905,927.5370733737946,349.443683385849,1251.1047592163086,41290,4982,36308,36308,0,9,5365000.0
5365,5365999,22.083389300375522,38.99602953283724,0.046172729463537454,927.9385211467743,349.5087020397186,1251.8751411437988,41325,4985,36340,36340,0,9,5366000.0
5366,5366999,22.081966385667663,38.99393018445576,0.04617819532276035,928.2413091659546,349.5719883441925,1252.308120727539,41337,4987,36350,36350,0,9,5367000.0
5367,5367999,22.080511811325135,38.99161697634882,0.04618205523095775,928.4568331241608,349.63481736183167,1252.584674835205,41349,4988,36361,36361,0,9,5368000.0
5368,5368999,22.079235354619765,38.98960532048975,0.046188355171386974,928.5782582759857,349.6974022388458,1252.8644523620605,41349,4988,36361,36361,0,9,5369000.0
5369,5369999,22.078089679951805,38.98791717274047,0.04618589015160901,928.7878570556641,349.75975799560547,1253.0743827819824,41352,4989,36363,36363,0,9,5370000.0
5370,5370999,22.07698479550717,38.98574409916374,0.04618473400025913,929.0041842460632,349.8221664428711,1253.249454498291,41354,4990,36364,36364,0,9,5371000.0
5371,5371999,22.075784661270195,38.98348680712266,0.046189296649887024,929.2186968326569,349.8875358104706,1253.4856605529785,41364,4991,36373,36373,0,9,5372000.0
5372,5372999,22.074703224207152,38.98130854184642,0.046190605158646814,929.4351558685303,349.953218460083,1253.8380126953125,41372,4992,36380,36380,0,9,5373000.0
5373,5373999,22.07358064556054,38.97906964246145,0.04618449205942232,929.6480884552002,350.01738142967224,1254.0331726074219,41375,4993,36382,36382,0,9,5374000.0
5374,5374999,22.072893304053764,38.97774563577126,0.046176538400588774,929.7721078395844,350.082236289978,1254.3916473388672,41379,4993,36386,36386,0,9,5375000.0
5375,5375999,22.07193766730416,38.975708612472204,0.04616590711324953,929.8946602344513,350.14767241477966,1254.7089462280273,41383,4993,36390,36390,0,9,5376000.0
5376,5376999,22.07124526973809,38.9738333723615,0.0461624524180837,930.1140201091766,350.2116997241974,1254.88480758667,41392,4994,36398,36398,0,9,5377000.0
5377,5377999,22.07081162590491,38.97249437372213,0.04615107226680948,930.3264787197113,350.2747926712036,1255.1075706481934,41401,4995,36406,36406,0,9,5378000.0
5378,5378999,22.070300617888545,38.970739127712825,0.04613498011534367,930.4447004795074,350.3376832008362,1255.3334655761719,41402,4995,36407,36407,0,9,5379000.0
5379,5379999,22.070156807456847,38.96907341978503,0.046113930291396654,930.7585065364838,350.4029619693756,1255.3569107055664,41408,4997,36411,36411,0,9,5380000.0
5380,5380999,22.07022113991274,38.968153838751306,0.04609077028184183,931.2548835277557,350.4662356376648,1255.4003791809082,41438,5001,36437,36437,0,9,5381000.0
5381,5381999,22.070287975645098,38.9671027842787,0.04607677741186211,931.4660768508911,350.52838349342346,1255.6528511047363,41448,5002,36446,36446,0,9,5382000.0
5382,5382999,22.070482716818216,38.96604340892684,0.04606306447078645,931.6740498542786,350.59108233451843,1255.829345703125,41464,5003,36461,36461,0,9,5383000.0
5383,5383999,22.070520328272764,38.964844876320775,0.04604920208235297,931.9817395210266,350.6544301509857,1256.0180320739746,41472,5005,36467,36467,0,9,5384000.0
5384,5384999,22.070551291071634,38.96363348118682,0.04604988558603451,932.0994119644165,350.7175085544586,1256.442741394043,41477,5005,36472,36472,0,9,5385000.0
5385,5385999,22.070100205453627,38.961879976368,0.04604879589012445,932.3203837871552,350.7804934978485,1257.0402336120605,41502,5006,36496,36496,0,9,5386000.0
5386,5386999,22.068842568405763,38.96029998726189,0.0460533296335377,932.4540393352509,350.846666097641,1257.679027557373,41514,5006,36508,36508,0,9,5387000.0
5387,5387999,22.06752813891761,38.95855981437739,0.04605345218046142,932.7605168819427,350.9103672504425,1257.970287322998,41526,5008,36518,36518,0,9,5388000.0
5388,5388999,22.066819642756958,38.96146367318398,0.0460436173716442,932.9838552474976,350.9733440876007,1258.2807579040527,41533,5009,36524,36524,0,9,5389000.0
5389,5389999,22.065659806642348,38.95921490483791,0.04604209017901095,933.09974193573,351.03518629074097,1258.5254859924316,41533,5009,36524,36524,0,9,5390000.0
5390,5390999,22.064656193808236,38.957148366013875,0.046035954592647754,933.4096972942352,351.0990686416626,1258.7106552124023,41545,5011,36534,36534,0,9,5391000.0
5391,5391999,22.06367497821965,38.95494041703719,0.04603332285074513,933.8145041465759,351.16385769844055,1258.8691711425781,41554,5014,36540,36540,0,9,5392000.0
5392,5392999,22.062877495874364,38.95321270582626,0.04602800553228459,933.9303421974182,351.22597432136536,1259.06547164917,41554,5014,36540,36540,0,9,5393000.0
5393,5393999,22.06203175292514,38.95122764934267,0.04602357139912083,934.0510137081146,351.2879128456116,1259.3714065551758,41556,5014,36542,36542,0,9,5394000.0
5394,5394999,22.0611631527132,38.949187953570856,0.04601911038559814,934.2670495510101,351.34999680519104,1259.524341583252,41563,5015,36548,36548,0,9,5395000.0
5395,5395999,22.06073413194518,38.94791719186049,0.04601204983664575,934.566499710083,351.41220140457153,1259.6126823425293,41567,5017,36550,36550,0,9,5396000.0
5396,5396999,22.060265169888442,38.94697708274039,0.0460095682764351,934.6836888790131,351.4742772579193,1259.808738708496,41568,5017,36551,36551,0,9,5397000.0
5397,5397999,22.059869294807463,38.945713170341016,0.04601090860931323,934.812881231308,351.53659439086914,1259.9340476989746,41568,5017,36551,36551,0,9,5398000.0
5398,5398999,22.05965377270286,38.94449212660889,0.04601071545201474,935.0285499095917,351.5999641418457,1260.0134735107422,41570,5018,36552,36552,0,9,5399000.0
5399,5399999,22.059911106196033,38.94478559433834,0.04601126841168446,935.147899389267,351.6621379852295,1260.2069702148438,41571,5018,36553,36553,0,9,5400000.0
5400,5400999,22.060547193415243,38.948009791610495,0.04603312756772471,935.2830293178558,351.7275195121765,1260.3303985595703,41571,5018,36553,36553,0,9,5401000.0
5401,5401999,22.062718064457837,38.9584019180638,0.046045901968899794,935.516273021698,351.7922306060791,1260.4046516418457,41578,5019,36559,36559,0,9,5402000.0
5402,5402999,22.064399849712,38.96132347616851,0.04609111902282981,935.7368142604828,351.8569312095642,1260.6164627075195,41587,5020,36567,36567,0,9,5403000.0
5403,5403999,22.066687881466716,38.96563457077143,0.046113378691209905,935.9498655796051,351.92001938819885,1260.8248176574707,41604,5021,36583,36583,0,9,5404000.0
5404,5404999,22.0682795984125,38.96765918296829,0.0461385869557821,936.2616946697235,351.98359513282776,1260.8863563537598,41613,5023,36590,36590,0,9,5405000.0
5405,5405999,22.069856298155717,38.96944738107809,0.04616618374393722,936.3833150863647,352.048623085022,1261.1345138549805,41614,5023,36591,36591,0,9,5406000.0
5406,5406999,22.069992462400883,38.97005887557672,0.04616998840174069,936.6038074493408,352.1149880886078,1261.6668968200684,41638,5024,36614,36614,0,9,5407000.0
5407,5407999,22.068474808071564,38.97383623037487,0.04616148573005596,936.8381292819977,352.1787166595459,1262.1716346740723,41660,5025,36635,36635,0,9,5408000.0
5408,5408999,22.06704904704686,38.97235446240146,0.04616387044814074,936.9727573394775,352.24078464508057,1262.406665802002,41662,5025,36637,36637,0,9,5409000.0
5409,5409999,22.065624466360223,38.96996635314425,0.046169436134808284,937.0907175540924,352.30319237709045,1262.6677894592285,41664,5025,36639,36639,0,9,5410000.0
5410,5410999,22.064346616653676,38.96792370796178,0.046168780599337156,937.3254342079163,352.3656692504883,1262.8161010742188,41672,5026,36646,36646,0,9,5411000.0
5411,5411999,22.06310342170797,38.965789344885216,0.04616596892315783,937.4502234458923,352.42726039886475,1263.024486541748,41673,5026,36647,36647,0,9,5412000.0
5412,5412999,22.0615639854177,38.96313392398474,0.0461691354257564,937.6684114933014,352.49211859703064,1263.204719543457,41684,5027,36657,36657,0,9,5413000.0
5413,5413999,22.060325034595838,38.96149989650664,0.046169510335862474,937.7903304100037,352.55371379852295,1263.3775062561035,41685,5027,36658,36658,0,9,5414000.0
5414,5414999,22.059230531421747,38.95979298268382,0.046165648825443606,938.0086193084717,352.61548256874084,1263.4609260559082,41687,5028,36659,36659,0,9,5415000.0
5415,5415999,22.05800092128092,38.95749874882896,0.04616602101673195,938.3310303688049,352.6783256530762,1263.608512878418,41707,5030,36677,36677,0,9,5416000.0
5416,5416999,22.057054151210014,38.955752408204184,0.046164153418520426,938.4581708908081,352.740602016449,1263.7722206115723,41708,5030,36678,36678,0,9,5417000.0
5417,5417999,22.05618438654962,38.953574617178376,0.04616300073296076,938.5812699794769,352.8045320510864,1263.967170715332,41710,5030,36680,36680,0,9,5418000.0
5418,5418999,22.055363053953567,38.95165682160134,0.046163255430234695,938.8030736446381,352.86677384376526,1264.0133590698242,41712,5031,36681,36681,0,9,5419000.0
5419,5419999,22.05477244454627,38.95063294918511,0.04616133537069478,939.0133843421936,352.92872285842896,1264.0643844604492,41714,5032,36682,36682,0,9,5420000.0
5420,5420999,22.05424879839364,38.94905287684218,0.0461610330631087,939.2217402458191,352.9905574321747,1264.2016906738281,41724,5033,36691,36691,0,9,5421000.0
5421,5421999,22.054161626997868,38.94854642922765,0.04617124839623865,939.6547021865845,353.0607500076294,1264.1336097717285,41743,5036,36707,36707,0,9,5422000.0
5422,5422999,22.053940047695697,38.94774328466009,0.0461689518577747,940.0576016902924,353.1258153915405,1264.2073516845703,41766,5039,36727,36727,0,9,5423000.0
5423,5423999,22.054077702378276,38.94747006465043,0.046157084750160005,940.2738947868347,353.18733048439026,1264.3774871826172,41771,5040,36731,36731,0,9,5424000.0
5424,5424999,22.054069279215284,38.94658173442276,0.04615442947671666,940.4898731708527,353.2511992454529,1264.6078605651855,41779,5041,36738,36738,0,9,5425000.0
5425,5425999,22.054450444531792,38.94630534919332,0.046155316386391365,944.8202102184296,353.32062792778015,1264.7420921325684,41779,5041,36738,36738,0,9,5426000.0
5426,5426999,22.054143993424486,38.944875887024246,0.046150634569171456,945.0394704341888,353.3826642036438,1264.8624305725098,41783,5042,36741,36741,0,9,5427000.0
5427,5427999,22.05343680609874,38.94303316341142,0.046149623458171085,945.1675314903259,353.4452121257782,1265.427619934082,41801,5042,36759,36759,0,9,5428000.0
5428,5428999,22.052518956194696,38.94163316014863,0.046150189303197364,945.3900291919708,353.5102860927582,1265.9536514282227,41819,5043,36776,36776,0,9,5429000.0
5429,5429999,22.051449717511215,38.93981488307064,0.046151421122276104,945.9908459186554,353.573890209198,1266.0042686462402,41851,5048,36803,36803,0,9,5430000.0
5430,5430999,22.05027096399525,38.93785818828696,0.04615419420487643,946.1166090965271,353.63669872283936,1266.2808303833008,41851,5048,36803,36803,0,9,5431000.0
5431,5431999,22.049196667119354,38.9356303692722,0.046153617289333426,946.5348732471466,353.7002491950989,1266.3544120788574,41869,5051,36818,36818,0,9,5432000.0
5432,5432999,22.047909313156957,38.93307682751828,0.04615844080127518,946.6737759113312,353.76375818252563,1266.6334991455078,41871,5051,36820,36820,0,9,5433000.0
5433,5433999,22.046973674730097,38.931558297913455,0.04616118338498998,946.8972086906433,353.8298020362854,1266.8073463439941,41877,5052,36825,36825,0,9,5434000.0
5434,5434999,22.04607786343763,38.92939440922199,0.04616017895697644,947.0393769741058,353.89513754844666,1267.030185699463,41877,5052,36825,36825,0,9,5435000.0
5435,5435999,22.04556909301987,38.93149651994932,0.04614314340785186,947.2600553035736,353.9598660469055,1267.3098449707031,41881,5053,36828,36828,0,9,5436000.0
5436,5436999,22.04495543352782,38.92956129596254,0.046136170287020994,947.6781876087189,354.02305364608765,1267.3663902282715,41901,5056,36845,36845,0,9,5437000.0
5437,5437999,22.044474169960395,38.927766953901454,0.04612943761550148,947.9867708683014,354.0860583782196,1267.5041961669922,41910,5058,36852,36852,0,9,5438000.0
5438,5438999,22.044116133774754,38.925771629845094,0.04611585679837371,948.4166622161865,354.1517684459686,1267.5396194458008,41920,5061,36859,36859,0,9,5439000.0
5439,5439999,22.043959288168693,38.92409639727326,0.04609883627902078,948.64537525177,354.21705889701843,1267.8099517822266,41930,5062,36868,36868,0,9,5440000.0
5440,5440999,22.043768952309073,38.92236373032768,0.046083258188532095,949.0667495727539,354.2808418273926,1267.900161743164,41950,5065,36885,36885,0,9,5441000.0
5441,5441999,22.043636395929184,38.92056958925451,0.04606367331025951,949.5796065330505,354.34424924850464,1268.004192352295,41967,5069,36898,36898,0,9,5442000.0
5442,5442999,22.043320187342747,38.91861269223072,0.04604818046686232,949.9069180488586,354.4086322784424,1268.2537841796875,41979,5071,36908,36908,0,9,5443000.0
5443,5443999,22.043085596468774,38.916767250882955,0.0460300164941273,950.139081954956,354.47340154647827,1268.5714683532715,41999,5072,36927,36927,0,9,5444000.0
5444,5444999,22.042573123641493,38.915267889095674,0.04602359392778499,950.3703007698059,354.5392105579376,1269.1567115783691,42023,5073,36950,36950,0,9,5445000.0
5445,5445999,22.04129995533907,38.91289437556653,0.04602950456429755,950.5040061473846,354.6020426750183,1269.6457481384277,42031,5073,36958,36958,0,9,5446000.0
5446,5446999,22.040276027326875,38.91117171559209,0.046036168393033816,950.7278861999512,354.66624212265015,1269.9437942504883,42042,5074,36968,36968,0,9,5447000.0
5447,5447999,22.039597169946912,38.91513965598445,0.04602611419004654,950.9528465270996,354.7299873828888,1270.1468124389648,42052,5075,36977,36977,0,9,5448000.0
5448,5448999,22.03887346817645,38.91468332623853,0.04602475879461365,951.1707875728607,354.79603004455566,1270.318115234375,42054,5076,36978,36978,0,9,5449000.0
5449,5449999,22.037731785172134,38.91218311790973,0.046025648909030714,951.5055375099182,354.86232352256775,1270.5075035095215,42061,5078,36983,36983,0,9,5450000.0
5450,5450999,22.03661160801183,38.91000160003701,0.04602637928568265,951.7344460487366,354.9264841079712,1270.6383514404297,42068,5079,36989,36989,0,9,5451000.0
5451,5451999,22.035626484617072,38.90831314608702,0.04602545056762064,951.8739249706268,354.9934334754944,1270.8721084594727,42069,5079,36990,36990,0,9,5452000.0
5452,5452999,22.034636723599085,38.90609448082587,0.04602242373051635,952.1053030490875,355.05925703048706,1271.034236907959,42072,5080,36992,36992,0,9,5453000.0
5453,5453999,22.033763339299334,38.90423053202099,0.046016600911872985,952.3298876285553,355.12451696395874,1271.1464614868164,42080,5081,36999,36999,0,9,5454000.0
5454,5454999,22.033254858312304,38.902810329056926,0.04600804332649022,952.5521092414856,355.18792366981506,1271.3339920043945,42084,5082,37002,37002,0,9,5455000.0
5455,5455999,22.03279951902523,38.901202662669995,0.046004350665016513,952.8728992938995,355.25154733657837,1271.3865394592285,42102,5084,37018,37018,0,9,5456000.0
5456,5456999,22.032402347622543,38.89969475016224,0.045995428872673716,953.1967813968658,355.31448101997375,1271.4927558898926,42106,5086,37020,37020,0,9,5457000.0
5457,5457999,22.032133882149264,38.89843958240103,0.045981760165762275,953.4115767478943,355.3764374256134,1271.6814231872559,42110,5087,37023,37023,0,9,5458000.0
5458,5458999,22.032364429478474,38.89937945528424,0.045964350526380815,953.725839138031,355.43921661376953,1271.796558380127,42129,5089,37040,37040,0,9,5459000.0
5459,5459999,22.032558247250595,38.90011505175235,0.0459426235013044,954.1513509750366,355.50220680236816,1271.8478775024414,42146,5092,37054,37054,0,9,5460000.0
5460,5460999,22.032977568657895,38.90012234471488,0.04591765907150824,954.2892646789551,355.5667550563812,1272.189167022705,42151,5092,37059,37059,0,9,5461000.0
5461,5461999,22.03330058257636,38.899619877738495,0.04590356490567682,954.5102651119232,355.62930488586426,1272.402946472168,42162,5093,37069,37069,0,9,5462000.0
5462,5462999,22.03305581968573,38.89842187767276,0.04589464208896832,954.7380719184875,355.6920144557953,1272.6115264892578,42177,5094,37083,37083,0,9,5463000.0
5463,5463999,22.032709418549448,38.89724384061065,0.045884158405381736,954.8715808391571,355.7559506893158,1272.906753540039,42180,5094,37086,37086,0,9,5464000.0
5464,5464999,22.032281210014002,38.89864940495733,0.04586978897911964,955.011125087738,355.82080149650574,1273.7277755737305,42205,5094,37111,37111,0,9,5465000.0
5465,5465999,22.030874909171924,38.896536712087645,0.04586897276164603,955.1404414176941,355.88424587249756,1274.29536819458,42220,5094,37126,37126,0,9,5466000.0
5466,5466999,22.029591029751348,38.894423829402136,0.045870939869356864,955.2701959609985,355.9514343738556,1274.6595001220703,42226,5094,37132,37132,0,9,5467000.0
5467,5467999,22.028552039480886,38.89311057815358,0.04586924922448732,955.5152397155762,356.02417063713074,1275.0763626098633,42246,5095,37151,37151,0,9,5468000.0
5468,5468999,22.02732614414579,38.89065607477355,0.045869160912236695,955.6475322246552,356.08716917037964,1275.3382568359375,42251,5095,37156,37156,0,9,5469000.0
5469,5469999,22.026366125217937,38.888660739693805,0.045865614568373014,955.7861576080322,356.1524498462677,1275.755428314209,42261,5095,37166,37166,0,9,5470000.0
5470,5470999,22.025390532110762,38.88677122790593,0.04586289569686819,956.0105888843536,356.2162892818451,1276.1121406555176,42273,5096,37177,37177,0,9,5471000.0
5471,5471999,22.024493452800257,38.8846590981248,0.04585857191098808,956.1316673755646,356.2803268432617,1276.401954650879,42278,5096,37182,37182,0,9,5472000.0
5472,5472999,22.02363773777354,38.88266389166394,0.045854924808813924,956.3577761650085,356.3426067829132,1276.6103591918945,42283,5097,37186,37186,0,9,5473000.0
5473,5473999,22.022900571968105,38.880961840473894,0.045853064521147346,956.4882342815399,356.40468764305115,1276.8723106384277,42286,5097,37189,37189,0,9,5474000.0
5474,5474999,22.021981106279288,38.87877790718286,0.04584665975550961,956.7076079845428,356.46673560142517,1276.9717254638672,42295,5098,37197,37197,0,9,5475000.0
5475,5475999,22.021615671493663,38.87709948294624,0.04583740455501151,956.9352586269379,356.5320451259613,1277.2595977783203,42303,5099,37204,37204,0,9,5476000.0
5476,5476999,22.02111097837703,38.87529461429708,0.04582859074923007,957.1585116386414,356.59454369544983,1277.4669723510742,42310,5100,37210,37210,0,9,5477000.0
5477,5477999,22.02091659933673,38.874546945606404,0.04581467067844769,957.3831384181976,356.66162753105164,1277.5882186889648,42318,5101,37217,37217,0,9,5478000.0
5478,5478999,22.02076256347808,38.87296513729384,0.0457967269061309,957.5104284286499,356.7245981693268,1277.8986358642578,42324,5101,37223,37223,0,9,5479000.0
5479,5479999,22.02058867606134,38.871463143806466,0.04578296996766906,957.6454756259918,356.7861738204956,1278.1320114135742,42327,5101,37226,37226,0,9,5480000.0
5480,5480999,22.020667771903756,38.870019522719005,0.04576266542479657,957.866448879242,356.8468704223633,1278.3039283752441,42331,5102,37229,37229,0,9,5481000.0
5481,5481999,22.020797916834645,38.868502155982945,0.045736194032253374,958.0894875526428,356.91004395484924,1278.5176887512207,42337,5103,37234,37234,0,9,5482000.0
5482,5482999,22.020870745081563,38.86723492673544,0.045710157905319626,958.326685667038,356.9755256175995,1278.7778358459473,42342,5104,37238,37238,0,9,5483000.0
5483,5483999,22.02054844712398,38.8653081878457,0.04569416094525702,958.6378586292267,357.0400757789612,1279.0869941711426,42370,5106,37264,37264,0,9,5484000.0
5484,5484999,22.019876169101728,38.86310165963205,0.04568136846301096,958.8542628288269,357.1021752357483,1279.4688262939453,42380,5107,37273,37273,0,9,5485000.0
5485,5485999,22.01939005802077,38.86163762390556,0.045670540215358435,959.0846192836761,357.16841435432434,1280.2822380065918,42414,5108,37306,37306,0,9,5486000.0
5486,5486999,22.017744180272214,38.858988205673676,0.045678019464993724,959.3123579025269,357.2353103160858,1280.7392120361328,42426,5109,37317,37317,0,9,5487000.0
5487,5487999,22.016639863077714,38.85940095365505,0.04567387438799375,959.5313446521759,357.29776263237,1280.9777526855469,42431,5110,37321,37321,0,9,5488000.0
5488,5488999,22.015360811863744,38.857087156715,0.04568053242919601,959.7792263031006,357.3624143600464,1281.252052307129,42444,5111,37333,37333,0,9,5489000.0
5489,5489999,22.01448629603429,38.85545297321096,0.04567796714924888,959.9038329124451,357.4269642829895,1281.4640274047852,42446,5111,37335,37335,0,9,5490000.0
5490,5490999,22.01389393994701,38.854557541085896,0.04567169741719235,960.1257004737854,357.4895737171173,1281.722068786621,42450,5112,37338,37338,0,9,5491000.0
5491,5491999,22.012961623250973,38.85243073646733,0.045672328890077774,960.245500087738,357.55157113075256,1281.9857635498047,42451,5112,37339,37339,0,9,5492000.0
5492,5492999,22.01233992431932,38.851014163525996,0.04567103732394018,960.4798047542572,357.61591815948486,1282.1837692260742,42462,5113,37349,37349,0,9,5493000.0
5493,5493999,22.01171689637129,38.84925051881915,0.045669792867561454,960.7113721370697,357.6813941001892,1282.3444709777832,42465,5114,37351,37351,0,9,5494000.0
5494,5494999,22.011193565520124,38.847564985363384,0.04567148718924374,960.8411748409271,357.7464756965637,1282.5572814941406,42466,5114,37352,37352,0,9,5495000.0
5495,5495999,22.010733768517454,38.84617965481027,0.04567104758339824,961.2596411705017,357.81086111068726,1282.512710571289,42488,5117,37371,37371,0,9,5496000.0
5496,5496999,22.010636210156918,38.84521232805965,0.04566956759537455,961.3915700912476,357.8728995323181,1282.7898483276367,42489,5117,37372,37372,0,9,5497000.0
5497,5497999,22.010320512329045,38.844005638603285,0.04566412922626917,961.6137218475342,357.9350483417511,1282.9461669921875,42493,5118,37375,37375,0,9,5498000.0
5498,5498999,22.010037658611147,38.842749820623034,0.04565923305602371,961.7472279071808,358.00059247016907,1283.2285194396973,42496,5118,37378,37378,0,9,5499000.0
5499,5499999,22.010009302542684,38.844538592609396,0.04565231532717284,961.8721415996552,358.06654357910156,1283.4245834350586,42496,5118,37378,37378,0,9,5500000.0
5500,5500999,22.010046909470997,38.85076161047208,0.045631671172268407,961.9980697631836,358.1279835700989,1283.734317779541,42500,5118,37382,37382,0,9,5501000.0
5501,5501999,22.00973343400505,38.849514078185145,0.04562586996380613,962.1298854351044,358.18915367126465,1283.949348449707,42501,5118,37383,37383,0,9,5502000.0
5502,5502999,22.00954313935984,38.848047687250116,0.045619775469645574,962.2520394325256,358.2527000904083,1284.108512878418,42501,5118,37383,37383,0,9,5503000.0
5503,5503999,22.00895575399789,38.84620335059356,0.04561444546109972,962.5728650093079,358.31529808044434,1284.3198165893555,42509,5120,37389,37389,0,9,5504000.0
5504,5504999,22.008242954885077,38.84404359752471,0.04561282196803251,962.7082417011261,358.37698340415955,1284.6214561462402,42512,5120,37392,37392,0,9,5505000.0
5505,5505999,22.007481127187372,38.84212790034021,0.04560667267827467,963.0280954837799,358.4419894218445,1285.0565147399902,42542,5122,37420,37420,0,9,5506000.0
5506,5506999,22.00599643486224,38.84007776300965,0.045608360820052374,963.2482876777649,358.5072066783905,1285.513759613037,42554,5123,37431,37431,0,9,5507000.0
5507,5507999,22.004619078673507,38.83830402601777,0.04560916473163534,963.3797330856323,358.5726282596588,1285.87158203125,42559,5123,37436,37436,0,9,5508000.0
5508,5508999,22.003377753009946,38.83624406243964,0.04561340872932407,963.5079367160797,358.6358439922333,1286.236011505127,42562,5123,37439,37439,0,9,5509000.0
5509,5509999,22.002227701269607,38.834105077390475,0.045616603513887855,963.6289687156677,358.6984839439392,1286.4555053710938,42563,5123,37440,37440,0,9,5510000.0
5510,5510999,22.000820458459565,38.831515555398035,0.045619313855115085,963.9548532962799,358.7617406845093,1286.5967063903809,42583,5125,37458,37458,0,9,5511000.0
5511,5511999,21.999355742938555,38.82886827650674,0.045626883791290096,964.2712190151215,358.82454776763916,1286.7431373596191,42610,5127,37483,37483,0,9,5512000.0
5512,5512999,21.998149173712253,38.826769553230356,0.04562798635248533,964.3913893699646,358.8885705471039,1286.9478569030762,42611,5127,37484,37484,0,9,5513000.0
5513,5513999,21.99690065041589,38.82428319620773,0.04562839696163912,964.6089460849762,358.95128631591797,1287.0613288879395,42613,5128,37485,37485,0,9,5514000.0
5514,5514999,21.995810596663194,38.821799732957295,0.04562899802494058,964.8254265785217,359.0132987499237,1287.2895011901855,42624,5129,37495,37495,0,9,5515000.0
5515,5515999,21.99546574038699,38.83575208804453,0.0455903575887574,964.9451785087585,359.07463574409485,1287.4843063354492,42624,5129,37495,37495,0,9,5516000.0
5516,5516999,21.994605667605345,38.833538420694175,0.04558763654440545,965.2534873485565,359.13697147369385,1287.6577110290527,42630,5131,37499,37499,0,9,5517000.0
5517,5517999,21.993845466858062,38.83146176827829,0.04558779905148458,965.3848853111267,359.2007465362549,1287.9151153564453,42632,5131,37501,37501,0,9,5518000.0
5518,5518999,21.99297004947092,38.829385423263304,0.04558186932803798,965.6007902622223,359.26288628578186,1288.100601196289,42650,5132,37518,37518,0,9,5519000.0
5519,5519999,21.99249341733968,38.82907459107629,0.04557255369580515,965.738064289093,359.32537293434143,1288.3500671386719,42650,5132,37518,37518,0,9,5520000.0
5520,5520999,21.992286766340236,38.827890956603866,0.045564161881898824,965.9484362602234,359.3870441913605,1288.5872955322266,42667,5133,37534,37534,0,9,5521000.0
5521,5521999,21.99213646721913,38.82693672507795,0.04555511920880717,966.0758082866669,359.4494013786316,1288.8131866455078,42668,5133,37535,37535,0,9,5522000.0
5522,5522999,21.99193007481829,38.82538077143242,0.04554745922993286,966.4806513786316,359.51289343833923,1288.8136711120605,42679,5136,37543,37543,0,9,5523000.0
5523,5523999,21.99173006920503,38.82408315555632,0.045537141166491546,966.6082699298859,359.57626032829285,1289.1832962036133,42683,5136,37547,37547,0,9,5524000.0
5524,5524999,21.9914392337175,38.82253344442999,0.04552818436692385,966.7303349971771,359.63844633102417,1289.3753280639648,42684,5136,37548,37548,0,9,5525000.0
5525,5525999,21.99095662947425,38.82048385757072,0.04552237209594645,966.9568247795105,359.7020299434662,1289.5681991577148,42692,5137,37555,37555,0,9,5526000.0
5526,5526999,21.98984602344513,38.81853746667774,0.04552525706421229,967.0853910446167,359.76574873924255,1290.3691368103027,42720,5137,37583,37583,0,9,5527000.0
5527,5527999,21.988417031851107,38.81719211228411,0.04548519541309759,967.3998637199402,359.82978677749634,1290.7603187561035,42744,5139,37605,37605,0,9,5528000.0
5528,5528999,21.987024493695603,38.81528905003931,0.04548941607360579,967.6134634017944,359.8920068740845,1291.0464477539062,42755,5140,37615,37615,0,9,5529000.0
5529,5529999,21.985741364612828,38.813211284258074,0.04549593474304481,967.8379039764404,359.95426058769226,1291.3563079833984,42769,5141,37628,37628,0,9,5530000.0
5530,5530999,21.984568482838387,38.812917511606464,0.04549477762183152,967.9739000797272,360.0170056819916,1291.5680122375488,42770,5141,37629,37629,0,9,5531000.0
5531,5531999,21.98326334199609,38.81073968030916,0.04549979157528494,968.0952091217041,360.0801856517792,1291.883731842041,42774,5141,37633,37633,0,9,5532000.0
5532,5532999,21.982019267671504,38.808483831923944,0.045499309510943164,968.3134453296661,360.1428813934326,1292.1129608154297,42787,5142,37645,37645,0,9,5533000.0
5533,5533999,21.980813247441866,38.806513590569274,0.04550154278339469,968.4243512153625,360.2024383544922,1292.392879486084,42791,5142,37649,37649,0,9,5534000.0
5534,5534999,21.979568086433016,38.80420783246032,0.045503445215829275,968.8449015617371,360.2646927833557,1292.457618713379,42810,5145,37665,37665,0,9,5535000.0
5535,5535999,21.978738285019862,38.80232255772631,0.04550343260474521,969.0587284564972,360.32701206207275,1292.6751136779785,42818,5146,37672,37672,0,9,5536000.0
5536,5536999,21.977960494615786,38.800533698755004,0.04550392048638929,969.17844581604,360.388710975647,1292.8035011291504,42818,5146,37672,37672,0,9,5537000.0
5537,5537999,21.977197161040102,38.79862870452873,0.04550010028015883,969.4937109947205,360.44887351989746,1292.9745750427246,42828,5148,37680,37680,0,9,5538000.0
5538,5538999,21.976597097057947,38.79705267019737,0.04549751605230756,969.6208560466766,360.51047682762146,1293.2548179626465,42830,5148,37682,37682,0,9,5539000.0
5539,5539999,21.97594761408814,38.79563528646817,0.04549162064522749,969.830235004425,360.570720911026,1293.400821685791,42832,5149,37683,37683,0,9,5540000.0
5540,5540999,21.975501238053745,38.7946083841607,0.04548556268060955,970.0581686496735,360.6361405849457,1293.6147766113281,42837,5150,37687,37687,0,9,5541000.0
5541,5541999,21.974897571938445,38.7930338913314,0.04548311786456016,970.1867861747742,360.7003138065338,1293.8445434570312,42838,5150,37688,37688,0,9,5542000.0
5542,5542999,21.974599419290218,38.791637641947155,0.04547121187086145,970.3255007266998,360.77430176734924,1294.0087432861328,42839,5150,37689,37689,0,9,5543000.0
5543,5543999,21.97447588593792,38.79047879719358,0.045462197582423536,970.5432591438293,360.83876395225525,1294.272834777832,42843,5151,37692,37692,0,9,5544000.0
5544,5544999,21.974123459340433,38.78912886437785,0.045455932207996486,970.7589354515076,360.90064764022827,1294.5138244628906,42846,5152,37694,37694,0,9,5545000.0
5545,5545999,21.973622186405212,38.78752428264781,0.04544918299175926,970.8794116973877,360.96149134635925,1294.6636543273926,42846,5152,37694,37694,0,9,5546000.0
5546,5546999,21.972910458491523,38.78570275137268,0.045444381850897386,971.0079438686371,361.0228443145752,1294.8994064331055,42847,5152,37695,37695,0,9,5547000.0
5547,5547999,21.971740460712965,38.78358657348167,0.04544763393765339,971.1410822868347,361.08815026283264,1295.5483932495117,42865,5152,37713,37713,0,9,5548000.0
5548,5548999,21.97026143567843,38.78238280746311,0.04544859631224418,971.3713812828064,361.15081214904785,1296.0156745910645,42882,5153,37729,37729,0,9,5549000.0
5549,5549999,21.9689213799194,38.780175506705184,0.045447676080608734,971.7805151939392,361.21590280532837,1296.1453895568848,42907,5156,37751,37751,0,9,5550000.0
5550,5550999,21.967524445560386,38.7778244894657,0.04545208576073634,971.9078004360199,361.27789664268494,1296.4585189819336,42908,5156,37752,37752,0,9,5551000.0
5551,5551999,21.966250874579995,38.775673367918024,0.04545449282746916,972.0307500362396,361.33934211730957,1296.6369895935059,42909,5156,37753,37753,0,9,5552000.0
5552,5552999,21.96495923204055,38.7732819306856,0.04545653079896306,972.1610593795776,361.4006760120392,1296.8347930908203,42909,5156,37753,37753,0,9,5553000.0
5553,5553999,21.963769362773473,38.77107969858446,0.04545812764597734,972.285231590271,361.4614679813385,1297.0637016296387,42911,5156,37755,37755,0,9,5554000.0
5554,5554999,21.96270529187055,38.769117570359256,0.04545614298802092,972.4110157489777,361.52230429649353,1297.284481048584,42912,5156,37756,37756,0,9,5555000.0
5555,5555999,21.96164214891778,38.76695867062965,0.045454544435070354,972.7329838275909,361.58436012268066,1297.3275299072266,42924,5158,37766,37766,0,9,5556000.0
5556,5556999,21.960913470672935,38.765236512331484,0.04545261609454454,973.0520539283752,361.64677906036377,1297.5088500976562,42937,5160,37777,37777,0,9,5557000.0
5557,5557999,21.960313453338358,38.76385928879955,0.04545394684009629,973.1797482967377,361.7119867801666,1297.6699562072754,42937,5160,37777,37777,0,9,5558000.0
5558,5558999,21.960275261716777,38.76375608547314,0.04545455605538962,973.2965524196625,361.77308917045593,1297.8558235168457,42938,5160,37778,37778,0,9,5559000.0
5559,5559999,21.960086005378017,38.762577226108895,0.04545149304251861,973.5126352310181,361.8369071483612,1297.924217224121,42940,5161,37779,37779,0,9,5560000.0
5560,5560999,21.959709720332338,38.761407066749065,0.04545438637157573,973.6358852386475,361.8979856967926,1298.0349884033203,42940,5161,37779,37779,0,9,5561000.0
5561,5561999,21.959796579756976,38.76129868848598,0.04545103609524581,973.7704093456268,361.96227288246155,1298.1923713684082,42941,5161,37780,37780,0,9,5562000.0
5562,5562999,21.960332163989897,38.76174114879536,0.045449147088403086,973.9974882602692,362.02434372901917,1298.3079719543457,42944,5162,37782,37782,0,9,5563000.0
5563,5563999,21.960582133819116,38.76124377724909,0.04544763703607335,974.1306960582733,362.0853822231293,1298.4417686462402,42946,5162,37784,37784,0,9,5564000.0
5564,5564999,21.961231528949988,38.76139961747345,0.045440492980022396,974.3567342758179,362.1471035480499,1298.5997772216797,42951,5163,37788,37788,0,9,5565000.0
5565,5565999,21.96146764758386,38.76070984460058,0.0454414075828663,974.5863425731659,362.20851588249207,1298.7600288391113,42956,5164,37792,37792,0,9,5566000.0
5566,5566999,21.961699438397687,38.75998486093219,0.045435690329203915,974.8198554515839,362.2705943584442,1298.855323791504,42965,5165,37800,37800,0,9,5567000.0
5567,5567999,21.961619913706656,38.758732695401314,0.04543238128894278,974.9424588680267,362.3328766822815,1299.040786743164,42966,5165,37801,37801,0,9,5568000.0
5568,5568999,21.960736590116216,38.75693502088858,0.045432141480572064,975.0820062160492,362.39917755126953,1300.063835144043,43008,5165,37843,37843,0,9,5569000.0
5569,5569999,21.959531545270426,38.75520293389412,0.04543841152076955,975.2086811065674,362.4636733531952,1300.8183517456055,43020,5165,37855,37855,0,9,5570000.0
5570,5570999,21.95820571923325,38.75305590761847,0.04544730215278192,975.4233636856079,362.5261776447296,1301.1661643981934,43026,5166,37860,37860,0,9,5571000.0
5571,5571999,21.957402376106145,38.75155599844448,0.04544787375208059,975.5470423698425,362.58872079849243,1301.4895248413086,43026,5166,37860,37860,0,9,5572000.0
5572,5572999,21.956463799733367,38.74971129151805,0.04545173219288878,975.679661989212,362.655907869339,1301.8319931030273,43028,5166,37862,37862,0,9,5573000.0
5573,5573999,21.95548335112888,38.7479945880853,0.04545056946506165,975.898758649826,362.7180070877075,1302.1426048278809,43033,5167,37866,37866,0,9,5574000.0
5574,5574999,21.95445078856821,38.746154421896485,0.045446288698498205,976.0180501937866,362.77963638305664,1302.5188446044922,43036,5167,37869,37869,0,9,5575000.0
5575,5575999,21.953367868858983,38.74415703948385,0.04544683509853742,976.1547708511353,362.8495557308197,1302.8367004394531,43036,5167,37869,37869,0,9,5576000.0
5576,5576999,21.952434229940124,38.74209723347068,0.04544458125578987,976.3804898262024,362.91526532173157,1303.1129302978516,43040,5168,37872,37872,0,9,5577000.0
5577,5577999,21.951573720287616,38.74028674816234,0.04543944552211021,976.5910806655884,362.9771373271942,1303.4155654907227,43045,5169,37876,37876,0,9,5578000.0
5578,5578999,21.951075255026943,38.740708553636054,0.045430307176810736,976.7156519889832,363.04178524017334,1303.6208267211914,43045,5169,37876,37876,0,9,5579000.0
5579,5579999,21.950134422844037,38.738409172278864,0.04543097899999482,977.023606300354,363.103942155838,1303.8766860961914,43055,5171,37884,37884,0,9,5580000.0
5580,5580999,21.94952541632369,38.73672443418304,0.04542614607366835,977.1507992744446,363.16674518585205,1304.2541961669922,43059,5171,37888,37888,0,9,5581000.0
5581,5581999,21.94900886045035,38.73472538891005,0.04542340484682972,977.3673272132874,363.23039174079895,1304.6189041137695,43073,5172,37901,37901,0,9,5582000.0
5582,5582999,21.94869955148781,38.73354091012247,0.04542527863553636,977.5852019786835,363.29259848594666,1305.023593902588,43081,5173,37908,37908,0,9,5583000.0
5583,5583999,21.9480898896156,38.73148180879837,0.04542388125946939,977.7001953125,363.355304479599,1305.4174308776855,43083,5173,37910,37910,0,9,5584000.0
5584,5584999,21.94749773083963,38.7294729577485,0.04541765013847221,977.8148410320282,363.4168584346771,1305.8094596862793,43087,5173,37914,37914,0,9,5585000.0
5585,5585999,21.946750958927648,38.7281305879531,0.045416839407463994,978.0387923717499,363.4798529148102,1306.5312385559082,43115,5174,37941,37941,0,9,5586000.0
5586,5586999,21.94573132485221,38.72714993501412,0.045416990629732146,978.1627576351166,363.54195976257324,1307.078742980957,43126,5174,37952,37952,0,9,5587000.0
5587,5587999,21.944531084609398,38.7251720355514,0.04543069118185117,978.2859356403351,363.606076002121,1307.4240684509277,43130,5174,37956,37956,0,9,5588000.0
5588,5588999,21.94341003873425,38.723082428640616,0.04544197890170254,978.8041479587555,363.67016315460205,1307.4063339233398,43153,5178,37975,37975,0,9,5589000.0
5589,5589999,21.94247566749838,38.721448939610646,0.04544867453473389,978.9268250465393,363.73472833633423,1307.7346649169922,43157,5178,37979,37979,0,9,5590000.0
5590,5590999,21.94139288466139,38.719747005490674,0.04544928460200881,979.0564124584198,363.79694271087646,1307.996280670166,43160,5178,37982,37982,0,9,5591000.0
5591,5591999,21.940296344336982,38.71762515730624,0.04545571868081921,979.1798830032349,363.859911441803,1308.193733215332,43161,5178,37983,37983,0,9,5592000.0
5592,5592999,21.93925195346173,38.71559443980079,0.04545555662705758,979.3028705120087,363.9241454601288,1308.344669342041,43161,5178,37983,37983,0,9,5593000.0
5593,5593999,21.9383274840532,38.71361586917366,0.045456040462327985,979.5327644348145,363.9861834049225,1308.4801788330078,43164,5179,37985,37985,0,9,5594000.0
5594,5594999,21.937775774263997,38.71262153619836,0.04545033885807548,979.6591789722443,364.0490267276764,1308.725227355957,43165,5179,37986,37986,0,9,5595000.0
5595,5595999,21.93715558477002,38.710836500971986,0.045443535888085584,979.7782022953033,364.1110577583313,1308.8925857543945,43165,5179,37986,37986,0,9,5596000.0
5596,5596999,21.93658796082036,38.709520819376415,0.04543551860605266,979.993848323822,364.17314529418945,1308.9743347167969,43168,5180,37988,37988,0,9,5597000.0
5597,5597999,21.93611257599384,38.70843014383615,0.04542840141515192,980.1130695343018,364.2345178127289,1309.124855041504,43168,5180,37988,37988,0,9,5598000.0
5598,5598999,21.935852788347542,38.70701968182358,0.045419553866830276,980.3461811542511,364.29684495925903,1309.221923828125,43177,5181,37996,37996,0,9,5599000.0
5599,5599999,21.93541286978292,38.70577956389252,0.04541097700021157,980.5850746631622,364.3596727848053,1309.2924575805664,43187,5182,38005,38005,0,9,5600000.0
5600,5600999,21.935084071554023,38.704450889020734,0.04540123130253959,980.7079372406006,364.42195534706116,1309.529685974121,43190,5182,38008,38008,0,9,5601000.0
5601,5601999,21.934999773357767,38.70482373450663,0.04539037167315674,980.8243324756622,364.4848096370697,1309.7070083618164,43191,5182,38009,38009,0,9,5602000.0
5602,5602999,21.934551591515135,38.70324792683439,0.04538211303569939,981.0444128513336,364.5465738773346,1309.8255653381348,43195,5183,38012,38012,0,9,5603000.0
5603,5603999,21.934092768035015,38.70168111084894,0.04537598501761597,981.2724657058716,364.6108844280243,1310.0360527038574,43207,5184,38023,38023,0,9,5604000.0
5604,5604999,21.933636992356313,38.70029086140011,0.04536977368864947,981.5117900371552,364.6821937561035,1310.1650924682617,43209,5185,38024,38024,0,9,5605000.0
5605,5605999,21.932540846749095,38.69981561078685,0.045372097950392654,981.7326645851135,364.7444944381714,1310.947353363037,43252,5186,38066,38066,0,9,5606000.0
5606,5606999,21.93106734315408,38.698043568258136,0.045376870255949386,981.8551309108734,364.8083474636078,1311.327838897705,43258,5186,38072,38072,0,9,5607000.0
5607,5607999,21.93002738062635,38.69644968387518,0.045380931045318706,981.9817349910736,364.8702471256256,1311.523681640625,43258,5186,38072,38072,0,9,5608000.0
5608,5608999,21.9289296202447,38.69446251104103,0.045388883936622104,982.2085874080658,364.932559967041,1311.7325019836426,43272,5187,38085,38085,0,9,5609000.0
5609,5609999,21.927992129713772,38.69264230464887,0.045393776089204474,982.4283654689789,364.99461126327515,1311.9533386230469,43279,5188,38091,38091,0,9,5610000.0
5610,5610999,21.927172029107705,38.69104957761102,0.04539666813701282,982.5599751472473,365.05643010139465,1312.1595306396484,43279,5188,38091,38091,0,9,5611000.0
5611,5611999,21.926367683293197,38.68944039857035,0.0453941521452037,982.870866060257,365.1186046600342,1312.318832397461,43291,5190,38101,38101,0,9,5612000.0
5612,5612999,21.925733660194364,38.68808516095298,0.04539579358235546,982.9900002479553,365.1805737018585,1312.5888137817383,43295,5190,38105,38105,0,9,5613000.0
5613,5613999,21.925207548144915,38.68705173839722,0.04539819947950774,983.2000677585602,365.2421417236328,1312.7435035705566,43304,5191,38113,38113,0,9,5614000.0
5614,5614999,21.924934555889383,38.686014019584874,0.04539945815252888,983.4146101474762,365.3034131526947,1312.8401222229004,43306,5192,38114,38114,0,9,5615000.0
5615,5615999,21.92454401369633,38.684656021455,0.04540146084222918,983.6323442459106,365.3668348789215,1312.9840850830078,43311,5193,38118,38118,0,9,5616000.0
5616,5616999,21.924413408613106,38.68426200389086,0.04539879443464556,983.7540316581726,365.42919421195984,1313.1389694213867,43311,5193,38118,38118,0,9,5617000.0
5617,5617999,21.924409138879128,38.685593423023874,0.045390064929436647,983.8889210224152,365.49841928482056,1313.3188591003418,43312,5193,38119,38119,0,9,5618000.0
5618,5618999,21.924796880529723,38.686541260053076,0.045388706013432256,984.0077743530273,365.55945086479187,1313.4418449401855,43312,5193,38119,38119,0,9,5619000.0
5619,5619999,21.925017700190125,38.68604773462657,0.04539062396261817,984.1466052532196,365.6211094856262,1313.6158409118652,43314,5193,38121,38121,0,9,5620000.0
5620,5620999,21.925527544141676,38.685449119462184,0.045392539079616157,984.2722408771515,365.6822018623352,1313.771312713623,43315,5193,38122,38122,0,9,5621000.0
5621,5621999,21.926203791821774,38.685435210152896,0.04539358704570973,984.4811220169067,365.7438790798187,1313.8728713989258,43326,5194,38132,38132,0,9,5622000.0
5622,5622999,21.926778544634626,38.68537987261423,0.045393080287758014,984.6013193130493,365.807555437088,1314.028564453125,43326,5194,38132,38132,0,9,5623000.0
5623,5623999,21.927177328424,38.68486932074062,0.04539154978308435,984.7318873405457,365.86920976638794,1314.2773742675781,43328,5194,38134,38134,0,9,5624000.0
5624,5624999,21.927558895051757,38.68424723047868,0.045390735475818844,984.8603465557098,365.9305737018585,1314.4526405334473,43330,5194,38136,38136,0,9,5625000.0
5625,5625999,21.926951041864967,38.682271285996976,0.04538977283658974,984.9983749389648,366.0024735927582,1314.6050262451172,43330,5194,38136,38136,0,9,5626000.0
5626,5626999,21.925567720717492,38.68104403936837,0.04539704553274104,985.1322889328003,366.0664005279541,1315.5984687805176,43364,5194,38170,38170,0,9,5627000.0
5627,5627999,21.92381673683702,38.67844103519517,0.04540761643545066,985.2519369125366,366.12920236587524,1316.0409317016602,43369,5194,38175,38175,0,9,5628000.0
5628,5628999,21.922346573105816,38.67672761380153,0.045417659900454876,985.3749632835388,366.19133138656616,1316.3149757385254,43371,5194,38177,38177,0,9,5629000.0
5629,5629999,21.9209242054197,38.67421503759555,0.04542983096421582,985.5924365520477,366.2544434070587,1316.550579071045,43383,5195,38188,38188,0,9,5630000.0
5630,5630999,21.91964638399489,38.67239207267558,0.045434832384686485,985.904016494751,366.31683564186096,1316.7226181030273,43405,5197,38208,38208,0,9,5631000.0
5631,5631999,21.918297876628998,38.67004473057828,0.045441924547766854,986.4126174449921,366.3803536891937,1316.8103103637695,43438,5201,38237,38237,0,9,5632000.0
5632,5632999,21.916772411721546,38.667400718013084,0.04544940467291336,986.6341614723206,366.44414353370667,1316.9995307922363,43447,5202,38245,38245,0,9,5633000.0
5633,5633999,21.915423774103214,38.66482889448753,0.045455085100516324,986.7568497657776,366.5110158920288,1317.3142356872559,43450,5202,38248,38248,0,9,5634000.0
5634,5634999,21.91439487307749,38.66288048197311,0.04546039330991314,987.0782814025879,366.5737807750702,1317.5429763793945,43483,5204,38279,38279,0,9,5635000.0
5635,5635999,21.913931223586697,38.66209862477457,0.045463004587015465,987.198793888092,366.6359269618988,1317.77836227417,43485,5204,38281,38281,0,9,5636000.0
5636,5636999,21.914040373986058,38.66283388882001,0.04546608829272425,987.3149774074554,366.69740891456604,1318.0835494995117,43488,5204,38284,38284,0,9,5637000.0
5637,5637999,21.91421393059722,38.66305955193972,0.04547224650886683,987.5504741668701,366.76581621170044,1318.24076461792,43491,5205,38286,38286,0,9,5638000.0
5638,5638999,21.91516399227005,38.66755511776598,0.04546750645813402,987.6652007102966,366.8274598121643,1318.5693092346191,43494,5205,38289,38289,0,9,5639000.0
5639,5639999,21.916987606758543,38.674052925132436,0.04546672390416295,987.8956029415131,366.89083099365234,1318.911563873291,43502,5206,38296,38296,0,9,5640000.0
5640,5640999,21.919018652484194,38.68076986189308,0.04546459479831999,988.120593547821,366.952721118927,1319.1571578979492,43508,5207,38301,38301,0,9,5641000.0
5641,5641999,21.920857385321085,38.68533898899008,0.04548594264720229,988.3319664001465,367.01505875587463,1319.384994506836,43518,5208,38310,38310,0,9,5642000.0
5642,5642999,21.92414201241633,38.69417841802401,0.0455200558057578,988.4533567428589,367.07772564888,1319.851432800293,43525,5208,38317,38317,0,9,5643000.0
5643,5643999,21.92638951718602,38.70026501275701,0.04555363874851537,988.7641825675964,367.1404232978821,1320.143970489502,43540,5210,38330,38330,0,9,5644000.0
5644,5644999,21.928553966769325,38.704875203897764,0.04556849785990702,988.978942155838,367.20242381095886,1320.4643745422363,43554,5211,38343,38343,0,9,5645000.0
5645,5645999,21.929642383870274,38.706957322306565,0.04556893601839018,989.1983137130737,367.26545000076294,1320.6628112792969,43557,5212,38345,38345,0,9,5646000.0
5646,5646999,21.928932519365926,38.70682564820628,0.045570744555698206,989.543571472168,367.33402371406555,1321.6173095703125,43605,5214,38391,38391,0,9,5647000.0
5647,5647999,21.92760728209529,38.70573260462892,0.045570504809160806,989.8559186458588,367.39778184890747,1322.06449508667,43637,5216,38421,38421,0,9,5648000.0
5648,5648999,21.9262399527406,38.704047963753396,0.0455773410751098,989.9793560504913,367.46038484573364,1322.3586730957031,43638,5216,38422,38422,0,9,5649000.0
5649,5649999,21.924855332204558,38.70183591755438,0.04558411711108801,990.1901350021362,367.5224070549011,1322.6748542785645,43645,5217,38428,38428,0,9,5650000.0
5650,5650999,21.923699738538318,38.70033991412746,0.04558484878373714,990.5071587562561,367.58729887008667,1322.885482788086,43663,5219,38444,38444,0,9,5651000.0
5651,5651999,21.922411997648144,38.698304129640306,0.04558566773991635,990.7352035045624,367.649374961853,1323.0341987609863,43672,5220,38452,38452,0,9,5652000.0
5652,5652999,21.92120251599021,38.69988443824006,0.045583083242421996,990.8545114994049,367.711519241333,1323.3158645629883,43674,5220,38454,38454,0,9,5653000.0
5653,5653999,21.919981833236708,38.697621193968715,0.045588795022870277,990.9742257595062,367.7729663848877,1323.6269760131836,43677,5220,38457,38457,0,9,5654000.0
5654,5654999,21.918865365568866,38.695516735925914,0.04559296614426245,991.2871382236481,367.83511114120483,1323.7692375183105,43691,5222,38469,38469,0,9,5655000.0
5655,5655999,21.918049405332216,38.69368599362036,0.045595885282200044,991.4167304039001,367.90109038352966,1324.0811195373535,43692,5222,38470,38470,0,9,5656000.0
5656,5656999,21.917409668162332,38.692551760175704,0.04559613299160026,991.5453834533691,367.96585512161255,1324.4260902404785,43696,5222,38474,38474,0,9,5657000.0
5657,5657999,21.916625235301872,38.690700243020366,0.04560411551663324,991.9612092971802,368.0282301902771,1324.4815101623535,43722,5225,38497,38497,0,9,5658000.0
5658,5658999,21.91599937754101,38.688917971402034,0.04560076363113885,992.1767003536224,368.09132266044617,1324.7402534484863,43726,5226,38500,38500,0,9,5659000.0
5659,5659999,21.91562509806074,38.68757496715776,0.04560184988251259,992.4970848560333,368.15502738952637,1324.982765197754,43734,5228,38506,38506,0,9,5660000.0
5660,5660999,21.91538546196574,38.68619620416435,0.04560726796237835,992.6115810871124,368.2165892124176,1325.240665435791,43734,5228,38506,38506,0,9,5661000.0
5661,5661999,21.915395591328537,38.685072406799634,0.04560148491977356,993.0389111042023,368.28222608566284,1325.4306831359863,43772,5231,38541,38541,0,9,5662000.0
5662,5662999,21.915757241552946,38.68603854194064,0.04559455550500746,993.2521297931671,368.34419655799866,1325.7451934814453,43783,5232,38551,38551,0,9,5663000.0
5663,5663999,21.91608925341858,38.68566006365571,0.04559329327749484,993.4702892303467,368.40687465667725,1325.9459114074707,43795,5233,38562,38562,0,9,5664000.0
5664,5664999,21.915976727664926,38.6844190202295,0.0455954584327013,993.6857197284698,368.46885085105896,1326.2560920715332,43801,5234,38567,38567,0,9,5665000.0
5665,5665999,21.916242523675027,38.6836375758474,0.045592688901295975,994.0989935398102,368.5338542461395,1326.5827560424805,43830,5237,38593,38593,0,9,5666000.0
5666,5666999,21.915502636959644,38.68183667188127,0.04559287616678365,994.3270509243011,368.59877705574036,1327.3218574523926,43859,5238,38621,38621,0,9,5667000.0
5667,5667999,21.913991325563497,38.679799946043175,0.045595005003991496,994.548641204834,368.66241216659546,1327.9187850952148,43888,5239,38649,38649,0,9,5668000.0
5668,5668999,21.912357247877374,38.67712252533182,0.045598900696032785,994.6774842739105,368.7258665561676,1328.4501152038574,43894,5239,38655,38655,0,9,5669000.0
5669,5669999,21.91092432096722,38.67465807112136,0.04560635114654743,994.8984885215759,368.7890901565552,1328.7338752746582,43907,5240,38667,38667,0,9,5670000.0
5670,5670999,21.909713764766664,38.67320564176441,0.04560908162164701,995.1165721416473,368.8513979911804,1328.9357109069824,43917,5241,38676,38676,0,9,5671000.0
5671,5671999,21.908191529512692,38.67064977869856,0.045614842497326835,995.2426359653473,368.91371297836304,1329.150936126709,43917,5241,38676,38676,0,9,5672000.0
5672,5672999,21.90675599481694,38.66817210657615,0.04562052179417231,995.459353685379,368.9762873649597,1329.3200416564941,43927,5242,38685,38685,0,9,5673000.0
5673,5673999,21.90557942361854,38.666213678068964,0.04562644521215897,995.5775730609894,369.03992676734924,1329.512435913086,43927,5242,38685,38685,0,9,5674000.0
5674,5674999,21.904672917339173,38.664979727504104,0.04563179491120173,995.9094998836517,369.10377764701843,1329.7272758483887,43948,5244,38704,38704,0,9,5675000.0
5675,5675999,21.904109965231243,38.66521493172275,0.045635948358869305,996.0298285484314,369.16697669029236,1330.0227241516113,43952,5244,38708,38708,0,9,5676000.0
5676,5676999,21.904205155504783,38.66677556223583,0.045653672062943684,996.2415907382965,369.2286913394928,1330.1741752624512,43955,5245,38710,38710,0,9,5677000.0
5677,5677999,21.90470442899471,38.668902909457714,0.04566389101402768,996.4617464542389,369.2907385826111,1330.444736480713,43959,5246,38713,38713,0,9,5678000.0
5678,5678999,21.905272998926122,38.67050630670951,0.045680304378339365,996.6820199489594,369.35357785224915,1330.5460090637207,43962,5247,38715,38715,0,9,5679000.0
5679,5679999,21.905889427543006,38.67230496841281,0.04569450516826279,997.0015637874603,369.4161686897278,1330.6577987670898,43968,5249,38719,38719,0,9,5680000.0
5680,5680999,21.90678953572428,38.67476727290208,0.045722723168135526,997.1163680553436,369.47839975357056,1330.9394149780273,43969,5249,38720,38720,0,9,5681000.0
5681,5681999,21.907962918197573,38.67767296576768,0.045753737869431266,997.2445011138916,369.5406494140625,1331.0873413085938,43969,5249,38720,38720,0,9,5682000.0
5682,5682999,21.908870716139244,38.67899653726893,0.04579521612651716,997.5707967281342,369.6041522026062,1331.0899467468262,43990,5251,38739,38739,0,9,5683000.0
5683,5683999,21.910440221416277,38.68155192703865,0.04582769841767487,997.6879894733429,369.6659209728241,1331.3353958129883,43990,5251,38739,38739,0,9,5684000.0
5684,5684999,21.911880928595643,38.68410501297383,0.045860967665042884,997.8058853149414,369.72740626335144,1331.5240936279297,43991,5251,38740,38740,0,9,5685000.0
5685,5685999,21.9134885007091,38.688917869460916,0.04586114831264021,997.925589799881,369.78721809387207,1331.6865844726562,43991,5251,38740,38740,0,9,5686000.0
5686,5686999,21.914342744331105,38.6896012715154,0.04587984768151798,998.2689752578735,369.8528263568878,1331.809310913086,44007,5253,38754,38754,0,9,5687000.0
5687,5687999,21.91423807617998,38.689630448738946,0.04588145168674351,998.5779592990875,369.91507744789124,1332.5639190673828,44049,5255,38794,38794,0,9,5688000.0
5688,5688999,21.912720650930765,38.68742757759567,0.04588786494459607,998.6963655948639,369.97608757019043,1333.1704368591309,44060,5255,38805,38805,0,9,5689000.0
5689,5689999,21.911153464362407,38.6854335652258,0.04589220971244079,998.9250361919403,370.03907895088196,1333.4582748413086,44064,5256,38808,38808,0,9,5690000.0
5690,5690999,21.90975095492867,38.68359316508894,0.045897953851819606,999.1459035873413,370.1015317440033,1333.7452812194824,44076,5257,38819,38819,0,9,5691000.0
5691,5691999,21.908598705633334,38.681747396574494,0.045899658772835306,999.2793025970459,370.1637487411499,1333.954360961914,44077,5257,38820,38820,0,9,5692000.0
5692,5692999,21.90765976967444,38.68003240253138,0.045897198602916744,999.607225894928,370.22815346717834,1334.124366760254,44097,5259,38838,38838,0,9,5693000.0
5693,5693999,21.906530647455522,38.67813064437914,0.045897912569758725,999.7260749340057,370.2921073436737,1334.4072189331055,44099,5259,38840,38840,0,9,5694000.0
5694,5694999,21.905847392049967,38.67687491670855,0.045895296653356454,999.9428460597992,370.3541967868805,1334.7031021118164,44113,5260,38853,38853,0,9,5695000.0
5695,5695999,21.905019620500173,38.67563398294143,0.04589645788006258,1000.1535677909851,370.4170036315918,1334.9396743774414,44121,5261,38860,38860,0,9,5696000.0
5696,5696999,21.90467806673974,38.67490298540938,0.04589320251018647,1000.3835344314575,370.48137879371643,1335.2160606384277,44126,5262,38864,38864,0,9,5697000.0
5697,5697999,21.9043297887717,38.6746591002716,0.04588874146868904,1000.5979816913605,370.5430905818939,1335.4112243652344,44137,5263,38874,38874,0,9,5698000.0
5698,5698999,21.903924518571916,38.673736651230314,0.04588542679134755,1000.7179021835327,370.6044702529907,1335.7222747802734,44139,5263,38876,38876,0,9,5699000.0
5699,5699999,21.904017475627853,38.6762970299764,0.04587437485754797,1000.8494040966034,370.66872477531433,1335.9778518676758,44141,5263,38878,38878,0,9,5700000.0
5700,5700999,21.904093922230413,38.67591722381146,0.04587053844119238,1000.9669034481049,370.7305989265442,1336.1837615966797,44142,5263,38879,38879,0,9,5701000.0
5701,5701999,21.904454729436452,38.67611564604242,0.045861183926867,1001.0900068283081,370.7919578552246,1336.417221069336,44143,5263,38880,38880,0,9,5702000.0
5702,5702999,21.90461858273979,38.67547385931427,0.04585689732524434,1001.2217080593109,370.8561418056488,1336.5927391052246,44143,5263,38880,38880,0,9,5703000.0
5703,5703999,21.904978377872414,38.675250669556895,0.045848770258093086,1001.4407367706299,370.91783618927,1336.6962890625,44154,5264,38890,38890,0,9,5704000.0
5704,5704999,21.90538878271123,38.674755707715775,0.04584584706210071,1001.5667057037354,370.9798698425293,1336.9051971435547,44155,5264,38891,38891,0,9,5705000.0
5705,5705999,21.905684494231824,38.675601657695346,0.04583570432735795,1001.8985843658447,371.0460135936737,1337.007396697998,44167,5266,38901,38901,0,9,5706000.0
5706,5706999,21.90595435208484,38.675002003785444,0.04583351428058002,1002.232123374939,371.10800671577454,1337.0401000976562,44186,5268,38918,38918,0,9,5707000.0
5707,5707999,21.90606980352509,38.674133597700326,0.04582589176001162,1002.357391834259,371.17204189300537,1337.2407188415527,44187,5268,38919,38919,0,9,5708000.0
5708,5708999,21.905339862381773,38.67241702001724,0.04582532572418507,1002.5798480510712,371.2359302043915,1338.1089668273926,44222,5269,38953,38953,0,9,5709000.0
5709,5709999,21.904014962485714,38.67077975793642,0.04583292625355995,1002.7059926986694,371.29939556121826,1338.8431015014648,44239,5269,38970,38970,0,9,5710000.0
5710,5710999,21.902859255000532,38.67007591640807,0.045836495387772125,1002.8203518390656,371.3614544868469,1339.138011932373,44240,5269,38971,38971,0,9,5711000.0
5711,5711999,21.901755917323918,38.66868482453465,0.045841325660596954,1002.9349024295807,371.4243152141571,1339.4971237182617,44244,5269,38975,38975,0,9,5712000.0
5712,5712999,21.900624297271783,38.66723807087858,0.04584431583919857,1003.0666983127594,371.48653411865234,1339.7556953430176,44244,5269,38975,38975,0,9,5713000.0
5713,5713999,21.89917848111128,38.66465958678456,0.04585475325724808,1003.1923551559448,371.5524711608887,1340.0068244934082,44246,5269,38977,38977,0,9,5714000.0
5714,5714999,21.89796929786858,38.66252205160339,0.04586176876871484,1003.3296077251434,371.6255795955658,1340.3013305664062,44249,5269,38980,38980,0,9,5715000.0
5715,5715999,21.896957913949013,38.66101590752389,0.04586475728374917,1003.5511264801025,371.6904249191284,1340.491958618164,44257,5270,38987,38987,0,9,5716000.0
5716,5716999,21.895756606317036,38.65905282763005,0.045871770820209434,1003.8824529647827,371.75251483917236,1340.6859321594238,44271,5272,38999,38999,0,9,5717000.0
5717,5717999,21.894618932231527,38.656794875290664,0.04587792896650744,1004.0990867614746,371.8165853023529,1340.936923980713,44282,5273,39009,39009,0,9,5718000.0
5718,5718999,21.893517827974648,38.654452544019016,0.04588319535043561,1004.3276970386505,371.881117105484,1341.051528930664,44284,5274,39010,39010,0,9,5719000.0
5719,5719999,21.892668498399125,38.65264624344865,0.04588656484566089,1004.5463421344757,371.94354128837585,1341.1778678894043,44296,5275,39021,39021,0,9,5720000.0
5720,5720999,21.89193721360686,38.65073567223983,0.04589287850523882,1004.6609420776367,372.00480794906616,1341.3870735168457,44296,5275,39021,39021,0,9,5721000.0
5721,5721999,21.891530082503852,38.64916857558257,0.04589111681397895,1004.8812863826752,372.0666038990021,1341.6349258422852,44301,5276,39025,39025,0,9,5722000.0
5722,5722999,21.891145086111806,38.64752533899638,0.045887526235072196,1005.0002229213715,372.1279900074005,1341.9271621704102,44302,5276,39026,39026,0,9,5723000.0
5723,5723999,21.890812061428445,38.64586812787533,0.045887828960268884,1005.2287969589233,372.19126439094543,1342.1970710754395,44313,5277,39036,39036,0,9,5724000.0
5724,5724999,21.889797710526658,38.64354080440357,0.045896556621856766,1005.3550937175751,372.25310349464417,1342.7096061706543,44319,5277,39042,39042,0,9,5725000.0
5725,5725999,21.88901924487988,38.64250809602088,0.04590187625581221,1005.4816892147064,372.3156199455261,1343.4726181030273,44342,5277,39065,39065,0,9,5726000.0
5726,5726999,21.887662211065113,38.64048591484174,0.045904490296197364,1005.602151632309,372.3784122467041,1344.0950164794922,44354,5277,39077,39077,0,9,5727000.0
5727,5727999,21.886612093251372,38.639736636815265,0.04591101970167599,1005.8179442882538,372.44072222709656,1344.4396171569824,44365,5278,39087,39087,0,9,5728000.0
5728,5728999,21.885605989963604,38.639406740165896,0.04591471903190558,1005.9377870559692,372.50284910202026,1344.7130432128906,44367,5278,39089,39089,0,9,5729000.0
5729,5729999,21.884711346459707,38.63801379357485,0.045917548007170295,1006.0705137252808,372.56809854507446,1345.0188179016113,44368,5278,39090,39090,0,9,5730000.0
5730,5730999,21.88410183588249,38.63752932879884,0.04591005933872139,1006.4969084262848,372.6304886341095,1345.1696510314941,44383,5281,39102,39102,0,9,5731000.0
5731,5731999,21.88327986910638,38.63604863008354,0.04591394513800506,1006.6144711971283,372.6954655647278,1345.4796600341797,44386,5281,39105,39105,0,9,5732000.0
5732,5732999,21.882313426005798,38.63414725150161,0.04591372646370273,1006.7325620651245,372.75749802589417,1345.7043342590332,44386,5281,39105,39105,0,9,5733000.0
5733,5733999,21.881466355493465,38.632293757295216,0.04591130686629108,1006.948766708374,372.8191866874695,1345.9708862304688,44391,5282,39109,39109,0,9,5734000.0
5734,5734999,21.88114236560346,38.63198009563346,0.045901747896168854,1007.1639409065247,372.8816316127777,1346.1479377746582,44401,5283,39118,39118,0,9,5735000.0
5735,5735999,21.880609942659294,38.63063402158507,0.04589819692731412,1007.3821196556091,372.9435317516327,1346.3304061889648,44411,5284,39127,39127,0,9,5736000.0
5736,5736999,21.879937497690893,38.62923693478387,0.04589461158686492,1007.618367433548,373.00829339027405,1346.4576568603516,44424,5285,39139,39139,0,9,5737000.0
5737,5737999,21.879353229114272,38.62767595856123,0.04589060481733653,1007.9396748542786,373.07132720947266,1346.6460266113281,44436,5287,39149,39149,0,9,5738000.0
5738,5738999,21.879155396012923,38.62738123345495,0.045883816183010406,1008.1631760597229,373.13303446769714,1346.7803421020508,44438,5288,39150,39150,0,9,5739000.0
5739,5739999,21.879154673249094,38.62741027429495,0.045873327381112494,1008.2810490131378,373.19503474235535,1347.0229415893555,44440,5288,39152,39152,0,9,5740000.0
5740,5740999,21.878707250971875,38.62588002139348,0.045865989189474154,1008.3957424163818,373.25640511512756,1347.2106475830078,44441,5288,39153,39153,0,9,5741000.0
5741,5741999,21.878720885864414,38.62496297047311,0.04585994854562836,1008.5245594978333,373.31832909584045,1347.4046897888184,44442,5288,39154,39154,0,9,5742000.0
5742,5742999,21.878895856432926,38.624432645620274,0.04585258206492149,1008.8524327278137,373.38290667533875,1347.502685546875,44452,5290,39162,39162,0,9,5743000.0
5743,5743999,21.87902481713949,38.62372107144109,0.04584882807569668,1008.9818270206451,373.44441199302673,1347.7083930969238,44453,5290,39163,39163,0,9,5744000.0
5744,5744999,21.879157349053667,38.62536013752632,0.045837559038133024,1009.1002788543701,373.5057122707367,1347.9138145446777,44453,5290,39163,39163,0,9,5745000.0
5745,5745999,21.878240524787316,38.623494214046474,0.045831287078602956,1009.4232730865479,373.5697057247162,1348.717197418213,44506,5292,39214,39214,0,9,5746000.0
5746,5746999,21.8778255837423,38.623808735229844,0.04584898540485871,1009.6391580104828,373.63298058509827,1349.1814155578613,44519,5293,39226,39226,0,9,5747000.0
5747,5747999,21.87778748597953,38.62511418318007,0.045850713065517135,1009.7686121463776,373.6949043273926,1349.4850769042969,44520,5293,39227,39227,0,9,5748000.0
5748,5748999,21.877777373146706,38.62513860520503,0.04585163717775875,1009.9914252758026,373.7581841945648,1349.7456359863281,44526,5294,39232,39232,0,9,5749000.0
5749,5749999,21.877821803728324,38.62519131676631,0.04585917568036735,1010.1144556999207,373.819620847702,1349.919548034668,44526,5294,39232,39232,0,9,5750000.0
5750,5750999,21.877566753680412,38.62438248144207,0.04585750619977946,1010.3415250778198,373.8819615840912,1350.1181297302246,44554,5295,39259,39259,0,9,5751000.0
5751,5751999,21.877541791248426,38.62385458898562,0.04585669508973411,1010.5659973621368,373.9446678161621,1350.3476905822754,44566,5296,39270,39270,0,9,5752000.0
5752,5752999,21.87804231092972,38.62460028044236,0.04585380698303232,1010.6853156089783,374.00677275657654,1350.5687713623047,44568,5296,39272,39272,0,9,5753000.0
5753,5753999,21.87818007319028,38.62399225076229,0.04585399493864939,1011.0109679698944,374.06903743743896,1350.6000785827637,44588,5298,39290,39290,0,9,5754000.0
5754,5754999,21.879021936137352,38.624570263966795,0.04585581953340867,1011.2372760772705,374.13187766075134,1350.8529624938965,44593,5299,39294,39294,0,9,5755000.0
5755,5755999,21.879568853601334,38.62539592142526,0.04586573107073888,1011.4580185413361,374.1925730705261,1351.0673332214355,44611,5300,39311,39311,0,9,5756000.0
5756,5756999,21.88061172549671,38.62647050939996,0.04587882627651452,1011.7681379318237,374.2551302909851,1351.1236763000488,44623,5302,39321,39321,0,9,5757000.0
5757,5757999,21.88193444825696,38.62915165876683,0.04590030647063281,1011.9881467819214,374.31713461875916,1351.4648971557617,44636,5303,39333,39333,0,9,5758000.0
5758,5758999,21.883395969445015,38.63179246943023,0.045924385955326996,1012.2107746601105,374.37899470329285,1351.6907005310059,44640,5304,39336,39336,0,9,5759000.0
5759,5759999,21.885323048696904,38.63623065371217,0.04596258362265215,1012.3293600082397,374.44373750686646,1351.8603706359863,44640,5304,39336,39336,0,9,5760000.0
5760,5760999,21.887310823691198,38.639574586937634,0.045990156874589516,1012.6538279056549,374.5062606334686,1351.9805183410645,44653,5306,39347,39347,0,9,5761000.0
5761,5761999,21.88974006691654,38.64618232249701,0.04602310758674977,1012.8705205917358,374.5693349838257,1352.212329864502,44657,5307,39350,39350,0,9,5762000.0
5762,5762999,21.89219717903119,38.65020304555479,0.046047838580794864,1013.1850481033325,374.6310324668884,1352.2339897155762,44676,5309,39367,39367,0,9,5763000.0
5763,5763999,21.89385841098385,38.6523841685697,0.046056972034879684,1013.3024294376373,374.691223859787,1352.5131072998047,44677,5309,39368,39368,0,9,5764000.0
5764,5764999,21.89491607298868,38.65258026873481,0.046059584668751596,1013.5207374095917,374.75204396247864,1352.7862739562988,44685,5310,39375,39375,0,9,5765000.0
5765,5765999,21.89536576382259,38.652759032049914,0.04606655870570875,1013.6375529766083,374.8131618499756,1353.3906593322754,44702,5310,39392,39392,0,9,5766000.0
5766,5766999,21.894495300514908,38.65224311715382,0.04606327196144888,1013.764906167984,374.8767054080963,1353.9460639953613,44714,5310,39404,39404,0,9,5767000.0
5767,5767999,21.893581284137188,38.650874941309915,0.04605909566635635,1013.9895370006561,374.9385461807251,1354.3429679870605,44725,5311,39414,39414,0,9,5768000.0
5768,5768999,21.892654640101494,38.64896655109973,0.04605882387567073,1014.2326576709747,375.0114207267761,1354.6631889343262,44736,5312,39424,39424,0,9,5769000.0
5769,5769999,21.891867187219727,38.64741716533517,0.046059340392279435,1014.4582483768463,375.0750699043274,1354.921054840088,44746,5313,39433,39433,0,9,5770000.0
5770,5770999,21.890969920478344,38.64563864891449,0.04605541485773135,1014.6821758747101,375.137836933136,1355.2287254333496,44751,5314,39437,39437,0,9,5771000.0
5771,5771999,21.89019686132943,38.64387860896803,0.0460492885403011,1014.9106788635254,375.20101737976074,1355.6111030578613,44757,5315,39442,39442,0,9,5772000.0
5772,5772999,21.88947423125126,38.642029392899964,0.04604261786065311,1015.0278415679932,375.2612063884735,1355.945629119873,44758,5315,39443,39443,0,9,5773000.0
5773,5773999,21.888773924995178,38.64005886194006,0.04603870315607583,1015.1446535587311,375.32337713241577,1356.193271636963,44759,5315,39444,39444,0,9,5774000.0
5774,5774999,21.88813250374701,38.638197501111804,0.046033204101000647,1015.2700564861298,375.38501930236816,1356.4646911621094,44761,5315,39446,39446,0,9,5775000.0
5775,5775999,21.887697611862492,38.636419861002786,0.04601820261760636,1015.4953134059906,375.44742226600647,1356.6183967590332,44771,5316,39455,39455,0,9,5776000.0
5776,5776999,21.887520225323662,38.6349230366451,0.046003461227272946,1015.7175161838531,375.5096580982208,1356.864818572998,44775,5317,39458,39458,0,9,5777000.0
5777,5777999,21.887424624997692,38.63353451253064,0.045985727002632926,1015.9365861415863,375.572390794754,1357.078353881836,44793,5318,39475,39475,0,9,5778000.0
5778,5778999,21.887493167127563,38.63237258591549,0.04596836921044056,1016.2681400775909,375.6377274990082,1357.1762771606445,44798,5320,39478,39478,0,9,5779000.0
5779,5779999,21.887742162523487,38.63168792541392,0.04594885729951137,1016.3923757076263,375.7002546787262,1357.4887008666992,44800,5320,39480,39480,0,9,5780000.0
5780,5780999,21.88802394266381,38.6306814550885,0.045924188836975466,1016.6074709892273,375.76142740249634,1357.6818389892578,44810,5321,39489,39489,0,9,5781000.0
5781,5781999,21.888694191013222,38.629937285484665,0.04588917930689973,1016.9402937889099,375.8265438079834,1357.8567008972168,44829,5323,39506,39506,0,9,5782000.0
5782,5782999,21.889282569405445,38.62921121953781,0.04586035692983126,1017.1659471988678,375.89132952690125,1358.0529708862305,44831,5324,39507,39507,0,9,5783000.0
5783,5783999,21.88951599748181,38.62812895492186,0.04583684622034623,1017.2864730358124,375.952383518219,1358.3828468322754,44835,5324,39511,39511,0,9,5784000.0
5784,5784999,21.88969180850951,38.62676210519488,0.04581545013614863,1017.6197872161865,376.01728892326355,1358.6655197143555,44846,5326,39520,39520,0,9,5785000.0
5785,5785999,21.889646455821246,38.625797887420525,0.04580021151217495,1017.8301708698273,376.0786347389221,1358.854335784912,44848,5327,39521,39521,0,9,5786000.0
5786,5786999,21.88845056253903,38.623436834816665,0.045797780490386075,1018.0529143810272,376.14139223098755,1359.6133575439453,44883,5328,39555,39555,0,9,5787000.0
5787,5787999,21.8873084554431,38.62151477659433,0.04579316591625027,1018.1745100021362,376.204936504364,1360.015380859375,44886,5328,39558,39558,0,9,5788000.0
5788,5788999,21.886159778884075,38.6193686573324,0.04578714159433017,1018.3098948001862,376.26758456230164,1360.2670669555664,44886,5328,39558,39558,0,9,5789000.0
5789,5789999,21.885377051587056,38.618429778499156,0.04577299615708608,1018.4363415241241,376.329163312912,1360.5093231201172,44886,5328,39558,39558,0,9,5790000.0
5790,5790999,21.884594626750022,38.617169770360114,0.04576056376750115,1018.7559850215912,376.3913116455078,1360.6540641784668,44907,5330,39577,39577,0,9,5791000.0
5791,5791999,21.883650283023353,38.61530650517063,0.045753160121626224,1019.076990365982,376.4543766975403,1360.8401679992676,44917,5332,39585,39585,0,9,5792000.0
5792,5792999,21.882762594078244,38.61328520733958,0.04574414787723646,1019.1971461772919,376.5158677101135,1360.9974899291992,44917,5332,39585,39585,0,9,5793000.0
5793,5793999,21.882158514267278,38.611962185427046,0.04573535599730516,1019.3214385509491,376.57716512680054,1361.2281494140625,44920,5332,39588,39588,0,9,5794000.0
5794,5794999,21.8816831653116,38.61032482111091,0.04572521612066549,1019.5434188842773,376.6387755870819,1361.3992156982422,44925,5333,39592,39592,0,9,5795000.0
5795,5795999,21.881244977432548,38.60932494490586,0.04571656522410872,1019.6667749881744,376.69988679885864,1361.5965194702148,44925,5333,39592,39592,0,9,5796000.0
5796,5796999,21.880654432469743,38.607538393612764,0.04571456796927198,1019.8920168876648,376.7619230747223,1361.7907409667969,44937,5334,39603,39603,0,9,5797000.0
5797,5797999,21.880476219607726,38.606869685927514,0.04571292618719902,1020.1131207942963,376.82331562042236,1361.889560699463,44941,5335,39606,39606,0,9,5798000.0
5798,5798999,21.88022209125442,38.605722971164134,0.0457090776531881,1020.4420490264893,376.8852469921112,1361.9683265686035,44955,5337,39618,39618,0,9,5799000.0
5799,5799999,21.880222865509488,38.60493754779975,0.045706497501734056,1020.6542227268219,376.9467399120331,1362.149787902832,44966,5338,39628,39628,0,9,5800000.0
5800,5800999,21.8798717252142,38.60347366549273,0.04569971515137461,1020.7775821685791,377.0087914466858,1362.3322143554688,44968,5338,39630,39630,0,9,5801000.0
5801,5801999,21.8798350431339,38.602464657427845,0.04569571233048142,1021.0033059120178,377.07303953170776,1362.4930114746094,44970,5339,39631,39631,0,9,5802000.0
5802,5802999,21.879820041025077,38.601412116442056,0.04568125368829745,1021.1250092983246,377.13622426986694,1362.8012008666992,44974,5339,39635,39635,0,9,5803000.0
5803,5803999,21.879688171763153,38.60049997905657,0.04567762553999932,1021.2501909732819,377.1982431411743,1363.01167678833,44976,5339,39637,39637,0,9,5804000.0
5804,5804999,21.879362920309248,38.59900712341815,0.04567229146070817,1021.4739985466003,377.26002764701843,1363.1472625732422,44985,5340,39645,39645,0,9,5805000.0
5805,5805999,21.87886259585738,38.59708731291401,0.045663475000982556,1021.5988237857819,377.32292890548706,1363.3564758300781,44987,5340,39647,39647,0,9,5806000.0
5806,5806999,21.878075668052723,38.594983951627434,0.045655144813970594,1021.72345495224,377.387610912323,1363.9669075012207,45006,5340,39666,39666,0,9,5807000.0
5807,5807999,21.876948827094647,38.59372103689199,0.0456478626802056,1021.9511752128601,377.4513874053955,1364.4827499389648,45018,5341,39677,39677,0,9,5808000.0
5808,5808999,21.87597290710929,38.59251571264098,0.04565013541490692,1022.0729115009308,377.51387882232666,1364.9282188415527,45022,5341,39681,39681,0,9,5809000.0
5809,5809999,21.875175085541144,38.590891224394476,0.04565594643426274,1022.3075757026672,377.5772531032562,1365.2277221679688,45036,5342,39694,39694,0,9,5810000.0
5810,5810999,21.874422754173537,38.58940495441008,0.04565126499618,1022.5457422733307,377.6430721282959,1365.4142227172852,45038,5343,39695,39695,0,9,5811000.0
5811,5811999,21.873595369631055,38.58829937775066,0.04564326142595576,1022.679034948349,377.71299862861633,1365.6471633911133,45038,5343,39695,39695,0,9,5812000.0
5812,5812999,21.872889529678552,38.5872396547225,0.0456391219170601,1022.9021453857422,377.7764027118683,1365.776512145996,45040,5344,39696,39696,0,9,5813000.0
5813,5813999,21.872216796368345,38.58578830984705,0.04563441553016234,1023.1297428607941,377.83949995040894,1365.993667602539,45053,5345,39708,39708,0,9,5814000.0
5814,5814999,21.871767036833827,38.584574990878494,0.04563336238612603,1023.2680943012238,377.90186834335327,1366.2011642456055,45053,5345,39708,39708,0,9,5815000.0
5815,5815999,21.87125772802322,38.58355145934865,0.045627575533146336,1023.5944187641144,377.96404480934143,1366.3076210021973,45065,5347,39718,39718,0,9,5816000.0
5816,5816999,21.871281504667877,38.583020262920854,0.04562381787864267,1023.7131316661835,378.026437997818,1366.4961967468262,45065,5347,39718,39718,0,9,5817000.0
5817,5817999,21.871563979183474,38.5835100243887,0.04562979539113132,1024.2424492835999,378.0896179676056,1366.4627571105957,45074,5351,39723,39723,0,9,5818000.0
5818,5818999,21.87186301525085,38.583642733066675,0.045638856862213806,1024.3889887332916,378.1515123844147,1366.697036743164,45074,5351,39723,39723,0,9,5819000.0
5819,5819999,21.872387320114502,38.58446126995778,0.04565992965917398,1024.5092461109161,378.21312618255615,1366.8517265319824,45074,5351,39723,39723,0,9,5820000.0
5820,5820999,21.873149090771214,38.586110813527455,0.04569762760611473,1024.7407674789429,378.27759552001953,1367.0085372924805,45078,5352,39726,39726,0,9,5821000.0
5821,5821999,21.874518183868556,38.5885712911261,0.04572384085289771,1024.957124710083,378.3396234512329,1367.2101020812988,45083,5353,39730,39730,0,9,5822000.0
5822,5822999,21.875892294416005,38.59095810037906,0.0457807999063925,1025.0704531669617,378.40096831321716,1367.4530715942383,45083,5353,39730,39730,0,9,5823000.0
5823,5823999,21.878438815820864,38.59563348075667,0.04584500686149218,1025.2945284843445,378.46352982521057,1367.6994400024414,45092,5354,39738,39738,0,9,5824000.0
5824,5824999,21.88101851326903,38.6024140535288,0.04588518916921369,1025.6192989349365,378.5260543823242,1367.8760719299316,45113,5356,39757,39757,0,9,5825000.0
5825,5825999,21.88386234735655,38.60894609722547,0.04591613773480896,1025.8353090286255,378.58812952041626,1368.0834045410156,45123,5357,39766,39766,0,9,5826000.0
5826,5826999,21.886025105714584,38.61236142943115,0.04593381813852504,1026.0631732940674,378.65058636665344,1368.293270111084,45139,5358,39781,39781,0,9,5827000.0
5827,5827999,21.885567995304754,38.611613477818665,0.04592163970158969,1026.3062846660614,378.7164568901062,1369.2440376281738,45184,5359,39825,39825,0,9,5828000.0
5828,5828999,21.88435618163787,38.61044731993798,0.04591143717988877,1026.4311707019806,378.7795395851135,1369.786964416504,45191,5359,39832,39832,0,9,5829000.0
5829,5829999,21.883249595230225,38.609593007578354,0.04590539647555458,1026.556527376175,378.84158062934875,1370.0757026672363,45193,5359,39834,39834,0,9,5830000.0
5830,5830999,21.88226487146607,38.6080275815047,0.04589779847179021,1026.7889988422394,378.9042775630951,1370.3445091247559,45204,5360,39844,39844,0,9,5831000.0
5831,5831999,21.88157033835676,38.60661551207474,0.045887536874595125,1027.0156428813934,378.96605229377747,1370.526180267334,45214,5361,39853,39853,0,9,5832000.0
5832,5832999,21.88078421877217,38.60533514923996,0.04588110231563147,1027.137797832489,379.02867102622986,1370.7821617126465,45215,5361,39854,39854,0,9,5833000.0
5833,5833999,21.880058354551434,38.60376440569339,0.04587516866054142,1027.2573537826538,379.09075379371643,1371.0659484863281,45217,5361,39856,39856,0,9,5834000.0
5834,5834999,21.879644606643268,38.60274095679994,0.04587267255929295,1027.48015999794,379.1534869670868,1371.360263824463,45239,5362,39877,39877,0,9,5835000.0
5835,5835999,21.87970643224771,38.605337974860056,0.045872253903269655,1027.6971848011017,379.21552443504333,1371.5253601074219,45249,5363,39886,39886,0,9,5836000.0
5836,5836999,21.88007185003787,38.605926555096154,0.045884521970601555,1027.9191019535065,379.27784752845764,1371.772777557373,45260,5364,39896,39896,0,9,5837000.0
5837,5837999,21.881088799180745,38.60736303483873,0.04589941943125564,1028.0430760383606,379.33917927742004,1372.0780639648438,45264,5364,39900,39900,0,9,5838000.0
5838,5838999,21.882255056037597,38.60916879259274,0.04593925411271227,1028.256408214569,379.40218234062195,1372.363941192627,45275,5365,39910,39910,0,9,5839000.0
5839,5839999,21.883306450886206,38.61014085988324,0.045976470398537805,1028.4829564094543,379.465829372406,1372.7278594970703,45283,5366,39917,39917,0,9,5840000.0
5840,5840999,21.88469384699965,38.61151179950016,0.046013911623333015,1028.8092765808105,379.53122091293335,1372.9246673583984,45295,5368,39927,39927,0,9,5841000.0
5841,5841999,21.88634043980873,38.61540478543158,0.046070555204973274,1029.0299565792084,379.5931897163391,1373.1966400146484,45305,5369,39936,39936,0,9,5842000.0
5842,5842999,21.8884627731818,38.62008810508394,0.046140392733379554,1029.3637971878052,379.65461587905884,1373.5889053344727,45333,5371,39962,39962,0,9,5843000.0
5843,5843999,21.890344651338335,38.62220850292362,0.0462000850229235,1029.4966237545013,379.72431445121765,1374.0087242126465,45340,5371,39969,39969,0,9,5844000.0
5844,5844999,21.892868893150602,38.62795579762146,0.04626585471767464,1029.8246564865112,379.7876281738281,1374.1345558166504,45360,5373,39987,39987,0,9,5845000.0
5845,5845999,21.894995231391906,38.63125724754429,0.04632664476230364,1030.3552315235138,379.85128116607666,1374.3527221679688,45393,5377,40016,40016,0,9,5846000.0
5846,5846999,21.897635924748275,38.63536342932882,0.04641089645498375,1030.474374294281,379.9132671356201,1374.7589721679688,45396,5377,40019,40019,0,9,5847000.0
5847,5847999,21.89874189038958,38.63643648831858,0.046432252648901384,1031.0021045207977,379.9771866798401,1375.0280952453613,45436,5381,40055,40055,0,9,5848000.0
5848,5848999,21.89775168773752,38.63632963774931,0.04643396500943442,1031.1245374679565,380.04110503196716,1375.892406463623,45459,5381,40078,40078,0,9,5849000.0
5849,5849999,21.89674732377016,38.635105210679725,0.04644012960977306,1031.343185186386,380.1040759086609,1376.2539901733398,45470,5382,40088,40088,0,9,5850000.0
5850,5850999,21.895700984641564,38.63333305130571,0.04644312926280436,1031.5726923942566,380.16984391212463,1376.5259094238281,45478,5383,40095,40095,0,9,5851000.0
5851,5851999,21.894711029905967,38.63144338450635,0.046444017733285436,1031.7994756698608,380.23215198516846,1376.7432708740234,45488,5384,40104,40104,0,9,5852000.0
5852,5852999,21.893725155497307,38.6329384395211,0.04643687057548984,1031.926143169403,380.2973983287811,1376.957405090332,45488,5384,40104,40104,0,9,5853000.0
5853,5853999,21.892590471543517,38.63075538394217,0.04644235821445408,1032.145869255066,380.3604803085327,1377.1449356079102,45497,5385,40112,40112,0,9,5854000.0
5854,5854999,21.89142373228785,38.62843802572394,0.04644927821358036,1032.3692922592163,380.4225857257843,1377.3873863220215,45504,5386,40118,40118,0,9,5855000.0
5855,5855999,21.890271191559872,38.626568477607876,0.046454110971691054,1032.5888905525208,380.4846303462982,1377.6320495605469,45507,5387,40120,40120,0,9,5856000.0
5856,5856999,21.8893344474246,38.6246525977701,0.04645334997735451,1033.016968011856,380.547119140625,1377.7082023620605,45528,5390,40138,40138,0,9,5857000.0
5857,5857999,21.88851375960369,38.62293301112266,0.04645366283726693,1033.357545375824,380.6166331768036,1377.9270095825195,45537,5392,40145,40145,0,9,5858000.0
5858,5858999,21.88775417208062,38.62131289082818,0.046452135426572894,1033.5790345668793,380.6788296699524,1378.1833534240723,45550,5393,40157,40157,0,9,5859000.0
5859,5859999,21.88680511508937,38.61923926748673,0.04645587221188063,1033.7089488506317,380.7411961555481,1378.4667778015137,45553,5393,40160,40160,0,9,5860000.0
5860,5860999,21.886108065829774,38.617532298213796,0.04645604622766086,1033.8506095409393,380.81424736976624,1378.6943817138672,45553,5393,40160,40160,0,9,5861000.0
5861,5861999,21.885518657488625,38.616166176826745,0.04645414316243146,1034.1759014129639,380.877060174942,1378.802360534668,45573,5395,40178,40178,0,9,5862000.0
5862,5862999,21.884871045540248,38.61430947870252,0.046454321512527375,1034.4079592227936,380.9402930736542,1379.1133880615234,45577,5396,40181,40181,0,9,5863000.0
5863,5863999,21.88414767329164,38.61250791095048,0.04645885378263881,1034.6239521503448,381.00201535224915,1379.376667022705,45589,5397,40192,40192,0,9,5864000.0
5864,5864999,21.883383722278978,38.61055350699707,0.046458650775955346,1035.042598247528,381.0645754337311,1379.6924362182617,45603,5400,40203,40203,0,9,5865000.0
5865,5865999,21.882369760642277,38.609074788140994,0.046462822688492555,1035.1596591472626,381.12689566612244,1380.2720947265625,45613,5400,40213,40213,0,9,5866000.0
5866,5866999,21.881577250493198,38.60871313963064,0.04645132310932398,1035.3917980194092,381.19020771980286,1380.5183944702148,45625,5401,40224,40224,0,9,5867000.0
5867,5867999,21.880670224319502,38.606908617358684,0.04643872124525128,1035.6155688762665,381.2530517578125,1380.729320526123,45638,5402,40236,40236,0,9,5868000.0
5868,5868999,21.879975480687243,38.60672652977681,0.04643338847967127,1035.9478750228882,381.315482378006,1380.6658325195312,45658,5404,40254,40254,0,9,5869000.0
5869,5869999,21.87941793169496,38.6060948451118,0.04641929129268496,1036.1814589500427,381.38067746162415,1380.7925720214844,45669,5405,40264,40264,0,9,5870000.0
5870,5870999,21.878739908118476,38.60443259069063,0.04641432584106353,1036.4132108688354,381.44539427757263,1380.9584922790527,45672,5406,40266,40266,0,9,5871000.0
5871,5871999,21.878175599957597,38.604448640620994,0.04640739906196023,1036.5307402610779,381.50690150260925,1381.125,45673,5406,40267,40267,0,9,5872000.0
5872,5872999,21.87750619123514,38.60297697739482,0.046402615949190706,1036.7560484409332,381.5687053203583,1381.2768020629883,45684,5407,40277,40277,0,9,5873000.0
5873,5873999,21.877036792264196,38.60174720856282,0.0463906782338529,1037.0893924236298,381.6309669017792,1381.3130073547363,45696,5409,40287,40287,0,9,5874000.0
5874,5874999,21.876654436647318,38.600705429611125,0.046381667212391786,1037.4353852272034,381.69751739501953,1381.3889198303223,45709,5411,40298,40298,0,9,5875000.0
5875,5875999,21.87635583649924,38.59963948238337,0.04636842534031915,1037.5617158412933,381.7594714164734,1381.5807800292969,45710,5411,40299,40299,0,9,5876000.0
5876,5876999,21.87607055701115,38.598932197433015,0.0463620820968621,1037.6898791790009,381.8211998939514,1381.730712890625,45710,5411,40299,40299,0,9,5877000.0
5877,5877999,21.876101179502808,38.59825717523801,0.04635393936306653,1037.8130640983582,381.882675409317,1381.937572479248,45712,5411,40301,40301,0,9,5878000.0
5878,5878999,21.87620674526385,38.59794011187607,0.04634848013384252,1038.2419345378876,381.94730520248413,1382.0053939819336,45741,5414,40327,40327,0,9,5879000.0
5879,5879999,21.876345632948702,38.59738136299871,0.04634025573484135,1038.4750318527222,382.0118091106415,1382.0686302185059,45751,5415,40336,40336,0,9,5880000.0
5880,5880999,21.87702297526271,38.59776154693935,0.046327510661405724,1038.5921971797943,382.0747797489166,1382.2990455627441,45753,5415,40338,40338,0,9,5881000.0
5881,5881999,21.87757257761945,38.59731638167798,0.04631209657811264,1038.717071056366,382.136456489563,1382.5362129211426,45756,5415,40341,40341,0,9,5882000.0
5882,5882999,21.87792501470757,38.59671723420353,0.04630267499346519,1039.0400292873383,382.1972625255585,1382.5574913024902,45776,5417,40359,40359,0,9,5883000.0
5883,5883999,21.878540623429036,38.59734247285481,0.04628022721632907,1039.2808682918549,382.2591302394867,1382.7814178466797,45783,5418,40365,40365,0,9,5884000.0
5884,5884999,21.878266292644888,38.597908580654405,0.04626995827963465,1039.399507522583,382.3216300010681,1383.242992401123,45795,5418,40377,40377,0,9,5885000.0
5885,5885999,21.87689787279284,38.595473973724594,0.04626913852065795,1039.5233342647552,382.38421392440796,1383.6905708312988,45806,5418,40388,40388,0,9,5886000.0
5886,5886999,21.875708115649132,38.593452123457446,0.0462691649552317,1039.6507833003998,382.447247505188,1383.8960990905762,45807,5418,40389,40389,0,9,5887000.0
5887,5887999,21.87468990879424,38.59153921711593,0.04626728133883773,1039.8923735618591,382.5102572441101,1384.0978393554688,45815,5419,40396,40396,0,9,5888000.0
5888,5888999,21.873842151345222,38.590143506589676,0.04626209565160211,1040.2239971160889,382.57221579551697,1384.147403717041,45827,5421,40406,40406,0,9,5889000.0
5889,5889999,21.873170085772735,38.588905098692585,0.046262708508908346,1040.3468599319458,382.63505935668945,1384.383644104004,45830,5421,40409,40409,0,9,5890000.0
5890,5890999,21.872988427325577,38.59163486603597,0.046253806105080786,1040.6712710857391,382.6977696418762,1384.532470703125,45846,5423,40423,40423,0,9,5891000.0
5891,5891999,21.87236861556672,38.590232065812046,0.046250479506748765,1041.102469444275,382.76292872428894,1384.7206268310547,45877,5426,40451,40451,0,9,5892000.0
5892,5892999,21.871890268624167,38.58897966373275,0.0462504998559079,1041.23051571846,382.82577443122864,1384.9609260559082,45877,5426,40451,40451,0,9,5893000.0
5893,5893999,21.87168261530808,38.587920157344925,0.046248669822429256,1041.376169204712,382.9019618034363,1385.21968460083,45881,5426,40455,40455,0,9,5894000.0
5894,5894999,21.871450830392558,38.58675736009997,0.04624763718865743,1041.8125281333923,382.9649760723114,1385.2206077575684,45914,5429,40485,40485,0,9,5895000.0
5895,5895999,21.87111881198382,38.585219016976424,0.046241886489199246,1041.9304263591766,383.028422832489,1385.4867362976074,45917,5429,40488,40488,0,9,5896000.0
5896,5896999,21.871262341943204,38.58476963389914,0.046244210186255685,1042.1552696228027,383.09209275245667,1385.6074295043945,45921,5430,40491,40491,0,9,5897000.0
5897,5897999,21.871514202529404,38.58723077009123,0.04624027253744989,1042.2924194335938,383.16525173187256,1385.7814559936523,45921,5430,40491,40491,0,9,5898000.0
5898,5898999,21.871781823041392,38.587007352434206,0.04623803620471367,1042.527691602707,383.22794699668884,1386.0139350891113,45927,5431,40496,40496,0,9,5899000.0
5899,5899999,21.871980194979244,38.58628979703626,0.04624269535063075,1042.7628078460693,383.2931115627289,1386.2097396850586,45940,5432,40508,40508,0,9,5900000.0
5900,5900999,21.87344966940039,38.588007374267306,0.046253149337160626,1043.0018243789673,383.35879778862,1386.3370971679688,45947,5433,40514,40514,0,9,5901000.0
5901,5901999,21.874346108095118,38.58846851708103,0.046260120083751244,1043.2397766113281,383.41997599601746,1386.5121879577637,45960,5434,40526,40526,0,9,5902000.0
5902,5902999,21.875073808370697,38.58818405368612,0.0462689133072971,1043.367705821991,383.48214316368103,1386.775951385498,45964,5434,40530,40530,0,9,5903000.0
5903,5903999,21.87546551560515,38.58782609651655,0.04627129188119927,1043.5844585895538,383.5450828075409,1386.896297454834,45966,5435,40531,40531,0,9,5904000.0
5904,5904999,21.876003065185348,38.58751656706843,0.04627409500597568,1044.0268845558167,383.6097412109375,1386.9995918273926,45987,5438,40549,40549,0,9,5905000.0
5905,5905999,21.87532383593384,38.58585708703556,0.046278673450836916,1044.2745003700256,383.6755962371826,1387.7953643798828,46017,5439,40578,40578,0,9,5906000.0
5906,5906999,21.87377086179022,38.58445878426161,0.04628028607301904,1044.3956961631775,383.7384343147278,1388.274887084961,46025,5439,40586,40586,0,9,5907000.0
5907,5907999,21.872358571964742,38.58268622788557,0.04628235719431162,1044.8214538097382,383.8018448352814,1388.4623641967773,46039,5442,40597,40597,0,9,5908000.0
5908,5908999,21.871407193486714,38.5817474652367,0.046278935211006345,1045.0549075603485,383.8647747039795,1388.8441352844238,46046,5443,40603,40603,0,9,5909000.0
5909,5909999,21.870221820943993,38.57969977632483,0.046280194920377826,1045.379822254181,383.927686214447,1388.9896926879883,46063,5445,40618,40618,0,9,5910000.0
5910,5910999,21.8690641919977,38.577539836245634,0.0462848152397638,1045.6152453422546,383.9929986000061,1389.1763191223145,46078,5446,40632,40632,0,9,5911000.0
5911,5911999,21.8678238690409,38.57535540743127,0.04628834961634154,1045.8401415348053,384.0554873943329,1389.411434173584,46094,5447,40647,40647,0,9,5912000.0
5912,5912999,21.866809974095013,38.573703186591864,0.04629369351365964,1046.0696737766266,384.1164643764496,1389.66068649292,46104,5448,40656,40656,0,9,5913000.0
5913,5913999,21.86578838189734,38.57184692223189,0.046296923313618565,1046.4093475341797,384.1828784942627,1389.6925315856934,46130,5450,40680,40680,0,9,5914000.0
5914,5914999,21.86516228593976,38.5729226482535,0.046286793603821375,1046.747036933899,384.2463319301605,1389.8919563293457,46157,5452,40705,40705,0,9,5915000.0
5915,5915999,21.86446792201405,38.571648100409426,0.04629142774261885,1046.8828997612,384.30965518951416,1390.1313781738281,46158,5452,40706,40706,0,9,5916000.0
5916,5916999,21.864044620453562,38.57108596343837,0.04628223734830805,1047.231793642044,384.3728520870209,1390.1798858642578,46163,5454,40709,40709,0,9,5917000.0
5917,5917999,21.863608374413875,38.56977986910509,0.0462911975726934,1047.3563253879547,384.43575739860535,1390.5941543579102,46167,5454,40713,40713,0,9,5918000.0
5918,5918999,21.86354867475325,38.569549816418416,0.04629340271839022,1047.701417207718,384.50039196014404,1390.7655029296875,46174,5456,40718,40718,0,9,5919000.0
5919,5919999,21.863828423287547,38.57079992729291,0.04629306101906505,1047.9213225841522,384.5623571872711,1391.0042114257812,46177,5457,40720,40720,0,9,5920000.0
5920,5920999,21.864245717067043,38.570701622921376,0.0463048491453667,1048.1505722999573,384.6268665790558,1391.3351364135742,46193,5458,40735,40735,0,9,5921000.0
5921,5921999,21.864799190544197,38.570822718281875,0.046314345559479664,1048.265772819519,384.689444065094,1391.71870803833,46196,5458,40738,40738,0,9,5922000.0
5922,5922999,21.86527017285963,38.5707617402532,0.046317451023381584,1048.5952949523926,384.7542083263397,1391.8620414733887,46207,5460,40747,40747,0,9,5923000.0
5923,5923999,21.865467886930954,38.5707160126514,0.046312187596868504,1048.8158304691315,384.8159680366516,1392.1320686340332,46216,5461,40755,40755,0,9,5924000.0
5924,5924999,21.865724814151786,38.57016861997679,0.046314984486397814,1049.3463878631592,384.8786392211914,1392.3666458129883,46237,5465,40772,40772,0,9,5925000.0
5925,5925999,21.865304338117955,38.568786745464216,0.04632247305843129,1049.58252120018,384.9428119659424,1393.0879554748535,46268,5466,40802,40802,0,9,5926000.0
5926,5926999,21.863763049495137,38.56630823054309,0.046328290661015514,1049.7045407295227,385.00485396385193,1393.5193901062012,46269,5466,40803,40803,0,9,5927000.0
5927,5927999,21.862531540735674,38.56452845463804,0.04632832850327673,1049.8362083435059,385.0688831806183,1393.939296722412,46272,5466,40806,40806,0,9,5928000.0
5928,5928999,21.86131146283396,38.56274155480762,0.04633104792692444,1050.1630642414093,385.1342511177063,1394.1536178588867,46288,5468,40820,40820,0,9,5929000.0
5929,5929999,21.860423535100114,38.56202541291678,0.04632794863941869,1050.289601802826,385.19819140434265,1394.3344497680664,46288,5468,40820,40820,0,9,5930000.0
5930,5930999,21.859410680411493,38.56012864926685,0.04632814593158596,1050.6275582313538,385.26106119155884,1394.4880867004395,46300,5470,40830,40830,0,9,5931000.0
5931,5931999,21.858379718798975,38.55815231899429,0.04632858587992217,1050.7455141544342,385.32401418685913,1394.7072868347168,46301,5470,40831,40831,0,9,5932000.0
5932,5932999,21.85748520296676,38.556540187558106,0.04633013497661309,1051.078353881836,385.3865821361542,1394.8426208496094,46314,5472,40842,40842,0,9,5933000.0
5933,5933999,21.856513130078834,38.55448339363794,0.046334038334384875,1051.2132802009583,385.4485185146332,1394.9930229187012,46314,5472,40842,40842,0,9,5934000.0
5934,5934999,21.85604482283461,38.55321349062561,0.0463332528382312,1051.4452822208405,385.51052021980286,1395.189567565918,46316,5473,40843,40843,0,9,5935000.0
5935,5935999,21.855770834009135,38.55224202731278,0.04634888838530671,1051.5892169475555,385.57411885261536,1395.3460083007812,46316,5473,40843,40843,0,9,5936000.0
5936,5936999,21.85593356362593,38.55241155868175,0.04635780011551571,1051.9195783138275,385.636545419693,1395.4209632873535,46329,5475,40854,40854,0,9,5937000.0
5937,5937999,21.85645387553894,38.55272476099413,0.04636023484253171,1052.1483087539673,385.69867610931396,1395.506748199463,46331,5476,40855,40855,0,9,5938000.0
5938,5938999,21.856842991694776,38.55273985493765,0.04637319020901831,1052.2690041065216,385.7604968547821,1395.6768836975098,46331,5476,40855,40855,0,9,5939000.0
5939,5939999,21.857376447713833,38.55308423701923,0.04637330132247164,1052.5086686611176,385.82375407218933,1395.8518981933594,46334,5477,40857,40857,0,9,5940000.0
5940,5940999,21.858228251246704,38.55373443699605,0.04637774463700861,1052.6528701782227,385.8972942829132,1396.0695533752441,46337,5477,40860,40860,0,9,5941000.0
5941,5941999,21.859361374649332,38.554701102704335,0.046388821085494136,1052.7786283493042,385.9610061645508,1396.274543762207,46337,5477,40860,40860,0,9,5942000.0
5942,5942999,21.860270356624103,38.555216773674346,0.04639208453457033,1053.0063025951385,386.022625207901,1396.4696731567383,46362,5478,40884,40884,0,9,5943000.0
5943,5943999,21.860989211555264,38.55553128118632,0.04638409087501383,1053.1314344406128,386.08601927757263,1396.6975784301758,46363,5478,40885,40885,0,9,5944000.0
5944,5944999,21.861645170823103,38.55555794538535,0.046380574766890725,1053.2523186206818,386.1474599838257,1396.8694610595703,46363,5478,40885,40885,0,9,5945000.0
5945,5945999,21.86198460528458,38.55500699954927,0.046379307793807945,1053.585064649582,386.20942187309265,1396.943058013916,46383,5480,40903,40903,0,9,5946000.0
5946,5946999,21.8609955034906,38.55345763808114,0.046370868940922905,1053.709623336792,386.27338194847107,1398.0852546691895,46423,5480,40943,40943,0,9,5947000.0
5947,5947999,21.85974091152456,38.55172501769312,0.04637131014861717,1053.832247018814,386.33696460723877,1398.6626281738281,46431,5480,40951,40951,0,9,5948000.0
5948,5948999,21.858816744307696,38.55068249914916,0.04637141279914325,1053.9700148105621,386.4010591506958,1399.0436172485352,46434,5480,40954,40954,0,9,5949000.0
5949,5949999,21.857929662077826,38.54889807562015,0.046374315540520517,1054.0850012302399,386.4628965854645,1399.4049530029297,46436,5480,40956,40956,0,9,5950000.0
5950,5950999,21.85712861176999,38.54708353507685,0.04637483423139366,1054.2102863788605,386.5252294540405,1399.6639938354492,46437,5480,40957,40957,0,9,5951000.0
5951,5951999,21.856574879187768,38.546620912010376,0.046371025993410364,1054.3305957317352,386.58794927597046,1399.8861541748047,46437,5480,40957,40957,0,9,5952000.0
5952,5952999,21.85560092086796,38.54489888313551,0.04636799873676267,1054.5623569488525,386.65263843536377,1400.2067794799805,46443,5481,40962,40962,0,9,5953000.0
5953,5953999,21.85484087706164,38.54320003076888,0.04636998949750437,1054.6827895641327,386.71479964256287,1400.5349349975586,46446,5481,40965,40965,0,9,5954000.0
5954,5954999,21.854318222190802,38.54235190690152,0.04637177369715617,1055.030294418335,386.78068709373474,1400.6324844360352,46459,5483,40976,40976,0,9,5955000.0
5955,5955999,21.8539136922912,38.5410663127336,0.046371686688300606,1055.352195262909,386.84300923347473,1400.9117164611816,46466,5485,40981,40981,0,9,5956000.0
5956,5956999,21.853408297378703,38.539903535661594,0.04637656896034015,1055.6770939826965,386.90562319755554,1401.0829162597656,46487,5487,41000,41000,0,9,5957000.0
5957,5957999,21.853158567604225,38.53867078437507,0.04638487597305718,1055.8027229309082,386.96739506721497,1401.3566703796387,46487,5487,41000,41000,0,9,5958000.0
5958,5958999,21.853149182227664,38.53864248795507,0.046385528225585726,1056.03276014328,387.0318057537079,1401.5905532836914,46493,5488,41005,41005,0,9,5959000.0
5959,5959999,21.85335965357837,38.53860429259367,0.046395988004750865,1056.2565188407898,387.0952191352844,1401.781967163086,46495,5489,41006,41006,0,9,5960000.0
5960,5960999,21.853377069092588,38.53788622144942,0.04639724817345825,1056.4875707626343,387.1573348045349,1402.0972175598145,46501,5490,41011,41011,0,9,5961000.0
5961,5961999,21.853927289233045,38.53827804934288,0.04640757309380672,1056.7208032608032,387.2224009037018,1402.3957290649414,46512,5491,41021,41021,0,9,5962000.0
5962,5962999,21.854245807742462,38.53778421120757,0.04641261724755397,1056.8410432338715,387.2843482494354,1402.7804718017578,46519,5491,41028,41028,0,9,5963000.0
5963,5963999,21.854609572786522,38.53724524131525,0.04641187636870092,1056.9545602798462,387.34652185440063,1403.06400680542,46519,5491,41028,41028,0,9,5964000.0
5964,5964999,21.854862597266454,38.53676479956395,0.04641211371660203,1057.0807492733002,387.40984058380127,1403.3366928100586,46520,5491,41029,41029,0,9,5965000.0
5965,5965999,21.855561720045902,38.536598093674726,0.046408974748645804,1057.309910774231,387.4733726978302,1403.6157035827637,46525,5492,41033,41033,0,9,5966000.0
5966,5966999,21.855232173799312,38.53519001406863,0.04640671090712967,1057.547193288803,387.53521943092346,1403.8043975830078,46534,5493,41041,41041,0,9,5967000.0
5967,5967999,21.85440279255157,38.534821040417434,0.0463892554450438,1057.6717958450317,387.5984160900116,1404.7554168701172,46561,5493,41068,41068,0,9,5968000.0
5968,5968999,21.853170939008702,38.53262840079352,0.04639084916529679,1057.8008563518524,387.66234517097473,1405.258888244629,46567,5493,41074,41074,0,9,5969000.0
5969,5969999,21.85194258846225,38.53043896084195,0.04639523957081981,1058.033192396164,387.7254776954651,1405.5557899475098,46571,5494,41077,41077,0,9,5970000.0
5970,5970999,21.851160694219853,38.52887274501814,0.04639859160231041,1058.149967432022,387.78814482688904,1405.9003677368164,46571,5494,41077,41077,0,9,5971000.0
5971,5971999,21.85033133083952,38.52750486904808,0.04640211474729461,1058.3731186389923,387.85161542892456,1406.1262283325195,46574,5495,41079,41079,0,9,5972000.0
5972,5972999,21.84966101450783,38.52630994128906,0.04640017791536455,1058.6997969150543,387.9144926071167,1406.269660949707,46578,5497,41081,41081,0,9,5973000.0
5973,5973999,21.84916888787652,38.527964541177525,0.04639028826178182,1058.924710035324,387.97822999954224,1406.4985961914062,46581,5498,41083,41083,0,9,5974000.0
5974,5974999,21.848554736913304,38.52635577994962,0.04638584740942342,1059.0390558242798,388.0400471687317,1406.841739654541,46586,5498,41088,41088,0,9,5975000.0
5975,5975999,21.848103542716135,38.5251615243029,0.04638392128267632,1059.2657670974731,388.10192608833313,1407.021614074707,46595,5499,41096,41096,0,9,5976000.0
5976,5976999,21.84815203128162,38.52490098982219,0.046385616602748314,1059.4928750991821,388.16576170921326,1407.2643013000488,46599,5500,41099,41099,0,9,5977000.0
5977,5977999,21.848412956542433,38.52558352953001,0.04638587153726714,1059.8242018222809,388.22828364372253,1407.545555114746,46641,5502,41139,41139,0,9,5978000.0
5978,5978999,21.848796635876834,38.527572101724175,0.04638643700271983,1059.9435431957245,388.29293632507324,1407.824993133545,46641,5502,41139,41139,0,9,5979000.0
5979,5979999,21.849254653399594,38.52811955034978,0.04638624241318201,1060.0638751983643,388.35609126091003,1408.0563163757324,46642,5502,41140,41140,0,9,5980000.0
5980,5980999,21.850106364496245,38.52976948655958,0.04638699395030743,1060.4058046340942,388.41956877708435,1408.1032676696777,46646,5504,41142,41142,0,9,5981000.0
5981,5981999,21.850743614689673,38.53037718011978,0.046396584204749125,1060.5330410003662,388.4817407131195,1408.3793640136719,46647,5504,41143,41143,0,9,5982000.0
5982,5982999,21.851908109939448,38.53188464308057,0.046398449977618994,1060.7663669586182,388.54694986343384,1408.5880584716797,46658,5505,41153,41153,0,9,5983000.0
5983,5983999,21.853095037289865,38.533081546755035,0.04639356416302287,1061.0934104919434,388.60924911499023,1408.6550979614258,46665,5507,41158,41158,0,9,5984000.0
5984,5984999,21.854143663257243,38.53426892209878,0.04640286789386283,1061.4222683906555,388.6714644432068,1408.7386093139648,46670,5509,41161,41161,0,9,5985000.0
5985,5985999,21.855519196372846,38.535774216031825,0.04640760838368252,1061.8589873313904,388.7348072528839,1408.9062881469727,46691,5512,41179,41179,0,9,5986000.0
5986,5986999,21.857068736889133,38.53782047587673,0.04642924065985676,1061.975476026535,388.7979996204376,1409.286220550537,46693,5512,41181,41181,0,9,5987000.0
5987,5987999,21.857470893247264,38.53761797983968,0.04642687283730651,1062.1937747001648,388.85972142219543,1409.5372695922852,46703,5513,41190,41190,0,9,5988000.0
5988,5988999,21.856498738713807,38.536109024434,0.04642085930864959,1062.3159918785095,388.92240381240845,1410.4822387695312,46726,5513,41213,41213,0,9,5989000.0
5989,5989999,21.855321294782303,38.53434512248767,0.046421328984431076,1062.437671661377,388.98520278930664,1410.9298934936523,46730,5513,41217,41217,0,9,5990000.0
5990,5990999,21.854324457620624,38.53316048303679,0.04642041151284848,1062.7712042331696,389.0484881401062,1411.2006378173828,46741,5515,41226,41226,0,9,5991000.0
5991,5991999,21.85336472779426,38.53137292772526,0.046421415407361444,1062.9986112117767,389.1110441684723,1411.3760948181152,46749,5516,41233,41233,0,9,5992000.0
5992,5992999,21.852444040763704,38.529683919731205,0.04641984314887104,1063.3301439285278,389.1736686229706,1411.569480895996,46759,5518,41241,41241,0,9,5993000.0
5993,5993999,21.85141457344249,38.52768558213809,0.04642285562332882,1063.5656123161316,389.23893690109253,1411.8077926635742,46776,5519,41257,41257,0,9,5994000.0
5994,5994999,21.850447612786727,38.52554660268792,0.04642434179353394,1063.7880215644836,389.3011989593506,1412.0025024414062,46779,5520,41259,41259,0,9,5995000.0
5995,5995999,21.849863956027974,38.524530456682655,0.04643010716532192,1063.9128956794739,389.36397433280945,1412.187843322754,46779,5520,41259,41259,0,9,5996000.0
5996,5996999,21.849133749884903,38.52318583426863,0.04643453313900603,1064.2494213581085,389.4266300201416,1412.2667388916016,46794,5522,41272,41272,0,9,5997000.0
5997,5997999,21.848746518740366,38.522196330591925,0.04643504032612511,1064.38330078125,389.4887535572052,1412.450080871582,46794,5522,41272,41272,0,9,5998000.0
5998,5998999,21.848477955761584,38.52113841495795,0.04643815976934451,1064.5047829151154,389.5506477355957,1412.5993919372559,46794,5522,41272,41272,0,9,5999000.0
5999,5999999,21.848269019753648,38.52016585113987,0.04643905311591712,1064.8395793437958,389.61325192451477,1412.5877799987793,46798,5524,41274,41274,0,9,6000000.0
6000,6000999,21.848354987442264,38.51945059864809,0.04643951918778155,1065.0689868927002,389.6763036251068,1412.7413215637207,46812,5525,41287,41287,0,9,6001000.0
6001,6001999,21.84842881427341,38.518376671184036,0.046432784580801245,1065.195389032364,389.73901772499084,1412.923225402832,46813,5525,41288,41288,0,9,6002000.0
6002,6002999,21.848394811412533,38.516864805295484,0.04642206631317858,1065.5236628055573,389.8014602661133,1413.0367584228516,46818,5527,41291,41291,0,9,6003000.0
6003,6003999,21.848271893159104,38.51547818005314,0.04641209745368613,1065.647701740265,389.86410307884216,1413.3828620910645,46821,5527,41294,41294,0,9,6004000.0
6004,6004999,21.847769221377987,38.5135415040997,0.04640789471119955,1065.9768924713135,389.9283902645111,1413.624252319336,46839,5529,41310,41310,0,9,6005000.0
6005,6005999,21.84688332020335,38.51229950920092,0.046408943814436276,1066.0997610092163,389.99200987815857,1414.4013023376465,46861,5529,41332,41332,0,9,6006000.0
6006,6006999,21.845679802633512,38.510594443413055,0.04641891921794261,1066.3260507583618,390.05561923980713,1414.7162437438965,46870,5530,41340,41340,0,9,6007000.0
6007,6007999,21.845082385218113,38.51694171072057,0.046398313887751286,1066.4645104408264,390.1211245059967,1415.0985946655273,46874,5530,41344,41344,0,9,6008000.0
6008,6008999,21.84462834282537,38.51944522298211,0.046394517719224204,1066.690646648407,390.1837089061737,1415.3547668457031,46879,5531,41348,41348,0,9,6009000.0
6009,6009999,21.843564599049586,38.51763416874009,0.04639915438755071,1066.9204905033112,390.2463722229004,1415.5049018859863,46883,5532,41351,41351,0,9,6010000.0
6010,6010999,21.842600924240514,38.51590872010892,0.046401830373240194,1067.1482322216034,390.3098304271698,1415.7638130187988,46897,5533,41364,41364,0,9,6011000.0
6011,6011999,21.841538117200706,38.513912525324066,0.046408159389688564,1067.2837781906128,390.37456035614014,1416.0107345581055,46900,5533,41367,41367,0,9,6012000.0
6012,6012999,21.840713606850773,38.512403701262734,0.046411173562788344,1067.4105825424194,390.4367923736572,1416.2532577514648,46904,5533,41371,41371,0,9,6013000.0
6013,6013999,21.840084848824528,38.5111477567394,0.0464083086527497,1067.7479767799377,390.4992971420288,1416.4259796142578,46918,5535,41383,41383,0,9,6014000.0
6014,6014999,21.8395554817424,38.509852104432035,0.04640622744015732,1067.868980884552,390.5615985393524,1416.672264099121,46921,5535,41386,41386,0,9,6015000.0
6015,6015999,21.838983275580986,38.50851823149439,0.046404130446130676,1068.213487625122,390.6242458820343,1416.7450904846191,46934,5537,41397,41397,0,9,6016000.0
6016,6016999,21.838427890769587,38.50689314665367,0.0464036294432163,1068.3397591114044,390.68656611442566,1416.9257507324219,46937,5537,41400,41400,0,9,6017000.0
6017,6017999,21.838114409838756,38.50589815872151,0.046403851702972676,1068.6756904125214,390.74900007247925,1417.0379638671875,46943,5539,41404,41404,0,9,6018000.0
6018,6018999,21.837893341728982,38.50642347974774,0.04639456288544497,1069.000896692276,390.8119661808014,1417.120403289795,46952,5541,41411,41411,0,9,6019000.0
6019,6019999,21.83758100107366,38.505194729685286,0.04639562491273952,1069.2240998744965,390.873672246933,1417.2200469970703,46961,5542,41419,41419,0,9,6020000.0
6020,6020999,21.837741401182775,38.50492042614422,0.04638894137112248,1069.462217092514,390.9356815814972,1417.3894004821777,46966,5543,41423,41423,0,9,6021000.0
6021,6021999,21.837636903463306,38.504262673818786,0.04638005330532091,1069.7934708595276,390.99773955345154,1417.5203094482422,46978,5545,41433,41433,0,9,6022000.0
6022,6022999,21.837299463189176,38.502996231032974,0.04637520886035573,1070.0300343036652,391.0598134994507,1417.648998260498,46980,5546,41434,41434,0,9,6023000.0
6023,6023999,21.836814888462,38.5013126274291,0.04637170772129495,1070.160427570343,391.12251377105713,1417.8768997192383,46980,5546,41434,41434,0,9,6024000.0
6024,6024999,21.83613761382802,38.499757075348874,0.04636834031131831,1070.3954334259033,391.18518924713135,1418.305721282959,46997,5547,41450,41450,0,9,6025000.0
6025,6025999,21.835161977304352,38.49923472667851,0.04636153374279761,1070.6360912322998,391.248010635376,1418.8635520935059,47022,5548,41474,41474,0,9,6026000.0
6026,6026999,21.833721187890657,38.496866259354,0.04636536688653414,1070.8651280403137,391.31058502197266,1419.2193069458008,47028,5549,41479,41479,0,9,6027000.0
6027,6027999,21.832409001612916,38.49521282504899,0.04636657699273328,1071.1934325695038,391.3743064403534,1419.403751373291,47041,5551,41490,41490,0,9,6028000.0
6028,6028999,21.83123077222258,38.493166878595204,0.04636826510352754,1071.3190886974335,391.4366054534912,1419.5865478515625,47041,5551,41490,41490,0,9,6029000.0
6029,6029999,21.830183374162335,38.49151260462325,0.046364290704361655,1071.453453540802,391.49942564964294,1419.809959411621,47042,5551,41491,41491,0,9,6030000.0
6030,6030999,21.829305559780984,38.4905381832311,0.0463642678630124,1071.6832139492035,391.56209444999695,1420.0225372314453,47054,5552,41502,41502,0,9,6031000.0
6031,6031999,21.828364753932718,38.488556792174485,0.04636446523729976,1071.9044461250305,391.6242027282715,1420.178997039795,47058,5553,41505,41505,0,9,6032000.0
6032,6032999,21.827337090379483,38.486391427438946,0.04636626185141868,1072.13530087471,391.6851439476013,1420.3857727050781,47065,5554,41511,41511,0,9,6033000.0
6033,6033999,21.82665948692691,38.484732758983874,0.04636235377816522,1072.4700810909271,391.7478997707367,1420.5548629760742,47079,5556,41523,41523,0,9,6034000.0
6034,6034999,21.82611778589401,38.483396757299914,0.04635624089088397,1072.694168806076,391.8114113807678,1420.7786865234375,47086,5557,41529,41529,0,9,6035000.0
6035,6035999,21.825672729405326,38.48177196965617,0.046349480857489356,1072.934802055359,391.87417125701904,1421.077735900879,47093,5558,41535,41535,0,9,6036000.0
6036,6036999,21.825501073452592,38.480495301909684,0.04633980888278655,1073.160083770752,391.93618869781494,1421.2120513916016,47095,5559,41536,41536,0,9,6037000.0
6037,6037999,21.825440601514195,38.47947853326229,0.04633124572626901,1073.496589422226,392.00047492980957,1421.4354515075684,47108,5561,41547,41547,0,9,6038000.0
6038,6038999,21.825460163374906,38.47833248294511,0.04631515580344692,1073.7218563556671,392.0632417201996,1421.7520217895508,47119,5562,41557,41557,0,9,6039000.0
6039,6039999,21.825337102470638,38.477063990350736,0.04630139320183002,1073.852885723114,392.1279034614563,1421.946590423584,47120,5562,41558,41558,0,9,6040000.0
6040,6040999,21.825099084973882,38.475627900657116,0.046287836643161495,1074.0834255218506,392.1910209655762,1422.1917839050293,47133,5563,41570,41570,0,9,6041000.0
6041,6041999,21.8252959249078,38.474660900137664,0.04627040585585096,1074.3069064617157,392.2529594898224,1422.4969673156738,47153,5564,41589,41589,0,9,6042000.0
6042,6042999,21.82527679816737,38.4732821136785,0.04625302382038854,1074.4378859996796,392.31936740875244,1422.7246322631836,47154,5564,41590,41590,0,9,6043000.0
6043,6043999,21.825153865601585,38.47194148809562,0.04623907818448303,1074.9890460968018,392.3834021091461,1422.7346992492676,47188,5568,41620,41620,0,9,6044000.0
6044,6044999,21.824900724807026,38.470519998348095,0.04623087936022885,1075.1153950691223,392.44520807266235,1423.0604133605957,47190,5568,41622,41622,0,9,6045000.0
6045,6045999,21.824235276326586,38.46854115547489,0.0462295853961896,1075.6652579307556,392.50826025009155,1423.3835220336914,47222,5572,41650,41650,0,9,6046000.0
6046,6046999,21.823168143808424,38.467596436128005,0.04623580784625991,1075.794949054718,392.57119393348694,1423.7777404785156,47232,5572,41660,41660,0,9,6047000.0
6047,6047999,21.821932507527226,38.466126069438225,0.046238877750631846,1075.9263565540314,392.63309359550476,1424.1178932189941,47232,5572,41660,41660,0,9,6048000.0
6048,6048999,21.820642184105786,38.4638186184618,0.046248615997274145,1076.1668293476105,392.6989586353302,1424.375690460205,47242,5573,41669,41669,0,9,6049000.0
6049,6049999,21.819577931127064,38.46187954393765,0.04625390581965594,1076.2943093776703,392.7635614871979,1424.5345611572266,47242,5573,41669,41669,0,9,6050000.0
6050,6050999,21.81851354705222,38.45962375669357,0.04625678034797909,1076.529531955719,392.8269853591919,1424.7116317749023,47246,5574,41672,41672,0,9,6051000.0
6051,6051999,21.817493419934042,38.45750805681077,0.04626573308741733,1076.7680308818817,392.88978481292725,1424.942783355713,47256,5575,41681,41681,0,9,6052000.0
6052,6052999,21.816477596979915,38.455270237708135,0.046274842875116295,1076.889407634735,392.95157170295715,1425.1457557678223,47257,5575,41682,41682,0,9,6053000.0
6053,6053999,21.81556782946126,38.45319782525299,0.04627641747101452,1077.1224355697632,393.013548374176,1425.239631652832,47265,5576,41689,41689,0,9,6054000.0
6054,6054999,21.814905963639045,38.45135976312826,0.04627805418715325,1077.6667540073395,393.0762195587158,1425.145679473877,47294,5580,41714,41714,0,9,6055000.0
6055,6055999,21.814266114906083,38.44945405122394,0.04627912615597418,1078.1080417633057,393.1408190727234,1425.219882965088,47320,5583,41737,41737,0,9,6056000.0
6056,6056999,21.813570242415384,38.44754153828548,0.04627995043498179,1078.4593586921692,393.205842256546,1425.3532066345215,47325,5585,41740,41740,0,9,6057000.0
6057,6057999,21.812987944144936,38.44576437590639,0.046276910605123844,1078.6892538070679,393.2675681114197,1425.5969848632812,47335,5586,41749,41749,0,9,6058000.0
6058,6058999,21.81235053984166,38.44371204662205,0.0462726927977839,1078.8166790008545,393.3294150829315,1425.7869262695312,47336,5586,41750,41750,0,9,6059000.0
6059,6059999,21.811874078252224,38.44218019111863,0.046266035194962085,1079.050460100174,393.39169812202454,1426.0295066833496,47352,5587,41765,41765,0,9,6060000.0
6060,6060999,21.811749222856744,38.44090567280056,0.046256841107275015,1079.399535894394,393.4568431377411,1426.184829711914,47372,5589,41783,41783,0,9,6061000.0
6061,6061999,21.811457776900443,38.4393369678263,0.04624238405318748,1079.533195734024,393.5222613811493,1426.5085983276367,47376,5589,41787,41787,0,9,6062000.0
6062,6062999,21.81165657011802,38.43857257082201,0.04622947865625093,1079.7734830379486,393.58435440063477,1426.7406005859375,47407,5590,41817,41817,0,9,6063000.0
6063,6063999,21.811538229907622,38.43772866316895,0.04621540701378024,1080.212985277176,393.6470148563385,1426.882724761963,47458,5593,41865,41865,0,9,6064000.0
6064,6064999,21.811296386742892,38.436511813657944,0.046208248702546806,1080.5452253818512,393.71035146713257,1427.1659545898438,47477,5595,41882,41882,0,9,6065000.0
6065,6065999,21.81062407984532,38.434578290135725,0.04620669376572206,1080.7732348442078,393.7702593803406,1427.371997833252,47479,5596,41883,41883,0,9,6066000.0
6066,6066999,21.809637998881687,38.43249516600415,0.04620979356963206,1080.911152124405,393.8321051597595,1427.830883026123,47479,5596,41883,41883,0,9,6067000.0
6067,6067999,21.808494371016696,38.43030895622978,0.04621056559230974,1081.1544766426086,393.89478611946106,1428.1510581970215,47484,5597,41887,41887,0,9,6068000.0
6068,6068999,21.80754695728325,38.428631355251035,0.046216068671662947,1081.4891476631165,393.95721673965454,1428.2752685546875,47490,5599,41891,41891,0,9,6069000.0
6069,6069999,21.8066840968052,38.42668372330085,0.04621737225067413,1081.8233578205109,394.01937913894653,1428.4364395141602,47504,5601,41903,41903,0,9,6070000.0
6070,6070999,21.806117521205987,38.42523030533756,0.046213344483521546,1082.0529808998108,394.0827374458313,1428.6779327392578,47518,5602,41916,41916,0,9,6071000.0
6071,6071999,21.80528876095456,38.423243874123756,0.04621664697531114,1082.2983441352844,394.14509558677673,1428.878273010254,47521,5603,41918,41918,0,9,6072000.0
6072,6072999,21.80462537771905,38.4216081753216,0.046218225716885164,1082.5270538330078,394.20680141448975,1428.9674491882324,47529,5604,41925,41925,0,9,6073000.0
6073,6073999,21.8041257346356,38.419961023149966,0.04622086598866759,1082.6510224342346,394.26853370666504,1429.192741394043,47529,5604,41925,41925,0,9,6074000.0
6074,6074999,21.80385427363511,38.418675791304054,0.04621913002362876,1082.7756006717682,394.32980370521545,1429.3768463134766,47529,5604,41925,41925,0,9,6075000.0
6075,6075999,21.80359343316345,38.417530467271696,0.046214380302783464,1083.0092890262604,394.39148330688477,1429.538673400879,47544,5605,41939,41939,0,9,6076000.0
6076,6076999,21.80334086996715,38.416107246420225,0.04620499513413989,1083.2371664047241,394.4538412094116,1429.732837677002,47546,5606,41940,41940,0,9,6077000.0
6077,6077999,21.803083419234394,38.414504543985025,0.04620147247065831,1083.4719343185425,394.51538586616516,1429.9102745056152,47554,5607,41947,41947,0,9,6078000.0
6078,6078999,21.803028061671068,38.41302564876427,0.04618899155022349,1083.5950682163239,394.57789397239685,1430.1410903930664,47554,5607,41947,41947,0,9,6079000.0
6079,6079999,21.802970806687174,38.41151602084893,0.04617717823634804,1084.0406830310822,394.64052629470825,1430.3080368041992,47571,5610,41961,41961,0,9,6080000.0
6080,6080999,21.803077694905458,38.41008935253037,0.04616654332310055,1084.164225101471,394.70207118988037,1430.538673400879,47571,5610,41961,41961,0,9,6081000.0
6081,6081999,21.803106176801425,38.40856531698684,0.04614895295526045,1084.2940955162048,394.76609921455383,1430.699047088623,47572,5610,41962,41962,0,9,6082000.0
6082,6082999,21.803412364933152,38.40732271263965,0.04612624959943634,1084.5210123062134,394.8275897502899,1430.7979125976562,47578,5611,41967,41967,0,9,6083000.0
6083,6083999,21.803536256956857,38.406744768097575,0.04611093071705297,1084.8589916229248,394.8895163536072,1430.882869720459,47593,5613,41980,41980,0,9,6084000.0
6084,6084999,21.803523821453577,38.405203458572814,0.046097879532227215,1084.9889032840729,394.95350885391235,1431.1215896606445,47594,5613,41981,41981,0,9,6085000.0
6085,6085999,21.803085916246726,38.4033320228262,0.046093964481670247,1085.1051495075226,395.0156157016754,1431.3418159484863,47595,5613,41982,41982,0,9,6086000.0
6086,6086999,21.802214297805783,38.40136187743455,0.046092022024705304,1085.2318167686462,395.0782914161682,1432.3064422607422,47627,5613,42014,42014,0,9,6087000.0
6087,6087999,21.800783440554277,38.39924901724633,0.046089435295927794,1085.353912115097,395.14164447784424,1432.8504028320312,47637,5613,42024,42024,0,9,6088000.0
6088,6088999,21.799408073742757,38.39766477139279,0.04608711498888152,1085.5889587402344,395.20564222335815,1433.1987686157227,47653,5614,42039,42039,0,9,6089000.0
6089,6089999,21.798355093620422,38.39594778397086,0.046086283844060216,1085.7189433574677,395.2713348865509,1433.6285972595215,47663,5614,42049,42049,0,9,6090000.0
6090,6090999,21.797370765954387,38.39389570310186,0.04608040056382667,1085.9544622898102,395.3362057209015,1433.952320098877,47682,5615,42067,42067,0,9,6091000.0
6091,6091999,21.7962226433402,38.39176761208467,0.046078409598767855,1086.2836248874664,395.39822030067444,1434.2403678894043,47702,5617,42085,42085,0,9,6092000.0
6092,6092999,21.79530576177234,38.39104298748961,0.04607207080682851,1086.6249978542328,395.46210956573486,1434.5100402832031,47720,5619,42101,42101,0,9,6093000.0
6093,6093999,21.794575167346686,38.3893520964033,0.046064917135682615,1086.8556942939758,395.52451753616333,1434.7608184814453,47733,5620,42113,42113,0,9,6094000.0
6094,6094999,21.793651893231065,38.38725723438665,0.04606344051297295,1086.977207660675,395.5863127708435,1434.9314460754395,47734,5620,42114,42114,0,9,6095000.0
6095,6095999,21.793123944773658,38.385581506020316,0.04605528839158568,1087.4233458042145,395.6500918865204,1435.0602798461914,47749,5623,42126,42126,0,9,6096000.0
6096,6096999,21.792565213759197,38.38379574829192,0.04605076371751571,1087.7710626125336,395.71399974823,1435.3850593566895,47767,5625,42142,42142,0,9,6097000.0
6097,6097999,21.792127205357072,38.382029597000084,0.046040993339759084,1087.9984538555145,395.7786045074463,1435.5575523376465,47778,5626,42152,42152,0,9,6098000.0
6098,6098999,21.79164833870212,38.380585998681966,0.04603242595253909,1088.349021434784,395.8446762561798,1435.670581817627,47792,5628,42164,42164,0,9,6099000.0
6099,6099999,21.79139117212098,38.379207781296685,0.04602303944735486,1088.5919086933136,395.907274723053,1435.7963752746582,47796,5629,42167,42167,0,9,6100000.0
6100,6100999,21.79104606722521,38.377618382967576,0.046009238793086826,1088.8254363536835,395.9719543457031,1436.010570526123,47806,5630,42176,42176,0,9,6101000.0
6101,6101999,21.790878140803414,38.376168068840705,0.04599456383990197,1089.0624151229858,396.03671884536743,1436.1844482421875,47811,5631,42180,42180,0,9,6102000.0
6102,6102999,21.790706990958757,38.37470261364896,0.045973931782301136,1089.2893450260162,396.0985617637634,1436.4537811279297,47826,5632,42194,42194,0,9,6103000.0
6103,6103999,21.790921904437745,38.37381622778802,0.04594914537443795,1089.5233001708984,396.16107153892517,1436.6366958618164,47830,5633,42197,42197,0,9,6104000.0
6104,6104999,21.79073377946716,38.37333572402021,0.045931193771196366,1089.7490236759186,396.2225570678711,1436.849708557129,47843,5634,42209,42209,0,9,6105000.0
6105,6105999,21.790487422037856,38.371751285079675,0.04591342076749483,1090.2023289203644,396.2878520488739,1437.0728149414062,47866,5637,42229,42229,0,9,6106000.0
6106,6106999,21.789950521321497,38.369974308021746,0.04590633596422111,1090.5438146591187,396.3497633934021,1437.4145698547363,47891,5639,42252,42252,0,9,6107000.0
6107,6107999,21.78908967887759,38.368483443667365,0.04590272828219133,1090.6732132434845,396.41550755500793,1438.4302825927734,47921,5639,42282,42282,0,9,6108000.0
6108,6108999,21.787818488973553,38.36725021211352,0.04590224699204781,1090.8961610794067,396.47829580307007,1438.8779182434082,47930,5640,42290,42290,0,9,6109000.0
6109,6109999,21.786425824124866,38.3650375063585,0.04590452855688809,1091.0343868732452,396.54318499565125,1439.1310691833496,47931,5640,42291,42291,0,9,6110000.0
6110,6110999,21.785410764695307,38.36418020295656,0.045841233788220026,1091.1552052497864,396.60338044166565,1439.470329284668,47932,5640,42292,42292,0,9,6111000.0
6111,6111999,21.784536237469457,38.3626331101491,0.04583598693278912,1091.3828375339508,396.66521191596985,1439.6551971435547,47942,5641,42301,42301,0,9,6112000.0
6112,6112999,21.78362090592029,38.36096133462754,0.045837570152294616,1091.498804807663,396.72686409950256,1439.8861694335938,47942,5641,42301,42301,0,9,6113000.0
6113,6113999,21.782720636601248,38.35927033054178,0.04583854444377755,1091.94144821167,396.7890655994415,1440.012409210205,47957,5644,42313,42313,0,9,6114000.0
6114,6114999,21.78197964960821,38.357565536244145,0.045830258138966906,1092.1650693416595,396.8510773181915,1440.2373428344727,47966,5645,42321,42321,0,9,6115000.0
6115,6115999,21.781069472737606,38.35564006790271,0.04582727860866076,1092.400179386139,396.91288113594055,1440.3899955749512,47997,5646,42351,42351,0,9,6116000.0
6116,6116999,21.780453517904864,38.35427291457086,0.04582466597628909,1092.7313754558563,396.97338128089905,1440.5041160583496,48009,5648,42361,42361,0,9,6117000.0
6117,6117999,21.779652458602857,38.35250599106505,0.04582140091497966,1093.1895570755005,397.03612899780273,1440.5898475646973,48030,5651,42379,42379,0,9,6118000.0
6118,6118999,21.779106448343438,38.35104477919362,0.04581312438227636,1093.309735774994,397.1008563041687,1440.7648391723633,48030,5651,42379,42379,0,9,6119000.0
6119,6119999,21.77845288116275,38.349616321682994,0.045811244565614806,1093.65278840065,397.1638114452362,1440.9168586730957,48036,5653,42383,42383,0,9,6120000.0
6120,6120999,21.777831006287048,38.34802658551935,0.045807348021859484,1093.883071899414,397.22570395469666,1441.0646171569824,48047,5654,42393,42393,0,9,6121000.0
6121,6121999,21.777432955538,38.34685694419349,0.04579879844411139,1094.1242015361786,397.2882387638092,1441.2995262145996,48050,5655,42395,42395,0,9,6122000.0
6122,6122999,21.776861952153553,38.345459697223276,0.045801259342973744,1094.3555235862732,397.3503668308258,1441.5079498291016,48063,5656,42407,42407,0,9,6123000.0
6123,6123999,21.776551176673866,38.344235743676656,0.04579205225165306,1094.6861498355865,397.4120798110962,1441.6777801513672,48081,5658,42423,42423,0,9,6124000.0
6124,6124999,21.776193314523603,38.34288677988583,0.04578737653517018,1095.0249376296997,397.4757978916168,1441.778579711914,48085,5660,42425,42425,0,9,6125000.0
6125,6125999,21.775841555101895,38.341466594636785,0.04577910553797038,1095.145243883133,397.53914618492126,1442.1192588806152,48088,5660,42428,42428,0,9,6126000.0
6126,6126999,21.775565730987278,38.34009787506131,0.045771719009359946,1095.2648756504059,397.600382566452,1442.3913307189941,48089,5660,42429,42429,0,9,6127000.0
6127,6127999,21.77500701734827,38.33888753843989,0.04576627609011952,1095.7228236198425,397.66562151908875,1442.4344673156738,48110,5663,42447,42447,0,9,6128000.0
6128,6128999,21.77394744545261,38.337095845773504,0.04577113282414624,1095.848599433899,397.7295699119568,1443.3693504333496,48132,5663,42469,42469,0,9,6129000.0
6129,6129999,21.7728996584052,38.33536035335354,0.04577529366529309,1095.9755191802979,397.79179286956787,1443.8456802368164,48136,5663,42473,42473,0,9,6130000.0
6130,6130999,21.771832924057556,38.333225022765525,0.04577995104870125,1096.2117459774017,397.8541724681854,1444.1981048583984,48145,5664,42481,42481,0,9,6131000.0
6131,6131999,21.771014282310087,38.33207909228425,0.045782207606446024,1096.433845758438,397.91556692123413,1444.4129638671875,48155,5665,42490,42490,0,9,6132000.0
6132,6132999,21.770076497765224,38.33068407959538,0.04578424496621614,1096.5621974468231,397.9776747226715,1444.7361106872559,48158,5665,42493,42493,0,9,6133000.0
6133,6133999,21.769102080765084,38.328698413189464,0.045785806176291466,1096.787335395813,398.0398461818695,1444.925651550293,48165,5666,42499,42499,0,9,6134000.0
6134,6134999,21.768286104551272,38.32716046239625,0.04578580445697966,1097.0181150436401,398.10199093818665,1445.164665222168,48168,5667,42501,42501,0,9,6135000.0
6135,6135999,21.767393811924904,38.32501501674542,0.045788824673475115,1097.1363875865936,398.1619155406952,1445.3946571350098,48169,5667,42502,42502,0,9,6136000.0
6136,6136999,21.766489117560614,38.32286671332334,0.04579265898259566,1097.2681884765625,398.22354912757874,1445.5737495422363,48169,5667,42502,42502,0,9,6137000.0
6137,6137999,21.76579407432276,38.3209393895116,0.045792524307020965,1097.386018037796,398.2852611541748,1445.8295402526855,48170,5667,42503,42503,0,9,6138000.0
6138,6138999,21.765312855866988,38.319279967749246,0.04579227674984643,1097.5010747909546,398.346563577652,1446.0475997924805,48171,5667,42504,42504,0,9,6139000.0
6139,6139999,21.764737497168657,38.31743669761641,0.04578919125500858,1097.6272416114807,398.4083847999573,1446.2249374389648,48171,5667,42504,42504,0,9,6140000.0
6140,6140999,21.764360536969,38.31558143432792,0.04578793525650848,1097.9660241603851,398.4710690975189,1446.2847061157227,48176,5669,42507,42507,0,9,6141000.0
6141,6141999,21.764076776203883,38.313971759140145,0.04578464282583605,1098.3076329231262,398.53371381759644,1446.4318733215332,48192,5671,42521,42521,0,9,6142000.0
6142,6142999,21.763749830143734,38.31220120837721,0.04577957858426107,1098.546528339386,398.59514451026917,1446.6527061462402,48199,5672,42527,42527,0,9,6143000.0
6143,6143999,21.763308227437715,38.310264818785384,0.04577770226247402,1098.6782360076904,398.65885829925537,1446.9192810058594,48202,5672,42530,42530,0,9,6144000.0
6144,6144999,21.763003491638152,38.310037731391574,0.04577847832671966,1099.029904127121,398.7211527824402,1447.2510032653809,48215,5674,42541,42541,0,9,6145000.0
6145,6145999,21.761988168340174,38.308423336605316,0.04578264432406021,1099.2621035575867,398.7839858531952,1448.1511726379395,48252,5675,42577,42577,0,9,6146000.0
6146,6146999,21.760808565153752,38.30670519842352,0.04579569840096631,1099.4913120269775,398.8479619026184,1448.7198791503906,48268,5676,42592,42592,0,9,6147000.0
6147,6147999,21.759854182182334,38.30540807044824,0.04580300783069824,1099.7193048000336,398.911288022995,1449.1349792480469,48276,5677,42599,42599,0,9,6148000.0
6148,6148999,21.758826580228735,38.30352362541317,0.04581124961376415,1099.8487992286682,398.97601413726807,1449.5663032531738,48284,5677,42607,42607,0,9,6149000.0
6149,6149999,21.75781464881082,38.30169224785488,0.04581942508210668,1099.968215227127,399.0388431549072,1449.969638824463,48289,5677,42612,42612,0,9,6150000.0
6150,6150999,21.75667108049513,38.299633112673654,0.04582677436436,1100.0922455787659,399.1011950969696,1450.3696517944336,48297,5677,42620,42620,0,9,6151000.0
6151,6151999,21.755514211199507,38.29752153696984,0.04583296429338768,1100.2110979557037,399.16314220428467,1450.715476989746,48302,5677,42625,42625,0,9,6152000.0
6152,6152999,21.754695164276935,38.29649239070518,0.045832943352571265,1100.5446372032166,399.22483682632446,1450.9157104492188,48322,5679,42643,42643,0,9,6153000.0
6153,6153999,21.753719432176577,38.29447704878502,0.045836402101576135,1100.9993829727173,399.2873125076294,1451.140796661377,48350,5682,42668,42668,0,9,6154000.0
6154,6154999,21.753243622797353,38.29351401112491,0.04582973797280976,1101.3418345451355,399.35038805007935,1451.4048919677734,48359,5684,42675,42675,0,9,6155000.0
6155,6155999,21.752583511631524,38.29200671003815,0.04582802525102059,1101.685319185257,399.4146795272827,1451.5273170471191,48379,5686,42693,42693,0,9,6156000.0
6156,6156999,21.751731719913504,38.28997556786813,0.04582516640644929,1101.8118472099304,399.476420879364,1451.8765907287598,48381,5686,42695,42695,0,9,6157000.0
6157,6157999,21.751322369387267,38.288614446944536,0.04581956514841545,1102.063954114914,399.54560232162476,1452.1298217773438,48386,5687,42699,42699,0,9,6158000.0
6158,6158999,21.750835008281754,38.28710038900349,0.04581791877677721,1102.3079075813293,399.610018491745,1452.2550506591797,48397,5688,42709,42709,0,9,6159000.0
6159,6159999,21.750392666870198,38.285621739330274,0.04580992845978904,1102.4232676029205,399.67101788520813,1452.5749320983887,48402,5688,42714,42714,0,9,6160000.0
6160,6160999,21.750136525658323,38.284431319107696,0.04580071154927856,1102.6645286083221,399.7359867095947,1452.84818649292,48413,5689,42724,42724,0,9,6161000.0
6161,6161999,21.74957057450088,38.28275152685229,0.045795799507764134,1102.7897744178772,399.79761934280396,1453.0727005004883,48414,5689,42725,42725,0,9,6162000.0
6162,6162999,21.74921519787743,38.28130169890758,0.04578858973229394,1102.9129748344421,399.85931038856506,1453.3409614562988,48418,5689,42729,42729,0,9,6163000.0
6163,6163999,21.74876016656278,38.279704367798104,0.04578127423965639,1103.151511669159,399.92124462127686,1453.5372619628906,48422,5690,42732,42732,0,9,6164000.0
6164,6164999,21.747902597086647,38.277639469135046,0.045781158705345826,1103.598732471466,399.9857485294342,1453.8510284423828,48450,5693,42757,42757,0,9,6165000.0
6165,6165999,21.746863852473513,38.27695839850543,0.04578441937374267,1103.8382594585419,400.0481858253479,1454.3972511291504,48471,5694,42777,42777,0,9,6166000.0
6166,6166999,21.74577824667787,38.275157821741324,0.045789555580994956,1103.9546601772308,400.110032081604,1454.790771484375,48475,5694,42781,42781,0,9,6167000.0
6167,6167999,21.74459872058846,38.27306651413715,0.04579793070907878,1104.2876739501953,400.1720025539398,1454.955883026123,48491,5696,42795,42795,0,9,6168000.0
6168,6168999,21.743729842993574,38.27141421951612,0.045801354694106955,1104.4082720279694,400.23276472091675,1455.2134628295898,48493,5696,42797,42797,0,9,6169000.0
6169,6169999,21.74286269614222,38.270168770117905,0.04579937398035061,1104.6388182640076,400.2941999435425,1455.3617248535156,48497,5697,42800,42800,0,9,6170000.0
6170,6170999,21.741869966697124,38.26813117847691,0.045802525494838875,1104.791759967804,400.36771941185,1455.6434364318848,48500,5697,42803,42803,0,9,6171000.0
6171,6171999,21.74095500850484,38.2662996925202,0.045805380422076825,1104.9124562740326,400.42912912368774,1455.8783073425293,48502,5697,42805,42805,0,9,6172000.0
6172,6172999,21.740212475182798,38.26454238185703,0.04580408804450575,1105.1413705348969,400.4910669326782,1456.1889190673828,48513,5698,42815,42815,0,9,6173000.0
6173,6173999,21.7391964072056,38.26240430638055,0.04580528569443543,1105.6217951774597,400.5574436187744,1456.2281875610352,48546,5701,42845,42845,0,9,6174000.0
6174,6174999,21.73868094067947,38.26319885626948,0.04579472380508742,1105.9867305755615,400.62832856178284,1456.5032081604004,48562,5703,42859,42859,0,9,6175000.0
6175,6175999,21.738042278344256,38.26147085540288,0.04579058196595809,1106.34135222435,400.6930046081543,1456.667465209961,48581,5705,42876,42876,0,9,6176000.0
6176,6176999,21.737679405434122,38.26027823229213,0.045786616512869416,1106.6894352436066,400.7553400993347,1456.7552871704102,48594,5707,42887,42887,0,9,6177000.0
6177,6177999,21.73711469187383,38.258832746127844,0.045783825733485384,1106.8101091384888,400.81864070892334,1456.948471069336,48594,5707,42887,42887,0,9,6178000.0
6178,6178999,21.737294930550792,38.258301712136294,0.04577839980443488,1107.1646304130554,400.87950706481934,1457.0256309509277,48607,5709,42898,42898,0,9,6179000.0
6179,6179999,21.737442078977278,38.25769245417487,0.04577253239871537,1107.3874771595001,400.94053649902344,1457.1495475769043,48609,5710,42899,42899,0,9,6180000.0
6180,6180999,21.737703784481297,38.25731890364554,0.04577007309905046,1107.8338420391083,401.0022053718567,1457.240608215332,48638,5713,42925,42925,0,9,6181000.0
6181,6181999,21.738383896860682,38.257915415775024,0.04575326771093291,1107.9759001731873,401.06745886802673,1457.5200309753418,48641,5713,42928,42928,0,9,6182000.0
6182,6182999,21.738869159224766,38.25785648024185,0.04574782436230662,1108.3170745372772,401.1289348602295,1457.5982666015625,48654,5715,42939,42939,0,9,6183000.0
6183,6183999,21.73889838050645,38.256884804844,0.04574177641994881,1108.547946214676,401.1904923915863,1457.7471199035645,48657,5716,42941,42941,0,9,6184000.0
6184,6184999,21.738668972063227,38.255545402367446,0.045742291029546855,1108.7814798355103,401.25271940231323,1457.9773063659668,48669,5717,42952,42952,0,9,6185000.0
6185,6185999,21.7381016359461,38.25391307815174,0.045740357842802726,1109.0250034332275,401.3160710334778,1458.6186981201172,48698,5718,42980,42980,0,9,6186000.0
6186,6186999,21.7365930742513,38.251560774560964,0.04574717335355716,1109.146150112152,401.37857699394226,1459.3361434936523,48717,5718,42999,42999,0,9,6187000.0
6187,6187999,21.73529885291689,38.25012041228415,0.04575017486376598,1109.380483865738,401.44211506843567,1459.7908668518066,48733,5719,43014,43014,0,9,6188000.0
6188,6188999,21.734079471510242,38.24872638974468,0.04575214495999225,1109.6168932914734,401.5049922466278,1460.0960083007812,48736,5720,43016,43016,0,9,6189000.0
6189,6189999,21.732836840878093,38.24646637470238,0.04575592793539862,1109.8510887622833,401.56728053092957,1460.3288764953613,48740,5721,43019,43019,0,9,6190000.0
6190,6190999,21.731643791451,38.24439655158002,0.045756041223335986,1110.078670501709,401.6293513774872,1460.5297508239746,48755,5722,43033,43033,0,9,6191000.0
6191,6191999,21.73045667057569,38.24233357787131,0.04575909910434284,1110.202630996704,401.6922869682312,1460.831527709961,48757,5722,43035,43035,0,9,6192000.0
6192,6192999,21.729357299784073,38.24035019484776,0.04576313909746543,1110.545394897461,401.7549214363098,1461.0662231445312,48777,5724,43053,43053,0,9,6193000.0
6193,6193999,21.72823525448078,38.238239702462444,0.0457675455316745,1110.6672837734222,401.81860280036926,1461.4468421936035,48780,5724,43056,43056,0,9,6194000.0
6194,6194999,21.727321855058413,38.236427456597774,0.04577101952318341,1110.7930979728699,401.88059544563293,1461.7540664672852,48782,5724,43058,43058,0,9,6195000.0
6195,6195999,21.726555473869173,38.23469978592529,0.045775002157680045,1111.1333532333374,401.9438509941101,1461.9239349365234,48792,5726,43066,43066,0,9,6196000.0
6196,6196999,21.725957801757712,38.23323388734479,0.04577906430647516,1111.264101266861,402.00591111183167,1462.2419128417969,48794,5726,43068,43068,0,9,6197000.0
6197,6197999,21.725228164872085,38.231558452926826,0.0457818067021476,1111.3860795497894,402.06749868392944,1462.5101318359375,48796,5726,43070,43070,0,9,6198000.0
6198,6198999,21.724523789558322,38.22979495520035,0.04578537314022124,1111.6130311489105,402.12981843948364,1462.708827972412,48798,5727,43071,43071,0,9,6199000.0
6199,6199999,21.72428656791321,38.22878901309362,0.045781201668904314,1111.8394331932068,402.19247794151306,1463.0887985229492,48805,5728,43077,43077,0,9,6200000.0
6200,6200999,21.72411462684307,38.22766723273095,0.045784403373058336,1111.9670202732086,402.2579233646393,1463.5024375915527,48809,5728,43081,43081,0,9,6201000.0
6201,6201999,21.72408112933974,38.227739527694624,0.0457829526472624,1112.4184486865997,402.32052421569824,1463.6938438415527,48863,5731,43132,43132,0,9,6202000.0
6202,6202999,21.7239011080355,38.226512197060806,0.0457835086676901,1112.7560896873474,402.38323187828064,1463.9913940429688,48881,5733,43148,43148,0,9,6203000.0
6203,6203999,21.723865797114943,38.22538677253623,0.045785011834630795,1113.1133124828339,402.44938588142395,1464.2135429382324,48915,5735,43180,43180,0,9,6204000.0
6204,6204999,21.72361689187756,38.22389975556445,0.045785787664737954,1113.244250535965,402.51453971862793,1464.5539779663086,48917,5735,43182,43182,0,9,6205000.0
6205,6205999,21.723038155027087,38.22205254666037,0.04578456845097545,1113.3725941181183,402.5770628452301,1464.7877388000488,48917,5735,43182,43182,0,9,6206000.0
6206,6206999,21.721996959438954,38.21979349859414,0.04579095044007453,1113.6088523864746,402.6404345035553,1465.5623664855957,48943,5736,43207,43207,0,9,6207000.0
6207,6207999,21.720594772817602,38.217484400453614,0.04580077742634192,1113.8486268520355,402.70321702957153,1466.0085754394531,48953,5737,43216,43216,0,9,6208000.0
6208,6208999,21.719319630489927,38.21551490328926,0.04580483214162523,1113.9764332771301,402.7661118507385,1466.2627601623535,48954,5737,43217,43217,0,9,6209000.0
6209,6209999,21.71813155381553,38.213277904381286,0.04581024224452801,1114.1021900177002,402.82813906669617,1466.6130599975586,48955,5737,43218,43218,0,9,6210000.0
6210,6210999,21.717198589885086,38.21154182927192,0.04581162611695122,1114.2169082164764,402.88959193229675,1466.8660697937012,48956,5737,43219,43219,0,9,6211000.0
6211,6211999,21.716323353342446,38.209751015082304,0.04581573429400054,1114.4557967185974,402.95157194137573,1466.9737815856934,48968,5738,43230,43230,0,9,6212000.0
6212,6212999,21.715373567622272,38.208003707805425,0.0458214966507513,1114.8053500652313,403.01557874679565,1467.1725997924805,48980,5740,43240,43240,0,9,6213000.0
6213,6213999,21.71450326574042,38.206379210342455,0.045824540289652216,1114.9209685325623,403.07717084884644,1467.3713874816895,48980,5740,43240,43240,0,9,6214000.0
6214,6214999,21.71353413244347,38.20444529861632,0.045828392830227105,1115.2716963291168,403.1394200325012,1467.4321937561035,49000,5742,43258,43258,0,9,6215000.0
6215,6215999,21.71267285376502,38.20268842996462,0.04582995115245503,1115.499730348587,403.20117020606995,1467.7479934692383,49017,5743,43274,43274,0,9,6216000.0
6216,6216999,21.712146802702126,38.201797749736116,0.04582661020349321,1115.8500535488129,403.26504158973694,1468.0306968688965,49039,5745,43294,43294,0,9,6217000.0
6217,6217999,21.71134288482807,38.1999139112956,0.045826429875389985,1116.1869404315948,403.3271903991699,1468.132007598877,49078,5747,43331,43331,0,9,6218000.0
6218,6218999,21.710503568136183,38.198061861296466,0.04582557133575049,1116.529786348343,403.3900284767151,1468.236728668213,49090,5749,43341,43341,0,9,6219000.0
6219,6219999,21.70979713493911,38.19630243929025,0.045819677008036463,1116.8801777362823,403.45171546936035,1468.316177368164,49102,5751,43351,43351,0,9,6220000.0
6220,6220999,21.709077929563588,38.19456638851311,0.045816697361294345,1117.113835811615,403.5134496688843,1468.46146774292,49106,5752,43354,43354,0,9,6221000.0
6221,6221999,21.708550045105518,38.19319891400741,0.04581121281349243,1117.2348520755768,403.57441544532776,1468.6612815856934,49107,5752,43355,43355,0,9,6222000.0
6222,6222999,21.707939092657995,38.19170990131343,0.04580730566083813,1117.5829770565033,403.636923789978,1468.7681694030762,49128,5754,43374,43374,0,9,6223000.0
6223,6223999,21.707233459645487,38.18996129340416,0.04580484961167586,1118.2696542739868,403.7006952762604,1468.6182594299316,49146,5759,43387,43387,0,9,6224000.0
6224,6224999,21.70656152929116,38.18834317291219,0.04580063696990777,1118.3928039073944,403.76202726364136,1468.8415832519531,49146,5759,43387,43387,0,9,6225000.0
6225,6225999,21.705766347438168,38.186387776362466,0.04580057314890573,1118.6237671375275,403.82386445999146,1469.0383224487305,49158,5760,43398,43398,0,9,6226000.0
6226,6226999,21.70482797654037,38.18425260057695,0.04580155360350069,1118.9663486480713,403.88541984558105,1469.1842651367188,49168,5762,43406,43406,0,9,6227000.0
6227,6227999,21.703774736644586,38.183252804282525,0.04580251237905164,1119.3136401176453,403.9483768939972,1469.9401397705078,49208,5764,43444,43444,0,9,6228000.0
6228,6228999,21.702513606564423,38.18125085023155,0.04580961059498201,1119.442137002945,404.01080417633057,1470.29496383667,49210,5764,43446,43446,0,9,6229000.0
6229,6229999,21.70120391045304,38.17894718438639,0.04581660591779546,1119.561081647873,404.07269167900085,1470.5426177978516,49211,5764,43447,43447,0,9,6230000.0
6230,6230999,21.70027746916234,38.17864610923597,0.045822144526917574,1119.6816844940186,404.13512110710144,1470.8339347839355,49212,5764,43448,43448,0,9,6231000.0
6231,6231999,21.699019376855684,38.17640058576298,0.045828105773529026,1119.8052520751953,404.19694089889526,1471.0715560913086,49214,5764,43450,43450,0,9,6232000.0
6232,6232999,21.698111989098326,38.174639771489915,0.04583010180219926,1120.0510115623474,404.259473323822,1471.2354316711426,49222,5765,43457,43457,0,9,6233000.0
6233,6233999,21.697267076868087,38.17312903209172,0.04582977264453025,1120.2898664474487,404.3221912384033,1471.4050216674805,49226,5766,43460,43460,0,9,6234000.0
6234,6234999,21.69662895792711,38.171761352170456,0.04582781237917355,1120.404997587204,404.38371992111206,1471.7274742126465,49229,5766,43463,43463,0,9,6235000.0
6235,6235999,21.695982109619553,38.17035858914879,0.04582777971007512,1120.6332688331604,404.4450969696045,1471.8515586853027,49238,5767,43471,43471,0,9,6236000.0
6236,6236999,21.69567186059975,38.16962540638467,0.045824545792088944,1121.3291976451874,404.50772500038147,1471.7383995056152,49264,5772,43492,43492,0,9,6237000.0
6237,6237999,21.695347503996263,38.16876117121443,0.045819747659960997,1121.6685552597046,404.5697338581085,1471.8903884887695,49285,5774,43511,43511,0,9,6238000.0
6238,6238999,21.695069347671954,38.16826626833444,0.04581484007207892,1121.9076025485992,404.6313154697418,1472.0254287719727,49291,5775,43516,43516,0,9,6239000.0
6239,6239999,21.694787609642628,38.16722849096921,0.04580606043340796,1122.251488685608,404.6933844089508,1472.1168098449707,49296,5777,43519,43519,0,9,6240000.0
6240,6240999,21.694423859990906,38.16609691678089,0.04580258968616979,1122.3766722679138,404.75488805770874,1472.3091659545898,49296,5777,43519,43519,0,9,6241000.0
6241,6241999,21.694176774042596,38.164903460264156,0.04579160633075263,1122.6121850013733,404.816917181015,1472.4860076904297,49308,5778,43530,43530,0,9,6242000.0
6242,6242999,21.694074494922223,38.16448214244971,0.045777801197280366,1122.7368414402008,404.8785808086395,1472.6395416259766,49308,5778,43530,43530,0,9,6243000.0
6243,6243999,21.69394376768171,38.163524027336535,0.04576812048788892,1122.972041130066,404.94191455841064,1472.7909507751465,49340,5779,43561,43561,0,9,6244000.0
6244,6244999,21.693753099130575,38.162745071147626,0.04575712074666838,1123.4241173267365,405.00411558151245,1472.7561378479004,49364,5782,43582,43582,0,9,6245000.0
6245,6245999,21.693431688111115,38.16138152932797,0.045745175564018026,1123.5647082328796,405.06613087654114,1473.0042533874512,49365,5782,43583,43583,0,9,6246000.0
6246,6246999,21.693188858931872,38.16016613416242,0.045736757988307564,1124.0301382541656,405.1284110546112,1473.0035667419434,49387,5785,43602,43602,0,9,6247000.0
6247,6247999,21.692676168889466,38.15871757845949,0.04572936986059739,1124.4939739704132,405.19266867637634,1473.1516189575195,49419,5788,43631,43631,0,9,6248000.0
6248,6248999,21.691515384976075,38.15675734145065,0.04573286029329393,1124.622644662857,405.25592160224915,1474.1920051574707,49449,5788,43661,43661,0,9,6249000.0
6249,6249999,21.69009560400203,38.1548038779117,0.045737926039550736,1124.8729367256165,405.32895255088806,1474.5996055603027,49462,5789,43673,43673,0,9,6250000.0
6250,6250999,21.6889583413423,38.15336410735563,0.04574143187581248,1125.2094480991364,405.39269948005676,1474.752540588379,49478,5791,43687,43687,0,9,6251000.0
6251,6251999,21.688074545528206,38.15196111170839,0.04574524426248716,1125.5551028251648,405.45581817626953,1475.0948867797852,49507,5793,43714,43714,0,9,6252000.0
6252,6252999,21.686903096409786,38.14993271512862,0.04574946987626094,1125.6813941001892,405.51896119117737,1475.3782234191895,49508,5793,43715,43715,0,9,6253000.0
6253,6253999,21.685817632847037,38.14779401797148,0.04575247994925402,1125.804514169693,405.58176445961,1475.5967102050781,49508,5793,43715,43715,0,9,6254000.0
6254,6254999,21.684681437188647,38.14610883473798,0.04575451348862469,1125.9256138801575,405.64363646507263,1475.8848114013672,49509,5793,43716,43716,0,9,6255000.0
6255,6255999,21.683976046364226,38.145227116525554,0.045754865725970095,1126.1683883666992,405.7096514701843,1476.1829071044922,49525,5794,43731,43731,0,9,6256000.0
6256,6256999,21.68309998973167,38.14357951872727,0.0457563805218868,1126.4035494327545,405.7714731693268,1476.35005569458,49538,5795,43743,43743,0,9,6257000.0
6257,6257999,21.682385681647247,38.142155118606226,0.0457582627259181,1126.866807460785,405.83441948890686,1476.496726989746,49567,5798,43769,43769,0,9,6258000.0
6258,6258999,21.681940282990436,38.14088936814153,0.04576324140408872,1127.4442465305328,405.89829897880554,1476.6986083984375,49607,5802,43805,43805,0,9,6259000.0
6259,6259999,21.681649138475624,38.140311536135506,0.04576682103024565,1127.671059370041,405.96017503738403,1476.8672676086426,49614,5803,43811,43811,0,9,6260000.0
6260,6260999,21.68129219746388,38.13913627055551,0.04576983705653148,1127.9156386852264,406.02258229255676,1477.101993560791,49626,5804,43822,43822,0,9,6261000.0
6261,6261999,21.68113735120034,38.1383319588755,0.045768285787379126,1128.0383772850037,406.08526492118835,1477.3551139831543,49629,5804,43825,43825,0,9,6262000.0
6262,6262999,21.681532821181264,38.13848282004339,0.04576239406854099,1128.3850173950195,406.14786434173584,1477.4833374023438,49671,5806,43865,43865,0,9,6263000.0
6263,6263999,21.68192361466649,38.13851257959777,0.04576525882682336,1128.6162843704224,406.2097566127777,1477.7393608093262,49690,5807,43883,43883,0,9,6264000.0
6264,6264999,21.682216504061447,38.13816814606674,0.04575894177492412,1128.7450592517853,406.2742817401886,1478.1569442749023,49694,5807,43887,43887,0,9,6265000.0
6265,6265999,21.682705245976166,38.13819866283893,0.04575795942593608,1128.974247455597,406.3362753391266,1478.3459701538086,49698,5808,43890,43890,0,9,6266000.0
6266,6266999,21.683147709357076,38.13815584444022,0.045752177364339675,1129.099915266037,406.3982186317444,1478.8107795715332,49702,5808,43894,43894,0,9,6267000.0
6267,6267999,21.68333464186375,38.13728934155487,0.04574684930767792,1129.2157626152039,406.46055340766907,1479.2134017944336,49705,5808,43897,43897,0,9,6268000.0
6268,6268999,21.682976175317986,38.136098678947626,0.045746613007562664,1129.4452457427979,406.52301383018494,1479.4207801818848,49707,5809,43898,43898,0,9,6269000.0
6269,6269999,21.682038770616824,38.1343460047622,0.04574841486070258,1129.5719499588013,406.58784794807434,1480.6200065612793,49745,5809,43936,43936,0,9,6270000.0
6270,6270999,21.68081672761517,38.132280188996326,0.045759424698476714,1129.805743932724,406.6513955593109,1481.2387199401855,49761,5810,43951,43951,0,9,6271000.0
6271,6271999,21.679762766456825,38.13092021446827,0.04576580059578039,1130.0347096920013,406.7141499519348,1481.7280502319336,49774,5811,43963,43963,0,9,6272000.0
6272,6272999,21.678575531991175,38.128840089796846,0.04577171099450239,1130.375864982605,406.7765853404999,1481.975700378418,49789,5813,43976,43976,0,9,6273000.0
6273,6273999,21.677406484648547,38.12671061920528,0.04578227220655595,1130.601182460785,406.83909463882446,1482.2866821289062,49793,5814,43979,43979,0,9,6274000.0
6274,6274999,21.676500990318246,38.125549218437975,0.04578707838223217,1130.8324060440063,406.90185713768005,1482.6580696105957,49804,5815,43989,43989,0,9,6275000.0
6275,6275999,21.675459366866658,38.12372059947874,0.04579053197182292,1130.9498460292816,406.96379709243774,1483.1394004821777,49809,5815,43994,43994,0,9,6276000.0
6276,6276999,21.67452852392835,38.12213417895049,0.04579387961707382,1131.2929005622864,407.026248216629,1483.4068069458008,49829,5817,44012,44012,0,9,6277000.0
6277,6277999,21.67364383514161,38.12029382319564,0.045794943160761936,1131.9708065986633,407.0900282859802,1483.476692199707,49851,5822,44029,44029,0,9,6278000.0
6278,6278999,21.672894914046744,38.11872922070635,0.045795510954176,1132.0850105285645,407.1522026062012,1483.9118156433105,49854,5822,44032,44032,0,9,6279000.0
6279,6279999,21.672272475926597,38.117299903836766,0.04579338332481653,1132.5419392585754,407.2167639732361,1484.1159324645996,49875,5825,44050,44050,0,9,6280000.0
6280,6280999,21.67163314779515,38.11567820136233,0.04579157137684553,1132.6567890644073,407.2783966064453,1484.433780670166,49875,5825,44050,44050,0,9,6281000.0
6281,6281999,21.671209419380524,38.11438642287215,0.04579055919783381,1133.3330557346344,407.3425943851471,1484.6405448913574,49918,5830,44088,44088,0,9,6282000.0
6282,6282999,21.670813396065686,38.11325884354988,0.04578352061203972,1133.4508185386658,407.4060814380646,1485.17387008667,49923,5830,44093,44093,0,9,6283000.0
6283,6283999,21.670178812453965,38.11165967808151,0.045785952880417646,1133.9040274620056,407.47006464004517,1485.4833297729492,49947,5833,44114,44114,0,9,6284000.0
6284,6284999,21.669445082525826,38.109784379386355,0.0457844730506215,1134.0264382362366,407.5345253944397,1485.878086090088,49950,5833,44117,44117,0,9,6285000.0
6285,6285999,21.668612270549453,38.10776939591887,0.0457886231818162,1134.5955305099487,407.5976150035858,1486.1741180419922,49984,5837,44147,44147,0,9,6286000.0
6286,6286999,21.66782866816522,38.106330897298925,0.04578900379380779,1134.8465831279755,407.66433548927307,1487.1292724609375,50027,5838,44189,44189,0,9,6287000.0
6287,6287999,21.666832375460384,38.10486440548151,0.04579718114525788,1135.092723608017,407.728679895401,1487.5996932983398,50045,5839,44206,44206,0,9,6288000.0
6288,6288999,21.665950495224173,38.10597469524282,0.045804641295941084,1135.3253283500671,407.7918965816498,1487.9824447631836,50050,5840,44210,44210,0,9,6289000.0
6289,6289999,21.664977750340892,38.10469224622795,0.04581566771689727,1135.5568890571594,407.85443353652954,1488.241283416748,50061,5841,44220,44220,0,9,6290000.0
6290,6290999,21.664006340623292,38.103192986341476,0.04582506770020911,1135.793664932251,407.9168198108673,1488.5009765625,50077,5842,44235,44235,0,9,6291000.0
6291,6291999,21.662924998495022,38.101357224859136,0.04582975546068768,1136.0423765182495,407.9812202453613,1488.715763092041,50089,5843,44246,44246,0,9,6292000.0
6292,6292999,21.661868107855888,38.099585774033976,0.045835255358108506,1136.1570541858673,408.04295563697815,1489.0198593139648,50092,5843,44249,44249,0,9,6293000.0
6293,6293999,21.660819348069932,38.09780120792204,0.0458396820078778,1136.3935842514038,408.10544538497925,1489.2013130187988,50094,5844,44250,44250,0,9,6294000.0
6294,6294999,21.659866608292667,38.09583529904839,0.04584364182939493,1136.7472157478333,408.16812682151794,1489.4920272827148,50108,5846,44262,44262,0,9,6295000.0
6295,6295999,21.658849771875385,38.09381556797535,0.04584444484806893,1136.9895758628845,408.2311656475067,1489.736671447754,50112,5847,44265,44265,0,9,6296000.0
6296,6296999,21.658167109730016,38.09263295675708,0.04583814255181318,1137.3418068885803,408.2961368560791,1489.9145050048828,50121,5849,44272,44272,0,9,6297000.0
6297,6297999,21.657474178108554,38.09105637476453,0.04583698151389293,1137.5733768939972,408.3583059310913,1490.1394348144531,50133,5850,44283,44283,0,9,6298000.0
6298,6298999,21.656956431129473,38.0898846530567,0.04583025729723633,1137.9305148124695,408.42218041419983,1490.2277717590332,50137,5852,44285,44285,0,9,6299000.0
6299,6299999,21.656616759695858,38.08878270356606,0.04581869182283971,1138.277301311493,408.4844329357147,1490.3775596618652,50154,5854,44300,44300,0,9,6300000.0
6300,6300999,21.656410471010968,38.08755142034315,0.04580498977812586,1138.4092392921448,408.5465850830078,1490.608226776123,50154,5854,44300,44300,0,9,6301000.0
6301,6301999,21.656370252666107,38.0864895341783,0.04579336629340913,1138.63809299469,408.6095895767212,1490.713966369629,50168,5855,44313,44313,0,9,6302000.0
6302,6302999,21.656217535212214,38.085416172608085,0.04578432243606423,1138.8763177394867,408.6748559474945,1490.8789176940918,50197,5856,44341,44341,0,9,6303000.0
6303,6303999,21.656255531094182,38.085346365196436,0.045769856096052663,1139.1169962882996,408.73782563209534,1491.070068359375,50199,5857,44342,44342,0,9,6304000.0
6304,6304999,21.65608636770126,38.08431806770761,0.04576045444206045,1139.3468849658966,408.7996611595154,1491.2731437683105,50209,5858,44351,44351,0,9,6305000.0
6305,6305999,21.65569598122702,38.08347932601378,0.04575019338107411,1139.6990597248077,408.8656644821167,1491.4183769226074,50214,5860,44354,44354,0,9,6306000.0
6306,6306999,21.655123862895508,38.083411076853736,0.04574838559965033,1140.0406806468964,408.9275267124176,1492.3292846679688,50268,5862,44406,44406,0,9,6307000.0
6307,6307999,21.653910204458796,38.08229064898442,0.045755836534530414,1140.3937184810638,408.99034428596497,1492.6229057312012,50285,5864,44421,44421,0,9,6308000.0
6308,6308999,21.652682750691543,38.080247682156894,0.04576495649654033,1140.512446641922,409.05314326286316,1492.9234161376953,50286,5864,44422,44422,0,9,6309000.0
6309,6309999,21.65188011114743,38.07928992594644,0.0457703590580385,1140.8605997562408,409.1164493560791,1493.1664848327637,50308,5866,44442,44442,0,9,6310000.0
6310,6310999,21.651117417514996,38.077746706831014,0.045771850473507736,1141.0931994915009,409.17887234687805,1493.3833923339844,50317,5867,44450,44450,0,9,6311000.0
6311,6311999,21.65004081636431,38.07556961185889,0.04577950949178755,1141.212464094162,409.2408256530762,1493.6204223632812,50317,5867,44450,44450,0,9,6312000.0
6312,6312999,21.64898907266145,38.07356238331027,0.04578236247819778,1141.341023683548,409.3060042858124,1493.9764518737793,50320,5867,44453,44453,0,9,6313000.0
6313,6313999,21.64824114671997,38.072294870708156,0.04578244068941628,1141.4629273414612,409.36859107017517,1494.415096282959,50326,5867,44459,44459,0,9,6314000.0
6314,6314999,21.64717477610481,38.070320393974015,0.04578469919149264,1141.7002730369568,409.4305725097656,1494.5526695251465,50334,5868,44466,44466,0,9,6315000.0
6315,6315999,21.646510028163934,38.069312609541655,0.04578243860578268,1142.3842914104462,409.49422240257263,1494.6325187683105,50376,5873,44503,44503,0,9,6316000.0
6316,6316999,21.645770682183677,38.06803824073232,0.04577612023772981,1142.5092856884003,409.5581820011139,1494.982135772705,50378,5873,44505,44505,0,9,6317000.0
6317,6317999,21.645319699386448,38.06672318895065,0.04576876879863001,1142.856957435608,409.62043595314026,1495.1240730285645,50390,5875,44515,44515,0,9,6318000.0
6318,6318999,21.644776505776388,38.066716057155084,0.04576394721469457,1142.9745955467224,409.6809928417206,1495.3888778686523,50392,5875,44517,44517,0,9,6319000.0
6319,6319999,21.64424654515142,38.06533322361141,0.045760597742487086,1143.2191376686096,409.7455961704254,1495.5695533752441,50403,5876,44527,44527,0,9,6320000.0
6320,6320999,21.64380446702511,38.06372609328394,0.0457559407755862,1143.464429140091,409.8083519935608,1495.7979316711426,50413,5877,44536,44536,0,9,6321000.0
6321,6321999,21.64357847950781,38.06238522860019,0.04574805387816583,1143.7030532360077,409.87044501304626,1495.9701690673828,50423,5878,44545,44545,0,9,6322000.0
6322,6322999,21.643333019111203,38.06105968615358,0.04574091162081306,1143.9505808353424,409.935546875,1496.0713577270508,50433,5879,44554,44554,0,9,6323000.0
6323,6323999,21.643317177889607,38.05993930957395,0.04573358088932933,1144.0691134929657,409.99681663513184,1496.211223602295,50433,5879,44554,44554,0,9,6324000.0
6324,6324999,21.64293196525659,38.058413347028164,0.04572755203752532,1144.3045980930328,410.05882692337036,1496.3609237670898,50441,5880,44561,44561,0,9,6325000.0
6325,6325999,21.64247043507704,38.05671999496786,0.045721235587025344,1144.7674086093903,410.1215353012085,1496.4506492614746,50465,5883,44582,44582,0,9,6326000.0
6326,6326999,21.641996900240347,38.05563494636142,0.045714659921216816,1145.1151463985443,410.18339681625366,1496.5954475402832,50486,5885,44601,44601,0,9,6327000.0
6327,6327999,21.640956887080165,38.053846174441915,0.04571469653107896,1145.4657695293427,410.24748611450195,1497.5527572631836,50529,5887,44642,44642,0,9,6328000.0
6328,6328999,21.64007369135091,38.05277641272027,0.04571468962210112,1145.695034980774,410.31006956100464,1498.0492134094238,50539,5888,44651,44651,0,9,6329000.0
6329,6329999,21.638995998302164,38.051814588626776,0.04571930964405324,1145.8230140209198,410.37530732154846,1498.3625717163086,50539,5888,44651,44651,0,9,6330000.0
6330,6330999,21.63789008549002,38.04977629837173,0.04572633874558063,1146.0730876922607,410.4405663013458,1498.703483581543,50550,5889,44661,44661,0,9,6331000.0
6331,6331999,21.636728025579018,38.04766774192108,0.04573022889175726,1146.1876497268677,410.5024027824402,1498.9650688171387,50550,5889,44661,44661,0,9,6332000.0
6332,6332999,21.635833473011775,38.04597060102676,0.04573193756231542,1146.3085658550262,410.56423115730286,1499.1879844665527,50550,5889,44661,44661,0,9,6333000.0
6333,6333999,21.63473497953078,38.04397970544124,0.04573632559333196,1146.4319157600403,410.6288471221924,1499.474323272705,50552,5889,44663,44663,0,9,6334000.0
6334,6334999,21.63383409580206,38.04224979348433,0.04573729113581093,1146.56183385849,410.69403409957886,1499.7900009155273,50555,5889,44666,44666,0,9,6335000.0
6335,6335999,21.63280393136687,38.041209921930424,0.04573924308265109,1146.8122279644012,410.7589077949524,1499.9539184570312,50559,5890,44669,44669,0,9,6336000.0
6336,6336999,21.631990722844602,38.03945116791155,0.04574083887242508,1147.0549104213715,410.82401490211487,1500.2220420837402,50569,5891,44678,44678,0,9,6337000.0
6337,6337999,21.631036736964496,38.037479603996736,0.04574328191491628,1147.411094903946,410.8898947238922,1500.4074783325195,50583,5893,44690,44690,0,9,6338000.0
6338,6338999,21.630213655003235,38.035635304716344,0.045743667670210875,1147.7624082565308,410.95549058914185,1500.5430030822754,50596,5895,44701,44701,0,9,6339000.0
6339,6339999,21.629559548820566,38.034379064955566,0.045743665629547015,1148.1335039138794,411.0222098827362,1500.6825485229492,50608,5897,44711,44711,0,9,6340000.0
6340,6340999,21.628917643746703,38.03263678014969,0.045742442355025226,1148.3735365867615,411.0872857570648,1500.8846473693848,50618,5898,44720,44720,0,9,6341000.0
6341,6341999,21.62829005018308,38.03076102573242,0.045738632791532896,1148.7342281341553,411.15243911743164,1500.9904289245605,50632,5900,44732,44732,0,9,6342000.0
6342,6342999,21.628057729574728,38.0295522795814,0.04572919650260421,1148.8800282478333,411.2218928337097,1501.3341026306152,50634,5900,44734,44734,0,9,6343000.0
6343,6343999,21.6276538892701,38.02795674155986,0.04572163403427665,1149.3662068843842,411.2876486778259,1501.6023597717285,50657,5903,44754,44754,0,9,6344000.0
6344,6344999,21.627263267555534,38.026439601102304,0.04571489462612366,1149.4940874576569,411.352609872818,1501.8314208984375,50657,5903,44754,44754,0,9,6345000.0
6345,6345999,21.626806083870004,38.02482723773633,0.045710834687124,1149.850285768509,411.41861367225647,1502.09379196167,50668,5905,44763,44763,0,9,6346000.0
6346,6346999,21.62617178738091,38.022988941130315,0.04570926383944929,1150.0849030017853,411.48335218429565,1502.4020462036133,50674,5906,44768,44768,0,9,6347000.0
6347,6347999,21.625270101139034,38.02096822256271,0.04570996583882392,1150.2202458381653,411.5496680736542,1503.1322174072266,50695,5906,44789,44789,0,9,6348000.0
6348,6348999,21.62433222331654,38.02073871954821,0.04571593996419576,1150.3414416313171,411.61501121520996,1503.75191116333,50707,5906,44801,44801,0,9,6349000.0
6349,6349999,21.623239512368308,38.02014159284345,0.045722560601477724,1150.5864009857178,411.6807873249054,1504.0941581726074,50739,5907,44832,44832,0,9,6350000.0
6350,6350999,21.622253430756516,38.01863153903555,0.04572248075935603,1150.721210718155,411.7466847896576,1504.458366394043,50741,5907,44834,44834,0,9,6351000.0
6351,6351999,21.62136323408286,38.017022653094315,0.0457266847973169,1150.8516612052917,411.81146907806396,1504.692855834961,50742,5907,44835,44835,0,9,6352000.0
6352,6352999,21.620486192734596,38.01543751137437,0.04572774164218951,1150.9769442081451,411.8762586116791,1504.9540557861328,50743,5907,44836,44836,0,9,6353000.0
6353,6353999,21.619651138262018,38.01360070898324,0.045730096876586024,1151.2309029102325,411.9430727958679,1505.168701171875,50747,5908,44839,44839,0,9,6354000.0
6354,6354999,21.618771771831078,38.01185136534574,0.04574081453378809,1151.5841102600098,412.00872921943665,1505.397117614746,50772,5910,44862,44862,0,9,6355000.0
6355,6355999,21.61805792693993,38.01060796751753,0.045738723761631794,1151.8231337070465,412.0736906528473,1505.6028938293457,50779,5911,44868,44868,0,9,6356000.0
6356,6356999,21.61739994526518,38.0098608552751,0.045741632292847445,1152.1904745101929,412.1402087211609,1505.7924613952637,50795,5913,44882,44882,0,9,6357000.0
6357,6357999,21.616934832563516,38.00857380327307,0.04574170032729885,1152.4479200839996,412.2057795524597,1505.974765777588,50798,5914,44884,44884,0,9,6358000.0
6358,6358999,21.6166788315646,38.00807971965848,0.045746212287302246,1152.8180005550385,412.2711908817291,1506.164478302002,50811,5916,44895,44895,0,9,6359000.0
6359,6359999,21.61711198534068,38.00905119007876,0.04574203052140402,1152.962068080902,412.33716011047363,1506.4688529968262,50815,5916,44899,44899,0,9,6360000.0
6360,6360999,21.6173805985688,38.009467470627975,0.04573861412702296,1153.2082304954529,412.4024500846863,1506.6854095458984,50817,5917,44900,44900,0,9,6361000.0
6361,6361999,21.617835534952246,38.00998160101,0.04573718926619208,1153.448302745819,412.4674389362335,1506.911304473877,50828,5918,44910,44910,0,9,6362000.0
6362,6362999,21.618408022453828,38.01034120294128,0.045742598331273365,1153.6903328895569,412.5325815677643,1507.1098022460938,50840,5919,44921,44921,0,9,6363000.0
6363,6363999,21.619367264169753,38.01227867222054,0.04574711316756164,1153.813658952713,412.5966725349426,1507.291820526123,50840,5919,44921,44921,0,9,6364000.0
6364,6364999,21.620305035538003,38.01305969756837,0.04574254042152781,1154.0759110450745,412.66164994239807,1507.4582710266113,50851,5920,44931,44931,0,9,6365000.0
6365,6365999,21.6213065085227,38.013750504490076,0.045748183680091925,1154.3265767097473,412.7264473438263,1507.5738067626953,50853,5921,44932,44932,0,9,6366000.0
6366,6366999,21.62196977232434,38.013789360192504,0.04575419554667326,1154.8047306537628,412.7924613952637,1507.5856170654297,50880,5924,44956,44956,0,9,6367000.0
6367,6367999,21.622362927928403,38.01331127291385,0.04575391404281981,1155.1701970100403,412.85743832588196,1507.662353515625,50893,5926,44967,44967,0,9,6368000.0
6368,6368999,21.621770460607372,38.011875539393614,0.045746571119173574,1155.419421672821,412.9253799915314,1508.6996612548828,50936,5927,45009,45009,0,9,6369000.0
6369,6369999,21.62113332667972,38.013621579211026,0.04572671632458947,1155.5420939922333,412.9915270805359,1509.2892227172852,50942,5927,45015,45015,0,9,6370000.0
6370,6370999,21.620442067211783,38.01376307894168,0.045720986361658555,1155.7872922420502,413.0574595928192,1509.5942916870117,50950,5928,45022,45022,0,9,6371000.0
6371,6371999,21.619757441279834,38.01232661078996,0.045712370136574365,1155.9084701538086,413.12257504463196,1509.912197113037,50950,5928,45022,45022,0,9,6372000.0
6372,6372999,21.619205838919072,38.01084265070915,0.0457070303396907,1156.2811861038208,413.18857169151306,1510.0161056518555,50967,5930,45037,45037,0,9,6373000.0
6373,6373999,21.618494547377736,38.010636215614696,0.045702036821915204,1156.4085457324982,413.2541129589081,1510.2763442993164,50967,5930,45037,45037,0,9,6374000.0
6374,6374999,21.617870449483554,38.009101552552416,0.04569753493256701,1156.5389692783356,413.32018542289734,1510.5523300170898,50969,5930,45039,45039,0,9,6375000.0
6375,6375999,21.61727821109268,38.00773810746948,0.04570022640986737,1156.6618340015411,413.38520336151123,1510.8771438598633,50971,5930,45041,45041,0,9,6376000.0
6376,6376999,21.616726425282803,38.00628145580918,0.045698858266533526,1156.791338443756,413.4502332210541,1511.0780601501465,50971,5930,45041,45041,0,9,6377000.0
6377,6377999,21.616298944850364,38.00484077189404,0.04569846101965691,1157.0453493595123,413.5153431892395,1511.3013763427734,50976,5931,45045,45045,0,9,6378000.0
6378,6378999,21.616183827120484,38.00473728728602,0.045700860845048874,1157.3023691177368,413.5804374217987,1511.4629135131836,50988,5932,45056,45056,0,9,6379000.0
6379,6379999,21.616025741434935,38.00383665753521,0.045705520130601696,1157.5518233776093,413.646121263504,1511.6390914916992,50995,5933,45062,45062,0,9,6380000.0
6380,6380999,21.61614057035116,38.003234684297766,0.04571368963478428,1157.9135262966156,413.7114942073822,1511.7878150939941,51010,5935,45075,45075,0,9,6381000.0
6381,6381999,21.616271898947485,38.00266846502136,0.04572350958312499,1158.152915239334,413.7773277759552,1511.9743919372559,51012,5936,45076,45076,0,9,6382000.0
6382,6382999,21.616669915633295,38.00272485405735,0.04573184779567918,1158.3989708423615,413.84280920028687,1512.198642730713,51016,5937,45079,45079,0,9,6383000.0
6383,6383999,21.617376689395247,38.003109673848776,0.04575457987741749,1158.5224840641022,413.90802240371704,1512.4506874084473,51017,5937,45080,45080,0,9,6384000.0
6384,6384999,21.617795760858094,38.0029627443658,0.04576416494304869,1158.7826879024506,413.9734492301941,1512.5934677124023,51029,5938,45091,45091,0,9,6385000.0
6385,6385999,21.618770548357503,38.003601906025835,0.0457747286703063,1159.0278084278107,414.03844356536865,1512.7939453125,51039,5939,45100,45100,0,9,6386000.0
6386,6386999,21.619399734003196,38.0045465964432,0.04579023392308135,1159.2726883888245,414.10348081588745,1512.941249847412,51044,5940,45104,45104,0,9,6387000.0
6387,6387999,21.620241379381778,38.0047143472761,0.0457999240637289,1159.3980321884155,414.1680269241333,1513.153938293457,51045,5940,45105,45105,0,9,6388000.0
6388,6388999,21.6204885824678,38.00419529336597,0.045806548569499506,1159.764093875885,414.23445415496826,1513.3506202697754,51086,5942,45144,45144,0,9,6389000.0
6389,6389999,21.620014701725278,38.002924410867806,0.04579683906318799,1160.017052412033,414.3014874458313,1514.1231498718262,51115,5943,45172,45172,0,9,6390000.0
6390,6390999,21.61914844074648,38.00181881668208,0.0457911014987229,1160.1492047309875,414.3673939704895,1514.6172485351562,51119,5943,45176,45176,0,9,6391000.0
6391,6391999,21.618195520966832,37.9998684494918,0.04578558262895582,1160.2755460739136,414.43297123908997,1514.9787559509277,51122,5943,45179,45179,0,9,6392000.0
6392,6392999,21.61752923782668,37.99842603994286,0.045780947840763364,1160.7544095516205,414.49917364120483,1515.2103118896484,51150,5946,45204,45204,0,9,6393000.0
6393,6393999,21.617302347927268,37.99808050897116,0.045771951591742965,1160.9994280338287,414.56476736068726,1515.3390617370605,51160,5947,45213,45213,0,9,6394000.0
6394,6394999,21.61663716807457,37.99671873970792,0.04576859414675505,1161.1291546821594,414.6318702697754,1515.6514205932617,51161,5947,45214,45214,0,9,6395000.0
6395,6395999,21.616301555309946,37.99572578652691,0.045758742434075406,1161.2633094787598,414.69835090637207,1515.968563079834,51164,5947,45217,45217,0,9,6396000.0
6396,6396999,21.616093521833076,37.99489346656856,0.045750329141493906,1161.5039930343628,414.76427268981934,1516.2247314453125,51175,5948,45227,45227,0,9,6397000.0
6397,6397999,21.61570942494022,37.99368771957997,0.045746726848735375,1161.6304292678833,414.83044600486755,1516.4192810058594,51175,5948,45227,45227,0,9,6398000.0
6398,6398999,21.61579447086904,37.993990954671354,0.04574443008903972,1161.8811507225037,414.8959653377533,1516.578769683838,51185,5949,45236,45236,0,9,6399000.0
6399,6399999,21.615849828022668,37.99318785652387,0.045742338699160445,1162.13276720047,414.96148443222046,1516.7652702331543,51196,5950,45246,45246,0,9,6400000.0
6400,6400999,21.615875595622153,37.992399092794145,0.04574319093497359,1162.5178904533386,415.02716541290283,1516.8581771850586,51218,5952,45266,45266,0,9,6401000.0
6401,6401999,21.616237803048175,37.991888152814155,0.0457464100798568,1162.890614748001,415.09439516067505,1517.0002632141113,51245,5954,45291,45291,0,9,6402000.0
6402,6402999,21.61650416022798,37.99125975162262,0.04574385255107949,1163.0181920528412,415.1591110229492,1517.2163467407227,51245,5954,45291,45291,0,9,6403000.0
6403,6403999,21.616677226268568,37.99064742793184,0.04573847623799643,1163.2608528137207,415.22446393966675,1517.4338340759277,51247,5955,45292,45292,0,9,6404000.0
6404,6404999,21.616974581556132,37.990125578570115,0.04573660249040068,1163.5150065422058,415.28974890708923,1517.593105316162,51250,5956,45294,45294,0,9,6405000.0
6405,6405999,21.61725013127521,37.989317852504506,0.04573329860714914,1163.7563679218292,415.3550868034363,1517.7658424377441,51260,5957,45303,45303,0,9,6406000.0
6406,6406999,21.61780218840152,37.9890262178022,0.045721743866316555,1164.0046138763428,415.42053031921387,1518.0470962524414,51271,5958,45313,45313,0,9,6407000.0
6407,6407999,21.618123990557656,37.98839563191804,0.04571649957237767,1164.1388430595398,415.4867408275604,1518.3555793762207,51273,5958,45315,45315,0,9,6408000.0
6408,6408999,21.618473860157202,37.98764978034814,0.04570603805518314,1164.2706079483032,415.55199360847473,1518.6569900512695,51274,5958,45316,45316,0,9,6409000.0
6409,6409999,21.61871896789973,37.986757250589115,0.04569384217899497,1164.5124516487122,415.61701679229736,1518.8468627929688,51281,5959,45322,45322,0,9,6410000.0
6410,6410999,21.618143590126447,37.98509779245443,0.04568861684429826,1165.1121697425842,415.68299627304077,1519.2419662475586,51335,5963,45372,45372,0,9,6411000.0
6411,6411999,21.61767933297956,37.984805670241705,0.04568369079560408,1165.2434010505676,415.7498378753662,1519.8141288757324,51345,5963,45382,45382,0,9,6412000.0
6412,6412999,21.617010607286424,37.98410887842559,0.045677604857057075,1165.6056439876556,415.8159911632538,1519.999740600586,51366,5965,45401,45401,0,9,6413000.0
6413,6413999,21.616496139535514,37.98420084268005,0.04566895885847699,1165.7311635017395,415.8818929195404,1520.2451972961426,51366,5965,45401,45401,0,9,6414000.0
6414,6414999,21.615736080881845,37.98247652302172,0.04566498675551467,1165.8621666431427,415.9494261741638,1520.585048675537,51368,5965,45403,45403,0,9,6415000.0
6415,6415999,21.615215175605133,37.9817040026496,0.04566075352980137,1166.1148579120636,416.0151171684265,1520.735725402832,51378,5966,45412,45412,0,9,6416000.0
6416,6416999,21.61460339328577,37.980153867045296,0.0456550641190101,1166.484053850174,416.08111000061035,1520.9463119506836,51400,5968,45432,45432,0,9,6417000.0
6417,6417999,21.61413440927987,37.979595349419846,0.04564980780982242,1166.615844488144,416.14651918411255,1521.1208953857422,51400,5968,45432,45432,0,9,6418000.0
6418,6418999,21.613706151288458,37.97815756855474,0.04563758577639032,1171.9365923404694,416.212455034256,1521.348892211914,51414,5969,45445,45445,0,9,6419000.0
6419,6419999,21.61327784036258,37.97679974017871,0.04563154609176734,1172.1955862045288,416.27920389175415,1521.564926147461,51428,5970,45458,45458,0,9,6420000.0
6420,6420999,21.612916806596772,37.97546025123731,0.04562357142607687,1172.3282253742218,416.3457381725311,1521.7103576660156,51428,5970,45458,45458,0,9,6421000.0
6421,6421999,21.612615478093357,37.97425982514118,0.045612836177173266,1172.7160184383392,416.4120862483978,1521.8195533752441,51450,5972,45478,45478,0,9,6422000.0
6422,6422999,21.61237106229908,37.9730285665868,0.045602500428123194,1172.979555606842,416.4784662723541,1522.0177688598633,51454,5973,45481,45481,0,9,6423000.0
6423,6423999,21.612167046768146,37.971689007828914,0.045590727342620485,1173.4990785121918,416.54721999168396,1522.1368827819824,51470,5976,45494,45494,0,9,6424000.0
6424,6424999,21.611934322283304,37.97021386021004,0.04558148195715317,1173.6372220516205,416.61442470550537,1522.45658493042,51474,5976,45498,45498,0,9,6425000.0
6425,6425999,21.611830044057335,37.969753899014464,0.04556926875866674,1174.0172526836395,416.6814181804657,1522.6404418945312,51493,5978,45515,45515,0,9,6426000.0
6426,6426999,21.611573243296604,37.96928762828122,0.045560960092384195,1174.1496014595032,416.7476155757904,1522.982048034668,51494,5978,45516,45516,0,9,6427000.0
6427,6427999,21.611056693945525,37.967631339364665,0.04555358936195919,1174.5413670539856,416.8143503665924,1523.4987449645996,51524,5980,45544,45544,0,9,6428000.0
6428,6428999,21.61024187881362,37.96627920728287,0.04555352003801527,1174.8020243644714,416.88132905960083,1524.1316833496094,51549,5981,45568,45568,0,9,6429000.0
6429,6429999,21.609321102925296,37.96458166057013,0.0455592026538848,1174.934093952179,416.94965648651123,1524.5198669433594,51553,5981,45572,45572,0,9,6430000.0
6430,6430999,21.608701039014402,37.96347128200807,0.045557304930153864,1175.30979347229,417.01636719703674,1524.7620010375977,51580,5983,45597,45597,0,9,6431000.0
6431,6431999,21.608013613178322,37.961952268193734,0.045556566487398475,1175.5640218257904,417.0820863246918,1524.9567413330078,51590,5984,45606,45606,0,9,6432000.0
6432,6432999,21.60756518667773,37.96119766050646,0.045556278899739566,1175.6907198429108,417.1475555896759,1525.1929550170898,51590,5984,45606,45606,0,9,6433000.0
6433,6433999,21.607050901795745,37.96013449894553,0.0455574870200115,1175.9519641399384,417.2138352394104,1525.407211303711,51602,5985,45617,45617,0,9,6434000.0
6434,6434999,21.606707867948327,37.959414086590776,0.04555179157175171,1176.0762946605682,417.27950620651245,1525.644775390625,51602,5985,45617,45617,0,9,6435000.0
6435,6435999,21.606452525718655,37.958677509299044,0.045545023211447155,1176.2121300697327,417.3464493751526,1525.8691024780273,51603,5985,45618,45618,0,9,6436000.0
6436,6436999,21.606307996920393,37.957948352878134,0.04554562223838654,1176.5963068008423,417.41261529922485,1526.0320053100586,51619,5987,45632,45632,0,9,6437000.0
6437,6437999,21.606318128688738,37.957306106538496,0.04554506926571078,1176.8575026988983,417.47845792770386,1526.2067604064941,51630,5988,45642,45642,0,9,6438000.0
6438,6438999,21.606246459135907,37.95635922625889,0.04554294620725585,1177.242376089096,417.5442934036255,1526.21244430542,51634,5990,45644,45644,0,9,6439000.0
6439,6439999,21.606408940330375,37.95591514438702,0.04553679862275595,1177.6395921707153,417.6119818687439,1526.359577178955,51646,5992,45654,45654,0,9,6440000.0
6440,6440999,21.606835982710756,37.95641331199839,0.04553301014123079,1178.034904241562,417.67809772491455,1526.5560874938965,51667,5994,45673,45673,0,9,6441000.0
6441,6441999,21.60712264901103,37.95591178540628,0.04552357828771547,1178.2946507930756,417.74412083625793,1526.787940979004,51682,5995,45687,45687,0,9,6442000.0
6442,6442999,21.607710643230792,37.95588468918465,0.04552591121747518,1178.4407885074615,417.8107318878174,1527.0313301086426,51682,5995,45687,45687,0,9,6443000.0
6443,6443999,21.608534537095426,37.95637123946572,0.04551623437421548,1178.5721142292023,417.8763072490692,1527.3874740600586,51685,5995,45690,45690,0,9,6444000.0
6444,6444999,21.60883640734207,37.95597510890377,0.045512296211544734,1178.826818227768,417.94418811798096,1527.668846130371,51690,5996,45694,45694,0,9,6445000.0
6445,6445999,21.60930295402741,37.95678342552362,0.04550140174120498,1179.2103445529938,418.01040291786194,1527.7521286010742,51701,5998,45703,45703,0,9,6446000.0
6446,6446999,21.60949371099465,37.95625347825157,0.045495092083751465,1179.6165506839752,418.07916021347046,1527.9307022094727,51722,6000,45722,45722,0,9,6447000.0
6447,6447999,21.609214282372648,37.95502112596389,0.045485336314267655,1179.7560892105103,418.1457281112671,1528.8880920410156,51756,6000,45756,45756,0,9,6448000.0
6448,6448999,21.608794883257065,37.95479457585896,0.045484750442866706,1179.8927586078644,418.2124493122101,1529.537525177002,51767,6000,45767,45767,0,9,6449000.0
6449,6449999,21.608980863127602,37.95536172785836,0.04548800910027473,1180.142662525177,418.2813489437103,1529.88618850708,51777,6001,45776,45776,0,9,6450000.0
6450,6450999,21.60932875622308,37.95604938233135,0.04545570049399672,1180.5169224739075,418.34839725494385,1530.2466621398926,51794,6003,45791,45791,0,9,6451000.0
6451,6451999,21.60985710071875,37.95650768394031,0.04545600273087547,1180.6530900001526,418.41520738601685,1530.5037269592285,51796,6003,45793,45793,0,9,6452000.0
6452,6452999,21.610611865701966,37.95851711155889,0.045449663832429654,1181.05859375,418.4849398136139,1530.6556205749512,51808,6005,45803,45803,0,9,6453000.0
6453,6453999,21.6114431098333,37.95918533359485,0.04544104973532659,1181.1871066093445,418.5508508682251,1531.015022277832,51810,6005,45805,45805,0,9,6454000.0
6454,6454999,21.61270511060661,37.960864899185125,0.04543603604613322,1181.3170013427734,418.61862993240356,1531.4012565612793,51815,6005,45810,45810,0,9,6455000.0
6455,6455999,21.61401690214485,37.96244259576902,0.04544933298565301,1181.563925743103,418.6843068599701,1531.6145668029785,51826,6006,45820,45820,0,9,6456000.0
6456,6456999,21.615415628299083,37.963644937603725,0.04545853720080817,1181.6993277072906,418.7503995895386,1531.982105255127,51829,6006,45823,45823,0,9,6457000.0
6457,6457999,21.616898421216405,37.965669718809174,0.04548055076304447,1181.9491629600525,418.8178701400757,1532.2991065979004,51848,6007,45841,45841,0,9,6458000.0
6458,6458999,21.618415700959492,37.967355512077276,0.04549519813930625,1182.0882658958435,418.8849928379059,1532.6016387939453,51850,6007,45843,45843,0,9,6459000.0
6459,6459999,21.619883326734474,37.96856801077979,0.04551288155728617,1182.345691204071,418.9519135951996,1532.9165000915527,51856,6008,45848,45848,0,9,6460000.0
6460,6460999,21.621503286816726,37.97021481728027,0.045537282181204675,1182.6011629104614,419.01837706565857,1533.31840133667,51870,6009,45861,45861,0,9,6461000.0
6461,6461999,21.62314324531276,37.97160845941857,0.04556553298451915,1182.7340698242188,419.0864510536194,1533.6459655761719,51872,6009,45863,45863,0,9,6462000.0
6462,6462999,21.62462305632074,37.97257755345352,0.04558692459034297,1182.870501279831,419.1523311138153,1534.1637229919434,51878,6009,45869,45869,0,9,6463000.0
6463,6463999,21.626243408073066,37.97383538932455,0.04560648090845565,1183.2616243362427,419.2191731929779,1534.4611854553223,51895,6011,45884,45884,0,9,6464000.0
6464,6464999,21.627447308738045,37.97450382707857,0.045617835225052694,1183.5133934020996,419.2854812145233,1534.8358039855957,51910,6012,45898,45898,0,9,6465000.0
6465,6465999,21.628654077607276,37.97494289134656,0.04563652794382267,1183.7631330490112,419.35355854034424,1535.0938720703125,51920,6013,45907,45907,0,9,6466000.0
6466,6466999,21.62942007901488,37.97461646715333,0.045639661272319554,1184.138785123825,419.4196209907532,1535.4679641723633,51941,6015,45926,45926,0,9,6467000.0
6467,6467999,21.62932183214164,37.97365999654913,0.04563266417591472,1184.2810912132263,419.48577761650085,1536.229721069336,51965,6015,45950,45950,0,9,6468000.0
6468,6468999,21.628206567366053,37.97206512539135,0.04563530970490548,1184.5365362167358,419.5527756214142,1536.7088508605957,51983,6016,45967,45967,0,9,6469000.0
6469,6469999,21.627296978487685,37.970759137991735,0.045636230875822914,1184.7966754436493,419.6189138889313,1537.0396690368652,51993,6017,45976,45976,0,9,6470000.0
6470,6470999,21.62630647565192,37.96939118738807,0.045639893100647644,1184.9308462142944,419.6850655078888,1537.413501739502,51994,6017,45977,45977,0,9,6471000.0
6471,6471999,21.625494851613414,37.96820625909034,0.045639518506091825,1185.0727581977844,419.7585461139679,1537.6296424865723,51994,6017,45977,45977,0,9,6472000.0
6472,6472999,21.62448310338261,37.96669951882585,0.04564069150252881,1185.2055168151855,419.8242256641388,1537.8908462524414,51995,6017,45978,45978,0,9,6473000.0
6473,6473999,21.623759712530315,37.96594541115808,0.045641005137630586,1185.342414855957,419.89312195777893,1538.1392669677734,51995,6017,45978,45978,0,9,6474000.0
6474,6474999,21.623072879909593,37.964938630178914,0.04564315773149785,1185.603129863739,419.9593117237091,1538.372329711914,52001,6018,45983,45983,0,9,6475000.0
6475,6475999,21.622567555038582,37.96384274479755,0.04564274348467079,1185.9916062355042,420.0262324810028,1538.5088081359863,52013,6020,45993,45993,0,9,6476000.0
6476,6476999,21.622048714468786,37.962565010537475,0.045647702986645444,1186.5068044662476,420.0931222438812,1538.553524017334,52034,6023,46011,46011,0,9,6477000.0
6477,6477999,21.622142346382496,37.96244675416598,0.04565438594570026,1186.6333770751953,420.1609604358673,1538.8347778320312,52035,6023,46012,46012,0,9,6478000.0
6478,6478999,21.62240175437055,37.962428010802675,0.04566733119831945,1186.8848667144775,420.2268364429474,1539.0950622558594,52039,6024,46015,46015,0,9,6479000.0
6479,6479999,21.622807978491274,37.962927020370714,0.04567600421127427,1187.0180745124817,420.2929654121399,1539.385181427002,52041,6024,46017,46017,0,9,6480000.0
6480,6480999,21.623326905855443,37.96357532541693,0.04568409302429466,1187.1682796478271,420.3735992908478,1539.6093368530273,52041,6024,46017,46017,0,9,6481000.0
6481,6481999,21.62420175395768,37.96438062684234,0.04568819996281015,1187.6611070632935,420.45934796333313,1539.8828582763672,52059,6026,46033,46033,0,9,6482000.0
6482,6482999,21.625162486529767,37.965645654219145,0.04569627265365206,1188.1679530143738,420.52818274497986,1540.131649017334,52097,6029,46068,46068,0,9,6483000.0
6483,6483999,21.62610558049736,37.966710149797564,0.0457018814168203,1188.4296534061432,420.5940320491791,1540.2686386108398,52099,6030,46069,46069,0,9,6484000.0
6484,6484999,21.627344795198628,37.96869938721688,0.045712194964809716,1188.5632655620575,420.6611580848694,1540.6450881958008,52101,6030,46071,46071,0,9,6485000.0
6485,6485999,21.628240687880567,37.96975543486619,0.0457161996343578,1188.9451568126678,420.7294182777405,1540.7474212646484,52115,6032,46083,46083,0,9,6486000.0
6486,6486999,21.629109465315562,37.970331566872595,0.04571613091972171,1189.0946402549744,420.7951273918152,1540.984432220459,52116,6032,46084,46084,0,9,6487000.0
6487,6487999,21.62951504432201,37.97005644075106,0.04571743419915264,1189.5999217033386,420.8612313270569,1541.0721969604492,52138,6035,46103,46103,0,9,6488000.0
6488,6488999,21.628944916293495,37.9691940593235,0.045717209252112756,1189.85000705719,420.9271664619446,1541.747470855713,52157,6036,46121,46121,0,9,6489000.0
6489,6489999,21.62773145236089,37.96775608295035,0.04571762684166358,1189.985270023346,420.9946630001068,1542.1838989257812,52160,6036,46124,46124,0,9,6490000.0
6490,6490999,21.626817837282818,37.9667657763321,0.045718275766949756,1190.3750035762787,421.06159567832947,1542.3844947814941,52176,6038,46138,46138,0,9,6491000.0
6491,6491999,21.625926506007335,37.96542780444064,0.0457220227697448,1190.659994840622,421.13480973243713,1542.6274681091309,52181,6039,46142,46142,0,9,6492000.0
6492,6492999,21.625104375059966,37.96380462002268,0.04572382464168345,1190.906389951706,421.20075964927673,1542.8092575073242,52183,6040,46143,46143,0,9,6493000.0
6493,6493999,21.62404828906941,37.96218893538714,0.0457245804817199,1191.062385559082,421.28104424476624,1543.0261993408203,52183,6040,46143,46143,0,9,6494000.0
6494,6494999,21.623252712441303,37.9605214708405,0.04572273864513143,1191.441822528839,421.3504583835602,1543.1767692565918,52196,6042,46154,46154,0,9,6495000.0
6495,6495999,21.62248375737426,37.961425279528015,0.045713400007984406,1191.694936990738,421.4164056777954,1543.3250465393066,52207,6043,46164,46164,0,9,6496000.0
6496,6496999,21.621577590128638,37.95966571542473,0.04571418748011624,1192.0029237270355,421.5138292312622,1543.3702659606934,52224,6044,46180,46180,0,9,6497000.0
6497,6497999,21.620928005191736,37.958282756581234,0.045710915578364375,1192.251002073288,421.5815601348877,1543.5560760498047,52228,6045,46183,46183,0,9,6498000.0
6498,6498999,21.62054711400735,37.95767260876505,0.045709324563173115,1192.7393374443054,421.6474492549896,1543.5699577331543,52242,6048,46194,46194,0,9,6499000.0
6499,6499999,21.62039033047504,37.95689004261372,0.04571315450879321,1193.1232481002808,421.71510100364685,1543.7362823486328,52255,6050,46205,46205,0,9,6500000.0
6500,6500999,21.62025519847432,37.95612987540047,0.04571342352898955,1193.3811392784119,421.78293466567993,1543.8661727905273,52258,6051,46207,46207,0,9,6501000.0
6501,6501999,21.61999444471314,37.95506664872833,0.04572463681804784,1193.6334636211395,421.84828782081604,1543.9738540649414,52260,6052,46208,46208,0,9,6502000.0
6502,6502999,21.620511315058934,37.95514656862841,0.04573634917842473,1193.8952496051788,421.9143831729889,1544.2133407592773,52265,6053,46212,46212,0,9,6503000.0
6503,6503999,21.621140625853865,37.95612365045524,0.04573897925450432,1194.14861536026,421.97979950904846,1544.4290504455566,52273,6054,46219,46219,0,9,6504000.0
6504,6504999,21.622023307793505,37.95713545764815,0.045759340183832764,1194.27383685112,422.04491567611694,1544.6458168029785,52274,6054,46220,46220,0,9,6505000.0
6505,6505999,21.623239037810915,37.9585664490851,0.04576954091384888,1194.652016878128,422.1109211444855,1544.8049850463867,52292,6056,46236,46236,0,9,6506000.0
6506,6506999,21.624707726466553,37.96152050807488,0.045779374874041046,1194.790947675705,422.1766607761383,1545.05952835083,52294,6056,46238,46238,0,9,6507000.0
6507,6507999,21.62622426776373,37.965340349311795,0.04577988459260629,1195.045462846756,422.2435929775238,1545.221767425537,52297,6057,46240,46240,0,9,6508000.0
6508,6508999,21.626919764638323,37.96572986802189,0.04578694900877245,1195.3024225234985,422.3085262775421,1545.3533744812012,52307,6058,46249,46249,0,9,6509000.0
6509,6509999,21.62706919522365,37.96581689417364,0.04577544311408255,1195.4353880882263,422.37412571907043,1545.9004936218262,52320,6058,46262,46262,0,9,6510000.0
6510,6510999,21.626423606117122,37.96500448365289,0.04576490575643721,1195.6857075691223,422.4401469230652,1546.4145545959473,52337,6059,46278,46278,0,9,6511000.0
6511,6511999,21.625513343468477,37.9632574319363,0.04576256119633659,1195.9427559375763,422.50638127326965,1546.6511878967285,52342,6060,46282,46282,0,9,6512000.0
6512,6512999,21.624883969728586,37.96197673346575,0.04575645340392154,1196.084236383438,422.57418847084045,1546.9644393920898,52344,6060,46284,46284,0,9,6513000.0
6513,6513999,21.62429954661398,37.96054881698082,0.04575344062763487,1196.220134973526,422.64022970199585,1547.169792175293,52344,6060,46284,46284,0,9,6514000.0
6514,6514999,21.623403906900478,37.958623774165105,0.045750130384413445,1196.4756274223328,422.7062509059906,1547.4312629699707,52360,6061,46299,46299,0,9,6515000.0
6515,6515999,21.622889007101314,37.95711574599056,0.04574618517590079,1196.6073944568634,422.7720503807068,1547.736442565918,52363,6061,46302,46302,0,9,6516000.0
6516,6516999,21.622312396596698,37.955534413365996,0.045741371827484834,1196.7383441925049,422.8373601436615,1548.0966300964355,52367,6061,46306,46306,0,9,6517000.0
6517,6517999,21.621872715664573,37.95402052058129,0.04573595713487166,1196.9926662445068,422.902241230011,1548.244457244873,52377,6062,46315,46315,0,9,6518000.0
6518,6518999,21.62163613384022,37.95300034029879,0.04572966806043832,1197.3580384254456,422.9681189060211,1548.504077911377,52401,6064,46337,46337,0,9,6519000.0
6519,6519999,21.621385994729646,37.951632254934616,0.04572395150489539,1197.7378993034363,423.03447675704956,1548.6999282836914,52439,6066,46373,46373,0,9,6520000.0
6520,6520999,21.62121536694963,37.950328821928366,0.04571703800383897,1197.8778085708618,423.0994505882263,1548.85209274292,52439,6066,46373,46373,0,9,6521000.0
6521,6521999,21.620923519792115,37.948801300140104,0.045715297243221986,1198.2664413452148,423.1655361652374,1549.0414810180664,52459,6068,46391,46391,0,9,6522000.0
6522,6522999,21.620964075448452,37.94748521495371,0.04571098176919819,1198.5110156536102,423.23171830177307,1549.4620552062988,52470,6069,46401,46401,0,9,6523000.0
6523,6523999,21.621404921897383,37.94645032956434,0.04570013112273075,1198.894063949585,423.3025050163269,1549.7424621582031,52492,6071,46421,46421,0,9,6524000.0
6524,6524999,21.620947148152958,37.94478425051005,0.04570147564507976,1199.407880306244,423.3715386390686,1550.6512145996094,52543,6074,46469,46469,0,9,6525000.0
6525,6525999,21.620091601060224,37.943825509155,0.04570482950420651,1199.5470190048218,423.4380884170532,1551.3573684692383,52550,6074,46476,46476,0,9,6526000.0
6526,6526999,21.619217085258555,37.942673092837644,0.045707413181399814,1199.6760749816895,423.5045337677002,1551.9375038146973,52553,6074,46479,46479,0,9,6527000.0
6527,6527999,21.618176183698736,37.940660546239826,0.04571402022629267,1200.0430133342743,423.57106924057007,1552.2122840881348,52577,6076,46501,46501,0,9,6528000.0
6528,6528999,21.617275121325594,37.938676937936414,0.04572160377308898,1200.1799187660217,423.6374843120575,1552.7438735961914,52579,6076,46503,46503,0,9,6529000.0
6529,6529999,21.616233056443157,37.936652545551866,0.045729164542780976,1200.4263894557953,423.70399045944214,1553.0766525268555,52593,6077,46516,46516,0,9,6530000.0
6530,6530999,21.61531719752088,37.93479735181556,0.04573644504333707,1200.6785469055176,423.77048778533936,1553.2825775146484,52602,6078,46524,46524,0,9,6531000.0
6531,6531999,21.614459033384808,37.93290410163244,0.04574192913610409,1200.9323635101318,423.8366894721985,1553.478931427002,52613,6079,46534,46534,0,9,6532000.0
6532,6532999,21.613602489723416,37.930909924394605,0.045744240661439006,1201.3062057495117,423.9028787612915,1553.6717071533203,52633,6081,46552,46552,0,9,6533000.0
6533,6533999,21.612956773366363,37.92946027495601,0.045742923923199896,1201.437213897705,423.9688653945923,1553.8703918457031,52634,6081,46553,46553,0,9,6534000.0
6534,6534999,21.612202086268354,37.92755036184374,0.04574495738505069,1201.5653858184814,424.0350000858307,1554.19966506958,52636,6081,46555,46555,0,9,6535000.0
6535,6535999,21.611689597432065,37.92602902606643,0.045745766120152576,1202.055462360382,424.1012225151062,1554.4300575256348,52650,6084,46566,46566,0,9,6536000.0
6536,6536999,21.611198473861535,37.92462385014102,0.0457476886151601,1202.5539147853851,424.16678261756897,1554.5754928588867,52674,6087,46587,46587,0,9,6537000.0
6537,6537999,21.61068479770497,37.922794688018264,0.04574678932623921,1202.9323766231537,424.2334473133087,1554.9169464111328,52690,6089,46601,46601,0,9,6538000.0
6538,6538999,21.610321361583956,37.92123801548139,0.04574107775470382,1203.1854662895203,424.2998821735382,1555.2299880981445,52700,6090,46610,46610,0,9,6539000.0
6539,6539999,21.6099992766004,37.919588419630614,0.04573228819835051,1203.432246685028,424.3668568134308,1555.5038757324219,52714,6091,46623,46623,0,9,6540000.0
6540,6540999,21.609630042858473,37.91789939128869,0.045725361710740264,1203.808221578598,424.43324637413025,1555.7714385986328,52735,6093,46642,46642,0,9,6541000.0
6541,6541999,21.608935745204995,37.91777877094819,0.045714123312792454,1203.938805103302,424.4999942779541,1556.5926666259766,52757,6093,46664,46664,0,9,6542000.0
6542,6542999,21.608027994068355,37.9160190261264,0.0457123503172715,1204.1895589828491,424.5671317577362,1557.1558647155762,52769,6094,46675,46675,0,9,6543000.0
6543,6543999,21.607443966890372,37.91636753562332,0.045709908796745635,1204.4534060955048,424.6333272457123,1557.4009704589844,52779,6095,46684,46684,0,9,6544000.0
6544,6544999,21.606741995076035,37.91480087999951,0.045711973083644386,1204.579516172409,424.69864106178284,1557.613151550293,52779,6095,46684,46684,0,9,6545000.0
6545,6545999,21.60608826826136,37.91360118950303,0.045709931442312834,1204.833663225174,424.76378440856934,1557.7914085388184,52789,6096,46693,46693,0,9,6546000.0
6546,6546999,21.60548246200992,37.912237210052304,0.04570756972629186,1205.084236383438,424.82982087135315,1558.0078315734863,52802,6097,46705,46705,0,9,6547000.0
6547,6547999,21.60477889958363,37.910870740386805,0.045707386864619615,1205.7067382335663,424.89673042297363,1558.0696640014648,52829,6101,46728,46728,0,9,6548000.0
6548,6548999,21.604067882821386,37.90928475190405,0.04570804964106079,1205.8347809314728,424.96398854255676,1558.2685356140137,52830,6101,46729,46729,0,9,6549000.0
6549,6549999,21.60334440956687,37.907869186409286,0.04570790501013988,1206.2214469909668,425.03008341789246,1558.3481369018555,52843,6103,46740,46740,0,9,6550000.0
6550,6550999,21.602914638812322,37.90664843934914,0.0457012309914413,1206.352551460266,425.0962359905243,1558.597068786621,52844,6103,46741,46741,0,9,6551000.0
6551,6551999,21.602546185063197,37.90614704555212,0.045699346988141265,1206.6019327640533,425.16161370277405,1558.666259765625,52846,6104,46742,46742,0,9,6552000.0
6552,6552999,21.60217513451218,37.9048146293737,0.045696010239703044,1206.9933893680573,425.22954750061035,1558.7606239318848,52858,6106,46752,46752,0,9,6553000.0
6553,6553999,21.601965470811855,37.90418732950402,0.04568645977828023,1207.2502455711365,425.29552483558655,1558.9639701843262,52869,6107,46762,46762,0,9,6554000.0
6554,6554999,21.60173714066047,37.90308793565205,0.045676529472520655,1207.5083746910095,425.36077308654785,1559.1657066345215,52882,6108,46774,46774,0,9,6555000.0
6555,6555999,21.601516654802097,37.901867995823935,0.04566676699487493,1207.6464204788208,425.4264085292816,1559.3875160217285,52883,6108,46775,46775,0,9,6556000.0
6556,6556999,21.60141907015358,37.90072111971869,0.045659270826635345,1207.775533914566,425.4922354221344,1559.6408195495605,52884,6108,46776,46776,0,9,6557000.0
6557,6557999,21.601034695787074,37.89942399207908,0.04564777811264975,1208.03994679451,425.5585000514984,1559.8254508972168,52897,6109,46788,46788,0,9,6558000.0
6558,6558999,21.600788260635333,37.89802199315357,0.04564063793979811,1208.3036816120148,425.623902797699,1560.0636405944824,52900,6110,46790,46790,0,9,6559000.0
6559,6559999,21.600088738403677,37.89699515442398,0.04562661507485899,1208.4376916885376,425.6915228366852,1560.8100852966309,52925,6110,46815,46815,0,9,6560000.0
6560,6560999,21.59997691664878,37.90175026350999,0.04559777329054382,1208.5672767162323,425.758917093277,1561.6514739990234,52942,6110,46832,46832,0,9,6561000.0
6561,6561999,21.599040633253992,37.900240827635045,0.04559395640101338,1208.942514181137,425.82534766197205,1562.0723876953125,52954,6112,46842,46842,0,9,6562000.0
6562,6562999,21.59831119532173,37.899610685923314,0.045589736370302725,1209.1862254142761,425.8909430503845,1562.4385833740234,52958,6113,46845,46845,0,9,6563000.0
6563,6563999,21.59750099493764,37.89807813651865,0.04558840158308963,1209.3121302127838,425.9570565223694,1562.7136001586914,52959,6113,46846,46846,0,9,6564000.0
6564,6564999,21.596646961663534,37.89684796758278,0.045587235608467114,1209.5666205883026,426.0227048397064,1562.8796997070312,52971,6114,46857,46857,0,9,6565000.0
6565,6565999,21.59589656911344,37.89595253545631,0.045567499712033,1209.6877858638763,426.0894236564636,1563.2966651916504,52974,6114,46860,46860,0,9,6566000.0
6566,6566999,21.595172271736576,37.89442370679661,0.045564227961448656,1209.8132803440094,426.1551682949066,1563.6180801391602,52976,6114,46862,46862,0,9,6567000.0
6567,6567999,21.59476603095518,37.893805734163365,0.04555780920236796,1210.0636622905731,426.22075486183167,1563.779296875,52985,6115,46870,46870,0,9,6568000.0
6568,6568999,21.594321143118172,37.892792388228884,0.04555366069348199,1210.4358594417572,426.287570476532,1564.092430114746,52998,6117,46881,46881,0,9,6569000.0
6569,6569999,21.593715267919574,37.89146582420559,0.045549070359787724,1210.5650391578674,426.35279631614685,1564.4232177734375,53000,6117,46883,46883,0,9,6570000.0
6570,6570999,21.593517432038727,37.890795103840055,0.04554108284384206,1210.8116092681885,426.4180111885071,1564.6463432312012,53007,6118,46889,46889,0,9,6571000.0
6571,6571999,21.593599093672253,37.890437901971474,0.04553708542571244,1210.9472358226776,426.48336720466614,1564.9795150756836,53010,6118,46892,46892,0,9,6572000.0
6572,6572999,21.593705659996527,37.8899961174918,0.04552925375705963,1211.0766105651855,426.54874062538147,1565.2001762390137,53010,6118,46892,46892,0,9,6573000.0
6573,6573999,21.594311361115153,37.890353288184365,0.04552358236526166,1211.3302879333496,426.6151969432831,1565.530532836914,53017,6119,46898,46898,0,9,6574000.0
6574,6574999,21.594957886422428,37.890809662673206,0.04552434968735253,1211.4554343223572,426.68162393569946,1565.8443336486816,53019,6119,46900,46900,0,9,6575000.0
6575,6575999,21.59665644067185,37.893732804407755,0.045532883114750344,1211.5870685577393,426.747038602829,1566.208839416504,53025,6119,46906,46906,0,9,6576000.0
6576,6576999,21.597818514670998,37.89474266649553,0.04553817862578291,1211.8289551734924,426.8136820793152,1566.4719543457031,53027,6120,46907,46907,0,9,6577000.0
6577,6577999,21.599449545294906,37.89840136509947,0.04554545440665292,1211.9594371318817,426.87898349761963,1566.7149772644043,53028,6120,46908,46908,0,9,6578000.0
6578,6578999,21.601115274196115,37.9004442162194,0.045557197832767904,1212.4505965709686,426.9458603858948,1566.815029144287,53053,6123,46930,46930,0,9,6579000.0
6579,6579999,21.601956623168817,37.9008863275127,0.045572459716079705,1212.5753557682037,427.013391494751,1567.157600402832,53054,6123,46931,46931,0,9,6580000.0
6580,6580999,21.601996729279634,37.900889584270274,0.045577552394382326,1213.09086227417,427.08214497566223,1567.8554039001465,53115,6126,46989,46989,0,9,6581000.0
6581,6581999,21.601132401460067,37.899821866136875,0.04557163675703324,1213.218879699707,427.148535490036,1568.3641166687012,53121,6126,46995,46995,0,9,6582000.0
6582,6582999,21.600495071904508,37.89935002647206,0.04557134154451792,1213.4638106822968,427.2149453163147,1568.6626586914062,53153,6127,47026,47026,0,9,6583000.0
6583,6583999,21.600313306252673,37.90125079803416,0.04556482230145242,1213.7195773124695,427.2812964916229,1568.9718322753906,53162,6128,47034,47034,0,9,6584000.0
6584,6584999,21.599993835877992,37.90032419666749,0.04555907795665237,1214.090158700943,427.3466651439667,1569.105297088623,53182,6130,47052,47052,0,9,6585000.0
6585,6585999,21.599942693054683,37.90015381018836,0.04555457943166785,1214.4884192943573,427.4150233268738,1569.3264122009277,53203,6132,47071,47071,0,9,6586000.0
6586,6586999,21.599741111738897,37.89922887365289,0.045557932272141555,1214.6237075328827,427.4810121059418,1569.635139465332,53203,6132,47071,47071,0,9,6587000.0
6587,6587999,21.59972622333252,37.89927850375946,0.04555405136997914,1214.7499821186066,427.54747104644775,1569.9727249145508,53207,6132,47075,47075,0,9,6588000.0
6588,6588999,21.59989721637037,37.89960129758861,0.045556163531978,1214.875581741333,427.61278080940247,1570.271255493164,53208,6132,47076,47076,0,9,6589000.0
6589,6589999,21.600267976629734,37.89990162566178,0.04555724124556859,1215.3767294883728,427.6797225475311,1570.4183311462402,53224,6135,47089,47089,0,9,6590000.0
6590,6590999,21.600808889545092,37.90058488800453,0.04557217743720643,1215.6338443756104,427.74507665634155,1570.617530822754,53231,6136,47095,47095,0,9,6591000.0
6591,6591999,21.601808614871885,37.90196477089646,0.045587124999685535,1215.8848493099213,427.8116602897644,1570.971046447754,53236,6137,47099,47099,0,9,6592000.0
6592,6592999,21.60295615408985,37.90358796476461,0.04561707851086394,1216.1281073093414,427.8770923614502,1571.2343559265137,53247,6138,47109,47109,0,9,6593000.0
6593,6593999,21.604577850470047,37.908129517759164,0.045665882793736956,1216.3762865066528,427.94369196891785,1571.39506149292,53249,6139,47110,47110,0,9,6594000.0
6594,6594999,21.60579934202168,37.909471412463965,0.045685099600230594,1216.5038650035858,428.00993251800537,1571.7051887512207,53250,6139,47111,47111,0,9,6595000.0
6595,6595999,21.607913168412427,37.91500597857387,0.045731224804248294,1216.9986426830292,428.07563948631287,1571.7856521606445,53291,6142,47149,47149,0,9,6596000.0
6596,6596999,21.61013250897023,37.92148410212302,0.04578022872131571,1217.503666639328,428.1422667503357,1571.860553741455,53312,6145,47167,47167,0,9,6597000.0
6597,6597999,21.612359003172152,37.92502028151385,0.04584240967475606,1217.6358816623688,428.2085886001587,1572.1700744628906,53313,6145,47168,47168,0,9,6598000.0
6598,6598999,21.61443963702956,37.92924487055795,0.04588810134463639,1217.8806557655334,428.2738857269287,1572.4758338928223,53318,6146,47172,47172,0,9,6599000.0
6599,6599999,21.616797321875648,37.93303426361528,0.04594073556152134,1218.1377549171448,428.33984088897705,1572.8289642333984,53332,6147,47185,47185,0,9,6600000.0
6600,6600999,21.618445395952456,37.93517434996917,0.04597476341853468,1218.3865869045258,428.40589475631714,1573.1334266662598,53343,6148,47195,47195,0,9,6601000.0
6601,6601999,21.618099434654173,37.93405837205006,0.04597753634868329,1218.762136220932,428.47265362739563,1573.8269577026367,53375,6150,47225,47225,0,9,6602000.0
6602,6602999,21.61699487365169,37.93258083849878,0.04597714740945158,1219.0086166858673,428.5385465621948,1574.2498474121094,53391,6151,47240,47240,0,9,6603000.0
6603,6603999,21.616209418060105,37.93148166721551,0.045970965702048505,1219.2615475654602,428.60522079467773,1574.5435104370117,53399,6152,47247,47247,0,9,6604000.0
6604,6604999,21.615381760392207,37.93014000627235,0.04596802048576243,1219.7614340782166,428.6714735031128,1574.8573837280273,53417,6155,47262,47262,0,9,6605000.0
6605,6605999,21.614739900975593,37.92902629691413,0.04596454376228287,1220.008949995041,428.7372500896454,1575.0476722717285,53421,6156,47265,47265,0,9,6606000.0
6606,6606999,21.6138604783413,37.9274219786043,0.045964043472958904,1220.2750520706177,428.8042311668396,1575.3081588745117,53447,6157,47290,47290,0,9,6607000.0
6607,6607999,21.61292050453155,37.925614271043486,0.04596511715098939,1220.4011738300323,428.8718364238739,1575.6437873840332,53449,6157,47292,47292,0,9,6608000.0
6608,6608999,21.612038678223378,37.92388774324275,0.04596456255762682,1220.6601374149323,428.9385817050934,1575.9156799316406,53458,6158,47300,47300,0,9,6609000.0
6609,6609999,21.6111996569243,37.92203632701147,0.04596444020845891,1220.7892110347748,429.0042142868042,1576.1054153442383,53458,6158,47300,47300,0,9,6610000.0
6610,6610999,21.610588284173932,37.920769694325365,0.04595993051366898,1221.0466182231903,429.07007932662964,1576.3084907531738,53460,6159,47301,47301,0,9,6611000.0
6611,6611999,21.609982977879536,37.91930154678607,0.04595642345975892,1221.3060541152954,429.1363515853882,1576.4994163513184,53468,6160,47308,47308,0,9,6612000.0
6612,6612999,21.609553500839443,37.918533842650795,0.045961445063203765,1221.4481041431427,429.20227575302124,1576.706771850586,53468,6160,47308,47308,0,9,6613000.0
6613,6613999,21.60902331086922,37.917095537225045,0.045956931025207814,1221.5740258693695,429.2672657966614,1576.9020309448242,53468,6160,47308,47308,0,9,6614000.0
6614,6614999,21.608776492323937,37.9160430467608,0.04595208142459495,1221.8260686397552,429.33211374282837,1576.996982574463,53470,6161,47309,47309,0,9,6615000.0
6615,6615999,21.608406906030947,37.91459201828878,0.045948676283931844,1221.9646377563477,429.3970968723297,1577.2438583374023,53471,6161,47310,47310,0,9,6616000.0
6616,6616999,21.60853262462502,37.91389669292422,0.045946680613121904,1222.2306761741638,429.4626307487488,1577.3983268737793,53485,6162,47323,47323,0,9,6617000.0
6617,6617999,21.608703672522374,37.913318967704804,0.04593348040425227,1222.6089010238647,429.528272151947,1577.6184120178223,53497,6164,47333,47333,0,9,6618000.0
6618,6618999,21.608763694020446,37.91224160383804,0.04592156585602514,1222.8618738651276,429.59418630599976,1577.777286529541,53508,6165,47343,47343,0,9,6619000.0
6619,6619999,21.608822363121963,37.9112503585384,0.045909978835670384,1223.2343320846558,429.66030979156494,1578.032112121582,53548,6167,47381,47381,0,9,6620000.0
6620,6620999,21.608649691913563,37.90994284886437,0.04589993990014796,1223.4952483177185,429.7265374660492,1578.2663803100586,53559,6168,47391,47391,0,9,6621000.0
6621,6621999,21.608253451128363,37.90846671195873,0.04589425731693786,1223.87331366539,429.7916886806488,1578.5064849853516,53581,6170,47411,47411,0,9,6622000.0
6622,6622999,21.60743318728588,37.90764123787588,0.04589602312075225,1224.133311510086,429.8576147556305,1579.1466217041016,53607,6171,47436,47436,0,9,6623000.0
6623,6623999,21.606438343274156,37.90616340963582,0.04589667905296724,1224.270100593567,429.9236934185028,1579.6502723693848,53610,6171,47439,47439,0,9,6624000.0
6624,6624999,21.605245387079826,37.90406881384861,0.04590119153742467,1224.396232366562,429.99090480804443,1579.8826026916504,53611,6171,47440,47440,0,9,6625000.0
6625,6625999,21.604428661669875,37.90225884576277,0.04590169376575737,1224.535876750946,430.056875705719,1580.1534156799316,53613,6171,47442,47442,0,9,6626000.0
6626,6626999,21.60358695018404,37.90074438379619,0.04590043442108371,1224.7840058803558,430.1222357749939,1580.3516998291016,53617,6172,47445,47445,0,9,6627000.0
6627,6627999,21.602818436368267,37.89922545239792,0.04590102419683861,1225.0403726100922,430.18854784965515,1580.5128898620605,53631,6173,47458,47458,0,9,6628000.0
6628,6628999,21.60187931066301,37.89743795339953,0.04590250755266545,1225.1724376678467,430.2543303966522,1580.7000198364258,53631,6173,47458,47458,0,9,6629000.0
6629,6629999,21.60100475578947,37.89575627440803,0.04590389043970711,1225.30216050148,430.31961584091187,1580.9226684570312,53633,6173,47460,47460,0,9,6630000.0
6630,6630999,21.600220521040786,37.89409547891749,0.045902985472792035,1225.5523128509521,430.3852984905243,1581.1345405578613,53642,6174,47468,47468,0,9,6631000.0
6631,6631999,21.59945994627128,37.89223174106695,0.04590059683824266,1225.6829929351807,430.4515149593353,1581.3451843261719,53642,6174,47468,47468,0,9,6632000.0
6632,6632999,21.598637508043733,37.89048492391471,0.04589750168521989,1225.9370412826538,430.5165328979492,1581.565029144287,53675,6175,47500,47500,0,9,6633000.0
6633,6633999,21.59785889393103,37.88881054310975,0.04589552475304859,1226.443522453308,430.5820138454437,1581.5106391906738,53711,6178,47533,47533,0,9,6634000.0
6634,6634999,21.597247983752133,37.88771412883614,0.0458929238703325,1226.7118473052979,430.64842414855957,1581.6120910644531,53722,6179,47543,47543,0,9,6635000.0
6635,6635999,21.596873105969692,37.88633943642397,0.04588781546855014,1226.9618401527405,430.71460127830505,1581.8436126708984,53735,6180,47555,47555,0,9,6636000.0
6636,6636999,21.596408623142935,37.88521980041698,0.04588018809508165,1227.0857772827148,430.7797074317932,1582.0131301879883,53735,6180,47555,47555,0,9,6637000.0
6637,6637999,21.595972855210874,37.88378836107383,0.04587147313290052,1227.5946803092957,430.8458824157715,1582.0348205566406,53755,6183,47572,47572,0,9,6638000.0
6638,6638999,21.595535498396018,37.882295902054096,0.045866279753946415,1227.8553006649017,430.91159176826477,1582.269386291504,53761,6184,47577,47577,0,9,6639000.0
6639,6639999,21.59513892364702,37.880904326886196,0.04585916455691297,1228.228558063507,430.97690176963806,1582.411075592041,53766,6186,47580,47580,0,9,6640000.0
6640,6640999,21.59479316406322,37.88147848823889,0.045854220559028214,1228.3550708293915,431.04277634620667,1582.611484527588,53767,6186,47581,47581,0,9,6641000.0
6641,6641999,21.594265373903315,37.87978689820245,0.045852493029660324,1228.7234976291656,431.1079726219177,1582.71577835083,53802,6188,47614,47614,0,9,6642000.0
6642,6642999,21.59376157409339,37.87809121927553,0.04585355774524724,1229.4753828048706,431.17506980895996,1583.107624053955,53860,6193,47667,47667,0,9,6643000.0
6643,6643999,21.59287352390092,37.876928343024645,0.04585095099991321,1229.7300186157227,431.242267370224,1583.7756576538086,53894,6194,47700,47700,0,9,6644000.0
6644,6644999,21.59183350302414,37.87519479041355,0.04585032873486028,1229.9847738742828,431.30921959877014,1584.1343803405762,53901,6195,47706,47706,0,9,6645000.0
6645,6645999,21.590906052358186,37.87354374822811,0.04585072345983621,1230.1121728420258,431.37473702430725,1584.4438285827637,53901,6195,47706,47706,0,9,6646000.0
6646,6646999,21.590300232686364,37.872039062123434,0.045850803341479285,1230.4835178852081,431.4417314529419,1584.5633659362793,53917,6197,47720,47720,0,9,6647000.0
6647,6647999,21.58942263306389,37.870203253275825,0.04585155076527658,1230.8642885684967,431.5087139606476,1584.7545471191406,53928,6199,47729,47729,0,9,6648000.0
6648,6648999,21.588656365896004,37.86836543940554,0.045853459949832476,1230.992931842804,431.57479071617126,1585.0554313659668,53929,6199,47730,47730,0,9,6649000.0
6649,6649999,21.58798629931218,37.866760842552225,0.04585285266835459,1231.2446057796478,431.64043831825256,1585.3104820251465,53933,6200,47733,47733,0,9,6650000.0
6650,6650999,21.587371412505536,37.86525831116244,0.045852644093009154,1231.377293586731,431.70665645599365,1585.5261154174805,53933,6200,47733,47733,0,9,6651000.0
6651,6651999,21.586853448572818,37.86400743300904,0.04585133639311767,1231.50577044487,431.7721209526062,1585.8463668823242,53935,6200,47735,47735,0,9,6652000.0
6652,6652999,21.586560255292746,37.86285962894971,0.04585001361180985,1231.7635486125946,431.83845496177673,1586.0088729858398,53945,6201,47744,47744,0,9,6653000.0
6653,6653999,21.586236730423217,37.861860725543686,0.045844071078058435,1232.1399993896484,431.9042465686798,1586.1850700378418,53971,6203,47768,47768,0,9,6654000.0
6654,6654999,21.58590724328768,37.86076824631735,0.04584297123452652,1232.5156435966492,431.9708878993988,1586.3641204833984,53984,6205,47779,47779,0,9,6655000.0
6655,6655999,21.58565609737166,37.86037837840336,0.04583778729002752,1233.0144991874695,432.0374732017517,1586.3865089416504,54004,6208,47796,47796,0,9,6656000.0
6656,6656999,21.585479618117716,37.859299998854574,0.045827138931655464,1233.2774233818054,432.10484194755554,1586.7989807128906,54008,6209,47799,47799,0,9,6657000.0
6657,6657999,21.585663230943574,37.85919796612458,0.0458239627618634,1233.4040868282318,432.1710729598999,1587.2212257385254,54012,6209,47803,47803,0,9,6658000.0
6658,6658999,21.585640446554105,37.858418855940144,0.04581625751246177,1233.6645722389221,432.2383396625519,1587.4168510437012,54014,6210,47804,47804,0,9,6659000.0
6659,6659999,21.585667559492382,37.85763704240717,0.04579643513391418,1234.173011302948,432.306086063385,1587.6760940551758,54046,6213,47833,47833,0,9,6660000.0
6660,6660999,21.58556454559655,37.85653815985755,0.045790319813892255,1234.3098442554474,432.3731441497803,1587.9641342163086,54049,6213,47836,47836,0,9,6661000.0
6661,6661999,21.585542658777086,37.855399930734606,0.04578082901241243,1234.6972839832306,432.43936681747437,1588.038101196289,54053,6215,47838,47838,0,9,6662000.0
6662,6662999,21.585206420503884,37.85386110662658,0.0457774454237615,1235.0685322284698,432.50480699539185,1588.3162803649902,54075,6217,47858,47858,0,9,6663000.0
6663,6663999,21.585169139764435,37.85399404391863,0.045772915367419564,1235.1970047950745,432.5724537372589,1589.1933212280273,54098,6217,47881,47881,0,9,6664000.0
6664,6664999,21.584737591749388,37.85372742370568,0.04576824718143124,1235.448228597641,432.63956236839294,1589.7510032653809,54106,6218,47888,47888,0,9,6665000.0
6665,6665999,21.584077213837173,37.85259132957857,0.04576463542965814,1235.7024743556976,432.70691537857056,1590.0455055236816,54110,6219,47891,47891,0,9,6666000.0
6666,6666999,21.583535798356333,37.85146611089174,0.045761655360768594,1236.0846757888794,432.7728970050812,1590.3225555419922,54129,6221,47908,47908,0,9,6667000.0
6667,6667999,21.58322282251428,37.85101158192808,0.04575955754825589,1236.2210292816162,432.8389205932617,1590.542236328125,54130,6221,47909,47909,0,9,6668000.0
6668,6668999,21.582843092816866,37.85025356053988,0.04575633047247296,1236.6080951690674,432.90569734573364,1590.7244606018066,54142,6223,47919,47919,0,9,6669000.0
6669,6669999,21.58284913987822,37.85003931369183,0.04574744732633762,1236.8682718276978,432.97341227531433,1591.0232543945312,54145,6224,47921,47921,0,9,6670000.0
6670,6670999,21.582690056806968,37.84977673096463,0.045741203420061605,1236.9981741905212,433.03956055641174,1591.2927627563477,54146,6224,47922,47922,0,9,6671000.0
6671,6671999,21.58241355599039,37.84892148317109,0.04573580409508471,1237.12002658844,433.1044547557831,1591.4802932739258,54146,6224,47922,47922,0,9,6672000.0
6672,6672999,21.582430320049586,37.848581599923776,0.04572110161364806,1237.3739051818848,433.16974687576294,1591.6910438537598,54177,6225,47952,47952,0,9,6673000.0
6673,6673999,21.58243511357274,37.848863703356386,0.04571125437257695,1237.6392271518707,433.2361717224121,1591.8557624816895,54181,6226,47955,47955,0,9,6674000.0
6674,6674999,21.5825379540517,37.84875537264342,0.045703353800708335,1238.1499614715576,433.3020672798157,1591.9422874450684,54195,6229,47966,47966,0,9,6675000.0
6675,6675999,21.582663619018707,37.84847283127323,0.04570060401615139,1238.5347485542297,433.36936616897583,1592.086326599121,54208,6231,47977,47977,0,9,6676000.0
6676,6676999,21.583302579712253,37.84954424350218,0.04569827593620701,1238.675992488861,433.43486428260803,1592.2818641662598,54208,6231,47977,47977,0,9,6677000.0
6677,6677999,21.584255494970225,37.851032432662,0.04570517252711015,1238.9523386955261,433.51512575149536,1592.5323524475098,54219,6232,47987,47987,0,9,6678000.0
6678,6678999,21.58501481211154,37.851768557972,0.04570230139226905,1239.5872955322266,433.58283495903015,1592.6387367248535,54247,6236,48011,48011,0,9,6679000.0
6679,6679999,21.586102575970042,37.85383291219596,0.0457119522405709,1239.713438987732,433.6486701965332,1592.9308013916016,54249,6236,48013,48013,0,9,6680000.0
6680,6680999,21.587350266542842,37.85612227009136,0.045701453926769164,1240.086682319641,433.71510100364685,1593.0717124938965,54268,6238,48030,48030,0,9,6681000.0
6681,6681999,21.58869184897301,37.858532475287944,0.045696936118661546,1240.3485653400421,433.78084802627563,1593.424388885498,54285,6239,48046,48046,0,9,6682000.0
6682,6682999,21.59049705817993,37.86214591161895,0.04569985356143913,1240.7235844135284,433.8467116355896,1593.65531539917,54293,6241,48052,48052,0,9,6683000.0
6683,6683999,21.59165858200085,37.86492055078901,0.04570832895284538,1241.1006038188934,433.9140305519104,1593.882884979248,54306,6243,48063,48063,0,9,6684000.0
6684,6684999,21.592141654992854,37.86741291311606,0.04569062904499255,1241.3608915805817,433.9820373058319,1595.0013160705566,54353,6244,48109,48109,0,9,6685000.0
6685,6685999,21.592417405663667,37.87739516134567,0.0456555215279294,1241.7366683483124,434.04820489883423,1595.5223350524902,54385,6246,48139,48139,0,9,6686000.0
6686,6686999,21.592281721192997,37.877835821881106,0.045651945817651085,1241.9893310070038,434.11532068252563,1595.9687995910645,54400,6247,48153,48153,0,9,6687000.0
6687,6687999,21.59221020087359,37.8804886006944,0.0456409392653121,1242.240021944046,434.1813952922821,1596.462200164795,54428,6248,48180,48180,0,9,6688000.0
6688,6688999,21.59182990505334,37.879798516551965,0.04563250007125663,1242.3790140151978,434.2478258609772,1596.9416999816895,54439,6248,48191,48191,0,9,6689000.0
6689,6689999,21.59177128116107,37.882189535183805,0.045625452733059846,1242.634654045105,434.31567454338074,1597.4174537658691,54455,6249,48206,48206,0,9,6690000.0
6690,6690999,21.59199037563024,37.88259774321571,0.04561933532544771,1242.8845999240875,434.3806929588318,1597.7171440124512,54470,6250,48220,48220,0,9,6691000.0
6691,6691999,21.591832193331577,37.88164018936971,0.04561870370159149,1243.013590812683,434.4464316368103,1598.066276550293,54475,6250,48225,48225,0,9,6692000.0
6692,6692999,21.592518396055286,37.8836025222439,0.0456095554451732,1243.4112164974213,434.5134720802307,1598.320671081543,54487,6252,48235,48235,0,9,6693000.0
6693,6693999,21.592824083903125,37.88420911854255,0.04560969393241088,1243.6634895801544,434.5795941352844,1598.6172370910645,54500,6253,48247,48247,0,9,6694000.0
6694,6694999,21.593807034650293,37.88650529734692,0.04561650407335793,1244.0698080062866,434.6462371349335,1598.7729949951172,54520,6255,48265,48265,0,9,6695000.0
6695,6695999,21.595056886086486,37.8929026533817,0.045599951107090364,1244.7039892673492,434.7138137817383,1598.888729095459,54559,6259,48300,48300,0,9,6696000.0
6696,6696999,21.59631548694821,37.89501370510398,0.04560566416720235,1245.211762189865,434.7810459136963,1599.1220092773438,54591,6262,48329,48329,0,9,6697000.0
6697,6697999,21.597552260365678,37.897434800421095,0.04560993428120719,1245.3417043685913,434.8458209037781,1599.5448989868164,54596,6262,48334,48334,0,9,6698000.0
6698,6698999,21.59935475566903,37.90316033863297,0.04563696925564742,1245.6020243167877,434.9113440513611,1599.884765625,54610,6263,48347,48347,0,9,6699000.0
6699,6699999,21.599938285625797,37.90340372001291,0.0456271802498972,1245.7487571239471,434.9885404109955,1600.7111587524414,54637,6263,48374,48374,0,9,6700000.0
6700,6700999,21.600032241483667,37.905278946109306,0.04559508634326637,1246.1268441677094,435.0552763938904,1601.5137977600098,54672,6265,48407,48407,0,9,6701000.0
6701,6701999,21.599718860776616,37.904943696815735,0.04559253446065936,1246.3775877952576,435.1217818260193,1601.954444885254,54686,6266,48420,48420,0,9,6702000.0
6702,6702999,21.5998944908891,37.90570773117382,0.04558205791785075,1246.761729001999,435.18788743019104,1602.2099151611328,54705,6268,48437,48437,0,9,6703000.0
6703,6703999,21.59977711563028,37.90542564818793,0.045574918103545636,1246.8877096176147,435.25298142433167,1602.5918769836426,54708,6268,48440,48440,0,9,6704000.0
6704,6704999,21.599779437036077,37.905274617502315,0.04556890863616825,1247.2700119018555,435.3194570541382,1602.8093147277832,54729,6270,48459,48459,0,9,6705000.0
6705,6705999,21.59998267908433,37.90549421703565,0.04557047762716482,1247.5275447368622,435.3852574825287,1603.1603660583496,54734,6271,48463,48463,0,9,6706000.0
6706,6706999,21.60026638275903,37.90559276751791,0.045575403956308325,1247.9210216999054,435.45183062553406,1603.3259658813477,54746,6273,48473,48473,0,9,6707000.0
6707,6707999,21.60097399630498,37.90710322431101,0.04558200190327566,1248.4295160770416,435.51935052871704,1603.4345092773438,54764,6276,48488,48488,0,9,6708000.0
6708,6708999,21.60154115334135,37.907945364275086,0.0455901947519286,1248.809758424759,435.5855920314789,1603.5762062072754,54778,6278,48500,48500,0,9,6709000.0
6709,6709999,21.602447933160757,37.90907720071701,0.04559553303729991,1249.4377806186676,435.6505811214447,1603.6300010681152,54794,6282,48512,48512,0,9,6710000.0
6710,6710999,21.60307076682514,37.90992917493252,0.04559771216143682,1249.814096212387,435.71803092956543,1603.7939186096191,54812,6284,48528,48528,0,9,6711000.0
6711,6711999,21.603962114528645,37.91130183070109,0.04560457044612509,1250.1965622901917,435.78503131866455,1604.0313186645508,54834,6286,48548,48548,0,9,6712000.0
6712,6712999,21.60521842655117,37.91382279948584,0.04561460464375089,1250.7078924179077,435.85155963897705,1604.1207466125488,54858,6289,48569,48569,0,9,6713000.0
6713,6713999,21.60631010309044,37.91503375923892,0.045628864012288606,1250.9630613327026,435.9185392856598,1604.4525032043457,54871,6290,48581,48581,0,9,6714000.0
6714,6714999,21.607622032216568,37.917722245825985,0.04563528314938603,1251.0853757858276,435.98421478271484,1604.8122596740723,54874,6290,48584,48584,0,9,6715000.0
6715,6715999,21.60850437370797,37.91861348301919,0.04564414012439566,1251.3457763195038,436.05030035972595,1605.0468673706055,54884,6291,48593,48593,0,9,6716000.0
6716,6716999,21.609733447410726,37.91984639920933,0.045654211439862924,1251.9946167469025,436.11675906181335,1605.079444885254,54918,6295,48623,48623,0,9,6717000.0
6717,6717999,21.61089805678871,37.9208482440427,0.045656413122034833,1252.6287953853607,436.18332529067993,1605.2567596435547,54941,6299,48642,48642,0,9,6718000.0
6718,6718999,21.61107592726181,37.92166228468093,0.045645062415413884,1252.8879055976868,436.24972701072693,1606.0219497680664,54966,6300,48666,48666,0,9,6719000.0
6719,6719999,21.610502124108546,37.92257113649418,0.04564764934595644,1253.0212006568909,436.31673526763916,1606.526943206787,54974,6300,48674,48674,0,9,6720000.0
6720,6720999,21.60974570906101,37.921290405677716,0.04565049853787906,1253.1527116298676,436.3826289176941,1606.8419075012207,54974,6300,48674,48674,0,9,6721000.0
6721,6721999,21.609070533941296,37.92008856757068,0.04565048807739991,1253.280727148056,436.4488625526428,1607.264289855957,54979,6300,48679,48679,0,9,6722000.0
6722,6722999,21.608735125341557,37.91993116284526,0.04564570473303731,1253.6697852611542,436.5156960487366,1607.3678283691406,54992,6302,48690,48690,0,9,6723000.0
6723,6723999,21.60830846066646,37.91891878530203,0.04564457184377246,1253.7959291934967,436.58164834976196,1607.6847915649414,54993,6302,48691,48691,0,9,6724000.0
6724,6724999,21.60786305673389,37.91784612860213,0.04564170132200085,1254.3038220405579,436.6489450931549,1607.8272666931152,55019,6305,48714,48714,0,9,6725000.0
6725,6725999,21.607712067369096,37.917367605643186,0.04563847979640012,1254.558940410614,436.71535205841064,1608.0947723388672,55032,6306,48726,48726,0,9,6726000.0
6726,6726999,21.60746765342322,37.91667115606605,0.04563512540170034,1254.6877274513245,436.78145837783813,1608.295021057129,55032,6306,48726,48726,0,9,6727000.0
6727,6727999,21.607768491865073,37.91709952814682,0.04562844773658703,1254.9497017860413,436.8481819629669,1608.4877433776855,55044,6307,48737,48737,0,9,6728000.0
6728,6728999,21.60793480359124,37.9168879537265,0.045628630492735356,1255.5826506614685,436.9140884876251,1608.5303421020508,55099,6311,48788,48788,0,9,6729000.0
6729,6729999,21.60814525974293,37.91666657107513,0.04562403961221184,1255.9712319374084,436.98023986816406,1608.7182731628418,55112,6313,48799,48799,0,9,6730000.0
6730,6730999,21.608525965087257,37.91697661643858,0.04562064948645406,1256.2205781936646,437.04620242118835,1608.908203125,55115,6314,48801,48801,0,9,6731000.0
6731,6731999,21.60885532182503,37.9168921639508,0.045613362478716724,1256.7298259735107,437.1131842136383,1608.8828620910645,55130,6317,48813,48813,0,9,6732000.0
6732,6732999,21.609054885724156,37.916450856621715,0.045611394456386956,1256.8559510707855,437.17811155319214,1609.1152687072754,55130,6317,48813,48813,0,9,6733000.0
6733,6733999,21.60977330528476,37.91688053186327,0.045609657836815476,1257.3768434524536,437.24512362480164,1609.1689720153809,55155,6320,48835,48835,0,9,6734000.0
6734,6734999,21.609961065019643,37.916308913783546,0.045609654230482355,1257.6250383853912,437.31060552597046,1609.345386505127,55166,6321,48845,48845,0,9,6735000.0
6735,6735999,21.610326249539135,37.91585921702523,0.0456023740003878,1258.0123522281647,437.3780851364136,1609.3338356018066,55178,6323,48855,48855,0,9,6736000.0
6736,6736999,21.61057269236183,37.91538390830242,0.045599530853891235,1258.2824940681458,437.44360184669495,1609.5348320007324,55190,6324,48866,48866,0,9,6737000.0
6737,6737999,21.610955900598377,37.91479630231674,0.04559261039719953,1258.5323719978333,437.50914669036865,1609.789421081543,55203,6325,48878,48878,0,9,6738000.0
6738,6738999,21.610747091007138,37.913492338733356,0.04559043582676847,1258.8061828613281,437.57512760162354,1610.2157745361328,55220,6326,48894,48894,0,9,6739000.0
6739,6739999,21.60964051775362,37.911720827345874,0.04559735943054921,1259.0620172023773,437.6426854133606,1610.834373474121,55244,6327,48917,48917,0,9,6740000.0
6740,6740999,21.60859177631757,37.910496860334646,0.045602577408379696,1259.1877763271332,437.7085418701172,1611.221866607666,55247,6327,48920,48920,0,9,6741000.0
6741,6741999,21.607667474737507,37.9090881214066,0.04560565011206097,1259.5646777153015,437.7750635147095,1611.404769897461,55270,6329,48941,48941,0,9,6742000.0
6742,6742999,21.606826604841295,37.90748103841601,0.045610979354167136,1259.945070028305,437.8410680294037,1611.489833831787,55279,6331,48948,48948,0,9,6743000.0
6743,6743999,21.60602393776728,37.90576020864785,0.04561616289877024,1260.4576723575592,437.9074447154999,1611.627155303955,55316,6334,48982,48982,0,9,6744000.0
6744,6744999,21.60530688776501,37.90410812411141,0.04562156913869375,1260.5859262943268,437.97333788871765,1611.9056091308594,55317,6334,48983,48983,0,9,6745000.0
6745,6745999,21.604734987047177,37.90294209251806,0.045625045791102936,1260.846322774887,438.03897881507874,1612.1195755004883,55322,6335,48987,48987,0,9,6746000.0
6746,6746999,21.60416025200282,37.901950618007774,0.045627585099606516,1261.1049287319183,438.1060047149658,1612.2910079956055,55324,6336,48988,48988,0,9,6747000.0
6747,6747999,21.603688466417175,37.90083081870303,0.045628153192845855,1261.2264018058777,438.17119908332825,1612.5988159179688,55325,6336,48989,48989,0,9,6748000.0
6748,6748999,21.60338266508459,37.90044926248713,0.0456276858032203,1261.4806623458862,438.23701095581055,1612.8225631713867,55330,6337,48993,48993,0,9,6749000.0
6749,6749999,21.603044342071765,37.899252839382086,0.04563140191213555,1261.607472896576,438.3011291027069,1613.0217971801758,55331,6337,48994,48994,0,9,6750000.0
6750,6750999,21.60295391288729,37.8984226084698,0.04563328879022133,1261.8735873699188,438.36686277389526,1613.2103729248047,55346,6338,49008,49008,0,9,6751000.0
6751,6751999,21.603053030019293,37.8995841969584,0.04563859278631932,1262.5174951553345,438.4340789318085,1613.152214050293,55372,6342,49030,49030,0,9,6752000.0
6752,6752999,21.60326890657867,37.8992924620122,0.04564093956358295,1262.7796003818512,438.5010201931,1613.37060546875,55385,6343,49042,49042,0,9,6753000.0
6753,6753999,21.603819007261272,37.89970870050697,0.045645185894083284,1263.0341658592224,438.56659865379333,1613.57767868042,55389,6344,49045,49045,0,9,6754000.0
6754,6754999,21.604518290705943,37.901456018241774,0.04565131046013482,1263.4732465744019,438.64654183387756,1613.7793502807617,55412,6346,49066,49066,0,9,6755000.0
6755,6755999,21.605384586330086,37.90232159238944,0.045655889188286225,1263.6040663719177,438.71254229545593,1613.9996376037598,55412,6346,49066,49066,0,9,6756000.0
6756,6756999,21.606124350223745,37.90292706351458,0.04566004785157707,1263.7425391674042,438.7790470123291,1614.1376876831055,55412,6346,49066,49066,0,9,6757000.0
6757,6757999,21.606841055100347,37.903430222584866,0.04566575520443672,1264.1266119480133,438.84528708457947,1614.301612854004,55427,6348,49079,49079,0,9,6758000.0
6758,6758999,21.606819936854887,37.90269723991471,0.04566551924334472,1264.2689983844757,438.9106550216675,1614.9762268066406,55445,6348,49097,49097,0,9,6759000.0
6759,6759999,21.60626351938563,37.902277394583095,0.045669117194096276,1264.5179634094238,438.9760100841522,1615.3864822387695,55455,6349,49106,49106,0,9,6760000.0
6760,6760999,21.606219487213977,37.90308201472972,0.04567125770317071,1264.772038936615,439.042852640152,1615.6386947631836,55457,6350,49107,49107,0,9,6761000.0
6761,6761999,21.60644850116817,37.90390299320004,0.04566612550571569,1265.1494841575623,439.1090176105499,1615.8697204589844,55472,6352,49120,49120,0,9,6762000.0
6762,6762999,21.60705838063712,37.904845528903586,0.04567088431588162,1265.5297853946686,439.17496943473816,1616.0487098693848,55493,6354,49139,49139,0,9,6763000.0
6763,6763999,21.607915411195894,37.90649320676704,0.04567266068930831,1265.7883455753326,439.2405536174774,1616.1764907836914,55501,6355,49146,49146,0,9,6764000.0
6764,6764999,21.608454747345498,37.90719112474107,0.04568039165205795,1266.0431616306305,439.30561232566833,1616.3890838623047,55515,6356,49159,49159,0,9,6765000.0
6765,6765999,21.609572385802633,37.90916273197939,0.04568447262375874,1266.4227302074432,439.3714883327484,1616.5926666259766,55533,6358,49175,49175,0,9,6766000.0
6766,6766999,21.610442203151077,37.91034458630403,0.04568255134744448,1266.5477643013,439.4371349811554,1616.8317947387695,55534,6358,49176,49176,0,9,6767000.0
6767,6767999,21.611302185302527,37.911182684764285,0.04569335463428059,1266.9272611141205,439.5033555030823,1616.9172439575195,55538,6360,49178,49178,0,9,6768000.0
6768,6768999,21.612842652452223,37.913421767537564,0.04569151468566224,1267.3089005947113,439.56839990615845,1617.0541877746582,55553,6362,49191,49191,0,9,6769000.0
6769,6769999,21.61418591832284,37.91559099874942,0.045700902963778045,1267.6872279644012,439.63439989089966,1617.1275215148926,55575,6364,49211,49211,0,9,6770000.0
6770,6770999,21.615158921838898,37.91709142451398,0.045711838755018275,1268.0728583335876,439.6999406814575,1617.1278114318848,55588,6366,49222,49222,0,9,6771000.0
6771,6771999,21.616205467124956,37.91852304310955,0.045717127771759625,1268.4593210220337,439.7672154903412,1617.1900444030762,55610,6368,49242,49242,0,9,6772000.0
6772,6772999,21.617612151617003,37.92061323221406,0.04573235723639657,1268.850263595581,439.8333942890167,1617.2793350219727,55623,6370,49253,49253,0,9,6773000.0
6773,6773999,21.618776360691516,37.9220324428085,0.04574633901057701,1269.2377572059631,439.8995101451874,1617.3836555480957,55647,6372,49275,49275,0,9,6774000.0
6774,6774999,21.620201090755486,37.92346674309437,0.045758812486727196,1269.5160875320435,439.9659903049469,1617.5246696472168,55659,6373,49286,49286,0,9,6775000.0
6775,6775999,21.621371127394088,37.924998364980596,0.0457637979695803,1269.7705881595612,440.03045654296875,1617.6733207702637,55671,6374,49297,49297,0,9,6776000.0
6776,6776999,21.622432331334362,37.92583471278415,0.04577447479680907,1270.0370140075684,440.097473859787,1617.7967643737793,55673,6375,49298,49298,0,9,6777000.0
6777,6777999,21.622773276858336,37.92562968722152,0.04577633163642747,1270.3043944835663,440.16286444664,1618.0207710266113,55689,6376,49313,49313,0,9,6778000.0
6778,6778999,21.622026539089973,37.92476681473666,0.04576875788249957,1270.4402775764465,440.23059368133545,1619.1240158081055,55731,6376,49355,49355,0,9,6779000.0
6779,6779999,21.620861776533825,37.92368701216515,0.04576892976085156,1270.5683152675629,440.29796957969666,1619.517246246338,55733,6376,49357,49357,0,9,6780000.0
6780,6780999,21.619765525621116,37.921890559903765,0.045772054311577604,1270.8237705230713,440.36455368995667,1619.7468795776367,55735,6377,49358,49358,0,9,6781000.0
6781,6781999,21.618895037873248,37.921618664697085,0.04577192624952586,1270.9499893188477,440.43013978004456,1620.0079040527344,55736,6377,49359,49359,0,9,6782000.0
6782,6782999,21.617888429953087,37.91982178785177,0.045773917880583936,1271.71395778656,440.4984767436981,1620.032241821289,55759,6382,49377,49377,0,9,6783000.0
6783,6783999,21.616876394183524,37.91797330606164,0.04577621977582935,1271.971361875534,440.56486320495605,1620.2346000671387,55769,6383,49386,49386,0,9,6784000.0
6784,6784999,21.616114684852263,37.91663760551218,0.04577600475036925,1272.2282633781433,440.6308853626251,1620.4348373413086,55771,6384,49387,49387,0,9,6785000.0
6785,6785999,21.61532277987409,37.91506197834684,0.045777981804030254,1272.353641986847,440.69704580307007,1620.7123107910156,55773,6384,49389,49389,0,9,6786000.0
6786,6786999,21.614738323609544,37.91430844778266,0.04577512934369632,1272.4845526218414,440.76229596138,1620.9372673034668,55775,6384,49391,49391,0,9,6787000.0
6787,6787999,21.61423051048454,37.912944227959855,0.04577281358939078,1272.740960597992,440.8273825645447,1621.141616821289,55806,6385,49421,49421,0,9,6788000.0
6788,6788999,21.6137430281604,37.9117239139952,0.04577087257970225,1272.996832370758,440.89339566230774,1621.388370513916,55824,6386,49438,49438,0,9,6789000.0
6789,6789999,21.613396174074524,37.91092653817639,0.04576983550017233,1273.2584936618805,440.9602630138397,1621.5372200012207,55836,6387,49449,49449,0,9,6790000.0
6790,6790999,21.613174295101828,37.91012495451644,0.04576937642818524,1273.3938994407654,441.02538084983826,1621.834617614746,55838,6387,49451,49451,0,9,6791000.0
6791,6791999,21.613139788543158,37.90939089919983,0.04576340212799368,1273.7864634990692,441.09213161468506,1622.087245941162,55847,6389,49458,49458,0,9,6792000.0
6792,6792999,21.613126128601326,37.90875118148849,0.045760852977745126,1273.909078836441,441.157874584198,1622.324520111084,55847,6389,49458,49458,0,9,6793000.0
6793,6793999,21.613506820139197,37.90884936050919,0.04575357135592251,1274.0332505702972,441.22383069992065,1622.7380752563477,55853,6389,49464,49464,0,9,6794000.0
6794,6794999,21.613849481976512,37.90878764651529,0.04575341639588881,1274.5568444728851,441.2924311161041,1622.9419593811035,55873,6392,49481,49481,0,9,6795000.0
6795,6795999,21.61466889447519,37.90920902869108,0.045750888067714546,1274.6871752738953,441.35748648643494,1623.1838264465332,55874,6392,49482,49482,0,9,6796000.0
6796,6796999,21.615203728820706,37.90909741583052,0.04575506177425259,1275.2236347198486,441.4249622821808,1623.1810302734375,55881,6395,49486,49486,0,9,6797000.0
6797,6797999,21.615852229731633,37.90915458223246,0.045761713322308606,1275.4760572910309,441.49041056632996,1623.4891738891602,55895,6396,49499,49499,0,9,6798000.0
6798,6798999,21.615899253771758,37.908508123033776,0.045761568713472145,1276.0000491142273,441.55715012550354,1624.0463027954102,55923,6399,49524,49524,0,9,6799000.0
6799,6799999,21.614891914198175,37.9072071976757,0.04576190053823748,1276.39248585701,441.62373638153076,1624.4669647216797,55957,6401,49556,49556,0,9,6800000.0
6800,6800999,21.614016034225607,37.90587885822095,0.04576492653576547,1276.7908208370209,441.6909718513489,1624.7532958984375,55977,6403,49574,49574,0,9,6801000.0
6801,6801999,21.613491797499343,37.90516093015943,0.04576284455437141,1276.9161839485168,441.7581617832184,1625.1051177978516,55979,6403,49576,49576,0,9,6802000.0
6802,6802999,21.613361412537127,37.90476536825144,0.0457578336747575,1277.0472025871277,441.82458662986755,1625.3721199035645,55980,6403,49577,49577,0,9,6803000.0
6803,6803999,21.61306544876018,37.90421616963756,0.04575035638513625,1277.1750228404999,441.89023780822754,1625.6014213562012,55981,6403,49578,49578,0,9,6804000.0
6804,6804999,21.61284904647523,37.9033090954028,0.04575072350722398,1277.4293420314789,441.95674300193787,1625.7998352050781,55994,6404,49590,49590,0,9,6805000.0
6805,6805999,21.612394336237315,37.90256038219239,0.04574715870095025,1277.5564830303192,442.02297735214233,1626.0094451904297,55994,6404,49590,49590,0,9,6806000.0
6806,6806999,21.612114354101767,37.901966125820124,0.04574512082240478,1277.685091972351,442.08877968788147,1626.2403869628906,55995,6404,49591,49591,0,9,6807000.0
6807,6807999,21.612109216366505,37.901665458317105,0.045740100267033235,1278.0890905857086,442.15570855140686,1626.4139099121094,56006,6406,49600,49600,0,9,6808000.0
6808,6808999,21.612009508165116,37.900882719174554,0.04573403280704891,1278.2176485061646,442.2232220172882,1626.632167816162,56007,6406,49601,49601,0,9,6809000.0
6809,6809999,21.611815270213892,37.899927149865725,0.04572912506499005,1278.6109013557434,442.288859128952,1626.8228149414062,56029,6408,49621,49621,0,9,6810000.0
6810,6810999,21.612208465710996,37.9003362786686,0.04572989291197882,1278.8752522468567,442.35534405708313,1626.9179916381836,56040,6409,49631,49631,0,9,6811000.0
6811,6811999,21.612466917215578,37.90018613081425,0.045727349880198664,1279.3991158008575,442.4218695163727,1626.9153327941895,56063,6412,49651,49651,0,9,6812000.0
6812,6812999,21.613123627718245,37.90070563185104,0.045728061936711084,1279.6555817127228,442.4883232116699,1627.0746574401855,56065,6413,49652,49652,0,9,6813000.0
6813,6813999,21.613866743290842,37.90117186821908,0.04573341271764564,1280.0526604652405,442.5542812347412,1627.2054405212402,56089,6415,49674,49674,0,9,6814000.0
6814,6814999,21.614609137787014,37.90158830774295,0.045732637466170734,1280.435576915741,442.61952209472656,1627.2979583740234,56103,6417,49686,49686,0,9,6815000.0
6815,6815999,21.61544001625243,37.90173522169807,0.04573160124552644,1280.570062637329,442.68505024909973,1627.550708770752,56106,6417,49689,49689,0,9,6816000.0
6816,6816999,21.616439193768937,37.902301287087255,0.04573054654777242,1281.2292144298553,442.75190567970276,1627.559970855713,56129,6421,49708,49708,0,9,6817000.0
6817,6817999,21.617397720007013,37.902604492831095,0.045732234735457955,1281.617399930954,442.818119764328,1627.6332778930664,56150,6423,49727,49727,0,9,6818000.0
6818,6818999,21.618142057644075,37.90286172203552,0.045725800091658386,1281.8732361793518,442.8827614784241,1627.790729522705,56160,6424,49736,49736,0,9,6819000.0
6819,6819999,21.617621197147972,37.902110566032036,0.04572090860420375,1282.2709910869598,442.9495937824249,1628.540786743164,56205,6426,49779,49779,0,9,6820000.0
6820,6820999,21.61683293447818,37.90113613794566,0.045720384468623365,1282.6514568328857,443.0159752368927,1628.8816032409668,56222,6428,49794,49794,0,9,6821000.0
6821,6821999,21.616004524642676,37.89959117911061,0.04572528915178875,1282.785879611969,443.0822823047638,1629.1685104370117,56223,6428,49795,49795,0,9,6822000.0
6822,6822999,21.615275284615354,37.89805543512134,0.045728010128562646,1282.9104685783386,443.1475896835327,1629.4001083374023,56224,6428,49796,49796,0,9,6823000.0
6823,6823999,21.614548436239552,37.89677011682451,0.045728960444049616,1283.038957118988,443.213250875473,1629.6015396118164,56224,6428,49796,49796,0,9,6824000.0
6824,6824999,21.6140899369917,37.89593334630876,0.045730424053831986,1283.168221950531,443.2800030708313,1629.837776184082,56225,6428,49797,49797,0,9,6825000.0
6825,6825999,21.61357031907402,37.89480428233883,0.045732148328863964,1283.4447066783905,443.3466274738312,1630.1352767944336,56232,6429,49803,49803,0,9,6826000.0
6826,6826999,21.613052818430187,37.893556143747944,0.045733935187330044,1283.7033865451813,443.41253209114075,1630.2914848327637,56243,6430,49813,49813,0,9,6827000.0
6827,6827999,21.61265324576732,37.89249117811265,0.04573328783560349,1284.1048505306244,443.47876620292664,1630.3582496643066,56257,6432,49825,49825,0,9,6828000.0
6828,6828999,21.612396271476797,37.891670421768985,0.04573226446179257,1284.4980981349945,443.5449388027191,1630.5207557678223,56262,6434,49828,49828,0,9,6829000.0
6829,6829999,21.6123826528261,37.89118338339548,0.04573071142637719,1284.7587296962738,443.6104202270508,1630.704574584961,56266,6435,49831,49831,0,9,6830000.0
6830,6830999,21.612759432933885,37.89333234875767,0.0457219620702084,1285.0135476589203,443.6767888069153,1630.8150596618652,56273,6436,49837,49837,0,9,6831000.0
6831,6831999,21.613296673992274,37.894766332468436,0.04571210940187176,1285.4092116355896,443.7431502342224,1631.0270195007324,56287,6438,49849,49849,0,9,6832000.0
6832,6832999,21.61370454064157,37.89501335959574,0.04571313434981694,1285.5477652549744,443.8093104362488,1631.221778869629,56287,6438,49849,49849,0,9,6833000.0
6833,6833999,21.6139583653743,37.89452204836115,0.045708952310944295,1285.811927318573,443.8754072189331,1631.3950233459473,56291,6439,49852,49852,0,9,6834000.0
6834,6834999,21.61397646026048,37.89473840240923,0.04571225711098137,1286.329470872879,443.94113755226135,1631.5189056396484,56325,6442,49883,49883,0,9,6835000.0
6835,6835999,21.613986989194476,37.894974547479336,0.04570562842904724,1286.5881748199463,444.00689339637756,1632.2583923339844,56352,6443,49909,49909,0,9,6836000.0
6836,6836999,21.613628609459816,37.89481043511502,0.045703809241936955,1286.724044561386,444.07578682899475,1632.8703422546387,56364,6443,49921,49921,0,9,6837000.0
6837,6837999,21.61393905785215,37.90037811541866,0.04570887920230449,1286.85640335083,444.14160799980164,1633.28470993042,56368,6443,49925,49925,0,9,6838000.0
6838,6838999,21.61383304120835,37.89983255831246,0.04570882257931819,1286.9849247932434,444.2079212665558,1633.635341644287,56369,6443,49926,49926,0,9,6839000.0
6839,6839999,21.61408730017189,37.90134815647273,0.04570660459759568,1287.2461380958557,444.27394676208496,1633.8754348754883,56380,6444,49936,49936,0,9,6840000.0
6840,6840999,21.61419532455552,37.90097547894089,0.045699459074656446,1287.6338376998901,444.38178038597107,1634.1264572143555,56392,6445,49947,49947,0,9,6841000.0
6841,6841999,21.61419442819128,37.900562875796275,0.04569535324722307,1287.758218050003,444.4475190639496,1634.3813400268555,56394,6445,49949,49949,0,9,6842000.0
6842,6842999,21.61444070240511,37.902955256084226,0.04568512858402718,1288.1536555290222,444.51292276382446,1634.439308166504,56420,6447,49973,49973,0,9,6843000.0
6843,6843999,21.614754914282383,37.90278062767528,0.04568287401725035,1288.4116365909576,444.579195022583,1634.7617073059082,56425,6448,49977,49977,0,9,6844000.0
6844,6844999,21.615211758798182,37.90312444060819,0.04567621728233373,1288.7978103160858,444.6449964046478,1635.0474166870117,56454,6450,50004,50004,0,9,6845000.0
6845,6845999,21.61604139852497,37.90594289461238,0.0456751504007874,1289.0510704517365,444.71116638183594,1635.2551460266113,56465,6451,50014,50014,0,9,6846000.0
6846,6846999,21.616422099378788,37.90644870182861,0.045683763097746244,1289.3060970306396,444.7774374485016,1635.566909790039,56469,6452,50017,50017,0,9,6847000.0
6847,6847999,21.617401451376143,37.90756792644236,0.04569746971866773,1289.5723950862885,444.84411573410034,1635.8386878967285,56479,6453,50026,50026,0,9,6848000.0
6848,6848999,21.618228797376585,37.90848440073703,0.045720722692307536,1289.9626700878143,444.91038250923157,1636.0168418884277,56494,6455,50039,50039,0,9,6849000.0
6849,6849999,21.61934769945741,37.91007475593465,0.04573660186942996,1290.2220096588135,444.9781572818756,1636.320011138916,56506,6456,50050,50050,0,9,6850000.0
6850,6850999,21.620218508357894,37.910620861790264,0.045749055493299884,1290.3434329032898,445.0442533493042,1636.7255973815918,56510,6456,50054,50054,0,9,6851000.0
6851,6851999,21.621395116446582,37.9129261567044,0.04576971324108259,1290.5984897613525,445.1105098724365,1637.0204582214355,56527,6457,50070,50070,0,9,6852000.0
6852,6852999,21.622430809928943,37.914395339606585,0.045791159209936816,1290.8554372787476,445.17676401138306,1637.2696075439453,56532,6458,50074,50074,0,9,6853000.0
6853,6853999,21.62296653736808,37.91432561963682,0.04580551116635312,1291.1292731761932,445.2518172264099,1637.5587158203125,56543,6459,50084,50084,0,9,6854000.0
6854,6854999,21.623028484420818,37.91494796133935,0.04578054462382253,1291.2619805335999,445.31971549987793,1638.490795135498,56577,6459,50118,50118,0,9,6855000.0
6855,6855999,21.622714095458196,37.91477794091611,0.045773228993037374,1291.3883867263794,445.3873198032379,1639.0655708312988,56587,6459,50128,50128,0,9,6856000.0
6856,6856999,21.622479577351086,37.91560610669815,0.04577368181947039,1291.5107626914978,445.45385694503784,1639.426368713379,56589,6459,50130,50130,0,9,6857000.0
6857,6857999,21.622270191088017,37.91610277840577,0.04576669322651605,1291.6422350406647,445.5209300518036,1639.7879943847656,56591,6459,50132,50132,0,9,6858000.0
6858,6858999,21.62212671718121,37.91603702461845,0.045764589854333515,1292.1692526340485,445.5890145301819,1639.9472541809082,56617,6462,50155,50155,0,9,6859000.0
6859,6859999,21.622255318845813,37.91660931556473,0.04576522927078419,1292.2907011508942,445.65458393096924,1640.2226181030273,56618,6462,50156,50156,0,9,6860000.0
6860,6860999,21.62203002860605,37.91602853207505,0.045766891822332734,1292.5462477207184,445.72054648399353,1640.4574546813965,56627,6463,50164,50164,0,9,6861000.0
6861,6861999,21.622127505759746,37.91606005533453,0.04577487372481692,1292.8014323711395,445.78703594207764,1640.8065223693848,56648,6464,50184,50184,0,9,6862000.0
6862,6862999,21.62238594539947,37.91624660417847,0.045782054799269556,1293.0615718364716,445.85430693626404,1640.9746398925781,56650,6465,50185,50185,0,9,6863000.0
6863,6863999,21.6226450952431,37.916384709101806,0.04578883265667555,1293.3229780197144,445.92106652259827,1641.3809127807617,56664,6466,50198,50198,0,9,6864000.0
6864,6864999,21.623307478878086,37.91684387219741,0.04580228484858795,1293.8516149520874,445.98962783813477,1641.6701126098633,56695,6469,50226,50226,0,9,6865000.0
6865,6865999,21.623990003998482,37.917703458181194,0.04581176557440769,1294.1163928508759,446.0572681427002,1641.8407936096191,56698,6470,50228,50228,0,9,6866000.0
6866,6866999,21.624402471264187,37.917839631196195,0.045825757433122005,1294.506663799286,446.1244914531708,1642.1145858764648,56712,6472,50240,50240,0,9,6867000.0
6867,6867999,21.625311543342075,37.91876090827931,0.045844399843299244,1295.346265554428,446.2387773990631,1642.3776245117188,56737,6475,50262,50262,0,9,6868000.0
6868,6868999,21.626297448250224,37.9196339890829,0.045868120497608245,1295.60342335701,446.30612659454346,1642.727439880371,56752,6476,50276,50276,0,9,6869000.0
6869,6869999,21.627166266532537,37.920020645330666,0.04588595455732569,1295.8578791618347,446.3732738494873,1643.0407257080078,56764,6477,50287,50287,0,9,6870000.0
6870,6870999,21.62799339009033,37.92131353411864,0.04590466296743778,1296.1149349212646,446.43982553482056,1643.3569259643555,56779,6478,50301,50301,0,9,6871000.0
6871,6871999,21.62875710396642,37.9217364244146,0.04592054225829734,1296.242434978485,446.50634026527405,1643.7067794799805,56783,6478,50305,50305,0,9,6872000.0
6872,6872999,21.629602951485207,37.922198779880965,0.04593762858381789,1296.8052394390106,446.6019103527069,1643.9403114318848,56800,6480,50320,50320,0,9,6873000.0
6873,6873999,21.629542528504253,37.921127102961265,0.045937722321530705,1297.1938066482544,446.6687664985657,1644.1552085876465,56841,6482,50359,50359,0,9,6874000.0
6874,6874999,21.62963447597174,37.923042102197776,0.045926095708653136,1297.4609205722809,446.73642802238464,1645.1861038208008,56880,6483,50397,50397,0,9,6875000.0
6875,6875999,21.629141172146035,37.92375828433234,0.04593829175908115,1297.7165565490723,446.8026316165924,1645.6941375732422,56889,6484,50405,50405,0,9,6876000.0
6876,6876999,21.628451809414717,37.92272795217818,0.04594105137782889,1298.0998339653015,446.86983728408813,1646.035343170166,56901,6486,50415,50415,0,9,6877000.0
6877,6877999,21.62785247199045,37.92149102322291,0.04594322924410266,1298.3558871746063,446.93641567230225,1646.3136024475098,56905,6487,50418,50418,0,9,6878000.0
6878,6878999,21.62727216403474,37.92046056873535,0.04594279086600073,1298.4861834049225,447.00180768966675,1646.5577659606934,56906,6487,50419,50419,0,9,6879000.0
6879,6879999,21.626848642673504,37.91980336040524,0.045944514225698674,1298.867667913437,447.068176984787,1646.7665176391602,56933,6489,50444,50444,0,9,6880000.0
6880,6880999,21.62642306551923,37.91863617778043,0.04595027353644199,1298.9965381622314,447.1354646682739,1647.1788444519043,56936,6489,50447,50447,0,9,6881000.0
6881,6881999,21.62607349745002,37.91790524743369,0.045962443389753194,1299.2489430904388,447.20119285583496,1647.4256706237793,56949,6490,50459,50459,0,9,6882000.0
6882,6882999,21.625842209366706,37.91731513810108,0.04596691689414523,1299.3695516586304,447.2666823863983,1647.7238540649414,56951,6490,50461,50461,0,9,6883000.0
6883,6883999,21.625732236434704,37.916987618137405,0.04596741851131392,1299.6233925819397,447.33327746391296,1647.9424362182617,56960,6491,50469,50469,0,9,6884000.0
6884,6884999,21.626058234848585,37.917772949934644,0.0459816708888241,1300.0108315944672,447.39938282966614,1648.1313705444336,56971,6493,50478,50478,0,9,6885000.0
6885,6885999,21.627050799441612,37.91951468530096,0.04600254239146895,1300.4068171977997,447.466112613678,1648.2936096191406,56998,6495,50503,50503,0,9,6886000.0
6886,6886999,21.628053518937577,37.92060801756095,0.04601118857207176,1300.815940618515,447.53197860717773,1648.454402923584,57011,6497,50514,50514,0,9,6887000.0
6887,6887999,21.629555760427216,37.92373261282871,0.046021099166458135,1301.3482489585876,447.59904646873474,1648.5094680786133,57035,6500,50535,50535,0,9,6888000.0
6888,6888999,21.630908040916,37.92566355872682,0.04603377590313551,1301.481533050537,447.6651723384857,1648.743366241455,57035,6500,50535,50535,0,9,6889000.0
6889,6889999,21.632361387247514,37.92754297929476,0.04604390856484353,1301.608775138855,447.73035168647766,1648.9438667297363,57035,6500,50535,50535,0,9,6890000.0
6890,6890999,21.633612012591293,37.929019282545035,0.046061367834548506,1301.8666746616364,447.7958059310913,1649.126796722412,57046,6501,50545,50545,0,9,6891000.0
6891,6891999,21.634386764510293,37.929363188247166,0.04607080982307066,1302.2541909217834,447.8622405529022,1649.3096351623535,57061,6503,50558,50558,0,9,6892000.0
6892,6892999,21.63438546291886,37.92946676009504,0.04606607166157828,1302.390237569809,447.9305019378662,1650.332836151123,57098,6503,50595,50595,0,9,6893000.0
6893,6893999,21.633838988927796,37.929739621419074,0.04604993889931808,1302.6539859771729,447.9978942871094,1650.835693359375,57116,6504,50612,50612,0,9,6894000.0
6894,6894999,21.633069784042263,37.92850042376024,0.04604620303417595,1302.7796785831451,448.0635061264038,1651.1897659301758,57117,6504,50613,50613,0,9,6895000.0
6895,6895999,21.632375283673447,37.927254577430745,0.046047486432826856,1303.0474600791931,448.1298863887787,1651.493251800537,57131,6505,50626,50626,0,9,6896000.0
6896,6896999,21.63174503283163,37.92598140024836,0.046046654215178395,1303.1845314502716,448.19643998146057,1651.770580291748,57133,6505,50628,50628,0,9,6897000.0
6897,6897999,21.63124152663572,37.92464464661851,0.0460430260242477,1303.3119959831238,448.2626898288727,1652.0119018554688,57133,6505,50628,50628,0,9,6898000.0
6898,6898999,21.63059318937925,37.923492226987754,0.046041738710007496,1303.569322347641,448.32824182510376,1652.2734718322754,57138,6506,50632,50632,0,9,6899000.0
6899,6899999,21.629992117783754,37.921937428414815,0.04603919863129835,1303.8331880569458,448.39544773101807,1652.6495513916016,57155,6507,50648,50648,0,9,6900000.0
6900,6900999,21.629381992553224,37.92046497463052,0.04603889475320799,1303.9533808231354,448.46117758750916,1652.90580368042,57156,6507,50649,50649,0,9,6901000.0
6901,6901999,21.628749000161562,37.918866805948234,0.04603920507636572,1304.0847864151,448.5285556316376,1653.3032760620117,57159,6507,50652,50652,0,9,6902000.0
6902,6902999,21.628173547203257,37.91775043140163,0.04603890644958519,1304.3382818698883,448.5955140590668,1653.5292358398438,57174,6508,50666,50666,0,9,6903000.0
6903,6903999,21.627733139925088,37.91647618262631,0.046036771922696285,1304.5937411785126,448.6612718105316,1653.7003631591797,57180,6509,50671,50671,0,9,6904000.0
6904,6904999,21.627342657782776,37.91534317902167,0.04604060968269863,1304.8472256660461,448.72749972343445,1654.0070877075195,57189,6510,50679,50679,0,9,6905000.0
6905,6905999,21.627169757996526,37.91427335658777,0.046040497427262905,1305.1042642593384,448.79419803619385,1654.220817565918,57201,6511,50690,50690,0,9,6906000.0
6906,6906999,21.626991670080407,37.91330326486385,0.0460411664760203,1305.371912240982,448.86000990867615,1654.3545379638672,57212,6512,50700,50700,0,9,6907000.0
6907,6907999,21.62705195435178,37.91255510988202,0.04604417264696192,1305.6298167705536,448.92487931251526,1654.491455078125,57219,6513,50706,50706,0,9,6908000.0
6908,6908999,21.62691375738091,37.91138198000675,0.046044348743168984,1305.8967134952545,448.99094128608704,1654.5636253356934,57230,6514,50716,50716,0,9,6909000.0
6909,6909999,21.626810176865842,37.910292973789424,0.04604441059158504,1306.1605248451233,449.05682730674744,1654.6928176879883,57233,6515,50718,50718,0,9,6910000.0
6910,6910999,21.626620288969388,37.909089310193785,0.0460470523989609,1306.8278024196625,449.12335300445557,1654.7004699707031,57242,6519,50723,50723,0,9,6911000.0
6911,6911999,21.626221851856396,37.90754397827496,0.04604556102295887,1306.961445569992,449.1898033618927,1655.0197448730469,57243,6519,50724,50724,0,9,6912000.0
6912,6912999,21.62557728141519,37.90611541740559,0.04604593395042644,1307.0863156318665,449.25610637664795,1655.7521781921387,57269,6519,50750,50750,0,9,6913000.0
6913,6913999,21.624548619612533,37.90458447108432,0.04604267653256966,1307.3590323925018,449.32324719429016,1656.3309593200684,57306,6520,50786,50786,0,9,6914000.0
6914,6914999,21.623448459450493,37.90334117146696,0.0460457153650744,1307.745910167694,449.38999223709106,1656.658130645752,57323,6522,50801,50801,0,9,6915000.0
6915,6915999,21.62244924823247,37.90173439450024,0.04605245982512873,1308.278712272644,449.4575140476227,1656.9353942871094,57356,6525,50831,50831,0,9,6916000.0
6916,6916999,21.62150154672635,37.899969142503444,0.04605283718209552,1308.4086227416992,449.52400398254395,1657.283603668213,57357,6525,50832,50832,0,9,6917000.0
6917,6917999,21.620783031406077,37.899072082155925,0.04604976055226906,1308.5485413074493,449.59094643592834,1657.5460777282715,57357,6525,50832,50832,0,9,6918000.0
6918,6918999,21.620232858462963,37.89827247037439,0.04604526468484316,1308.6707508563995,449.6577413082123,1657.837200164795,57359,6525,50834,50834,0,9,6919000.0
6919,6919999,21.619678080470624,37.89757975252718,0.046039445684377345,1308.794971704483,449.72377347946167,1658.1738357543945,57362,6525,50837,50837,0,9,6920000.0
6920,6920999,21.619171541670223,37.89706813355529,0.04603729339120333,1308.9246051311493,449.7893373966217,1658.3785285949707,57362,6525,50837,50837,0,9,6921000.0
6921,6921999,21.61923917062758,37.8982966993316,0.04603018538455439,1309.186019897461,449.85580611228943,1658.709358215332,57368,6526,50842,50842,0,9,6922000.0
6922,6922999,21.619569755758512,37.90171074938994,0.046018206350377455,1309.4512023925781,449.9227752685547,1658.97998046875,57374,6527,50847,50847,0,9,6923000.0
6923,6923999,21.619940306506976,37.90308468115279,0.04601629757286552,1309.5784094333649,449.9892592430115,1659.249641418457,57374,6527,50847,50847,0,9,6924000.0
6924,6924999,21.620536424110103,37.90551134808016,0.046022526728626945,1309.8442854881287,450.0561738014221,1659.495216369629,57382,6528,50854,50854,0,9,6925000.0
6925,6925999,21.62092217832788,37.90589242908814,0.0460229732152182,1309.975771188736,450.12190985679626,1659.6841201782227,57382,6528,50854,50854,0,9,6926000.0
6926,6926999,21.621818170616955,37.90798302900554,0.046029019060068954,1310.2274942398071,450.18776512145996,1659.892074584961,57396,6529,50867,50867,0,9,6927000.0
6927,6927999,21.62275852516051,37.91003512441197,0.04602978946155134,1310.4852726459503,450.25526905059814,1660.0689697265625,57407,6530,50877,50877,0,9,6928000.0
6928,6928999,21.623607384241623,37.911630954844966,0.0460348748725764,1310.6113176345825,450.3214566707611,1660.4168395996094,57410,6530,50880,50880,0,9,6929000.0
6929,6929999,21.624136230380962,37.912470344227486,0.04603799751762627,1310.8856282234192,450.39030623435974,1660.700180053711,57426,6531,50895,50895,0,9,6930000.0
6930,6930999,21.624700159256673,37.91274224149692,0.04603921826738333,1311.1555833816528,450.45656538009644,1660.9523086547852,57430,6532,50898,50898,0,9,6931000.0
6931,6931999,21.625029911180107,37.91288514518434,0.046032366707214,1311.4195556640625,450.5227527618408,1661.1602935791016,57432,6533,50899,50899,0,9,6932000.0
6932,6932999,21.624994369173187,37.91336466236924,0.046017905264183034,1311.5508992671967,450.5900864601135,1662.2017974853516,57468,6533,50935,50935,0,9,6933000.0
6933,6933999,21.624340764727815,37.91234388310515,0.04601732886188914,1311.6791396141052,450.6566581726074,1662.6557388305664,57470,6533,50937,50937,0,9,6934000.0
6934,6934999,21.623827228861476,37.9112665165329,0.04601106413213907,1311.806101322174,450.7222697734833,1662.8976554870605,57470,6533,50937,50937,0,9,6935000.0
6935,6935999,21.62341278725069,37.910390207673125,0.04600668261803875,1312.2027473449707,450.78803181648254,1663.1167526245117,57495,6535,50960,50960,0,9,6936000.0
6936,6936999,21.623159185283885,37.90969763523773,0.04600182963902044,1312.3321013450623,450.8550794124603,1663.4082565307617,57497,6535,50962,50962,0,9,6937000.0
6937,6937999,21.62257837250046,37.90827856622643,0.04599776788125598,1312.5904881954193,450.92322611808777,1663.620231628418,57511,6536,50975,50975,0,9,6938000.0
6938,6938999,21.622109570734704,37.9069584558952,0.04600124169471698,1313.1136543750763,450.98952317237854,1663.689453125,57527,6539,50988,50988,0,9,6939000.0
6939,6939999,21.622012005292707,37.90627018401203,0.0459921425194596,1313.2346551418304,451.0564329624176,1664.0991897583008,57530,6539,50991,50991,0,9,6940000.0
6940,6940999,21.6217650854172,37.905388110468486,0.04598739327972723,1313.4970073699951,451.1218819618225,1664.383689880371,57536,6540,50996,50996,0,9,6941000.0
6941,6941999,21.6216576607514,37.90695179739898,0.04598052240985029,1313.7491908073425,451.1881923675537,1664.544849395752,57542,6541,51001,51001,0,9,6942000.0
6942,6942999,21.621865409916484,37.90693208402321,0.045978248755924156,1314.0024271011353,451.25352907180786,1664.7895050048828,57547,6542,51005,51005,0,9,6943000.0
6943,6943999,21.621903696472508,37.906371908908476,0.04598071734992504,1314.3937752246857,451.3200545310974,1665.0136642456055,57557,6544,51013,51013,0,9,6944000.0
6944,6944999,21.622235229532855,37.90642063118572,0.04597974263810245,1314.521535396576,451.3860800266266,1665.353458404541,57558,6544,51014,51014,0,9,6945000.0
6945,6945999,21.62274116922894,37.90650788288649,0.04598816343625689,1314.91695022583,451.4527072906494,1665.5938758850098,57594,6546,51048,51048,0,9,6946000.0
6946,6946999,21.623131012745038,37.90638003636202,0.04600166513955062,1315.1791582107544,451.5175471305847,1665.810302734375,57606,6547,51059,51059,0,9,6947000.0
6947,6947999,21.623759614849487,37.90663648620795,0.046010240607511244,1315.442039012909,451.58423709869385,1666.0065841674805,57617,6548,51069,51069,0,9,6948000.0
6948,6948999,21.624364476979107,37.90668082169726,0.04601775374135353,1315.8317227363586,451.6502196788788,1666.1241340637207,57624,6550,51074,51074,0,9,6949000.0
6949,6949999,21.624930922482946,37.906576595262244,0.046030606558230214,1316.100005865097,451.71548318862915,1666.3532791137695,57628,6551,51077,51077,0,9,6950000.0
6950,6950999,21.625407543888457,37.90641484881382,0.04604550448466993,1316.3629999160767,451.7828357219696,1666.476791381836,57635,6552,51083,51083,0,9,6951000.0
6951,6951999,21.62568312950696,37.90577410258194,0.04605302476458428,1316.6273941993713,451.84867334365845,1666.7077980041504,57647,6553,51094,51094,0,9,6952000.0
6952,6952999,21.625947252331155,37.90748574067934,0.04597002657666016,1316.8932402133942,451.91546750068665,1667.424243927002,57677,6554,51123,51123,0,9,6953000.0
6953,6953999,21.625823713101745,37.907342423205414,0.04597184636989193,1317.0179557800293,451.98265290260315,1668.1431732177734,57693,6554,51139,51139,0,9,6954000.0
6954,6954999,21.625420564249968,37.90673445466093,0.0459785073084803,1317.2747778892517,452.0484616756439,1668.5182876586914,57703,6555,51148,51148,0,9,6955000.0
6955,6955999,21.625219225445157,37.90644677024449,0.04597980584769512,1317.4013435840607,452.11388421058655,1668.816005706787,57706,6555,51151,51151,0,9,6956000.0
6956,6956999,21.62515401453982,37.90624804513509,0.04598203129512679,1317.6599156856537,452.1802554130554,1669.0165405273438,57718,6556,51162,51162,0,9,6957000.0
6957,6957999,21.625383747952263,37.90656775277307,0.045993660408081394,1318.0512928962708,452.24676728248596,1669.1823272705078,57729,6558,51171,51171,0,9,6958000.0
6958,6958999,21.625529839181052,37.90666144938246,0.0459974529516779,1318.3064787387848,452.3123507499695,1669.4270248413086,57743,6559,51184,51184,0,9,6959000.0
6959,6959999,21.62579744326267,37.907244888031826,0.046004075641007613,1318.694129705429,452.378399848938,1669.5882568359375,57756,6561,51195,51195,0,9,6960000.0
6960,6960999,21.626782004518443,37.910678034239986,0.04601954548991072,1318.9559240341187,452.4437327384949,1669.8747825622559,57770,6562,51208,51208,0,9,6961000.0
6961,6961999,21.627751645491283,37.91192183671021,0.046037134583247874,1319.3565900325775,452.5096848011017,1670.0439682006836,57792,6564,51228,51228,0,9,6962000.0
6962,6962999,21.629243576424845,37.91724833846209,0.04606731799353592,1319.7500667572021,452.57504415512085,1670.1553764343262,57796,6566,51230,51230,0,9,6963000.0
6963,6963999,21.630426149051935,37.91877099089353,0.04609415024676777,1320.0199720859528,452.6456959247589,1670.442440032959,57801,6567,51234,51234,0,9,6964000.0
6964,6964999,21.63190489488719,37.92164446054598,0.046126918408988415,1320.149124622345,452.7094655036926,1670.7209968566895,57802,6567,51235,51235,0,9,6965000.0
6965,6965999,21.634092944100313,37.925687981962625,0.04617137994796405,1320.5424206256866,452.77451610565186,1670.9751205444336,57817,6569,51248,51248,0,9,6966000.0
6966,6966999,21.635670754231267,37.92779385041357,0.04621172216861702,1320.7947568893433,452.8364894390106,1671.2263679504395,57831,6570,51261,51261,0,9,6967000.0
6967,6967999,21.637736214506695,37.93120024578724,0.04625894435422717,1321.176276922226,452.8991746902466,1671.3481903076172,57844,6572,51272,51272,0,9,6968000.0
6968,6968999,21.639700286200753,37.935809633961696,0.04629863187383754,1321.2999501228333,452.9642004966736,1671.6444931030273,57847,6572,51275,51275,0,9,6969000.0
6969,6969999,21.640559580637763,37.93969333287378,0.046279961575528716,1321.5490458011627,453.0273540019989,1672.3555335998535,57873,6573,51300,51300,0,9,6970000.0
6970,6970999,21.641236214652224,37.94629836226015,0.046204901392137065,1321.6750285625458,453.0913028717041,1672.846523284912,57880,6573,51307,51307,0,9,6971000.0
6971,6971999,21.6419978377107,37.95022556092329,0.04622383150278497,1322.2057332992554,453.15697479248047,1673.1095581054688,57914,6576,51338,51338,0,9,6972000.0
6972,6972999,21.642283767399462,37.951374154755186,0.046270079181101376,1322.468598127365,453.2207760810852,1673.335350036621,57917,6577,51340,51340,0,9,6973000.0
6973,6973999,21.64315939161545,37.95482504725897,0.046235602938186515,1322.5886499881744,453.28448152542114,1673.7080345153809,57920,6577,51343,51343,0,9,6974000.0
6974,6974999,21.643726322100687,37.95690680593635,0.04627208281544015,1322.8394367694855,453.34917283058167,1674.0440711975098,57952,6578,51374,51374,0,9,6975000.0
6975,6975999,21.64420558356902,37.95850957295713,0.04627265688758353,1322.971283197403,453.4141728878021,1674.39595413208,57954,6578,51376,51376,0,9,6976000.0
6976,6976999,21.645846522284252,37.96676531396214,0.04626101798547266,1323.2364852428436,453.4783718585968,1674.6170501708984,57967,6579,51388,51388,0,9,6977000.0
6977,6977999,21.64680358012899,37.96877655667747,0.04628358822804268,1323.4955615997314,453.5431127548218,1674.8013954162598,57971,6580,51391,51391,0,9,6978000.0
6978,6978999,21.6477591091666,37.97019725544117,0.0462782005405723,1323.6156475543976,453.6058588027954,1675.0075378417969,57971,6580,51391,51391,0,9,6979000.0
6979,6979999,21.64882541224998,37.972009488700856,0.04629766082179898,1324.0120341777802,453.6699845790863,1675.1916961669922,57991,6582,51409,51409,0,9,6980000.0
6980,6980999,21.650079067855685,37.97514049845222,0.04629918063156413,1324.265702009201,453.7338569164276,1675.3782119750977,58001,6583,51418,51418,0,9,6981000.0
6981,6981999,21.65138571297261,37.97668259358615,0.04632381013963571,1324.664579153061,453.79951548576355,1675.4789695739746,58022,6585,51437,51437,0,9,6982000.0
6982,6982999,21.65340700979565,37.981167090279314,0.04637187901831907,1325.0524413585663,453.8619887828827,1675.5099029541016,58026,6587,51439,51439,0,9,6983000.0
6983,6983999,21.654898196026778,37.98418732804296,0.046392072274823226,1325.5819780826569,453.9261872768402,1675.7312660217285,58063,6590,51473,51473,0,9,6984000.0
6984,6984999,21.656428064702204,37.986624017899736,0.04645607378303929,1325.704214811325,453.98814940452576,1675.9989547729492,58065,6590,51475,51475,0,9,6985000.0
6985,6985999,21.65790472428418,37.98812335168982,0.04648292862702352,1325.825131893158,454.0509743690491,1676.2607116699219,58067,6590,51477,51477,0,9,6986000.0
6986,6986999,21.658982919521847,37.988870064321574,0.04650025130972257,1325.9385740756989,454.1140806674957,1676.4775886535645,58067,6590,51477,51477,0,9,6987000.0
6987,6987999,21.659067753746953,37.989292500528336,0.046500824029452326,1326.7115116119385,454.1790466308594,1677.0700912475586,58126,6595,51531,51531,0,9,6988000.0
6988,6988999,21.65855807976403,37.98964367731917,0.04644255917109685,1326.8337125778198,454.2416920661926,1677.517910003662,58132,6595,51537,51537,0,9,6989000.0
6989,6989999,21.658091553225717,37.98914763852078,0.0464351029954293,1327.0870809555054,454.30417346954346,1677.7256088256836,58142,6596,51546,51546,0,9,6990000.0
6990,6990999,21.65762377324732,37.98816606898289,0.04642807269448834,1327.604792356491,454.368891954422,1677.7633171081543,58177,6599,51578,51578,0,9,6991000.0
6991,6991999,21.65733035918584,37.98732479275551,0.04642314037972439,1328.1369671821594,454.4330198764801,1677.8782844543457,58207,6602,51605,51605,0,9,6992000.0
6992,6992999,21.65701076925223,37.986416531311804,0.0464252166853214,1328.2605588436127,454.49543952941895,1678.125877380371,58207,6602,51605,51605,0,9,6993000.0
6993,6993999,21.656563686873806,37.98514392189465,0.04642415849280823,1328.384114742279,454.55980491638184,1678.3548393249512,58208,6602,51606,51606,0,9,6994000.0
6994,6994999,21.656560231213938,37.98476845744413,0.046415752613510386,1328.5132341384888,454.6230962276459,1678.5922927856445,58211,6602,51609,51609,0,9,6995000.0
6995,6995999,21.65645722123443,37.98468792357846,0.04641858309696645,1328.9018468856812,454.6854817867279,1678.617317199707,58223,6604,51619,51619,0,9,6996000.0
6996,6996999,21.656495657165898,37.98428630331017,0.04642601496832732,1329.0191941261292,454.74703097343445,1679.0008392333984,58226,6604,51622,51622,0,9,6997000.0
6997,6997999,21.656656222069238,37.98415053120887,0.04642735975982071,1329.4031386375427,454.811728477478,1679.1325302124023,58246,6606,51640,51640,0,9,6998000.0
6998,6998999,21.656754909244793,37.98378977705657,0.04642892494128048,1329.7897577285767,454.87547612190247,1679.2544212341309,58268,6608,51660,51660,0,9,6999000.0
6999,6999999,21.657076017364332,37.984117528797206,0.046434597320270665,1330.1852877140045,454.93972969055176,1679.3852844238281,58286,6610,51676,51676,0,9,7000000.0
7000,7000999,21.657267429056034,37.98390520281415,0.04643591678349801,1330.3148636817932,455.0033690929413,1679.6534996032715,58288,6610,51678,51678,0,9,7001000.0
7001,7001999,21.657586024883436,37.98376263960488,0.046434177788809095,1330.8422031402588,455.06943559646606,1679.7447547912598,58305,6613,51692,51692,0,9,7002000.0
7002,7002999,21.65799674491082,37.98393982699682,0.04644277828743648,1331.1015892028809,455.132905960083,1679.9375038146973,58308,6614,51694,51694,0,9,7003000.0
7003,7003999,21.65806002924979,37.98351917051712,0.04644052279802913,1331.3528082370758,455.1977446079254,1680.2984085083008,58315,6615,51700,51700,0,9,7004000.0
7004,7004999,21.65836008342483,37.983280174561784,0.04644580111277907,1331.604411125183,455.26091480255127,1680.5386810302734,58319,6616,51703,51703,0,9,7005000.0
7005,7005999,21.658347095815035,37.98239094846714,0.04644799756116047,1331.8552944660187,455.324209690094,1680.724552154541,58321,6617,51704,51704,0,9,7006000.0
7006,7006999,21.65806615652167,37.981319951410654,0.04644374173781396,1332.2413139343262,455.38780188560486,1680.931308746338,58337,6619,51718,51718,0,9,7007000.0
7007,7007999,21.657479190495604,37.97992284742174,0.04643985164872144,1332.5008070468903,455.45279717445374,1681.6558990478516,58364,6620,51744,51744,0,9,7008000.0
7008,7008999,21.656430018961085,37.97835099900911,0.046442372621782635,1332.6236991882324,455.5161590576172,1682.187629699707,58377,6620,51757,51757,0,9,7009000.0
7009,7009999,21.655309907538218,37.97661964681986,0.04644284547947608,1333.0010151863098,455.5801591873169,1682.465129852295,58383,6622,51761,51761,0,9,7010000.0
7010,7010999,21.65450882947242,37.975495630424426,0.046439105464853414,1333.5175733566284,455.64543628692627,1682.5965194702148,58400,6625,51775,51775,0,9,7011000.0
7011,7011999,21.65381688430949,37.974600614540044,0.04643650915170994,1333.6398203372955,455.7088680267334,1682.808937072754,58400,6625,51775,51775,0,9,7012000.0
7012,7012999,21.653322334966965,37.97375745709462,0.04643111656403398,1333.7738320827484,455.7725262641907,1683.0463066101074,58402,6625,51777,51777,0,9,7013000.0
7013,7013999,21.652731420505162,37.973200566278386,0.046429548035422874,1334.1570591926575,455.836140871048,1683.1522903442383,58412,6627,51785,51785,0,9,7014000.0
7014,7014999,21.652253300960737,37.97218202375552,0.046426206888410704,1334.4077308177948,455.90064668655396,1683.4145469665527,58426,6628,51798,51798,0,9,7015000.0
7015,7015999,21.65177482168748,37.97111706483878,0.046421604885581114,1334.65820646286,455.96352791786194,1683.5812606811523,58438,6629,51809,51809,0,9,7016000.0
7016,7016999,21.651557057270576,37.97062032233286,0.04641492199526387,1334.9151062965393,456.0266819000244,1683.7782402038574,58441,6630,51811,51811,0,9,7017000.0
7017,7017999,21.651408543012543,37.96990351585953,0.04640863260186234,1335.0343930721283,456.0881452560425,1683.9680137634277,58441,6630,51811,51811,0,9,7018000.0
7018,7018999,21.651187480877635,37.96939828818035,0.04640509627620992,1335.282024860382,456.1499216556549,1684.052619934082,58443,6631,51812,51812,0,9,7019000.0
7019,7019999,21.650899622373142,37.9686975205966,0.046397190134062405,1335.536353111267,456.2124059200287,1684.1792755126953,58447,6632,51815,51815,0,9,7020000.0
7020,7020999,21.650938222298986,37.96828510508845,0.04639209817486156,1336.069727897644,456.27682995796204,1684.2436828613281,58474,6635,51839,51839,0,9,7021000.0
7021,7021999,21.651095502009653,37.96946041314289,0.04637053764716714,1336.3316705226898,456.3441605567932,1684.396499633789,58486,6636,51850,51850,0,9,7022000.0
7022,7022999,21.651007528553958,37.968704944412394,0.04636137338553492,1336.586499452591,456.40619111061096,1684.641845703125,58492,6637,51855,51855,0,9,7023000.0
7023,7023999,21.651063309371068,37.96782426907538,0.04634725455086952,1336.7257134914398,456.4762005805969,1684.9306716918945,58494,6637,51857,51857,0,9,7024000.0
7024,7024999,21.65116220444477,37.967276763465804,0.04633854530684123,1336.854261636734,456.53806614875793,1685.1464462280273,58494,6637,51857,51857,0,9,7025000.0
7025,7025999,21.651050396687403,37.96650367569565,0.04632798842249941,1337.242019891739,456.6017277240753,1685.4227752685547,58510,6639,51871,51871,0,9,7026000.0
7026,7026999,21.65104865617743,37.96570799903657,0.046321308783582094,1337.4972462654114,456.66425585746765,1685.7339363098145,58523,6640,51883,51883,0,9,7027000.0
7027,7027999,21.65101499073777,37.966306267576,0.04630933301074569,1337.6207592487335,456.7280511856079,1686.0248527526855,58527,6640,51887,51887,0,9,7028000.0
7028,7028999,21.65022947458759,37.965620430332166,0.046296486556913985,1338.134309053421,456.7929332256317,1686.9244995117188,58608,6643,51965,51965,0,9,7029000.0
7029,7029999,21.64934774718618,37.96455965691885,0.04628280235906845,1338.650072336197,456.8589029312134,1687.530345916748,58628,6646,51982,51982,0,9,7030000.0
7030,7030999,21.64865837032951,37.965208812850065,0.04627374271342377,1338.9076616764069,456.9233374595642,1687.8230514526367,58633,6647,51986,51986,0,9,7031000.0
7031,7031999,21.64780609592365,37.963663355614145,0.04626753730955724,1339.16264462471,456.9878327846527,1688.239273071289,58637,6648,51989,51989,0,9,7032000.0
7032,7032999,21.647131013369904,37.962431711039514,0.046260713609253656,1339.6893033981323,457.0515847206116,1688.3860168457031,58665,6651,52014,52014,0,9,7033000.0
7033,7033999,21.646526148497756,37.961479776354686,0.046256151818411806,1339.9371089935303,457.1142203807831,1688.6523818969727,58669,6652,52017,52017,0,9,7034000.0
7034,7034999,21.645982072039615,37.96039334763812,0.04624615683842559,1340.0564007759094,457.1772520542145,1688.9582595825195,58670,6652,52018,52018,0,9,7035000.0
7035,7035999,21.645334048668342,37.958975855614696,0.04624209893928166,1340.3202419281006,457.24264907836914,1689.290397644043,58680,6653,52027,52027,0,9,7036000.0
7036,7036999,21.644969501241928,37.95815437322549,0.04623542162986638,1340.4409883022308,457.3074414730072,1689.6302070617676,58683,6653,52030,52030,0,9,7037000.0
7037,7037999,21.644336319803507,37.95672183485933,0.04622585133061141,1340.5619847774506,457.3710868358612,1689.9410591125488,58684,6653,52031,52031,0,9,7038000.0
7038,7038999,21.643868363810277,37.95564125683746,0.0462202318936481,1340.8181495666504,457.4348084926605,1690.283561706543,58698,6654,52044,52044,0,9,7039000.0
7039,7039999,21.643628482401677,37.9547901343537,0.04621104366777529,1341.0682094097137,457.4975800514221,1690.5398254394531,58704,6655,52049,52049,0,9,7040000.0
7040,7040999,21.64323953372944,37.953608492505104,0.04620829923498182,1341.3205435276031,457.56087374687195,1690.9183082580566,58717,6656,52061,52061,0,9,7041000.0
7041,7041999,21.64310769169795,37.95423165470583,0.04619480531534903,1342.0040662288666,457.62800097465515,1691.2028770446777,58743,6660,52083,52083,0,9,7042000.0
7042,7042999,21.64302815914757,37.953572370785174,0.04619276712675768,1342.6698112487793,457.6932144165039,1691.4034843444824,58767,6664,52103,52103,0,9,7043000.0
7043,7043999,21.64310710073709,37.9531445497618,0.04619057821432637,1342.9301645755768,457.75886583328247,1691.8384246826172,58781,6665,52116,52116,0,9,7044000.0
7044,7044999,21.64304663774999,37.952152766770034,0.04618163501683359,1343.0536060333252,457.82241702079773,1692.330421447754,58787,6665,52122,52122,0,9,7045000.0
7045,7045999,21.643334174912688,37.95165506787846,0.046179344994672356,1343.572890996933,457.8868589401245,1692.6396980285645,58809,6668,52141,52141,0,9,7046000.0
7046,7046999,21.64346057093688,37.95089809222153,0.04617999830535535,1343.9561359882355,457.9501986503601,1692.9094276428223,58813,6670,52143,52143,0,9,7047000.0
7047,7047999,21.643660135874292,37.95011623217406,0.0461776607407951,1344.0776884555817,458.01491522789,1693.335277557373,58817,6670,52147,52147,0,9,7048000.0
7048,7048999,21.643482619235712,37.94952511679844,0.04615888141386337,1344.5938839912415,458.07856345176697,1693.9311790466309,58862,6673,52189,52189,0,9,7049000.0
7049,7049999,21.642850058317634,37.94941876467519,0.04614291069497145,1344.8469495773315,458.14178681373596,1694.4874954223633,58880,6674,52206,52206,0,9,7050000.0
7050,7050999,21.64202633207451,37.94843506732741,0.04614194990381704,1345.1013910770416,458.20470237731934,1694.860637664795,58890,6675,52215,52215,0,9,7051000.0
7051,7051999,21.641339281214417,37.94763210111193,0.04613949677947171,1345.3635997772217,458.2680358886719,1695.0901794433594,58899,6676,52223,52223,0,9,7052000.0
7052,7052999,21.640698442213868,37.94717778911054,0.046136703810799484,1345.7667808532715,458.3347969055176,1695.2243041992188,58916,6678,52238,52238,0,9,7053000.0
7053,7053999,21.640398231443488,37.94738711599259,0.04613624204626532,1345.8996126651764,458.3996374607086,1695.5102882385254,58917,6678,52239,52239,0,9,7054000.0
7054,7054999,21.64004069177117,37.94648926270754,0.04613013436106472,1346.158228635788,458.4638395309448,1695.6719055175781,58928,6679,52249,52249,0,9,7055000.0
7055,7055999,21.63992222594041,37.94735366865178,0.04612454243375097,1346.2874810695648,458.5284390449524,1695.8924942016602,58929,6679,52250,52250,0,9,7056000.0
7056,7056999,21.639572207214933,37.94688367692932,0.04612446423588168,1346.4190142154694,458.59138011932373,1696.141315460205,58930,6679,52251,52251,0,9,7057000.0
7057,7057999,21.639539618188653,37.94670433963609,0.0461184851405636,1346.8120765686035,458.6542122364044,1696.3094444274902,58946,6681,52265,52265,0,9,7058000.0
7058,7058999,21.63929129511856,37.946105765326955,0.04611780536446686,1347.0762095451355,458.7169740200043,1696.4098052978516,58949,6682,52267,52267,0,9,7059000.0
7059,7059999,21.63963020795096,37.94744350120634,0.04612052960347657,1347.3258156776428,458.7795753479004,1696.6603088378906,58954,6683,52271,52271,0,9,7060000.0
7060,7060999,21.639834474929394,37.94749704962302,0.046125329898770495,1347.860629081726,458.8440685272217,1696.7578201293945,58986,6686,52300,52300,0,9,7061000.0
7061,7061999,21.64024928213705,37.948693656942176,0.046131408127471185,1348.2526557445526,458.90930128097534,1696.8786849975586,58991,6688,52303,52303,0,9,7062000.0
7062,7062999,21.64083374601091,37.94960532592601,0.04613730033051677,1348.6372566223145,458.9748558998108,1697.2599029541016,59012,6690,52322,52322,0,9,7063000.0
7063,7063999,21.642037531078486,37.95206656358903,0.04615204476898971,1349.2960386276245,459.03959560394287,1697.29252243042,59046,6694,52352,52352,0,9,7064000.0
7064,7064999,21.64285702746696,37.95379232187052,0.046162296488685306,1349.4207117557526,459.1032979488373,1697.623146057129,59046,6694,52352,52352,0,9,7065000.0
7065,7065999,21.64397896064192,37.95635676452608,0.04617109349983517,1349.9484961032867,459.16861391067505,1697.7926445007324,59072,6697,52375,52375,0,9,7066000.0
7066,7066999,21.6451483039899,37.95873789754349,0.04618823541240957,1350.3511497974396,459.2325282096863,1698.063087463379,59077,6699,52378,52378,0,9,7067000.0
7067,7067999,21.646711148193127,37.9627882436819,0.04620676809820834,1350.490228652954,459.305837392807,1698.3611526489258,59080,6699,52381,52381,0,9,7068000.0
7068,7068999,21.647979605299966,37.96477381190425,0.046231950932236865,1350.6184232234955,459.36931109428406,1698.6671752929688,59080,6699,52381,52381,0,9,7069000.0
7069,7069999,21.648108956660668,37.96464452747949,0.04622115646201941,1351.143911600113,459.4327027797699,1699.299518585205,59132,6702,52430,52430,0,9,7070000.0
7070,7070999,21.647615343821638,37.964553024549076,0.04621770227927635,1351.406619310379,459.495423078537,1699.7156105041504,59138,6703,52435,52435,0,9,7071000.0
7071,7071999,21.64712070727911,37.96406761141361,0.0462176578580189,1351.6596148014069,459.559312582016,1699.9365730285645,59146,6704,52442,52442,0,9,7072000.0
7072,7072999,21.646994512154148,37.965018924957455,0.04621113692848777,1351.784392118454,459.62159991264343,1700.2310180664062,59147,6704,52443,52443,0,9,7073000.0
7073,7073999,21.647234106034066,37.966774946573274,0.04620434366537085,1352.0347020626068,459.68499517440796,1700.3445014953613,59149,6705,52444,52444,0,9,7074000.0
7074,7074999,21.646996672606733,37.96634586581068,0.04620870896327656,1352.1564469337463,459.7477514743805,1700.514274597168,59149,6705,52444,52444,0,9,7075000.0
7075,7075999,21.647923594872513,37.968648523334984,0.04620629802644838,1352.4133274555206,459.8111834526062,1700.7125053405762,59152,6706,52446,52446,0,9,7076000.0
7076,7076999,21.64867867864997,37.97051417318726,0.046209003774487556,1352.6693913936615,459.8739674091339,1700.8302307128906,59164,6707,52457,52457,0,9,7077000.0
7077,7077999,21.649185167849108,37.97115386652653,0.046214732374272316,1352.7976739406586,459.93676948547363,1700.9818305969238,59164,6707,52457,52457,0,9,7078000.0
7078,7078999,21.65013552370041,37.972553748972175,0.04621827229043696,1353.0629642009735,459.998872756958,1701.1956596374512,59173,6708,52465,52465,0,9,7079000.0
7079,7079999,21.6516841385484,37.975668337005104,0.04625100854150643,1353.458352804184,460.0633909702301,1701.3201522827148,59178,6710,52468,52468,0,9,7080000.0
7080,7080999,21.653185489140498,37.978278267000526,0.04628143034554155,1353.7138903141022,460.12660574913025,1701.437644958496,59180,6711,52469,52469,0,9,7081000.0
7081,7081999,21.65480957032583,37.98162878950763,0.04630183920376951,1353.9778697490692,460.19072794914246,1701.599895477295,59183,6712,52471,52471,0,9,7082000.0
7082,7082999,21.656458582128746,37.984319503493374,0.04633997257392719,1354.2502353191376,460.25465989112854,1701.7517356872559,59196,6713,52483,52483,0,9,7083000.0
7083,7083999,21.65851484457682,37.98814574497401,0.046388008178041784,1354.3690185546875,460.3186082839966,1702.0157356262207,59196,6713,52483,52483,0,9,7084000.0
7084,7084999,21.660839157183933,37.99195225309713,0.04645937165622971,1354.6395347118378,460.3826458454132,1702.2193145751953,59210,6714,52496,52496,0,9,7085000.0
7085,7085999,21.66287981552735,37.994681218924796,0.046519424428054346,1355.0399904251099,460.44922733306885,1702.3608512878418,59228,6716,52512,52512,0,9,7086000.0
7086,7086999,21.665574824859956,37.99942616566721,0.046574854354947126,1355.440355539322,460.51418352127075,1702.3771362304688,59241,6718,52523,52523,0,9,7087000.0
7087,7087999,21.668058313749,38.003602740184164,0.046643857658025256,1355.834587097168,460.5773570537567,1702.5912132263184,59260,6720,52540,52540,0,9,7088000.0
7088,7088999,21.670308466866008,38.007236568892466,0.04671479821279323,1355.9571418762207,460.6401467323303,1702.82767868042,59262,6720,52542,52542,0,9,7089000.0
7089,7089999,21.672055498298317,38.011808484975425,0.04674657175198493,1356.2193248271942,460.7031569480896,1703.0459365844727,59276,6721,52555,52555,0,9,7090000.0
7090,7090999,21.671508155196637,38.011717463993804,0.046740481280695745,1356.3502316474915,460.7668616771698,1703.7586708068848,59301,6721,52580,52580,0,9,7091000.0
7091,7091999,21.671375281709416,38.012722964596335,0.04673675401592836,1356.629765510559,460.8326699733734,1703.9830780029297,59305,6722,52583,52583,0,9,7092000.0
7092,7092999,21.67131422929191,38.01534385176241,0.04672591807794413,1356.7619998455048,460.896053314209,1704.22456741333,59305,6722,52583,52583,0,9,7093000.0
7093,7093999,21.67122475421946,38.01526779105164,0.046726778279010284,1357.2929406166077,460.9603033065796,1704.2150039672852,59335,6725,52610,52610,0,9,7094000.0
7094,7094999,21.67127637022813,38.015435417486344,0.04672399783188186,1357.4143817424774,461.0248246192932,1704.4779357910156,59337,6725,52612,52612,0,9,7095000.0
7095,7095999,21.671531781621024,38.015897575003436,0.04672037234396231,1357.6768851280212,461.0884008407593,1704.6937522888184,59341,6726,52615,52615,0,9,7096000.0
7096,7096999,21.67214776411734,38.017208484464206,0.04672057200878321,1357.9411962032318,461.1515939235687,1704.9973068237305,59354,6727,52627,52627,0,9,7097000.0
7097,7097999,21.672964891191608,38.01815439528565,0.04672592380159801,1358.0617108345032,461.21431970596313,1705.1930503845215,59354,6727,52627,52627,0,9,7098000.0
7098,7098999,21.67425128463572,38.02072042819787,0.04672849737516782,1358.7374830245972,461.2788064479828,1705.3046913146973,59386,6731,52655,52655,0,9,7099000.0
7099,7099999,21.676852427031918,38.02928934654258,0.04673786665114876,1358.9927082061768,461.34218430519104,1705.5707893371582,59401,6732,52669,52669,0,9,7100000.0
7100,7100999,21.679165945115447,38.03399047180649,0.04676063388077534,1359.1161713600159,461.4061896800995,1705.7917289733887,59401,6732,52669,52669,0,9,7101000.0
7101,7101999,21.681279407286347,38.03845980350485,0.04677038284341972,1359.2303023338318,461.46794867515564,1706.073787689209,59403,6732,52671,52671,0,9,7102000.0
7102,7102999,21.68423025437369,38.045497632892854,0.04680528210996304,1359.9007921218872,461.5322299003601,1706.116123199463,59443,6736,52707,52707,0,9,7103000.0
7103,7103999,21.686934433809544,38.05242429092522,0.046848860098128386,1360.7168486118317,461.5973205566406,1706.2003746032715,59486,6741,52745,52745,0,9,7104000.0
7104,7104999,21.689747957092234,38.06003379420628,0.04689283688773027,1360.844680070877,461.6609945297241,1706.5522232055664,59490,6741,52749,52749,0,9,7105000.0
7105,7105999,21.692481684728335,38.06499980541768,0.04692999988285218,1361.1192288398743,461.7244267463684,1706.740421295166,59504,6742,52762,52762,0,9,7106000.0
7106,7106999,21.695017907321585,38.06945316437533,0.04696109384216063,1361.372816324234,461.7881429195404,1706.988136291504,59515,6743,52772,52772,0,9,7107000.0
7107,7107999,21.69669254634423,38.07261080078093,0.046983915554628886,1361.7534923553467,461.8503315448761,1707.2163619995117,59531,6745,52786,52786,0,9,7108000.0
7108,7108999,21.697018201878787,38.07566465459371,0.04697019316437068,1361.8803417682648,461.91567277908325,1708.2256164550781,59564,6745,52819,52819,0,9,7109000.0
7109,7109999,21.6971275562666,38.08120967151122,0.04694840743923989,1362.0016481876373,461.97880363464355,1708.8512115478516,59574,6745,52829,52829,0,9,7110000.0
7110,7110999,21.697296820232065,38.08200329162244,0.046938816321477006,1362.1317465305328,462.04251050949097,1709.261619567871,59575,6745,52830,52830,0,9,7111000.0
7111,7111999,21.69752183916883,38.08354609242655,0.04693417939360123,1362.25270485878,462.1065480709076,1709.5700607299805,59575,6745,52830,52830,0,9,7112000.0
7112,7112999,21.69796496134519,38.084934258629154,0.046951762092146354,1362.509062051773,462.16930294036865,1709.872703552246,59608,6746,52862,52862,0,9,7113000.0
7113,7113999,21.69904188035483,38.087023762052794,0.04696657462087106,1362.7669026851654,462.23347449302673,1710.210319519043,59612,6747,52865,52865,0,9,7114000.0
7114,7114999,21.700364836959142,38.091035278685766,0.04698466031756898,1363.287160873413,462.29751110076904,1710.3902587890625,59628,6750,52878,52878,0,9,7115000.0
7115,7115999,21.702026334618232,38.095118130462595,0.04700290411545438,1363.5486516952515,462.36124563217163,1710.630527496338,59644,6751,52893,52893,0,9,7116000.0
7116,7116999,21.70416493430691,38.104075754401926,0.04703767777295398,1363.676204442978,462.42709279060364,1710.9550704956055,59646,6751,52895,52895,0,9,7117000.0
7117,7117999,21.70684555670873,38.11358430483908,0.04709252619338322,1363.9382383823395,462.4896249771118,1711.071201324463,59656,6752,52904,52904,0,9,7118000.0
7118,7118999,21.709827791285175,38.122443291586336,0.047176705709830014,1364.3361530303955,462.55378437042236,1711.1997184753418,59681,6754,52927,52927,0,9,7119000.0
7119,7119999,21.712420955646053,38.12971529642508,0.04727012969790778,1365.0252013206482,462.61821937561035,1711.2417755126953,59710,6758,52952,52952,0,9,7120000.0
7120,7120999,21.715135235420103,38.13914427957359,0.04733033172639878,1365.6964354515076,462.68511414527893,1711.3931999206543,59729,6762,52967,52967,0,9,7121000.0
7121,7121999,21.71867301735096,38.148754509727354,0.047478059463264,1365.9527418613434,462.7474846839905,1711.7424926757812,59742,6763,52979,52979,0,9,7122000.0
7122,7122999,21.723030225529026,38.16259454418426,0.0476014909985073,1366.3606872558594,462.8119397163391,1711.898838043213,59764,6765,52999,52999,0,9,7123000.0
7123,7123999,21.726600775863083,38.17272484836751,0.04771490524366073,1366.6224789619446,462.8748722076416,1712.3003273010254,59780,6766,53014,53014,0,9,7124000.0
7124,7124999,21.730876560725303,38.18345792720626,0.04781203387309019,1366.7352941036224,462.9371485710144,1712.6136093139648,59781,6766,53015,53015,0,9,7125000.0
7125,7125999,21.7344373810428,38.19310569459231,0.04792014132137046,1366.9927303791046,463.0000581741333,1712.8817710876465,59786,6767,53019,53019,0,9,7126000.0
7126,7126999,21.73793950812552,38.20134136713094,0.04800960361630513,1367.2500872612,463.06346893310547,1713.1548767089844,59798,6768,53030,53030,0,9,7127000.0
7127,7127999,21.739268906069363,38.20472867187389,0.048004421521414264,1367.6390516757965,463.12928533554077,1713.9331550598145,59837,6770,53067,53067,0,9,7128000.0
7128,7128999,21.739390582129303,38.20594159587455,0.04799294627240758,1367.9007918834686,463.19397592544556,1714.4055786132812,59848,6771,53077,53077,0,9,7129000.0
7129,7129999,21.739641952265558,38.208214871665454,0.047992206178498864,1368.0297548770905,463.2590413093567,1714.6828346252441,59851,6771,53080,53080,0,9,7130000.0
7130,7130999,21.739630997410867,38.208694015579205,0.047988849181089366,1368.293690919876,463.3224070072174,1714.8215560913086,59863,6772,53091,53091,0,9,7131000.0
7131,7131999,21.73974560929527,38.209183562730495,0.047985040427988124,1368.564810037613,463.38750290870667,1715.1034965515137,59872,6773,53099,53099,0,9,7132000.0
7132,7132999,21.739834812149002,38.20957184229244,0.047981684739392017,1368.69664144516,463.4504191875458,1715.3477096557617,59876,6773,53103,53103,0,9,7133000.0
7133,7133999,21.739690518251802,38.20973699094017,0.04798107532529272,1369.0971715450287,463.515154838562,1715.503475189209,59904,6775,53129,53129,0,9,7134000.0
7134,7134999,21.73972275640995,38.21041985411727,0.047983209749752787,1369.4899671077728,463.57789373397827,1715.6702766418457,59918,6777,53141,53141,0,9,7135000.0
7135,7135999,21.7397991018486,38.21031268900466,0.04798319474678958,1369.7570354938507,463.6413400173187,1715.8556022644043,59921,6778,53143,53143,0,9,7136000.0
7136,7136999,21.739927267427642,38.21045839998091,0.04797707317416677,1370.1646873950958,463.7056260108948,1715.982120513916,59942,6780,53162,53162,0,9,7137000.0
7137,7137999,21.739967702538905,38.21030225729954,0.04797430457023999,1370.6843495368958,463.7679932117462,1715.999423980713,59953,6783,53170,53170,0,9,7138000.0
7138,7138999,21.74011073408065,38.209965626733826,0.04796983072112204,1370.951242685318,463.8306214809418,1716.1168594360352,59955,6784,53171,53171,0,9,7139000.0
7139,7139999,21.740248390073237,38.20941021273328,0.047966605144396546,1371.0813932418823,463.8937096595764,1716.3867263793945,59958,6784,53174,53174,0,9,7140000.0
7140,7140999,21.740720976501507,38.20942895013281,0.04796253072698675,1371.4768674373627,463.9577431678772,1716.5756149291992,59978,6786,53192,53192,0,9,7141000.0
7141,7141999,21.74103290909265,38.20994209427315,0.047954197688393596,1371.6069061756134,464.02203345298767,1716.8671684265137,59980,6786,53194,53194,0,9,7142000.0
7142,7142999,21.74118970601165,38.209117941431074,0.047951190718433345,1371.8814721107483,464.0876395702362,1717.0157737731934,59984,6787,53197,53197,0,9,7143000.0
7143,7143999,21.741157451820392,38.207963039902,0.04794475894535144,1372.1405925750732,464.1510851383209,1717.2842292785645,59995,6788,53207,53207,0,9,7144000.0
7144,7144999,21.740632989665283,38.20669119746401,0.04794165748068435,1372.2737355232239,464.2156810760498,1718.451515197754,60039,6788,53251,53251,0,9,7145000.0
7145,7145999,21.74021132219884,38.2063394912135,0.0479399447282749,1372.3966617584229,464.2795112133026,1718.9913902282715,60046,6788,53258,53258,0,9,7146000.0
7146,7146999,21.739937566318584,38.20634834382369,0.04794527529421899,1372.6617176532745,464.3427526950836,1719.4052429199219,60057,6789,53268,53268,0,9,7147000.0
7147,7147999,21.739200672167627,38.20469315620248,0.04795481489725417,1372.7791497707367,464.406503200531,1719.7190322875977,60059,6789,53270,53270,0,9,7148000.0
7148,7148999,21.73903594404189,38.20515773717188,0.047958212163648706,1372.9112386703491,464.4702513217926,1720.0987930297852,60062,6789,53273,53273,0,9,7149000.0
7149,7149999,21.73911483926114,38.20536066717259,0.04797018299025024,1373.0340280532837,464.53256940841675,1720.4941787719727,60064,6789,53275,53275,0,9,7150000.0
7150,7150999,21.739100752379954,38.20520062801222,0.04797003555406476,1373.4399156570435,464.59698009490967,1720.7551574707031,60088,6791,53297,53297,0,9,7151000.0
7151,7151999,21.73911004534757,38.20543775510801,0.04797498685709689,1373.5643146038055,464.66140723228455,1721.1485481262207,60090,6791,53299,53299,0,9,7152000.0
7152,7152999,21.739265802668726,38.20549239159822,0.04798223014752068,1374.108981847763,464.72692584991455,1721.3217468261719,60110,6794,53316,53316,0,9,7153000.0
7153,7153999,21.740061442812348,38.20867921039222,0.04798072194409542,1374.3629863262177,464.78937125205994,1721.620174407959,60125,6795,53330,53330,0,9,7154000.0
7154,7154999,21.740678233557734,38.20965267367899,0.04799148016609378,1374.6275870800018,464.8528006076813,1721.9800987243652,60141,6796,53345,53345,0,9,7155000.0
7155,7155999,21.7411847602826,38.210099981667874,0.04799329710766953,1374.8834028244019,464.915274143219,1722.2102813720703,60143,6797,53346,53346,0,9,7156000.0
7156,7156999,21.741719176618183,38.21024768783173,0.048000812348935384,1375.4000601768494,464.9783658981323,1722.4544143676758,60161,6800,53361,53361,0,9,7157000.0
7157,7157999,21.742389694126054,38.21055908886188,0.04799449444862991,1375.5208983421326,465.04230856895447,1723.0193901062012,60167,6800,53367,53367,0,9,7158000.0
7158,7158999,21.74347367123073,38.21352106385254,0.04800327487841416,1375.780924797058,465.1054253578186,1723.2396621704102,60170,6801,53369,53369,0,9,7159000.0
7159,7159999,21.74394828521499,38.21310489800405,0.048015662075337695,1376.0498855113983,465.1699433326721,1723.4812049865723,60176,6802,53374,53374,0,9,7160000.0
7160,7160999,21.74410042691137,38.212626669301045,0.04802996703436713,1376.4487628936768,465.23227310180664,1723.7995223999023,60207,6804,53403,53403,0,9,7161000.0
7161,7161999,21.744970345778,38.22226332927291,0.048008902474218074,1376.840749502182,465.2978308200836,1724.6022262573242,60241,6806,53435,53435,0,9,7162000.0
7162,7162999,21.74490693411444,38.22634015553094,0.04799043951204052,1376.9618632793427,465.3606321811676,1725.0447273254395,60246,6806,53440,53440,0,9,7163000.0
7163,7163999,21.744694913172918,38.226395271680566,0.04797108555665175,1377.0851545333862,465.4256227016449,1725.4028129577637,60251,6806,53445,53445,0,9,7164000.0
7164,7164999,21.744768163419753,38.22746816749882,0.04796594791147035,1377.3458235263824,465.48941373825073,1725.6252212524414,60254,6807,53447,53447,0,9,7165000.0
7165,7165999,21.745096902523752,38.22819457151338,0.047964751711803366,1377.6130499839783,465.55453515052795,1725.8848304748535,60258,6808,53450,53450,0,9,7166000.0
7166,7166999,21.745295980705592,38.228511687587336,0.04795961956014139,1377.7354323863983,465.6180958747864,1726.1372108459473,60258,6808,53450,53450,0,9,7167000.0
7167,7167999,21.745544812919416,38.22887753229193,0.04796834412330475,1377.9896972179413,465.6816232204437,1726.3942260742188,60264,6809,53455,53455,0,9,7168000.0
7168,7168999,21.74591553796667,38.229189089367075,0.047968184201866104,1378.113659620285,465.74610686302185,1726.7935752868652,60266,6809,53457,53457,0,9,7169000.0
7169,7169999,21.746421218266978,38.229507655670446,0.047971421357766,1378.5048036575317,465.80972838401794,1726.9381256103516,60272,6811,53461,53461,0,9,7170000.0
7170,7170999,21.74739043386796,38.23279460240769,0.04797701836029267,1378.6328444480896,465.874703168869,1727.2456359863281,60273,6811,53462,53462,0,9,7171000.0
7171,7171999,21.748421109460487,38.2344203088812,0.04796796289603156,1379.0333259105682,465.9385485649109,1727.4841079711914,60289,6813,53476,53476,0,9,7172000.0
7172,7172999,21.749229753746242,38.23492131256531,0.04797644424766678,1379.1563749313354,466.00213718414307,1727.741771697998,60290,6813,53477,53477,0,9,7173000.0
7173,7173999,21.75031887685475,38.236248097640214,0.04798159180315309,1379.4155793190002,466.0661563873291,1727.8821754455566,60293,6814,53479,53479,0,9,7174000.0
7174,7174999,21.751423289054312,38.23930088369998,0.04797979557822529,1380.07453250885,466.1280496120453,1727.8931198120117,60313,6818,53495,53495,0,9,7175000.0
7175,7175999,21.75261066026155,38.24059401702897,0.04799996436787368,1380.4656252861023,466.1899356842041,1728.1781768798828,60335,6820,53515,53515,0,9,7176000.0
7176,7176999,21.753496746915644,38.241119412063114,0.048000909219368726,1380.7245435714722,466.2523789405823,1728.3596267700195,60338,6821,53517,53517,0,9,7177000.0
7177,7177999,21.75450783942184,38.24228041041709,0.04800163570287974,1380.9824330806732,466.3167862892151,1728.4976692199707,60340,6822,53518,53518,0,9,7178000.0
7178,7178999,21.755540197579048,38.24303140002552,0.04801119481026683,1381.110533952713,466.37957525253296,1728.8729553222656,60344,6822,53522,53522,0,9,7179000.0
7179,7179999,21.75628562355148,38.24310590030081,0.04801608312919392,1381.3632073402405,466.44296312332153,1729.1284561157227,60349,6823,53526,53526,0,9,7180000.0
7180,7180999,21.757213299268884,38.24430195237764,0.04804026938698436,1381.8890788555145,466.5063724517822,1729.274700164795,60382,6826,53556,53556,0,9,7181000.0
7181,7181999,21.75720199017846,38.244831432325675,0.048036824158140035,1382.016149520874,466.5703353881836,1730.056022644043,60402,6826,53576,53576,0,9,7182000.0
7182,7182999,21.75660736017359,38.244550083524906,0.048029062039076975,1382.1425142288208,466.6339008808136,1730.4022102355957,60404,6826,53578,53578,0,9,7183000.0
7183,7183999,21.756182736151793,38.244512073187565,0.04802073022463782,1382.2666940689087,466.69781160354614,1730.637294769287,60405,6826,53579,53579,0,9,7184000.0
7184,7184999,21.755984298179747,38.243951563780186,0.04801881333891622,1382.5293476581573,466.7623519897461,1730.8157577514648,60408,6827,53581,53581,0,9,7185000.0
7185,7185999,21.755845377153562,38.24333542468913,0.04801286756196499,1382.7824857234955,466.8250308036804,1731.103099822998,60413,6828,53585,53585,0,9,7186000.0
7186,7186999,21.75566504208498,38.2434931999154,0.04801121510927864,1383.0375909805298,466.8872489929199,1731.2642784118652,60416,6829,53587,53587,0,9,7187000.0
7187,7187999,21.756100854919513,38.24381544689834,0.04800960202701676,1383.3032295703888,466.95094084739685,1731.4229927062988,60419,6830,53589,53589,0,9,7188000.0
7188,7188999,21.756531961766008,38.244399479084294,0.04801287729648407,1383.4349143505096,467.0151135921478,1731.7603187561035,60421,6830,53591,53591,0,9,7189000.0
7189,7189999,21.757091229283663,38.24504989224596,0.04801023212705524,1383.982745885849,467.0798497200012,1731.771411895752,60453,6833,53620,53620,0,9,7190000.0
7190,7190999,21.757889369652993,38.246227926181014,0.04802144455926083,1384.2440481185913,467.14256262779236,1731.924648284912,60465,6834,53631,53631,0,9,7191000.0
7191,7191999,21.758947292836258,38.24781471157652,0.04803841946767651,1384.3745067119598,467.2069945335388,1732.1229782104492,60465,6834,53631,53631,0,9,7192000.0
7192,7192999,21.760334292839683,38.250517985866715,0.04804493714816027,1384.63929271698,467.26937675476074,1732.2327995300293,60472,6835,53637,53637,0,9,7193000.0
7193,7193999,21.76179348191919,38.25425660684195,0.048070102851687446,1384.9016377925873,467.3328061103821,1732.344253540039,60482,6836,53646,53646,0,9,7194000.0
7194,7194999,21.763177898296245,38.25612470250017,0.04809535011936761,1385.444394826889,467.3972897529602,1732.3054275512695,60504,6839,53665,53665,0,9,7195000.0
7195,7195999,21.764847816666784,38.259024805447034,0.048126480775648406,1385.7081837654114,467.46138286590576,1732.4344100952148,60506,6840,53666,53666,0,9,7196000.0
7196,7196999,21.766607234185756,38.26173955097031,0.048161072907382474,1385.9901399612427,467.525404214859,1732.5671005249023,60509,6841,53668,53668,0,9,7197000.0
7197,7197999,21.76837998047951,38.26438101026401,0.048193074746634146,1386.260179758072,467.5887939929962,1732.7060203552246,60512,6842,53670,53670,0,9,7198000.0
7198,7198999,21.769983744866018,38.26662759814256,0.048248305709013284,1386.3851821422577,467.6519498825073,1732.918601989746,60513,6842,53671,53671,0,9,7199000.0
7199,7199999,21.771837913598397,38.270099768336806,0.04831513065934512,1386.8100321292877,467.7175462245941,1733.0453453063965,60519,6844,53675,53675,0,9,7200000.0
7200,7200999,21.773731891068245,38.27267587769436,0.04838604573812577,1387.070532798767,467.78047347068787,1733.23246383667,60531,6845,53686,53686,0,9,7201000.0
7201,7201999,21.774737591465158,38.27494264690537,0.048423188160587216,1387.4775733947754,467.8499517440796,1733.601318359375,60564,6847,53717,53717,0,9,7202000.0
7202,7202999,21.774589654926736,38.27503364116294,0.048413616447769536,1387.7351613044739,467.91488218307495,1734.1831016540527,60578,6848,53730,53730,0,9,7203000.0
7203,7203999,21.77402659247292,38.27399007926838,0.04841613333817296,1387.8558070659637,467.97941851615906,1734.5865364074707,60581,6848,53733,53733,0,9,7204000.0
7204,7204999,21.773803277835604,38.27375551284515,0.04841421071230223,1387.9777133464813,468.0426778793335,1734.9008865356445,60585,6848,53737,53737,0,9,7205000.0
7205,7205999,21.774146134222086,38.27460583460732,0.04841880620158823,1388.5286462306976,468.1066508293152,1735.029525756836,60611,6851,53760,53760,0,9,7206000.0
7206,7206999,21.77489361184396,38.27631967910202,0.04842313204167625,1388.7840023040771,468.1698546409607,1735.2461585998535,60622,6852,53770,53770,0,9,7207000.0
7207,7207999,21.776330557115003,38.279021076656555,0.04842892650246777,1389.0485072135925,468.23330187797546,1735.5002822875977,60635,6853,53782,53782,0,9,7208000.0
7208,7208999,21.77856552885447,38.28384799752252,0.04842994979644033,1389.175138950348,468.29638266563416,1735.751838684082,60636,6853,53783,53783,0,9,7209000.0
7209,7209999,21.780395216427266,38.287542822986815,0.048446724174942335,1389.4332313537598,468.36023473739624,1735.951816558838,60648,6854,53794,53794,0,9,7210000.0
7210,7210999,21.78289803986554,38.29237410540001,0.04847818688483707,1389.8294122219086,468.42379546165466,1736.180377960205,60672,6856,53816,53816,0,9,7211000.0
7211,7211999,21.785271199327802,38.296710643462085,0.048525090924213976,1390.1189799308777,468.4886705875397,1736.3973960876465,60686,6857,53829,53829,0,9,7212000.0
7212,7212999,21.78778424294169,38.30144844369754,0.04855956781693538,1390.6835963726044,468.56159377098083,1736.4070320129395,60718,6860,53858,53858,0,9,7213000.0
7213,7213999,21.78993955114216,38.304758322329455,0.048605875658423336,1391.094148159027,468.6274383068085,1736.5190124511719,60743,6862,53881,53881,0,9,7214000.0
7214,7214999,21.79252148591904,38.30934227993448,0.04864603584344929,1391.6426496505737,468.6906535625458,1736.6898880004883,60772,6865,53907,53907,0,9,7215000.0
7215,7215999,21.795312252053844,38.31794400855496,0.04869615368104241,1392.182267665863,468.7546830177307,1736.8101615905762,60801,6868,53933,53933,0,9,7216000.0
7216,7216999,21.797653982457764,38.32152487101059,0.04874120564234308,1392.5742387771606,468.81708693504333,1736.9102897644043,60820,6870,53950,53950,0,9,7217000.0
7217,7217999,21.800496303065167,38.32712420440903,0.048785932821603484,1393.2498795986176,468.88329911231995,1736.9897537231445,60861,6874,53987,53987,0,9,7218000.0
7218,7218999,21.802877223918937,38.33039871255426,0.04883969358067486,1393.9506595134735,468.9537570476532,1737.0099296569824,60897,6878,54019,54019,0,9,7219000.0
7219,7219999,21.80560045306229,38.33481167159844,0.0488898754374435,1394.6191465854645,469.0173785686493,1737.0022315979004,60940,6882,54058,54058,0,9,7220000.0
7220,7220999,21.80766460881865,38.33749471633842,0.04892442654777418,1394.8841300010681,469.0828330516815,1737.1508560180664,60951,6883,54068,54068,0,9,7221000.0
7221,7221999,21.80767060018601,38.33726829634097,0.04892259598849935,1395.296347618103,469.1482710838318,1737.986011505127,60999,6885,54114,54114,0,9,7222000.0
7222,7222999,21.80704695409898,38.33659999390404,0.04891355165985656,1395.6919658184052,469.2130637168884,1738.3834381103516,61010,6887,54123,54123,0,9,7223000.0
7223,7223999,21.806395629363188,38.335649393098436,0.048908515095373084,1395.9519429206848,469.2770366668701,1738.709186553955,61014,6888,54126,54126,0,9,7224000.0
7224,7224999,21.806034166818677,38.33490247441012,0.048900811618224904,1396.0834765434265,469.34082674980164,1738.949634552002,61015,6888,54127,54127,0,9,7225000.0
7225,7225999,21.805640714064364,38.334060161010804,0.04889546402357614,1396.4862496852875,469.40584683418274,1739.1095275878906,61028,6890,54138,54138,0,9,7226000.0
7226,7226999,21.805568526078325,38.33385540435037,0.048884144146061015,1396.6163330078125,469.4696168899536,1739.4786987304688,61030,6890,54140,54140,0,9,7227000.0
7227,7227999,21.80542050503387,38.333347853742026,0.048875092392987596,1396.8768124580383,469.5322198867798,1739.7075653076172,61041,6891,54150,54150,0,9,7228000.0
7228,7228999,21.805306718004214,38.33283630465069,0.04887266951223623,1397.1396441459656,469.5953896045685,1739.8777885437012,61045,6892,54153,54153,0,9,7229000.0
7229,7229999,21.80549177614503,38.33345589210172,0.04886363516185477,1397.6732048988342,469.6600878238678,1740.1058044433594,61061,6895,54166,54166,0,9,7230000.0
7230,7230999,21.805611115724428,38.33297874158237,0.048858283184506024,1397.8018925189972,469.72385907173157,1740.4367942810059,61063,6895,54168,54168,0,9,7231000.0
7231,7231999,21.805741408798912,38.33285465333346,0.04885746220600551,1398.0651106834412,469.7877404689789,1740.6083221435547,61074,6896,54178,54178,0,9,7232000.0
7232,7232999,21.805857644000813,38.33243959393543,0.04885554756779409,1398.5938017368317,469.8495795726776,1740.765537261963,61108,6899,54209,54209,0,9,7233000.0
7233,7233999,21.806023834779694,38.33210143935891,0.04884834400041205,1398.7151417732239,469.91277956962585,1741.0888938903809,61111,6899,54212,54212,0,9,7234000.0
7234,7234999,21.80642016477298,38.33222698916694,0.04884216786850515,1399.114713191986,469.97651171684265,1741.3076362609863,61132,6901,54231,54231,0,9,7235000.0
7235,7235999,21.80657555402914,38.33164630163826,0.04883202447329971,1399.5250651836395,470.0424678325653,1741.6624946594238,61159,6903,54256,54256,0,9,7236000.0
7236,7236999,21.807126939691138,38.331747194268196,0.048828340847268725,1399.9204885959625,470.10671281814575,1741.8017883300781,61163,6905,54258,54258,0,9,7237000.0
7237,7237999,21.8072660689022,38.33110550731573,0.048825630843061574,1400.1839425563812,470.17088866233826,1742.0234489440918,61173,6906,54267,54267,0,9,7238000.0
7238,7238999,21.80732647067952,38.33036407013546,0.04882129400636226,1400.3023943901062,470.2335569858551,1742.4228210449219,61176,6906,54270,54270,0,9,7239000.0
7239,7239999,21.806759954602285,38.32930715186603,0.04881687222650277,1400.561244726181,470.2969923019409,1743.0605583190918,61200,6907,54293,54293,0,9,7240000.0
7240,7240999,21.80620524689435,38.32921959424992,0.04880997985953184,1400.6882755756378,470.3597161769867,1743.5403747558594,61209,6907,54302,54302,0,9,7241000.0
7241,7241999,21.805432667462682,38.328468226356264,0.048806775417658876,1400.9591908454895,470.4250726699829,1743.8625602722168,61214,6908,54306,54306,0,9,7242000.0
7242,7242999,21.804886774774292,38.328038812864214,0.04880230905178451,1401.2266683578491,470.4887948036194,1744.062068939209,61225,6909,54316,54316,0,9,7243000.0
7243,7243999,21.80436900441856,38.327711378506955,0.0487979751572819,1401.490787744522,470.5527331829071,1744.2390899658203,61236,6910,54326,54326,0,9,7244000.0
7244,7244999,21.803951604765732,38.327038986110104,0.048793343717911886,1401.623435497284,470.61827969551086,1744.5074577331543,61238,6910,54328,54328,0,9,7245000.0
7245,7245999,21.803607414716232,38.32635990629293,0.04878717976014735,1401.747478723526,470.6809003353119,1744.728141784668,61238,6910,54328,54328,0,9,7246000.0
7246,7246999,21.803511737031666,38.3260850250664,0.0487819768328297,1402.0123431682587,470.74387431144714,1744.8224754333496,61249,6911,54338,54338,0,9,7247000.0
7247,7247999,21.803352034302577,38.32546232368244,0.04877824441081613,1402.1463043689728,470.8079388141632,1745.0116729736328,61249,6911,54338,54338,0,9,7248000.0
7248,7248999,21.80360422225382,38.32575320712605,0.04877418524688182,1402.427426815033,470.8728301525116,1745.14750289917,61260,6912,54348,54348,0,9,7249000.0
7249,7249999,21.803850936861213,38.32613477901122,0.04876971402241659,1402.851951122284,470.940593957901,1745.2260780334473,61269,6914,54355,54355,0,9,7250000.0
7250,7250999,21.80429929049434,38.32788752645207,0.048758135652968715,1403.1260750293732,471.0045208930969,1745.4597244262695,61281,6915,54366,54366,0,9,7251000.0
7251,7251999,21.804483179507262,38.327704683081336,0.04875731122098925,1403.6663842201233,471.0688934326172,1745.5400848388672,61315,6918,54397,54397,0,9,7252000.0
7252,7252999,21.804955903414108,38.327776665694564,0.04876071079369926,1403.9331393241882,471.1314949989319,1745.7617797851562,61319,6919,54400,54400,0,9,7253000.0
7253,7253999,21.80537089624458,38.32751231539712,0.04876284291473587,1404.341784954071,471.1952621936798,1745.891429901123,61341,6921,54420,54420,0,9,7254000.0
7254,7254999,21.80604725256187,38.327952240707106,0.0487645073652333,1404.7403264045715,471.2591428756714,1746.069667816162,61366,6923,54443,54443,0,9,7255000.0
7255,7255999,21.806582863003825,38.32795920163189,0.04876881801643218,1405.412044763565,471.32388067245483,1746.2730865478516,61388,6927,54461,54461,0,9,7256000.0
7256,7256999,21.807313062146058,38.32871475096677,0.04876867350802083,1405.6712992191315,471.38645124435425,1746.6059684753418,61399,6928,54471,54471,0,9,7257000.0
7257,7257999,21.807733303891425,38.32935391414684,0.04878314165444875,1405.9348063468933,471.44982838630676,1746.8011436462402,61410,6929,54481,54481,0,9,7258000.0
7258,7258999,21.80782167582126,38.33031240474033,0.0487713044621535,1406.352260351181,471.5146746635437,1747.2177276611328,61426,6931,54495,54495,0,9,7259000.0
7259,7259999,21.80784001043479,38.33166594774692,0.04876638113181708,1406.6152877807617,471.57800459861755,1747.5618858337402,61433,6932,54501,54501,0,9,7260000.0
7260,7260999,21.80754525247802,38.3323715487054,0.048765480727398836,1406.7481503486633,471.6415629386902,1747.869743347168,61437,6932,54505,54505,0,9,7261000.0
7261,7261999,21.80720017346278,38.33162393843129,0.048756622941134475,1407.298483133316,471.7060239315033,1747.8931884765625,61453,6935,54518,54518,0,9,7262000.0
7262,7262999,21.807100979185673,38.33155422458045,0.04874698296148594,1407.5793919563293,471.7696764469147,1748.1079597473145,61457,6936,54521,54521,0,9,7263000.0
7263,7263999,21.806908245636652,38.33100045062789,0.048741620294486365,1407.834644317627,471.8302278518677,1748.3285179138184,61466,6937,54529,54529,0,9,7264000.0
7264,7264999,21.806835929884844,38.33069032853746,0.04874063283489227,1407.9725947380066,471.8941214084625,1748.5955848693848,61468,6937,54531,54531,0,9,7265000.0
7265,7265999,21.806644208540348,38.33067012842854,0.04873169887184636,1408.0967700481415,471.9570345878601,1748.8004913330078,61469,6937,54532,54532,0,9,7266000.0
7266,7266999,21.806887705484286,38.33272293042656,0.048730070955170235,1408.2197694778442,472.01848912239075,1748.9922523498535,61470,6937,54533,54533,0,9,7267000.0
7267,7267999,21.80705587134053,38.332718500896625,0.04872799510436299,1408.3493130207062,472.08108854293823,1749.22505569458,61473,6937,54536,54536,0,9,7268000.0
7268,7268999,21.80736679509218,38.33322588758114,0.048724876620867885,1408.6135416030884,472.1429421901703,1749.3422508239746,61475,6938,54537,54537,0,9,7269000.0
7269,7269999,21.80780646257559,38.33344059951377,0.0487254325051637,1408.7441096305847,472.2046580314636,1749.5031623840332,61475,6938,54537,54537,0,9,7270000.0
7270,7270999,21.8083408501306,38.333812877971944,0.04872762176318024,1409.0014019012451,472.26712346076965,1749.7116432189941,61489,6939,54550,54550,0,9,7271000.0
7271,7271999,21.808835582862155,38.33396955710449,0.048733366993180205,1409.4231753349304,472.32990431785583,1749.8415603637695,61498,6941,54557,54557,0,9,7272000.0
7272,7272999,21.80968877151207,38.33517835558528,0.04874039789106288,1409.6938910484314,472.3929934501648,1750.0479774475098,61513,6942,54571,54571,0,9,7273000.0
7273,7273999,21.810791655645023,38.336890412578036,0.04874687413493073,1409.824856042862,472.4566442966461,1750.305923461914,61515,6942,54573,54573,0,9,7274000.0
7274,7274999,21.811716013895975,38.337830880831554,0.04875411781000227,1409.959270954132,472.52169942855835,1750.6066055297852,61518,6942,54576,54576,0,9,7275000.0
7275,7275999,21.811621931464277,38.337360699606755,0.04874993129675331,1410.2243320941925,472.5876522064209,1752.4645881652832,61569,6943,54626,54626,0,9,7276000.0
7276,7276999,21.81162105904673,38.338615410786424,0.04875185898958123,1410.492145061493,472.6523220539093,1753.9813117980957,61591,6944,54647,54647,0,9,7277000.0
7277,7277999,21.811410481046202,38.33840423715027,0.04875026284810424,1410.9291589260101,472.72610569000244,1755.3155822753906,61613,6946,54667,54667,0,9,7278000.0
7278,7278999,21.811310560156933,38.33811009091301,0.048750471530579875,1411.3425533771515,472.7907044887543,1756.5521812438965,61628,6948,54680,54680,0,9,7279000.0
7279,7279999,21.8114150916304,38.338156385355376,0.04874706894045,1411.7603673934937,472.85670232772827,1757.6656188964844,61658,6950,54708,54708,0,9,7280000.0
7280,7280999,21.81136266194597,38.338091222820296,0.048752338255005356,1412.165519952774,472.9222228527069,1758.6635284423828,61684,6952,54732,54732,0,9,7281000.0
7281,7281999,21.811287062686585,38.33801513354368,0.04875053764936266,1412.4374294281006,472.9864568710327,1759.5387725830078,61691,6953,54738,54738,0,9,7282000.0
7282,7282999,21.811409526334018,38.33805707745869,0.04875239535167475,1412.5629308223724,473.0501289367676,1760.5778770446777,61696,6953,54743,54743,0,9,7283000.0
7283,7283999,21.811811741544258,38.339054674554305,0.04876143010243672,1412.8359565734863,473.11574029922485,1761.4438247680664,61707,6954,54753,54753,0,9,7284000.0
7284,7284999,21.812408792319662,38.34009708066683,0.048770379116751195,1413.2305779457092,473.178879737854,1762.2990646362305,61728,6956,54772,54772,0,9,7285000.0
7285,7285999,21.812942378067792,38.340858554633684,0.04877109450300998,1413.363941669464,473.2432608604431,1763.1409072875977,61732,6956,54776,54776,0,9,7286000.0
7286,7286999,21.813908698015936,38.34215776366003,0.048779301871319514,1413.6230580806732,473.307377576828,1763.857192993164,61745,6957,54788,54788,0,9,7287000.0
7287,7287999,21.814934783135232,38.343264642025865,0.04880175143365095,1414.034194946289,473.37222051620483,1764.4440841674805,61758,6959,54799,54799,0,9,7288000.0
7288,7288999,21.816313212106316,38.34537185307752,0.04881037061133353,1414.3051888942719,473.435435295105,1765.1785888671875,61773,6960,54813,54813,0,9,7289000.0
7289,7289999,21.817805412300352,38.34869463737094,0.0488352143058155,1414.7127237319946,473.49963212013245,1765.895076751709,61793,6962,54831,54831,0,9,7290000.0
7290,7290999,21.81884687578924,38.349519148035945,0.04885532386566216,1414.8330640792847,473.56317687034607,1766.4868659973145,61794,6962,54832,54832,0,9,7291000.0
7291,7291999,21.82023785490803,38.35148347491387,0.048881051511242224,1415.1033573150635,473.62751722335815,1767.16109085083,61800,6963,54837,54837,0,9,7292000.0
7292,7292999,21.821621022980658,38.35302091000383,0.04889569017067563,1415.359615802765,473.690691947937,1767.8993339538574,61813,6964,54849,54849,0,9,7293000.0
7293,7293999,21.821832698974504,38.35279815226953,0.04890533990294199,1415.4994707107544,473.7565379142761,1769.0280380249023,61835,6964,54871,54871,0,9,7294000.0
7294,7294999,21.821428014865155,38.352774303361336,0.04888241560240847,1415.9070394039154,473.8214147090912,1770.2477722167969,61895,6966,54929,54929,0,9,7295000.0
7295,7295999,21.82103077760118,38.35260576989916,0.048877303722518195,1416.1654953956604,473.88566970825195,1771.0960693359375,61910,6967,54943,54943,0,9,7296000.0
7296,7296999,21.820629204978488,38.35218075851622,0.04887559114528928,1416.4308114051819,473.950008392334,1771.8258018493652,61922,6968,54954,54954,0,9,7297000.0
7297,7297999,21.820384441129754,38.35137265501624,0.048866770385719516,1416.8376758098602,474.01412773132324,1772.346435546875,61944,6970,54974,54974,0,9,7298000.0
7298,7298999,21.820400753326716,38.35165912290545,0.04886496850957922,1417.234169960022,474.0756187438965,1772.9778327941895,61962,6972,54990,54990,0,9,7299000.0
7299,7299999,21.82024246026807,38.351048831883816,0.048865305061671416,1417.6274886131287,474.1402883529663,1773.6344032287598,61998,6974,55024,55024,0,9,7300000.0
7300,7300999,21.8201811925972,38.35041240730852,0.04886426962592971,1417.7430317401886,474.2039771080017,1774.1713104248047,61999,6974,55025,55025,0,9,7301000.0
7301,7301999,21.82040537864343,38.350275587470435,0.04885848458136388,1418.4209914207458,474.2685315608978,1774.5131301879883,62034,6978,55056,55056,0,9,7302000.0
7302,7302999,21.8208195752959,38.35080250134896,0.048859262272769155,1418.824030160904,474.3319299221039,1775.034740447998,62056,6980,55076,55076,0,9,7303000.0
7303,7303999,21.821336833303125,38.35142883113251,0.04885617785833374,1419.3650765419006,474.3949694633484,1775.3231735229492,62081,6983,55098,55098,0,9,7304000.0
7304,7304999,21.82188523179603,38.351494594017694,0.04885796180681168,1419.6326653957367,474.45974707603455,1775.8822441101074,62090,6984,55106,55106,0,9,7305000.0
7305,7305999,21.822502477371668,38.35212265667056,0.04886159105481658,1420.3194012641907,474.52367877960205,1776.1422309875488,62119,6988,55131,55131,0,9,7306000.0
7306,7306999,21.823103184082388,38.35250364748959,0.048868997019525406,1420.5881326198578,474.5870478153229,1776.6105194091797,62132,6989,55143,55143,0,9,7307000.0
7307,7307999,21.823890423816586,38.35316548955611,0.04887340926887451,1421.0150964260101,474.65297389030457,1777.033390045166,62147,6991,55156,55156,0,9,7308000.0
7308,7308999,21.82515422391262,38.354400749410594,0.04888068801171397,1421.283603668213,474.7160573005676,1777.5223846435547,62162,6992,55170,55170,0,9,7309000.0
7309,7309999,21.826104595923066,38.35495748525398,0.04889060662448841,1421.5460426807404,474.77935576438904,1778.0751724243164,62177,6993,55184,55184,0,9,7310000.0
7310,7310999,21.82743985445616,38.3569928081175,0.048900169266225535,1421.6647222042084,474.8423810005188,1778.508888244629,62178,6993,55185,55185,0,9,7311000.0
7311,7311999,21.82854191197075,38.35809614279278,0.0489202790687121,1422.21808719635,474.9048888683319,1778.846908569336,62197,6996,55201,55201,0,9,7312000.0
7312,7312999,21.829990782158873,38.360478305508536,0.04895185511849354,1422.6368129253387,474.97013115882874,1779.3183326721191,62221,6998,55223,55223,0,9,7313000.0
7313,7313999,21.830915292175032,38.361317754133054,0.0489740473606447,1422.8943264484406,475.0333209037781,1779.750358581543,62232,6999,55233,55233,0,9,7314000.0
7314,7314999,21.83032163422079,38.36186662673913,0.048920540370607,1423.1604533195496,475.09736132621765,1780.9527053833008,62272,7000,55272,55272,0,9,7315000.0
7315,7315999,21.82962800264143,38.36132344475471,0.04889841008181295,1423.5794217586517,475.1619074344635,1781.6032218933105,62292,7002,55290,55290,0,9,7316000.0
7316,7316999,21.828906882035856,38.3605701608908,0.0488953162174407,1423.8444283008575,475.22712421417236,1782.1587829589844,62295,7003,55292,55292,0,9,7317000.0
7317,7317999,21.828142410240034,38.35923930839423,0.04888662023766088,1424.2499523162842,475.29097604751587,1782.691089630127,62321,7005,55316,55316,0,9,7318000.0
7318,7318999,21.827708917209566,38.35924561501622,0.04887570636401273,1424.6552743911743,475.35451793670654,1783.216667175293,62333,7007,55326,55326,0,9,7319000.0
7319,7319999,21.827267141326267,38.35829828536437,0.04887306237477307,1424.7759449481964,475.41841888427734,1783.6943435668945,62333,7007,55326,55326,0,9,7320000.0
7320,7320999,21.82675986553454,38.35730108166998,0.048865159492519905,1424.9066483974457,475.48306131362915,1784.271499633789,62334,7007,55327,55327,0,9,7321000.0
7321,7321999,21.82640374602929,38.356532362241154,0.04885773901670043,1425.4601516723633,475.5465934276581,1784.639575958252,62371,7010,55361,55361,0,9,7322000.0
7322,7322999,21.826441045772487,38.35647315325094,0.048848991597085445,1425.7352466583252,475.6135358810425,1784.9568939208984,62381,7011,55370,55370,0,9,7323000.0
7323,7323999,21.826464087244286,38.35616702784796,0.048843282635199214,1425.8754799365997,475.6773319244385,1785.4272689819336,62382,7011,55371,55371,0,9,7324000.0
7324,7324999,21.826795303326083,38.3574565249738,0.04883342093483156,1426.1428163051605,475.74027490615845,1785.866886138916,62395,7012,55383,55383,0,9,7325000.0
7325,7325999,21.82679402932523,38.35857231532508,0.0488241297039006,1426.4117572307587,475.80476570129395,1786.158592224121,62405,7013,55392,55392,0,9,7326000.0
7326,7326999,21.82703586435338,38.358463293748855,0.04881807338298216,1426.681009054184,475.8673310279846,1786.6637382507324,62410,7014,55396,55396,0,9,7327000.0
7327,7327999,21.827460065786024,38.36067128506856,0.04880553025878831,1426.9439539909363,475.9305775165558,1786.998062133789,62414,7015,55399,55399,0,9,7328000.0
7328,7328999,21.82785667564071,38.36076884891401,0.04879933466314057,1427.2056148052216,475.99164032936096,1787.328769683838,62416,7016,55400,55400,0,9,7329000.0
7329,7329999,21.82805541993345,38.36059580501228,0.04879806988235158,1427.4717609882355,476.05476808547974,1787.6796417236328,62431,7017,55414,55414,0,9,7330000.0
7330,7330999,21.82868417738747,38.36195346806245,0.048788452235591806,1428.154268026352,476.11938762664795,1787.9717750549316,62479,7021,55458,55458,0,9,7331000.0
7331,7331999,21.82944590759878,38.362782343864694,0.048779357676759116,1428.2831242084503,476.18164348602295,1788.2754516601562,62480,7021,55459,55459,0,9,7332000.0
7332,7332999,21.829955427150622,38.36295671835631,0.04877475589475011,1428.6778128147125,476.2425000667572,1788.5281677246094,62494,7023,55471,55471,0,9,7333000.0
7333,7333999,21.83040695916353,38.36279361348098,0.048773246331234366,1429.3762171268463,476.3054747581482,1788.7200241088867,62534,7027,55507,55507,0,9,7334000.0
7334,7334999,21.83058215724374,38.36313376746719,0.04876696671991698,1429.9232051372528,476.3707172870636,1789.4484176635742,62578,7030,55548,55548,0,9,7335000.0
7335,7335999,21.829673849201804,38.36224563165917,0.04876197765144863,1430.1860013008118,476.43370294570923,1790.3691787719727,62595,7031,55564,55564,0,9,7336000.0
7336,7336999,21.829140804769242,38.36356047551276,0.0487537372741873,1430.3088750839233,476.49668979644775,1790.9670372009277,62597,7031,55566,55566,0,9,7337000.0
7337,7337999,21.828766401716145,38.36476237945963,0.0487456719900512,1430.5715403556824,476.5611906051636,1791.5062217712402,62609,7032,55577,55577,0,9,7338000.0
7338,7338999,21.828515437832532,38.36579177840434,0.04873973938338805,1430.698808670044,476.62461733818054,1792.1681861877441,62610,7032,55578,55578,0,9,7339000.0
7339,7339999,21.828687758547403,38.36786565165075,0.0487307246228359,1430.9601323604584,476.6865944862366,1792.5691528320312,62624,7033,55591,55591,0,9,7340000.0
7340,7340999,21.828590954966653,38.368408761847945,0.0487231123086167,1431.0751221179962,476.7489857673645,1792.9697456359863,62627,7033,55594,55594,0,9,7341000.0
7341,7341999,21.828374890047588,38.36842775261678,0.048721117998210994,1431.4985995292664,476.8149161338806,1793.3523139953613,62643,7035,55608,55608,0,9,7342000.0
7342,7342999,21.828374183984515,38.368923700217884,0.048718581561987606,1431.6142597198486,476.87719798088074,1793.681079864502,62643,7035,55608,55608,0,9,7343000.0
7343,7343999,21.8286451768687,38.37014910314633,0.048714380081758546,1431.744128704071,476.9400517940521,1794.0368957519531,62645,7035,55610,55610,0,9,7344000.0
7344,7344999,21.829075454194534,38.37131543549949,0.048704435674900126,1432.1484515666962,477.0040009021759,1794.4612655639648,62661,7037,55624,55624,0,9,7345000.0
7345,7345999,21.82953228685367,38.37251007210029,0.048699657165102606,1432.2621891498566,477.06671953201294,1794.8405380249023,62661,7037,55624,55624,0,9,7346000.0
7346,7346999,21.829538314014542,38.37229149231058,0.04869538773237314,1432.6748061180115,477.1307272911072,1795.1704139709473,62669,7039,55630,55630,0,9,7347000.0
7347,7347999,21.830167360698518,38.37359789331042,0.048694058114050254,1432.796784877777,477.1937327384949,1795.4948425292969,62670,7039,55631,55631,0,9,7348000.0
7348,7348999,21.8308094274263,38.37453233456571,0.04869009957664394,1433.0538818836212,477.25473737716675,1795.855136871338,62673,7040,55633,55633,0,9,7349000.0
7349,7349999,21.83115378999704,38.37478319795269,0.048683627371109095,1433.337084531784,477.31825399398804,1796.1568984985352,62688,7041,55647,55647,0,9,7350000.0
7350,7350999,21.831818774771104,38.37571810296729,0.048678240358334124,1433.7526578903198,477.38172364234924,1796.486328125,62732,7043,55689,55689,0,9,7351000.0
7351,7351999,21.832523886312543,38.376299540683426,0.04866936165746305,1434.010221004486,477.44472002983093,1796.7509307861328,62744,7044,55700,55700,0,9,7352000.0
7352,7352999,21.83322700712299,38.377112380679314,0.048664970620341474,1434.124128818512,477.5079689025879,1797.1513175964355,62744,7044,55700,55700,0,9,7353000.0
7353,7353999,21.8339036700219,38.377458718592294,0.048669412597484474,1434.6602449417114,477.5697355270386,1797.2574501037598,62762,7047,55715,55715,0,9,7354000.0
7354,7354999,21.83464355584879,38.37848600507124,0.04866074752309246,1434.9337365627289,477.63677978515625,1797.9536666870117,62776,7048,55728,55728,0,9,7355000.0
7355,7355999,21.83412399325654,38.37811457205976,0.0486561662903936,1435.4818439483643,477.70024132728577,1798.7942352294922,62812,7051,55761,55761,0,9,7356000.0
7356,7356999,21.834166526360725,38.37886085875035,0.04864027802184456,1435.6105563640594,477.7678244113922,1799.5221710205078,62813,7051,55762,55762,0,9,7357000.0
7357,7357999,21.834237730844986,38.37919345992223,0.048631428481014205,1435.8886182308197,477.8348207473755,1800.026294708252,62823,7052,55771,55771,0,9,7358000.0
7358,7358999,21.83420030797877,38.37953167540972,0.04862617378977507,1436.3083987236023,477.89827251434326,1800.3544654846191,62838,7054,55784,55784,0,9,7359000.0
7359,7359999,21.834057917086074,38.379277176124056,0.04861879937496283,1436.5818922519684,477.9628412723541,1800.7332801818848,62845,7055,55790,55790,0,9,7360000.0
7360,7360999,21.834589722177036,38.3840505223316,0.04860732197697082,1436.7073910236359,478.0264959335327,1801.2415313720703,62847,7055,55792,55792,0,9,7361000.0
7361,7361999,21.835142558967096,38.384749461517345,0.04861098217875248,1437.1303596496582,478.0901381969452,1801.6020050048828,62863,7057,55806,55806,0,9,7362000.0
7362,7362999,21.835604569586447,38.385680210627584,0.048612711608023385,1437.2505209445953,478.1529269218445,1802.00532913208,62864,7057,55807,55807,0,9,7363000.0
7363,7363999,21.836296015851456,38.38622413704324,0.048608653445276206,1437.660549402237,478.21635341644287,1802.2071990966797,62889,7059,55830,55830,0,9,7364000.0
7364,7364999,21.8372138078739,38.38816462935129,0.04860942708509908,1437.7968571186066,478.28086519241333,1802.532356262207,62890,7059,55831,55831,0,9,7365000.0
7365,7365999,21.83765005458937,38.38834890820929,0.04861120761080784,1438.060467004776,478.3449285030365,1802.8693161010742,62906,7060,55846,55846,0,9,7366000.0
7366,7366999,21.83854293177943,38.38978401798987,0.04862010962173935,1438.3210537433624,478.4087378978729,1803.1620979309082,62919,7061,55858,55858,0,9,7367000.0
7367,7367999,21.839556290984987,38.39094494410727,0.048631931710905185,1438.447654247284,478.4715497493744,1803.4205360412598,62920,7061,55859,55859,0,9,7368000.0
7368,7368999,21.84051673052688,38.391731564981804,0.04863736953473663,1438.7170844078064,478.53528118133545,1803.6853370666504,62932,7062,55870,55870,0,9,7369000.0
7369,7369999,21.842109196537812,38.39401210889626,0.04865914255318915,1438.8536336421967,478.5976974964142,1804.0867004394531,62935,7062,55873,55873,0,9,7370000.0
7370,7370999,21.84335065613695,38.39539919519919,0.0486619081839722,1439.1177952289581,478.6615045070648,1804.5805625915527,62948,7063,55885,55885,0,9,7371000.0
7371,7371999,21.84426929301054,38.39609226000903,0.04867127715802255,1439.5203742980957,478.72435426712036,1804.9434700012207,62962,7065,55897,55897,0,9,7372000.0
7372,7372999,21.8442346878308,38.3962702417141,0.04866908010769877,1439.6543881893158,478.78822803497314,1806.1396751403809,62991,7065,55926,55926,0,9,7373000.0
7373,7373999,21.84375205364966,38.397798838091624,0.04866470637193365,1439.7835655212402,478.8527624607086,1806.93794631958,62998,7065,55933,55933,0,9,7374000.0
7374,7374999,21.843252705726435,38.3969602931237,0.048665228309618724,1440.204597234726,478.91820192337036,1807.351650238037,63020,7067,55953,55953,0,9,7375000.0
7375,7375999,21.842850958394884,38.39661869459097,0.04866458486862302,1440.3273491859436,478.9819474220276,1807.933250427246,63021,7067,55954,55954,0,9,7376000.0
7376,7376999,21.84259922197291,38.3966834603938,0.04866265005171311,1440.6215562820435,479.0607259273529,1808.5156593322754,63024,7068,55956,55956,0,9,7377000.0
7377,7377999,21.842759191246333,38.39828009443009,0.0486576015477318,1440.8933727741241,479.1245882511139,1809.0191192626953,63030,7069,55961,55961,0,9,7378000.0
7378,7378999,21.842940714437383,38.39841952820359,0.048657920202678784,1441.1651866436005,479.1884093284607,1809.4253387451172,63040,7070,55970,55970,0,9,7379000.0
7379,7379999,21.84321700477133,38.39864214068866,0.04865926047732949,1441.4384672641754,479.2504925727844,1809.7159805297852,63054,7071,55983,55983,0,9,7380000.0
7380,7380999,21.843502095087878,38.398924126335224,0.048664932552461626,1441.700441122055,479.3138391971588,1810.1140747070312,63058,7072,55986,55986,0,9,7381000.0
7381,7381999,21.844197029535984,38.401026600590825,0.04866648874206536,1442.2536580562592,479.3796980381012,1810.3692741394043,63099,7075,56024,56024,0,9,7382000.0
7382,7382999,21.844582746597506,38.40123812043596,0.048673778549404245,1442.3720791339874,479.4426190853119,1810.8214111328125,63099,7075,56024,56024,0,9,7383000.0
7383,7383999,21.84495040219657,38.40323930306162,0.048673725443820204,1442.7872159481049,479.5059931278229,1811.1040725708008,63122,7077,56045,56045,0,9,7384000.0
7384,7384999,21.845481076626637,38.403543627904085,0.04867259932424384,1442.9056568145752,479.5678880214691,1811.526912689209,63128,7077,56051,56051,0,9,7385000.0
7385,7385999,21.845993273657438,38.403692637257905,0.048680121006476895,1443.1682822704315,479.6322920322418,1811.8528938293457,63134,7078,56056,56056,0,9,7386000.0
7386,7386999,21.846493524585018,38.40364329227443,0.04868232799249428,1443.2883296012878,479.69507694244385,1812.240493774414,63134,7078,56056,56056,0,9,7387000.0
7387,7387999,21.847097567243566,38.40389374304255,0.04868422793172289,1443.5552203655243,479.75884199142456,1812.6539497375488,63151,7079,56072,56072,0,9,7388000.0
7388,7388999,21.847666652251394,38.405790406779204,0.04868469921651386,1443.8234939575195,479.8218584060669,1812.9871444702148,63164,7080,56084,56084,0,9,7389000.0
7389,7389999,21.848409095022074,38.40626174600079,0.04868686715223891,1444.225169658661,479.88412070274353,1813.3894844055176,63177,7082,56095,56095,0,9,7390000.0
7390,7390999,21.84904610026692,38.40627719680973,0.04869158667140272,1444.3466475009918,479.9468832015991,1813.905559539795,63180,7082,56098,56098,0,9,7391000.0
7391,7391999,21.84920253280808,38.40733409875599,0.04867078635784783,1444.4769201278687,480.01110076904297,1815.2185134887695,63215,7082,56133,56133,0,9,7392000.0
7392,7392999,21.84865846938327,38.40741985142139,0.04866498804553121,1444.7390608787537,480.075222492218,1815.9516677856445,63226,7083,56143,56143,0,9,7393000.0
7393,7393999,21.84772434699267,38.406147551465885,0.048668151018054884,1445.0044753551483,480.1391944885254,1816.3576202392578,63240,7084,56156,56156,0,9,7394000.0
7394,7394999,21.847131744454117,38.40601635367893,0.04866797416281832,1445.1311597824097,480.2028136253357,1816.9265251159668,63246,7084,56162,56162,0,9,7395000.0
7395,7395999,21.84671465732219,38.405833226065916,0.048666201559895206,1445.5399723052979,480.26784086227417,1817.2889022827148,63261,7086,56175,56175,0,9,7396000.0
7396,7396999,21.846187527406656,38.40496655662225,0.04866794656387674,1445.6662213802338,480.3335177898407,1817.836353302002,63262,7086,56176,56176,0,9,7397000.0
7397,7397999,21.845698057515428,38.403849219296184,0.04867005989266249,1445.7885048389435,480.39587211608887,1818.3828506469727,63266,7086,56180,56180,0,9,7398000.0
7398,7398999,21.845286867626797,38.40288201238734,0.04867321917075218,1446.3419661521912,480.4601356983185,1818.6736450195312,63302,7089,56213,56213,0,9,7399000.0
7399,7399999,21.844963418136857,38.402319623566214,0.04867274195483329,1446.4630439281464,480.52514123916626,1818.9807243347168,63302,7089,56213,56213,0,9,7400000.0
7400,7400999,21.84488883430646,38.40235984687586,0.0486770395248024,1446.7227971553802,480.5867118835449,1819.3510360717773,63316,7090,56226,56226,0,9,7401000.0
7401,7401999,21.84499451447813,38.40273140281824,0.04868405523681252,1446.9987468719482,480.6512267589569,1819.7599639892578,63331,7091,56240,56240,0,9,7402000.0
7402,7402999,21.84517401404369,38.403431745060324,0.04868606744834225,1447.1127984523773,480.7136297225952,1819.9993858337402,63331,7091,56240,56240,0,9,7403000.0
7403,7403999,21.845225837288808,38.40339797945711,0.0486883799637956,1447.515145778656,480.77668857574463,1820.2218170166016,63365,7093,56272,56272,0,9,7404000.0
7404,7404999,21.84579959776591,38.40522576730183,0.04869612882128427,1447.7750189304352,480.83972907066345,1820.662899017334,63369,7094,56275,56275,0,9,7405000.0
7405,7405999,21.846498995327586,38.407102290274445,0.04870700617676427,1448.1748113632202,480.90228176116943,1820.956901550293,63384,7096,56288,56288,0,9,7406000.0
7406,7406999,21.847580387663946,38.41058014609755,0.048714255087752845,1448.4423666000366,480.9640836715698,1821.3124771118164,63396,7097,56299,56299,0,9,7407000.0
7407,7407999,21.84884691236052,38.413210107069695,0.04872516904155533,1448.855815410614,481.0266373157501,1821.6024284362793,63413,7099,56314,56314,0,9,7408000.0
7408,7408999,21.850561849406976,38.41949643516325,0.04872428136172735,1449.1166563034058,481.0883409976959,1821.852954864502,63424,7100,56324,56324,0,9,7409000.0
7409,7409999,21.851557061425435,38.421396839842416,0.048732284004480486,1449.9638357162476,481.1527180671692,1821.905834197998,63455,7105,56350,56350,0,9,7410000.0
7410,7410999,21.851889243225163,38.422046771746594,0.048739916778566816,1450.5154268741608,481.21462178230286,1822.1648025512695,63472,7108,56364,56364,0,9,7411000.0
7411,7411999,21.851639057570598,38.42323597088376,0.048725670558843914,1451.0662643909454,481.2796883583069,1823.2436218261719,63518,7111,56407,56407,0,9,7412000.0
7412,7412999,21.850692531605993,38.421847666874335,0.0487271573074175,1451.3287785053253,481.34457182884216,1823.9027671813965,63529,7112,56417,56417,0,9,7413000.0
7413,7413999,21.849922771861145,38.420790410682315,0.048725948114618944,1451.6010959148407,481.4081275463104,1824.4122772216797,63538,7113,56425,56425,0,9,7414000.0
7414,7414999,21.849246484587844,38.41968067019893,0.04872708735463804,1451.8719391822815,481.4714059829712,1824.9894180297852,63550,7114,56436,56436,0,9,7415000.0
7415,7415999,21.848887814745822,38.42011955266817,0.048724529802161465,1452.1453993320465,481.5364599227905,1825.3596305847168,63558,7115,56443,56443,0,9,7416000.0
7416,7416999,21.848460360341686,38.41911681831267,0.04872209788321891,1452.276202917099,481.5992612838745,1825.7387771606445,63559,7115,56444,56444,0,9,7417000.0
7417,7417999,21.848082372123056,38.41841150370749,0.04872540320619634,1452.3972127437592,481.6620500087738,1826.1468048095703,63564,7115,56449,56449,0,9,7418000.0
7418,7418999,21.847768733492344,38.41765494647245,0.048722375773684656,1458.5841994285583,481.7251400947571,1826.464427947998,63564,7115,56449,56449,0,9,7419000.0
7419,7419999,21.84751478248106,38.41695869511395,0.048721664688532784,1458.8635184764862,481.7893669605255,1826.71586227417,63577,7116,56461,56461,0,9,7420000.0
7420,7420999,21.84756252774234,38.4169186667038,0.048718320681141125,1459.1528425216675,481.854124546051,1826.9783401489258,63580,7117,56463,56463,0,9,7421000.0
7421,7421999,21.847439588987218,38.41619934478403,0.048720460452764014,1459.5824389457703,481.9177129268646,1827.1117668151855,63603,7119,56484,56484,0,9,7422000.0
7422,7422999,21.847671844793748,38.416351148822315,0.0487164305617247,1460.299212217331,481.98226714134216,1827.2680740356445,63636,7123,56513,56513,0,9,7423000.0
7423,7423999,21.84817775687133,38.418508705611,0.04871189826548905,1460.4183535575867,482.0442171096802,1827.6822204589844,63638,7123,56515,56515,0,9,7424000.0
7424,7424999,21.848795886347595,38.41904429005499,0.048707661996438056,1460.5458319187164,482.112188577652,1828.0664138793945,63638,7123,56515,56515,0,9,7425000.0
7425,7425999,21.84919372555135,38.4191908735133,0.048705349555277055,1460.985770702362,482.17383766174316,1828.2510948181152,63642,7125,56517,56517,0,9,7426000.0
7426,7426999,21.84996821083407,38.42013698413496,0.04871080469101541,1461.116115808487,482.2370755672455,1828.5824966430664,63644,7125,56519,56519,0,9,7427000.0
7427,7427999,21.85042714677816,38.42036147366518,0.048708520850320736,1461.3910238742828,482.30151748657227,1828.7916297912598,63657,7126,56531,56531,0,9,7428000.0
7428,7428999,21.850905177282304,38.42134918585105,0.04870727564175137,1461.6694786548615,482.36413526535034,1829.0507202148438,63660,7127,56533,56533,0,9,7429000.0
7429,7429999,21.85120032199327,38.421287155633145,0.048702373514748376,1461.7894451618195,482.4264853000641,1829.3413047790527,63661,7127,56534,56534,0,9,7430000.0
7430,7430999,21.85097583899803,38.42104783336048,0.04869095495802411,1461.9463868141174,482.49664521217346,1830.6565322875977,63697,7127,56570,56570,0,9,7431000.0
7431,7431999,21.84990112219973,38.41916403425475,0.04869286741622658,1462.230049610138,482.56170630455017,1831.257682800293,63701,7128,56573,56573,0,9,7432000.0
7432,7432999,21.849008564644016,38.41956153595707,0.04869094156988274,1462.5157897472382,482.6269905567169,1831.7086372375488,63710,7129,56581,56581,0,9,7433000.0
7433,7433999,21.848129069527097,38.4184845247565,0.048692462075703435,1462.7953050136566,482.6914474964142,1832.2509384155273,63720,7130,56590,56590,0,9,7434000.0
7434,7434999,21.847447522441165,38.41743687793644,0.04869491795704406,1463.2260003089905,482.75719261169434,1832.596996307373,63749,7132,56617,56617,0,9,7435000.0
7435,7435999,21.846780801299914,38.41596722309532,0.048697614056668614,1463.5155446529388,482.82417249679565,1833.2324752807617,63762,7133,56629,56629,0,9,7436000.0
7436,7436999,21.845973756381927,38.414413059014976,0.04870060250068775,1463.6353940963745,482.8894109725952,1833.6099586486816,63762,7133,56629,56629,0,9,7437000.0
7437,7437999,21.845363966811703,38.41318009070449,0.04870317597352236,1463.7560729980469,482.9525558948517,1834.0910758972168,63765,7133,56632,56632,0,9,7438000.0
7438,7438999,21.844771971187843,38.41202267396481,0.048706767242348126,1464.3357031345367,483.01677942276,1834.3699340820312,63823,7136,56687,56687,0,9,7439000.0
7439,7439999,21.844324971715086,38.411062151019124,0.04870814802202883,1464.6123955249786,483.0812554359436,1834.627426147461,63836,7137,56699,56699,0,9,7440000.0
7440,7440999,21.84366548653788,38.40949962095317,0.04871084470717102,1464.7363860607147,483.14741230010986,1835.0498657226562,63838,7137,56701,56701,0,9,7441000.0
7441,7441999,21.843269144180393,38.408339793874084,0.04870763195403127,1465.0100400447845,483.2099118232727,1835.3331909179688,63843,7138,56705,56705,0,9,7442000.0
7442,7442999,21.843049006777424,38.40748873509811,0.0487015962862436,1465.282487154007,483.2753093242645,1835.6062850952148,63849,7139,56710,56710,0,9,7443000.0
7443,7443999,21.842662076224904,38.40608997084074,0.048699336325074505,1465.8766045570374,483.3413391113281,1835.8845710754395,63858,7142,56716,56716,0,9,7444000.0
7444,7444999,21.842285920301748,38.4047033561741,0.04869942082953038,1466.0090973377228,483.40428471565247,1836.3654975891113,63863,7142,56721,56721,0,9,7445000.0
7445,7445999,21.8418234700535,38.403246648032216,0.0486949395405506,1466.1357741355896,483.467125415802,1836.8179092407227,63867,7142,56725,56725,0,9,7446000.0
7446,7446999,21.84162130849239,38.40201045082624,0.04869149489477764,1466.8594107627869,483.53393840789795,1836.911735534668,63887,7146,56741,56741,0,9,7447000.0
7447,7447999,21.841076383281184,38.4004502330994,0.048689176867755535,1467.1442704200745,483.59720182418823,1837.418701171875,63893,7147,56746,56746,0,9,7448000.0
7448,7448999,21.840574831360787,38.399098434610075,0.04868678672220672,1467.2740905284882,483.6617274284363,1837.9821586608887,63897,7147,56750,56750,0,9,7449000.0
7449,7449999,21.84009671358795,38.39851395677577,0.04866449150178387,1467.4081254005432,483.72831535339355,1838.9236793518066,63921,7147,56774,56774,0,9,7450000.0
7450,7450999,21.839305471369872,38.39713886603466,0.04865628191025473,1467.541640996933,483.7945258617401,1839.9591369628906,63940,7147,56793,56793,0,9,7451000.0
7451,7451999,21.838521910190146,38.39573878920625,0.04865998629994761,1467.6684033870697,483.85961627960205,1840.6682891845703,63946,7147,56799,56799,0,9,7452000.0
7452,7452999,21.83778776303675,38.39459789879162,0.048659020749331705,1467.9579148292542,483.9270715713501,1841.2699356079102,63954,7148,56806,56806,0,9,7453000.0
7453,7453999,21.837058818708154,38.39321792587113,0.048658190043205596,1468.388594865799,483.99470567703247,1841.6536140441895,63996,7150,56846,56846,0,10,7454000.0
7454,7454999,21.83648560192936,38.392177157481136,0.04866136453094816,1468.5216183662415,484.05928683280945,1842.0932655334473,63998,7150,56848,56848,0,10,7455000.0
7455,7455999,21.836008082632432,38.390889236869604,0.04865940835476368,1468.9424777030945,484.12447452545166,1842.4343643188477,64018,7152,56866,56866,0,10,7456000.0
7456,7456999,21.835599872797246,38.390074184675846,0.04865741659223677,1469.0665383338928,484.1883821487427,1842.9128494262695,64022,7152,56870,56870,0,10,7457000.0
7457,7457999,21.83511462333309,38.389850430446565,0.04866146014238837,1469.193921327591,484.2560603618622,1843.228271484375,64022,7152,56870,56870,0,10,7458000.0
7458,7458999,21.834981146401564,38.38979869664769,0.04865386563011087,1469.6488716602325,484.3216652870178,1843.5641975402832,64030,7154,56876,56876,0,10,7459000.0
7459,7459999,21.834655526299343,38.388790599400764,0.04864834031282572,1469.9230089187622,484.38462829589844,1843.9537773132324,64045,7155,56890,56890,0,10,7460000.0
7460,7460999,21.834404707794143,38.38822586315,0.04864370891943981,1470.4986324310303,484.44901180267334,1844.2006950378418,64072,7158,56914,56914,0,10,7461000.0
7461,7461999,21.83410417285836,38.38735665528892,0.048636922314230446,1470.9424088001251,484.51692724227905,1844.6723556518555,64098,7160,56938,56938,0,10,7462000.0
7462,7462999,21.834076406004087,38.38704243398397,0.04862879214780247,1471.075595855713,484.58118295669556,1845.1559524536133,64101,7160,56941,56941,0,10,7463000.0
7463,7463999,21.83419379903312,38.38670490853235,0.048623527628498864,1471.3434178829193,484.64572644233704,1845.6002616882324,64106,7161,56945,56945,0,10,7464000.0
7464,7464999,21.834264061866094,38.3864333437232,0.0486117577642059,1471.469622373581,484.71247148513794,1846.1567306518555,64112,7161,56951,56951,0,10,7465000.0
7465,7465999,21.83459537061667,38.38633896858898,0.04860924635768904,1471.7594792842865,484.77773880958557,1846.6091117858887,64118,7162,56956,56956,0,10,7466000.0
7466,7466999,21.83512807587491,38.38741476940413,0.048606804945188986,1472.1856117248535,484.84265089035034,1846.8481559753418,64132,7164,56968,56968,0,10,7467000.0
7467,7467999,21.835397889553875,38.38722862800022,0.04860516281666449,1472.6137833595276,484.9056782722473,1847.233196258545,64149,7166,56983,56983,0,10,7468000.0
7468,7468999,21.835405413106447,38.38650239895325,0.04860133116010523,1472.73481631279,484.9699695110321,1847.7099494934082,64154,7166,56988,56988,0,10,7469000.0
7469,7469999,21.835120125069235,38.385437490573416,0.04859815750359031,1473.1655957698822,485.03433871269226,1848.684284210205,64192,7168,57024,57024,0,10,7470000.0
7470,7470999,21.83456298190744,38.38638298581337,0.04859596177614878,1473.2977759838104,485.1016824245453,1849.5935020446777,64202,7168,57034,57034,0,10,7471000.0
7471,7471999,21.8336598715643,38.38505172167388,0.048603702020652895,1473.8755576610565,485.1659405231476,1850.2045936584473,64239,7171,57068,57068,0,10,7472000.0
7472,7472999,21.83305370080115,38.38383563142427,0.04860652836915236,1474.0081329345703,485.2304801940918,1850.82035446167,64241,7171,57070,57070,0,10,7473000.0
7473,7473999,21.832697979321075,38.38400559227105,0.048602907715646015,1474.1451179981232,485.29512548446655,1851.2192039489746,64242,7171,57071,57071,0,10,7474000.0
7474,7474999,21.83213873032549,38.38275002872553,0.04861015297628579,1474.4272470474243,485.3624894618988,1851.6391983032227,64256,7172,57084,57084,0,10,7475000.0
7475,7475999,21.83172173303554,38.38207768388852,0.04861398239954584,1474.5621156692505,485.4269177913666,1852.0653991699219,64257,7172,57085,57085,0,10,7476000.0
7476,7476999,21.83157828579666,38.381348672226636,0.04861833698446272,1474.691308259964,485.4934685230255,1852.510082244873,64260,7172,57088,57088,0,10,7477000.0
7477,7477999,21.831662721301957,38.38170825960538,0.04863177092020432,1474.823966741562,485.56419467926025,1852.9511756896973,64260,7172,57088,57088,0,10,7478000.0
7478,7478999,21.831698380151284,38.38143945182406,0.048639531203010344,1474.9536221027374,485.63293409347534,1853.4202690124512,64263,7172,57091,57091,0,10,7479000.0
7479,7479999,21.83204047572018,38.38158829717829,0.048645171555386835,1475.24147605896,485.6994454860687,1853.810317993164,64278,7173,57105,57105,0,10,7480000.0
7480,7480999,21.832285527495284,38.381726866408066,0.04865100181580273,1475.3695271015167,485.7628197669983,1854.0744857788086,64278,7173,57105,57105,0,10,7481000.0
7481,7481999,21.832466186381925,38.38146742127245,0.04865771410938469,1475.7913200855255,485.82598209381104,1854.2937927246094,64293,7175,57118,57118,0,10,7482000.0
7482,7482999,21.832696979766755,38.38142107106896,0.04865983945854968,1476.2168946266174,485.8911361694336,1854.4529495239258,64307,7177,57130,57130,0,10,7483000.0
7483,7483999,21.832927711821977,38.3810750247095,0.048665051337526744,1476.4945697784424,485.9536180496216,1854.6301498413086,64309,7178,57131,57131,0,10,7484000.0
7484,7484999,21.833353938245857,38.38095390491056,0.048668581879127815,1477.1014156341553,486.0197856426239,1854.7158393859863,64330,7181,57149,57149,0,10,7485000.0
7485,7485999,21.833580004293257,38.38032263184276,0.04866771593667929,1477.520525932312,486.0830588340759,1854.9598503112793,64344,7183,57161,57161,0,10,7486000.0
7486,7486999,21.833990994017725,38.38027607174136,0.04866848841300553,1477.940190076828,486.14613580703735,1855.1559944152832,64369,7185,57184,57184,0,10,7487000.0
7487,7487999,21.834021799143205,38.379336776194265,0.048666882054492655,1478.225423336029,486.21001505851746,1855.3678436279297,64381,7186,57195,57195,0,10,7488000.0
7488,7488999,21.8339980905432,38.378423206785364,0.04866069445134191,1478.5139322280884,486.27461314201355,1855.602783203125,64394,7187,57207,57207,0,10,7489000.0
7489,7489999,21.833720176455614,38.37735116010234,0.048656230780198095,1478.6411199569702,486.33816933631897,1856.8081092834473,64421,7187,57234,57234,0,10,7490000.0
7490,7490999,21.83302962237643,38.37597117544882,0.04864960859109457,1478.76842212677,486.4011015892029,1857.6659126281738,64427,7187,57240,57240,0,10,7491000.0
7491,7491999,21.832377888393655,38.37444240639796,0.0486470416889615,1479.0477666854858,486.4668970108032,1858.162754058838,64442,7188,57254,57254,0,10,7492000.0
7492,7492999,21.831720749294362,38.37330263872718,0.04865034899312615,1479.3269822597504,486.5311875343323,1858.5981140136719,64456,7189,57267,57267,0,10,7493000.0
7493,7493999,21.83095821937031,38.37173521676316,0.04865306916825951,1479.4687087535858,486.5976228713989,1859.0836067199707,64460,7189,57271,57271,0,10,7494000.0
7494,7494999,21.830313894096953,38.37038071074067,0.048650053899369716,1479.591676235199,486.6619243621826,1859.5819854736328,64465,7189,57276,57276,0,10,7495000.0
7495,7495999,21.829490972118847,38.3686470618774,0.04865429896582962,1479.7184455394745,486.7279772758484,1860.2471466064453,64471,7189,57282,57282,0,10,7496000.0
7496,7496999,21.828724069087254,38.367022691939134,0.0486600981495261,1479.9894115924835,486.7910921573639,1860.647159576416,64487,7190,57297,57297,0,10,7497000.0
7497,7497999,21.828128565318583,38.365722500266756,0.048659058616547624,1480.4089155197144,486.8551368713379,1861.0123481750488,64492,7192,57300,57300,0,10,7498000.0
7498,7498999,21.827521006559916,38.36421258502785,0.04865650156608381,1480.6862874031067,486.9203088283539,1861.370273590088,64533,7193,57340,57340,0,10,7499000.0
7499,7499999,21.82698826847624,38.36274045621365,0.04865968040178825,1480.8129057884216,486.985164642334,1861.7803421020508,64537,7193,57344,57344,0,10,7500000.0
7500,7500999,21.826350538500616,38.3612692277852,0.048664472793338076,1481.100660085678,487.0492126941681,1862.1285285949707,64549,7194,57355,57355,0,10,7501000.0
7501,7501999,21.82623095115865,38.360241771341286,0.04866089574410104,1481.2200043201447,487.11210322380066,1862.5540885925293,64550,7194,57356,57356,0,10,7502000.0
7502,7502999,21.82627737320011,38.35987038869315,0.04865455898767557,1481.4996767044067,487.17738342285156,1862.83207321167,64563,7195,57368,57368,0,10,7503000.0
7503,7503999,21.826444263768142,38.359777492859386,0.04864546027163563,1481.6229286193848,487.2390658855438,1863.1540985107422,64564,7195,57369,57369,0,10,7504000.0
7504,7504999,21.826182809148836,38.358330788785544,0.048643936188688786,1481.7488939762115,487.3023862838745,1863.5276069641113,64565,7195,57370,57370,0,10,7505000.0
7505,7505999,21.825824855170506,38.357637969671615,0.04864083494290028,1481.8770713806152,487.3651463985443,1864.4099922180176,64582,7195,57387,57387,0,10,7506000.0
7506,7506999,21.825266513521605,38.357339994618926,0.048646482125613066,1482.0024888515472,487.4296226501465,1865.431812286377,64601,7195,57406,57406,0,10,7507000.0
7507,7507999,21.824446709882913,38.35574532613662,0.04865396619088369,1482.5682637691498,487.4949789047241,1865.9748001098633,64642,7198,57444,57444,0,10,7508000.0
7508,7508999,21.82368869241055,38.354410754112024,0.048661964876191455,1482.6997818946838,487.55852341651917,1866.4800491333008,64644,7198,57446,57446,0,10,7509000.0
7509,7509999,21.822934435606587,38.35316761241088,0.04866758024459206,1482.8231735229492,487.6209213733673,1866.9218559265137,64647,7198,57449,57449,0,10,7510000.0
7510,7510999,21.822025414296377,38.35147830459416,0.048674312305058365,1483.0958964824677,487.6846420764923,1867.34769821167,64663,7199,57464,57464,0,10,7511000.0
7511,7511999,21.821024344514072,38.34965059900708,0.04867987057737244,1483.5176475048065,487.74860739707947,1867.6367301940918,64681,7201,57480,57480,0,10,7512000.0
7512,7512999,21.820300562939124,38.34836745174543,0.04868084053250843,1483.6397960186005,487.8120753765106,1867.9251022338867,64683,7201,57482,57482,0,10,7513000.0
7513,7513999,21.81984587436953,38.34760647797348,0.048677055511598954,1484.0590817928314,487.87595868110657,1868.198398590088,64701,7203,57498,57498,0,10,7514000.0
7514,7514999,21.81921499328667,38.34635093199419,0.04867273661646465,1484.1799006462097,487.93925285339355,1868.618480682373,64706,7203,57503,57503,0,10,7515000.0
7515,7515999,21.81872254556325,38.34526038205787,0.04866873337026045,1484.4588694572449,488.0031976699829,1868.8546867370605,64718,7204,57514,57514,0,10,7516000.0
7516,7516999,21.818206421046668,38.34414804866042,0.0486619536902001,1484.7326219081879,488.06570768356323,1869.264274597168,64731,7205,57526,57526,0,10,7517000.0
7517,7517999,21.817889906733736,38.34314380359706,0.04865715241806157,1484.8682749271393,488.1290056705475,1869.5572128295898,64731,7205,57526,57526,0,10,7518000.0
7518,7518999,21.817516128034143,38.342043067457354,0.048651755043633615,1484.9899008274078,488.1914179325104,1869.780662536621,64731,7205,57526,57526,0,10,7519000.0
7519,7519999,21.817421188361532,38.34205395620108,0.048644438108354504,1485.5485577583313,488.2539885044098,1870.0378074645996,64771,7208,57563,57563,0,10,7520000.0
7520,7520999,21.817323392911927,38.341249717598885,0.04863391175466314,1485.681342124939,488.3165943622589,1870.4391708374023,64774,7208,57566,57566,0,10,7521000.0
7521,7521999,21.81701875636972,38.34031459032538,0.04862542431600081,1485.9462387561798,488.378945350647,1870.7347984313965,64788,7209,57579,57579,0,10,7522000.0
7522,7522999,21.816767950025184,38.33910565349386,0.048617269019424425,1486.0747032165527,488.44242429733276,1871.0601234436035,64792,7209,57583,57583,0,10,7523000.0
7523,7523999,21.8163033678271,38.33772935021177,0.04861417372109744,1486.1885628700256,488.5041124820709,1871.3932991027832,64792,7209,57583,57583,0,10,7524000.0
7524,7524999,21.816039913877063,38.33735531825516,0.04859635768045323,1486.3197038173676,488.5678598880768,1872.6700553894043,64816,7209,57607,57607,0,10,7525000.0
7525,7525999,21.81557384360795,38.336695134455454,0.048585519319451986,1486.4500634670258,488.6307747364044,1873.398120880127,64822,7209,57613,57613,0,10,7526000.0
7526,7526999,21.815076004951962,38.335913248123,0.04857867529207682,1486.57155585289,488.69411730766296,1873.8042449951172,64824,7209,57615,57615,0,10,7527000.0
7527,7527999,21.81448228937948,38.3344557761279,0.04857522138916015,1486.841194152832,488.7573938369751,1874.2166175842285,64842,7210,57632,57632,0,10,7528000.0
7528,7528999,21.81401206879975,38.33336148422742,0.04857495473698603,1486.9687016010284,488.8206582069397,1874.68355178833,64844,7210,57634,57634,0,10,7529000.0
7529,7529999,21.813569468814027,38.332094376816904,0.048573649895400806,1487.2398557662964,488.8843822479248,1875.110263824463,64860,7211,57649,57649,0,10,7530000.0
7530,7530999,21.812839887143618,38.33042798179423,0.04857194057697023,1487.367141008377,488.9475781917572,1875.5915184020996,64865,7211,57654,57654,0,10,7531000.0
7531,7531999,21.812271681752712,38.329048665898284,0.04857255378255654,1487.7778923511505,489.01125168800354,1875.8686561584473,64913,7213,57700,57700,0,10,7532000.0
7532,7532999,21.811697512049786,38.32760687436781,0.04857214112588015,1487.903908252716,489.07544589042664,1876.370719909668,64915,7213,57702,57702,0,10,7533000.0
7533,7533999,21.811360851233296,38.32637906393638,0.048569784772076297,1488.1838686466217,489.1407186985016,1876.695915222168,64927,7214,57713,57713,0,10,7534000.0
7534,7534999,21.810945832286833,38.3251876154403,0.0485678700748462,1488.6029706001282,489.20302081108093,1876.8608131408691,64941,7216,57725,57725,0,10,7535000.0
7535,7535999,21.81076842567402,38.32424019709656,0.04856604764409611,1488.879328250885,489.26631116867065,1877.2053871154785,64946,7217,57729,57729,0,10,7536000.0
7536,7536999,21.810754064115386,38.324918280689076,0.048560741456152745,1489.0020961761475,489.3298795223236,1877.5127410888672,64947,7217,57730,57730,0,10,7537000.0
7537,7537999,21.81085959129459,38.324554678281544,0.04855589221356027,1489.119244813919,489.39243364334106,1877.817813873291,64947,7217,57730,57730,0,10,7538000.0
7538,7538999,21.810974501324882,38.323743005613,0.04855043549200899,1489.5372893810272,489.4549684524536,1878.114616394043,64964,7219,57745,57745,0,10,7539000.0
7539,7539999,21.81114132357255,38.32305576547393,0.04855261959626189,1489.6532561779022,489.5178735256195,1878.6273193359375,64967,7219,57748,57748,0,10,7540000.0
7540,7540999,21.811616105804056,38.322830909520306,0.048551398674094415,1490.075028181076,489.58090806007385,1878.7885246276855,64991,7221,57770,57770,0,10,7541000.0
7541,7541999,21.811744624633995,38.322160246260246,0.04855298501035199,1490.64386677742,489.64437770843506,1878.9703559875488,65018,7224,57794,57794,0,10,7542000.0
7542,7542999,21.81162360362097,38.32123156994821,0.04854937669092141,1490.7702641487122,489.70852279663086,1879.448673248291,65020,7224,57796,57796,0,10,7543000.0
7543,7543999,21.811564423435218,38.320434016542514,0.04852557197153351,1490.8998675346375,489.7737989425659,1880.6641731262207,65044,7224,57820,57820,0,10,7544000.0
7544,7544999,21.811978886108694,38.32222926117204,0.04848482518317532,1491.0248415470123,489.8378894329071,1881.4677505493164,65050,7224,57826,57826,0,10,7545000.0
7545,7545999,21.812008076007363,38.32176810541866,0.04845787223814357,1491.1446497440338,489.90162920951843,1882.0179443359375,65051,7224,57827,57827,0,10,7546000.0
7546,7546999,21.812134542401495,38.32216467652675,0.04842810963962563,1491.5705394744873,489.9653127193451,1882.3385047912598,65075,7226,57849,57849,0,10,7547000.0
7547,7547999,21.812097260590708,38.32143293522756,0.04840616998445846,1491.696881055832,490.02958846092224,1882.7466773986816,65075,7226,57849,57849,0,10,7548000.0
7548,7548999,21.812121700492725,38.32100936575736,0.04838685626980477,1491.970060825348,490.09438395500183,1882.9601364135742,65087,7227,57860,57860,0,10,7549000.0
7549,7549999,21.81229433770449,38.320507231957755,0.048363878771515156,1492.0985729694366,490.1566050052643,1883.384349822998,65089,7227,57862,57862,0,10,7550000.0
7550,7550999,21.81247694905806,38.32037997750324,0.04834672023842912,1492.2225320339203,490.2210569381714,1883.877597808838,65092,7227,57865,57865,0,10,7551000.0
7551,7551999,21.81273270230927,38.31974779536043,0.048327311336408774,1492.491583108902,490.2841260433197,1884.197769165039,65106,7228,57878,57878,0,10,7552000.0
7552,7552999,21.813011257323733,38.31941129514486,0.04831269111717407,1492.763837814331,490.3463008403778,1884.476848602295,65119,7229,57890,57890,0,10,7553000.0
7553,7553999,21.8131409847931,38.31869606719441,0.048293864422954136,1492.8881106376648,490.41073751449585,1884.7777709960938,65119,7229,57890,57890,0,10,7554000.0
7554,7554999,21.813396954882116,38.318138697553124,0.04827236645806743,1493.1563744544983,490.4737367630005,1885.0563011169434,65133,7230,57903,57903,0,10,7555000.0
7555,7555999,21.813504820622924,38.31713328147874,0.04825213993115263,1493.4289190769196,490.53651332855225,1885.275535583496,65145,7231,57914,57914,0,10,7556000.0
7556,7556999,21.813759249397517,38.31655359844086,0.048230971026251956,1493.566559791565,490.6001703739166,1885.6558227539062,65147,7231,57916,57916,0,10,7557000.0
7557,7557999,21.81408260256862,38.31587670217811,0.04820375074150829,1493.8303153514862,490.66332817077637,1885.9601783752441,65159,7232,57927,57927,0,10,7558000.0
7558,7558999,21.814393063591403,38.31489824492374,0.04817404427259109,1494.2519581317902,490.7268178462982,1886.2085876464844,65185,7234,57951,57951,0,10,7559000.0
7559,7559999,21.814786305505045,38.31436544951733,0.04814716928134832,1494.3739705085754,490.78958773612976,1886.4195518493652,65185,7234,57951,57951,0,10,7560000.0
7560,7560999,21.8149224116465,38.31326295834889,0.048124688000195204,1494.4975028038025,490.8529784679413,1886.6253623962402,65185,7234,57951,57951,0,10,7561000.0
7561,7561999,21.814918931906146,38.31199336092988,0.04810779438396573,1494.7732939720154,490.91618299484253,1886.8613395690918,65199,7235,57964,57964,0,10,7562000.0
7562,7562999,21.81468062102048,38.31076314865728,0.048097668756933,1494.9087538719177,490.9790961742401,1887.54487991333,65210,7235,57975,57975,0,10,7563000.0
7563,7563999,21.813978962068262,38.309874618627425,0.048090586082110365,1495.3378148078918,491.04340863227844,1888.1120223999023,65236,7237,57999,57999,0,10,7564000.0
7564,7564999,21.81313688887623,38.30863786213713,0.04808848863079174,1495.7587821483612,491.10811972618103,1888.4765090942383,65254,7239,58015,58015,0,10,7565000.0
7565,7565999,21.81250007545712,38.30718407253677,0.04808738169492577,1495.8830451965332,491.17212557792664,1888.8925476074219,65256,7239,58017,58017,0,10,7566000.0
7566,7566999,21.811849450702866,38.30572731789304,0.04808527686966557,1496.3195497989655,491.23853302001953,1889.2105712890625,65269,7241,58028,58028,0,10,7567000.0
7567,7567999,21.81130296790709,38.30433518543195,0.04808184041800201,1496.7402544021606,491.30296754837036,1889.556926727295,65293,7243,58050,58050,0,10,7568000.0
7568,7568999,21.810607262448887,38.30268869244341,0.048079186448635514,1496.865746498108,491.3705747127533,1890.0178871154785,65296,7243,58053,58053,0,10,7569000.0
7569,7569999,21.810030752738527,38.30134765326009,0.04807755370981548,1496.9895884990692,491.43602681159973,1890.4546012878418,65299,7243,58056,58056,0,10,7570000.0
7570,7570999,21.809426273447237,38.30014841623423,0.04807581481965417,1497.2567393779755,491.5001120567322,1890.6637535095215,65311,7244,58067,58067,0,10,7571000.0
7571,7571999,21.80896285703023,38.298542098323274,0.048069669773426194,1497.3773820400238,491.5630877017975,1890.9947967529297,65312,7244,58068,58068,0,10,7572000.0
7572,7572999,21.80873466033403,38.29752610648851,0.04805793600191055,1497.788963317871,491.6265380382538,1891.2623138427734,65337,7246,58091,58091,0,10,7573000.0
7573,7573999,21.808331296063265,38.29611718121374,0.048047162415823186,1497.907787322998,491.6893241405487,1891.505039215088,65338,7246,58092,58092,0,10,7574000.0
7574,7574999,21.80797601913446,38.29501959188497,0.04803827688756812,1498.3401153087616,491.75453782081604,1891.7356185913086,65364,7248,58116,58116,0,10,7575000.0
7575,7575999,21.807908083908245,38.293947914061064,0.04802888085945789,1498.6158010959625,491.8189842700958,1892.0585136413574,65378,7249,58129,58129,0,10,7576000.0
7576,7576999,21.80836651609864,38.29507352789005,0.04801633967680774,1498.737089395523,491.88076972961426,1892.3528022766113,65378,7249,58129,58129,0,10,7577000.0
7577,7577999,21.809473249207286,38.29696367303729,0.048008592885806056,1499.159524679184,491.9442729949951,1892.476936340332,65392,7251,58141,58141,0,10,7578000.0
7578,7578999,21.810598048297614,38.29991014029565,0.04799035628931092,1499.2832849025726,492.00773072242737,1892.8477935791016,65394,7251,58143,58143,0,10,7579000.0
7579,7579999,21.811860284914285,38.30576953808402,0.04799118638671329,1499.5604770183563,492.07008504867554,1893.1491355895996,65407,7252,58155,58155,0,10,7580000.0
7580,7580999,21.812550574478873,38.30734287269805,0.04797760503095472,1499.8371880054474,492.1358337402344,1893.3880920410156,65411,7253,58158,58158,0,10,7581000.0
7581,7581999,21.813344537577564,38.30898693670183,0.04797109268540134,1500.2608921527863,492.20022439956665,1893.7609825134277,65441,7255,58186,58186,0,10,7582000.0
7582,7582999,21.812733540091074,38.30780005378708,0.04796544313603868,1500.6785073280334,492.2635397911072,1894.839023590088,65468,7257,58211,58211,0,10,7583000.0
7583,7583999,21.812293174809113,38.307513703959145,0.04796019245311878,1500.8071477413177,492.32702469825745,1895.4605178833008,65469,7257,58212,58212,0,10,7584000.0
7584,7584999,21.81200482917697,38.30718205318742,0.047952723914860385,1501.22128200531,492.389817237854,1895.8078498840332,65493,7259,58234,58234,0,10,7585000.0
7585,7585999,21.811670092526047,38.30662231472693,0.04794442087716744,1501.5267317295074,492.46038794517517,1896.0598030090332,65505,7260,58245,58245,0,10,7586000.0
7586,7586999,21.811361615693535,38.30563645155187,0.04793785612956847,1501.6659564971924,492.532443523407,1896.410888671875,65506,7260,58246,58246,0,10,7587000.0
7587,7587999,21.81114443917894,38.30502009197709,0.0479354610595637,1501.9531621932983,492.5960383415222,1896.6537246704102,65519,7261,58258,58258,0,10,7588000.0
7588,7588999,21.811043537318596,38.3047807716716,0.04793202566555166,1502.0746870040894,492.6598663330078,1896.9569091796875,65521,7261,58260,58260,0,10,7589000.0
7589,7589999,21.81125825802708,38.30522506233718,0.04792879483598689,1502.4933006763458,492.7235186100006,1897.064796447754,65539,7263,58276,58276,0,10,7590000.0
7590,7590999,21.812031025571237,38.30704025036406,0.04792519182391397,1502.6194455623627,492.78549337387085,1897.4544143676758,65540,7263,58277,58277,0,10,7591000.0
7591,7591999,21.812966767172043,38.309013356088045,0.047919138397788275,1502.757800579071,492.8617653846741,1897.7786598205566,65542,7263,58279,58279,0,10,7592000.0
7592,7592999,21.813807164353932,38.31080970735389,0.047929020091347696,1503.1688494682312,492.9250180721283,1897.8866386413574,65565,7265,58300,58300,0,10,7593000.0
7593,7593999,21.81505330522847,38.31326795936295,0.047937733039056685,1503.2939245700836,492.9883008003235,1898.165756225586,65567,7265,58302,58302,0,10,7594000.0
7594,7594999,21.81654677443624,38.31626290824094,0.04794302090750402,1503.7205319404602,493.0530209541321,1898.3650550842285,65590,7267,58323,58323,0,10,7595000.0
7595,7595999,21.818448020161117,38.3202666477817,0.04796205487472893,1503.843789100647,493.1159725189209,1898.6566162109375,65592,7267,58325,58325,0,10,7596000.0
7596,7596999,21.820516422651238,38.32454081246663,0.04797121607977328,1504.1156494617462,493.17843556404114,1898.8400650024414,65594,7268,58326,58326,0,10,7597000.0
7597,7597999,21.822156079507632,38.327220494407875,0.04799075296841926,1504.5431940555573,493.2440857887268,1899.2636184692383,65603,7270,58333,58333,0,10,7598000.0
7598,7598999,21.82358558677211,38.32929764519203,0.048011130273998726,1504.8154945373535,493.3074767589569,1899.7022285461426,65616,7271,58345,58345,0,10,7599000.0
7599,7599999,21.82540507777778,38.3319256642312,0.04802144904674577,1504.9357087612152,493.3703546524048,1900.0506172180176,65618,7271,58347,58347,0,10,7600000.0
7600,7600999,21.826272673331395,38.33306580929587,0.048034721309372586,1505.0576598644257,493.43345165252686,1900.3210525512695,65618,7271,58347,58347,0,10,7601000.0
7601,7601999,21.826145412612345,38.33333728942956,0.04802314860204082,1505.1932430267334,493.4977798461914,1901.5137786865234,65636,7271,58365,58365,0,10,7602000.0
7602,7602999,21.825620327846483,38.33243751569126,0.0480119035519716,1505.4629046916962,493.56178736686707,1902.1583099365234,65653,7272,58381,58381,0,10,7603000.0
7603,7603999,21.825284309488424,38.33151682321163,0.047998014440069015,1505.599276304245,493.62523221969604,1902.5947074890137,65654,7272,58382,58382,0,10,7604000.0
7604,7604999,21.82518563763458,38.3315310343977,0.04798333641644115,1505.7376508712769,493.69150042533875,1903.0656280517578,65655,7272,58383,58383,0,10,7605000.0
7605,7605999,21.824812842417103,38.33049011491551,0.04797585723471143,1506.0220720767975,493.7556166648865,1903.3819389343262,65665,7273,58392,58392,0,10,7606000.0
7606,7606999,21.824433902312812,38.329259264560775,0.04796312888733312,1506.5931959152222,493.8197784423828,1903.492301940918,65694,7276,58418,58418,0,10,7607000.0
7607,7607999,21.824063736269974,38.3279230430688,0.047953643169300286,1506.7189044952393,493.88390946388245,1903.8163833618164,65694,7276,58418,58418,0,10,7608000.0
7608,7608999,21.82391658718504,38.32718234362532,0.04794194423257103,1507.1424055099487,493.94919776916504,1904.1695594787598,65713,7278,58435,58435,0,10,7609000.0
7609,7609999,21.823691744983684,38.32607259930795,0.047932359364521004,1507.2602007389069,494.01123881340027,1904.5022811889648,65715,7278,58437,58437,0,10,7610000.0
7610,7610999,21.82345896139047,38.32497797183707,0.04792148636697535,1507.5297644138336,494.07319712638855,1904.704978942871,65717,7279,58438,58438,0,10,7611000.0
7611,7611999,21.823074754303132,38.32375327102015,0.0479159495446867,1507.6652209758759,494.1353578567505,1904.9931106567383,65717,7279,58438,58438,0,10,7612000.0
7612,7612999,21.82285852135935,38.32290186774981,0.047911646038908295,1507.949450969696,494.19968128204346,1905.101734161377,65729,7280,58449,58449,0,10,7613000.0
7613,7613999,21.822713230006826,38.322046814177824,0.04790650540232977,1508.3724648952484,494.26101994514465,1905.349811553955,65750,7282,58468,58468,0,10,7614000.0
7614,7614999,21.822624659993725,38.3212040540872,0.047903846263608996,1508.5072934627533,494.3256652355194,1905.6782531738281,65751,7282,58469,58469,0,10,7615000.0
7615,7615999,21.82261048734762,38.3203730227831,0.04790616827932048,1508.641014099121,494.3909728527069,1905.9820709228516,65753,7282,58471,58471,0,10,7616000.0
7616,7616999,21.82276315295895,38.31966001721339,0.047912136924555204,1508.7649652957916,494.45463466644287,1906.2686042785645,65753,7282,58471,58471,0,10,7617000.0
7617,7617999,21.823297275396403,38.319751897113896,0.04791003545742112,1509.0440237522125,494.5178894996643,1906.5896377563477,65767,7283,58484,58484,0,10,7618000.0
7618,7618999,21.823676060116608,38.32046518605182,0.047906106622554345,1509.1750655174255,494.5801033973694,1906.898422241211,65769,7283,58486,58486,0,10,7619000.0
7619,7619999,21.824017779529388,38.32019561269534,0.047909283447076234,1509.4378578662872,494.643501996994,1907.1542472839355,65781,7284,58497,58497,0,10,7620000.0
7620,7620999,21.823987392399335,38.31922839924533,0.04790845732274829,1509.5737833976746,494.7087941169739,1907.4689178466797,65783,7284,58499,58499,0,10,7621000.0
7621,7621999,21.82364567886977,38.31843128789237,0.04789523388890915,1509.8660018444061,494.77572870254517,1908.6676406860352,65826,7285,58541,58541,0,10,7622000.0
7622,7622999,21.823288632988238,38.31803876875323,0.04788354622310853,1510.2881529331207,494.8401372432709,1909.5828742980957,65861,7287,58574,58574,0,10,7623000.0
7623,7623999,21.822807478556914,38.3167866111502,0.047876358350674275,1510.7121078968048,494.90471625328064,1910.140251159668,65888,7289,58599,58599,0,10,7624000.0
7624,7624999,21.822556150623257,38.3164314531651,0.04786985269100774,1510.8331429958344,494.9690315723419,1910.6167488098145,65890,7289,58601,58601,0,10,7625000.0
7625,7625999,21.8221909072016,38.31604981989237,0.04786253767652415,1511.1135923862457,495.0352737903595,1910.9725227355957,65904,7290,58614,58614,0,10,7626000.0
7626,7626999,21.821988262545943,38.315443745520525,0.047854066291105224,1511.5308623313904,495.09918689727783,1911.2669296264648,65931,7292,58639,58639,0,10,7627000.0
7627,7627999,21.82175624921362,38.3145671231684,0.04784802088528939,1511.808195590973,495.16478395462036,1911.682788848877,65938,7293,58645,58645,0,10,7628000.0
7628,7628999,21.821908195887996,38.3145127548761,0.04784142764224186,1512.0781111717224,495.22830986976624,1912.0756568908691,65952,7294,58658,58658,0,10,7629000.0
7629,7629999,21.8220400104977,38.31414716959012,0.04783707088730671,1512.3483142852783,495.29191851615906,1912.4722900390625,65969,7295,58674,58674,0,10,7630000.0
7630,7630999,21.822356243037685,38.3142654059392,0.04785452913900734,1512.4625463485718,495.35468649864197,1912.8295059204102,65971,7295,58676,58676,0,10,7631000.0
7631,7631999,21.822727060827468,38.31408848141452,0.047862309210257914,1512.8896214962006,495.41866302490234,1913.333511352539,65988,7297,58691,58691,0,10,7632000.0
7632,7632999,21.823507707793212,38.31497787324553,0.04788403515795281,1513.0202205181122,495.4853045940399,1913.8221244812012,65992,7297,58695,58695,0,10,7633000.0
7633,7633999,21.82429789682221,38.31554144115754,0.04788794565462362,1513.2940101623535,495.5493359565735,1914.3834953308105,66006,7298,58708,58708,0,10,7634000.0
7634,7634999,21.82511398859594,38.31638591685138,0.04788903125506805,1513.732451915741,495.61358666419983,1914.9838180541992,66031,7300,58731,58731,0,10,7635000.0
7635,7635999,21.825601156848588,38.316547945478916,0.047896634186920806,1513.8495290279388,495.67707443237305,1915.6327667236328,66037,7300,58737,58737,0,10,7636000.0
7636,7636999,21.826129882790248,38.31696440515243,0.04789122183149397,1513.9807243347168,495.7433354854584,1916.7050132751465,66054,7300,58754,58754,0,10,7637000.0
7637,7637999,21.825718153520615,38.317240684418465,0.04788517420575367,1514.1044957637787,495.80712032318115,1917.6672477722168,66065,7300,58765,58765,0,10,7638000.0
7638,7638999,21.82538057902248,38.31717821760369,0.047884210109307324,1514.3795919418335,495.87275290489197,1918.228759765625,66075,7301,58774,58774,0,10,7639000.0
7639,7639999,21.824849414120447,38.317203354788674,0.04788169663460906,1514.8017268180847,495.9361448287964,1918.5734825134277,66093,7303,58790,58790,0,10,7640000.0
7640,7640999,21.824138178635692,38.31574814186531,0.04788440743706801,1514.9203071594238,496.0007848739624,1918.9922142028809,66094,7303,58791,58791,0,10,7641000.0
7641,7641999,21.82360154465824,38.31461658473848,0.047884370275020016,1515.034438610077,496.06229043006897,1919.354721069336,66094,7303,58791,58791,0,10,7642000.0
7642,7642999,21.82300742724756,38.3132871297426,0.04788383497317139,1515.3072912693024,496.12474513053894,1919.6532135009766,66097,7304,58793,58793,0,10,7643000.0
7643,7643999,21.8224211936162,38.3118831305494,0.04788488605349206,1516.0384550094604,496.18688130378723,1919.6642532348633,66144,7308,58836,58836,0,10,7644000.0
7644,7644999,21.822072105149118,38.310965677534114,0.04788204516214101,1516.324144601822,496.2497045993805,1919.9408721923828,66156,7309,58847,58847,0,10,7645000.0
7645,7645999,21.82151188695249,38.30955023318729,0.04787971737490482,1516.4400734901428,496.3129496574402,1920.3794250488281,66157,7309,58848,58848,0,10,7646000.0
7646,7646999,21.821160213457613,38.30889074027106,0.047874085475991035,1516.718729019165,496.3754725456238,1920.613510131836,66168,7310,58858,58858,0,10,7647000.0
7647,7647999,21.820629881738906,38.30763600230513,0.04787097736548784,1517.15349650383,496.4390366077423,1920.832836151123,66193,7312,58881,58881,0,10,7648000.0
7648,7648999,21.82004716538093,38.30616290469845,0.04786863437270816,1517.4270520210266,496.5031056404114,1921.2621040344238,66203,7313,58890,58890,0,10,7649000.0
7649,7649999,21.81967048196694,38.305137388808134,0.04786389590826101,1517.5470089912415,496.5652484893799,1921.6460647583008,66204,7313,58891,58891,0,10,7650000.0
7650,7650999,21.819292779179108,38.304092927139976,0.04785968409005614,1517.9680993556976,496.62781047821045,1921.8138618469238,66228,7315,58913,58913,0,10,7651000.0
7651,7651999,21.818829865306984,38.30288924390324,0.04785585376025936,1518.2482481002808,496.68974232673645,1922.1500968933105,66241,7316,58925,58925,0,10,7652000.0
7652,7652999,21.818560164555674,38.30194910909413,0.047849060668721854,1518.5185205936432,496.7516779899597,1922.3396644592285,66252,7317,58935,58935,0,10,7653000.0
7653,7653999,21.81831472965053,38.30102045762154,0.04784647324301383,1518.9546976089478,496.8166153430939,1922.4957656860352,66258,7319,58939,58939,0,10,7654000.0
7654,7654999,21.81792574581362,38.29981919180226,0.04784442698832314,1519.5415532588959,496.8806211948395,1922.5632438659668,66292,7322,58970,58970,0,10,7655000.0
7655,7655999,21.81844400147067,38.30351560867711,0.04780683640077399,1519.9756453037262,496.9464302062988,1923.5382766723633,66342,7324,59018,59018,0,10,7656000.0
7656,7656999,21.81852185094286,38.303628151000346,0.04778610648256598,1520.2510995864868,497.00982189178467,1924.0077743530273,66346,7325,59021,59021,0,10,7657000.0
7657,7657999,21.81838633867096,38.30367057815872,0.04778126448316944,1520.5285410881042,497.07364797592163,1924.2826499938965,66358,7326,59032,59032,0,10,7658000.0
7658,7658999,21.818321949550924,38.302921646495335,0.0477714754358437,1520.6565680503845,497.13723850250244,1924.7086753845215,66358,7326,59032,59032,0,10,7659000.0
7659,7659999,21.818579739235094,38.30302585695334,0.04777116487525468,1520.9335930347443,497.20211720466614,1924.943359375,66365,7327,59038,59038,0,10,7660000.0
7660,7660999,21.81919224259285,38.30357425430619,0.04776697139947317,1521.0563142299652,497.2652244567871,1925.2662544250488,66365,7327,59038,59038,0,10,7661000.0
7661,7661999,21.81989970734766,38.30413778014002,0.04776962281130526,1521.1762962341309,497.3271806240082,1925.4856224060059,66365,7327,59038,59038,0,10,7662000.0
7662,7662999,21.82076287214452,38.305282779125065,0.04777352863560569,1521.3070459365845,497.39018201828003,1925.7232551574707,66365,7327,59038,59038,0,10,7663000.0
7663,7663999,21.821479256346727,38.305979408602994,0.04777278720871436,1521.4318509101868,497.45456194877625,1926.0218467712402,66365,7327,59038,59038,0,10,7664000.0
7664,7664999,21.822418377479647,38.30676744191951,0.04778232728976861,1521.8753986358643,497.5190556049347,1926.1078643798828,66389,7329,59060,59060,0,10,7665000.0
7665,7665999,21.82332240007207,38.30820322282355,0.04779566211040587,1522.160076379776,497.5822207927704,1926.3074760437012,66394,7330,59064,59064,0,10,7666000.0
7666,7666999,21.824505443603496,38.3105831797141,0.04780947774443378,1522.4444828033447,497.645644903183,1926.518440246582,66406,7331,59075,59075,0,10,7667000.0
7667,7667999,21.825328021761205,38.31139719202683,0.0478290696172583,1523.015290737152,497.7101528644562,1926.5634651184082,66452,7334,59118,59118,0,10,7668000.0
7668,7668999,21.82703295864257,38.314281280723314,0.04785927784431809,1523.459757566452,497.7751536369324,1926.803310394287,66477,7336,59141,59141,0,10,7669000.0
7669,7669999,21.82825593959,38.31580497267793,0.047892416824080075,1523.5963697433472,497.8471176624298,1927.1420822143555,66478,7336,59142,59142,0,10,7670000.0
7670,7670999,21.829857203660005,38.318265296163844,0.047929154569550825,1523.7223439216614,497.9118390083313,1927.4166259765625,66478,7336,59142,59142,0,10,7671000.0
7671,7671999,21.83171511787967,38.321739872278876,0.04797144314252255,1524.1434450149536,497.9751064777374,1927.4709663391113,66501,7338,59163,59163,0,10,7672000.0
7672,7672999,21.833422361068706,38.324391028014304,0.04800438769926574,1524.4179158210754,498.0379514694214,1927.6755981445312,66503,7339,59164,59164,0,10,7673000.0
7673,7673999,21.83479926130704,38.32629143255676,0.048046881789666096,1524.70308303833,498.10052514076233,1927.9270477294922,66516,7340,59176,59176,0,10,7674000.0
7674,7674999,21.83542731981542,38.32718941359981,0.04804960116765111,1524.8351755142212,498.16401505470276,1928.5621871948242,66521,7340,59181,59181,0,10,7675000.0
7675,7675999,21.835022780603648,38.32651621030308,0.04804842280351884,1525.2608671188354,498.22744822502136,1929.2337608337402,66542,7342,59200,59200,0,10,7676000.0
7676,7676999,21.83467883806486,38.326135531873724,0.048051294523685284,1525.383507013321,498.290771484375,1929.729793548584,66547,7342,59205,59205,0,10,7677000.0
7677,7677999,21.834550931880543,38.32612134809432,0.048049087275356284,1525.503371477127,498.3554174900055,1930.1901168823242,66548,7342,59206,59206,0,10,7678000.0
7678,7678999,21.834346889836265,38.325336822648396,0.04804840658706622,1525.9216253757477,498.4182620048523,1930.6858139038086,66565,7344,59221,59221,0,10,7679000.0
7679,7679999,21.834436764151857,38.32520222523137,0.048057612893145474,1526.352597951889,498.48353457450867,1930.9405403137207,66589,7346,59243,59243,0,10,7680000.0
7680,7680999,21.834572115258418,38.324773519999184,0.04806199823133994,1526.7761583328247,498.54657554626465,1931.2570533752441,66600,7348,59252,59252,0,10,7681000.0
7681,7681999,21.834670098112248,38.32482552846959,0.04806589536946182,1527.3544738292694,498.6103615760803,1931.5594291687012,66637,7351,59286,59286,0,10,7682000.0
7682,7682999,21.834989775595787,38.325109933883105,0.0480742391181892,1527.7764806747437,498.6730465888977,1931.9090270996094,66661,7353,59308,59308,0,10,7683000.0
7683,7683999,21.8356085851263,38.32622186574635,0.04808769239050237,1527.9036030769348,498.73788356781006,1932.2561340332031,66661,7353,59308,59308,0,10,7684000.0
7684,7684999,21.836237554978986,38.326851406983465,0.048103706663549795,1528.3204715251923,498.8005828857422,1932.4934768676758,66682,7355,59327,59327,0,10,7685000.0
7685,7685999,21.836861191700535,38.327602934368706,0.04811662987061416,1528.7632460594177,498.86517238616943,1932.7623100280762,66703,7357,59346,59346,0,10,7686000.0
7686,7686999,21.837486903219382,38.328074972515445,0.04812968586460409,1529.1838097572327,498.9287552833557,1932.9568634033203,66728,7359,59369,59369,0,10,7687000.0
7687,7687999,21.838528332091713,38.329537012228336,0.048156675111934444,1529.7594876289368,498.99328351020813,1933.3096313476562,66755,7362,59393,59393,0,10,7688000.0
7688,7688999,21.83965260783124,38.330707230594726,0.048185365879741315,1530.4926216602325,499.0574953556061,1933.5225257873535,66794,7366,59428,59428,0,10,7689000.0
7689,7689999,21.840671013002137,38.33202922049889,0.048200383221083554,1530.9411871433258,499.1211943626404,1933.8073463439941,66817,7368,59449,59449,0,10,7690000.0
7690,7690999,21.841598195857156,38.332953601125816,0.04822437729141982,1531.2158768177032,499.1846213340759,1934.0101165771484,66829,7369,59460,59460,0,10,7691000.0
7691,7691999,21.842312907898567,38.333386221594154,0.04823608394435597,1531.4939651489258,499.24772024154663,1934.355339050293,66832,7370,59462,59462,0,10,7692000.0
7692,7692999,21.842563993983266,38.333136112218696,0.04824105365952969,1531.9155943393707,499.31123328208923,1934.622184753418,66845,7372,59473,59473,0,10,7693000.0
7693,7693999,21.84221165026017,38.332383720207424,0.04823724925705486,1532.3469607830048,499.374653339386,1935.7982635498047,66887,7374,59513,59513,0,10,7694000.0
7694,7694999,21.841387623763264,38.332680052625804,0.04823287391061837,1532.6209063529968,499.4402070045471,1936.5642204284668,66898,7375,59523,59523,0,10,7695000.0
7695,7695999,21.840666801994487,38.332317814738374,0.048232981243267026,1532.9131126403809,499.5061995983124,1937.0556907653809,66911,7376,59535,59535,0,10,7696000.0
7696,7696999,21.839812683071997,38.331019537418776,0.04823212019538892,1533.3366034030914,499.57182002067566,1937.4721717834473,66926,7378,59548,59548,0,10,7697000.0
7697,7697999,21.839128302417564,38.329942061611845,0.04822695772395458,1533.6084005832672,499.6351706981659,1937.7919006347656,66935,7379,59556,59556,0,10,7698000.0
7698,7698999,21.838536434030164,38.3287097100478,0.04822707688476924,1534.039353609085,499.6995825767517,1938.0209197998047,66954,7381,59573,59573,0,10,7699000.0
7699,7699999,21.837901491066773,38.32733221606947,0.04823148887576478,1534.469275712967,499.7639842033386,1938.317584991455,66977,7383,59594,59594,0,10,7700000.0
7700,7700999,21.837263180855896,38.32608941153635,0.048234080932958334,1534.5853395462036,499.82720470428467,1938.6661224365234,66978,7383,59595,59595,0,10,7701000.0
7701,7701999,21.837056535543685,38.326085544268246,0.04823119073893589,1534.8588604927063,499.8922851085663,1938.9660606384277,66991,7384,59607,59607,0,10,7702000.0
7702,7702999,21.83704699831979,38.32576062718151,0.04823318808110133,1535.139416217804,499.95591735839844,1939.0830993652344,66998,7385,59613,59613,0,10,7703000.0
7703,7703999,21.836799965805092,38.32518031424414,0.04824307893245616,1535.2564420700073,500.019095659256,1939.3945388793945,66998,7385,59613,59613,0,10,7704000.0
7704,7704999,21.836803032878457,38.32524994101478,0.048246638914745676,1535.6884303092957,500.0833320617676,1939.5400314331055,67042,7387,59655,59655,0,10,7705000.0
7705,7705999,21.836889803054294,38.325028676082646,0.04825914467779446,1535.9978494644165,500.1540687084198,1939.752182006836,67054,7388,59666,59666,0,10,7706000.0
7706,7706999,21.837503526743422,38.32599221835796,0.04826793798796891,1536.1232669353485,500.21593856811523,1940.177017211914,67054,7388,59666,59666,0,10,7707000.0
7707,7707999,21.837983587177426,38.32645208520364,0.04827586374437853,1536.395761013031,500.27822947502136,1940.5226707458496,67057,7389,59668,59668,0,10,7708000.0
7708,7708999,21.838803686081214,38.32731132706676,0.04827946732248656,1536.515711069107,500.3414235115051,1940.9430694580078,67060,7389,59671,59671,0,10,7709000.0
7709,7709999,21.83977351912824,38.32828210975034,0.04828608270584822,1536.7816433906555,500.4053590297699,1941.1351699829102,67072,7390,59682,59682,0,10,7710000.0
7710,7710999,21.840149959698678,38.32820519042642,0.04829393543013849,1537.210568189621,500.4693748950958,1941.334644317627,67095,7392,59703,59703,0,10,7711000.0
7711,7711999,21.840593172865137,38.328651668892824,0.0482952115969274,1537.776437997818,500.5319309234619,1941.5275535583496,67133,7395,59738,59738,0,10,7712000.0
7712,7712999,21.84032384404154,38.32765310893667,0.04829398459617851,1537.899911403656,500.5970342159271,1942.3512382507324,67145,7395,59750,59750,0,10,7713000.0
7713,7713999,21.83963524970771,38.32749328449061,0.04829178048089955,1538.0270092487335,500.66067481040955,1943.0259094238281,67150,7395,59755,59755,0,10,7714000.0
7714,7714999,21.839017281481134,38.32678894413143,0.0482889741470256,1538.1574091911316,500.72516560554504,1943.434799194336,67152,7395,59757,59757,0,10,7715000.0
7715,7715999,21.838351296652128,38.32581571158061,0.04828780605642624,1538.2950656414032,500.78830194473267,1943.80269241333,67152,7395,59757,59757,0,10,7716000.0
7716,7716999,21.8376075260118,38.32442617354248,0.04828792912726976,1538.8720660209656,500.8529529571533,1943.9087562561035,67188,7398,59790,59790,0,10,7717000.0
7717,7717999,21.837245181645404,38.32400028631669,0.04828361740958442,1539.3022401332855,500.9157204627991,1944.016414642334,67202,7400,59802,59802,0,10,7718000.0
7718,7718999,21.83659634457376,38.3226720098397,0.04827729226009769,1539.4377481937408,500.97976994514465,1944.3639907836914,67202,7400,59802,59802,0,10,7719000.0
7719,7719999,21.83622077818986,38.32172332070315,0.04827475979681173,1539.718917608261,501.04302191734314,1944.5703010559082,67214,7401,59813,59813,0,10,7720000.0
7720,7720999,21.835599215486003,38.32043647622159,0.048274768154907166,1539.854564189911,501.1176497936249,1944.7741317749023,67214,7401,59813,59813,0,10,7721000.0
7721,7721999,21.83512056625009,38.31926990670832,0.04827409186556775,1540.28546500206,501.18116188049316,1944.9000816345215,67236,7403,59833,59833,0,10,7722000.0
7722,7722999,21.83470778227522,38.31808001981017,0.04827226920056882,1540.7191262245178,501.2443106174469,1945.028938293457,67255,7405,59850,59850,0,10,7723000.0
7723,7723999,21.834328922002104,38.31697231026463,0.04826375402203331,1541.0074062347412,501.31040930747986,1945.1124534606934,67257,7406,59851,59851,0,10,7724000.0
7724,7724999,21.8338562698808,38.31584901344416,0.04826196953325024,1541.75723695755,501.3746190071106,1945.1095085144043,67299,7410,59889,59889,0,10,7725000.0
7725,7725999,21.83370332530098,38.31529513098247,0.048256787082441854,1541.8804879188538,501.43713450431824,1945.4656524658203,67300,7410,59890,59890,0,10,7726000.0
7726,7726999,21.833581100588344,38.315004236138634,0.0482484648753807,1542.0020871162415,501.50134110450745,1945.6786766052246,67300,7410,59890,59890,0,10,7727000.0
7727,7727999,21.833518032775878,38.31430069470853,0.04824196224850519,1542.2811512947083,501.56587314605713,1945.9565200805664,67312,7411,59901,59901,0,10,7728000.0
7728,7728999,21.83341630477245,38.31363255147652,0.04823486530875176,1542.7075777053833,501.6300365924835,1946.1933135986328,67337,7413,59924,59924,0,10,7729000.0
7729,7729999,21.833452128485153,38.31309374437081,0.04823037045618839,1542.984120130539,501.6933743953705,1946.3721313476562,67339,7414,59925,59925,0,10,7730000.0
7730,7730999,21.833241587358017,38.31209171000765,0.04822595773292826,1543.588797569275,501.75753903388977,1946.6678657531738,67372,7417,59955,59955,0,10,7731000.0
7731,7731999,21.832923847170584,38.310884662864694,0.04822119146857262,1544.0125217437744,501.82016468048096,1946.9436569213867,67389,7419,59970,59970,0,10,7732000.0
7732,7732999,21.832389615972932,38.30969562420733,0.04821923793822658,1544.608387708664,501.8868112564087,1947.9687995910645,67423,7422,60001,60001,0,10,7733000.0
7733,7733999,21.83131730115555,38.30789710139064,0.048222897559407674,1544.733145236969,501.9508845806122,1948.8239364624023,67430,7422,60008,60008,0,10,7734000.0
7734,7734999,21.830295262940105,38.306257089091815,0.04822425297580113,1545.005396604538,502.0153098106384,1949.403377532959,67444,7423,60021,60021,0,10,7735000.0
7735,7735999,21.82964486508239,38.30553942830634,0.04822248579469701,1545.1271138191223,502.0791094303131,1949.9181060791016,67444,7423,60021,60021,0,10,7736000.0
7736,7736999,21.82904644694637,38.30444399951618,0.04822970616575184,1545.4069874286652,502.1431519985199,1950.2773208618164,67447,7424,60023,60023,0,10,7737000.0
7737,7737999,21.828564188244165,38.303826786631845,0.048239451746403095,1545.542375087738,502.2068281173706,1950.6365966796875,67447,7424,60023,60023,0,10,7738000.0
7738,7738999,21.82811576135285,38.303391769548206,0.04823562242565049,1545.826896429062,502.2708170413971,1951.0587730407715,67460,7425,60035,60035,0,10,7739000.0
7739,7739999,21.827891324577813,38.30350165041324,0.048229908964619095,1545.9502067565918,502.33658814430237,1951.4890098571777,67461,7425,60036,60036,0,10,7740000.0
7740,7740999,21.827611555669407,38.30339906931655,0.04822572330790664,1546.2324831485748,502.4016361236572,1951.7735557556152,67472,7426,60046,60046,0,10,7741000.0
7741,7741999,21.827490976085894,38.30439907921492,0.04822055978976858,1546.50635099411,502.4655828475952,1952.135341644287,67476,7427,60049,60049,0,10,7742000.0
7742,7742999,21.82784120475284,38.30589926546268,0.04821041638523382,1546.8053450584412,502.53975009918213,1952.454532623291,67492,7428,60064,60064,0,10,7743000.0
7743,7743999,21.82782947050591,38.305825566410135,0.04820730330311951,1546.9261758327484,502.6030533313751,1952.7375450134277,67493,7428,60065,60065,0,10,7744000.0
7744,7744999,21.82786851804449,38.3060074014848,0.04820508488308284,1547.370997428894,502.66780519485474,1953.052661895752,67514,7430,60084,60084,0,10,7745000.0
7745,7745999,21.82850404475861,38.30807554717195,0.04820247172172176,1547.4927265644073,502.7318124771118,1953.4568061828613,67516,7430,60086,60086,0,10,7746000.0
7746,7746999,21.828965158177457,38.31019833208475,0.04818703420588111,1547.617820739746,502.79389691352844,1953.8119773864746,67516,7430,60086,60086,0,10,7747000.0
7747,7747999,21.829209155655743,38.31046538259006,0.04818439336164293,1547.9023113250732,502.8578517436981,1954.0844345092773,67528,7431,60097,60097,0,10,7748000.0
7748,7748999,21.82982824858006,38.31132453953822,0.04818312028997351,1548.024253129959,502.92092204093933,1954.6814575195312,67531,7431,60100,60100,0,10,7749000.0
7749,7749999,21.83033415869213,38.31162372183408,0.04818223834654556,1548.3147745132446,502.9867367744446,1954.9348754882812,67543,7432,60111,60111,0,10,7750000.0
7750,7750999,21.830960106868744,38.31192938319705,0.048185621747130813,1548.5968255996704,503.05056715011597,1955.1813354492188,67556,7433,60123,60123,0,10,7751000.0
7751,7751999,21.83126288880417,38.31185927637875,0.048185420862260964,1548.8662545681,503.11279344558716,1955.5353927612305,67561,7434,60127,60127,0,10,7752000.0
7752,7752999,21.831197758150473,38.31154513432373,0.048172554987330196,1548.9880249500275,503.1768968105316,1956.6008186340332,67579,7434,60145,60145,0,10,7753000.0
7753,7753999,21.830847833320398,38.31108644074489,0.04816292770496089,1549.2649343013763,503.2401165962219,1957.2478828430176,67594,7435,60159,60159,0,10,7754000.0
7754,7754999,21.83035363466192,38.30992723270625,0.04816369567363654,1549.6840407848358,503.3049511909485,1957.5764274597168,67611,7437,60174,60174,0,10,7755000.0
7755,7755999,21.829934222796624,38.30882523457481,0.048167504638579106,1549.7997040748596,503.3672058582306,1957.9903411865234,67612,7437,60175,60175,0,10,7756000.0
7756,7756999,21.829485320019664,38.307619695203,0.04816353910260551,1550.2205893993378,503.430139541626,1958.2559509277344,67632,7439,60193,60193,0,10,7757000.0
7757,7757999,21.82910626389654,38.3065502305149,0.04816052028422435,1550.7999215126038,503.4932050704956,1958.4114112854004,67658,7442,60216,60216,0,10,7758000.0
7758,7758999,21.828516444773673,38.305199556691605,0.04815891739352551,1551.1067700386047,503.56131529808044,1958.8158798217773,67672,7443,60229,60229,0,10,7759000.0
7759,7759999,21.82807011407623,38.304140023120645,0.048154751253403294,1551.2266945838928,503.62494254112244,1959.1777534484863,67673,7443,60230,60230,0,10,7760000.0
7760,7760999,21.827986936810316,38.30341099743139,0.048149487071631136,1551.344332933426,503.68917655944824,1959.5270195007324,67677,7443,60234,60234,0,10,7761000.0
7761,7761999,21.827727190562833,38.30233025609376,0.048144475558133504,1551.4632315635681,503.75230956077576,1959.8152046203613,67677,7443,60234,60234,0,10,7762000.0
7762,7762999,21.827575065405657,38.301331911841054,0.04813536022534204,1552.5147936344147,503.8187849521637,1959.8608360290527,67750,7449,60301,60301,0,10,7763000.0
7763,7763999,21.827692337177695,38.300594751512605,0.04812746897861142,1552.7919430732727,503.8829138278961,1960.1744766235352,67767,7450,60317,60317,0,10,7764000.0
7764,7764999,21.82779904344279,38.299672469372524,0.0481113811571956,1552.9195663928986,503.9458341598511,1960.4983711242676,67767,7450,60317,60317,0,10,7765000.0
7765,7765999,21.827834723444607,38.298663833945966,0.04809797187228004,1553.1939997673035,504.00993180274963,1960.7536735534668,67770,7451,60319,60319,0,10,7766000.0
7766,7766999,21.82768423271159,38.29749616990444,0.04808893679995452,1553.4815452098846,504.07421231269836,1961.0571250915527,67778,7452,60326,60326,0,10,7767000.0
7767,7767999,21.827401205868547,38.297123121590644,0.04808084740919105,1553.7707521915436,504.13866353034973,1961.4817657470703,67805,7453,60352,60352,0,10,7768000.0
7768,7768999,21.8277131974887,38.29987389198778,0.04807804244517888,1553.8972759246826,504.20385909080505,1962.6047096252441,67818,7453,60365,60365,0,10,7769000.0
7769,7769999,21.82779859603166,38.30098138906249,0.048080690180883345,1554.023244857788,504.2678828239441,1963.0955390930176,67819,7453,60366,60366,0,10,7770000.0
7770,7770999,21.827606331243096,38.30075137507963,0.048074343986716506,1554.306937456131,504.33143758773804,1963.4553756713867,67831,7454,60377,60377,0,10,7771000.0
7771,7771999,21.828213718491423,38.30244586223506,0.0480640201439142,1554.4339468479156,504.3954200744629,1963.7915878295898,67832,7454,60378,60378,0,10,7772000.0
7772,7772999,21.828845712814122,38.304224024765404,0.04804964182511695,1555.0435078144073,504.4602599143982,1964.0262603759766,67851,7457,60394,60394,0,10,7773000.0
7773,7773999,21.829357168715767,38.3051555709296,0.04803877922616806,1555.1705875396729,504.5243752002716,1964.4402618408203,67852,7457,60395,60395,0,10,7774000.0
7774,7774999,21.83020195550448,38.3067123404843,0.048032604256697975,1555.4484088420868,504.58858156204224,1964.6440467834473,67857,7458,60399,60399,0,10,7775000.0
7775,7775999,21.831388389078803,38.3108056553505,0.04801577684328062,1555.5771610736847,504.6523187160492,1964.9164581298828,67857,7458,60399,60399,0,10,7776000.0
7776,7776999,21.832442280669778,38.312710574418006,0.04800219649287041,1555.8639523983002,504.71861124038696,1965.1197776794434,67868,7459,60409,60409,0,10,7777000.0
7777,7777999,21.833746522072712,38.31469335098326,0.04799823918157886,1556.1477093696594,504.7812702655792,1965.300796508789,67872,7460,60412,60412,0,10,7778000.0
7778,7778999,21.835165780790987,38.31737160569201,0.047997124043656636,1556.4249584674835,504.8461217880249,1965.5164260864258,67879,7461,60418,60418,0,10,7779000.0
7779,7779999,21.836681055063615,38.320193490423144,0.04799270351997453,1556.5545315742493,504.9090747833252,1965.7231903076172,67880,7461,60419,60419,0,10,7780000.0
7780,7780999,21.838392499834615,38.32338006115263,0.047987564433098484,1556.8319318294525,504.97283959388733,1965.8456764221191,67890,7462,60428,60428,0,10,7781000.0
7781,7781999,21.839860285167813,38.3258913705232,0.04798026498574559,1557.1081156730652,505.03512382507324,1966.0165328979492,67903,7463,60440,60440,0,10,7782000.0
7782,7782999,21.841780909490353,38.329292325574954,0.047980419302952604,1557.5493717193604,505.1011505126953,1966.199836730957,67927,7465,60462,60462,0,10,7783000.0
7783,7783999,21.84312450888516,38.331201562458475,0.04798176901317619,1557.6677181720734,505.16334795951843,1966.4661865234375,67927,7465,60462,60462,0,10,7784000.0
7784,7784999,21.845011997210143,38.334198061241494,0.04798876104549166,1557.9419915676117,505.22396540641785,1966.663661956787,67939,7466,60473,60473,0,10,7785000.0
7785,7785999,21.8462773896124,38.33575235550684,0.04800026483610298,1558.3790638446808,505.28778409957886,1966.8603591918945,67965,7468,60497,60497,0,10,7786000.0
7786,7786999,21.84619455972177,38.334846484265434,0.04799921211711855,1558.5074746608734,505.35223364830017,1968.0077362060547,67985,7468,60517,60517,0,10,7787000.0
7787,7787999,21.84551808826293,38.333743642302416,0.048000794254740686,1558.928547859192,505.4141957759857,1968.4949989318848,68008,7470,60538,60538,0,10,7788000.0
7788,7788999,21.844837906351756,38.332749315801095,0.04799883523078918,1559.2112364768982,505.4799060821533,1968.8209533691406,68021,7471,60550,60550,0,10,7789000.0
7789,7789999,21.84438578573615,38.33211986690443,0.04799752127838752,1559.498517036438,505.5439507961273,1969.2557983398438,68029,7472,60557,60557,0,10,7790000.0
7790,7790999,21.84380116356062,38.33075902001142,0.04799887298503136,1559.9226388931274,505.60828709602356,1969.484462738037,68050,7474,60576,60576,0,10,7791000.0
7791,7791999,21.843453673763015,38.3298781309449,0.048004031519744084,1560.3450934886932,505.67244815826416,1969.7580757141113,68072,7476,60596,60596,0,10,7792000.0
7792,7792999,21.84351346724587,38.32964503531141,0.04801378480013763,1560.78360414505,505.7368495464325,1970.1909446716309,68116,7478,60638,60638,0,10,7793000.0
7793,7793999,21.843875720656946,38.3308994814637,0.04801933875286202,1561.0587561130524,505.80089020729065,1970.6953582763672,68130,7479,60651,60651,0,10,7794000.0
7794,7794999,21.844033593253375,38.330974797866865,0.04802726818477321,1561.1873135566711,505.86538529396057,1971.1392974853516,68130,7479,60651,60651,0,10,7795000.0
7795,7795999,21.844489377985653,38.33166580028211,0.048049141374797766,1561.4635801315308,505.9312400817871,1971.443214416504,68144,7480,60664,60664,0,10,7796000.0
7796,7796999,21.845270585082826,38.334614890149645,0.04805569131733756,1561.7471017837524,505.99618768692017,1971.802677154541,68157,7481,60676,60676,0,10,7797000.0
7797,7797999,21.845679531690127,38.335253156517965,0.04806646197774167,1561.8656661510468,506.0585927963257,1972.1327285766602,68160,7481,60679,60679,0,10,7798000.0
7798,7798999,21.846107464494242,38.3359190651155,0.048071825371538646,1562.466398715973,506.1230056285858,1972.2138175964355,68193,7484,60709,60709,0,10,7799000.0
7799,7799999,21.846609543063792,38.33640209191617,0.04807761275977085,1562.7520489692688,506.18677949905396,1972.6043739318848,68203,7485,60718,60718,0,10,7800000.0
7800,7800999,21.84753665307237,38.33784819198387,0.0480889997590872,1563.0302183628082,506.2508466243744,1972.9517974853516,68217,7486,60731,60731,0,10,7801000.0
7801,7801999,21.848200816400293,38.338542179589496,0.048096997336742,1563.1499950885773,506.3138949871063,1973.3412895202637,68219,7486,60733,60733,0,10,7802000.0
7802,7802999,21.848707226093076,38.33859287523683,0.04809662747893095,1563.2610709667206,506.37562084198,1973.6171836853027,68219,7486,60733,60733,0,10,7803000.0
7803,7803999,21.849295606765672,38.33964418068463,0.048100095696233414,1563.8468379974365,506.43980646133423,1973.7716064453125,68236,7489,60747,60747,0,10,7804000.0
7804,7804999,21.84949993794038,38.33912414725219,0.04810192719367867,1564.4372930526733,506.50377440452576,1973.964942932129,68272,7492,60780,60780,0,10,7805000.0
7805,7805999,21.849475939229944,38.339030909645786,0.04809711069257372,1564.5620951652527,506.56624364852905,1974.9187316894531,68286,7492,60794,60794,0,10,7806000.0
7806,7806999,21.849075040200184,38.34042979225313,0.04808430127971064,1564.8346154689789,506.6299614906311,1975.803783416748,68299,7493,60806,60806,0,10,7807000.0
7807,7807999,21.84846178504266,38.33954661709494,0.048082286578444156,1564.9561607837677,506.6934506893158,1976.4252662658691,68301,7493,60808,60808,0,10,7808000.0
7808,7808999,21.847698906875102,38.3379531971656,0.04808690313678898,1565.3975129127502,506.75819158554077,1976.8042488098145,68320,7495,60825,60825,0,10,7809000.0
7809,7809999,21.846947331894388,38.33636074916126,0.04808474785314665,1565.517122745514,506.8210680484772,1977.221752166748,68320,7495,60825,60825,0,10,7810000.0
7810,7810999,21.84645233816966,38.335334743500205,0.04808715723851664,1565.7940385341644,506.88541650772095,1977.559181213379,68330,7496,60834,60834,0,10,7811000.0
7811,7811999,21.846168518367502,38.33444577599514,0.048084627572110406,1565.9127900600433,506.94858407974243,1977.9124870300293,68330,7496,60834,60834,0,10,7812000.0
7812,7812999,21.846246886533425,38.334260719784666,0.048090250646487975,1566.342916727066,507.0126910209656,1978.2946434020996,68349,7498,60851,60851,0,10,7813000.0
7813,7813999,21.846428401700663,38.33481719710301,0.04809256966802866,1566.4651432037354,507.0758125782013,1978.6669692993164,68349,7498,60851,60851,0,10,7814000.0
7814,7814999,21.84702798581686,38.33573085137231,0.04810215475637669,1566.60063290596,507.13937282562256,1979.0850982666016,68350,7498,60852,60852,0,10,7815000.0
7815,7815999,21.847887581895602,38.337446137545854,0.048107599536747814,1566.731835603714,507.203138589859,1979.4192504882812,68351,7498,60853,60853,0,10,7816000.0
7816,7816999,21.848488188476654,38.33856122010511,0.04811164357640341,1566.8612806797028,507.26735663414,1979.7753295898438,68352,7498,60854,60854,0,10,7817000.0
7817,7817999,21.84906572037735,38.33934555386368,0.048118631146688684,1566.9811334609985,507.32931423187256,1980.078899383545,68352,7498,60854,60854,0,10,7818000.0
7818,7818999,21.849884377326717,38.34152376460583,0.048121810720822444,1567.4289026260376,507.39419436454773,1980.4056816101074,68371,7500,60871,60871,0,10,7819000.0
7819,7819999,21.850758348952056,38.34333072091206,0.0481259966409332,1567.5748872756958,507.4682762622833,1980.8624649047852,68373,7500,60873,60873,0,10,7820000.0
7820,7820999,21.851195532456018,38.34364676926654,0.04813255856279852,1568.0125060081482,507.53402614593506,1981.2103843688965,68387,7502,60885,60885,0,10,7821000.0
7821,7821999,21.852006206559135,38.34516595184094,0.04813028169712119,1568.1302194595337,507.5956506729126,1981.5194931030273,68388,7502,60886,60886,0,10,7822000.0
7822,7822999,21.852837727700717,38.346993696768244,0.04812501061401919,1568.4133360385895,507.65838265419006,1981.7610626220703,68399,7503,60896,60896,0,10,7823000.0
7823,7823999,21.8534355195363,38.348389196355654,0.04812503647533806,1568.6826133728027,507.7221312522888,1982.1566543579102,68413,7504,60909,60909,0,10,7824000.0
7824,7824999,21.853245321046504,38.348567469001495,0.04812262321532601,1568.96710729599,507.7867000102997,1983.1992149353027,68439,7505,60934,60934,0,10,7825000.0
7825,7825999,21.85270753196861,38.34777835307591,0.04812604299005108,1569.2475423812866,507.8515524864197,1983.7266426086426,68450,7506,60944,60944,0,10,7826000.0
7826,7826999,21.85214235743946,38.34667644807505,0.0481258837527605,1569.683853149414,507.9150507450104,1984.060146331787,68471,7508,60963,60963,0,10,7827000.0
7827,7827999,21.85168803945615,38.34584200679066,0.048120863780710676,1569.9693298339844,507.9796452522278,1984.388584136963,68475,7509,60966,60966,0,10,7828000.0
7828,7828999,21.85128587236124,38.34514844151687,0.04811627446326783,1570.550311088562,508.04217052459717,1984.5755996704102,68508,7512,60996,60996,0,10,7829000.0
7829,7829999,21.8508420011254,38.34394973216686,0.048114489872389865,1570.833933353424,508.1072344779968,1984.8761749267578,68516,7513,61003,61003,0,10,7830000.0
7830,7830999,21.85031102103695,38.3426603999538,0.04811488196012759,1571.2676408290863,508.1710841655731,1985.065761566162,68538,7515,61023,61023,0,10,7831000.0
7831,7831999,21.849893201682132,38.3416356408189,0.04811228728916073,1571.7109777927399,508.23517417907715,1985.2011184692383,68544,7517,61027,61027,0,10,7832000.0
7832,7832999,21.849648941916577,38.340887746172534,0.048109176985902,1571.8334567546844,508.29860949516296,1985.5124244689941,68544,7517,61027,61027,0,10,7833000.0
7833,7833999,21.84951023248361,38.34018379319464,0.04810695624024208,1571.9593727588654,508.3640151023865,1985.7895164489746,68544,7517,61027,61027,0,10,7834000.0
7834,7834999,21.84906633525259,38.33906276356944,0.048108804986808806,1572.0909807682037,508.42702770233154,1986.0233039855957,68544,7517,61027,61027,0,10,7835000.0
7835,7835999,21.84870203446217,38.337920511669324,0.04810594447174121,1572.380667924881,508.49276900291443,1986.245750427246,68546,7518,61028,61028,0,10,7836000.0
7836,7836999,21.848466856088287,38.33693455939319,0.04810278493068332,1572.5102620124817,508.55682468414307,1986.5286331176758,68546,7518,61028,61028,0,10,7837000.0
7837,7837999,21.84822140270398,38.33587986773629,0.04809520654418342,1572.9408767223358,508.6208987236023,1986.6822204589844,68558,7520,61038,61038,0,10,7838000.0
7838,7838999,21.848116036234696,38.3350723244431,0.04808630687830728,1573.216537475586,508.6835763454437,1986.9690132141113,68569,7521,61048,61048,0,10,7839000.0
7839,7839999,21.848076279711407,38.334120760625396,0.0480748869893185,1573.809118270874,508.7469792366028,1987.1847229003906,68601,7524,61077,61077,0,10,7840000.0
7840,7840999,21.847857701296064,38.33301453351183,0.04806762860825964,1574.2385272979736,508.8097128868103,1987.405361175537,68627,7526,61101,61101,0,10,7841000.0
7841,7841999,21.84754635261082,38.33182268704257,0.04806155126602074,1574.5126967430115,508.8737018108368,1987.654685974121,68629,7527,61102,61102,0,10,7842000.0
7842,7842999,21.84712888041107,38.33113989448279,0.04805460431018915,1574.6336269378662,508.9364140033722,1987.9878768920898,68630,7527,61103,61103,0,10,7843000.0
7843,7843999,21.846889238914663,38.33239381638444,0.04805788073652728,1575.0868787765503,509.0025897026062,1988.374568939209,68638,7529,61109,61109,0,10,7844000.0
7844,7844999,21.846314009376904,38.33157082476965,0.048061949981193286,1575.5342149734497,509.0661389827728,1988.5935096740723,68646,7531,61115,61115,0,10,7845000.0
7845,7845999,21.845874877643826,38.331296566103084,0.04806958371933423,1575.6584815979004,509.1282856464386,1988.8652267456055,68646,7531,61115,61115,0,10,7846000.0
7846,7846999,21.84582397721346,38.33175052047198,0.048071406704053965,1575.7827603816986,509.19220995903015,1989.1436729431152,68646,7531,61115,61115,0,10,7847000.0
7847,7847999,21.846111431883973,38.332681254826326,0.04808443737682244,1576.0705835819244,509.2559859752655,1989.3275337219238,68650,7532,61118,61118,0,10,7848000.0
7848,7848999,21.846241306013763,38.332913671201105,0.04809047987937465,1576.1992213726044,509.3189001083374,1989.567470550537,68650,7532,61118,61118,0,10,7849000.0
7849,7849999,21.846918606874933,38.33473096557262,0.04809261306949075,1576.4823062419891,509.3807773590088,1989.6741218566895,68656,7533,61123,61123,0,10,7850000.0
7850,7850999,21.84771846908317,38.33654654241855,0.04810405116595684,1576.61932015419,509.44432854652405,1989.877758026123,68657,7533,61124,61124,0,10,7851000.0
7851,7851999,21.84870572672195,38.33899360485724,0.04811169338268573,1576.9110124111176,509.5093574523926,1990.07271194458,68660,7534,61126,61126,0,10,7852000.0
7852,7852999,21.850188436745917,38.343007238785965,0.048140920918478436,1577.2027220726013,509.5726308822632,1990.243278503418,68668,7535,61133,61133,0,10,7853000.0
7853,7853999,21.852371905732678,38.35173467506469,0.04816364288494468,1577.6471011638641,509.63527965545654,1990.3677215576172,68673,7537,61136,61136,0,10,7854000.0
7854,7854999,21.854360036035352,38.35699089685839,0.04819196561884975,1577.9292023181915,509.6979515552521,1990.5106163024902,68675,7538,61137,61137,0,10,7855000.0
7855,7855999,21.85535985575334,38.358522994200555,0.04822114316732462,1578.2186841964722,509.7600955963135,1990.6725807189941,68677,7539,61138,61138,0,10,7856000.0
7856,7856999,21.857581591474183,38.363774553386314,0.04825040609580178,1578.5044479370117,509.8246068954468,1990.8819999694824,68684,7540,61144,61144,0,10,7857000.0
7857,7857999,21.8592628077469,38.36786146906642,0.04827933797608652,1578.625423192978,509.88612174987793,1991.0432052612305,68684,7540,61144,61144,0,10,7858000.0
7858,7858999,21.86096273979515,38.37056598277916,0.04829537449440091,1579.0601015090942,509.95031356811523,1991.1242446899414,68705,7542,61163,61163,0,10,7859000.0
7859,7859999,21.863088542832845,38.37486401728373,0.0483111159084163,1579.1880323886871,510.01181745529175,1991.2802963256836,68705,7542,61163,61163,0,10,7860000.0
7860,7860999,21.86494396506414,38.37849012121243,0.04833474523861914,1579.7772612571716,510.0746896266937,1991.2358894348145,68711,7545,61166,61166,0,10,7861000.0
7861,7861999,21.866727900963646,38.38162569493629,0.04835557943558311,1580.210752248764,510.1364893913269,1991.444679260254,68717,7547,61170,61170,0,10,7862000.0
7862,7862999,21.867182965699897,38.38238391707668,0.04834818379193129,1580.5116846561432,510.2029187679291,1992.7001342773438,68747,7548,61199,61199,0,10,7863000.0
7863,7863999,21.86790286744498,38.38500724616872,0.04834690171090461,1580.6476652622223,510.26759362220764,1993.5732536315918,68755,7548,61207,61207,0,10,7864000.0
7864,7864999,21.868483532013496,38.38710030386929,0.048341224954104534,1580.9268450737,510.330265045166,1994.080436706543,68772,7549,61223,61223,0,10,7865000.0
7865,7865999,21.869337468174905,38.38894764946021,0.04833422597753756,1581.369961977005,510.39438104629517,1994.6124229431152,68786,7551,61235,61235,0,10,7866000.0
7866,7866999,21.869745785554358,38.38977945022925,0.04833855224324046,1581.4961323738098,510.4572048187256,1995.205924987793,68789,7551,61238,61238,0,10,7867000.0
7867,7867999,21.870505879512297,38.3914807714593,0.04834371178569452,1581.9381530284882,510.5197892189026,1995.563117980957,68814,7553,61261,61261,0,10,7868000.0
7868,7868999,21.871025376096924,38.39186133947606,0.04834514167927406,1582.531839132309,510.584397315979,1995.7955703735352,68832,7556,61276,61276,0,10,7869000.0
7869,7869999,21.8717487692659,38.39252645889738,0.048353768093453264,1582.6548211574554,510.64849948883057,1996.39111328125,68832,7556,61276,61276,0,10,7870000.0
7870,7870999,21.87273730486906,38.39416357223467,0.0483573014663321,1583.0931956768036,510.7132773399353,1996.7295188903809,68848,7558,61290,61290,0,10,7871000.0
7871,7871999,21.873830813797614,38.396007548399815,0.04837531244595794,1583.3759770393372,510.77677869796753,1997.1133995056152,68860,7559,61301,61301,0,10,7872000.0
7872,7872999,21.875105936577924,38.397932554495924,0.048388002731801216,1583.4963159561157,510.8387989997864,1997.531349182129,68862,7559,61303,61303,0,10,7873000.0
7873,7873999,21.876441862263537,38.39997363181474,0.048401124621907154,1583.780695438385,510.90438771247864,1997.888313293457,68876,7560,61316,61316,0,10,7874000.0
7874,7874999,21.87810905022992,38.404526065362184,0.04843497926099016,1584.0681920051575,510.9671995639801,1998.3091163635254,68880,7561,61319,61319,0,10,7875000.0
7875,7875999,21.87980293973864,38.40852655544009,0.0484489876130777,1584.6674761772156,511.0306463241577,1998.4316024780273,68900,7564,61336,61336,0,10,7876000.0
7876,7876999,21.881447299104117,38.41121256478816,0.04847788824788912,1584.784916639328,511.09442806243896,1998.9089889526367,68901,7564,61337,61337,0,10,7877000.0
7877,7877999,21.882990742480207,38.41331205601065,0.04850986624680953,1585.0758290290833,511.15786933898926,1999.3472785949707,68916,7565,61351,61351,0,10,7878000.0
7878,7878999,21.884787715576717,38.41606260648554,0.048541347329154716,1585.359262228012,511.2209084033966,1999.7125701904297,68931,7566,61365,61365,0,10,7879000.0
7879,7879999,21.88640853971432,38.41827807736064,0.048566192876985936,1585.4856224060059,511.2840085029602,2000.104263305664,68934,7566,61368,61368,0,10,7880000.0
7880,7880999,21.887269844845555,38.41900742382571,0.04858311395966419,1585.7658009529114,511.34688091278076,2000.5352058410645,68947,7567,61380,61380,0,10,7881000.0
7881,7881999,21.887513109731742,38.41909783145861,0.04857577854428752,1585.9001922607422,511.41164088249207,2002.101016998291,68974,7567,61407,61407,0,10,7882000.0
7882,7882999,21.887122345886574,38.41830094358884,0.04856691237591715,1586.0211434364319,511.47645831108093,2003.0106735229492,68978,7567,61411,61411,0,10,7883000.0
7883,7883999,21.88684914019632,38.41819488320487,0.04855891376306953,1586.1455295085907,511.5398919582367,2003.6458282470703,68981,7567,61414,61414,0,10,7884000.0
7884,7884999,21.88644154790028,38.417399197399824,0.04855291281128504,1586.271239042282,511.6047041416168,2004.1006317138672,68981,7567,61414,61414,0,10,7885000.0
7885,7885999,21.885980955120736,38.41642774315642,0.04854942985489896,1586.7140755653381,511.67002034187317,2004.488468170166,69001,7569,61432,61432,0,10,7886000.0
7886,7886999,21.885603753070804,38.415338164553916,0.048548871451435494,1587.3139584064484,511.7333972454071,2004.8125267028809,69029,7572,61457,61457,0,10,7887000.0
7887,7887999,21.885654845654607,38.41537940898801,0.04854644525204743,1587.4287109375,511.796267747879,2005.3219413757324,69031,7572,61459,61459,0,10,7888000.0
7888,7888999,21.885428321833754,38.4146357312252,0.048538366507888786,1587.5436944961548,511.85879707336426,2005.7244911193848,69035,7572,61463,61463,0,10,7889000.0
7889,7889999,21.885577723469968,38.41428610985301,0.04853470650722236,1587.8320508003235,511.9326264858246,2005.9610290527344,69049,7573,61476,61476,0,10,7890000.0
7890,7890999,21.885585271813977,38.41541147957737,0.04852774771181945,1588.1273980140686,511.99866342544556,2006.309310913086,69064,7574,61490,61490,0,10,7891000.0
7891,7891999,21.885732042872835,38.41505081447444,0.048518605146624205,1588.412501335144,512.063404083252,2006.6357955932617,69066,7575,61491,61491,0,10,7892000.0
7892,7892999,21.885904503110474,38.41453775956707,0.04851381097425189,1588.849040031433,512.1273467540741,2006.935920715332,69088,7577,61511,61511,0,10,7893000.0
7893,7893999,21.885990306916707,38.413752760547624,0.048504759524485186,1588.9686319828033,512.19096326828,2007.3659172058105,69088,7577,61511,61511,0,10,7894000.0
7894,7894999,21.886070343810456,38.412975213909256,0.04849859870995887,1589.397171497345,512.2539715766907,2007.783836364746,69104,7579,61525,61525,0,10,7895000.0
7895,7895999,21.885954622115072,38.41182825865972,0.04849413329295138,1589.824565410614,512.3169927597046,2008.1342506408691,69117,7581,61536,61536,0,10,7896000.0
7896,7896999,21.885801107971446,38.41059047196685,0.04849087873895008,1589.946278333664,512.3800709247589,2008.5398330688477,69117,7581,61536,61536,0,10,7897000.0
7897,7897999,21.885525141081803,38.40995779412019,0.04848736493807504,1590.3898503780365,512.4446702003479,2009.6100234985352,69153,7583,61570,61570,0,10,7898000.0
7898,7898999,21.88490379475493,38.40949986870206,0.04848661883783356,1590.509325504303,512.5084388256073,2010.255298614502,69154,7583,61571,61571,0,10,7899000.0
7899,7899999,21.884298997312587,38.40825410573936,0.04848539870832136,1590.7865302562714,512.5717484951019,2010.804084777832,69160,7584,61576,61576,0,10,7900000.0
7900,7900999,21.883913858177728,38.407622309107666,0.04848194643540149,1591.2269387245178,512.6368396282196,2011.1815071105957,69177,7586,61591,61591,0,10,7901000.0
7901,7901999,21.883511123219613,38.40649708754667,0.04847956836010214,1591.5019071102142,512.6993186473846,2011.5086784362793,69189,7587,61602,61602,0,10,7902000.0
7902,7902999,21.883397826008753,38.40595945341542,0.04848054828916848,1591.6345627307892,512.7687349319458,2011.9396705627441,69192,7587,61605,61605,0,10,7903000.0
7903,7903999,21.88338906803647,38.40557142652431,0.048479538629150554,1591.9115536212921,512.8311927318573,2012.2328796386719,69205,7588,61617,61617,0,10,7904000.0
7904,7904999,21.883730555296584,38.40617216135141,0.048476160771197985,1592.2042019367218,512.8960916996002,2012.5419654846191,69220,7589,61631,61631,0,10,7905000.0
7905,7905999,21.884719253584525,38.40769915647964,0.04847355707522649,1592.4992504119873,512.9633531570435,2012.7958183288574,69231,7590,61641,61641,0,10,7906000.0
7906,7906999,21.88561805631758,38.411642319668175,0.04847463476708824,1592.630578994751,513.0267181396484,2013.1583862304688,69232,7590,61642,61642,0,10,7907000.0
7907,7907999,21.886747714707294,38.41569021324067,0.04846942223483286,1593.0690231323242,513.0902338027954,2013.4284133911133,69262,7592,61670,61670,0,10,7908000.0
7908,7908999,21.88754236582669,38.41682270420046,0.04847199730282281,1593.5091497898102,513.1532831192017,2013.573989868164,69284,7594,61690,61690,0,10,7909000.0
7909,7909999,21.888793249357413,38.419342868908835,0.04846615778977037,1593.793356180191,513.2171325683594,2013.7914428710938,69295,7595,61700,61700,0,10,7910000.0
7910,7910999,21.889998131544907,38.42120750260228,0.048465222961611265,1594.079461812973,513.2809779644012,2014.15185546875,69308,7596,61712,61712,0,10,7911000.0
7911,7911999,21.892000565923436,38.43436461791019,0.048454448950679074,1594.355469942093,513.343909740448,2014.4853248596191,69320,7597,61723,61723,0,10,7912000.0
7912,7912999,21.893855297611182,38.437540867208305,0.04846040932206397,1594.486618757248,513.4132721424103,2014.7753219604492,69320,7597,61723,61723,0,10,7913000.0
7913,7913999,21.896072451691154,38.44148029209155,0.04849027822773544,1594.9272191524506,513.4768855571747,2014.9205589294434,69337,7599,61738,61738,0,10,7914000.0
7914,7914999,21.897727379565666,38.44427753969306,0.04850547931142035,1595.3687052726746,513.5396802425385,2015.1628952026367,69353,7601,61752,61752,0,10,7915000.0
7915,7915999,21.897572334255344,38.444113239261995,0.048503471878723614,1595.8177425861359,513.6025886535645,2016.1696510314941,69385,7603,61782,61782,0,10,7916000.0
7916,7916999,21.89691692268478,38.44337419215318,0.04850132346443681,1595.9386312961578,513.6658644676208,2016.7851295471191,69389,7603,61786,61786,0,10,7917000.0
7917,7917999,21.89640625527974,38.44257629510346,0.04849777369621733,1596.0594294071198,513.727748632431,2017.135570526123,69389,7603,61786,61786,0,10,7918000.0
7918,7918999,21.89642316911518,38.44288325821505,0.04849246473142377,1596.1776361465454,513.7892682552338,2017.697566986084,69394,7603,61791,61791,0,10,7919000.0
7919,7919999,21.896416282415302,38.44282041135954,0.04848794766894915,1596.3019578456879,513.8512659072876,2018.0679512023926,69395,7603,61792,61792,0,10,7920000.0
7920,7920999,21.896562248794474,38.44277399765952,0.048482995385514704,1596.4319303035736,513.9144484996796,2018.4001388549805,69395,7603,61792,61792,0,10,7921000.0
7921,7921999,21.89682810253738,38.442810023455365,0.04848044101965632,1596.863409280777,513.9778428077698,2018.676944732666,69414,7605,61809,61809,0,10,7922000.0
7922,7922999,21.897634145511454,38.44421443679929,0.04846999793304496,1596.9937756061554,514.0413374900818,2019.016845703125,69415,7605,61810,61810,0,10,7923000.0
7923,7923999,21.898527697237753,38.44573182589226,0.048455676070507825,1597.609359741211,514.106020450592,2019.2718696594238,69450,7608,61842,61842,0,10,7924000.0
7924,7924999,21.899305084998566,38.44682979601601,0.04845088640208106,1597.732027053833,514.168710231781,2019.6223907470703,69451,7608,61843,61843,0,10,7925000.0
7925,7925999,21.90019180499533,38.44815153462797,0.048444854142494886,1597.85466837883,514.2329459190369,2019.963981628418,69451,7608,61843,61843,0,10,7926000.0
7926,7926999,21.9013311403253,38.452123811877534,0.048438695878995075,1598.1547150611877,514.2969901561737,2020.2351303100586,69455,7609,61846,61846,0,10,7927000.0
7927,7927999,21.902485906823454,38.45345046045293,0.048447566397335606,1598.280389547348,514.361873626709,2020.6023864746094,69455,7609,61846,61846,0,10,7928000.0
7928,7928999,21.90366012802127,38.455015866354024,0.048454739620621856,1598.4020791053772,514.4264929294586,2020.880714416504,69455,7609,61846,61846,0,10,7929000.0
7929,7929999,21.904803667744115,38.45773999996126,0.04845103690567243,1598.8465151786804,514.4888739585876,2021.0237579345703,69477,7611,61866,61866,0,10,7930000.0
7930,7930999,21.90600599523489,38.45904519580339,0.04845158254362225,1598.9689598083496,514.5507400035858,2021.3113632202148,69478,7611,61867,61867,0,10,7931000.0
7931,7931999,21.907271295662245,38.46181879134529,0.04845830270691198,1599.2474286556244,514.6134173870087,2021.4880065917969,69489,7612,61877,61877,0,10,7932000.0
7932,7932999,21.90797958770806,38.46210419386529,0.04845970546986167,1599.686215877533,514.6764268875122,2021.7334060668945,69502,7614,61888,61888,0,10,7933000.0
7933,7933999,21.908000906089836,38.462561951776806,0.04845775966406418,1599.8217277526855,514.7389998435974,2022.5380744934082,69504,7614,61890,61890,0,10,7934000.0
7934,7934999,21.907403853016493,38.46173854624552,0.0484595193599604,1600.4180126190186,514.8031659126282,2023.0303764343262,69531,7617,61914,61914,0,10,7935000.0
7935,7935999,21.90673480482786,38.46105307136527,0.04845776040519134,1600.6948137283325,514.8678152561188,2023.46781539917,69534,7618,61916,61916,0,10,7936000.0
7936,7936999,21.90654291357938,38.4607110420551,0.048454331314969123,1600.992169380188,514.9360797405243,2024.0089263916016,69550,7619,61931,61931,0,10,7937000.0
7937,7937999,21.906252669303303,38.460014977177906,0.04845208671622414,1601.2849073410034,515.0050613880157,2024.2568550109863,69552,7620,61932,61932,0,10,7938000.0
7938,7938999,21.90609495991388,38.45974193107229,0.04844928618236366,1601.4082973003387,515.0680012702942,2024.5957069396973,69552,7620,61932,61932,0,10,7939000.0
7939,7939999,21.90586287260256,38.45888525901094,0.048445406475089214,1602.0053222179413,515.1320910453796,2024.7903022766113,69583,7623,61960,61960,0,10,7940000.0
7940,7940999,21.90567515116293,38.458059973648126,0.048448229003400844,1602.454751253128,515.2008202075958,2025.1400909423828,69597,7625,61972,61972,0,10,7941000.0
7941,7941999,21.905708946197507,38.46050737980001,0.04844630846266962,1602.8942420482635,515.2650513648987,2025.4021797180176,69624,7627,61997,61997,0,10,7942000.0
7942,7942999,21.905946356667243,38.4603466747115,0.04844684287259926,1603.1831884384155,515.3277521133423,2025.6405220031738,69628,7628,62000,62000,0,10,7943000.0
7943,7943999,21.906429690449986,38.4621968871194,0.0484430127497808,1603.317962884903,515.3903424739838,2025.9519500732422,69630,7628,62002,62002,0,10,7944000.0
7944,7944999,21.907162346722885,38.46471131419339,0.048441527547230856,1603.7548282146454,515.4535593986511,2026.0420989990234,69654,7630,62024,62024,0,10,7945000.0
7945,7945999,21.908277947331513,38.46630575385143,0.04845132224997584,1604.0386173725128,515.515873670578,2026.2697448730469,69664,7631,62033,62033,0,10,7946000.0
7946,7946999,21.909426171501234,38.46781233264439,0.04845907813850514,1604.1708261966705,515.5811424255371,2026.4872360229492,69666,7631,62035,62035,0,10,7947000.0
7947,7947999,21.910989537846568,38.46990124140857,0.04846787974593547,1604.6016867160797,515.6434595584869,2026.6796035766602,69680,7633,62047,62047,0,10,7948000.0
7948,7948999,21.912428445215138,38.471494678414196,0.04847607073471272,1604.7251780033112,515.7072892189026,2027.0535736083984,69681,7633,62048,62048,0,10,7949000.0
7949,7949999,21.914027915325686,38.47494212397252,0.048478975057764995,1605.0028924942017,515.7709684371948,2027.2932243347168,69693,7634,62059,62059,0,10,7950000.0
7950,7950999,21.914977752103322,38.4755758799583,0.048484596587363926,1605.2940294742584,515.8350510597229,2027.5030555725098,69695,7635,62060,62060,0,10,7951000.0
7951,7951999,21.914950825590395,38.47474992315888,0.04848524732631099,1605.7413001060486,515.89683842659,2027.808162689209,69723,7637,62086,62086,0,10,7952000.0
7952,7952999,21.91470359823988,38.474314622136966,0.0484802788123766,1605.8779065608978,515.9632618427277,2028.9290084838867,69726,7637,62089,62089,0,10,7953000.0
7953,7953999,21.914452728397553,38.47460668273941,0.048475927778032,1606.0109100341797,516.0338504314423,2029.4486465454102,69726,7637,62089,62089,0,10,7954000.0
7954,7954999,21.914263604751824,38.4744526852356,0.0484722766649891,1606.1405003070831,516.0965147018433,2029.9182014465332,69728,7637,62091,62091,0,10,7955000.0
7955,7955999,21.91440042243851,38.474952349010515,0.04846967184172579,1606.4241428375244,516.1597788333893,2030.178997039795,69740,7638,62102,62102,0,10,7956000.0
7956,7956999,21.914757002418796,38.476223076713694,0.04846999861104617,1606.7031736373901,516.2231163978577,2030.3910522460938,69742,7639,62103,62103,0,10,7957000.0
7957,7957999,21.91536397372487,38.47769440652251,0.048471973093613285,1606.820398569107,516.28595662117,2030.8206596374512,69742,7639,62103,62103,0,10,7958000.0
7958,7958999,21.91582873138447,38.478445928464275,0.04847583694098845,1607.1004796028137,516.3495111465454,2031.1806945800781,69744,7640,62104,62104,0,10,7959000.0
7959,7959999,21.916026086436098,38.47861951798282,0.04847327373682642,1607.2194273471832,516.4123005867004,2031.6156692504883,69746,7640,62106,62106,0,10,7960000.0
7960,7960999,21.91666599204506,38.47980386363549,0.048486758326631074,1607.6623241901398,516.4763631820679,2031.9235458374023,69764,7642,62122,62122,0,10,7961000.0
7961,7961999,21.917192092682317,38.48193430620024,0.0484839680924406,1607.7939722537994,516.5466930866241,2032.2553672790527,69765,7642,62123,62123,0,10,7962000.0
7962,7962999,21.917841244423588,38.48348234709419,0.04848272542025922,1608.0788474082947,516.6096382141113,2032.5128135681152,69777,7643,62134,62134,0,10,7963000.0
7963,7963999,21.918239857313978,38.484148729610574,0.04847910728666294,1608.2067620754242,516.6717178821564,2032.901699066162,69777,7643,62134,62134,0,10,7964000.0
7964,7964999,21.919295755293103,38.48799934065809,0.04848409455116376,1608.3228161334991,516.7338767051697,2033.497013092041,69778,7643,62135,62135,0,10,7965000.0
7965,7965999,21.91995695664874,38.4890228879987,0.048479169666305166,1608.4442665576935,516.7962913513184,2033.9712219238281,69778,7643,62135,62135,0,10,7966000.0
7966,7966999,21.920811246789075,38.49006368251929,0.04848126432400601,1609.0404846668243,516.8588447570801,2034.138656616211,69806,7646,62160,62160,0,10,7967000.0
7967,7967999,21.921854800061467,38.49276469975387,0.04848312746867678,1609.3278510570526,516.9209053516388,2034.4840126037598,69818,7647,62171,62171,0,10,7968000.0
7968,7968999,21.922564158964267,38.49358813903529,0.04848535645111607,1609.4428036212921,516.9833810329437,2034.8286170959473,69818,7647,62171,62171,0,10,7969000.0
7969,7969999,21.922391153844195,38.49397906064113,0.048483143680739804,1609.5683555603027,517.0471708774567,2036.1932411193848,69826,7647,62179,62179,0,10,7970000.0
7970,7970999,21.921869526453904,38.49333715513397,0.04848208354951655,1609.6994168758392,517.1117813587189,2036.965389251709,69827,7647,62180,62180,0,10,7971000.0
7971,7971999,21.921179951026637,38.492720559719274,0.048484828635314,1610.1478283405304,517.1762697696686,2037.335578918457,69852,7649,62203,62203,0,10,7972000.0
7972,7972999,21.920611241819433,38.49138620082865,0.04848402924676676,1610.4333419799805,517.240017414093,2037.7984352111816,69856,7650,62206,62206,0,10,7973000.0
7973,7973999,21.92002314508366,38.49010526204706,0.04848393306374854,1610.7151324748993,517.3036637306213,2038.1445960998535,69869,7651,62218,62218,0,10,7974000.0
7974,7974999,21.919529190037423,38.48913342176317,0.04848331823552754,1611.161715745926,517.3757953643799,2038.3674659729004,69883,7653,62230,62230,0,10,7975000.0
7975,7975999,21.919003302216197,38.48806055531774,0.04848685773671102,1611.600662946701,517.4391705989838,2038.5959358215332,69892,7655,62237,62237,0,10,7976000.0
7976,7976999,21.918483663021224,38.48685707324019,0.04848869447586768,1611.881660938263,517.5032000541687,2038.9384307861328,69894,7656,62238,62238,0,10,7977000.0
7977,7977999,21.918122474387104,38.48785832190035,0.04848097079671454,1612.004639863968,517.5665533542633,2039.2544593811035,69894,7656,62238,62238,0,10,7978000.0
7978,7978999,21.917684388890873,38.486875180300274,0.048477499141438396,1612.2904720306396,517.6299347877502,2039.544765472412,69906,7657,62249,62249,0,10,7979000.0
7979,7979999,21.91711564939339,38.48547440724143,0.04847637449416253,1612.5761141777039,517.6933014392853,2039.8569717407227,69914,7658,62256,62256,0,10,7980000.0
7980,7980999,21.916909062633618,38.48496017871829,0.04847423460366518,1612.8517444133759,517.7557129859924,2040.0893669128418,69927,7659,62268,62268,0,10,7981000.0
7981,7981999,21.916753326991152,38.4858291622682,0.048467576345160523,1613.2997651100159,517.8198142051697,2040.266201019287,69951,7661,62290,62290,0,10,7982000.0
7982,7982999,21.916352038586446,38.484581335827286,0.048465236341033724,1613.7501254081726,517.8830192089081,2040.4760246276855,69976,7663,62313,62313,0,10,7983000.0
7983,7983999,21.916269887340558,38.48399202265225,0.048459854608934316,1613.8643617630005,517.9454526901245,2040.7763977050781,69976,7663,62313,62313,0,10,7984000.0
7984,7984999,21.916079269941307,38.4830289499826,0.04845677129306891,1614.1588952541351,518.0194272994995,2040.9598426818848,69989,7664,62325,62325,0,10,7985000.0
7985,7985999,21.915881939789806,38.48197904243127,0.04845158765882285,1614.2825434207916,518.0821118354797,2041.3371047973633,69989,7664,62325,62325,0,10,7986000.0
7986,7986999,21.91553357330086,38.480616982530016,0.04844691029131132,1614.5560014247894,518.144749879837,2041.5519790649414,70001,7665,62336,62336,0,10,7987000.0
7987,7987999,21.915346301823984,38.47956863168887,0.04844398886714085,1615.1737220287323,518.2087466716766,2041.6072273254395,70020,7668,62352,62352,0,10,7988000.0
7988,7988999,21.914855952434927,38.47824204676435,0.048443366950224664,1615.4514627456665,518.270204782486,2041.8258934020996,70032,7669,62363,62363,0,10,7989000.0
7989,7989999,21.914181066842726,38.47673342674943,0.04844196756037222,1615.890141248703,518.3336820602417,2042.7852058410645,70046,7671,62375,62375,0,10,7990000.0
7990,7990999,21.91350718590206,38.475500207503664,0.048436443684474306,1616.4949514865875,518.3976762294769,2043.1725273132324,70066,7674,62392,62392,0,10,7991000.0
7991,7991999,21.912758694197397,38.47399841795436,0.048435604157408885,1616.7693231105804,518.4599659442902,2043.455307006836,70078,7675,62403,62403,0,10,7992000.0
7992,7992999,21.912222035546137,38.47286715425947,0.04843312318771131,1617.0478188991547,518.523416519165,2043.8351707458496,70085,7676,62409,62409,0,10,7993000.0
7993,7993999,21.91178407471509,38.47202243502809,0.048426755144182154,1617.3243598937988,518.5854415893555,2044.0813789367676,70087,7677,62410,62410,0,10,7994000.0
7994,7994999,21.911572214525712,38.4713248782956,0.0484194192912869,1617.447392463684,518.6479904651642,2044.3663787841797,70088,7677,62411,62411,0,10,7995000.0
7995,7995999,21.911456390225755,38.47065894858578,0.04842103381219709,1617.878921031952,518.7087948322296,2044.485694885254,70112,7679,62433,62433,0,10,7996000.0
7996,7996999,21.91125134955108,38.469830741409694,0.048414610971515004,1618.317765712738,518.7711274623871,2044.7640113830566,70128,7681,62447,62447,0,10,7997000.0
7997,7997999,21.911301243041727,38.469643650638794,0.04841007963823485,1618.7626283168793,518.835209608078,2044.985610961914,70151,7683,62468,62468,0,10,7998000.0
7998,7998999,21.911152525553472,38.46898304678601,0.04840679647301427,1619.2034947872162,518.8977580070496,2045.0600814819336,70175,7685,62490,62490,0,10,7999000.0
7999,7999999,21.911143205773705,38.46828460892717,0.048401290861647794,1619.6458027362823,518.9611756801605,2045.348373413086,70193,7687,62506,62506,0,10,8000000.0
8000,8000999,21.911181384335933,38.46778603647957,0.0483984741951039,1620.403273820877,519.0245728492737,2045.3464126586914,70236,7691,62545,62545,0,10,8001000.0
8001,8001999,21.911201419398022,38.467525665698936,0.048389176515079346,1621.0009379386902,519.088056564331,2045.5288047790527,70273,7694,62579,62579,0,10,8002000.0
8002,8002999,21.911398483039182,38.467366370632014,0.04837764823835089,1621.6153943538666,519.1540813446045,2045.7025108337402,70310,7697,62613,62613,0,10,8003000.0
8003,8003999,21.91138714683389,38.466623345538835,0.04836502300309753,1621.9137675762177,519.2191004753113,2045.8918800354004,70322,7698,62624,62624,0,10,8004000.0
8004,8004999,21.91148520164983,38.46598258491076,0.04836064464955192,1622.1916024684906,519.281543970108,2046.0029563903809,70334,7699,62635,62635,0,10,8005000.0
8005,8005999,21.91173866789534,38.465452383402805,0.048350703328705724,1622.4646062850952,519.3449709415436,2046.2843894958496,70346,7700,62646,62646,0,10,8006000.0
8006,8006999,21.911751309384282,38.46462236287488,0.04834347047425491,1622.9109644889832,519.407927274704,2046.5284690856934,70362,7702,62660,62660,0,10,8007000.0
8007,8007999,21.911904370848088,38.463785691837664,0.04833514166299813,1623.1942386627197,519.4709665775299,2046.7181777954102,70374,7703,62671,62671,0,10,8008000.0
8008,8008999,21.91171400542616,38.462677483079005,0.04832946441756525,1623.7977344989777,519.5356776714325,2046.8014183044434,70400,7706,62694,62694,0,10,8009000.0
8009,8009999,21.911135726057882,38.46125348323765,0.04832824481204856,1624.090289592743,519.6010167598724,2047.9139938354492,70404,7707,62697,62697,0,10,8010000.0
8010,8010999,21.91039458437984,38.45991538261767,0.04833102202116202,1624.2197029590607,519.6660940647125,2048.5355796813965,70404,7707,62697,62697,0,10,8011000.0
8011,8011999,21.909689924524994,38.45875338748459,0.048334333021995746,1624.6787369251251,519.7307806015015,2048.9723930358887,70435,7709,62726,62726,0,10,8012000.0
8012,8012999,21.908974135354697,38.45729112619824,0.048337225228382796,1624.8042557239532,519.7952208518982,2049.4302825927734,70435,7709,62726,62726,0,10,8013000.0
8013,8013999,21.908285801158602,38.45600574358661,0.048337165429861884,1625.5691680908203,519.8595149517059,2049.562385559082,70469,7713,62756,62756,0,10,8014000.0
8014,8014999,21.907536887322212,38.454591324253045,0.048337844393054996,1625.6987552642822,519.9255845546722,2049.9182052612305,70469,7713,62756,62756,0,10,8015000.0
8015,8015999,21.90697165544453,38.453427175716776,0.04833780348684924,1625.9729361534119,519.9873933792114,2050.3106422424316,70482,7714,62768,62768,0,10,8016000.0
8016,8016999,21.9065959458064,38.452590976344425,0.048340090455588625,1626.0980048179626,520.0483644008636,2050.701728820801,70482,7714,62768,62768,0,10,8017000.0
8017,8017999,21.906276043207647,38.45159975752046,0.04833621327530768,1626.2156174182892,520.1101577281952,2051.005214691162,70482,7714,62768,62768,0,10,8018000.0
8018,8018999,21.905996805999337,38.45071246427491,0.04833127613466248,1626.4962520599365,520.1748631000519,2051.3491020202637,70485,7715,62770,62770,0,10,8019000.0
8019,8019999,21.905766147301687,38.44971812380529,0.048326569503815864,1626.946340560913,520.23890209198,2051.634147644043,70510,7717,62793,62793,0,10,8020000.0
8020,8020999,21.905890213716336,38.450966015419155,0.04830930444680337,1627.0709166526794,520.3029642105103,2052.051467895508,70510,7717,62793,62793,0,10,8021000.0
8021,8021999,21.905753051707507,38.4497982705414,0.048296741937171705,1627.353880405426,520.3665370941162,2052.4252014160156,70522,7718,62804,62804,0,10,8022000.0
8022,8022999,21.905995062148822,38.45154428133144,0.04828485052317111,1627.7818756103516,520.4284791946411,2052.8580169677734,70537,7720,62817,62817,0,10,8023000.0
8023,8023999,21.905948931783307,38.450838799951605,0.04828071422103197,1627.90096783638,520.4913249015808,2053.2891273498535,70538,7720,62818,62818,0,10,8024000.0
8024,8024999,21.905661833279687,38.44947691806122,0.04828058105805655,1628.183381319046,520.5552275180817,2053.7459716796875,70548,7721,62827,62827,0,10,8025000.0
8025,8025999,21.905012599417244,38.44886740095503,0.04828423088818101,1628.5038821697235,520.6226131916046,2054.9361152648926,70562,7722,62840,62840,0,10,8026000.0
8026,8026999,21.904201649454283,38.44804886091436,0.04828717970268914,1628.940081357956,520.6880149841309,2055.561046600342,70586,7724,62862,62862,0,10,8027000.0
8027,8027999,21.903397875062563,38.447043878043445,0.04828798048050165,1629.3769552707672,520.7523860931396,2056.0670204162598,70607,7726,62881,62881,0,10,8028000.0
8028,8028999,21.90261069800197,38.44572786720846,0.04829229341921515,1629.5010690689087,520.8164756298065,2056.471481323242,70607,7726,62881,62881,0,10,8029000.0
8029,8029999,21.902040492854198,38.44481365777083,0.04828970238832042,1629.9451537132263,520.8806962966919,2056.847843170166,70621,7728,62893,62893,0,10,8030000.0
8030,8030999,21.901262982543376,38.44340093339797,0.04829167702477344,1630.2267529964447,520.9443743228912,2057.276020050049,70634,7729,62905,62905,0,10,8031000.0
8031,8031999,21.900819572086284,38.443287679182895,0.048284017571047944,1630.5044512748718,521.0091745853424,2057.5858764648438,70640,7730,62910,62910,0,10,8032000.0
8032,8032999,21.900564232971924,38.443268104988,0.048282527184006274,1630.6259183883667,521.0724704265594,2058.0934257507324,70640,7730,62910,62910,0,10,8033000.0
8033,8033999,21.90042667715247,38.44333915648349,0.04827907682306465,1630.7477023601532,521.1356184482574,2058.428871154785,70640,7730,62910,62910,0,10,8034000.0
8034,8034999,21.900298351268805,38.4429372707028,0.04827632625369915,1631.2044625282288,521.199343919754,2058.6904792785645,70666,7732,62934,62934,0,10,8035000.0
8035,8035999,21.900431941393606,38.44328077410984,0.04827152726933959,1631.6384496688843,521.2628736495972,2059.030891418457,70691,7734,62957,62957,0,10,8036000.0
8036,8036999,21.900799045281975,38.44341984195706,0.048269758111516126,1631.764728307724,521.3256809711456,2059.3816833496094,70691,7734,62957,62957,0,10,8037000.0
8037,8037999,21.901208946908103,38.44407280050956,0.04826517507771244,1632.202118396759,521.3901252746582,2059.662410736084,70710,7736,62974,62974,0,10,8038000.0
8038,8038999,21.902287950916094,38.44672872725882,0.04826069172002412,1632.486136674881,521.4542598724365,2060.102279663086,70722,7737,62985,62985,0,10,8039000.0
8039,8039999,21.902883679555675,38.447447956976134,0.04825961802342238,1632.7685000896454,521.5177574157715,2060.5642738342285,70729,7738,62991,62991,0,10,8040000.0
8040,8040999,21.903901060323832,38.448807155488154,0.0482604619905983,1633.3801174163818,521.5831851959229,2060.7591094970703,70744,7741,63003,63003,0,10,8041000.0
8041,8041999,21.90462178159944,38.44944149593543,0.0482613488892818,1633.820336818695,521.6469573974609,2061.026134490967,70758,7743,63015,63015,0,10,8042000.0
8042,8042999,21.905178089368057,38.44975573525807,0.048264736079656756,1633.9372067451477,521.7097706794739,2061.442901611328,70758,7743,63015,63015,0,10,8043000.0
8043,8043999,21.905165240315288,38.449576380528036,0.04826086592110679,1634.0654828548431,521.7741096019745,2062.5848121643066,70763,7743,63020,63020,0,10,8044000.0
8044,8044999,21.904871464580133,38.45140405393511,0.04825242931323659,1634.5191404819489,521.8387448787689,2063.23832321167,70796,7745,63051,63051,0,10,8045000.0
8045,8045999,21.90419910623065,38.45165860026345,0.0482454464412303,1634.6381294727325,521.9026970863342,2063.747947692871,70796,7745,63051,63051,0,10,8046000.0
8046,8046999,21.903826842872952,38.45260313671774,0.04823715239509441,1634.7593686580658,521.9675514698029,2064.235565185547,70797,7745,63052,63052,0,10,8047000.0
8047,8047999,21.90326809407196,38.451942067173626,0.04823643742586381,1635.0377185344696,522.0315444469452,2064.491008758545,70809,7746,63063,63063,0,10,8048000.0
8048,8048999,21.90275792738638,38.45089217131211,0.04823528568812174,1635.4835546016693,522.0964732170105,2064.7158432006836,70827,7748,63079,63079,0,10,8049000.0
8049,8049999,21.902299855802625,38.45003037912599,0.04823254898149998,1635.773199081421,522.1610050201416,2065.0947303771973,70834,7749,63085,63085,0,10,8050000.0
8050,8050999,21.901910454161197,38.44924484227043,0.04823091866616058,1636.054378271103,522.2251489162445,2065.4377098083496,70842,7750,63092,63092,0,10,8051000.0
8051,8051999,21.901568353341222,38.448688131194345,0.04822587211051188,1636.337826013565,522.287707567215,2065.628562927246,70844,7751,63093,63093,0,10,8052000.0
8052,8052999,21.901245652562537,38.44829457470295,0.04822103153074919,1636.6346633434296,522.3515565395355,2065.9260215759277,70856,7752,63104,63104,0,10,8053000.0
8053,8053999,21.90101250848056,38.44776318926979,0.04821964688411484,1636.9060854911804,522.4124879837036,2066.2565269470215,70868,7753,63115,63115,0,10,8054000.0
8054,8054999,21.900987733994945,38.448009132916134,0.048215630025672085,1637.033729314804,522.4740555286407,2066.5133934020996,70868,7753,63115,63115,0,10,8055000.0
8055,8055999,21.901206097155438,38.44829822186139,0.048216807931053984,1637.322922706604,522.5375411510468,2066.8244285583496,70871,7754,63117,63117,0,10,8056000.0
8056,8056999,21.901347560137395,38.44812126636525,0.04821446459249212,1637.7584443092346,522.5998413562775,2067.0581245422363,70885,7756,63129,63129,0,10,8057000.0
8057,8057999,21.90177841885261,38.44839318690854,0.04820925591472691,1638.0352549552917,522.663149356842,2067.2762489318848,70897,7757,63140,63140,0,10,8058000.0
8058,8058999,21.902464376021612,38.44998186189482,0.048205266429697136,1638.3064987659454,522.7249953746796,2067.458541870117,70909,7758,63151,63151,0,10,8059000.0
8059,8059999,21.90342113024257,38.45278232461731,0.048206747240920556,1638.9049870967865,522.788830280304,2067.673397064209,70936,7761,63175,63175,0,10,8060000.0
8060,8060999,21.904024210556937,38.45326620374048,0.048201882802685114,1639.1851389408112,522.8525269031525,2067.920093536377,70948,7762,63186,63186,0,10,8061000.0
8061,8061999,21.904629777931515,38.45348475169274,0.04819943656544512,1639.4732491970062,522.9149813652039,2068.191661834717,70951,7763,63188,63188,0,10,8062000.0
8062,8062999,21.90470076652734,38.45290154121778,0.04819601343953506,1639.7788722515106,522.9901442527771,2068.435417175293,70957,7764,63193,63193,0,10,8063000.0
8063,8063999,21.904550860207816,38.45297081798097,0.04819105119380773,1640.2442755699158,523.0644612312317,2069.7124557495117,70978,7766,63212,63212,0,10,8064000.0
8064,8064999,21.904440483420455,38.453339726675765,0.04819174555334205,1640.3765423297882,523.1301901340485,2070.3345680236816,70978,7766,63212,63212,0,10,8065000.0
8065,8065999,21.904260307179566,38.452974773107535,0.048191409722942,1640.6794352531433,523.1938254833221,2070.760585784912,70991,7767,63224,63224,0,10,8066000.0
8066,8066999,21.904063127128467,38.45231521670431,0.04819222003067769,1641.1455323696136,523.2619712352753,2071.030506134033,71012,7769,63243,63243,0,10,8067000.0
8067,8067999,21.904371745243616,38.45265874643722,0.048192816883671274,1641.2633390426636,523.3257803916931,2071.441795349121,71014,7769,63245,63245,0,10,8068000.0
8068,8068999,21.905014891305235,38.45436760368174,0.04819019426636606,1641.7044622898102,523.3898313045502,2071.777820587158,71039,7771,63268,63268,0,10,8069000.0
8069,8069999,21.90616853498452,38.45685986124046,0.0482038517074459,1641.9937217235565,523.4538578987122,2072.270179748535,71052,7772,63280,63280,0,10,8070000.0
8070,8070999,21.90725056101104,38.45934919930849,0.048221567953442124,1642.4440174102783,523.5176413059235,2072.618625640869,71068,7774,63294,63294,0,10,8071000.0
8071,8071999,21.90902835919124,38.463736077572946,0.04823918449895448,1642.9089469909668,523.5903980731964,2072.966655731201,71092,7776,63316,63316,0,10,8072000.0
8072,8072999,21.911141320431184,38.46848025710877,0.04826703007600597,1643.5206046104431,523.6545193195343,2073.208709716797,71117,7779,63338,63338,0,10,8073000.0
8073,8073999,21.913395389329736,38.473039502093485,0.04830463620606962,1643.8079931735992,523.7207267284393,2073.6551818847656,71122,7780,63342,63342,0,10,8074000.0
8074,8074999,21.915207979310892,38.47722185085577,0.04833188963052282,1644.2553510665894,523.784749507904,2073.926383972168,71146,7782,63364,63364,0,10,8075000.0
8075,8075999,21.91740603176592,38.482787016829604,0.048361783264799674,1644.5445342063904,523.848584651947,2074.30029296875,71153,7783,63370,63370,0,10,8076000.0
8076,8076999,21.91998835260033,38.48955110383104,0.04839889167771083,1644.6649708747864,523.9118287563324,2074.5857315063477,71154,7783,63371,63371,0,10,8077000.0
8077,8077999,21.922774601614876,38.49554880891449,0.048431030928141605,1645.277425289154,523.9761636257172,2074.8036880493164,71185,7786,63399,63399,0,10,8078000.0
8078,8078999,21.9260735798545,38.505100488703356,0.0484507443989467,1645.4096419811249,524.0392348766327,2075.149196624756,71185,7786,63399,63399,0,10,8079000.0
8079,8079999,21.92954882363999,38.51275804656144,0.04848860500688035,1645.536499261856,524.1028940677643,2075.509044647217,71185,7786,63399,63399,0,10,8080000.0
8080,8080999,21.93059236369259,38.51394473864948,0.04849994480964004,1646.0072875022888,524.168707370758,2076.248966217041,71203,7788,63415,63415,0,10,8081000.0
8081,8081999,21.931137109961593,38.51652521740566,0.04850421245527736,1646.4611954689026,524.2335135936737,2077.146827697754,71230,7790,63440,63440,0,10,8082000.0
8082,8082999,21.931776367460056,38.51856701686458,0.04848535770303486,1646.7621836662292,524.3034272193909,2077.6267585754395,71241,7791,63450,63450,0,10,8083000.0
8083,8083999,21.93239599034395,38.52071334052578,0.04847768074487113,1647.2260336875916,524.3709001541138,2078.279441833496,71263,7793,63470,63470,0,10,8084000.0
8084,8084999,21.93300454675987,38.522046609830014,0.04847256634053454,1647.3557512760162,524.4383444786072,2078.8066215515137,71263,7793,63470,63470,0,10,8085000.0
8085,8085999,21.933571290626997,38.52396173116619,0.04846180152360535,1647.4784667491913,524.5014398097992,2079.1992416381836,71263,7793,63470,63470,0,10,8086000.0
8086,8086999,21.934092326819002,38.52473120358155,0.04845942531482139,1647.6092734336853,524.5673127174377,2079.610527038574,71263,7793,63470,63470,0,10,8087000.0
8087,8087999,21.934637646799946,38.525393851150326,0.048451421025533015,1647.7374110221863,524.6332173347473,2080.143241882324,71263,7793,63470,63470,0,10,8088000.0
8088,8088999,21.93541563267352,38.52637620494255,0.048453454527899176,1647.8576769828796,524.6960444450378,2080.650177001953,71263,7793,63470,63470,0,10,8089000.0
8089,8089999,21.93633525029009,38.528102063273955,0.048455882703248965,1647.976618528366,524.7589793205261,2081.0094108581543,71263,7793,63470,63470,0,10,8090000.0
8090,8090999,21.937435592251692,38.529881508106,0.04846027087160587,1648.1183149814606,524.8293571472168,2081.502056121826,71263,7793,63470,63470,0,10,8091000.0
8091,8091999,21.938765935733716,38.534487154899516,0.048461624634253964,1648.24884557724,524.8941066265106,2081.9019927978516,71263,7793,63470,63470,0,10,8092000.0
8092,8092999,21.939712768259607,38.535398464018684,0.048465656313609995,1648.5270159244537,524.9565274715424,2082.1456413269043,71275,7794,63481,63481,0,10,8093000.0
8093,8093999,21.940939441758033,38.53808176767542,0.048471114270772886,1648.6499569416046,525.01921916008,2082.466449737549,71275,7794,63481,63481,0,10,8094000.0
8094,8094999,21.94261448745856,38.54139636945895,0.0484842555005528,1648.7725744247437,525.0815086364746,2082.9056663513184,71276,7794,63482,63482,0,10,8095000.0
8095,8095999,21.944325817334313,38.545401505525085,0.048495307365559515,1648.8887984752655,525.1431124210358,2083.3589973449707,71277,7794,63483,63483,0,10,8096000.0
8096,8096999,21.946274633515348,38.54914662279595,0.048503454232026066,1649.1620979309082,525.2058281898499,2083.6170501708984,71289,7795,63494,63494,0,10,8097000.0
8097,8097999,21.947740615350963,38.55165841611301,0.04851929470643901,1649.6089277267456,525.2683713436127,2083.837001800537,71314,7797,63517,63517,0,10,8098000.0
8098,8098999,21.949250131474024,38.55403978068253,0.048553693268811315,1649.732661485672,525.3315918445587,2084.2352409362793,71315,7797,63518,63518,0,10,8099000.0
8099,8099999,21.950196172514573,38.55584400133624,0.0485136965829005,1650.0387134552002,525.4046394824982,2085.5807609558105,71321,7798,63523,63523,0,10,8100000.0
8100,8100999,21.950301848294057,38.555700145444774,0.04846320359406586,1650.163213968277,525.468190908432,2086.3267097473145,71323,7798,63525,63525,0,10,8101000.0
8101,8101999,21.950561629213915,38.55605707349108,0.04841817304527518,1650.4507899284363,525.5323131084442,2086.7338371276855,71335,7799,63536,63536,0,10,8102000.0
8102,8102999,21.951193531481493,38.55687271632523,0.04835333494473115,1650.7372562885284,525.5955772399902,2087.114990234375,71347,7800,63547,63547,0,10,8103000.0
8103,8103999,21.95137956487078,38.556374994009104,0.04833172992875012,1650.8555929660797,525.6593353748322,2087.434558868408,71347,7800,63547,63547,0,10,8104000.0
8104,8104999,21.951677944009656,38.55639419227074,0.048293648698245484,1651.141146183014,525.7230560779572,2087.656074523926,71360,7801,63559,63559,0,10,8105000.0
8105,8105999,21.951769391221397,38.55616116880364,0.048273744653635986,1651.26819896698,525.7871491909027,2088.014881134033,71361,7801,63560,63560,0,10,8106000.0
8106,8106999,21.952067350413113,38.55550989797449,0.0482480227987242,1651.3914504051208,525.8512477874756,2088.4140281677246,71361,7801,63560,63560,0,10,8107000.0
8107,8107999,21.952505839786877,38.5556178152916,0.04821977390312571,1651.6679224967957,525.9145057201385,2088.63285446167,71373,7802,63571,63571,0,10,8108000.0
8108,8108999,21.952751143148557,38.55502106114586,0.04819426171000729,1651.7978451251984,525.978316783905,2088.98291015625,71374,7802,63572,63572,0,10,8109000.0
8109,8109999,21.95298723312044,38.554649006089576,0.0481762950758825,1652.0787417888641,526.0410871505737,2089.2268829345703,71378,7803,63575,63575,0,10,8110000.0
8110,8110999,21.953283494611412,38.55423484121906,0.048165635498804926,1652.546053647995,526.1051375865936,2089.412353515625,71401,7805,63596,63596,0,10,8111000.0
8111,8111999,21.95357347365236,38.553828956050744,0.04815547391983144,1652.6825351715088,526.1685395240784,2089.712791442871,71401,7805,63596,63596,0,10,8112000.0
8112,8112999,21.953954601887524,38.55376367787284,0.048146712548450155,1652.8030862808228,526.2311537265778,2090.0327644348145,71401,7805,63596,63596,0,10,8113000.0
8113,8113999,21.954191389412202,38.553193125649976,0.04814135657154606,1652.921588420868,526.2936236858368,2090.200366973877,71401,7805,63596,63596,0,10,8114000.0
8114,8114999,21.954651349992236,38.5528826818566,0.048132255724531725,1653.0392935276031,526.3570907115936,2090.529582977295,71401,7805,63596,63596,0,10,8115000.0
8115,8115999,21.955015095894577,38.552441903266256,0.04812933383881557,1653.170960187912,526.4217755794525,2090.8569374084473,71402,7805,63597,63597,0,10,8116000.0
8116,8116999,21.955508351822278,38.55341748474535,0.04812296763903312,1653.301346063614,526.4843757152557,2091.106101989746,71402,7805,63597,63597,0,10,8117000.0
8117,8117999,21.955767805396793,38.55271434236922,0.048115894131573356,1653.7631673812866,526.5495615005493,2091.2679862976074,71414,7807,63607,63607,0,10,8118000.0
8118,8118999,21.95612242110868,38.55221501983192,0.048108273210602515,1653.8771970272064,526.6123924255371,2091.5742378234863,71414,7807,63607,63607,0,10,8119000.0
8119,8119999,21.95669660257478,38.55439748356635,0.04805917003778515,1654.0034918785095,526.6754624843597,2092.5330352783203,71417,7807,63610,63610,0,10,8120000.0
8120,8120999,21.95748661523014,38.55616192678979,0.04791185424210187,1654.286358833313,526.739015340805,2093.3847312927246,71429,7808,63621,63621,0,10,8121000.0
8121,8121999,21.958315216335343,38.558473897136594,0.04775573738092276,1654.4170949459076,526.8036623001099,2093.890869140625,71430,7808,63622,63622,0,10,8122000.0
8122,8122999,21.959061273969446,38.559677494933325,0.047637384732596266,1655.0420620441437,526.8723304271698,2094.094268798828,71452,7811,63641,63641,0,10,8123000.0
8123,8123999,21.95945725943674,38.55998641711286,0.047566082505760665,1655.1608803272247,526.9342737197876,2094.3400917053223,71452,7811,63641,63641,0,10,8124000.0
8124,8124999,21.960025519621627,38.56066355229636,0.04748465952676306,1655.4457023143768,526.9970779418945,2094.557590484619,71454,7812,63642,63642,0,10,8125000.0
8125,8125999,21.960699995416427,38.562729369129045,0.04741690891858985,1655.902598142624,527.0612003803253,2094.7959899902344,71479,7814,63665,63665,0,10,8126000.0
8126,8126999,21.96105236556093,38.56263654233916,0.04736264888161157,1656.0211610794067,527.1234958171844,2095.109218597412,71479,7814,63665,63665,0,10,8127000.0
8127,8127999,21.96161442020336,38.56321187527208,0.04730011304662751,1656.143614768982,527.189165353775,2095.4228706359863,71479,7814,63665,63665,0,10,8128000.0
8128,8128999,21.962231439682036,38.56364890649345,0.04724027296671651,1656.9266393184662,527.2523057460785,2095.5269317626953,71529,7818,63711,63711,0,10,8129000.0
8129,8129999,21.96264728127441,38.563387079807924,0.0471903058372678,1657.0464565753937,527.3143072128296,2095.7904739379883,71529,7818,63711,63711,0,10,8130000.0
8130,8130999,21.963221106641274,38.56386651152112,0.04716887121318758,1657.348244190216,527.3811831474304,2096.1326637268066,71541,7819,63722,63722,0,10,8131000.0
8131,8131999,21.96381978866691,38.56651111413314,0.04713631006433283,1657.4679462909698,527.4450328350067,2096.469005584717,71542,7819,63723,63723,0,10,8132000.0
8132,8132999,21.96434838933107,38.56635805217532,0.04711011682302668,1657.7611911296844,527.5082240104675,2096.649913787842,71554,7820,63734,63734,0,10,8133000.0
8133,8133999,21.964896301552045,38.56628520219935,0.04708717792339945,1658.041799068451,527.5725464820862,2096.90470123291,71565,7821,63744,63744,0,10,8134000.0
8134,8134999,21.96550090055879,38.56615744263881,0.047062065352308724,1658.6511890888214,527.6357583999634,2097.1076431274414,71591,7824,63767,63767,0,10,8135000.0
8135,8135999,21.966143204040772,38.56616297495709,0.04704494653720437,1658.9431657791138,527.6985743045807,2097.370445251465,71603,7825,63778,63778,0,10,8136000.0
8136,8136999,21.966859772311892,38.566111544846855,0.047031175497918576,1659.0595107078552,527.759774684906,2097.655086517334,71603,7825,63778,63778,0,10,8137000.0
8137,8137999,21.967388715756154,38.565815348826504,0.0470156649105864,1659.3399930000305,527.8213527202606,2097.9128913879395,71615,7826,63789,63789,0,10,8138000.0
8138,8138999,21.968033260653772,38.565660401654455,0.04699392704485761,1659.6224880218506,527.8826148509979,2098.098457336426,71627,7827,63800,63800,0,10,8139000.0
8139,8139999,21.968208982896194,38.5649319303872,0.04697839477360943,1659.7359266281128,527.9459779262543,2098.3475456237793,71628,7827,63801,63801,0,10,8140000.0
8140,8140999,21.968667196803203,38.5653302503922,0.046921026158790013,1659.872994184494,528.0123209953308,2099.428478240967,71633,7827,63806,63806,0,10,8141000.0
8141,8141999,21.96897328360195,38.56572652829041,0.04686977065343512,1660.0038361549377,528.0764951705933,2100.1362075805664,71635,7827,63808,63808,0,10,8142000.0
8142,8142999,21.969300203160675,38.56599146973159,0.04682254746549808,1660.2946300506592,528.1409015655518,2100.538402557373,71647,7828,63819,63819,0,10,8143000.0
8143,8143999,21.969203930739,38.565402741739625,0.04680313297093375,1660.5857791900635,528.2046132087708,2100.753131866455,71653,7829,63824,63824,0,10,8144000.0
8144,8144999,21.969538559383185,38.565911361005014,0.0467686749899795,1661.2124140262604,528.2733070850372,2101.008716583252,71692,7832,63860,63860,0,10,8145000.0
8145,8145999,21.969617273032817,38.56557094730014,0.046747550003103266,1661.3491151332855,528.3378794193268,2101.452293395996,71692,7832,63860,63860,0,10,8146000.0
8146,8146999,21.96994265609471,38.56559000278909,0.04671670640129544,1661.4756944179535,528.401300907135,2101.888816833496,71692,7832,63860,63860,0,10,8147000.0
8147,8147999,21.97022302571263,38.56537804044362,0.04669120439097141,1661.7722449302673,528.4651646614075,2102.1683387756348,71704,7833,63871,63871,0,10,8148000.0
8148,8148999,21.97082831643309,38.565733753956835,0.046676836912735165,1662.0647842884064,528.5293941497803,2102.4166107177734,71707,7834,63873,63873,0,10,8149000.0
8149,8149999,21.97154409057471,38.56645731846084,0.04666100616948632,1662.1951730251312,528.5928659439087,2102.7945709228516,71708,7834,63874,63874,0,10,8150000.0
8150,8150999,21.97225915306369,38.56723272837031,0.046644623436663535,1662.8008177280426,528.6569938659668,2103.055992126465,71740,7837,63903,63903,0,10,8151000.0
8151,8151999,21.973268125318455,38.568523072635905,0.04662104969995895,1663.0885469913483,528.7204098701477,2103.3912773132324,71743,7838,63905,63905,0,10,8152000.0
8152,8152999,21.974418790204492,38.570575071102006,0.0465972564451923,1663.37730717659,528.7841792106628,2103.668556213379,71755,7839,63916,63916,0,10,8153000.0
8153,8153999,21.975765666552185,38.57286946303362,0.0465755040214908,1663.4979050159454,528.8470768928528,2104.072422027588,71755,7839,63916,63916,0,10,8154000.0
8154,8154999,21.97757653748475,38.57507844452007,0.04656409680805551,1663.626505613327,528.9108123779297,2104.4449195861816,71755,7839,63916,63916,0,10,8155000.0
8155,8155999,21.978992552733523,38.57607466097452,0.046539829080698425,1663.7488887310028,528.9734435081482,2104.866912841797,71756,7839,63917,63917,0,10,8156000.0
8156,8156999,21.97994928455498,38.576791358357774,0.046519939185270975,1664.0330488681793,529.0356976985931,2105.6263160705566,71767,7840,63927,63927,0,10,8157000.0
8157,8157999,21.980364921795335,38.57813111385907,0.046503754401828634,1664.1614224910736,529.0996642112732,2106.677822113037,71771,7840,63931,63931,0,10,8158000.0
8158,8158999,21.981194787364082,38.582599626491195,0.046473192069224956,1664.2850720882416,529.1658537387848,2107.278419494629,71771,7840,63931,63931,0,10,8159000.0
8159,8159999,21.98173923927667,38.583950055608305,0.04646121054147878,1664.5650689601898,529.2292289733887,2107.601936340332,71773,7841,63932,63932,0,10,8160000.0
8160,8160999,21.982189712694982,38.58447971030615,0.046449821989394846,1665.1698904037476,529.2938461303711,2107.805850982666,71787,7844,63943,63943,0,10,8161000.0
8161,8161999,21.982411520730086,38.5846056717842,0.046441002889809235,1665.3011031150818,529.3569936752319,2108.201126098633,71788,7844,63944,63944,0,10,8162000.0
8162,8162999,21.98290181794015,38.58503288409878,0.0464250385495677,1665.5832993984222,529.4210388660431,2108.5205078125,71801,7845,63956,63956,0,10,8163000.0
8163,8163999,21.98346836726568,38.58596701687454,0.046411610397979586,1665.7019934654236,529.4839532375336,2108.8482627868652,71801,7845,63956,63956,0,10,8164000.0
8164,8164999,21.984075238143063,38.586517558275965,0.04639935049406929,1666.0015082359314,529.5476746559143,2109.1684036254883,71817,7846,63971,63971,0,10,8165000.0
8165,8165999,21.984484751195208,38.58673693709357,0.046395213117586875,1666.4632289409637,529.6125886440277,2109.4567070007324,71836,7848,63988,63988,0,10,8166000.0
8166,8166999,21.985595398689682,38.591818409505194,0.04637827323274635,1666.7540004253387,529.6760201454163,2109.6649017333984,71848,7849,63999,63999,0,10,8167000.0
8167,8167999,21.98693692298239,38.59465812049414,0.046370625962407264,1666.871666431427,529.7389862537384,2109.921714782715,71848,7849,63999,63999,0,10,8168000.0
8168,8168999,21.98860239078791,38.59804745129245,0.046357009352357204,1667.1556596755981,529.8020083904266,2110.2116165161133,71861,7850,64011,64011,0,10,8169000.0
8169,8169999,21.99030456745055,38.601185656812774,0.04635924898660326,1667.6021683216095,529.865472316742,2110.458511352539,71869,7852,64017,64017,0,10,8170000.0
8170,8170999,21.992633065973347,38.608029001238876,0.04635772091123613,1667.881667137146,529.9291021823883,2110.883232116699,71881,7853,64028,64028,0,10,8171000.0
8171,8171999,21.994443620530845,38.61140890087776,0.04636864909804017,1668.0132658481598,529.9944181442261,2111.1534538269043,71881,7853,64028,64028,0,10,8172000.0
8172,8172999,21.996065535761794,38.6146616230308,0.04638483518915315,1668.4739964008331,530.0596652030945,2111.445625305176,71890,7855,64035,64035,0,10,8173000.0
8173,8173999,21.99738943803726,38.617050715239955,0.046406379602269565,1668.921493768692,530.1227793693542,2111.6466369628906,71914,7857,64057,64057,0,10,8174000.0
8174,8174999,21.998030658133153,38.618299198927616,0.04641933220320371,1669.548228263855,530.1867733001709,2112.3253440856934,71934,7860,64074,64074,0,10,8175000.0
8175,8175999,21.997374842834446,38.61812689247297,0.0464203052269363,1669.6793539524078,530.2494585514069,2113.0383377075195,71938,7860,64078,64078,0,10,8176000.0
8176,8176999,21.99683580369151,38.61718254746718,0.04642083021616561,1669.809723854065,530.3127429485321,2113.4630584716797,71938,7860,64078,64078,0,10,8177000.0
8177,8177999,21.99653715551269,38.61689940988142,0.046422997697298185,1669.9333808422089,530.3768544197083,2113.8826904296875,71939,7860,64079,64079,0,10,8178000.0
8178,8178999,21.996246417491022,38.6163266046696,0.04642196873745541,1670.213478088379,530.4402079582214,2114.0983543395996,71952,7861,64091,64091,0,10,8179000.0
8179,8179999,21.996043002383207,38.61642603719753,0.046422137851875656,1670.4987621307373,530.5037968158722,2114.3554344177246,71964,7862,64102,64102,0,10,8180000.0
8180,8180999,21.99584039826084,38.61592720761294,0.046425422628962654,1670.806209564209,530.5721278190613,2114.580165863037,71976,7863,64113,64113,0,10,8181000.0
8181,8181999,21.995860816853394,38.61559657727153,0.046429070393280036,1670.9296753406525,530.6359212398529,2114.866584777832,71976,7863,64113,64113,0,10,8182000.0
8182,8182999,21.996151305910054,38.615806925887505,0.046437525942201185,1671.3920314311981,530.702894449234,2114.982089996338,71995,7865,64130,64130,0,10,8183000.0
8183,8183999,21.996762715279942,38.616885336253034,0.046447287938465864,1671.5220906734467,530.7670087814331,2115.2956314086914,71995,7865,64130,64130,0,10,8184000.0
8184,8184999,21.997535855496313,38.6180228636475,0.046460790296655174,1671.6516501903534,530.8330266475677,2115.5647163391113,71995,7865,64130,64130,0,10,8185000.0
8185,8185999,21.99802904405455,38.6186907522257,0.04647464944800417,1671.7834787368774,530.8948304653168,2115.7498207092285,71995,7865,64130,64130,0,10,8186000.0
8186,8186999,21.999005453468165,38.620088513887886,0.046483755621269496,1671.9119589328766,530.9570121765137,2116.099338531494,71995,7865,64130,64130,0,10,8187000.0
8187,8187999,22.00006937764653,38.62164119960356,0.046504047812764404,1672.0469100475311,531.0201041698456,2116.372627258301,71995,7865,64130,64130,0,10,8188000.0
8188,8188999,22.001228743749234,38.62342243336353,0.046530466014730765,1672.3327059745789,531.0836448669434,2116.472541809082,72007,7866,64141,64141,0,10,8189000.0
8189,8189999,22.002259161876523,38.62466992033061,0.046548837693088596,1672.6194150447845,531.1456139087677,2116.773147583008,72019,7867,64152,64152,0,10,8190000.0
8190,8190999,22.003610485221916,38.62730226519502,0.04658493612868608,1672.9060277938843,531.2080903053284,2117.040641784668,72031,7868,64163,64163,0,10,8191000.0
8191,8191999,22.005337107663426,38.630081731396274,0.04661131378341932,1673.0269815921783,531.2697520256042,2117.3406982421875,72032,7868,64164,64164,0,10,8192000.0
8192,8192999,22.006962895551688,38.634260045697864,0.04663122562809907,1673.4658777713776,531.3320450782776,2117.471031188965,72039,7870,64169,64169,0,10,8193000.0
8193,8193999,22.008029927094213,38.63534996156803,0.046656095925372565,1674.0977680683136,531.4015636444092,2117.6541595458984,72066,7873,64193,64193,0,10,8194000.0
8194,8194999,22.008257100344707,38.63601606913931,0.04666696617866317,1674.3971419334412,531.4652194976807,2118.6704635620117,72077,7874,64203,64203,0,10,8195000.0
8195,8195999,22.00775827009144,38.636547075482056,0.046658448522722495,1674.6914842128754,531.5296096801758,2119.761661529541,72089,7875,64214,64214,0,10,8196000.0
8196,8196999,22.00716662180511,38.63642375918178,0.046651459725798095,1674.8129799365997,531.5938076972961,2120.3029556274414,72089,7875,64214,64214,0,10,8197000.0
8197,8197999,22.006694847466346,38.63558384629114,0.046641260407763174,1675.1098906993866,531.6593487262726,2120.8279876708984,72106,7876,64230,64230,0,10,8198000.0
8198,8198999,22.006161631767576,38.63469482649823,0.046637123436046535,1675.2313764095306,531.7243747711182,2121.135139465332,72106,7876,64230,64230,0,10,8199000.0
8199,8199999,22.005849645874804,38.633865047831875,0.04663450905603106,1675.6843042373657,531.7881042957306,2121.410541534424,72131,7878,64253,64253,0,10,8200000.0
8200,8200999,22.005280859389792,38.632510687110184,0.04663295170839399,1676.4870781898499,531.860443353653,2121.705066680908,72167,7882,64285,64285,0,10,8201000.0
8201,8201999,22.005176552907567,38.63380299606737,0.046629894343335865,1676.9448039531708,531.9257147312164,2122.0917167663574,72185,7884,64301,64301,0,10,8202000.0
8202,8202999,22.0048699797168,38.63276759587758,0.04662437919039142,1677.0680561065674,531.9906587600708,2122.4755668640137,72186,7884,64302,64302,0,10,8203000.0
8203,8203999,22.004884644040015,38.63218522360008,0.046617938252342284,1677.3497676849365,532.0532350540161,2122.9493827819824,72189,7885,64304,64304,0,10,8204000.0
8204,8204999,22.004913863391202,38.63169436533668,0.04661263848696051,1677.482250213623,532.1163849830627,2123.368553161621,72192,7885,64307,64307,0,10,8205000.0
8205,8205999,22.004901904771906,38.63119209099964,0.04660979644187302,1677.6078598499298,532.1797571182251,2123.7516136169434,72193,7885,64308,64308,0,10,8206000.0
8206,8206999,22.005277161369587,38.63131346839963,0.0465960805086727,1677.7428042888641,532.2531633377075,2124.20756149292,72195,7885,64310,64310,0,10,8207000.0
8207,8207999,22.005739581400512,38.63400115348697,0.04658438239339879,1677.8667800426483,532.3165340423584,2124.6483306884766,72197,7885,64312,64312,0,10,8208000.0
8208,8208999,22.006097714238756,38.63378788979451,0.04657393439710078,1677.9890205860138,532.3810081481934,2125.071933746338,72198,7885,64313,64313,0,10,8209000.0
8209,8209999,22.00670383454665,38.6339803736875,0.0465605384029798,1678.1121034622192,532.4436230659485,2125.6134185791016,72200,7885,64315,64315,0,10,8210000.0
8210,8210999,22.007274177220996,38.6339921823904,0.04654075804440949,1678.7234072685242,532.5069646835327,2125.9740982055664,72214,7888,64326,64326,0,10,8211000.0
8211,8211999,22.00786514964227,38.63390822417729,0.046526283456055695,1678.8372769355774,532.5709998607635,2126.3213844299316,72215,7888,64327,64327,0,10,8212000.0
8212,8212999,22.00827478944504,38.63354367103602,0.046508589786311116,1678.9590666294098,532.6329216957092,2126.7840881347656,72216,7888,64328,64328,0,10,8213000.0
8213,8213999,22.008591481257117,38.632836677451046,0.04649881230940778,1679.086748600006,532.6991560459137,2127.2181434631348,72217,7888,64329,64329,0,10,8214000.0
8214,8214999,22.008525019293014,38.63263596735691,0.046490304063153354,1679.2167432308197,532.7632102966309,2128.0319061279297,72221,7888,64333,64333,0,10,8215000.0
8215,8215999,22.0076933727164,38.63128984380501,0.046487410450447575,1679.3369164466858,532.8267390727997,2128.8412475585938,72226,7888,64338,64338,0,10,8216000.0
8216,8216999,22.006949474730668,38.630921577218196,0.04648671129438764,1679.4586503505707,532.8904058933258,2129.3987350463867,72227,7888,64339,64339,0,10,8217000.0
8217,8217999,22.006190152465525,38.62983018192585,0.046486380631673874,1679.6013238430023,532.9669785499573,2129.831859588623,72227,7888,64339,64339,0,10,8218000.0
8218,8218999,22.00541503094422,38.62832076059465,0.04648690628682439,1679.724539756775,533.0330095291138,2130.1284217834473,72227,7888,64339,64339,0,10,8219000.0
8219,8219999,22.00484114384278,38.62704673587369,0.04649044759528809,1679.8414590358734,533.0959346294403,2130.4143829345703,72227,7888,64339,64339,0,10,8220000.0
8220,8220999,22.004272212031427,38.62593131758975,0.04649131982590293,1680.1281714439392,533.1598072052002,2130.5462799072266,72239,7889,64350,64350,0,10,8221000.0
8221,8221999,22.00355871800252,38.624575011390874,0.04649213915663575,1680.2553489208221,533.2236287593842,2130.8025970458984,72239,7889,64350,64350,0,10,8222000.0
8222,8222999,22.003243791727705,38.62376057489193,0.04648832254616675,1680.549917936325,533.287763595581,2130.977981567383,72251,7890,64361,64361,0,10,8223000.0
8223,8223999,22.002799495914438,38.62298916206587,0.0464872500012764,1680.8318388462067,533.3510205745697,2131.2611541748047,72263,7891,64372,64372,0,10,8224000.0
8224,8224999,22.002298424465927,38.62195664042788,0.04648556388364977,1681.4502804279327,533.41419672966,2131.387149810791,72296,7894,64402,64402,0,10,8225000.0
8225,8225999,22.001897525954003,38.6208676359276,0.04648273123812119,1681.8982622623444,533.4790387153625,2131.6681632995605,72315,7896,64419,64419,0,10,8226000.0
8226,8226999,22.00179497634764,38.62021759675944,0.046478675968185446,1682.182144165039,533.5437006950378,2131.9530487060547,72317,7897,64420,64420,0,10,8227000.0
8227,8227999,22.001735068511923,38.619701496315116,0.04647155261811042,1682.4781470298767,533.6106352806091,2132.151252746582,72319,7898,64421,64421,0,10,8228000.0
8228,8228999,22.00191272246137,38.61937112102088,0.0464669708049521,1682.923811674118,533.6746711730957,2132.49515914917,72343,7900,64443,64443,0,10,8229000.0
8229,8229999,22.002369963610725,38.61939779625482,0.046461611559496685,1683.2075674533844,533.7374260425568,2132.9458084106445,72354,7901,64453,64453,0,10,8230000.0
8230,8230999,22.002665059307475,38.61930819538241,0.04646301616985504,1683.3355159759521,533.8008472919464,2133.327522277832,72354,7901,64453,64453,0,10,8231000.0
8231,8231999,22.00304587507927,38.619159786613494,0.046461112974471974,1683.4587452411652,533.863763332367,2133.621608734131,72354,7901,64453,64453,0,10,8232000.0
8232,8232999,22.00325425902214,38.618938485248506,0.0464542251824378,1683.912178993225,533.9288091659546,2133.7339363098145,72358,7903,64455,64455,0,10,8233000.0
8233,8233999,22.00346069276557,38.61845504299081,0.046444536427384664,1684.038819551468,533.9931335449219,2134.0390129089355,72358,7903,64455,64455,0,10,8234000.0
8234,8234999,22.003367729278697,38.61898174289962,0.046438916593186774,1684.3357543945312,534.0572552680969,2134.295909881592,72371,7904,64467,64467,0,10,8235000.0
8235,8235999,22.00322800992838,38.619340069430585,0.04642272165145078,1684.6581346988678,534.1315457820892,2135.3492736816406,72380,7905,64475,64475,0,10,8236000.0
8236,8236999,22.002848086169873,38.61859586319265,0.046408333471464336,1684.9503931999207,534.1953594684601,2135.772819519043,72382,7906,64476,64476,0,10,8237000.0
8237,8237999,22.002608935376763,38.618778750769344,0.046396085607152915,1685.0753750801086,534.2617967128754,2136.342727661133,72383,7906,64477,64477,0,10,8238000.0
8238,8238999,22.002488655088417,38.61882267882046,0.046390534235720926,1685.5328404903412,534.3292906284332,2136.7894172668457,72398,7908,64490,64490,0,10,8239000.0
8239,8239999,22.002412764623408,38.618198794150494,0.046382667602831607,1685.828694820404,534.3953619003296,2137.1160736083984,72410,7909,64501,64501,0,10,8240000.0
8240,8240999,22.00241649823107,38.61805717225528,0.0463767993631059,1685.9559156894684,534.4592878818512,2137.466484069824,72410,7909,64501,64501,0,10,8241000.0
8241,8241999,22.002570835055185,38.61770289762227,0.04636626308034897,1686.4114844799042,534.5222103595734,2137.624668121338,72429,7911,64518,64518,0,10,8242000.0
8242,8242999,22.002677828431796,38.61724335476605,0.04635664851721999,1687.0307023525238,534.5862002372742,2137.7418899536133,72455,7914,64541,64541,0,10,8243000.0
8243,8243999,22.00281191695705,38.6168282035765,0.046347937167700914,1687.651765346527,534.6508457660675,2137.876792907715,72486,7917,64569,64569,0,10,8244000.0
8244,8244999,22.00291812526577,38.616608591839054,0.046347268447397005,1687.776175737381,534.7142808437347,2138.126735687256,72486,7917,64569,64569,0,10,8245000.0
8245,8245999,22.0032779784808,38.61674726751083,0.04633881600007117,1687.9362988471985,534.7801587581635,2138.4186630249023,72487,7917,64570,64570,0,10,8246000.0
8246,8246999,22.00365506198265,38.616952431529825,0.04633717412024341,1688.5602097511292,534.8443894386292,2138.529945373535,72536,7920,64616,64616,0,10,8247000.0
8247,8247999,22.003874597204458,38.616780887726534,0.046333028198933035,1688.8574521541595,534.9095392227173,2138.6921005249023,72548,7921,64627,64627,0,10,8248000.0
8248,8248999,22.00460871230661,38.61910460545142,0.046332332970651646,1689.1409223079681,534.972916841507,2139.0041122436523,72559,7922,64637,64637,0,10,8249000.0
8249,8249999,22.005143303241915,38.61930566470975,0.046339117103595395,1689.2670369148254,535.0356757640839,2139.349479675293,72559,7922,64637,64637,0,10,8250000.0
8250,8250999,22.005720022437185,38.619468489720205,0.0463423269283495,1689.3835062980652,535.098516702652,2139.647331237793,72560,7922,64638,64638,0,10,8251000.0
8251,8251999,22.006737245721308,38.620954777934536,0.04634572196964626,1689.676106452942,535.1611745357513,2139.830711364746,72572,7923,64649,64649,0,10,8252000.0
8252,8252999,22.0075740029282,38.62224312294669,0.04635105196383338,1690.3007066249847,535.2257072925568,2139.950168609619,72588,7926,64662,64662,0,10,8253000.0
8253,8253999,22.00853947361282,38.6230423603357,0.04635917049647331,1690.7404901981354,535.287230014801,2140.139228820801,72609,7928,64681,64681,0,10,8254000.0
8254,8254999,22.009089301480312,38.622977587870054,0.046365714330503405,1691.0217988491058,535.3490333557129,2140.44388961792,72616,7929,64687,64687,0,10,8255000.0
8255,8255999,22.009077871330533,38.623588400161736,0.04636651194138397,1691.1467399597168,535.4144048690796,2141.8687057495117,72622,7929,64693,64693,0,10,8256000.0
8256,8256999,22.009307294841673,38.62414840812467,0.04637584617277124,1691.2788627147675,535.4782314300537,2142.576114654541,72624,7929,64695,64695,0,10,8257000.0
8257,8257999,22.010070882484314,38.625831456881954,0.046384228736493394,1691.5816485881805,535.5528430938721,2142.9937896728516,72638,7930,64708,64708,0,10,8258000.0
8258,8258999,22.01075400060724,38.62974796947629,0.0463924420341667,1691.6986248493195,535.616171836853,2143.3306198120117,72638,7930,64708,64708,0,10,8259000.0
8259,8259999,22.01153254811377,38.631197438307,0.04640326680040319,1691.814915895462,535.6787955760956,2143.671142578125,72638,7930,64708,64708,0,10,8260000.0
8260,8260999,22.012238739525507,38.63199913756778,0.04640740300823987,1692.4460384845734,535.7458939552307,2143.918296813965,72665,7933,64732,64732,0,10,8261000.0
8261,8261999,22.013349028602914,38.63367760878658,0.046411534838686874,1692.5611009597778,535.808135509491,2144.3343772888184,72665,7933,64732,64732,0,10,8262000.0
8262,8262999,22.014277047694453,38.63472039798742,0.04641660326228736,1692.6782839298248,535.8712759017944,2144.715133666992,72665,7933,64732,64732,0,10,8263000.0
8263,8263999,22.015432534680805,38.63616058729196,0.046428647634323084,1692.791930437088,535.9334609508514,2145.0769538879395,72666,7933,64733,64733,0,10,8264000.0
8264,8264999,22.016506693680167,38.6385518809355,0.04643239823650891,1693.072872877121,535.9969437122345,2145.4079933166504,72679,7934,64745,64745,0,10,8265000.0
8265,8265999,22.01764420226457,38.640154828952326,0.046446845609451115,1693.6837856769562,536.0612404346466,2145.648105621338,72715,7937,64778,64778,0,10,8266000.0
8266,8266999,22.018927288627996,38.64171466014781,0.04646561927498727,1694.1298825740814,536.1245307922363,2145.761474609375,72736,7939,64797,64797,0,10,8267000.0
8267,8267999,22.02006687980755,38.642878738086196,0.046491611603813654,1694.2540490627289,536.1883845329285,2146.267158508301,72737,7939,64798,64798,0,10,8268000.0
8268,8268999,22.02144783243213,38.64460231237194,0.04651862687764463,1694.5396406650543,536.2518346309662,2146.692611694336,72748,7940,64808,64808,0,10,8269000.0
8269,8269999,22.023241645376302,38.648459984515135,0.04654798276883887,1694.9892148971558,536.3153064250946,2146.9923515319824,72773,7942,64831,64831,0,10,8270000.0
8270,8270999,22.024572060065537,38.64971153617443,0.046571910580827436,1695.451720714569,536.3786578178406,2147.2504653930664,72799,7944,64855,64855,0,10,8271000.0
8271,8271999,22.02592962172726,38.65111266519397,0.046603740257226356,1695.7455558776855,536.4429609775543,2147.485607147217,72811,7945,64866,64866,0,10,8272000.0
8272,8272999,22.027317083167066,38.65242266768311,0.04662794090010758,1695.87051820755,536.5049359798431,2147.846061706543,72812,7945,64867,64867,0,10,8273000.0
8273,8273999,22.027757616842237,38.65308981960697,0.04662798357487308,1696.3280546665192,536.568053483963,2148.893939971924,72830,7947,64883,64883,0,10,8274000.0
8274,8274999,22.027397715465302,38.6540534168298,0.046625600216962715,1696.7760207653046,536.6322989463806,2149.701587677002,72857,7949,64908,64908,0,10,8275000.0
8275,8275999,22.026986948953883,38.65406770493617,0.046622955624675,1697.4024503231049,536.6969039440155,2150.0533752441406,72878,7952,64926,64926,0,10,8276000.0
8276,8276999,22.026599000818567,38.65444377978587,0.04662045461473563,1697.6834812164307,536.7607147693634,2150.4796981811523,72885,7953,64932,64932,0,10,8277000.0
8277,8277999,22.026365342147162,38.65415064725414,0.04661786145414548,1698.2996702194214,536.8239142894745,2150.712417602539,72911,7956,64955,64955,0,10,8278000.0
8278,8278999,22.0259902850227,38.653659285012516,0.046619758151266844,1698.446716785431,536.8988003730774,2151.2007789611816,72913,7956,64957,64957,0,10,8279000.0
8279,8279999,22.02598312578725,38.65326728347587,0.04661774865293877,1699.063315629959,536.9642992019653,2151.357467651367,72942,7959,64983,64983,0,10,8280000.0
8280,8280999,22.02620411982821,38.6537494469055,0.04661562279556741,1699.7005128860474,537.030903339386,2151.5762786865234,72978,7962,65016,65016,0,10,8281000.0
8281,8281999,22.026328973434705,38.65364223527913,0.04661080218205271,1700.1573889255524,537.094607591629,2151.8814849853516,73002,7964,65038,65038,0,10,8282000.0
8282,8282999,22.026521277844317,38.65362220644848,0.046605656698903264,1700.2790567874908,537.1592485904694,2152.3181648254395,73003,7964,65039,65039,0,10,8283000.0
8283,8283999,22.026937872227297,38.65411088589422,0.04660468585799138,1700.739308834076,537.2230620384216,2152.504825592041,73025,7966,65059,65059,0,10,8284000.0
8284,8284999,22.027396443291803,38.65437124084711,0.04660030662299208,1700.858409166336,537.2863037586212,2152.8163146972656,73025,7966,65059,65059,0,10,8285000.0
8285,8285999,22.027855097640142,38.654513345322734,0.046598595063714554,1700.9764902591705,537.3500683307648,2153.2716636657715,73025,7966,65059,65059,0,10,8286000.0
8286,8286999,22.028249024533807,38.65451037431099,0.04659178157863153,1701.2647354602814,537.4141492843628,2153.5449867248535,73037,7967,65070,65070,0,10,8287000.0
8287,8287999,22.028713173163773,38.654492571152936,0.04658627562941908,1701.5545604228973,537.4777328968048,2153.9777755737305,73049,7968,65081,65081,0,10,8288000.0
8288,8288999,22.02908577244065,38.65450874979486,0.046579148285851746,1701.678965806961,537.542316198349,2154.341281890869,73049,7968,65081,65081,0,10,8289000.0
8289,8289999,22.029173300236423,38.65382720407997,0.046574822863810206,1702.2976984977722,537.6067886352539,2154.6440200805664,73076,7971,65105,65105,0,10,8290000.0
8290,8290999,22.029257424123138,38.65520893385384,0.0465575230611357,1702.4329357147217,537.6710753440857,2155.8053588867188,73081,7971,65110,65110,0,10,8291000.0
8291,8291999,22.029098900142433,38.654503730899386,0.046539265219674664,1702.57151055336,537.7354545593262,2156.4734382629395,73084,7971,65113,65113,0,10,8292000.0
8292,8292999,22.028956443309003,38.65450078988722,0.04652594357426887,1702.8666825294495,537.8003709316254,2156.940704345703,73092,7972,65120,65120,0,10,8293000.0
8293,8293999,22.028793256245468,38.653815470195894,0.04651861091505727,1703.3390052318573,537.8651783466339,2157.1230812072754,73116,7974,65142,65142,0,10,8294000.0
8294,8294999,22.028883689597492,38.653572251075204,0.04650098200344999,1703.6336643695831,537.930526971817,2157.2931938171387,73128,7975,65153,65153,0,10,8295000.0
8295,8295999,22.028941995559165,38.6537022609332,0.046488560159185344,1703.9191625118256,537.9948906898499,2157.5810546875,73130,7976,65154,65154,0,10,8296000.0
8296,8296999,22.0290031132578,38.65400560544507,0.04647626205552624,1704.0429067611694,538.0576536655426,2157.9189682006836,73131,7976,65155,65155,0,10,8297000.0
8297,8297999,22.02910117806242,38.65398517464711,0.04646594818507466,1704.3463516235352,538.1217379570007,2158.164279937744,73134,7977,65157,65157,0,10,8298000.0
8298,8298999,22.029323991940615,38.65408621485934,0.046458233377191904,1704.6337549686432,538.1865930557251,2158.376567840576,73136,7978,65158,65158,0,10,8299000.0
8299,8299999,22.029504350820854,38.653779971576895,0.046448059515292295,1704.7703998088837,538.2501909732819,2158.625846862793,73136,7978,65158,65158,0,10,8300000.0
8300,8300999,22.02986895473885,38.654759240053835,0.04643606279722856,1705.2223525047302,538.3146390914917,2158.711414337158,73161,7980,65181,65181,0,10,8301000.0
8301,8301999,22.03009590351842,38.654618750772215,0.0464257427228586,1705.6883580684662,538.380211353302,2158.8023109436035,73185,7982,65203,65203,0,10,8302000.0
8302,8302999,22.030513301830027,38.65500312440931,0.04641722815169225,1705.8200232982635,538.4441976547241,2159.1563453674316,73185,7982,65203,65203,0,10,8303000.0
8303,8303999,22.03076447181087,38.65500286191114,0.04640900848701468,1706.2742788791656,538.507735490799,2159.325294494629,73199,7984,65215,65215,0,10,8304000.0
8304,8304999,22.030984101330116,38.65489017744106,0.0463999171754933,1706.563304901123,538.5717144012451,2159.561740875244,73210,7985,65225,65225,0,10,8305000.0
8305,8305999,22.031378992685962,38.65490988514852,0.046389626967059616,1706.8614146709442,538.6335875988007,2159.8640747070312,73222,7986,65236,65236,0,10,8306000.0
8306,8306999,22.031729750687894,38.65481923694321,0.04637517486779097,1707.0068867206573,538.7082676887512,2160.093360900879,73223,7986,65237,65237,0,10,8307000.0
8307,8307999,22.031967805046772,38.655257133227636,0.04636797321432462,1707.4611263275146,538.772052526474,2160.20320892334,73246,7988,65258,65258,0,10,8308000.0
8308,8308999,22.031887086517486,38.65438427744253,0.046358757136547246,1707.7536308765411,538.8382906913757,2160.446147918701,73257,7989,65268,65268,0,10,8309000.0
8309,8309999,22.032168170732202,38.65439099447946,0.04633185326435929,1708.0587983131409,538.901688337326,2161.6191368103027,73271,7990,65281,65281,0,10,8310000.0
8310,8310999,22.032241534702912,38.65397117330715,0.04630351351563555,1708.3494338989258,538.9658789634705,2162.2559204101562,73275,7991,65284,65284,0,10,8311000.0
8311,8311999,22.032668074727564,38.65450039288252,0.046270952697655354,1708.4683463573456,539.0313410758972,2162.716526031494,73276,7991,65285,65285,0,10,8312000.0
8312,8312999,22.032877289834023,38.654611461717394,0.04624669791789737,1708.598478794098,539.0963604450226,2163.180290222168,73276,7991,65285,65285,0,10,8313000.0
8313,8313999,22.03312397314595,38.654874704465016,0.04622126824000128,1708.8938403129578,539.1605832576752,2163.432907104492,73278,7992,65286,65286,0,10,8314000.0
8314,8314999,22.03377612264409,38.655169723756345,0.04619502840332601,1709.1789309978485,539.2240812778473,2163.6989097595215,73290,7993,65297,65297,0,10,8315000.0
8315,8315999,22.034322722805456,38.6555038082476,0.04617491753648817,1709.301010608673,539.2884421348572,2164.1677284240723,73290,7993,65297,65297,0,10,8316000.0
8316,8316999,22.034679445039135,38.655596740596714,0.04616083716693631,1709.426587820053,539.349837064743,2164.5576171875,73291,7993,65298,65298,0,10,8317000.0
8317,8317999,22.03508353557007,38.655387391237134,0.04614568436320399,1709.717021226883,539.4130816459656,2164.6970405578613,73303,7994,65309,65309,0,10,8318000.0
8318,8318999,22.035604654677783,38.65529487512989,0.04613094611616608,1709.8325374126434,539.4766781330109,2165.161087036133,73304,7994,65310,65310,0,10,8319000.0
8319,8319999,22.036568172383884,38.65593941061768,0.04611782997284519,1710.1291534900665,539.5411236286163,2165.5062103271484,73316,7995,65321,65321,0,10,8320000.0
8320,8320999,22.037283718071972,38.6563312914153,0.04611120140269109,1710.5753061771393,539.6042520999908,2165.665584564209,73340,7997,65343,65343,0,10,8321000.0
8321,8321999,22.03784013991868,38.65638693772223,0.04609977256662601,1710.8788273334503,539.6702675819397,2166.0530548095703,73351,7998,65353,65353,0,10,8322000.0
8322,8322999,22.038591000010896,38.65666535400561,0.04609235196376871,1711.1851089000702,539.7398042678833,2166.4520721435547,73364,7999,65365,65365,0,10,8323000.0
8323,8323999,22.039528380248022,38.65734986920301,0.04607751174310859,1711.3136005401611,539.8058590888977,2166.742198944092,73364,7999,65365,65365,0,10,8324000.0
8324,8324999,22.040607389870786,38.657832250848585,0.04605320847879435,1711.6238601207733,539.8821406364441,2167.121269226074,73376,8000,65376,65376,0,10,8325000.0
8325,8325999,22.041554556266814,38.65807426880991,0.046037564024211,1711.9309751987457,539.949031829834,2167.565212249756,73384,8001,65383,65383,0,10,8326000.0
8326,8326999,22.04264718896215,38.65881531120484,0.04603336851693429,1712.0560293197632,540.0159733295441,2167.904411315918,73384,8001,65383,65383,0,10,8327000.0
8327,8327999,22.043770946283068,38.65963285642459,0.04603331604521099,1712.3416590690613,540.0790736675262,2168.047676086426,73386,8002,65384,65384,0,10,8328000.0
8328,8328999,22.044834907943574,38.66008868565261,0.04601200306602704,1712.4575440883636,540.1430420875549,2168.5174407958984,73386,8002,65384,65384,0,10,8329000.0
8329,8329999,22.045142584379732,38.66077184843599,0.04599679588954786,1712.5942120552063,540.2083854675293,2169.657703399658,73389,8002,65387,65387,0,10,8330000.0
8330,8330999,22.044996895881674,38.66005833309095,0.04599292191729465,1712.7241659164429,540.2738733291626,2170.346576690674,73390,8002,65388,65388,0,10,8331000.0
8331,8331999,22.044951328426873,38.66026200609909,0.04598794561681452,1713.0132856369019,540.3370881080627,2170.8078651428223,73403,8003,65400,65400,0,10,8332000.0
8332,8332999,22.045188797140746,38.661118734613126,0.04598645416241198,1713.3051581382751,540.4000341892242,2171.182373046875,73416,8004,65412,65412,0,10,8333000.0
8333,8333999,22.045512542370343,38.661030663593245,0.045980643733974036,1713.9221198558807,540.4647805690765,2171.3712615966797,73452,8007,65445,65445,0,10,8334000.0
8334,8334999,22.046043381292353,38.66201877336655,0.04599109169757365,1714.0587320327759,540.5326080322266,2171.709732055664,73452,8007,65445,65445,0,10,8335000.0
8335,8335999,22.046513344193567,38.66234461220696,0.045988981153928465,1714.1858777999878,540.5985381603241,2172.127826690674,73452,8007,65445,65445,0,10,8336000.0
8336,8336999,22.04709452709185,38.66293270477223,0.04600215909461158,1714.644146680832,540.662116765976,2172.545753479004,73461,8009,65452,65452,0,10,8337000.0
8337,8337999,22.047763522078302,38.66394085853631,0.04600479406930724,1714.768785238266,540.724837064743,2172.963390350342,73461,8009,65452,65452,0,10,8338000.0
8338,8338999,22.04867791853872,38.6652006596078,0.04602055055937693,1714.9046864509583,540.7916724681854,2173.2290649414062,73461,8009,65452,65452,0,10,8339000.0
8339,8339999,22.049945550243514,38.667163066560676,0.04604590382729179,1715.0542011260986,540.8658876419067,2173.6676063537598,73462,8009,65453,65453,0,10,8340000.0
8340,8340999,22.05106998477183,38.669005371996676,0.046060258096193185,1715.176864862442,540.9282767772675,2174.020408630371,73464,8009,65455,65455,0,10,8341000.0
8341,8341999,22.05231866007479,38.670254107085235,0.04607148287213081,1715.6405339241028,540.9926164150238,2174.2457542419434,73487,8011,65476,65476,0,10,8342000.0
8342,8342999,22.053692828123122,38.67212567612718,0.0461030925884407,1715.7573750019073,541.0553469657898,2174.603225708008,73487,8011,65476,65476,0,10,8343000.0
8343,8343999,22.055534211356733,38.674676537524,0.04613773563407231,1716.041137933731,541.1176578998566,2174.878288269043,73499,8012,65487,65487,0,10,8344000.0
8344,8344999,22.057171467653465,38.67635871083428,0.04616287762653659,1716.3283698558807,541.1797194480896,2175.1650581359863,73511,8013,65498,65498,0,10,8345000.0
8345,8345999,22.05921305687899,38.67904055946964,0.04620056009941742,1716.7903306484222,541.2422504425049,2175.371612548828,73535,8015,65520,65520,0,10,8346000.0
8346,8346999,22.060783354818263,38.68061347465568,0.04623100180064632,1716.9183814525604,541.3092110157013,2175.8477897644043,73538,8015,65523,65523,0,10,8347000.0
8347,8347999,22.06247458069751,38.68229045730194,0.046250457168147796,1717.2001087665558,541.3732056617737,2176.1843757629395,73541,8016,65525,65525,0,10,8348000.0
8348,8348999,22.063084737911026,38.68224560658603,0.04626510549916252,1717.4915182590485,541.4353048801422,2176.5149688720703,73545,8017,65528,65528,0,10,8349000.0
8349,8349999,22.062955345304147,38.68237995428841,0.046249131541938215,1717.7814364433289,541.4985387325287,2177.652088165283,73559,8018,65541,65541,0,10,8350000.0
8350,8350999,22.0626950012005,38.68199237549177,0.046230003767153804,1718.2390990257263,541.5621588230133,2178.108371734619,73584,8020,65564,65564,0,10,8351000.0
8351,8351999,22.062617258901675,38.68199155342624,0.04622220841676761,1718.704930305481,541.627072095871,2178.4388885498047,73604,8022,65582,65582,0,10,8352000.0
8352,8352999,22.06243291032665,38.68100541208127,0.04620821414925591,1718.8223330974579,541.6892240047455,2178.7896842956543,73605,8022,65583,65583,0,10,8353000.0
8353,8353999,22.062144927090472,38.679828756368934,0.046193300818763494,1719.1209478378296,541.7529263496399,2179.0109481811523,73617,8023,65594,65594,0,10,8354000.0
8354,8354999,22.061804660988862,38.67855173363868,0.0461843610854924,1719.4064028263092,541.8167655467987,2179.268970489502,73629,8024,65605,65605,0,10,8355000.0
8355,8355999,22.061454402566003,38.67738417773158,0.04617412599112258,1719.5252964496613,541.8802745342255,2179.510959625244,73629,8024,65605,65605,0,10,8356000.0
8356,8356999,22.06124952751893,38.67641116475601,0.04616247218032066,1720.1456472873688,541.9442913532257,2179.711711883545,73665,8027,65638,65638,0,10,8357000.0
8357,8357999,22.061083628880706,38.67560639629459,0.04615247122245336,1720.2640075683594,542.0061626434326,2179.9942932128906,73666,8027,65639,65639,0,10,8358000.0
8358,8358999,22.060757633904103,38.674425627808034,0.046145186382085646,1720.5558369159698,542.0706949234009,2180.125904083252,73678,8028,65650,65650,0,10,8359000.0
8359,8359999,22.060580991785802,38.67354704950177,0.04613685806648338,1720.69007730484,542.1373748779297,2180.403610229492,73678,8028,65650,65650,0,10,8360000.0
8360,8360999,22.060440985809567,38.67265307673907,0.046127656030400255,1721.3047106266022,542.201308965683,2180.476390838623,73703,8031,65672,65672,0,10,8361000.0
8361,8361999,22.060416589922333,38.67178676743506,0.04611756765732922,1721.4298813343048,542.264044046402,2180.6089057922363,73703,8031,65672,65672,0,10,8362000.0
8362,8362999,22.060389445717373,38.671063436022685,0.046105626303147074,1721.5462701320648,542.3256549835205,2180.757049560547,73703,8031,65672,65672,0,10,8363000.0
8363,8363999,22.060385843348136,38.670018235109296,0.04609135651904772,1721.676173210144,542.3879222869873,2180.942481994629,73704,8031,65673,65673,0,10,8364000.0
8364,8364999,22.06046390378487,38.66909820019698,0.04608023842487563,1722.2941303253174,542.4504108428955,2180.948268890381,73740,8034,65706,65706,0,10,8365000.0
8365,8365999,22.060735415490385,38.668421518975514,0.04606013516815466,1722.4238419532776,542.5165798664093,2181.130401611328,73740,8034,65706,65706,0,10,8366000.0
8366,8366999,22.060965841018156,38.667696387120486,0.04603753230694796,1722.8835196495056,542.5799427032471,2181.28466796875,73755,8036,65719,65719,0,10,8367000.0
8367,8367999,22.061039111325435,38.6669388388483,0.04601607915523831,1723.0104005336761,542.6438028812408,2181.5361976623535,73755,8036,65719,65719,0,10,8368000.0
8368,8368999,22.06085709676648,38.66610078445404,0.046004496068255185,1723.4823470115662,542.707929611206,2181.7647743225098,73794,8038,65756,65756,0,10,8369000.0
8369,8369999,22.0603394061103,38.66527618407256,0.045997887239956126,1723.6187632083893,542.7724480628967,2183.1396293640137,73804,8038,65766,65766,0,10,8370000.0
8370,8370999,22.059597786975285,38.664343094039495,0.04599188103152607,1723.9187865257263,542.8414607048035,2183.722557067871,73817,8039,65778,65778,0,10,8371000.0
8371,8371999,22.058820345082847,38.66273043874449,0.045991778020262664,1724.3857588768005,542.9080681800842,2184.0319213867188,73841,8041,65800,65800,0,10,8372000.0
8372,8372999,22.058095288308685,38.661175025774185,0.04599128080184589,1724.511361837387,542.9745187759399,2184.4475708007812,73842,8041,65801,65801,0,10,8373000.0
8373,8373999,22.057640196491384,38.661097716415576,0.04598631706013867,1724.9781348705292,543.0415368080139,2184.6827812194824,73867,8043,65824,65824,0,10,8374000.0
8374,8374999,22.056948660124387,38.65957806937192,0.04598677857293798,1725.105391740799,543.1078271865845,2185.0094985961914,73868,8043,65825,65825,0,10,8375000.0
8375,8375999,22.05620582431925,38.65836587591167,0.04598739669690266,1725.4047827720642,543.1744384765625,2185.2071113586426,73881,8044,65837,65837,0,10,8376000.0
8376,8376999,22.05585431115746,38.65955139949359,0.04598061079792537,1725.8758239746094,543.242945432663,2185.4367599487305,73896,8046,65850,65850,0,10,8377000.0
8377,8377999,22.055372361090793,38.65928245465314,0.04597539264917905,1726.3431434631348,543.3094396591187,2185.735565185547,73920,8048,65872,65872,0,10,8378000.0
8378,8378999,22.054936822660025,38.65843229478492,0.04597060367648331,1726.6366679668427,543.374929189682,2185.93363571167,73930,8049,65881,65881,0,10,8379000.0
8379,8379999,22.054290870795047,38.65692290613357,0.04596675872684619,1727.0837409496307,543.438319683075,2186.153663635254,73954,8051,65903,65903,0,10,8380000.0
8380,8380999,22.053781439044506,38.655672110601785,0.04596212575035885,1728.2119586467743,543.5021903514862,2186.1460494995117,74006,8057,65949,65949,0,10,8381000.0
8381,8381999,22.053478218229845,38.65578608040093,0.04595496375013197,1728.6673934459686,543.5663239955902,2186.341526031494,74030,8059,65971,65971,0,10,8382000.0
8382,8382999,22.05325869738941,38.65492105017376,0.04594632832102863,1728.965126991272,543.6336913108826,2186.7517013549805,74043,8060,65983,65983,0,10,8383000.0
8383,8383999,22.053250450403294,38.654479712176986,0.04593630716241004,1729.5914068222046,543.6994273662567,2186.973690032959,74080,8063,66017,66017,0,10,8384000.0
8384,8384999,22.053115446695376,38.65366315223998,0.045926818734760455,1729.878428220749,543.7624831199646,2187.3483238220215,74092,8064,66028,66028,0,10,8385000.0
8385,8385999,22.053299416004485,38.65346377988614,0.04591656186252091,1730.4944851398468,543.8256888389587,2187.4871711730957,74128,8067,66061,66061,0,10,8386000.0
8386,8386999,22.053247748235837,38.652752302555285,0.04590402139155059,1730.96444272995,543.8897342681885,2187.741985321045,74151,8069,66082,66082,0,10,8387000.0
8387,8387999,22.05325893282416,38.651952328878984,0.04588823872217218,1731.5794224739075,543.9536085128784,2187.9402770996094,74188,8072,66116,66116,0,10,8388000.0
8388,8388999,22.053442073533173,38.65313926067454,0.0458823604365205,1731.6985032558441,544.014657497406,2188.230136871338,74188,8072,66116,66116,0,10,8389000.0
8389,8389999,22.052687661729678,38.65177570542563,0.04588419422275691,1731.9971837997437,544.078920841217,2189.4785118103027,74232,8073,66159,66159,0,10,8390000.0
8390,8390999,22.051641894489325,38.65008492770031,0.04588443982880053,1732.2988815307617,544.1469583511353,2190.0317459106445,74242,8074,66168,66168,0,10,8391000.0
8391,8391999,22.050903414482196,38.64913313827337,0.04588397765950247,1732.7659685611725,544.2121040821075,2190.5023078918457,74288,8076,66212,66212,0,10,8392000.0
8392,8392999,22.050153811064803,38.64772770237264,0.045884286566032495,1733.0638871192932,544.2771232128143,2190.865337371826,74303,8077,66226,66226,0,10,8393000.0
8393,8393999,22.049620796560365,38.646766030514456,0.045885749879591375,1733.3499405384064,544.3415002822876,2191.1336822509766,74306,8078,66228,66228,0,10,8394000.0
8394,8394999,22.04924981124437,38.645852237023846,0.04588694329422438,1733.825117111206,544.4077003002167,2191.307025909424,74328,8080,66248,66248,0,10,8395000.0
8395,8395999,22.04891794028985,38.644992280122935,0.045888992223032554,1734.116218805313,544.4712793827057,2191.555767059326,74330,8081,66249,66249,0,10,8396000.0
8396,8396999,22.048552927868954,38.64393065558499,0.04588782185778062,1734.246388912201,544.5337233543396,2191.8761863708496,74333,8081,66252,66252,0,10,8397000.0
8397,8397999,22.048591513500806,38.646553740650376,0.0458804456529307,1734.8674829006195,544.5984303951263,2192.0363807678223,74361,8084,66277,66277,0,10,8398000.0
8398,8398999,22.048613165103337,38.646750103008834,0.045878637505254116,1735.3223371505737,544.6622166633606,2192.247383117676,74374,8086,66288,66288,0,10,8399000.0
8399,8399999,22.048577624510955,38.6462569417018,0.04588233959287913,1735.9392313957214,544.725120306015,2192.4702682495117,74401,8089,66312,66312,0,10,8400000.0
8400,8400999,22.048589252987448,38.64622228991351,0.04587988875638527,1736.3890776634216,544.7894921302795,2192.5888748168945,74426,8091,66335,66335,0,10,8401000.0
8401,8401999,22.048674610909675,38.64638437361097,0.045887341520369884,1736.5233850479126,544.8567826747894,2192.9713859558105,74429,8091,66338,66338,0,10,8402000.0
8402,8402999,22.048883059575505,38.64647862771991,0.04588517266396275,1736.8345086574554,544.9294188022614,2193.2524070739746,74433,8092,66341,66341,0,10,8403000.0
8403,8403999,22.049125946057394,38.64641173629266,0.04588080176100684,1736.9652779102325,544.995534658432,2193.656410217285,74438,8092,66346,66346,0,10,8404000.0
8404,8404999,22.04938341393477,38.64606970893159,0.045880018384397814,1737.2522315979004,545.0590105056763,2193.9015464782715,74450,8093,66357,66357,0,10,8405000.0
8405,8405999,22.050016077324,38.646632006428455,0.045877276388251786,1737.5397741794586,545.1232333183289,2194.2806129455566,74456,8094,66362,66362,0,10,8406000.0
8406,8406999,22.050563089570613,38.64662150670924,0.04587900919775878,1737.6577184200287,545.1872100830078,2194.5977630615234,74459,8094,66365,66365,0,10,8407000.0
8407,8407999,22.05111901497208,38.646816058656164,0.04587818486767914,1738.1351130008698,545.2569286823273,2194.826015472412,74477,8096,66381,66381,0,10,8408000.0
8408,8408999,22.051374348399886,38.64637240345319,0.04588134710422431,1738.6075055599213,545.3228490352631,2195.1034812927246,74502,8098,66404,66404,0,10,8409000.0
8409,8409999,22.05142435257328,38.646162025208845,0.045856514697540374,1738.745038986206,545.3881204128265,2196.3128967285156,74508,8098,66410,66410,0,10,8410000.0
8410,8410999,22.051484439714812,38.64630495682713,0.04583031240879576,1739.2064900398254,545.4523267745972,2196.984317779541,74533,8100,66433,66433,0,10,8411000.0
8411,8411999,22.051358974077697,38.6454593592093,0.045803846009838445,1739.6723549365997,545.5153403282166,2197.5526161193848,74557,8102,66455,66455,0,10,8412000.0
8412,8412999,22.051424407164188,38.64484148707502,0.045777882881658294,1739.962620973587,545.5800516605377,2198.020538330078,74564,8103,66461,66461,0,10,8413000.0
8413,8413999,22.051500035474138,38.644113143185656,0.04575404244053083,1740.4223165512085,545.6449229717255,2198.451789855957,74590,8105,66485,66485,0,10,8414000.0
8414,8414999,22.05128874339182,38.6430253200284,0.0457353170456406,1740.8885929584503,545.7089149951935,2198.891902923584,74611,8107,66504,66504,0,10,8415000.0
8415,8415999,22.051293750150208,38.64230008978416,0.045710760386184046,1741.1951158046722,545.7726242542267,2199.331672668457,74613,8108,66505,66505,0,10,8416000.0
8416,8416999,22.051425465252112,38.6416041341335,0.045688458109030106,1741.8462381362915,545.8375024795532,2199.508964538574,74651,8111,66540,66540,0,10,8417000.0
8417,8417999,22.051533322835155,38.64116875623946,0.045662967493678375,1741.9841990470886,545.9006209373474,2199.858455657959,74651,8111,66540,66540,0,10,8418000.0
8418,8418999,22.05152958865239,38.640137693072056,0.04564257807132266,1742.2890722751617,545.9645392894745,2200.31778717041,74654,8112,66542,66542,0,10,8419000.0
8419,8419999,22.051860643754615,38.63964627720785,0.0456220581072152,1742.4176876544952,546.0284199714661,2200.6814727783203,74655,8112,66543,66543,0,10,8420000.0
8420,8420999,22.052284205419888,38.63914835961728,0.04559757709754997,1742.7161180973053,546.09357213974,2200.966018676758,74662,8113,66549,66549,0,10,8421000.0
8421,8421999,22.052672442918194,38.63845637469626,0.04557343566235661,1743.1765005588531,546.1590914726257,2201.1575889587402,74687,8115,66572,66572,0,10,8422000.0
8422,8422999,22.05349901320808,38.63840782374834,0.04553581764774095,1743.470065832138,546.2230761051178,2201.513458251953,74689,8116,66573,66573,0,10,8423000.0
8423,8423999,22.054259787953168,38.63932394669288,0.04550051986639314,1743.5861675739288,546.286657333374,2201.9145469665527,74690,8116,66574,66574,0,10,8424000.0
8424,8424999,22.055033705142673,38.640056091595135,0.04546111881612469,1744.0400683879852,546.3506393432617,2202.19913482666,74694,8118,66576,66576,0,10,8425000.0
8425,8425999,22.055179045294032,38.63926965612703,0.04543235600667339,1744.3285689353943,546.412496805191,2202.73299407959,74701,8119,66582,66582,0,10,8426000.0
8426,8426999,22.055487438610225,38.63880851279039,0.0454011051818457,1744.4678087234497,546.4781215190887,2204.2150268554688,74707,8119,66588,66588,0,10,8427000.0
8427,8427999,22.056075474766086,38.64060204636357,0.045360506091683406,1744.5894055366516,546.5415308475494,2204.9441299438477,74707,8119,66588,66588,0,10,8428000.0
8428,8428999,22.056603496167494,38.64082919104629,0.045328521720707005,1745.2251961231232,546.6060466766357,2205.357967376709,74731,8122,66609,66609,0,10,8429000.0
8429,8429999,22.056781530848617,38.64032054370063,0.04530126050516392,1745.6820006370544,546.6702308654785,2205.6739616394043,74756,8124,66632,66632,0,10,8430000.0
8430,8430999,22.056968556642794,38.63989968116294,0.04528043224470524,1745.9695739746094,546.7337007522583,2206.0877647399902,74770,8125,66645,66645,0,10,8431000.0
8431,8431999,22.057432464385695,38.63986974862679,0.04526484666112096,1746.2718513011932,546.7974104881287,2206.390193939209,74782,8126,66656,66656,0,10,8432000.0
8432,8432999,22.057780534299013,38.639356442788575,0.04524658364327627,1746.3943526744843,546.8615081310272,2206.819591522217,74783,8126,66657,66657,0,10,8433000.0
8433,8433999,22.05805360308112,38.63894974586598,0.04522340989448548,1746.513213634491,546.9253833293915,2207.1934356689453,74784,8126,66658,66658,0,10,8434000.0
8434,8434999,22.05856798357271,38.63954427929488,0.04520301858076703,1746.8060131072998,546.9883549213409,2207.39737701416,74796,8127,66669,66669,0,10,8435000.0
8435,8435999,22.059024453319545,38.6394136342108,0.04518830932477713,1747.1053493022919,547.0506360530853,2207.7232666015625,74803,8128,66675,66675,0,10,8436000.0
8436,8436999,22.059198644410667,38.638710045618204,0.04517680250159406,1747.3976702690125,547.1150903701782,2207.9973335266113,74815,8129,66686,66686,0,10,8437000.0
8437,8437999,22.05960880117931,38.63858037924016,0.04517331914950806,1747.6850090026855,547.178151845932,2208.224620819092,74827,8130,66697,66697,0,10,8438000.0
8438,8438999,22.05995028627416,38.63809505437578,0.04515809820100514,1747.9654858112335,547.2407028675079,2208.5916633605957,74839,8131,66708,66708,0,10,8439000.0
8439,8439999,22.06054461598772,38.638193436913895,0.045153883577442544,1748.252896785736,547.3027584552765,2209.176731109619,74851,8132,66719,66719,0,10,8440000.0
8440,8440999,22.06085773520781,38.6375723847846,0.045144177112253825,1748.3774387836456,547.3645896911621,2209.6905632019043,74851,8132,66719,66719,0,10,8441000.0
8441,8441999,22.061289892207206,38.63722097686262,0.04514054376647425,1748.4909813404083,547.4262487888336,2210.0747680664062,74852,8132,66720,66720,0,10,8442000.0
8442,8442999,22.061752997356653,38.63691407891998,0.04513941973809732,1748.6099710464478,547.4894216060638,2210.5665588378906,74853,8132,66721,66721,0,10,8443000.0
8443,8443999,22.061999224964126,38.636934852490654,0.0451317017831907,1749.0776762962341,547.5534460544586,2210.820941925049,74878,8134,66744,66744,0,10,8444000.0
8444,8444999,22.062276210080157,38.63850855416798,0.045120947868751204,1749.3718564510345,547.6150898933411,2211.1258659362793,74891,8135,66756,66756,0,10,8445000.0
8445,8445999,22.061843609844058,38.63797734110897,0.04512052536801203,1756.6938741207123,547.6792500019073,2212.499153137207,74911,8136,66775,66775,0,10,8446000.0
8446,8446999,22.061238454474065,38.63692882175671,0.04512231053508309,1757.0001392364502,547.7430384159088,2213.144790649414,74926,8137,66789,66789,0,10,8447000.0
8447,8447999,22.060887538353704,38.63703813143736,0.045120237000606855,1757.4912552833557,547.8076059818268,2213.486038208008,74948,8139,66809,66809,0,10,8448000.0
8448,8448999,22.06058701088688,38.637072639697024,0.045119080035294634,1757.8310356140137,547.8782751560211,2214.0264167785645,74964,8140,66824,66824,0,10,8449000.0
8449,8449999,22.060547089290708,38.63683883401698,0.04512458125096297,1757.9538712501526,547.94331407547,2214.488193511963,74966,8140,66826,66826,0,10,8450000.0
8450,8450999,22.060615054448206,38.637103631090596,0.04512617828185772,1758.2656230926514,548.0094802379608,2214.838394165039,74969,8141,66828,66828,0,10,8451000.0
8451,8451999,22.06079067087314,38.63713218329258,0.045127083768536025,1758.7419707775116,548.0717413425446,2215.1787033081055,74983,8143,66840,66840,0,10,8452000.0
8452,8452999,22.06092704332076,38.63692890252976,0.04513287475575789,1758.8686110973358,548.1347754001617,2215.617401123047,74984,8143,66841,66841,0,10,8453000.0
8453,8453999,22.06141856467588,38.63756550942884,0.04513390771831671,1759.007527589798,548.2008221149445,2216.001419067383,74984,8143,66841,66841,0,10,8454000.0
8454,8454999,22.061819197002958,38.63789191556664,0.04513861747987047,1759.318983078003,548.2671315670013,2216.227840423584,74992,8144,66848,66848,0,10,8455000.0
8455,8455999,22.062039722117746,38.63822783757052,0.04513800637057397,1759.4492435455322,548.3320753574371,2216.544048309326,74992,8144,66848,66848,0,10,8456000.0
8456,8456999,22.062726903700145,38.63946111925919,0.04514182131383537,1759.5808782577515,548.3959138393402,2216.8820610046387,74993,8144,66849,66849,0,10,8457000.0
8457,8457999,22.06286637508251,38.63930003660467,0.0451404567770618,1759.8934981822968,548.4624788761139,2217.121269226074,74995,8145,66850,66850,0,10,8458000.0
8458,8458999,22.063509581849743,38.64041823167521,0.04514141947196493,1760.0194029808044,548.5260059833527,2217.478614807129,74995,8145,66850,66850,0,10,8459000.0
8459,8459999,22.06391388542736,38.640721422269884,0.045145467322007526,1760.3384659290314,548.5896565914154,2217.7938346862793,75008,8146,66862,66862,0,10,8460000.0
8460,8460999,22.064242132941427,38.6409149670006,0.04514517076997082,1760.459365606308,548.6531460285187,2218.1507148742676,75009,8146,66863,66863,0,10,8461000.0
8461,8461999,22.064967650009972,38.641695051651,0.04514802602003554,1760.5892233848572,548.7163043022156,2218.368061065674,75009,8146,66863,66863,0,10,8462000.0
8462,8462999,22.065647610681626,38.642986994106096,0.04514410904538624,1760.90185880661,548.7803003787994,2218.664680480957,75021,8147,66874,66874,0,10,8463000.0
8463,8463999,22.065931956879478,38.64297266071715,0.045153690832335336,1761.0194594860077,548.8443903923035,2219.0615272521973,75025,8147,66878,66878,0,10,8464000.0
8464,8464999,22.066168903882918,38.64275149941286,0.045163465990571416,1761.3413019180298,548.9152898788452,2219.297966003418,75040,8148,66892,66892,0,10,8465000.0
8465,8465999,22.065627750181353,38.64286263156734,0.045160307465869076,1761.6603167057037,548.9788522720337,2220.3133811950684,75052,8149,66903,66903,0,10,8466000.0
8466,8466999,22.06486477398937,38.641883296457735,0.04516141594519707,1761.7953794002533,549.0432922840118,2220.8363876342773,75053,8149,66904,66904,0,10,8467000.0
8467,8467999,22.06429251034654,38.641098064038516,0.045159387153089536,1762.4582648277283,549.1087503433228,2220.9686851501465,75059,8152,66907,66907,0,10,8468000.0
8468,8468999,22.063679852752678,38.63988262423672,0.04515674690465965,1762.5905849933624,549.1710679531097,2221.4326133728027,75060,8152,66908,66908,0,10,8469000.0
8469,8469999,22.063254438691818,38.6397356153742,0.04515249651721864,1762.7347223758698,549.2401220798492,2221.778621673584,75060,8152,66908,66908,0,10,8470000.0
8470,8470999,22.062818719149966,38.63921175880783,0.04515072473669257,1763.0396609306335,549.3041272163391,2222.024631500244,75062,8153,66909,66909,0,10,8471000.0
8471,8471999,22.062368751695956,38.63824745728769,0.04514934768464596,1763.1638691425323,549.3665640354156,2222.2881965637207,75062,8153,66909,66909,0,10,8472000.0
8472,8472999,22.062091760999838,38.63775484215754,0.04514334827964739,1763.8410758972168,549.4328091144562,2222.4561080932617,75080,8156,66924,66924,0,10,8473000.0
8473,8473999,22.062149370900162,38.63781167825721,0.04514680754950007,1764.5218245983124,549.4992337226868,2222.6563262939453,75116,8159,66957,66957,0,10,8474000.0
8474,8474999,22.06266758208544,38.63857362026497,0.04514476942775647,1764.663829088211,549.5715057849884,2223.046516418457,75118,8159,66959,66959,0,10,8475000.0
8475,8475999,22.063334835035477,38.639639671523476,0.04514364455342523,1764.983794927597,549.6358201503754,2223.3407135009766,75135,8160,66975,66975,0,10,8476000.0
8476,8476999,22.064422308296866,38.64189174155431,0.045141877677005726,1765.111201286316,549.699102640152,2223.6609840393066,75137,8160,66977,66977,0,10,8477000.0
8477,8477999,22.06595680435518,38.64530863729919,0.04515245364397136,1765.4145121574402,549.7632427215576,2223.9058876037598,75144,8161,66983,66983,0,10,8478000.0
8478,8478999,22.067426536948958,38.64874134244368,0.045158495716347336,1765.5405988693237,549.8291642665863,2224.1534004211426,75144,8161,66983,66983,0,10,8479000.0
8479,8479999,22.069288888440372,38.653543963081475,0.04516255489377452,1765.8423402309418,549.8919954299927,2224.427257537842,75155,8162,66993,66993,0,10,8480000.0
8480,8480999,22.070427126208248,38.654962345678456,0.04516396604905293,1766.3340165615082,549.9579870700836,2224.631908416748,75176,8164,67012,67012,0,10,8481000.0
8481,8481999,22.0721116790534,38.6592169796252,0.0451741031837718,1766.644234418869,550.0230858325958,2224.7868843078613,75183,8165,67018,67018,0,10,8482000.0
8482,8482999,22.073470699739993,38.66093411652733,0.04518520117440339,1766.7770426273346,550.0846798419952,2225.0247344970703,75185,8165,67020,67020,0,10,8483000.0
8483,8483999,22.074498822349305,38.662563507781975,0.045186422899244905,1767.083505153656,550.1468725204468,2225.261936187744,75197,8166,67031,67031,0,10,8484000.0
8484,8484999,22.074384059141444,38.662314829256495,0.045187232113978126,1767.5683875083923,550.2108571529388,2226.041549682617,75217,8168,67049,67049,0,10,8485000.0
8485,8485999,22.073784039978325,38.661563925545806,0.04518956119786144,1767.6949899196625,550.2749049663544,2226.61079788208,75219,8168,67051,67051,0,10,8486000.0
8486,8486999,22.073534827899365,38.66150047243323,0.04519191047835647,1768.0165662765503,550.3396346569061,2226.95853805542,75234,8169,67065,67065,0,10,8487000.0
8487,8487999,22.0732721444324,38.661626007643406,0.0451893383254004,1768.143367767334,550.4040348529816,2227.407569885254,75234,8169,67065,67065,0,10,8488000.0
8488,8488999,22.07317108075865,38.661399650644775,0.04519144479680759,1768.2671678066254,550.4683637619019,2227.6955375671387,75234,8169,67065,67065,0,10,8489000.0
8489,8489999,22.07294397740728,38.66076707811403,0.04519136266785184,1768.9181129932404,550.5313305854797,2227.8483505249023,75255,8172,67083,67083,0,10,8490000.0
8490,8490999,22.07279597461464,38.66024764550257,0.04518870253829488,1769.5956313610077,550.5992305278778,2228.0597496032715,75286,8175,67111,67111,0,10,8491000.0
8491,8491999,22.072701620719503,38.659880788841804,0.04518536028553144,1769.7267882823944,550.6686480045319,2228.4169120788574,75286,8175,67111,67111,0,10,8492000.0
8492,8492999,22.072746769834357,38.660387676658615,0.045182644419962226,1770.0306346416473,550.7322051525116,2228.685592651367,75298,8176,67122,67122,0,10,8493000.0
8493,8493999,22.07271751585232,38.659912941411996,0.04518124587445249,1770.3505592346191,550.7981555461884,2228.8670539855957,75310,8177,67133,67133,0,10,8494000.0
8494,8494999,22.07280785621075,38.65991836332034,0.04517889478345405,1770.6505899429321,550.8609981536865,2229.0655822753906,75312,8178,67134,67134,0,10,8495000.0
8495,8495999,22.072872879403945,38.65950942007604,0.0451771786981483,1771.4832272529602,550.9249677658081,2229.091320037842,75347,8182,67165,67165,0,10,8496000.0
8496,8496999,22.072819624011476,38.65895252683359,0.04517230547528173,1772.1635274887085,550.9921448230743,2229.1770248413086,75386,8185,67201,67201,0,10,8497000.0
8497,8497999,22.072809144281884,38.65830600108711,0.045168092975842455,1772.4697802066803,551.0560758113861,2229.4377632141113,75398,8186,67212,67212,0,10,8498000.0
8498,8498999,22.072937165050856,38.657987131344484,0.045166159330845,1772.9662454128265,551.1259183883667,2229.6474266052246,75412,8188,67224,67224,0,10,8499000.0
8499,8499999,22.073001282956273,38.65745821634563,0.04515964197874267,1773.2694396972656,551.1902747154236,2229.827163696289,75419,8189,67230,67230,0,10,8500000.0
8500,8500999,22.07310543759896,38.657050816883746,0.04515325772140988,1773.579794883728,551.2542977333069,2230.0608253479004,75426,8190,67236,67236,0,10,8501000.0
8501,8501999,22.073095853533545,38.657403349477896,0.045145453709889205,1773.7065193653107,551.3191542625427,2230.3379974365234,75427,8190,67237,67237,0,10,8502000.0
8502,8502999,22.072918748804266,38.656383583815625,0.045139598075433995,1773.8376429080963,551.3840370178223,2230.5480041503906,75427,8190,67237,67237,0,10,8503000.0
8503,8503999,22.072729393472674,38.65550453337255,0.04513760927767141,1774.139907836914,551.44828748703,2230.6646766662598,75439,8191,67248,67248,0,10,8504000.0
8504,8504999,22.071997041633228,38.65394225008772,0.04513764706056811,1774.4592819213867,551.5136425495148,2231.7493324279785,75455,8192,67263,67263,0,10,8505000.0
8505,8505999,22.070999520001195,38.6523795901311,0.0451412961469575,1774.7607176303864,551.5810277462006,2232.1888122558594,75469,8193,67276,67276,0,10,8506000.0
8506,8506999,22.07005935478543,38.65074758950492,0.04514609193296304,1774.8942284584045,551.6477949619293,2232.5486450195312,75469,8193,67276,67276,0,10,8507000.0
8507,8507999,22.069306352587322,38.64980647673308,0.04514713524308267,1775.3792572021484,551.7124972343445,2232.8712577819824,75475,8195,67280,67280,0,10,8508000.0
8508,8508999,22.068462669669543,38.64828011206595,0.045148348038691166,1775.5088865756989,551.7811107635498,2233.199420928955,75476,8195,67281,67281,0,10,8509000.0
8509,8509999,22.06780623261707,38.64731837045309,0.04514812866941653,1775.8181343078613,551.8431191444397,2233.419822692871,75488,8196,67292,67292,0,10,8510000.0
8510,8510999,22.067086391556177,38.646174356528476,0.045149036238644746,1776.1189069747925,551.9058501720428,2233.74373626709,75496,8197,67299,67299,0,10,8511000.0
8511,8511999,22.066507155261885,38.64570355380343,0.04514503759567157,1776.2547039985657,551.9724538326263,2234.140682220459,75497,8197,67300,67300,0,10,8512000.0
8512,8512999,22.066448084247458,38.646600834326904,0.045137197453292255,1776.3728058338165,552.0352358818054,2234.3777084350586,75498,8197,67301,67301,0,10,8513000.0
8513,8513999,22.066976226250937,38.649647449244696,0.04513391431273528,1776.5184590816498,552.1064925193787,2234.841522216797,75505,8197,67308,67308,0,10,8514000.0
8514,8514999,22.067120841390395,38.65238136571615,0.0451241136834164,1776.6426875591278,552.1689846515656,2235.23624420166,75506,8197,67309,67309,0,10,8515000.0
8515,8515999,22.067174065855518,38.65276615381062,0.04513030801268847,1776.9411466121674,552.2307558059692,2235.3868827819824,75512,8198,67314,67314,0,10,8516000.0
8516,8516999,22.06733111968889,38.653620516452364,0.04512082543278384,1777.0733363628387,552.2957644462585,2235.718132019043,75512,8198,67314,67314,0,10,8517000.0
8517,8517999,22.067633593706592,38.65420433696837,0.04510972806120617,1777.2059984207153,552.3606443405151,2236.11368560791,75512,8198,67314,67314,0,10,8518000.0
8518,8518999,22.067960151943613,38.654532528353826,0.045101186778610525,1777.3315086364746,552.4250066280365,2236.488945007324,75512,8198,67314,67314,0,10,8519000.0
8519,8519999,22.068573925640795,38.65602348317235,0.045088503361634946,1777.4518988132477,552.4896945953369,2236.8519744873047,75512,8198,67314,67314,0,10,8520000.0
8520,8520999,22.069458591749274,38.65743418643418,0.04507805642385676,1777.5796055793762,552.5549685955048,2237.1563835144043,75513,8198,67315,67315,0,10,8521000.0
8521,8521999,22.070203191569373,38.658712513692464,0.04506310788782075,1777.876724243164,552.6179056167603,2237.3553352355957,75527,8199,67328,67328,0,10,8522000.0
8522,8522999,22.07073782500295,38.659248683608084,0.04505411280219007,1778.0092086791992,552.680962562561,2237.6571769714355,75527,8199,67328,67328,0,10,8523000.0
8523,8523999,22.070761969476948,38.659103541668266,0.045049603172721664,1778.1319465637207,552.7436425685883,2237.9036293029785,75528,8199,67329,67329,0,10,8524000.0
8524,8524999,22.07067822268893,38.65877475849431,0.04502747754171732,1778.2656002044678,552.8089780807495,2239.0779762268066,75528,8199,67329,67329,0,10,8525000.0
8525,8525999,22.07036042132994,38.658049375471855,0.04501255387702885,1778.7421040534973,552.874813079834,2239.6821327209473,75534,8201,67333,67333,0,10,8526000.0
8526,8526999,22.070219301185773,38.65760867533526,0.04500048087516573,1779.2309756278992,552.9434952735901,2240.070400238037,75562,8203,67359,67359,0,10,8527000.0
8527,8527999,22.07009959286511,38.65686381012086,0.044988201661073424,1779.3668978214264,553.0108258724213,2240.524513244629,75562,8203,67359,67359,0,10,8528000.0
8528,8528999,22.070182160525427,38.656531049689306,0.04498298495586084,1779.8434343338013,553.0758702754974,2240.790725708008,75590,8205,67385,67385,0,10,8529000.0
8529,8529999,22.070327074125423,38.65666075376511,0.04497891910412566,1780.1321110725403,553.1387894153595,2241.1229286193848,75592,8206,67386,67386,0,10,8530000.0
8530,8530999,22.070532915365305,38.65684409231704,0.044978344320927066,1780.27094912529,553.2027564048767,2241.416404724121,75592,8206,67386,67386,0,10,8531000.0
8531,8531999,22.07087544237592,38.65769126772963,0.04496832904050607,1780.565933227539,553.2669792175293,2241.7433586120605,75604,8207,67397,67397,0,10,8532000.0
8532,8532999,22.071250968015544,38.65818932435862,0.04496308161949658,1780.7040803432465,553.3294684886932,2242.122341156006,75604,8207,67397,67397,0,10,8533000.0
8533,8533999,22.0715115635355,38.658307898663075,0.04495897443297692,1781.1698501110077,553.3927991390228,2242.2363357543945,75622,8209,67413,67413,0,10,8534000.0
8534,8534999,22.07251115541128,38.66171582028783,0.04495789973019626,1781.47220993042,553.4555714130402,2242.5317573547363,75628,8210,67418,67418,0,10,8535000.0
8535,8535999,22.073630782792378,38.66328086983932,0.044971086476098154,1781.603726863861,553.52117395401,2242.9095611572266,75629,8210,67419,67419,0,10,8536000.0
8536,8536999,22.07468069856514,38.66471089064033,0.04498618375987884,1781.898428440094,553.5833749771118,2243.119701385498,75641,8211,67430,67430,0,10,8537000.0
8537,8537999,22.075958079880067,38.66687978074214,0.045002918387974766,1782.0224611759186,553.6459450721741,2243.3978843688965,75641,8211,67430,67430,0,10,8538000.0
8538,8538999,22.077290263979783,38.66880759068342,0.04501975769732436,1782.3284845352173,553.7091088294983,2243.735095977783,75653,8212,67441,67441,0,10,8539000.0
8539,8539999,22.078769639191176,38.671009169499726,0.04504451694668232,1782.979887008667,553.7723994255066,2244.0072059631348,75689,8215,67474,67474,0,10,8540000.0
8540,8540999,22.080835188147688,38.67485483814415,0.04507582052102643,1783.271190404892,553.8334093093872,2244.3055992126465,75701,8216,67485,67485,0,10,8541000.0
8541,8541999,22.082561211199526,38.677346637051855,0.04511991930040393,1783.4002528190613,553.8973157405853,2244.5708618164062,75701,8216,67485,67485,0,10,8542000.0
8542,8542999,22.084278634689266,38.679709773744904,0.04514895664694618,1783.8693985939026,553.9606540203094,2244.8366622924805,75723,8218,67505,67505,0,10,8543000.0
8543,8543999,22.084576755755865,38.67977482012775,0.04515365710978825,1784.518057346344,554.0256576538086,2245.6017532348633,75750,8221,67529,67529,0,10,8544000.0
8544,8544999,22.084768543395505,38.68118706776865,0.045146774996375316,1784.991935968399,554.0916366577148,2246.418167114258,75776,8223,67553,67553,0,10,8545000.0
8545,8545999,22.085397884320347,38.68318558870331,0.04513855355844287,1785.458467721939,554.1554765701294,2246.8857078552246,75794,8225,67569,67569,0,10,8546000.0
8546,8546999,22.08635044319359,38.68656812042418,0.04512366099459786,1785.5805718898773,554.2198543548584,2247.5402755737305,75798,8225,67573,67573,0,10,8547000.0
8547,8547999,22.08742151007121,38.68833469302226,0.045119828794046746,1786.22483086586,554.2837748527527,2247.9957275390625,75825,8228,67597,67597,0,10,8548000.0
8548,8548999,22.0887814145844,38.69118048573774,0.04511213788391644,1786.6846165657043,554.3469347953796,2248.432472229004,75841,8230,67611,67611,0,10,8549000.0
8549,8549999,22.090193319730265,38.6947286838644,0.04509606944097788,1786.8091943264008,554.4105696678162,2248.960521697998,75845,8230,67615,67615,0,10,8550000.0
8550,8550999,22.092396617027436,38.70224267861065,0.045080721615022856,1787.2841324806213,554.4754610061646,2249.217010498047,75861,8232,67629,67629,0,10,8551000.0
8551,8551999,22.09429435261192,38.70755628110063,0.04507265481927181,1787.753059387207,554.5380198955536,2249.4440002441406,75887,8234,67653,67653,0,10,8552000.0
8552,8552999,22.09658553837371,38.71509220058033,0.0450710389132184,1788.230726480484,554.6043725013733,2249.7832641601562,75905,8236,67669,67669,0,10,8553000.0
8553,8553999,22.098884684247643,38.72272516957373,0.04506591690254691,1788.3498094081879,554.6664078235626,2250.228561401367,75905,8236,67669,67669,0,10,8554000.0
8554,8554999,22.101052666849867,38.72917522933492,0.04506678183560531,1788.4691109657288,554.7299890518188,2250.567066192627,75905,8236,67669,67669,0,10,8555000.0
8555,8555999,22.10359062503094,38.735747860087095,0.045070142414801784,1789.6440768241882,554.794668674469,2250.579647064209,75968,8242,67726,67726,0,10,8556000.0
8556,8556999,22.10566248521367,38.74090214235151,0.0450714347254314,1789.9520416259766,554.8654839992523,2250.945301055908,75980,8243,67737,67737,0,10,8557000.0
8557,8557999,22.107604395463433,38.74580833205349,0.0450859675211972,1790.2602636814117,554.936261177063,2251.2474975585938,75992,8244,67748,67748,0,10,8558000.0
8558,8558999,22.10912040834919,38.74893113322321,0.04510469098446379,1790.7272136211395,555.0019557476044,2251.48978805542,76017,8246,67771,67771,0,10,8559000.0
8559,8559999,22.10958058821443,38.75112506956842,0.04509811859217494,1791.3767302036285,555.0677242279053,2252.623695373535,76052,8249,67803,67803,0,10,8560000.0
8560,8560999,22.10913294333832,38.75113502766986,0.045095401052386075,1791.850890636444,555.1326212882996,2253.253044128418,76079,8251,67828,67828,0,10,8561000.0
8561,8561999,22.108968841477928,38.75125763765898,0.04508959788098843,1792.3215959072113,555.1980502605438,2253.6980056762695,76102,8253,67849,67849,0,10,8562000.0
8562,8562999,22.108673493207004,38.75113448611158,0.04508490554666644,1792.4479629993439,555.2623517513275,2254.231227874756,76102,8253,67849,67849,0,10,8563000.0
8563,8563999,22.10818791688477,38.750158250808596,0.04508368063468715,1792.5727236270905,555.3257796764374,2254.768695831299,76110,8253,67857,67857,0,10,8564000.0
8564,8564999,22.107983576118503,38.74965700582877,0.04507645296986407,1792.8636026382446,555.3889439105988,2255.155693054199,76114,8254,67860,67860,0,10,8565000.0
8565,8565999,22.10790487128243,38.74943810252624,0.045072148849574445,1793.166217803955,555.4525837898254,2255.603546142578,76130,8255,67875,67875,0,10,8566000.0
8566,8566999,22.107992749263307,38.74969666781043,0.04506534014956454,1793.2846546173096,555.5165390968323,2256.0023155212402,76130,8255,67875,67875,0,10,8567000.0
8567,8567999,22.10796010432741,38.749838817538055,0.045058418574386194,1793.4046268463135,555.5803353786469,2256.3048706054688,76130,8255,67875,67875,0,10,8568000.0
8568,8568999,22.108131747771385,38.749976389711094,0.04505399797037224,1793.529304265976,555.6435668468475,2256.7007217407227,76130,8255,67875,67875,0,10,8569000.0
8569,8569999,22.108228193122,38.749862253036554,0.04505334544064865,1793.8270931243896,555.7080185413361,2256.9266815185547,76143,8256,67887,67887,0,10,8570000.0
8570,8570999,22.10835492010233,38.749630304911385,0.04505311983720228,1793.9498538970947,555.7727262973785,2257.231388092041,76143,8256,67887,67887,0,10,8571000.0
8571,8571999,22.1085915219598,38.74953885798589,0.04505392852409906,1794.6003477573395,555.8399503231049,2257.4296875,76180,8259,67921,67921,0,10,8572000.0
8572,8572999,22.10888459242025,38.74954586776873,0.045056661424084266,1795.06081032753,555.906861782074,2257.803325653076,76200,8261,67939,67939,0,10,8573000.0
8573,8573999,22.109250925314413,38.7495242504866,0.04505432015531374,1795.183967590332,555.971935749054,2258.205032348633,76200,8261,67939,67939,0,10,8574000.0
8574,8574999,22.109945181754412,38.750281330805855,0.045060023916677516,1795.4768543243408,556.035984992981,2258.479072570801,76207,8262,67945,67945,0,10,8575000.0
8575,8575999,22.110146045573345,38.749999829559236,0.045059935718935296,1795.7694973945618,556.0989134311676,2258.8434677124023,76223,8263,67960,67960,0,10,8576000.0
8576,8576999,22.110436683167087,38.74995253054164,0.04506120141161252,1795.8874382972717,556.1637234687805,2259.1961936950684,76223,8263,67960,67960,0,10,8577000.0
8577,8577999,22.110543340979078,38.74948410042519,0.04506104817019685,1796.0100872516632,556.2254581451416,2259.522041320801,76224,8263,67961,67961,0,10,8578000.0
8578,8578999,22.10995246753893,38.748708352949656,0.04505839699398051,1796.31227850914,556.2902114391327,2260.837574005127,76233,8264,67969,67969,0,10,8579000.0
8579,8579999,22.109168547160763,38.74806121215017,0.04505673135264032,1796.4550654888153,556.3627645969391,2261.6325912475586,76239,8264,67975,67975,0,10,8580000.0
8580,8580999,22.10833623656457,38.7467627541611,0.04505596019859659,1796.5878367424011,556.4272615909576,2262.0941200256348,76241,8264,67977,67977,0,10,8581000.0
8581,8581999,22.10777819801681,38.74623327259231,0.0450529986189272,1796.88210439682,556.4921908378601,2262.5180702209473,76253,8265,67988,67988,0,10,8582000.0
8582,8582999,22.107253588218203,38.7454291102845,0.04504868725671707,1797.180829524994,556.5572748184204,2262.8733253479004,76261,8266,67995,67995,0,10,8583000.0
8583,8583999,22.10671429836553,38.74452605851783,0.0450455292934171,1797.6525824069977,556.6231615543365,2263.1108627319336,76275,8268,68007,68007,0,10,8584000.0
8584,8584999,22.106392507301475,38.74418991438986,0.045042368388854004,1797.7686641216278,556.6857838630676,2263.469470977783,76275,8268,68007,68007,0,10,8585000.0
8585,8585999,22.10614314005486,38.7436960527207,0.04503914178841384,1797.8833358287811,556.7486484050751,2263.902088165283,76275,8268,68007,68007,0,10,8586000.0
8586,8586999,22.10613193200999,38.74377356081806,0.045037846695241024,1798.1832547187805,556.8121769428253,2264.213146209717,76279,8269,68010,68010,0,10,8587000.0
8587,8587999,22.10635957929924,38.74468856560004,0.04503452171608224,1798.4878311157227,556.877198934555,2264.4354934692383,76284,8270,68014,68014,0,10,8588000.0
8588,8588999,22.10641934460123,38.74498810228173,0.04503254791480682,1798.6087865829468,556.9405393600464,2264.886203765869,76285,8270,68015,68015,0,10,8589000.0
8589,8589999,22.106460868935095,38.7448780975777,0.0450310913427302,1798.897914648056,557.004248380661,2265.119071960449,76297,8271,68026,68026,0,10,8590000.0
8590,8590999,22.106639507686257,38.744916896998646,0.04502878390247356,1799.026573896408,557.0676429271698,2265.496353149414,76297,8271,68026,68026,0,10,8591000.0
8591,8591999,22.10674849454522,38.744809990969976,0.04502402470887357,1799.1476845741272,557.1318726539612,2265.938648223877,76297,8271,68026,68026,0,10,8592000.0
8592,8592999,22.106884272600396,38.74481625595968,0.045021065108607705,1799.7910981178284,557.1985666751862,2266.244529724121,76333,8274,68059,68059,0,10,8593000.0
8593,8593999,22.10704584749685,38.74486602111374,0.045020131187259005,1799.9148166179657,557.2624108791351,2266.5988693237305,76333,8274,68059,68059,0,10,8594000.0
8594,8594999,22.107246667077977,38.744389664475186,0.045012960392637136,1800.2052772045135,557.3275113105774,2267.0076637268066,76345,8275,68070,68070,0,10,8595000.0
8595,8595999,22.107438899686095,38.74417682615878,0.04500791793653425,1800.333347082138,557.3912897109985,2267.378173828125,76345,8275,68070,68070,0,10,8596000.0
8596,8596999,22.10734465668068,38.743375891665416,0.04500280062618078,1800.6327393054962,557.4589216709137,2267.6714057922363,76357,8276,68081,68081,0,10,8597000.0
8597,8597999,22.10731257731441,38.74353494989557,0.044998179738437005,1800.9242811203003,557.5229003429413,2267.964065551758,76369,8277,68092,68092,0,10,8598000.0
8598,8598999,22.10673228872292,38.74240630136083,0.044997606742406826,1801.2446591854095,557.5911719799042,2269.0695190429688,76382,8278,68104,68104,0,10,8599000.0
8599,8599999,22.106194428113668,38.74195475155469,0.045004430907730986,1801.5459802150726,557.6572668552399,2269.678512573242,76388,8279,68109,68109,0,10,8600000.0
8600,8600999,22.105550414116824,38.740995883763944,0.045017253895485276,1802.011709690094,557.7229347229004,2270.071559906006,76402,8281,68121,68121,0,10,8601000.0
8601,8601999,22.10500166660056,38.73987530914594,0.045022461790750534,1802.3283932209015,557.7938952445984,2270.4281463623047,76414,8282,68132,68132,0,10,8602000.0
8602,8602999,22.10454811936533,38.73907061892284,0.045024592758773685,1802.4630863666534,557.8571231365204,2270.7991638183594,76414,8282,68132,68132,0,10,8603000.0
8603,8603999,22.10417898124506,38.738172920032596,0.04503256383305443,1802.5876314640045,557.9206132888794,2271.1654319763184,76414,8282,68132,68132,0,10,8604000.0
8604,8604999,22.10381606322786,38.73782484934994,0.04502850299276284,1802.883250951767,557.9846041202545,2271.489673614502,76419,8283,68136,68136,0,10,8605000.0
8605,8605999,22.103297629207372,38.73665250642535,0.045029876854445594,1803.0118448734283,558.0467438697815,2271.9390602111816,76419,8283,68136,68136,0,10,8606000.0
8606,8606999,22.10298278611239,38.73570038547588,0.0450273285282593,1803.1330885887146,558.1101517677307,2272.3114051818848,76420,8283,68137,68137,0,10,8607000.0
8607,8607999,22.102622031852636,38.73504192737135,0.04502359630879138,1803.2495629787445,558.1734137535095,2272.601417541504,76420,8283,68137,68137,0,10,8608000.0
8608,8608999,22.102201566746803,38.73381874089895,0.04502150744471678,1803.5410542488098,558.2368233203888,2272.908187866211,76432,8284,68148,68148,0,10,8609000.0
8609,8609999,22.102001053707642,38.73425525127034,0.04501409775880838,1803.6795086860657,558.3014903068542,2273.144733428955,76432,8284,68148,68148,0,10,8610000.0
8610,8610999,22.101779683267583,38.73339632882108,0.04500846633872224,1803.9889361858368,558.3638272285461,2273.4420585632324,76444,8285,68159,68159,0,10,8611000.0
8611,8611999,22.101505122398816,38.73256418192534,0.04500564777130989,1804.277615070343,558.427994966507,2273.6753883361816,76456,8286,68170,68170,0,10,8612000.0
8612,8612999,22.10144622548424,38.73157845931789,0.04500065101386974,1804.4029521942139,558.4912829399109,2273.953544616699,76456,8286,68170,68170,0,10,8613000.0
8613,8613999,22.101376635327735,38.730636465278685,0.044995407694659484,1804.702798128128,558.5544505119324,2274.0153427124023,76468,8287,68181,68181,0,10,8614000.0
8614,8614999,22.101379844304624,38.72963479847308,0.044990693155255834,1804.9947862625122,558.6169106960297,2274.3047370910645,76480,8288,68192,68192,0,10,8615000.0
8615,8615999,22.101336870696947,38.72862195197019,0.04498571236008253,1805.2966010570526,558.6803643703461,2274.5329360961914,76492,8289,68203,68203,0,10,8616000.0
8616,8616999,22.101229661012677,38.72762107852437,0.04498145100615358,1805.4143435955048,558.7432582378387,2274.7461471557617,76492,8289,68203,68203,0,10,8617000.0
8617,8617999,22.10088101122247,38.72625689887828,0.044978450952331106,1805.7101476192474,558.8092195987701,2274.98734664917,76504,8290,68214,68214,0,10,8618000.0
8618,8618999,22.100379007472153,38.7268349521172,0.04497387504884065,1806.36767411232,558.8753957748413,2275.974822998047,76532,8293,68239,68239,0,10,8619000.0
8619,8619999,22.099514319150376,38.72535711339334,0.04497304409515013,1806.6721725463867,558.9424767494202,2276.507034301758,76544,8294,68250,68250,0,10,8620000.0
8620,8620999,22.09870060008805,38.72412085201366,0.04497501396332593,1806.8037796020508,559.0076310634613,2276.8892250061035,76545,8294,68251,68251,0,10,8621000.0
8621,8621999,22.098077054236565,38.723006640584494,0.04497680748330313,1807.4365780353546,559.0728912353516,2277.1759185791016,76578,8297,68281,68281,0,10,8622000.0
8622,8622999,22.0975901110265,38.722001113293516,0.04497326459918005,1808.0822415351868,559.1380817890167,2277.3157386779785,76600,8300,68300,68300,0,10,8623000.0
8623,8623999,22.09700799747948,38.720905415301104,0.04497425588323467,1808.5541126728058,559.2029495239258,2277.545612335205,76608,8302,68306,68306,0,10,8624000.0
8624,8624999,22.096453373506794,38.719606561590304,0.044972750842115605,1808.6831431388855,559.2689173221588,2277.996349334717,76608,8302,68306,68306,0,10,8625000.0
8625,8625999,22.095865275812926,38.71865977623576,0.04497182941906841,1808.812534570694,559.3349113464355,2278.5288162231445,76608,8302,68306,68306,0,10,8626000.0
8626,8626999,22.095434490128895,38.71858761530129,0.044969459015762214,1808.9390230178833,559.3990404605865,2278.9041328430176,76608,8302,68306,68306,0,10,8627000.0
8627,8627999,22.095117235518686,38.7196191473762,0.04496327780141618,1809.0660977363586,559.4625985622406,2279.2701721191406,76608,8302,68306,68306,0,10,8628000.0
8628,8628999,22.094829553240903,38.71895918411155,0.04496348797554639,1809.3568086624146,559.5265200138092,2279.578456878662,76621,8303,68318,68318,0,10,8629000.0
8629,8629999,22.094654019765617,38.72021225045305,0.04495628226895676,1809.817128419876,559.589528799057,2279.74808883667,76640,8305,68335,68335,0,10,8630000.0
8630,8630999,22.094426402894513,38.71946949852614,0.04495258176367489,1809.9332435131073,559.6534287929535,2280.1728019714355,76640,8305,68335,68335,0,10,8631000.0
8631,8631999,22.094394785965076,38.718920440078946,0.04495066665392933,1810.5856008529663,559.7176065444946,2280.364513397217,76672,8308,68364,68364,0,10,8632000.0
8632,8632999,22.09428368035292,38.71820181211799,0.04494909502142641,1810.721025943756,559.7895042896271,2280.6398315429688,76672,8308,68364,68364,0,10,8633000.0
8633,8633999,22.094365208285964,38.717710744205824,0.04494510314217581,1811.1906373500824,559.8523139953613,2280.7671241760254,76687,8310,68377,68377,0,10,8634000.0
8634,8634999,22.09452287704304,38.71732051592138,0.04493853813487625,1811.4802119731903,559.912855386734,2281.044101715088,76694,8311,68383,68383,0,10,8635000.0
8635,8635999,22.094604030690846,38.71688314766861,0.04493422120835977,1811.6125388145447,559.9749209880829,2281.2880058288574,76694,8311,68383,68383,0,10,8636000.0
8636,8636999,22.09447430012294,38.71597887497794,0.04493070247272235,1812.0761315822601,560.0382330417633,2281.382900238037,76713,8313,68400,68400,0,10,8637000.0
8637,8637999,22.09441310884385,38.71532171405157,0.04492795293534746,1812.3635046482086,560.1021597385406,2281.6179847717285,76725,8314,68411,68411,0,10,8638000.0
8638,8638999,22.094001150073847,38.714763251787836,0.04492498165300951,1812.503202676773,560.1686246395111,2282.678291320801,76729,8314,68415,68415,0,10,8639000.0
8639,8639999,22.093059194546985,38.71375430301105,0.04492804801537209,1812.7954428195953,560.2321302890778,2283.2411308288574,76737,8315,68422,68422,0,10,8640000.0
8640,8640999,22.092055297244237,38.71239204574974,0.04492950918038674,1813.0864520072937,560.2950468063354,2283.6127433776855,76740,8316,68424,68424,0,10,8641000.0
8641,8641999,22.091437330022156,38.71153913403016,0.04492589310486872,1813.388326883316,560.361090183258,2284.0615043640137,76748,8317,68431,68431,0,10,8642000.0
8642,8642999,22.09060978843754,38.71032995918814,0.04492518555206981,1813.5083544254303,560.4255197048187,2284.3969802856445,76748,8317,68431,68431,0,10,8643000.0
8643,8643999,22.089875087699586,38.709153454785294,0.04492518209872842,1813.9913909435272,560.4919221401215,2284.6228942871094,76772,8319,68453,68453,0,10,8644000.0
8644,8644999,22.089188083746162,38.70811083762987,0.044922254199732614,1814.2915217876434,560.5566153526306,2284.9398803710938,76787,8320,68467,68467,0,10,8645000.0
8645,8645999,22.088400428495298,38.706784962082494,0.044922001188723026,1814.5872159004211,560.6184606552124,2285.282314300537,76818,8321,68497,68497,0,10,8646000.0
8646,8646999,22.08757447708607,38.705283770867574,0.04492362166893826,1814.8821475505829,560.6816403865814,2285.548683166504,76849,8322,68527,68527,0,10,8647000.0
8647,8647999,22.08684669643122,38.703888055161805,0.04492381054604366,1815.0122117996216,560.7460851669312,2285.9877891540527,76849,8322,68527,68527,0,10,8648000.0
8648,8648999,22.08607055872084,38.70237598229275,0.04492725503378436,1815.648589372635,560.8102426528931,2286.156467437744,76869,8325,68544,68544,0,10,8649000.0
8649,8649999,22.08549582863522,38.701270566272335,0.044923029674432735,1815.7906584739685,560.8823230266571,2286.529853820801,76869,8325,68544,68544,0,10,8650000.0
8650,8650999,22.08495618311708,38.700182297862625,0.04492236622637902,1815.9120438098907,560.9437370300293,2286.8064346313477,76869,8325,68544,68544,0,10,8651000.0
8651,8651999,22.0844534459492,38.69934271882603,0.044919264083693844,1816.0367648601532,561.0059559345245,2286.9915504455566,76869,8325,68544,68544,0,10,8652000.0
8652,8652999,22.084081925366412,38.69832503647257,0.04491006347493853,1816.162003993988,561.0690319538116,2287.2209129333496,76869,8325,68544,68544,0,10,8653000.0
8653,8653999,22.083797336751235,38.69742373895237,0.04490185999901086,1816.2779998779297,561.132800579071,2287.5666275024414,76870,8325,68545,68545,0,10,8654000.0
8654,8654999,22.083635909550495,38.6967877409658,0.04489332408700564,1816.3979773521423,561.1956009864807,2287.957733154297,76870,8325,68545,68545,0,10,8655000.0
8655,8655999,22.08346054601185,38.69589923861024,0.044883790871363516,1816.5168671607971,561.2573835849762,2288.1736640930176,76870,8325,68545,68545,0,10,8656000.0
8656,8656999,22.083258567817982,38.69518868551725,0.044879503444011926,1816.638011455536,561.319655418396,2288.5126304626465,76870,8325,68545,68545,0,10,8657000.0
8657,8657999,22.083211742500506,38.69448355580302,0.04487419590981667,1816.7648961544037,561.3828127384186,2288.8628425598145,76871,8325,68546,68546,0,10,8658000.0
8658,8658999,22.082803163341932,38.69334380598208,0.04487117269677621,1816.8895189762115,561.4452695846558,2289.093406677246,76871,8325,68546,68546,0,10,8659000.0
8659,8659999,22.082203945964896,38.6928289965543,0.04486428610462123,1817.374674320221,561.5087785720825,2290.073459625244,76901,8327,68574,68574,0,10,8660000.0
8660,8660999,22.081360602599805,38.692018577435356,0.044866566168003996,1817.6781129837036,561.57537317276,2290.4686851501465,76903,8328,68575,68575,0,10,8661000.0
8661,8661999,22.080603650945417,38.690822790231046,0.044863866868195657,1817.9757044315338,561.6388680934906,2290.8262062072754,76919,8329,68590,68590,0,10,8662000.0
8662,8662999,22.080139538638825,38.690630886653146,0.044863121680340456,1818.2811822891235,561.7040672302246,2291.1898193359375,76931,8330,68601,68601,0,10,8663000.0
8663,8663999,22.079521201565054,38.68929018711126,0.04485809892706438,1818.578914642334,561.7665660381317,2291.491111755371,76934,8331,68603,68603,0,10,8664000.0
8664,8664999,22.078822025873848,38.687931893971346,0.04485709328340515,1818.8827016353607,561.8296897411346,2291.7943992614746,76950,8332,68618,68618,0,10,8665000.0
8665,8665999,22.078304569442206,38.6868341501793,0.04485205406319748,1819.0020334720612,561.8928759098053,2292.2724227905273,76950,8332,68618,68618,0,10,8666000.0
8666,8666999,22.077711141253967,38.68557839569904,0.0448482161292747,1819.1214599609375,561.9560506343842,2292.7208213806152,76950,8332,68618,68618,0,10,8667000.0
8667,8667999,22.077236470436603,38.68511082288441,0.044841680895530533,1819.243864774704,562.0182249546051,2293.0976524353027,76950,8332,68618,68618,0,10,8668000.0
8668,8668999,22.076736568033372,38.68389132084586,0.04483623619640442,1819.544763803482,562.0811669826508,2293.308280944824,76962,8333,68629,68629,0,10,8669000.0
8669,8669999,22.076256638928392,38.68271323704458,0.044832059155586745,1820.0127353668213,562.1461102962494,2293.543628692627,76988,8335,68653,68653,0,10,8670000.0
8670,8670999,22.075783580077104,38.68155855225397,0.04482892297928864,1820.1382420063019,562.2108235359192,2293.7982025146484,76988,8335,68653,68653,0,10,8671000.0
8671,8671999,22.07554803421829,38.680741695630836,0.044824358972702094,1820.2730674743652,562.2830300331116,2294.190860748291,76988,8335,68653,68653,0,10,8672000.0
8672,8672999,22.07541754458176,38.68008001385115,0.044820949408864386,1820.390072107315,562.346461057663,2294.533515930176,76988,8335,68653,68653,0,10,8673000.0
8673,8673999,22.075335533383893,38.67930719344409,0.04481670594370979,1820.5092403888702,562.40988945961,2294.8105239868164,76988,8335,68653,68653,0,10,8674000.0
8674,8674999,22.075263551451823,38.67855206002489,0.04481318534910439,1820.6304650306702,562.4733309745789,2295.1014251708984,76988,8335,68653,68653,0,10,8675000.0
8675,8675999,22.07544494105776,38.67809221506638,0.04480935034649014,1820.9334375858307,562.537255525589,2295.4162521362305,76990,8336,68654,68654,0,10,8676000.0
8676,8676999,22.075541840064165,38.677669501126786,0.04480612309056964,1821.0539515018463,562.6002428531647,2295.723918914795,76990,8336,68654,68654,0,10,8677000.0
8677,8677999,22.075563219390165,38.67713103295991,0.04480189845851423,1821.169979095459,562.6640040874481,2295.9377098083496,76990,8336,68654,68654,0,10,8678000.0
8678,8678999,22.075507995508975,38.67629452747327,0.04479886157296942,1821.6482553482056,562.7389070987701,2296.1809616088867,77015,8338,68677,68677,0,10,8679000.0
8679,8679999,22.075469237322025,38.675608416713644,0.04479745657751999,1821.7788684368134,562.8020844459534,2297.0302085876465,77018,8338,68680,68680,0,10,8680000.0
8680,8680999,22.075442084239878,38.67597964848306,0.0447919115629869,1821.911360502243,562.8733277320862,2297.8557662963867,77018,8338,68680,68680,0,10,8681000.0
8681,8681999,22.075178909293218,38.675754197298644,0.044792953762422316,1822.231947183609,562.9401097297668,2298.276191711426,77032,8339,68693,68693,0,10,8682000.0
8682,8682999,22.075155630529498,38.675424669934756,0.04478665304705298,1822.3517861366272,563.0022795200348,2298.6504859924316,77032,8339,68693,68693,0,10,8683000.0
8683,8683999,22.07526306952954,38.67576990009478,0.044781158675542665,1822.6445145606995,563.064621925354,2298.879566192627,77044,8340,68704,68704,0,10,8684000.0
8684,8684999,22.07555737969284,38.67613122767169,0.044775848561405596,1822.9438092708588,563.1302404403687,2299.172306060791,77058,8341,68717,68717,0,10,8685000.0
8685,8685999,22.07566235361531,38.67635171257053,0.0447696982044784,1823.2485485076904,563.1936130523682,2299.49560546875,77061,8342,68719,68719,0,10,8686000.0
8686,8686999,22.075906335680006,38.6773798152737,0.044760483002562856,1823.3713822364807,563.2571914196014,2299.9141273498535,77061,8342,68719,68719,0,10,8687000.0
8687,8687999,22.076206064078598,38.67750502100688,0.04476221319537266,1823.5020394325256,563.3196814060211,2300.2999725341797,77061,8342,68719,68719,0,10,8688000.0
8688,8688999,22.076811353406153,38.679809711267815,0.04475740154347885,1823.6329908370972,563.3830592632294,2300.6359214782715,77061,8342,68719,68719,0,10,8689000.0
8689,8689999,22.077428296515553,38.68087874730471,0.044756546170674594,1823.7574543952942,563.4453432559967,2300.8791885375977,77061,8342,68719,68719,0,10,8690000.0
8690,8690999,22.078609647003887,38.683238961244484,0.044763244545219516,1824.5895471572876,563.5086631774902,2300.9829177856445,77109,8346,68763,68763,0,10,8691000.0
8691,8691999,22.079995014261417,38.68618860624847,0.04477273987288566,1824.7089264392853,563.5711438655853,2301.36767578125,77110,8346,68764,68764,0,10,8692000.0
8692,8692999,22.081324435858743,38.68840265324053,0.044782222244823644,1825.0099050998688,563.6338970661163,2301.7132263183594,77122,8347,68775,68775,0,10,8693000.0
8693,8693999,22.08317240677082,38.693073939670334,0.04478662680270218,1825.307000875473,563.6966722011566,2301.9779624938965,77126,8348,68778,68778,0,10,8694000.0
8694,8694999,22.084724448135038,38.69625451407881,0.044797296987815316,1825.601239681244,563.7592697143555,2302.2172927856445,77139,8349,68790,68790,0,10,8695000.0
8695,8695999,22.08577378170889,38.698338129820215,0.044798356755305746,1825.7277414798737,563.822368144989,2302.4993934631348,77139,8349,68790,68790,0,10,8696000.0
8696,8696999,22.086678625603273,38.70004245257181,0.0448022756358426,1825.8654973506927,563.8854882717133,2303.163143157959,77140,8349,68791,68791,0,10,8697000.0
8697,8697999,22.08622508280045,38.699491226796944,0.04479602356156498,1826.3384923934937,563.9491698741913,2303.8062057495117,77147,8351,68796,68796,0,10,8698000.0
8698,8698999,22.08598140472982,38.699296322644145,0.044789848619635975,1826.8097741603851,564.0129375457764,2304.096237182617,77162,8353,68809,68809,0,10,8699000.0
8699,8699999,22.085520907998777,38.698334496322005,0.04478336400801042,1827.1096920967102,564.0785944461823,2304.4008445739746,77164,8354,68810,68810,0,10,8700000.0
8700,8700999,22.085190018573098,38.6977467276251,0.04477642236188073,1827.5846264362335,564.1419203281403,2304.618350982666,77188,8356,68832,68832,0,10,8701000.0
8701,8701999,22.084720462602554,38.696610295342275,0.0447699476158544,1828.2373306751251,564.2080357074738,2304.8648681640625,77225,8359,68866,68866,0,10,8702000.0
8702,8702999,22.08415984584436,38.695250807538336,0.04476398575629337,1828.3524215221405,564.2702927589417,2305.205867767334,77225,8359,68866,68866,0,10,8703000.0
8703,8703999,22.08380306634013,38.69437291795908,0.0447554911706165,1828.470728635788,564.3334760665894,2305.5393028259277,77225,8359,68866,68866,0,10,8704000.0
8704,8704999,22.08346102869247,38.69342380132613,0.04475187489387833,1828.5909082889557,564.3945777416229,2305.821220397949,77225,8359,68866,68866,0,10,8705000.0
8705,8705999,22.083171357234477,38.69265542522818,0.04474733794185948,1828.7113649845123,564.460408449173,2306.0064811706543,77226,8359,68867,68867,0,10,8706000.0
8706,8706999,22.083100270521317,38.69245366959896,0.04474365732771335,1828.8288819789886,564.5231709480286,2306.3623962402344,77226,8359,68867,68867,0,10,8707000.0
8707,8707999,22.08298198309278,38.69168571639357,0.04473920111697505,1828.9477000236511,564.5855169296265,2306.670097351074,77226,8359,68867,68867,0,10,8708000.0
8708,8708999,22.082896166553226,38.690862685785056,0.04473669097382704,1829.0686807632446,564.6475479602814,2306.86580657959,77226,8359,68867,68867,0,10,8709000.0
8709,8709999,22.08315082850775,38.690841827144745,0.04473186539020724,1829.5418202877045,564.7119495868683,2306.968776702881,77250,8361,68889,68889,0,10,8710000.0
8710,8710999,22.0832959204042,38.690431318537414,0.04472984445141803,1830.0099568367004,564.7745840549469,2307.075508117676,77259,8363,68896,68896,0,10,8711000.0
8711,8711999,22.083429171096,38.690192148371025,0.04472869389531642,1830.3148138523102,564.8376064300537,2307.337459564209,77270,8364,68906,68906,0,10,8712000.0
8712,8712999,22.08372295967344,38.68989268768312,0.04472925882049417,1830.6083929538727,564.9000954627991,2307.675037384033,77282,8365,68917,68917,0,10,8713000.0
8713,8713999,22.08396145637994,38.6898498274024,0.044729215455103555,1830.916225194931,564.9637279510498,2308.0636825561523,77295,8366,68929,68929,0,10,8714000.0
8714,8714999,22.084308474454847,38.689686052196635,0.04473375564525839,1831.0455322265625,565.0293025970459,2308.4795684814453,77296,8366,68930,68930,0,10,8715000.0
8715,8715999,22.084347305033567,38.689216356942524,0.044730868519080036,1831.1634788513184,565.0912153720856,2308.8585052490234,77297,8366,68931,68931,0,10,8716000.0
8716,8716999,22.084384899070653,38.68923741700039,0.04469742591661463,1831.467457294464,565.1555490493774,2310.2845001220703,77311,8367,68944,68944,0,10,8717000.0
8717,8717999,22.08412224255042,38.68880009580649,0.04467114437988218,1831.7700164318085,565.2190775871277,2310.897994995117,77324,8368,68956,68956,0,10,8718000.0
8718,8718999,22.083992111935927,38.68807015806408,0.044643816469851605,1831.8921344280243,565.2829563617706,2311.291934967041,77324,8368,68956,68956,0,10,8719000.0
8719,8719999,22.084076366979456,38.68760389588797,0.04461087444529932,1832.3763282299042,565.3481025695801,2311.6384506225586,77337,8370,68967,68967,0,10,8720000.0
8720,8720999,22.083814296505043,38.68687579435342,0.04458938788934874,1832.6832540035248,565.4120628833771,2311.990093231201,77338,8371,68967,68967,0,10,8721000.0
8721,8721999,22.083471885766432,38.68577033225739,0.0445697138364487,1833.1506488323212,565.4765810966492,2312.296772003174,77352,8373,68979,68979,0,10,8722000.0
8722,8722999,22.083216804809876,38.685039304205546,0.04455088534907481,1833.2703657150269,565.5391900539398,2312.6091918945312,77352,8373,68979,68979,0,10,8723000.0
8723,8723999,22.082881788172376,38.683867483417266,0.04453427802092125,1833.7459750175476,565.603095293045,2312.913017272949,77376,8375,69001,69001,0,10,8724000.0
8724,8724999,22.082798826035866,38.68344130292676,0.04451726027132541,1833.8756356239319,565.6652917861938,2313.265338897705,77376,8375,69001,69001,0,10,8725000.0
8725,8725999,22.082611188820767,38.68244338755245,0.04450166337739181,1834.1666400432587,565.7277054786682,2313.512233734131,77383,8376,69007,69007,0,10,8726000.0
8726,8726999,22.082365376175293,38.68140964375108,0.044489937809799374,1834.6401081085205,565.7914593219757,2313.790901184082,77411,8378,69033,69033,0,10,8727000.0
8727,8727999,22.082183636620247,38.6805468014973,0.04447762542283262,1834.766185760498,565.8582203388214,2313.9735412597656,77411,8378,69033,69033,0,10,8728000.0
8728,8728999,22.082148064964198,38.679805588283806,0.04446366446133321,1835.0749747753143,565.9218256473541,2314.2857246398926,77423,8379,69044,69044,0,10,8729000.0
8729,8729999,22.082325987118455,38.67955624366981,0.044451926188690205,1835.1900045871735,565.984721660614,2314.6303176879883,77423,8379,69044,69044,0,10,8730000.0
8730,8730999,22.082529110820417,38.67900681301112,0.044438784843692125,1835.6773796081543,566.0509033203125,2314.860668182373,77428,8381,69047,69047,0,10,8731000.0
8731,8731999,22.082738082048394,38.67843701197172,0.04443123341043009,1835.8155965805054,566.1216886043549,2315.118076324463,77428,8381,69047,69047,0,10,8732000.0
8732,8732999,22.083138570281783,38.678170670591285,0.04441939738327105,1836.3258163928986,566.1888453960419,2315.471954345703,77452,8383,69069,69069,0,10,8733000.0
8733,8733999,22.083490575599285,38.67787864943454,0.04441180300324177,1836.4517874717712,566.2508053779602,2315.783908843994,77452,8383,69069,69069,0,10,8734000.0
8734,8734999,22.083732657952428,38.67728523873233,0.04439860323062472,1836.564650297165,566.3123514652252,2316.016044616699,77452,8383,69069,69069,0,10,8735000.0
8735,8735999,22.083905844882782,38.67688431617293,0.04439122760416914,1836.8536593914032,566.3741710186005,2316.1822204589844,77464,8384,69080,69080,0,10,8736000.0
8736,8736999,22.083858029193763,38.67700658086654,0.0443806364301943,1836.9831085205078,566.4377291202545,2317.188777923584,77472,8384,69088,69088,0,10,8737000.0
8737,8737999,22.084034326108007,38.679437036229835,0.044378701929719155,1837.2784214019775,566.5016293525696,2317.658203125,77485,8385,69100,69100,0,10,8738000.0
8738,8738999,22.083820413322506,38.680074973246036,0.044385343021167145,1837.5817604064941,566.566326379776,2317.992691040039,77493,8386,69107,69107,0,10,8739000.0
8739,8739999,22.084216785128113,38.68319390139087,0.044387670683355473,1837.877769947052,566.6313564777374,2318.2947883605957,77496,8387,69109,69109,0,10,8740000.0
8740,8740999,22.08466949448441,38.68531560158224,0.044382960655752646,1838.005197763443,566.6950159072876,2318.612968444824,77497,8387,69110,69110,0,10,8741000.0
8741,8741999,22.08504116397501,38.688355925199,0.04438064185136681,1838.3102695941925,566.7591359615326,2318.841594696045,77499,8388,69111,69111,0,10,8742000.0
8742,8742999,22.085826444078897,38.69201239583709,0.04437824819224723,1838.6202373504639,566.8231155872345,2319.0116844177246,77503,8389,69114,69114,0,10,8743000.0
8743,8743999,22.086260630657186,38.69412285017383,0.04436929578295912,1838.9186491966248,566.8866288661957,2319.3396377563477,77513,8390,69123,69123,0,10,8744000.0
8744,8744999,22.08692342055983,38.69657436018933,0.04436254422190322,1839.0337944030762,566.9498369693756,2319.6320152282715,77513,8390,69123,69123,0,10,8745000.0
8745,8745999,22.087598687634635,38.69858773764187,0.044358471483619266,1839.3252201080322,567.0123059749603,2319.87300491333,77527,8391,69136,69136,0,10,8746000.0
8746,8746999,22.088469866627513,38.70025127029735,0.044358214772816096,1839.4473791122437,567.0751495361328,2320.049991607666,77527,8391,69136,69136,0,10,8747000.0
8747,8747999,22.08943979206851,38.704086031528334,0.04435325467340023,1839.5801289081573,567.1394746303558,2320.4052734375,77527,8391,69136,69136,0,10,8748000.0
8748,8748999,22.0908080798765,38.70640056650523,0.04435672501267074,1839.8772354125977,567.2020237445831,2320.6105308532715,77539,8392,69147,69147,0,10,8749000.0
8749,8749999,22.091907134686082,38.70827455409034,0.04435579387418953,1840.1703572273254,567.2654483318329,2320.909339904785,77551,8393,69158,69158,0,10,8750000.0
8750,8750999,22.093422144389198,38.71084750996291,0.0443598051967099,1841.0005912780762,567.3333196640015,2321.0114936828613,77590,8397,69193,69193,0,10,8751000.0
8751,8751999,22.09498060274878,38.71369638902983,0.04435817719021784,1841.4815678596497,567.3970556259155,2321.112606048584,77606,8399,69207,69207,0,10,8752000.0
8752,8752999,22.096378593465907,38.715873913572054,0.04436100013374522,1841.776192188263,567.4606297016144,2321.392303466797,77613,8400,69213,69213,0,10,8753000.0
8753,8753999,22.09756833752009,38.717225403276466,0.044366934022609605,1841.8923280239105,567.5236542224884,2321.7232093811035,77613,8400,69213,69213,0,10,8754000.0
8754,8754999,22.097633700815567,38.71715890916663,0.04436203307219422,1842.020758152008,567.5865926742554,2322.700408935547,77614,8400,69214,69214,0,10,8755000.0
8755,8755999,22.097149562458906,38.71788716800026,0.044355116105382564,1842.3279206752777,567.65039229393,2323.5987968444824,77628,8401,69227,69227,0,10,8756000.0
8756,8756999,22.096593180286757,38.717086626836334,0.04435221714592186,1842.450796365738,567.714010477066,2324.1054916381836,77628,8401,69227,69227,0,10,8757000.0
8757,8757999,22.096376825510557,38.717953580617795,0.04434406476325381,1842.7559957504272,567.780946969986,2324.5010948181152,77640,8402,69238,69238,0,10,8758000.0
8758,8758999,22.095965650328544,38.71744916006544,0.04434247527010071,1843.067318201065,567.8547010421753,2324.8133850097656,77642,8403,69239,69239,0,10,8759000.0
8759,8759999,22.09576286481492,38.71692858178579,0.04434245164282158,1843.7265524864197,567.9203779697418,2325.1291313171387,77680,8406,69274,69274,0,10,8760000.0
8760,8760999,22.09564290934707,38.7165014641513,0.044338214808399945,1844.3736100196838,567.9867894649506,2325.473159790039,77711,8409,69302,69302,0,10,8761000.0
8761,8761999,22.095699715585212,38.71642011155702,0.044337119736375996,1844.8317306041718,568.0489385128021,2325.925205230713,77739,8411,69328,69328,0,10,8762000.0
8762,8762999,22.09621937583264,38.71739520428941,0.044340948062093655,1845.1243262290955,568.1140365600586,2326.1868743896484,77751,8412,69339,69339,0,10,8763000.0
8763,8763999,22.097066964722043,38.71919336064706,0.0443543399398445,1845.2487723827362,568.1783475875854,2326.6363677978516,77753,8412,69341,69341,0,10,8764000.0
8764,8764999,22.097917242312192,38.72081366188023,0.04436542601118609,1845.5419301986694,568.2433278560638,2327.036304473877,77767,8413,69354,69354,0,10,8765000.0
8765,8765999,22.09914938790769,38.72299812515806,0.04438353348053836,1845.83775639534,568.307309627533,2327.3596229553223,77770,8414,69356,69356,0,10,8766000.0
8766,8766999,22.1005315150461,38.725662482046864,0.04440540237714952,1846.1337687969208,568.3711440563202,2327.7625465393066,77772,8415,69357,69357,0,10,8767000.0
8767,8767999,22.101914037501256,38.728255706019326,0.04443724977018004,1846.4305591583252,568.4357099533081,2328.2093238830566,77780,8416,69364,69364,0,10,8768000.0
8768,8768999,22.103606052659607,38.73105994961321,0.04447664475596658,1846.5519995689392,568.5007400512695,2328.562370300293,77780,8416,69364,69364,0,10,8769000.0
8769,8769999,22.10548536515798,38.73436312773837,0.044517454864833605,1846.6772062778473,568.5651426315308,2329.125617980957,77780,8416,69364,69364,0,10,8770000.0
8770,8770999,22.10776629108388,38.73965945059802,0.0445585875274539,1846.979689836502,568.6300842761993,2329.52734375,77792,8417,69375,69375,0,10,8771000.0
8771,8771999,22.109579448872964,38.74245468714883,0.04459156698103839,1847.4611353874207,568.6950242519379,2329.843105316162,77816,8419,69397,69397,0,10,8772000.0
8772,8772999,22.11149314712615,38.74561003724212,0.044633442321172834,1847.9357767105103,568.75927734375,2330.087345123291,77833,8421,69412,69412,0,10,8773000.0
8773,8773999,22.113277636849517,38.74837158061636,0.04466773239443789,1848.246497631073,568.827107667923,2330.4583740234375,77864,8422,69442,69442,0,10,8774000.0
8774,8774999,22.113550705697172,38.74829504382253,0.04467316301373159,1848.5675241947174,568.9018728733063,2331.5035247802734,77879,8423,69456,69456,0,10,8775000.0
8775,8775999,22.113023166966354,38.74837943356217,0.044677440911010224,1848.867079257965,568.9661393165588,2332.098434448242,77891,8424,69467,69467,0,10,8776000.0
8776,8776999,22.11236154688161,38.74722522094059,0.04467852539337902,1849.338279724121,569.0309362411499,2332.4847984313965,77915,8426,69489,69489,0,10,8777000.0
8777,8777999,22.111767948946316,38.74622949820513,0.04468124596168577,1849.8086159229279,569.0959644317627,2332.793212890625,77939,8428,69511,69511,0,10,8778000.0
8778,8778999,22.111218232835935,38.7451593433998,0.04467743618166142,1850.2743005752563,569.160159111023,2333.045352935791,77943,8430,69513,69513,0,10,8779000.0
8779,8779999,22.11080664991685,38.744268419602676,0.04467450859263955,1850.7541825771332,569.2258813381195,2333.3262062072754,77967,8432,69535,69535,0,10,8780000.0
8780,8780999,22.11046607049238,38.743579704730585,0.04467689103756434,1851.0499413013458,569.2914414405823,2333.594898223877,77969,8433,69536,69536,0,10,8781000.0
8781,8781999,22.110220435308538,38.74295306461287,0.044680035379450755,1851.708065032959,569.3573353290558,2333.747978210449,77991,8436,69555,69555,0,10,8782000.0
8782,8782999,22.110018460821845,38.74247979508801,0.04468014071687454,1852.1764159202576,569.4212484359741,2333.898853302002,78015,8438,69577,69577,0,10,8783000.0
8783,8783999,22.109934836600736,38.741992703388284,0.04468067845624557,1852.4703423976898,569.4847571849823,2334.281021118164,78021,8439,69582,69582,0,10,8784000.0
8784,8784999,22.109939344311094,38.74177595105733,0.04468300401385228,1852.7710378170013,569.5479071140289,2334.629348754883,78045,8440,69605,69605,0,10,8785000.0
8785,8785999,22.109990942039474,38.74189699983051,0.04469074394485817,1853.0643420219421,569.6119692325592,2334.9153175354004,78057,8441,69616,69616,0,10,8786000.0
8786,8786999,22.110157776998438,38.74203115317058,0.04469335184176049,1853.3575336933136,569.6750948429108,2335.219638824463,78069,8442,69627,69627,0,10,8787000.0
8787,8787999,22.110350235142516,38.74234789383528,0.044690229616296095,1853.6535999774933,569.7376780509949,2335.486301422119,78071,8443,69628,69628,0,10,8788000.0
8788,8788999,22.110483940773875,38.74222346098983,0.0446901988183831,1853.942792415619,569.8006212711334,2335.7910766601562,78083,8444,69639,69639,0,10,8789000.0
8789,8789999,22.11097886647614,38.742799025418094,0.04469432584147193,1854.070838689804,569.8643751144409,2336.2277641296387,78083,8444,69639,69639,0,10,8790000.0
8790,8790999,22.11152720502095,38.74345671867293,0.04469917737529416,1854.3806438446045,569.9286427497864,2336.5054969787598,78085,8445,69640,69640,0,10,8791000.0
8791,8791999,22.111957954807373,38.74381981274336,0.044706170274918855,1854.692785024643,569.9926989078522,2336.715831756592,78097,8446,69651,69651,0,10,8792000.0
8792,8792999,22.11228106802503,38.74396199931619,0.044710565433049854,1855.2072093486786,570.0632448196411,2336.8773803710938,78121,8448,69673,69673,0,10,8793000.0
8793,8793999,22.11253444902807,38.74393745513155,0.0447154480753954,1855.6739275455475,570.1265859603882,2337.114902496338,78146,8450,69696,69696,0,10,8794000.0
8794,8794999,22.11266930679449,38.74348364969959,0.044717483433250216,1855.800836801529,570.1890983581543,2337.4384727478027,78147,8450,69697,69697,0,10,8795000.0
8795,8795999,22.11233021124453,38.7471079656753,0.044708703794760996,1856.1029460430145,570.2535154819489,2338.355743408203,78166,8451,69715,69715,0,10,8796000.0
8796,8796999,22.111645522942897,38.74592786477629,0.04470835152053143,1856.4148037433624,570.3171362876892,2338.9235458374023,78180,8452,69728,69728,0,10,8797000.0
8797,8797999,22.11127869798727,38.74616548560139,0.0447098357180703,1856.722902059555,570.3821551799774,2339.369697570801,78204,8453,69751,69751,0,10,8798000.0
8798,8798999,22.11104598261384,38.74576281361449,0.04470924106393803,1857.020128250122,570.4453883171082,2339.7391510009766,78218,8454,69764,69764,0,10,8799000.0
8799,8799999,22.11080571702348,38.745068885829575,0.044712038750194694,1857.326339006424,570.5110116004944,2340.0670280456543,78220,8455,69765,69765,0,10,8800000.0
8800,8800999,22.1103780146025,38.74403431018662,0.04471697412421283,1857.4528276920319,570.5750434398651,2340.427745819092,78220,8455,69765,69765,0,10,8801000.0
8801,8801999,22.110392612241547,38.74576568783762,0.044712092699626504,1857.5803620815277,570.6397440433502,2340.7134857177734,78220,8455,69765,69765,0,10,8802000.0
8802,8802999,22.11025812778977,38.745017701874765,0.044719211740998466,1857.8704073429108,570.7021753787994,2340.921085357666,78232,8456,69776,69776,0,10,8803000.0
8803,8803999,22.11044533450318,38.745578825818434,0.04473564718878631,1857.9975564479828,570.7672193050385,2341.2798500061035,78232,8456,69776,69776,0,10,8804000.0
8804,8804999,22.11107861428772,38.74693468464908,0.04475083086518894,1858.1289370059967,570.8341624736786,2341.556079864502,78234,8456,69778,69778,0,10,8805000.0
8805,8805999,22.111684425383455,38.74795793117296,0.04476819081925476,1858.425360918045,570.8974747657776,2341.7412490844727,78236,8457,69779,69779,0,10,8806000.0
8806,8806999,22.11234947778591,38.748900865091414,0.04477740350514925,1858.5466384887695,570.9594669342041,2342.014488220215,78236,8457,69779,69779,0,10,8807000.0
8807,8807999,22.113132627267106,38.75134753323285,0.04479410539961737,1858.857453584671,571.0245127677917,2342.253318786621,78240,8458,69782,69782,0,10,8808000.0
8808,8808999,22.11379402522147,38.75199831387176,0.04481110844334124,1858.9924511909485,571.0876243114471,2342.5395278930664,78240,8458,69782,69782,0,10,8809000.0
8809,8809999,22.11481635810251,38.75400094584167,0.044828414999987354,1859.4714543819427,571.1511390209198,2342.671184539795,78264,8460,69804,69804,0,10,8810000.0
8810,8810999,22.11620029751182,38.75801202562458,0.04485911332812076,1859.9426276683807,571.2150545120239,2342.9019813537598,78282,8462,69820,69820,0,10,8811000.0
8811,8811999,22.11763420416221,38.762302598526965,0.04487720633585646,1860.41650557518,571.2786247730255,2343.1563262939453,78308,8464,69844,69844,0,10,8812000.0
8812,8812999,22.118698746236568,38.76506306182162,0.0448971208409914,1860.5473728179932,571.3421275615692,2343.4372329711914,78309,8464,69845,69845,0,10,8813000.0
8813,8813999,22.11956328132933,38.7659639599905,0.044917941959182195,1861.0235509872437,571.4074635505676,2343.6489067077637,78324,8466,69858,69858,0,10,8814000.0
8814,8814999,22.11985110360523,38.76654530363682,0.04491132028231526,1861.3285639286041,571.4709994792938,2344.8526649475098,78338,8467,69871,69871,0,10,8815000.0
8815,8815999,22.11988589404107,38.76683095938937,0.04490825515887786,1861.9961948394775,571.5363414287567,2345.4092025756836,78375,8470,69905,69905,0,10,8816000.0
8816,8816999,22.120224519681837,38.76764613273294,0.04490041836333125,1862.8194739818573,571.6022522449493,2345.7307662963867,78405,8474,69931,69931,0,10,8817000.0
8817,8817999,22.12051148067398,38.76902876141147,0.044892072434872476,1863.293225288391,571.6656792163849,2345.9657974243164,78416,8476,69940,69940,0,10,8818000.0
8818,8818999,22.120738248856966,38.769513663606894,0.04488533235684089,1863.4244265556335,571.7291097640991,2346.3724822998047,78416,8476,69940,69940,0,10,8819000.0
8819,8819999,22.120806477856522,38.769404175245036,0.04488008889240369,1863.7334849834442,571.7921640872955,2346.759433746338,78418,8477,69941,69941,0,10,8820000.0
8820,8820999,22.12092144675744,38.769243506665845,0.044873732677755296,1864.0229709148407,571.8540630340576,2347.1040992736816,78430,8478,69952,69952,0,10,8821000.0
8821,8821999,22.120949971752918,38.76855154092564,0.044866123808781966,1864.3170971870422,571.9181509017944,2347.3011589050293,78437,8479,69958,69958,0,10,8822000.0
8822,8822999,22.121335919413937,38.770284448792324,0.04486237046859598,1864.6104836463928,571.980370759964,2347.629535675049,78444,8480,69964,69964,0,10,8823000.0
8823,8823999,22.121386122582383,38.7695554682103,0.04485497377399439,1865.0796978473663,572.0454096794128,2347.896415710449,78470,8482,69988,69988,0,10,8824000.0
8824,8824999,22.121394457349385,38.76896783006806,0.04484589830783725,1865.3772010803223,572.11061835289,2348.204345703125,78480,8483,69997,69997,0,10,8825000.0
8825,8825999,22.121562180782746,38.768467893525575,0.04483439957459279,1865.6746089458466,572.1753573417664,2348.5034675598145,78490,8484,70006,70006,0,10,8826000.0
8826,8826999,22.12203510809278,38.76822007426563,0.04481722202872618,1865.7941498756409,572.236820936203,2348.913173675537,78490,8484,70006,70006,0,10,8827000.0
8827,8827999,22.12247849492412,38.767824010786015,0.04479886581218673,1865.9168674945831,572.3024561405182,2349.317279815674,78490,8484,70006,70006,0,10,8828000.0
8828,8828999,22.123039030442833,38.76747414655071,0.04477879580207256,1866.0427668094635,572.3658177852631,2349.707836151123,78490,8484,70006,70006,0,10,8829000.0
8829,8829999,22.12314011220495,38.7665512285093,0.044763661446935,1866.3520910739899,572.4296183586121,2349.9847259521484,78493,8485,70008,70008,0,10,8830000.0
8830,8830999,22.123442790295034,38.76580594334975,0.04474501464839442,1866.6464006900787,572.4915766716003,2350.2790908813477,78505,8486,70019,70019,0,10,8831000.0
8831,8831999,22.123098490749626,38.765013399657725,0.04473909612963023,1866.7821967601776,572.5542178153992,2351.4131355285645,78508,8486,70022,70022,0,10,8832000.0
8832,8832999,22.12250882414002,38.76497332105079,0.04473752679867704,1866.903898715973,572.6173806190491,2352.2320709228516,78510,8486,70024,70024,0,10,8833000.0
8833,8833999,22.122075430191444,38.76459203117971,0.04473473631893721,1867.3778431415558,572.6825053691864,2352.652286529541,78524,8488,70036,70036,0,10,8834000.0
8834,8834999,22.121514111442988,38.763305712486705,0.044733046917058594,1867.855793952942,572.7473602294922,2352.907611846924,78551,8490,70061,70061,0,10,8835000.0
8835,8835999,22.120952428699507,38.762134287790964,0.044730550876334596,1868.321897983551,572.8100688457489,2353.3008766174316,78576,8492,70084,70084,0,10,8836000.0
8836,8836999,22.1205258443646,38.76108474873834,0.04472798352191887,1868.624939918518,572.8745818138123,2353.6891593933105,78589,8493,70096,70096,0,10,8837000.0
8837,8837999,22.120053281024195,38.76068390162391,0.044724485248189394,1868.9330415725708,572.9416174888611,2354.1255226135254,78606,8494,70112,70112,0,10,8838000.0
8838,8838999,22.119678108698764,38.76049474635657,0.04471825514560235,1869.2539064884186,573.0096302032471,2354.4515380859375,78619,8495,70124,70124,0,10,8839000.0
8839,8839999,22.119274320964145,38.75947816573887,0.04471796678954798,1869.3844707012177,573.0759644508362,2354.881000518799,78619,8495,70124,70124,0,10,8840000.0
8840,8840999,22.119064368724512,38.758747962271485,0.04471614287040737,1869.8794057369232,573.141191482544,2355.1882362365723,78634,8497,70137,70137,0,10,8841000.0
8841,8841999,22.118734999460106,38.75771162304294,0.04471537825893446,1870.0012481212616,573.2028932571411,2355.491195678711,78634,8497,70137,70137,0,10,8842000.0
8842,8842999,22.118539935010123,38.75696514626287,0.044711439838546974,1870.4731965065002,573.2657389640808,2355.7759590148926,78653,8499,70154,70154,0,10,8843000.0
8843,8843999,22.1185129707332,38.75628618879755,0.04470123236699863,1870.5910651683807,573.3288824558258,2356.1840209960938,78653,8499,70154,70154,0,10,8844000.0
8844,8844999,22.118709337197608,38.75596970364298,0.04469208592900853,1870.898158788681,573.394693851471,2356.4349403381348,78655,8500,70155,70155,0,10,8845000.0
8845,8845999,22.118964396263248,38.75566397393784,0.0446807040456344,1871.4092211723328,573.4622411727905,2356.682647705078,78682,8502,70180,70180,0,10,8846000.0
8846,8846999,22.11939356374188,38.756309540673634,0.04466637067519519,1871.5267691612244,573.5257277488708,2357.19766998291,78682,8502,70180,70180,0,10,8847000.0
8847,8847999,22.11959614152518,38.75577958951888,0.04465643437921052,1871.8151755332947,573.5871980190277,2357.4632530212402,78694,8503,70191,70191,0,10,8848000.0
8848,8848999,22.119718203697143,38.755132817380115,0.04464460604304965,1872.1151387691498,573.6504309177399,2357.680824279785,78706,8504,70202,70202,0,10,8849000.0
8849,8849999,22.119802898306055,38.75440635849379,0.044634285287539766,1872.2424738407135,573.7147934436798,2358.0170936584473,78706,8504,70202,70202,0,10,8850000.0
8850,8850999,22.11942210095601,38.753290503767516,0.044630443628528305,1872.3978984355927,573.7860493659973,2358.8848838806152,78710,8504,70206,70206,0,10,8851000.0
8851,8851999,22.118655334148933,38.75231397350492,0.04462842921482346,1872.8793668746948,573.8501405715942,2359.4082374572754,78737,8506,70231,70231,0,10,8852000.0
8852,8852999,22.117891118188144,38.75174944163231,0.04463119186806708,1873.0051620006561,573.9147055149078,2359.8889656066895,78740,8506,70234,70234,0,10,8853000.0
8853,8853999,22.11712446958444,38.75029130423786,0.04463024053420961,1873.332753419876,573.9833383560181,2360.2549934387207,78749,8507,70242,70242,0,10,8854000.0
8854,8854999,22.11643262327934,38.74900162436611,0.044633086979179226,1873.458467245102,574.0485408306122,2360.5735931396484,78749,8507,70242,70242,0,10,8855000.0
8855,8855999,22.115793807248693,38.747646744817786,0.04463197296748622,1873.9646368026733,574.1160385608673,2360.8767623901367,78773,8509,70264,70264,0,10,8856000.0
8856,8856999,22.115255079922186,38.746448650963366,0.0446293593741639,1874.4411075115204,574.1804692745209,2361.1859092712402,78787,8511,70276,70276,0,10,8857000.0
8857,8857999,22.114635214926924,38.74528674491656,0.044628854261647644,1874.744101524353,574.2458040714264,2361.4151153564453,78799,8512,70287,70287,0,10,8858000.0
8858,8858999,22.11400159507317,38.74410882459045,0.044627191749002426,1875.0451102256775,574.3095519542694,2361.6228103637695,78814,8513,70301,70301,0,10,8859000.0
8859,8859999,22.113498435322573,38.74291569864869,0.0446244607293832,1875.1671884059906,574.373945236206,2361.9042053222656,78814,8513,70301,70301,0,10,8860000.0
8860,8860999,22.11295244280445,38.74189354884589,0.044620692205294965,1875.4820461273193,574.4407222270966,2362.071601867676,78825,8514,70311,70311,0,10,8861000.0
8861,8861999,22.112433205570838,38.740593338950134,0.044618186163919105,1876.1565327644348,574.5082137584686,2362.159526824951,78852,8517,70335,70335,0,10,8862000.0
8862,8862999,22.112014681505755,38.73936353438119,0.04461394391931439,1876.6489443778992,574.5747880935669,2362.2876625061035,78858,8519,70339,70339,0,10,8863000.0
8863,8863999,22.111603418125167,38.73817845747114,0.04460919194316626,1876.7819352149963,574.638644695282,2362.538505554199,78858,8519,70339,70339,0,10,8864000.0
8864,8864999,22.111393703260852,38.73835529178975,0.044602517550827,1876.9009869098663,574.7020196914673,2362.9074172973633,78859,8519,70340,70340,0,10,8865000.0
8865,8865999,22.11110941641277,38.73727500028529,0.044595192468179556,1877.0366492271423,574.7654340267181,2363.2821502685547,78859,8519,70340,70340,0,10,8866000.0
8866,8866999,22.110743129327606,38.7361566609065,0.044591416800951245,1877.6981337070465,574.8299968242645,2363.4113998413086,78891,8522,70369,70369,0,10,8867000.0
8867,8867999,22.11044170266946,38.73496081863373,0.04458775310513996,1878.1795544624329,574.8950884342194,2363.5980072021484,78905,8524,70381,70381,0,10,8868000.0
8868,8868999,22.110085584998238,38.734454621037635,0.04458710047889369,1878.3032789230347,574.9596891403198,2363.9156532287598,78906,8524,70382,70382,0,10,8869000.0
8869,8869999,22.109545490992797,38.73321997256001,0.04458587165373917,1878.4247081279755,575.0234375,2364.2351303100586,78906,8524,70382,70382,0,10,8870000.0
8870,8870999,22.1089546161815,38.7319006178754,0.04458334955438903,1878.5434725284576,575.0848379135132,2364.535488128662,78906,8524,70382,70382,0,10,8871000.0
8871,8871999,22.10826446451315,38.731397555781605,0.044586467735637125,1878.6805839538574,575.1489949226379,2365.5134201049805,78907,8524,70383,70383,0,10,8872000.0
8872,8872999,22.107525424682763,38.730854891604245,0.04458542093789786,1879.1912956237793,575.2175872325897,2365.9151153564453,78918,8526,70392,70392,0,10,8873000.0
8873,8873999,22.106686529342642,38.72959747757148,0.04458655848405668,1879.5023634433746,575.2819464206696,2366.2466430664062,78922,8527,70395,70395,0,10,8874000.0
8874,8874999,22.10642469187436,38.72946757659157,0.04458349823434993,1879.6387798786163,575.3488471508026,2366.585105895996,78922,8527,70395,70395,0,10,8875000.0
8875,8875999,22.10605141841471,38.72901731174079,0.0445835268610868,1879.9486842155457,575.4141528606415,2366.8119773864746,78924,8528,70396,70396,0,10,8876000.0
8876,8876999,22.105823109795242,38.728523109672324,0.04458213540433131,1880.4333431720734,575.478093624115,2366.9621353149414,78948,8530,70418,70418,0,10,8877000.0
8877,8877999,22.105614247406468,38.72819614456745,0.04457847416577376,1880.557494878769,575.5422134399414,2367.3529739379883,78948,8530,70418,70418,0,10,8878000.0
8878,8878999,22.105271483414743,38.72758656633178,0.04457560736033939,1880.8606569766998,575.6056439876556,2367.6401329040527,78950,8531,70419,70419,0,10,8879000.0
8879,8879999,22.105239746270147,38.727211422789864,0.044572659778845614,1881.3544433116913,575.669294834137,2367.785789489746,78973,8533,70440,70440,0,10,8880000.0
8880,8880999,22.10512742961069,38.72674812732782,0.04457160516667846,1881.4792416095734,575.7364990711212,2368.061248779297,78973,8533,70440,70440,0,10,8881000.0
8881,8881999,22.10514661705529,38.726489520030036,0.044569425238227045,1881.7761189937592,575.8006708621979,2368.354206085205,78986,8534,70452,70452,0,10,8882000.0
8882,8882999,22.10499228330224,38.725883997092104,0.04456844627473322,1881.911244392395,575.8636968135834,2368.6203269958496,78986,8534,70452,70452,0,10,8883000.0
8883,8883999,22.10495071182356,38.72528714433551,0.04456815989975804,1882.563853263855,575.9285893440247,2368.7449493408203,79014,8537,70477,70477,0,10,8884000.0
8884,8884999,22.10501327086932,38.724856957570594,0.04456823562931622,1882.8693263530731,575.9930582046509,2369.130157470703,79019,8538,70481,70481,0,10,8885000.0
8885,8885999,22.105124214951946,38.72451520114802,0.04457000606304362,1883.3578984737396,576.0569252967834,2369.4292526245117,79023,8540,70483,70483,0,10,8886000.0
8886,8886999,22.105173752246326,38.72390953193872,0.044568365087133466,1883.487830400467,576.1221220493317,2369.8447914123535,79023,8540,70483,70483,0,10,8887000.0
8887,8887999,22.10541097700703,38.72365871137758,0.04456654600910248,1883.6140818595886,576.1862258911133,2370.2598037719727,79023,8540,70483,70483,0,10,8888000.0
8888,8888999,22.105482216092085,38.723080074538025,0.04456279891836057,1884.272656917572,576.250091791153,2370.4346618652344,79060,8543,70517,70517,0,10,8889000.0
8889,8889999,22.10559399554005,38.72243408381186,0.04455915136761701,1884.4058527946472,576.3163776397705,2370.770923614502,79060,8543,70517,70517,0,10,8890000.0
8890,8890999,22.10532076652838,38.72149258807917,0.04455628958958413,1884.5200266838074,576.3793864250183,2371.050868988037,79060,8543,70517,70517,0,10,8891000.0
8891,8891999,22.104476749522526,38.719870476973426,0.04455971137324877,1884.646104812622,576.4435303211212,2372.0448455810547,79065,8543,70522,70522,0,10,8892000.0
8892,8892999,22.103482925384153,38.71866726527389,0.04456110154692594,1884.7725684642792,576.5095012187958,2372.5948791503906,79067,8543,70524,70524,0,10,8893000.0
8893,8893999,22.102537598829255,38.717163765745106,0.04456375245522426,1884.8996324539185,576.5740263462067,2372.9286041259766,79068,8543,70525,70525,0,10,8894000.0
8894,8894999,22.101893078879737,38.716060986016195,0.044563758316335744,1885.2129883766174,576.6395437717438,2373.2592735290527,79071,8544,70527,70527,0,10,8895000.0
8895,8895999,22.101264788414777,38.71503934450524,0.04456276226169942,1885.3367636203766,576.7024869918823,2373.5948181152344,79071,8544,70527,70527,0,10,8896000.0
8896,8896999,22.10063047695058,38.71425046669373,0.044562814486618585,1885.6523969173431,576.7687699794769,2373.83927154541,79081,8545,70536,70536,0,10,8897000.0
8897,8897999,22.100016192764038,38.71338235371242,0.04456374837425692,1886.1318583488464,576.8320269584656,2374.110450744629,79108,8547,70561,70561,0,10,8898000.0
8898,8898999,22.099190349951314,38.711837470767826,0.04456355196841044,1886.2533597946167,576.8946559429169,2374.550754547119,79108,8547,70561,70561,0,10,8899000.0
8899,8899999,22.09849003984227,38.710407276575786,0.044563032128929425,1886.5656971931458,576.9602646827698,2374.8198204040527,79121,8548,70573,70573,0,10,8900000.0
8900,8900999,22.097967294148187,38.70935461541336,0.044562073526821955,1886.8659672737122,577.0241661071777,2375.145118713379,79133,8549,70584,70584,0,10,8901000.0
8901,8901999,22.09767376976506,38.71003616372505,0.04455489326220641,1886.9875886440277,577.0899560451508,2375.610794067383,79134,8549,70585,70585,0,10,8902000.0
8902,8902999,22.09716357375327,38.708741684440405,0.04455238944802076,1887.1125588417053,577.1553514003754,2375.928451538086,79134,8549,70585,70585,0,10,8903000.0
8903,8903999,22.09694789361346,38.707835819405545,0.044546337765168365,1887.4135248661041,577.2217228412628,2376.2523918151855,79139,8550,70589,70589,0,10,8904000.0
8904,8904999,22.096796483863255,38.70698447876351,0.044536619557298485,1888.0755772590637,577.2862725257874,2376.4580574035645,79175,8553,70622,70622,0,10,8905000.0
8905,8905999,22.096806172436807,38.70642123002932,0.04452738061519512,1888.7340948581696,577.349823474884,2376.6508598327637,79201,8556,70645,70645,0,10,8906000.0
8906,8906999,22.096914994665692,38.70579191469006,0.044517561056114596,1888.8610410690308,577.4143400192261,2376.990650177002,79201,8556,70645,70645,0,10,8907000.0
8907,8907999,22.096905880615886,38.704977020980984,0.044511235067382415,1889.50812458992,577.478343963623,2377.1433143615723,79227,8559,70668,70668,0,10,8908000.0
8908,8908999,22.096855576694505,38.704210912318906,0.044504872374090954,1889.6578602790833,577.553026676178,2377.494785308838,79227,8559,70668,70668,0,10,8909000.0
8909,8909999,22.096728827222062,38.7033409340679,0.044498297111783325,1889.9519929885864,577.616979598999,2377.7862815856934,79239,8560,70679,70679,0,10,8910000.0
8910,8910999,22.09640807828425,38.7022156339198,0.0444934609151747,1890.245890378952,577.68017578125,2378.0262413024902,79241,8561,70680,70680,0,10,8911000.0
8911,8911999,22.095583000358577,38.70073296459,0.04449533255795146,1891.075433254242,577.7463476657867,2378.773006439209,79286,8565,70721,70721,0,10,8912000.0
8912,8912999,22.094576058029794,38.69914363128299,0.044497480795966715,1891.202418088913,577.8104288578033,2379.274112701416,79288,8565,70723,70723,0,10,8913000.0
8913,8913999,22.093751225290703,38.69780139384651,0.04450106738585191,1891.6886925697327,577.876266002655,2379.521915435791,79314,8567,70747,70747,0,10,8914000.0
8914,8914999,22.093143462723063,38.69662582613945,0.044499811829431635,1891.8133385181427,577.940098285675,2379.8644790649414,79315,8567,70748,70748,0,10,8915000.0
8915,8915999,22.092608671588398,38.69619021621758,0.04449245422795456,1892.1197938919067,578.0047197341919,2380.1652488708496,79318,8568,70750,70750,0,10,8916000.0
8916,8916999,22.09194527476043,38.69490764936464,0.04448990233370953,1892.4196274280548,578.069483757019,2380.4127082824707,79330,8569,70761,70761,0,10,8917000.0
8917,8917999,22.091339405095418,38.69371669778729,0.0444889165813005,1892.5547547340393,578.1420252323151,2380.7225341796875,79331,8569,70762,70762,0,10,8918000.0
8918,8918999,22.090836538330294,38.69290678211945,0.04448703093251327,1892.844223499298,578.2037432193756,2381.0864601135254,79335,8570,70765,70765,0,10,8919000.0
8919,8919999,22.090439384131898,38.692055282376515,0.04448282061959408,1892.9604365825653,578.2671973705292,2381.381805419922,79335,8570,70765,70765,0,10,8920000.0
8920,8920999,22.09022728323427,38.69186444422938,0.04448199264405395,1893.4773154258728,578.3362121582031,2381.4891662597656,79351,8572,70779,70779,0,10,8921000.0
8921,8921999,22.09014242991115,38.691500275540136,0.04448420579050616,1893.598724603653,578.3997528553009,2381.816879272461,79353,8572,70781,70781,0,10,8922000.0
8922,8922999,22.09043477959692,38.692133811863705,0.04448532045983633,1894.2614850997925,578.4653418064117,2381.8244590759277,79389,8575,70814,70814,0,10,8923000.0
8923,8923999,22.09055158906704,38.692547650148825,0.044485540098874954,1894.3992853164673,578.5397508144379,2382.035747528076,79389,8575,70814,70814,0,10,8924000.0
8924,8924999,22.09107571095554,38.69353351470029,0.044487088282549214,1895.0582010746002,578.6027274131775,2382.0601081848145,79425,8578,70847,70847,0,10,8925000.0
8925,8925999,22.0918564472427,38.69513100694244,0.04449464692354088,1895.5548243522644,578.6666281223297,2382.2273864746094,79439,8580,70859,70859,0,10,8926000.0
8926,8926999,22.092615096558273,38.69669058944232,0.044502138715443285,1896.2227945327759,578.7302193641663,2382.274730682373,79475,8583,70892,70892,0,10,8927000.0
8927,8927999,22.09350455278788,38.69839762245964,0.04450993007637971,1896.7030556201935,578.7939512729645,2382.426326751709,79499,8585,70914,70914,0,10,8928000.0
8928,8928999,22.094656421903117,38.70108278181283,0.04451456291673228,1896.9989547729492,578.8581438064575,2382.720516204834,79511,8586,70925,70925,0,10,8929000.0
8929,8929999,22.095426713199362,38.70232680852402,0.04452847128166004,1897.4918549060822,578.9296405315399,2382.8965225219727,79525,8588,70937,70937,0,10,8930000.0
8930,8930999,22.09614873238126,38.70379579609224,0.044535494487360605,1898.1545596122742,578.992769241333,2383.0310974121094,79556,8591,70965,70965,0,10,8931000.0
8931,8931999,22.095726662370975,38.70328139817602,0.044526182556440475,1898.2825438976288,579.05508685112,2384.4914169311523,79564,8591,70973,70973,0,10,8932000.0
8932,8932999,22.095296683955212,38.70336784144708,0.04451389751457013,1898.7583310604095,579.1210770606995,2385.055767059326,79576,8593,70983,70983,0,10,8933000.0
8933,8933999,22.094831099272433,38.70266074085757,0.044506405128546755,1899.0625145435333,579.1847598552704,2385.4658164978027,79581,8594,70987,70987,0,10,8934000.0
8934,8934999,22.09458234299644,38.70307703421669,0.04449262148131272,1899.3693046569824,579.2486402988434,2385.8416442871094,79593,8595,70998,70998,0,10,8935000.0
8935,8935999,22.094313285171285,38.70233066914052,0.04448440307770096,1900.2050619125366,579.3138253688812,2386.0068435668945,79631,8599,71032,71032,0,10,8936000.0
8936,8936999,22.093917379857444,38.70147567080347,0.044475826277132535,1900.8571527004242,579.3782176971436,2386.210750579834,79662,8602,71060,71060,0,10,8937000.0
8937,8937999,22.093713193314972,38.70127428436495,0.04446195046636858,1901.3480858802795,579.4434239864349,2386.5977096557617,79686,8604,71082,71082,0,10,8938000.0
8938,8938999,22.093571530553742,38.70253517963423,0.04445140514472168,1901.470799446106,579.5073575973511,2387.0828704833984,79686,8604,71082,71082,0,10,8939000.0
8939,8939999,22.093458447795737,38.70195572017011,0.04444440605195654,1901.7669064998627,579.5713455677032,2387.3429069519043,79693,8605,71088,71088,0,10,8940000.0
8940,8940999,22.093390122524276,38.70129209310465,0.04443743044039672,1901.895983695984,579.6382179260254,2387.675235748291,79693,8605,71088,71088,0,10,8941000.0
8941,8941999,22.09341715725791,38.700581185948785,0.044430703746616396,1902.1967115402222,579.7033331394196,2388.062267303467,79697,8606,71091,71091,0,10,8942000.0
8942,8942999,22.0933534194904,38.70018750278892,0.04442497235142284,1902.491287946701,579.7669656276703,2388.2602195739746,79700,8607,71093,71093,0,10,8943000.0
8943,8943999,22.093423985825606,38.69981229106289,0.04442564023239148,1902.9718792438507,579.8319373130798,2388.563045501709,79724,8609,71115,71115,0,10,8944000.0
8944,8944999,22.09367360882886,38.69965142424168,0.044422191964172186,1903.0860931873322,579.8944640159607,2388.9964027404785,79725,8609,71116,71116,0,10,8945000.0
8945,8945999,22.09402410695318,38.69953199185755,0.0444220618391159,1903.3888850212097,579.9586148262024,2389.307685852051,79737,8610,71127,71127,0,10,8946000.0
8946,8946999,22.094363839415855,38.69911198205758,0.04441795167934859,1903.5094141960144,580.0206587314606,2389.5919799804688,79738,8610,71128,71128,0,10,8947000.0
8947,8947999,22.094736479595674,38.69896500464667,0.04441703039892442,1904.162974357605,580.0862214565277,2389.9052696228027,79772,8613,71159,71159,0,10,8948000.0
8948,8948999,22.09542027002982,38.69927597636751,0.04441405270393051,1904.64116024971,580.150064945221,2390.1379432678223,79788,8615,71173,71173,0,10,8949000.0
8949,8949999,22.09583439798425,38.699179885796276,0.044416221132474454,1905.3146398067474,580.2156476974487,2390.340003967285,79825,8618,71207,71207,0,10,8950000.0
8950,8950999,22.09626330446405,38.699585616134364,0.044414021632298684,1905.8082489967346,580.2811028957367,2390.590003967285,79850,8620,71230,71230,0,10,8951000.0
8951,8951999,22.096094757785995,38.69881806649129,0.044411160028030805,1905.929036140442,580.3434224128723,2391.549530029297,79857,8620,71237,71237,0,10,8952000.0
8952,8952999,22.09544963746719,38.69780586534572,0.04440821067755396,1906.4115455150604,580.4075841903687,2392.194553375244,79873,8622,71251,71251,0,10,8953000.0
8953,8953999,22.09481476933523,38.69762519168008,0.04440714898368836,1906.5391299724579,580.4716081619263,2392.7054710388184,79874,8622,71252,71252,0,10,8954000.0
8954,8954999,22.094251170249837,38.69659087521524,0.04440403586870767,1906.6764788627625,580.5441780090332,2393.10311126709,79874,8622,71252,71252,0,10,8955000.0
8955,8955999,22.09365592931004,38.69605161747915,0.044401481811029875,1906.81396484375,580.6179928779602,2393.45503616333,79875,8622,71253,71253,0,10,8956000.0
8956,8956999,22.093210512614725,38.695845085733566,0.04439654477466015,1907.1142342090607,580.680983543396,2393.733108520508,79877,8623,71254,71254,0,10,8957000.0
8957,8957999,22.092633444942603,38.69464929534863,0.04439354948034502,1907.4178788661957,580.7470202445984,2393.9764442443848,79889,8624,71265,71265,0,10,8958000.0
8958,8958999,22.092076168298483,38.69343780182395,0.04439148440127372,1907.7194015979767,580.8109731674194,2394.308547973633,79897,8625,71272,71272,0,10,8959000.0
8959,8959999,22.09164146383744,38.69244215624105,0.044387804683054144,1907.8417491912842,580.8741939067841,2394.6350059509277,79898,8625,71273,71273,0,10,8960000.0
8960,8960999,22.091328817670533,38.69361104167728,0.04437710498650138,1908.1507632732391,580.9390287399292,2394.8920135498047,79907,8626,71281,71281,0,10,8961000.0
8961,8961999,22.091027730445123,38.692677464867664,0.04437394958608143,1908.2800595760345,581.0015594959259,2395.1464042663574,79907,8626,71281,71281,0,10,8962000.0
8962,8962999,22.090886003650485,38.69205080686222,0.04436510360358881,1908.5906066894531,581.0655670166016,2395.4635047912598,79920,8627,71293,71293,0,10,8963000.0
8963,8963999,22.090986647994654,38.69194971232136,0.044357821759859695,1908.713047027588,581.1294689178467,2395.7860260009766,79920,8627,71293,71293,0,10,8964000.0
8964,8964999,22.09090796360574,38.691167960821375,0.0443518043838127,1908.8363280296326,581.1928689479828,2396.145679473877,79920,8627,71293,71293,0,10,8965000.0
8965,8965999,22.091029440420794,38.690685537661544,0.044343895489733276,1909.1744630336761,581.261471748352,2396.4817543029785,79932,8628,71304,71304,0,10,8966000.0
8966,8966999,22.091065327108495,38.689904114719546,0.044336369682600796,1909.6619715690613,581.326756477356,2396.6641426086426,79942,8630,71312,71312,0,10,8967000.0
8967,8967999,22.0910636447199,38.68911577713988,0.044329429366040674,1909.797072172165,581.3933646678925,2397.031936645508,79942,8630,71312,71312,0,10,8968000.0
8968,8968999,22.09095795500186,38.689452775821565,0.04432369374314349,1909.9189784526825,581.4567325115204,2397.6877403259277,79945,8630,71315,71315,0,10,8969000.0
8969,8969999,22.090660288656668,38.68915484479581,0.04431567995481955,1910.0503478050232,581.521014213562,2398.611557006836,79948,8630,71318,71318,0,10,8970000.0
8970,8970999,22.09021420146741,38.688568768636856,0.044310746156880354,1910.5299832820892,581.5837380886078,2398.9576454162598,79956,8632,71324,71324,0,10,8971000.0
8971,8971999,22.089766621450345,38.687726658134764,0.04430741280364214,1910.8410201072693,581.6478929519653,2399.3308639526367,79965,8633,71332,71332,0,10,8972000.0
8972,8972999,22.089547818001225,38.68738642727363,0.04430424755126239,1910.968703508377,581.7115650177002,2399.636257171631,79965,8633,71332,71332,0,10,8973000.0
8973,8973999,22.08937777215575,38.687412377237976,0.044304856285646954,1911.6252529621124,581.775309085846,2399.8352241516113,79998,8636,71362,71362,0,10,8974000.0
8974,8974999,22.088963132786226,38.68658580514568,0.04430375456594582,1912.1167795658112,581.8400158882141,2400.0078048706055,80012,8638,71374,71374,0,10,8975000.0
8975,8975999,22.089095281943035,38.68876767491235,0.04429678258381431,1912.4203498363495,581.9038455486298,2400.304344177246,80023,8639,71384,71384,0,10,8976000.0
8976,8976999,22.0889323684842,38.68823702178566,0.04429809592131362,1913.259553194046,581.9668498039246,2400.4225540161133,80080,8643,71437,71437,0,10,8977000.0
8977,8977999,22.08912263362001,38.688335649748204,0.04430125659952355,1913.3815429210663,582.0310614109039,2400.648391723633,80080,8643,71437,71437,0,10,8978000.0
8978,8978999,22.089395395794668,38.688615569196955,0.04430508565457092,1913.882866859436,582.0949399471283,2400.823585510254,80094,8645,71449,71449,0,10,8979000.0
8979,8979999,22.089954568129432,38.689204481857324,0.04430943269155452,1914.7330634593964,582.1593976020813,2400.810615539551,80129,8649,71480,71480,0,10,8980000.0
8980,8980999,22.090231689550734,38.69033432281715,0.0443166961001884,1915.2202019691467,582.222418308258,2400.9449501037598,80151,8651,71500,71500,0,10,8981000.0
8981,8981999,22.09075472059436,38.69092582936406,0.04432177280478744,1915.344865322113,582.2893507480621,2401.344394683838,80151,8651,71500,71500,0,10,8982000.0
8982,8982999,22.09161483538202,38.69262841603443,0.0443351201449701,1916.0212786197662,582.3533298969269,2401.533233642578,80178,8654,71524,71524,0,10,8983000.0
8983,8983999,22.092416328508506,38.693767394814785,0.04434443283254663,1916.1399161815643,582.4170806407928,2401.9510917663574,80180,8654,71526,71526,0,10,8984000.0
8984,8984999,22.093496050307532,38.6946844153114,0.04435969379132576,1916.459328174591,582.480450630188,2402.159336090088,80191,8655,71536,71536,0,10,8985000.0
8985,8985999,22.094274225152343,38.69504844279382,0.044374197819217254,1916.7646918296814,582.5434925556183,2402.552234649658,80204,8656,71548,71548,0,10,8986000.0
8986,8986999,22.095138840489074,38.69637447956644,0.04438074491501931,1916.8796229362488,582.6055040359497,2402.894844055176,80205,8656,71549,71549,0,10,8987000.0
8987,8987999,22.095369192061487,38.695907980313834,0.0443881313224902,1917.1877419948578,582.667738199234,2403.0840911865234,80216,8657,71559,71559,0,10,8988000.0
8988,8988999,22.095009863492983,38.69504793518652,0.04438317270511938,1917.4974019527435,582.7299327850342,2403.522575378418,80225,8658,71567,71567,0,10,8989000.0
8989,8989999,22.09426843764259,38.693828372386996,0.04438107781543643,1917.9894111156464,582.7932522296906,2403.6843605041504,80245,8660,71585,71585,0,10,8990000.0
8990,8990999,22.093922408890098,38.693345422485905,0.044383156903721965,1918.3064744472504,582.8563451766968,2403.9010467529297,80248,8661,71587,71587,0,10,8991000.0
8991,8991999,22.09369452301232,38.692789616716695,0.04437982777169924,1918.4330999851227,582.918459892273,2404.107219696045,80248,8661,71587,71587,0,10,8992000.0
8992,8992999,22.09343361093703,38.69207035414224,0.04437672851029484,1918.9358322620392,582.9821667671204,2404.153709411621,80265,8663,71602,71602,0,10,8993000.0
8993,8993999,22.093756326485465,38.692946691024055,0.04438051995965808,1919.7916748523712,583.0460751056671,2404.130039215088,80282,8667,71615,71615,0,10,8994000.0
8994,8994999,22.09423625434296,38.69422993533755,0.04439070534927958,1919.924629688263,583.108864068985,2404.368064880371,80282,8667,71615,71615,0,10,8995000.0
8995,8995999,22.09464335431934,38.6950945110464,0.04440055320505931,1920.0489075183868,583.1719079017639,2404.5507774353027,80282,8667,71615,71615,0,10,8996000.0
8996,8996999,22.0956256462271,38.69762216673986,0.04440882363807297,1920.358634710312,583.2341840267181,2404.673572540283,80289,8668,71621,71621,0,10,8997000.0
8997,8997999,22.096504910444796,38.69940036395628,0.044424301974196,1920.49445104599,583.2964098453522,2404.7906494140625,80289,8668,71621,71621,0,10,8998000.0
8998,8998999,22.097723391110158,38.70272167718633,0.04444939213765697,1920.638118982315,583.3588228225708,2405.0347595214844,80291,8668,71623,71623,0,10,8999000.0
8999,8999999,22.0994892962916,38.706566957389946,0.04448043293937487,1920.7720692157745,583.4262623786926,2405.2065658569336,80291,8668,71623,71623,0,10,9000000.0
9000,9000999,22.10098780543449,38.710592045781,0.04451616935402203,1921.4493362903595,583.4899489879608,2405.193618774414,80304,8671,71633,71633,0,10,9001000.0
9001,9001999,22.10274318687014,38.71384238553624,0.04454508199871099,1921.9366807937622,583.5548906326294,2405.2435913085938,80313,8673,71640,71640,0,10,9002000.0
9002,9002999,22.104763882439848,38.71782242065337,0.04457440882611263,1922.2505881786346,583.6174371242523,2405.3841590881348,80320,8674,71646,71646,0,10,9003000.0
9003,9003999,22.106581881620023,38.72099233489497,0.044610216107107914,1922.3941283226013,583.6802890300751,2405.5562057495117,80320,8674,71646,71646,0,10,9004000.0
9004,9004999,22.108473408102174,38.72415255026104,0.044643333332072155,1922.6994843482971,583.7433235645294,2405.574565887451,80327,8675,71652,71652,0,10,9005000.0
9005,9005999,22.110047567132806,38.72626416523836,0.04467241425941304,1922.8290963172913,583.8065176010132,2405.7575302124023,80327,8675,71652,71652,0,10,9006000.0
9006,9006999,22.11183890816796,38.72888509654374,0.04469757128072871,1923.4972836971283,583.8706073760986,2405.8122787475586,80349,8678,71671,71671,0,10,9007000.0
9007,9007999,22.112658979769545,38.73052398872765,0.0447085893988145,1923.8091008663177,583.9366855621338,2406.7075233459473,80356,8679,71677,71677,0,10,9008000.0
9008,9008999,22.111963013681443,38.72936024299249,0.04469985457559689,1923.9372086524963,584.0005767345428,2407.633975982666,80361,8679,71682,71682,0,10,9009000.0
9009,9009999,22.11136138300971,38.72840386157184,0.04469626786289971,1924.2611730098724,584.0641188621521,2408.2787017822266,80372,8680,71692,71692,0,10,9010000.0
9010,9010999,22.111056229432688,38.72790905651433,0.0446910416122317,1924.5711524486542,584.1280527114868,2408.7944984436035,80379,8681,71698,71698,0,10,9011000.0
9011,9011999,22.11084428200032,38.72825752784618,0.044687161377717444,1924.8822066783905,584.1932344436646,2409.2955780029297,80392,8682,71710,71710,0,10,9012000.0
9012,9012999,22.110431384634033,38.72745432297293,0.044685416086888585,1925.0142993927002,584.2567880153656,2409.9704399108887,80396,8682,71714,71714,0,10,9013000.0
9013,9013999,22.1100178274473,38.72642236607077,0.044682698041894064,1925.4994275569916,584.321444272995,2410.3024673461914,80410,8684,71726,71726,0,10,9014000.0
9014,9014999,22.109683793920098,38.72571902941348,0.044682965456958046,1925.8233199119568,584.3872756958008,2410.605628967285,80423,8685,71738,71738,0,10,9015000.0
9015,9015999,22.10973519630747,38.727464972111896,0.04467630508178799,1926.6777906417847,584.4525854587555,2410.694591522217,80457,8689,71768,71768,0,10,9016000.0
9016,9016999,22.10988313644816,38.72785005292503,0.04467897304343782,1926.800695180893,584.5158202648163,2411.156238555908,80457,8689,71768,71768,0,10,9017000.0
9017,9017999,22.110243081041542,38.72845929114326,0.04468349620105383,1927.4645297527313,584.58029961586,2411.4305725097656,80483,8692,71791,71791,0,10,9018000.0
9018,9018999,22.110691421524635,38.729017480574846,0.04468516458135685,1927.5769362449646,584.6407704353333,2411.7225646972656,80483,8692,71791,71791,0,10,9019000.0
9019,9019999,22.11131228856678,38.73041530198344,0.04468586883873649,1927.884203672409,584.7057480812073,2412.1338500976562,80497,8693,71804,71804,0,10,9020000.0
9020,9020999,22.11197645466681,38.73110509609641,0.04469317660406713,1928.3564453125,584.7665684223175,2412.451217651367,80520,8695,71825,71825,0,10,9021000.0
9021,9021999,22.11268617946677,38.73215726204734,0.04469821336495727,1929.218697309494,584.831084728241,2412.525291442871,80549,8699,71850,71850,0,10,9022000.0
9022,9022999,22.113493736093943,38.73337420838932,0.04471412111216688,1929.342984199524,584.8952474594116,2412.9914054870605,80549,8699,71850,71850,0,10,9023000.0
9023,9023999,22.114488539300915,38.735759067273435,0.04472541188274737,1929.8476829528809,584.9605474472046,2413.339370727539,80575,8701,71874,71874,0,10,9024000.0
9024,9024999,22.115609408887277,38.73733964894235,0.04473022758795242,1929.9725079536438,585.0225172042847,2413.7333030700684,80575,8701,71874,71874,0,10,9025000.0
9025,9025999,22.11672448295186,38.73924346144058,0.04473764108328082,1930.283147096634,585.0861568450928,2413.8955116271973,80578,8702,71876,71876,0,10,9026000.0
9026,9026999,22.117375809261475,38.73977499830379,0.04474599788824396,1930.759325504303,585.1496117115021,2414.2890396118164,80597,8704,71893,71893,0,10,9027000.0
9027,9027999,22.117293956449352,38.73946973352465,0.04474490018649091,1931.0801718235016,585.212541103363,2415.551052093506,80605,8705,71900,71900,0,10,9028000.0
9028,9028999,22.116628620463224,38.73831151328365,0.04474529203800093,1931.3891003131866,585.2777161598206,2416.218765258789,80609,8706,71903,71903,0,10,9029000.0
9029,9029999,22.115932288395648,38.736962374952434,0.044749172529144676,1931.5055074691772,585.3403217792511,2416.754596710205,80611,8706,71905,71905,0,10,9030000.0
9030,9030999,22.115397380696983,38.736139721927536,0.04474820292753934,1932.0040616989136,585.405152797699,2417.149971008301,80624,8708,71916,71916,0,10,9031000.0
9031,9031999,22.114870313246264,38.73499743447809,0.044745363714402964,1932.2982337474823,585.4663894176483,2417.4791221618652,80637,8709,71928,71928,0,10,9032000.0
9032,9032999,22.11415242884586,38.73363257490925,0.0447453165980517,1932.5923473834991,585.5287384986877,2417.8000297546387,80649,8710,71939,71939,0,10,9033000.0
9033,9033999,22.113763471817194,38.732558397173975,0.04474334941169911,1932.903579711914,585.59445977211,2418.2899169921875,80661,8711,71950,71950,0,10,9034000.0
9034,9034999,22.113119400934373,38.73115149318101,0.0447417674830326,1933.2159657478333,585.658043384552,2418.6765785217285,80663,8712,71951,71951,0,10,9035000.0
9035,9035999,22.11269394675934,38.73174245996842,0.04473375161709081,1933.3369002342224,585.7218971252441,2418.9673805236816,80663,8712,71951,71951,0,10,9036000.0
9036,9036999,22.112240028588783,38.730928532891475,0.0447324570195573,1934.0235409736633,585.7863917350769,2419.098114013672,80698,8715,71983,71983,0,10,9037000.0
9037,9037999,22.11182122188357,38.72986260691583,0.04473209984922877,1934.323660850525,585.850216627121,2419.3851890563965,80710,8716,71994,71994,0,10,9038000.0
9038,9038999,22.111328711474627,38.72884053370178,0.04473011456464915,1934.4471633434296,585.9135541915894,2419.6598930358887,80710,8716,71994,71994,0,10,9039000.0
9039,9039999,22.110932419422777,38.727959687308996,0.04472975720016614,1934.7673435211182,585.9788248538971,2419.9657287597656,80723,8717,72006,72006,0,10,9040000.0
9040,9040999,22.110459946295702,38.72677642476917,0.044728082573117445,1935.062382698059,586.0406935214996,2420.253486633301,80725,8718,72007,72007,0,10,9041000.0
9041,9041999,22.110108892410004,38.72582586662678,0.04472548710076829,1935.179053068161,586.1008536815643,2420.49649810791,80725,8718,72007,72007,0,10,9042000.0
9042,9042999,22.109834988360756,38.7250702956391,0.04472555587046312,1935.4885938167572,586.1638050079346,2420.871627807617,80735,8719,72016,72016,0,10,9043000.0
9043,9043999,22.10944602903,38.72400757140781,0.04472401260556558,1935.7895872592926,586.2260508537292,2421.2326469421387,80741,8720,72021,72021,0,10,9044000.0
9044,9044999,22.109193775424117,38.72300864617058,0.0447179271243352,1936.0950119495392,586.2893092632294,2421.4280014038086,80751,8721,72030,72030,0,10,9045000.0
9045,9045999,22.108804678175495,38.72182530250636,0.044713182788244765,1936.5729751586914,586.3502969741821,2421.696216583252,80765,8723,72042,72042,0,10,9046000.0
9046,9046999,22.108406466943027,38.72089980222401,0.04470696968913246,1936.8717019557953,586.4130568504333,2421.9961547851562,80777,8724,72053,72053,0,10,9047000.0
9047,9047999,22.10790862784873,38.719666316130805,0.04470489571420444,1937.0009407997131,586.4763600826263,2422.791027069092,80777,8724,72053,72053,0,10,9048000.0
9048,9048999,22.10731840486327,38.718877815882585,0.0447001745415061,1937.1328444480896,586.5406093597412,2423.5340843200684,80779,8724,72055,72055,0,10,9049000.0
9049,9049999,22.10664326776491,38.71775009358358,0.04469777500312144,1937.4447965621948,586.6043198108673,2423.943531036377,80792,8725,72067,72067,0,10,9050000.0
9050,9050999,22.10603351494326,38.7169884140559,0.04469685134857204,1937.758866071701,586.6697881221771,2424.2383460998535,80800,8726,72074,72074,0,10,9051000.0
9051,9051999,22.105618194763878,38.7163760059723,0.0446894641621014,1938.2519881725311,586.7335150241852,2424.4540405273438,80824,8728,72096,72096,0,10,9052000.0
9052,9052999,22.105181813023492,38.71577523341383,0.044679898095690396,1938.5669524669647,586.7993052005768,2424.7396659851074,80836,8729,72107,72107,0,10,9053000.0
9053,9053999,22.104783800556792,38.71472777134728,0.04467453895820961,1938.6877853870392,586.8634374141693,2425.1037216186523,80836,8729,72107,72107,0,10,9054000.0
9054,9054999,22.104284818791836,38.71347391459917,0.044669383265546925,1939.164234161377,586.925675868988,2425.291404724121,80850,8731,72119,72119,0,10,9055000.0
9055,9055999,22.10397605065791,38.71274476014831,0.04466458474481838,1939.49165225029,586.9969809055328,2425.5652809143066,80855,8732,72123,72123,0,10,9056000.0
9056,9056999,22.10364472555865,38.71172715303593,0.044659898147986765,1940.3402469158173,587.0613162517548,2425.5983123779297,80898,8736,72162,72162,0,10,9057000.0
9057,9057999,22.103291548631173,38.710784638642934,0.04465515097218464,1940.4706771373749,587.1246404647827,2425.866855621338,80898,8736,72162,72162,0,10,9058000.0
9058,9058999,22.102966194115723,38.709912614320565,0.04465000438009048,1940.592232465744,587.1913843154907,2426.188877105713,80898,8736,72162,72162,0,10,9059000.0
9059,9059999,22.10282199032393,38.70933657877447,0.044646029393912934,1940.9101469516754,587.2554979324341,2426.3780517578125,80914,8737,72177,72177,0,10,9060000.0
9060,9060999,22.102598098760293,38.708519623790764,0.04464352333320287,1941.0324802398682,587.3176376819611,2426.616558074951,80914,8737,72177,72177,0,10,9061000.0
9061,9061999,22.102571761004434,38.70824094424076,0.04463878558663015,1941.8778080940247,587.3814427852631,2426.728713989258,80947,8741,72206,72206,0,10,9062000.0
9062,9062999,22.102571840807144,38.70785196152727,0.04463713439202832,1942.1791462898254,587.4448962211609,2427.1384201049805,80959,8742,72217,72217,0,10,9063000.0
9063,9063999,22.102672685791656,38.70754470843014,0.04463870701626926,1942.3023827075958,587.5085220336914,2427.5108947753906,80959,8742,72217,72217,0,10,9064000.0
9064,9064999,22.102669818601434,38.707099495325224,0.044640042442522065,1942.427440404892,587.5720608234406,2427.78466796875,80959,8742,72217,72217,0,10,9065000.0
9065,9065999,22.102789103647403,38.70674347191498,0.04463869998297887,1943.3167521953583,587.6419501304626,2427.9785766601562,81020,8746,72274,72274,0,10,9066000.0
9066,9066999,22.10287227797851,38.70618337514637,0.044641532716597765,1943.6256792545319,587.704669713974,2428.3098106384277,81032,8747,72285,72285,0,10,9067000.0
9067,9067999,22.102986293370122,38.7058244060431,0.04464381963609754,1943.9373607635498,587.7690649032593,2428.621467590332,81041,8748,72293,72293,0,10,9068000.0
9068,9068999,22.10260069157949,38.70478895560425,0.044635331137632406,1944.0691184997559,587.8329603672028,2429.7569999694824,81044,8748,72296,72296,0,10,9069000.0
9069,9069999,22.102359331360265,38.70558481553196,0.04462215747175535,1944.1906599998474,587.8964500427246,2430.27006149292,81044,8748,72296,72296,0,10,9070000.0
9070,9070999,22.102442993736513,38.70831439763802,0.04460821023929118,1944.3136014938354,587.9602861404419,2430.608196258545,81045,8748,72297,72297,0,10,9071000.0
9071,9071999,22.102198378268035,38.70746001113732,0.044604314186101224,1944.6283340454102,588.0243322849274,2430.977798461914,81057,8749,72308,72308,0,10,9072000.0
9072,9072999,22.102236527511845,38.70711489749976,0.044604663520554144,1945.1266539096832,588.0878562927246,2431.218906402588,81070,8751,72319,72319,0,10,9073000.0
9073,9073999,22.102606661661746,38.70765723593064,0.04460480596175809,1945.4326968193054,588.1504662036896,2431.4200172424316,81083,8752,72331,72331,0,10,9074000.0
9074,9074999,22.103264202115117,38.70850670256243,0.04460083134221127,1945.9317989349365,588.2142190933228,2431.698928833008,81102,8754,72348,72348,0,10,9075000.0
9075,9075999,22.104228691059028,38.70990871016925,0.044605864122184924,1946.2394411563873,588.2774810791016,2432.0975456237793,81115,8755,72360,72360,0,10,9076000.0
9076,9076999,22.10537663744709,38.71173323271859,0.04462210165027114,1946.9063255786896,588.3412337303162,2432.336357116699,81145,8758,72387,72387,0,10,9077000.0
9077,9077999,22.107048629354633,38.715162138178634,0.0446451311482734,1947.2195653915405,588.4073755741119,2432.605209350586,81158,8759,72399,72399,0,10,9078000.0
9078,9078999,22.10840517257427,38.71736870336612,0.04465935720680225,1947.5148890018463,588.4691700935364,2432.9240531921387,81171,8760,72411,72411,0,10,9079000.0
9079,9079999,22.110460359157326,38.72278243070914,0.04469274234919829,1947.6280002593994,588.5300595760345,2433.229549407959,81172,8760,72412,72412,0,10,9080000.0
9080,9080999,22.11221271726003,38.72608492908812,0.044735046794058375,1948.1123859882355,588.5909237861633,2433.4107627868652,81196,8762,72434,72434,0,10,9081000.0
9081,9081999,22.114412441852057,38.73070613362934,0.04479078185315377,1948.229587316513,588.6515016555786,2433.780055999756,81196,8762,72434,72434,0,10,9082000.0
9082,9082999,22.117180635322253,38.73984808126863,0.04482816448610538,1948.6936919689178,588.711564540863,2434.0238151550293,81205,8764,72441,72441,0,10,9083000.0
9083,9083999,22.11960011773007,38.74484305975121,0.044882898876846045,1949.0040991306305,588.7750480175018,2434.3265342712402,81213,8765,72448,72448,0,10,9084000.0
9084,9084999,22.121763017008455,38.748864184822565,0.044924493839609725,1949.2937624454498,588.8362588882446,2434.6095695495605,81221,8766,72455,72455,0,10,9085000.0
9085,9085999,22.124245675444907,38.7541104563986,0.04496550769904972,1949.7605805397034,588.8974294662476,2434.770462036133,81236,8768,72468,72468,0,10,9086000.0
9086,9086999,22.12630002932422,38.757757946001455,0.04500575733369916,1950.609287261963,588.9605939388275,2434.8183364868164,81279,8772,72507,72507,0,10,9087000.0
9087,9087999,22.128194790514687,38.761776214814624,0.04503006528568654,1951.0893442630768,589.0238585472107,2434.918872833252,81298,8774,72524,72524,0,10,9088000.0
9088,9088999,22.12829855962689,38.762507571980734,0.045026880977588,1951.2234027385712,589.0843393802643,2435.951950073242,81298,8774,72524,72524,0,10,9089000.0
9089,9089999,22.12787019481942,38.76181894407913,0.04502391634389458,1951.5187590122223,589.146392583847,2436.584930419922,81312,8775,72537,72537,0,10,9090000.0
9090,9090999,22.12764693553713,38.76190620138677,0.045017654398354146,1951.831619977951,589.2176818847656,2437.046661376953,81325,8776,72549,72549,0,10,9091000.0
9091,9091999,22.1273532975022,38.76126983408672,0.04501334735610907,1951.9514620304108,589.279581785202,2437.41463470459,81325,8776,72549,72549,0,10,9092000.0
9092,9092999,22.127072408307342,38.7605942519378,0.0450087433697296,1952.7891194820404,589.3417234420776,2437.5621490478516,81363,8780,72583,72583,0,10,9093000.0
9093,9093999,22.12678557528842,38.76017700740991,0.045009342739316005,1952.9131708145142,589.4057636260986,2438.0300254821777,81363,8780,72583,72583,0,10,9094000.0
9094,9094999,22.126587915813978,38.75963714745382,0.045003728235395,1953.2185697555542,589.4679846763611,2438.545307159424,81365,8781,72584,72584,0,10,9095000.0
9095,9095999,22.126543631545157,38.761206917517484,0.044994715099823446,1953.5130212306976,589.529812335968,2438.8749809265137,81377,8782,72595,72595,0,10,9096000.0
9096,9096999,22.12618901376826,38.76017914528747,0.044992006914680194,1953.9941017627716,589.5915448665619,2439.208335876465,81405,8784,72621,72621,0,10,9097000.0
9097,9097999,22.126144433166118,38.75949590477055,0.04498924918074343,1954.1225264072418,589.6537261009216,2439.7051391601562,81406,8784,72622,72622,0,10,9098000.0
9098,9098999,22.12617012164907,38.759122924400025,0.04498408511788299,1954.2350597381592,589.7139670848846,2440.116912841797,81406,8784,72622,72622,0,10,9099000.0
9099,9099999,22.12635151369952,38.75909677696415,0.04497973521551446,1954.3572764396667,589.7750260829926,2440.4496726989746,81406,8784,72622,72622,0,10,9100000.0
9100,9100999,22.126569423305384,38.758931513015035,0.0449768049047331,1954.6622128486633,589.8364911079407,2440.754020690918,81418,8785,72633,72633,0,10,9101000.0
9101,9101999,22.126910095877278,38.758893919023905,0.044973497549686825,1954.9657411575317,589.8982434272766,2441.105411529541,81430,8786,72644,72644,0,10,9102000.0
9102,9102999,22.127364820472845,38.75890746555317,0.044968442356217664,1955.2744126319885,589.9588265419006,2441.4408950805664,81432,8787,72645,72645,0,10,9103000.0
9103,9103999,22.127651625939613,38.75853956234198,0.04496301761896759,1955.7561757564545,590.0191643238068,2441.7049598693848,81446,8789,72657,72657,0,10,9104000.0
9104,9104999,22.127713702206027,38.75794830220866,0.0449578925312365,1956.3959939479828,590.0803198814392,2441.9006156921387,81482,8792,72690,72690,0,10,9105000.0
9105,9105999,22.12718100262622,38.75714138624583,0.044953806038739774,1956.5302064418793,590.1440079212189,2443.056999206543,81484,8792,72692,72692,0,10,9106000.0
9106,9106999,22.126683661151205,38.75647383444126,0.044949484180921706,1956.6500811576843,590.2053184509277,2443.6953125,81484,8792,72692,72692,0,10,9107000.0
9107,9107999,22.12610320289153,38.755500897205835,0.044948364211195746,1956.7761373519897,590.2664012908936,2444.3285331726074,81486,8792,72694,72694,0,10,9108000.0
9108,9108999,22.12554111039339,38.7550060440953,0.04494601200452786,1957.0749685764313,590.3285238742828,2444.708713531494,81498,8793,72705,72705,0,10,9109000.0
9109,9109999,22.1251637167004,38.7542431398231,0.044941097063551205,1957.194743156433,590.389654636383,2445.1071243286133,81499,8793,72706,72706,0,10,9110000.0
9110,9110999,22.124892129749927,38.75343758606591,0.04493687404632085,1957.3194556236267,590.4517331123352,2445.6027069091797,81499,8793,72706,72706,0,10,9111000.0
9111,9111999,22.124700733697747,38.752597684149855,0.04493232654624768,1957.4432809352875,590.5138602256775,2446.050449371338,81501,8793,72708,72708,0,10,9112000.0
9112,9112999,22.1246899555935,38.75219685880561,0.04492421958043591,1957.5785431861877,590.5786101818085,2446.3976974487305,81502,8793,72709,72709,0,10,9113000.0
9113,9113999,22.124729690040613,38.75182427169546,0.044918922245745896,1957.7061142921448,590.6399791240692,2446.739471435547,81502,8793,72709,72709,0,10,9114000.0
9114,9114999,22.12473178907051,38.75149708696097,0.04491030842430943,1958.003366947174,590.7010865211487,2447.072811126709,81514,8794,72720,72720,0,10,9115000.0
9115,9115999,22.12476172799834,38.75106178257789,0.044904942314867746,1958.1170318126678,590.7619254589081,2447.3441047668457,81514,8794,72720,72720,0,10,9116000.0
9116,9116999,22.125085654374484,38.751222185842764,0.044902882859270576,1958.2401819229126,590.8222632408142,2447.654945373535,81515,8794,72721,72721,0,10,9117000.0
9117,9117999,22.12545396584743,38.751245380343995,0.044896990330572484,1958.54705452919,590.8840463161469,2447.9853706359863,81517,8795,72722,72722,0,10,9118000.0
9118,9118999,22.12593957709717,38.75179610237797,0.044890650972324475,1958.8490543365479,590.945426940918,2448.3119201660156,81519,8796,72723,72723,0,10,9119000.0
9119,9119999,22.12627310707977,38.75178845466175,0.04488749612162457,1958.9749248027802,591.0065095424652,2448.614418029785,81519,8796,72723,72723,0,10,9120000.0
9120,9120999,22.126927243564815,38.75241484416457,0.044881202478674886,1959.2724108695984,591.068235874176,2449.0393295288086,81531,8797,72734,72734,0,10,9121000.0
9121,9121999,22.127584670387705,38.75284909922758,0.04487884418498145,1959.5778317451477,591.1294341087341,2449.3143272399902,81541,8798,72743,72743,0,10,9122000.0
9122,9122999,22.128172232649412,38.75336430374395,0.04487550395668105,1960.0531928539276,591.1922416687012,2449.454879760742,81551,8800,72751,72751,0,10,9123000.0
9123,9123999,22.128519149903465,38.75340337861126,0.04487064592921142,1960.5241219997406,591.2539460659027,2449.6559448242188,81575,8802,72773,72773,0,10,9124000.0
9124,9124999,22.12825252063337,38.752776659439164,0.04487003842331305,1960.8267273902893,591.3159921169281,2450.7301750183105,81581,8803,72778,72778,0,10,9125000.0
9125,9125999,22.127276138120717,38.7513001761182,0.0448737310013827,1960.9626245498657,591.3794648647308,2451.432357788086,81582,8803,72779,72779,0,10,9126000.0
9126,9126999,22.12636369227328,38.74990233785438,0.044876756084921254,1961.2564923763275,591.4418323040009,2451.797374725342,81584,8804,72780,72780,0,10,9127000.0
9127,9127999,22.125624315827903,38.7489621482032,0.044876531289837485,1961.5600469112396,591.5032589435577,2452.3025817871094,81597,8805,72792,72792,0,10,9128000.0
9128,9128999,22.124914383552838,38.747969474461534,0.04487415706624864,1961.855280637741,591.5650188922882,2452.5451698303223,81599,8806,72793,72793,0,10,9129000.0
9129,9129999,22.124181424327656,38.7466048812914,0.04487424902448223,1961.9738845825195,591.6267776489258,2452.9699668884277,81599,8806,72793,72793,0,10,9130000.0
9130,9130999,22.123484521698426,38.74535951239985,0.04487325221257976,1962.2689340114594,591.6894476413727,2453.3224449157715,81601,8807,72794,72794,0,10,9131000.0
9131,9131999,22.122727842296868,38.74405386503342,0.04487224315383631,1962.9340379238129,591.7511978149414,2453.562023162842,81637,8810,72827,72827,0,10,9132000.0
9132,9132999,22.122115198219014,38.74297913085224,0.04487000318786638,1963.0554373264313,591.8115131855011,2453.8480644226074,81637,8810,72827,72827,0,10,9133000.0
9133,9133999,22.121626234462425,38.742074969743825,0.04486788304565248,1963.1737215518951,591.8730487823486,2454.1880378723145,81637,8810,72827,72827,0,10,9134000.0
9134,9134999,22.121158135010848,38.74101648409683,0.04486472993514823,1963.2979397773743,591.933839559555,2454.4957389831543,81637,8810,72827,72827,0,10,9135000.0
9135,9135999,22.120566250011173,38.739652900682295,0.044863055268683616,1963.4173164367676,591.9950890541077,2454.7494316101074,81637,8810,72827,72827,0,10,9136000.0
9136,9136999,22.120044515403112,38.73874022212724,0.04486067265415383,1963.7270300388336,592.0558433532715,2455.0459785461426,81668,8811,72857,72857,0,10,9137000.0
9137,9137999,22.11978219463222,38.738100778739096,0.04485807736634595,1963.8392415046692,592.1160283088684,2455.3081245422363,81668,8811,72857,72857,0,10,9138000.0
9138,9138999,22.11949047043381,38.737245746333954,0.044855337033252174,1964.339610338211,592.1805355548859,2455.542449951172,81692,8813,72879,72879,0,10,9139000.0
9139,9139999,22.119093969943876,38.7362814270892,0.04485482957576237,1964.634194612503,592.2417719364166,2455.8610229492188,81704,8814,72890,72890,0,10,9140000.0
9140,9140999,22.118835754607982,38.73537686616406,0.04485071515458605,1965.3011071681976,592.3040435314178,2456.1345863342285,81740,8817,72923,72923,0,10,9141000.0
9141,9141999,22.11849619745886,38.73433200454276,0.04484713791563011,1965.414053440094,592.363870382309,2456.4116134643555,81740,8817,72923,72923,0,10,9142000.0
9142,9142999,22.118030287067864,38.73313659957486,0.04484573304579198,1965.5296568870544,592.426233291626,2456.772476196289,81740,8817,72923,72923,0,10,9143000.0
9143,9143999,22.117537632645938,38.732231499716846,0.0448431702877512,1966.011375427246,592.4865746498108,2457.064609527588,81754,8819,72935,72935,0,10,9144000.0
9144,9144999,22.116996604751233,38.730997632849075,0.044843664575045517,1966.1351425647736,592.5471050739288,2457.6119499206543,81755,8819,72936,72936,0,10,9145000.0
9145,9145999,22.11587948490859,38.72969229628922,0.044848628233449706,1966.8070797920227,592.6101536750793,2458.5572204589844,81780,8822,72958,72958,0,10,9146000.0
9146,9146999,22.1148367938088,38.72831189623019,0.04485108461307896,1967.1077494621277,592.6733567714691,2459.151222229004,81793,8823,72970,72970,0,10,9147000.0
9147,9147999,22.113904838207816,38.72724078329904,0.0448496611898086,1967.2291717529297,592.736414194107,2459.574691772461,81793,8823,72970,72970,0,10,9148000.0
9148,9148999,22.11306187431466,38.726324639506295,0.044850605717252634,1967.3431656360626,592.7989287376404,2459.9135360717773,81793,8823,72970,72970,0,10,9149000.0
9149,9149999,22.112187846608652,38.72488986345129,0.04485239933861063,1967.460469007492,592.8614010810852,2460.2755088806152,81793,8823,72970,72970,0,10,9150000.0
9150,9150999,22.111394114871487,38.72350619007124,0.04485344181223916,1967.7557423114777,592.9225635528564,2460.6431159973145,81798,8824,72974,72974,0,10,9151000.0
9151,9151999,22.110638966290374,38.72247201107459,0.04485283659804773,1968.224402666092,592.9837203025818,2460.9526290893555,81822,8826,72996,72996,0,10,9152000.0
9152,9152999,22.109890966544377,38.721349175225896,0.04485245645441227,1968.3409869670868,593.043853521347,2461.3266830444336,81823,8826,72997,72997,0,10,9153000.0
9153,9153999,22.109209360986867,38.72010671174861,0.04485286165090474,1968.6540701389313,593.1068558692932,2461.6247329711914,81828,8827,73001,73001,0,10,9154000.0
9154,9154999,22.10850465517819,38.71872076655013,0.044854342470582065,1968.7678534984589,593.1670095920563,2461.9781761169434,81828,8827,73001,73001,0,10,9155000.0
9155,9155999,22.1077921062455,38.717399320145354,0.04485339635242158,1968.8853979110718,593.2296657562256,2462.2521171569824,81828,8827,73001,73001,0,10,9156000.0
9156,9156999,22.107199692233173,38.71623628076415,0.04485337412586654,1969.1875138282776,593.2912895679474,2462.533836364746,81840,8828,73012,73012,0,10,9157000.0
9157,9157999,22.10686751428396,38.715658193640955,0.04485101294002447,1969.3079314231873,593.3530070781708,2462.8986587524414,81840,8828,73012,73012,0,10,9158000.0
9158,9158999,22.106617099591286,38.71500707665548,0.04484642341749756,1969.9503560066223,593.4147017002106,2463.0215606689453,81876,8831,73045,73045,0,10,9159000.0
9159,9159999,22.106468338603207,38.71461043748001,0.044843778258511935,1970.4380474090576,593.4757280349731,2463.2697143554688,81900,8833,73067,73067,0,10,9160000.0
9160,9160999,22.10659808684328,38.714977272138015,0.04483490506768295,1971.0886952877045,593.5381441116333,2463.5553817749023,81936,8836,73100,73100,0,10,9161000.0
9161,9161999,22.106876777657565,38.71595588084867,0.04483319066698732,1971.5694971084595,593.5999639034271,2463.783737182617,81960,8838,73122,73122,0,10,9162000.0
9162,9162999,22.10722516089617,38.71708395462234,0.04483185478934926,1971.6799392700195,593.6620802879333,2464.062602996826,81960,8838,73122,73122,0,10,9163000.0
9163,9163999,22.107422802852437,38.71737100837044,0.04482813738340452,1972.5349969863892,593.7254886627197,2464.205898284912,81998,8842,73156,73156,0,10,9164000.0
9164,9164999,22.10653051986961,38.715907865443874,0.04483346560104651,1972.8461973667145,593.7866597175598,2465.2919578552246,82000,8843,73157,73157,0,10,9165000.0
9165,9165999,22.105726047438644,38.71572771492294,0.04483290334435841,1972.9686875343323,593.8492169380188,2465.8396644592285,82000,8843,73157,73157,0,10,9166000.0
9166,9166999,22.104948766346027,38.71482767395129,0.044833006512210116,1973.097157716751,593.9110605716705,2466.221782684326,82002,8843,73159,73159,0,10,9167000.0
9167,9167999,22.10411144246545,38.7136558061055,0.044832610249059934,1973.2210261821747,593.9728479385376,2466.6585655212402,82002,8843,73159,73159,0,10,9168000.0
9168,9168999,22.10339627430377,38.7127616372567,0.04483083878720062,1973.5273756980896,594.0359063148499,2466.9647369384766,82014,8844,73170,73170,0,10,9169000.0
9169,9169999,22.102658757396913,38.711607788221286,0.04483153971667986,1973.6488173007965,594.1001405715942,2467.3226470947266,82014,8844,73170,73170,0,10,9170000.0
9170,9170999,22.10188602750619,38.71024711325958,0.044833707772608755,1973.950633764267,594.1630444526672,2467.6633796691895,82017,8845,73172,73172,0,10,9171000.0
9171,9171999,22.101147147291446,38.70891247712351,0.04483520229450544,1974.2445123195648,594.2248480319977,2467.9559059143066,82025,8846,73179,73179,0,10,9172000.0
9172,9172999,22.100585537732595,38.7080390848159,0.04483343045334953,1974.3635132312775,594.2868349552155,2468.300392150879,82025,8846,73179,73179,0,10,9173000.0
9173,9173999,22.09998775553751,38.70681381747377,0.04483303754234358,1974.4827539920807,594.3481431007385,2468.6736373901367,82025,8846,73179,73179,0,10,9174000.0
9174,9174999,22.099515235745827,38.706128750913436,0.04483110996553541,1974.6079754829407,594.4101467132568,2468.9565773010254,82025,8846,73179,73179,0,10,9175000.0
9175,9175999,22.099030948662236,38.7050219688345,0.04483091697645336,1975.0842275619507,594.4712016582489,2469.14542388916,82049,8848,73201,73201,0,10,9176000.0
9176,9176999,22.098820397774993,38.70448010933456,0.04482721269502932,1975.4025738239288,594.5323078632355,2469.4282417297363,82061,8849,73212,73212,0,10,9177000.0
9177,9177999,22.09850971934431,38.7036328972818,0.0448260714849299,1975.8715600967407,594.5932357311249,2469.591022491455,82089,8851,73238,73238,0,10,9178000.0
9178,9178999,22.09845234084268,38.70360235947565,0.04482575795172472,1975.9858930110931,594.653272151947,2470.020263671875,82089,8851,73238,73238,0,10,9179000.0
9179,9179999,22.098417862036456,38.7033045220582,0.04482409861270631,1976.10547041893,594.7136244773865,2470.507541656494,82089,8851,73238,73238,0,10,9180000.0
9180,9180999,22.098744161554638,38.704936855116244,0.04481735279245769,1976.5869703292847,594.7774815559387,2470.7271995544434,82104,8853,73251,73251,0,10,9181000.0
9181,9181999,22.098702006223046,38.70465434103808,0.044815979639685755,1976.7129747867584,594.8401350975037,2471.0042152404785,82104,8853,73251,73251,0,10,9182000.0
9182,9182999,22.098655157435505,38.70453415027431,0.04481260252366959,1977.5404529571533,594.9012722969055,2471.1751708984375,82139,8857,73282,73282,0,10,9183000.0
9183,9183999,22.098168447742186,38.703737489053374,0.044815303709040855,1977.844877243042,594.9640216827393,2472.263328552246,82144,8858,73286,73286,0,10,9184000.0
9184,9184999,22.097658950136054,38.703334783222324,0.04481210411459835,1977.967541694641,595.0268261432648,2473.103012084961,82147,8858,73289,73289,0,10,9185000.0
9185,9185999,22.09741925690455,38.703901981498845,0.04480720682311068,1978.6229898929596,595.0896892547607,2473.548240661621,82175,8861,73314,73314,0,10,9186000.0
9186,9186999,22.097221380602623,38.70400449474035,0.04480151530832688,1978.9278528690338,595.1523942947388,2474.090679168701,82182,8862,73320,73320,0,10,9187000.0
9187,9187999,22.096825017975632,38.70325173361576,0.044799308629292045,1979.0449821949005,595.2148153781891,2474.5420989990234,82182,8862,73320,73320,0,10,9188000.0
9188,9188999,22.096599074481606,38.7027477280115,0.044793531261750674,1979.5190703868866,595.2782702445984,2474.8949699401855,82196,8864,73332,73332,0,10,9189000.0
9189,9189999,22.09672891257463,38.70290740777871,0.044785847152198466,1979.812196969986,595.3389217853546,2475.2034301757812,82208,8865,73343,73343,0,10,9190000.0
9190,9190999,22.09670107193446,38.70288346930432,0.044781928908069646,1980.1041061878204,595.4006733894348,2475.657516479492,82215,8866,73349,73349,0,10,9191000.0
9191,9191999,22.097131197786425,38.70416356205167,0.04477858397944945,1980.231945514679,595.4658436775208,2476.106014251709,82216,8866,73350,73350,0,10,9192000.0
9192,9192999,22.09744956095928,38.70516689901275,0.0447741524397931,1980.7085855007172,595.5287737846375,2476.3923683166504,82225,8868,73357,73357,0,10,9193000.0
9193,9193999,22.098241904428743,38.70694753578632,0.044773638873574884,1981.1791298389435,595.5911757946014,2476.795726776123,82250,8870,73380,73380,0,10,9194000.0
9194,9194999,22.099518352838103,38.71807647814411,0.044753684109158365,1981.655858039856,595.6537754535675,2477.142936706543,82269,8872,73397,73397,0,10,9195000.0
9195,9195999,22.100118919324732,38.719349122261356,0.044752925407232746,1981.7729058265686,595.7156147956848,2477.436767578125,82269,8872,73397,73397,0,10,9196000.0
9196,9196999,22.101273726898413,38.72188961308813,0.04476370676409169,1982.4293706417084,595.777174949646,2477.8709869384766,82295,8875,73420,73420,0,10,9197000.0
9197,9197999,22.10229383226152,38.725020456413844,0.04477892639323866,1982.5448331832886,595.8411338329315,2478.391010284424,82295,8875,73420,73420,0,10,9198000.0
9198,9198999,22.103322757995276,38.72695864958036,0.044791872441526825,1982.8419816493988,595.903404712677,2478.9473876953125,82299,8876,73423,73423,0,10,9199000.0
9199,9199999,22.105277861303957,38.732981081146114,0.04481331034244607,1983.4974637031555,595.9648506641388,2479.2100257873535,82327,8879,73448,73448,0,10,9200000.0
9200,9200999,22.1066562119835,38.736017195498185,0.044833419940858876,1983.6083118915558,596.0252468585968,2479.66215133667,82327,8879,73448,73448,0,10,9201000.0
9201,9201999,22.107925415332748,38.7383610262414,0.04484958802067085,1983.7392559051514,596.096373796463,2480.087303161621,82327,8879,73448,73448,0,10,9202000.0
9202,9202999,22.107998411652098,38.73808879740445,0.044857044205747765,1984.0474185943604,596.158947467804,2480.9532051086426,82333,8880,73453,73453,0,10,9203000.0
9203,9203999,22.107670967705964,38.73836082465004,0.04484803196913156,1984.1858236789703,596.2329573631287,2481.772258758545,82334,8880,73454,73454,0,10,9204000.0
9204,9204999,22.10729175445564,38.73785275643068,0.04484225069889336,1984.3135373592377,596.2954065799713,2482.3278617858887,82335,8880,73455,73455,0,10,9205000.0
9205,9205999,22.106902236518582,38.73724701960032,0.044841007526868926,1984.6118333339691,596.3577537536621,2482.723663330078,82347,8881,73466,73466,0,10,9206000.0
9206,9206999,22.106703536898397,38.73678255109111,0.04483354106971671,1984.9164159297943,596.4204258918762,2482.9516525268555,82359,8882,73477,73477,0,10,9207000.0
9207,9207999,22.106519673180767,38.73634452043505,0.04482813721222634,1985.4007964134216,596.4830853939056,2483.17476272583,82366,8884,73482,73482,0,10,9208000.0
9208,9208999,22.106382144416134,38.73578077845682,0.04481660291786893,1985.5303916931152,596.5465741157532,2483.5718688964844,82366,8884,73482,73482,0,10,9209000.0
9209,9209999,22.10625814791693,38.735385463182425,0.04480533736966741,1986.2007014751434,596.6098489761353,2483.861328125,82392,8887,73505,73505,0,10,9210000.0
9210,9210999,22.106167917565593,38.73523729535184,0.044802032542137105,1986.497169494629,596.6718413829803,2484.1248321533203,82403,8888,73515,73515,0,10,9211000.0
9211,9211999,22.10663845036335,38.73609766377448,0.04479460329369389,1986.6191265583038,596.7334797382355,2484.5125427246094,82403,8888,73515,73515,0,10,9212000.0
9212,9212999,22.107097900944684,38.73756211250283,0.044791022264403124,1986.7424323558807,596.7958643436432,2484.8483810424805,82403,8888,73515,73515,0,10,9213000.0
9213,9213999,22.107444565744142,38.73774322720186,0.044791291312516246,1986.8652486801147,596.8567132949829,2485.0736351013184,82403,8888,73515,73515,0,10,9214000.0
9214,9214999,22.107897260330276,38.73817004414708,0.044789477922881016,1986.9960486888885,596.9183230400085,2485.442657470703,82403,8888,73515,73515,0,10,9215000.0
9215,9215999,22.108256315685523,38.73824684031486,0.04480146724123435,1987.4810235500336,596.9799542427063,2485.690139770508,82424,8890,73534,73534,0,10,9216000.0
9216,9216999,22.108956351903593,38.73926790629727,0.04481472976507206,1987.9555897712708,597.0415165424347,2485.8231506347656,82442,8892,73550,73550,0,10,9217000.0
9217,9217999,22.109893983431107,38.74070311403471,0.0448239814028103,1988.2481327056885,597.1017889976501,2485.963180541992,82448,8893,73555,73555,0,10,9218000.0
9218,9218999,22.111278835017806,38.74434201311444,0.04483670752514868,1988.5526189804077,597.1631121635437,2486.332347869873,82455,8894,73561,73561,0,10,9219000.0
9219,9219999,22.112588292286883,38.746729918942535,0.04485619285518527,1988.6697034835815,597.2255473136902,2486.6822814941406,82455,8894,73561,73561,0,10,9220000.0
9220,9220999,22.11424363703097,38.75129791517146,0.04487831734383618,1988.7981262207031,597.2862737178802,2486.9590339660645,82455,8894,73561,73561,0,10,9221000.0
9221,9221999,22.115648052786433,38.75306260006836,0.04489779109862069,1989.103640794754,597.3479177951813,2487.1904640197754,82467,8895,73572,73572,0,10,9222000.0
9222,9222999,22.116041433000458,38.7541630311011,0.04488840705764874,1989.2323026657104,597.4104678630829,2488.284320831299,82468,8895,73573,73573,0,10,9223000.0
9223,9223999,22.115725065727666,38.75315480039699,0.04487378472932546,1990.0925233364105,597.4730916023254,2488.798141479492,82494,8899,73595,73595,0,10,9224000.0
9224,9224999,22.11536546690716,38.75213952154986,0.044865330600249886,1990.2094757556915,597.5348331928253,2489.398036956787,82496,8899,73597,73597,0,10,9225000.0
9225,9225999,22.11509498923685,38.751620752779054,0.044857129259235684,1990.5072252750397,597.5961837768555,2489.7062454223633,82508,8900,73608,73608,0,10,9226000.0
9226,9226999,22.11482269857297,38.75083974633567,0.044846956673459504,1990.6281337738037,597.65766954422,2490.0953674316406,82509,8900,73609,73609,0,10,9227000.0
9227,9227999,22.11451331755565,38.74977254935213,0.044840382500810794,1990.9281332492828,597.7190937995911,2490.5516052246094,82522,8901,73621,73621,0,10,9228000.0
9228,9228999,22.114189414798844,38.74879619426084,0.04482888377515448,1991.0449001789093,597.7804436683655,2491.061191558838,82522,8901,73621,73621,0,10,9229000.0
9229,9229999,22.113860400485486,38.747961650826,0.04482468456217259,1991.345573425293,597.8424742221832,2491.3648262023926,82530,8902,73628,73628,0,10,9230000.0
9230,9230999,22.11381563734866,38.74732257795111,0.044819725726575554,1991.6659088134766,597.9040100574493,2491.692039489746,82543,8903,73640,73640,0,10,9231000.0
9231,9231999,22.11387783245493,38.748008969175736,0.04480967024627258,1991.7847974300385,597.965069770813,2492.1233406066895,82543,8903,73640,73640,0,10,9232000.0
9232,9232999,22.1139948019017,38.747801645318276,0.04480916030926885,1992.0850405693054,598.0273158550262,2492.4931869506836,82550,8904,73646,73646,0,10,9233000.0
9233,9233999,22.114268549093214,38.74782822165693,0.0448007736484064,1992.2001111507416,598.0876786708832,2492.8361320495605,82550,8904,73646,73646,0,10,9234000.0
9234,9234999,22.11458642937014,38.747585605369665,0.04479152751604043,1992.495712518692,598.1492691040039,2493.15034866333,82557,8905,73652,73652,0,10,9235000.0
9235,9235999,22.11481749433025,38.747188328870436,0.044785767413684785,1992.8134195804596,598.2096424102783,2493.408088684082,82565,8906,73659,73659,0,10,9236000.0
9236,9236999,22.115003213175186,38.746492441534656,0.04477694778503216,1992.9338128566742,598.2705645561218,2493.7575721740723,82565,8906,73659,73659,0,10,9237000.0
9237,9237999,22.115108165933467,38.74585029759498,0.044767222771386894,1993.2390732765198,598.331964969635,2494.015857696533,82568,8907,73661,73661,0,10,9238000.0
9238,9238999,22.115127243427388,38.74505717218059,0.044757023789710915,1993.538631439209,598.3934438228607,2494.2997512817383,82580,8908,73672,73672,0,10,9239000.0
9239,9239999,22.114607731397292,38.744846638522496,0.04475040375435324,1993.6684503555298,598.457391500473,2495.395725250244,82582,8908,73674,73674,0,10,9240000.0
9240,9240999,22.113966828244962,38.74384575941542,0.0447475817278189,1993.9742147922516,598.5197477340698,2495.8927116394043,82585,8909,73676,73676,0,10,9241000.0
9241,9241999,22.113577919466508,38.744077358118936,0.04474269886267246,1994.1008653640747,598.5819413661957,2496.298984527588,82585,8909,73676,73676,0,10,9242000.0
9242,9242999,22.112931931214927,38.74306490602654,0.04474170092137886,1994.2164635658264,598.6446945667267,2496.5928535461426,82585,8909,73676,73676,0,10,9243000.0
9243,9243999,22.112257066660362,38.7417516175683,0.044740271644574614,1994.339230298996,598.7067003250122,2496.8102493286133,82585,8909,73676,73676,0,10,9244000.0
9244,9244999,22.111474270057528,38.74031890427616,0.044738223907757946,1994.8277370929718,598.7703700065613,2496.980339050293,82599,8911,73688,73688,0,10,9245000.0
9245,9245999,22.110880264079867,38.73918370681509,0.04473227615925457,1995.3109817504883,598.8329174518585,2497.26176071167,82608,8913,73695,73695,0,10,9246000.0
9246,9246999,22.11047709408956,38.73836610184116,0.04472584555415382,1995.4254808425903,598.8948142528534,2497.5740356445312,82608,8913,73695,73695,0,10,9247000.0
9247,9247999,22.11003837749866,38.73745872635245,0.04472389641832353,1995.5483181476593,598.9558610916138,2497.9024085998535,82608,8913,73695,73695,0,10,9248000.0
9248,9248999,22.10966119547702,38.736579822325055,0.04471698861039486,1995.6778881549835,599.0165212154388,2498.231346130371,82608,8913,73695,73695,0,10,9249000.0
9249,9249999,22.109395554596787,38.73575240805853,0.04471167362684303,1995.792359828949,599.0786061286926,2498.4734687805176,82609,8913,73696,73696,0,10,9250000.0
9250,9250999,22.10907710003563,38.73478707483066,0.04470832336257957,1996.2727615833282,599.1408252716064,2498.573230743408,82623,8915,73708,73708,0,10,9251000.0
9251,9251999,22.10885386020638,38.73413853177616,0.04470481683468508,1996.3915910720825,599.2009007930756,2498.758499145508,82623,8915,73708,73708,0,10,9252000.0
9252,9252999,22.10878356228192,38.73432450800402,0.044699087663854886,1997.059799194336,599.262158870697,2498.8037719726562,82658,8918,73740,73740,0,10,9253000.0
9253,9253999,22.108832176937558,38.73367739633248,0.04468651210272878,1997.7368385791779,599.323962688446,2498.9662284851074,82685,8921,73764,73764,0,10,9254000.0
9254,9254999,22.10905324923837,38.73318394174919,0.04466415714302241,1998.2103929519653,599.3861074447632,2499.313732147217,82704,8923,73781,73781,0,10,9255000.0
9255,9255999,22.109192754905425,38.73321463850543,0.044653967433801234,1998.8948440551758,599.4532527923584,2499.4902954101562,82730,8926,73804,73804,0,10,9256000.0
9256,9256999,22.109093425967625,38.73289589332327,0.04464511006281646,1999.0163178443909,599.5149919986725,2499.702091217041,82730,8926,73804,73804,0,10,9257000.0
9257,9257999,22.108983118522048,38.73209601144857,0.04463729325435528,1999.3200674057007,599.5765554904938,2499.9815826416016,82742,8927,73815,73815,0,10,9258000.0
9258,9258999,22.108406785341465,38.731193715146325,0.04463785250974861,1999.9863195419312,599.6377913951874,2500.6999015808105,82769,8930,73839,73839,0,10,9259000.0
9259,9259999,22.10746837596434,38.729659236487194,0.04464247467202076,2000.2933197021484,599.6997113227844,2501.1701583862305,82772,8931,73841,73841,0,10,9260000.0
9260,9260999,22.106503892154368,38.728036739969625,0.04464690763414414,2000.7804989814758,599.7621800899506,2501.4271697998047,82790,8933,73857,73857,0,10,9261000.0
9261,9261999,22.105730641598026,38.72665654133123,0.044651375626291956,2001.081824541092,599.8238205909729,2501.731456756592,82802,8934,73868,73868,0,10,9262000.0
9262,9262999,22.10509625524577,38.72552256139824,0.04465260612183597,2001.3814945220947,599.8862025737762,2501.924964904785,82805,8935,73870,73870,0,10,9263000.0
9263,9263999,22.104442602891343,38.72420703458031,0.04465631554658722,2001.6842079162598,599.9474637508392,2502.1673698425293,82820,8936,73884,73884,0,10,9264000.0
9264,9264999,22.103866019304363,38.722984463455944,0.04465758355184535,2002.3612520694733,600.0105345249176,2502.489044189453,82847,8939,73908,73908,0,10,9265000.0
9265,9265999,22.10310759303209,38.72147041382766,0.04465921204511725,2002.6689174175262,600.0730736255646,2502.8271865844727,82853,8940,73913,73913,0,10,9266000.0
9266,9266999,22.102531619376816,38.72119519285184,0.04465849182365389,2002.9738869667053,600.1340968608856,2503.0928115844727,82866,8941,73925,73925,0,10,9267000.0
9267,9267999,22.1020395648928,38.72036889093013,0.04465870864068022,2003.2814364433289,600.1962110996246,2503.396438598633,82878,8942,73936,73936,0,10,9268000.0
9268,9268999,22.10151784937767,38.71947250501176,0.044657219403243964,2003.4064745903015,600.2565908432007,2503.6324577331543,82878,8942,73936,73936,0,10,9269000.0
9269,9269999,22.100937931414663,38.71814887743514,0.04465679584940718,2003.5295941829681,600.3169922828674,2503.9614219665527,82878,8942,73936,73936,0,10,9270000.0
9270,9270999,22.100558119744353,38.71740806949445,0.04465501685793494,2003.857228755951,600.3872499465942,2504.2351608276367,82882,8943,73939,73939,0,10,9271000.0
9271,9271999,22.099987333107148,38.71631867610169,0.044655542428426176,2004.3431169986725,600.4497444629669,2504.3246536254883,82909,8945,73964,73964,0,10,9272000.0
9272,9272999,22.09962023853607,38.71523076681763,0.04465363718087956,2004.6784369945526,600.511682510376,2504.603370666504,82911,8946,73965,73965,0,10,9273000.0
9273,9273999,22.09923083909939,38.71405641184134,0.044651524948543964,2004.7961218357086,600.5746412277222,2504.99715423584,82911,8946,73965,73965,0,10,9274000.0
9274,9274999,22.099022720464827,38.71310016848934,0.04464809931654368,2005.111046075821,600.6358733177185,2505.284622192383,82923,8947,73976,73976,0,10,9275000.0
9275,9275999,22.098917200406326,38.71313631286561,0.044641279937525424,2005.4049286842346,600.6986246109009,2505.523693084717,82925,8948,73977,73977,0,10,9276000.0
9276,9276999,22.098590321668155,38.71202915167789,0.04463816946155086,2005.5482859611511,600.7711191177368,2505.897659301758,82925,8948,73977,73977,0,10,9277000.0
9277,9277999,22.098048121852052,38.710808443918076,0.04463891686212007,2005.666570186615,600.8329503536224,2506.2220039367676,82925,8948,73977,73977,0,10,9278000.0
9278,9278999,22.09747601212063,38.71014951366514,0.04463577411114106,2006.167507648468,600.8942174911499,2506.39501953125,82933,8950,73983,73983,0,10,9279000.0
9279,9279999,22.09700585950113,38.70899438499967,0.04462542928370561,2006.2978031635284,600.9577717781067,2507.6638221740723,82936,8950,73986,73986,0,10,9280000.0
9280,9280999,22.0964287491008,38.7081214174998,0.044613065469166435,2006.6076664924622,601.0203161239624,2508.076915740967,82948,8951,73997,73997,0,10,9281000.0
9281,9281999,22.095903145331857,38.706881296136196,0.04460066105485683,2006.9103627204895,601.0833969116211,2508.352771759033,82955,8952,74003,74003,0,10,9282000.0
9282,9282999,22.095565705868804,38.70591473742049,0.04457940625731205,2007.4030187129974,601.1490604877472,2508.4991302490234,82969,8954,74015,74015,0,10,9283000.0
9283,9283999,22.095147375686835,38.704750445057954,0.0445670502819272,2007.7085237503052,601.2110359668732,2508.781806945801,82981,8955,74026,74026,0,10,9284000.0
9284,9284999,22.09458453630022,38.70352923043642,0.044563255685262204,2007.8299036026,601.2737596035004,2509.145740509033,82981,8955,74026,74026,0,10,9285000.0
9285,9285999,22.094141080282057,38.70227551493085,0.044556869676038335,2007.9462888240814,601.3362064361572,2509.4277153015137,82981,8955,74026,74026,0,10,9286000.0
9286,9286999,22.09381503815717,38.70128575384841,0.044547442804344195,2008.066106557846,601.3979976177216,2509.867874145508,82982,8955,74027,74027,0,10,9287000.0
9287,9287999,22.093558537880615,38.70025985075917,0.044537908238126867,2008.1877603530884,601.4604341983795,2510.1879234313965,82982,8955,74027,74027,0,10,9288000.0
9288,9288999,22.093424356762586,38.70075068890049,0.044525756782362924,2008.488477230072,601.5223808288574,2510.399101257324,82985,8956,74029,74029,0,10,9289000.0
9289,9289999,22.093219636093032,38.69992428272856,0.044518527971271094,2008.9789426326752,601.584862947464,2510.6241874694824,83009,8958,74051,74051,0,10,9290000.0
9290,9290999,22.092979838328194,38.69887623756208,0.04450701135391966,2009.2893207073212,601.6468162536621,2510.867877960205,83016,8959,74057,74057,0,10,9291000.0
9291,9291999,22.092805262755792,38.697894942876985,0.044495068316034,2009.4082520008087,601.7078256607056,2511.0971908569336,83016,8959,74057,74057,0,10,9292000.0
9292,9292999,22.092757125444923,38.69691364497613,0.04448297929771894,2009.5265197753906,601.7691080570221,2511.384777069092,83016,8959,74057,74057,0,10,9293000.0
9293,9293999,22.092793086594206,38.69607495505533,0.0444663738167268,2009.8344769477844,601.8311631679535,2511.7095260620117,83021,8960,74061,74061,0,10,9294000.0
9294,9294999,22.09272836392829,38.69506111933559,0.044453350290838634,2010.1397306919098,601.8947393894196,2511.938102722168,83033,8961,74072,74072,0,10,9295000.0
9295,9295999,22.09282616216304,38.69423346935842,0.044439284648613686,2010.4428045749664,601.9570069313049,2512.1505088806152,83045,8962,74083,74083,0,10,9296000.0
9296,9296999,22.09267387670013,38.693127085755485,0.04442507154149489,2010.7391476631165,602.0219540596008,2512.365562438965,83047,8963,74084,74084,0,10,9297000.0
9297,9297999,22.092468752534245,38.691938825927785,0.04441141498625634,2011.2225654125214,602.0831210613251,2512.5676765441895,83072,8965,74107,74107,0,10,9298000.0
9298,9298999,22.092210903351138,38.690732066261305,0.044399619994030526,2011.339819908142,602.1458070278168,2512.901912689209,83073,8965,74108,74108,0,10,9299000.0
9299,9299999,22.091630600278002,38.689381970257536,0.0443968626026795,2011.6456186771393,602.2074453830719,2513.6899642944336,83076,8966,74110,74110,0,10,9300000.0
9300,9300999,22.090983645104668,38.68814699865932,0.044393437625164345,2011.9608833789825,602.2699627876282,2514.1312217712402,83079,8967,74112,74112,0,10,9301000.0
9301,9301999,22.090370465603623,38.68711515137311,0.044389228574880146,2012.0817203521729,602.33118891716,2514.427478790283,83080,8967,74113,74113,0,10,9302000.0
9302,9302999,22.089905754993794,38.6860358939119,0.04438328641347811,2012.3841979503632,602.3924834728241,2514.6014976501465,83092,8968,74124,74124,0,10,9303000.0
9303,9303999,22.08944536709083,38.68488948856476,0.0443766336197402,2012.8709390163422,602.4537045955658,2514.8512420654297,83096,8970,74126,74126,0,10,9304000.0
9304,9304999,22.088950807948844,38.68404718313487,0.04437224214112312,2013.3573563098907,602.5163476467133,2515.0894775390625,83120,8972,74148,74148,0,10,9305000.0
9305,9305999,22.08837427577269,38.68265885936925,0.04436851482400628,2013.4878342151642,602.5779926776886,2515.318103790283,83120,8972,74148,74148,0,10,9306000.0
9306,9306999,22.087778572646684,38.681241551055194,0.044364198414156064,2013.7811443805695,602.6389482021332,2515.6529426574707,83133,8973,74160,74160,0,10,9307000.0
9307,9307999,22.087583918162494,38.6834479652431,0.044349702677111025,2014.0831053256989,602.7016010284424,2515.916244506836,83140,8974,74166,74166,0,10,9308000.0
9308,9308999,22.087264029123478,38.68234063361587,0.04434345717511545,2014.5686676502228,602.7634069919586,2515.985523223877,83154,8976,74178,74178,0,10,9309000.0
9309,9309999,22.08688413426294,38.68119625976625,0.04433548801292042,2014.8810086250305,602.8245182037354,2516.2681732177734,83159,8977,74182,74182,0,10,9310000.0
9310,9310999,22.08662060344233,38.68016241450068,0.04432738508832923,2015.5386600494385,602.8875036239624,2516.3482704162598,83180,8980,74200,74200,0,10,9311000.0
9311,9311999,22.086444957563625,38.679293830594375,0.04431622867963281,2015.662452697754,602.9491875171661,2516.6533851623535,83180,8980,74200,74200,0,10,9312000.0
9312,9312999,22.08645033432862,38.67854562130888,0.04430839185137925,2016.3293063640594,603.0103826522827,2516.8212547302246,83207,8983,74224,74224,0,10,9313000.0
9313,9313999,22.08650717522574,38.67776536320342,0.04430020614622776,2016.4504487514496,603.0708477497101,2517.1318016052246,83207,8983,74224,74224,0,10,9314000.0
9314,9314999,22.086837760152704,38.67747204464274,0.04429093843062548,2016.7506935596466,603.1330506801605,2517.3056678771973,83219,8984,74235,74235,0,10,9315000.0
9315,9315999,22.08721305571221,38.67714146787051,0.04428126303129365,2016.8621580600739,603.193231344223,2517.707996368408,83219,8984,74235,74235,0,10,9316000.0
9316,9316999,22.08748668023567,38.67656145956423,0.044274085795781626,2017.1654171943665,603.2548613548279,2517.9714546203613,83231,8985,74246,74246,0,10,9317000.0
9317,9317999,22.087696787435295,38.67591739860242,0.044266420486593905,2017.2829420566559,603.3152585029602,2518.2579383850098,83232,8985,74247,74247,0,10,9318000.0
9318,9318999,22.087477754332586,38.67477103616389,0.044260304003721385,2017.404713153839,603.3771679401398,2518.5041160583496,83232,8985,74247,74247,0,10,9319000.0
9319,9319999,22.086878699007634,38.673380357976036,0.04425945888692462,2017.713033914566,603.438583612442,2519.584056854248,83234,8986,74248,74248,0,10,9320000.0
9320,9320999,22.08603855238098,38.67189813828148,0.04426028187176967,2017.8269720077515,603.500191450119,2520.10599899292,83235,8986,74249,74249,0,10,9321000.0
9321,9321999,22.085547105015547,38.6709452394964,0.044255756418309145,2018.1326746940613,603.5620591640472,2520.41658782959,83241,8987,74254,74254,0,10,9322000.0
9322,9322999,22.085030840912268,38.669928506894095,0.04425173204421107,2018.4456162452698,603.623517036438,2520.679515838623,83253,8988,74265,74265,0,10,9323000.0
9323,9323999,22.08443269051813,38.668532487970054,0.044249584178348456,2018.5655355453491,603.6861274242401,2520.9742851257324,83253,8988,74265,74265,0,10,9324000.0
9324,9324999,22.083839954794133,38.667337281920304,0.04425007963556227,2018.6852715015411,603.7477445602417,2521.2331199645996,83253,8988,74265,74265,0,10,9325000.0
9325,9325999,22.083187163431944,38.66591188195216,0.04425032433536513,2018.8022010326385,603.8094189167023,2521.4734802246094,83253,8988,74265,74265,0,10,9326000.0
9326,9326999,22.0825669517035,38.664567310962184,0.04424793154346596,2019.1022458076477,603.8713252544403,2521.7245025634766,83258,8989,74269,74269,0,10,9327000.0
9327,9327999,22.08195772497912,38.66318705887241,0.044247845176138556,2019.2181782722473,603.9325754642487,2521.9202766418457,83258,8989,74269,74269,0,10,9328000.0
9328,9328999,22.08143411939024,38.66205216120929,0.04424688813692845,2019.5266835689545,603.9933466911316,2522.166820526123,83273,8990,74283,74283,0,10,9329000.0
9329,9329999,22.080908781969256,38.66074761841593,0.044244611608186823,2019.655746459961,604.0550169944763,2522.432792663574,83273,8990,74283,74283,0,10,9330000.0
9330,9330999,22.08049974334357,38.65980240126645,0.044239975255617625,2019.7713453769684,604.1165683269501,2522.627151489258,83273,8990,74283,74283,0,10,9331000.0
9331,9331999,22.07999388681499,38.658558404901775,0.044236976910451586,2020.2588231563568,604.1777606010437,2522.8358764648438,83301,8992,74309,74309,0,10,9332000.0
9332,9332999,22.07962390259158,38.65760909009934,0.04423261190094663,2020.562748670578,604.2382507324219,2523.053840637207,83313,8993,74320,74320,0,10,9333000.0
9333,9333999,22.07932400423188,38.65661041308799,0.04422384273009583,2020.677976846695,604.2986299991608,2523.2997703552246,83313,8993,74320,74320,0,10,9334000.0
9334,9334999,22.079131809382098,38.65577932661413,0.04421662335044907,2020.7983326911926,604.3599007129669,2523.567626953125,83314,8993,74321,74321,0,10,9335000.0
9335,9335999,22.079105937915966,38.65525091912643,0.04420988104915213,2021.6609284877777,604.4243450164795,2523.7896041870117,83341,8997,74344,74344,0,10,9336000.0
9336,9336999,22.079178121110377,38.65524499671861,0.04420909559145292,2021.958481311798,604.4858474731445,2523.9636001586914,83343,8998,74345,74345,0,10,9337000.0
9337,9337999,22.079359882443175,38.655522780925914,0.04420775274603972,2022.4767615795135,604.5542411804199,2524.16259765625,83351,9000,74351,74351,0,10,9338000.0
9338,9338999,22.07993775984303,38.656560787235485,0.044203629772535336,2022.5981185436249,604.6158850193024,2524.4754753112793,83352,9000,74352,74352,0,10,9339000.0
9339,9339999,22.07988625621596,38.656912814200524,0.044187477736476244,2022.7437043190002,604.692619562149,2525.0404319763184,83354,9000,74354,74354,0,10,9340000.0
9340,9340999,22.079013633555775,38.655650392062455,0.04419340398715477,2022.8834064006805,604.7617726325989,2525.795497894287,83356,9000,74356,74356,0,10,9341000.0
9341,9341999,22.07836695656647,38.65527431629317,0.04419462691581,2023.1902484893799,604.824141740799,2526.2162857055664,83368,9001,74367,74367,0,10,9342000.0
9342,9342999,22.077548964077938,38.65378731976235,0.0441990048959523,2023.3111906051636,604.8857173919678,2526.5529708862305,83369,9001,74368,74368,0,10,9343000.0
9343,9343999,22.0770940925389,38.65490086605656,0.044192937441713154,2023.6159977912903,604.9479966163635,2526.7159538269043,83371,9002,74369,74369,0,10,9344000.0
9344,9344999,22.076551290618628,38.65446680461928,0.04419553919521979,2023.7382736206055,605.0097448825836,2527.028465270996,83372,9002,74370,74370,0,10,9345000.0
9345,9345999,22.076035844040767,38.65367689135179,0.04419609668534097,2023.8603384494781,605.0719549655914,2527.2484245300293,83373,9002,74371,74371,0,10,9346000.0
9346,9346999,22.075487323880797,38.652481346877224,0.044194479893987726,2023.9875407218933,605.1336398124695,2527.472496032715,83374,9002,74372,74372,0,10,9347000.0
9347,9347999,22.074857283248566,38.65128320550657,0.044193633690698286,2024.138151884079,605.2051799297333,2527.719680786133,83374,9002,74372,74372,0,10,9348000.0
9348,9348999,22.074236897430477,38.649949171319854,0.04419335003796121,2024.260846376419,605.2676939964294,2528.0236167907715,83374,9002,74372,74372,0,10,9349000.0
9349,9349999,22.073879550074423,38.649405261945695,0.044189048705980394,2024.3799469470978,605.3287634849548,2528.1878967285156,83374,9002,74372,74372,0,10,9350000.0
9350,9350999,22.073379243026924,38.64849870481524,0.044188407714685574,2024.5244719982147,605.3999669551849,2528.430046081543,83375,9002,74373,74373,0,10,9351000.0
9351,9351999,22.072998236595325,38.64754234517202,0.044184951894286284,2024.8325202465057,605.4614975452423,2528.5833129882812,83387,9003,74384,74384,0,10,9352000.0
9352,9352999,22.07249164144727,38.64632010422835,0.04418231452697008,2024.95632147789,605.5228898525238,2528.8175010681152,83387,9003,74384,74384,0,10,9353000.0
9353,9353999,22.072157796357985,38.64526700187469,0.04417833862334819,2025.4607424736023,605.584112405777,2528.9508209228516,83404,9005,74399,74399,0,10,9354000.0
9354,9354999,22.071886676153316,38.64435959551664,0.04417052877220806,2025.5932703018188,605.6540846824646,2529.2864112854004,83404,9005,74399,74399,0,10,9355000.0
9355,9355999,22.071558235150533,38.643307303405486,0.04416374699686709,2025.7158653736115,605.7154331207275,2529.596477508545,83405,9005,74400,74400,0,10,9356000.0
9356,9356999,22.071381382873398,38.64245884476383,0.044157123512184815,2026.017905473709,605.7785246372223,2529.822780609131,83417,9006,74411,74411,0,10,9357000.0
9357,9357999,22.07105875759335,38.64143617032703,0.044150892446954804,2026.1360840797424,605.8404977321625,2530.0920944213867,83417,9006,74411,74411,0,10,9358000.0
9358,9358999,22.070688056666555,38.64032104004025,0.0441468382085235,2026.4534072875977,605.9024815559387,2530.30961227417,83430,9007,74423,74423,0,10,9359000.0
9359,9359999,22.070320463304373,38.63969069253721,0.04414046027005669,2027.4841854572296,605.9643726348877,2530.3087005615234,83514,9012,74502,74502,0,10,9360000.0
9360,9360999,22.069708807653083,38.63938902305368,0.044143091934831236,2027.798861503601,606.026849269867,2531.5705337524414,83517,9013,74504,74504,0,10,9361000.0
9361,9361999,22.068821358449828,38.63783619906613,0.04414985486995826,2028.1020753383636,606.0897150039673,2532.2702560424805,83529,9014,74515,74515,0,10,9362000.0
9362,9362999,22.068047494801977,38.63709377012328,0.044154287789344715,2028.229009628296,606.1520464420319,2532.807949066162,83529,9014,74515,74515,0,10,9363000.0
9363,9363999,22.067414896322116,38.636484509743866,0.044154709397869474,2028.8946533203125,606.2156195640564,2533.1611862182617,83565,9017,74548,74548,0,10,9364000.0
9364,9364999,22.066868845646486,38.63546574435392,0.0441536166926344,2029.0207505226135,606.2803189754486,2533.6741638183594,83566,9017,74549,74549,0,10,9365000.0
9365,9365999,22.0664005080775,38.63449576101201,0.044154028929164646,2029.1381995677948,606.3424756526947,2534.1831703186035,83566,9017,74549,74549,0,10,9366000.0
9366,9366999,22.06593344015792,38.634136877387824,0.044148858952876346,2029.253998041153,606.405948638916,2534.680892944336,83567,9017,74550,74550,0,10,9367000.0
9367,9367999,22.065491322745185,38.63316160786735,0.04414705713161071,2029.375949382782,606.4698414802551,2535.03470993042,83567,9017,74550,74550,0,10,9368000.0
9368,9368999,22.06518505575687,38.63276754220046,0.04414193847983405,2029.8744163513184,606.5332379341125,2535.3943939208984,83591,9019,74572,74572,0,10,9369000.0
9369,9369999,22.064898239460277,38.63210494295722,0.04413854101788606,2030.1782116889954,606.5961332321167,2535.810260772705,83594,9020,74574,74574,0,10,9370000.0
9370,9370999,22.064590724991362,38.63108654345462,0.04413444961598112,2030.2982988357544,606.6603846549988,2536.2126693725586,83594,9020,74574,74574,0,10,9371000.0
9371,9371999,22.064279911771177,38.6302587109487,0.04413229559258958,2030.603019475937,606.7230660915375,2536.565101623535,83605,9021,74584,74584,0,10,9372000.0
9372,9372999,22.064083068900587,38.62940975542566,0.04413116087153757,2030.9096176624298,606.7866501808167,2537.053150177002,83607,9022,74585,74585,0,10,9373000.0
9373,9373999,22.063841463090544,38.628381100432925,0.0441275528965962,2031.2091999053955,606.8511657714844,2537.505382537842,83619,9023,74596,74596,0,10,9374000.0
9374,9374999,22.063753327985395,38.6275783331847,0.0441239477372638,2031.331927061081,606.9134459495544,2538.0555534362793,83619,9023,74596,74596,0,10,9375000.0
9375,9375999,22.063564059990142,38.62670279924297,0.04411989278356698,2031.8123972415924,606.9757418632507,2538.42964553833,83633,9025,74608,74608,0,10,9376000.0
9376,9376999,22.06317157192887,38.625484053445234,0.044117571375433484,2032.1206684112549,607.0381562709808,2538.8614959716797,83641,9026,74615,74615,0,10,9377000.0
9377,9377999,22.062550880612157,38.62474612748262,0.04412298949048643,2032.2465143203735,607.1012003421783,2540.0752143859863,83643,9026,74617,74617,0,10,9378000.0
9378,9378999,22.061608326336863,38.62357411418561,0.044132105594182014,2032.3700280189514,607.1646366119385,2540.8057136535645,83644,9026,74618,74618,0,10,9379000.0
9379,9379999,22.06069999543477,38.622121784857406,0.04414090646194557,2032.4880611896515,607.2286503314972,2541.3508911132812,83645,9026,74619,74619,0,10,9380000.0
9380,9380999,22.059829077769425,38.62080090734591,0.04414569187695361,2032.7900397777557,607.2906203269958,2541.5883865356445,83656,9027,74629,74629,0,10,9381000.0
9381,9381999,22.059071901044607,38.61948893982247,0.04415067944470641,2032.91819357872,607.3521661758423,2541.9569931030273,83656,9027,74629,74629,0,10,9382000.0
9382,9382999,22.05833463665884,38.61869041889353,0.04415260303610424,2033.2259194850922,607.4133679866791,2542.228931427002,83669,9028,74641,74641,0,10,9383000.0
9383,9383999,22.057683806989512,38.61778767207938,0.04415352162407282,2033.535706281662,607.476113319397,2542.566825866699,83682,9029,74653,74653,0,10,9384000.0
9384,9384999,22.057071661487164,38.61725564112273,0.04415224821661934,2033.8514120578766,607.540189743042,2542.7451095581055,83694,9030,74664,74664,0,10,9385000.0
9385,9385999,22.056437785463174,38.61617372322895,0.044154652883989454,2033.9776408672333,607.6010072231293,2543.1912574768066,83694,9030,74664,74664,0,10,9386000.0
9386,9386999,22.055871364975523,38.61534061087318,0.04415580394763163,2034.1031758785248,607.6660299301147,2543.6096992492676,83696,9030,74666,74666,0,10,9387000.0
9387,9387999,22.055681570397166,38.615097697765115,0.0441610963404685,2034.397522687912,607.7267520427704,2543.7983436584473,83707,9031,74676,74676,0,10,9388000.0
9388,9388999,22.055426918329896,38.61471267493906,0.04416344946590178,2035.0675070285797,607.7894160747528,2544.0318145751953,83742,9034,74708,74708,0,10,9389000.0
9389,9389999,22.055426120975053,38.614795300385865,0.044163596092275825,2035.550472021103,607.8517646789551,2544.326519012451,83763,9036,74727,74727,0,10,9390000.0
9390,9390999,22.055402131635233,38.614804473580584,0.04416499501502602,2035.6638822555542,607.9138560295105,2544.6917610168457,83763,9036,74727,74727,0,10,9391000.0
9391,9391999,22.055670495728275,38.61533890393302,0.044163209504524126,2035.797090291977,607.975900888443,2545.043067932129,83763,9036,74727,74727,0,10,9392000.0
9392,9392999,22.05594814048605,38.61577009491226,0.044162817370351215,2036.2815446853638,608.0372607707977,2545.278533935547,83782,9038,74744,74744,0,10,9393000.0
9393,9393999,22.056109350534893,38.61588407779593,0.04416283114011654,2036.395430803299,608.0976176261902,2545.556053161621,83782,9038,74744,74744,0,10,9394000.0
9394,9394999,22.056235498167098,38.616319685319766,0.0441603486304637,2036.513914823532,608.1597790718079,2545.753890991211,83782,9038,74744,74744,0,10,9395000.0
9395,9395999,22.056336383146327,38.61622476311156,0.04415637701192776,2036.6379256248474,608.2210309505463,2546.087089538574,83782,9038,74744,74744,0,10,9396000.0
9396,9396999,22.055978491917283,38.615581488785665,0.04415750486015613,2037.1271650791168,608.2831077575684,2546.6074981689453,83812,9040,74772,74772,0,10,9397000.0
9397,9397999,22.05503027537817,38.61441334974184,0.04416351690343623,2037.2553284168243,608.3461940288544,2547.2282676696777,83813,9040,74773,74773,0,10,9398000.0
9398,9398999,22.05410440867545,38.61332320186119,0.044168094903275,2037.7437374591827,608.4083716869354,2547.6647415161133,83827,9042,74785,74785,0,10,9399000.0
9399,9399999,22.053272303434124,38.61197407009222,0.044171526187032795,2038.2400884628296,608.472341299057,2547.934051513672,83853,9044,74809,74809,0,10,9400000.0
9400,9400999,22.052638698029533,38.61109733318254,0.04417182365650396,2038.5511877536774,608.5373764038086,2548.2264251708984,83860,9045,74815,74815,0,10,9401000.0
9401,9401999,22.051944262654473,38.6104633009334,0.04416920238284483,2038.683452129364,608.6001667976379,2548.566848754883,83860,9045,74815,74815,0,10,9402000.0
9402,9402999,22.0512226927706,38.6091221861237,0.044169903309788205,2038.9896087646484,608.663300037384,2548.7957878112793,83872,9046,74826,74826,0,10,9403000.0
9403,9403999,22.050567806925777,38.60788817854865,0.04416990261294984,2039.1207308769226,608.7271647453308,2549.0523376464844,83872,9046,74826,74826,0,10,9404000.0
9404,9404999,22.049856161359994,38.60661579058073,0.044170148416127764,2039.238450050354,608.7893538475037,2549.304546356201,83873,9046,74827,74827,0,10,9405000.0
9405,9405999,22.0492064242383,38.60534748117545,0.04417173738688618,2039.3696458339691,608.8526337146759,2549.5728149414062,83873,9046,74827,74827,0,10,9406000.0
9406,9406999,22.048609307778644,38.60412715367446,0.044172940931660465,2039.6769235134125,608.9145104885101,2549.6681327819824,83882,9047,74835,74835,0,10,9407000.0
9407,9407999,22.04823522281529,38.603135141580104,0.04417052850339864,2039.99400639534,608.9767894744873,2549.9285583496094,83896,9048,74848,74848,0,10,9408000.0
9408,9408999,22.047804693126032,38.60201095107613,0.04416776224855756,2040.1138830184937,609.038599729538,2550.164749145508,83896,9048,74848,74848,0,10,9409000.0
9409,9409999,22.047440374351737,38.601155636590015,0.04416532218698033,2040.4303925037384,609.1003637313843,2550.2787895202637,83906,9049,74857,74857,0,10,9410000.0
9410,9410999,22.04721783807547,38.600379487031354,0.04416014286185377,2040.7540202140808,609.161673784256,2550.5525856018066,83910,9050,74860,74860,0,10,9411000.0
9411,9411999,22.046996454275213,38.59952440723055,0.04415573163817266,2040.8708295822144,609.2238030433655,2550.884120941162,83910,9050,74860,74860,0,10,9412000.0
9412,9412999,22.046714332287962,38.59867628021082,0.04415313586662106,2041.1855721473694,609.2872798442841,2551.110466003418,83922,9051,74871,74871,0,10,9413000.0
9413,9413999,22.046637209243947,38.59806301192316,0.044143525627471925,2041.4826595783234,609.3483707904816,2551.342311859131,83934,9052,74882,74882,0,10,9414000.0
9414,9414999,22.046401682842838,38.598131112224706,0.0441369361724705,2041.6179821491241,609.4094884395599,2551.682342529297,83934,9052,74882,74882,0,10,9415000.0
9415,9415999,22.045922541425814,38.596928318698694,0.044133053083202034,2041.9196362495422,609.4713644981384,2551.962978363037,83947,9053,74894,74894,0,10,9416000.0
9416,9416999,22.045416557736466,38.59572833078553,0.04413006835692668,2042.2343754768372,609.5317656993866,2552.1625175476074,83959,9054,74905,74905,0,10,9417000.0
9417,9417999,22.044669368040886,38.594219899974725,0.044135613942994256,2042.538673877716,609.595103263855,2553.3982124328613,83976,9055,74921,74921,0,10,9418000.0
9418,9418999,22.04377274398352,38.59286350371554,0.0441400112739877,2042.8443789482117,609.6586236953735,2553.9788513183594,83990,9056,74934,74934,0,10,9419000.0
9419,9419999,22.04287370640574,38.59130870695638,0.044143152648683626,2042.9635195732117,609.7220244407654,2554.3697242736816,83990,9056,74934,74934,0,10,9420000.0
9420,9420999,22.042057207991363,38.58984895683174,0.044145954440984014,2043.0844631195068,609.7831046581268,2554.7999725341797,83990,9056,74934,74934,0,10,9421000.0
9421,9421999,22.041374129912068,38.588557528141855,0.04414758570913779,2043.584329366684,609.8464918136597,2555.0799980163574,84015,9058,74957,74957,0,10,9422000.0
9422,9422999,22.04058279969616,38.58715683862467,0.044149230536280726,2043.69912648201,609.9074785709381,2555.409336090088,84015,9058,74957,74957,0,10,9423000.0
9423,9423999,22.039950729747165,38.58580727820629,0.04415079023109736,2044.1913754940033,609.9701569080353,2555.6440811157227,84029,9060,74969,74969,0,10,9424000.0
9424,9424999,22.03918920233298,38.584417853843526,0.044150815939304366,2044.4947173595428,610.0328874588013,2556.0213890075684,84041,9061,74980,74980,0,10,9425000.0
9425,9425999,22.038550896554863,38.583144896454606,0.04415029905877632,2044.804374217987,610.0954704284668,2556.286476135254,84053,9062,74991,74991,0,10,9426000.0
9426,9426999,22.03797950531466,38.58209476043462,0.04415272359194378,2045.2896492481232,610.1571865081787,2556.4898796081543,84067,9064,75003,75003,0,10,9427000.0
9427,9427999,22.03731394064885,38.58069458666029,0.04415294792304014,2045.7910978794098,610.2198400497437,2556.764358520508,84075,9066,75009,75009,0,10,9428000.0
9428,9428999,22.036784267574845,38.579490662174386,0.04415126310072626,2046.0980761051178,610.2809946537018,2557.02689743042,84087,9067,75020,75020,0,10,9429000.0
9429,9429999,22.036358226477844,38.5784468179939,0.044147445753591086,2046.7646787166595,610.3434453010559,2557.1154022216797,84120,9070,75050,75050,0,10,9430000.0
9430,9430999,22.035927473264152,38.57725724992655,0.0441450741298417,2047.2521514892578,610.4063980579376,2557.421642303467,84144,9072,75072,75072,0,10,9431000.0
9431,9431999,22.035704164991103,38.57647435672147,0.04413964470339382,2047.5528347492218,610.4670193195343,2557.7543029785156,84157,9073,75084,75084,0,10,9432000.0
9432,9432999,22.035395717480128,38.57535772879421,0.044134721039124636,2047.8545544147491,610.5281162261963,2557.992401123047,84159,9074,75085,75085,0,10,9433000.0
9433,9433999,22.035277417987533,38.574276498096495,0.044125517472256015,2048.3413252830505,610.590380191803,2558.130569458008,84182,9076,75106,75106,0,10,9434000.0
9434,9434999,22.03497159696628,38.573077488505724,0.044121577056215,2048.830552339554,610.6514613628387,2558.3361892700195,84200,9078,75122,75122,0,10,9435000.0
9435,9435999,22.03459090362376,38.57182294642325,0.044118881024679646,2048.9474177360535,610.7118670940399,2558.6534309387207,84200,9078,75122,75122,0,10,9436000.0
9436,9436999,22.034076806887303,38.57043067655534,0.0441198748462831,2049.2479112148285,610.7733960151672,2558.875518798828,84212,9079,75133,75133,0,10,9437000.0
9437,9437999,22.033139533043617,38.569072963004125,0.04412833230341584,2049.5622708797455,610.836925983429,2560.0817260742188,84216,9080,75136,75136,0,10,9438000.0
9438,9438999,22.032156292322593,38.56821669079773,0.044137384977199434,2050.050938129425,610.901123046875,2560.625114440918,84222,9082,75140,75140,0,10,9439000.0
9439,9439999,22.031293168969093,38.56705900414716,0.044147974961800895,2050.7290267944336,610.9635682106018,2560.889778137207,84278,9085,75193,75193,0,10,9440000.0
9440,9440999,22.03045435181403,38.56566724138406,0.04415516420600296,2050.8489305973053,611.0262291431427,2561.3124198913574,84278,9085,75193,75193,0,10,9441000.0
9441,9441999,22.029610462386966,38.56445359722295,0.04415527181507517,2051.1507189273834,611.0890526771545,2561.6316261291504,84291,9086,75205,75205,0,10,9442000.0
9442,9442999,22.028895795514984,38.56333075729248,0.04415894435470402,2051.2722985744476,611.1526961326599,2561.9767532348633,84291,9086,75205,75205,0,10,9443000.0
9443,9443999,22.02821751338174,38.5623267211557,0.04416114981847108,2051.938149213791,611.2157258987427,2562.1659507751465,84307,9089,75218,75218,0,10,9444000.0
9444,9444999,22.027490369454263,38.56163654825349,0.04416127702991446,2052.059046983719,611.2785179615021,2562.731330871582,84309,9089,75220,75220,0,10,9445000.0
9445,9445999,22.026780796195673,38.560541418253095,0.04416323840114178,2052.3587169647217,611.3410453796387,2563.029472351074,84322,9090,75232,75232,0,10,9446000.0
9446,9446999,22.026037432810373,38.55940850495678,0.04416438909417064,2052.6632645130157,611.4039969444275,2563.364345550537,84327,9091,75236,75236,0,10,9447000.0
9447,9447999,22.025508087008394,38.558418187442854,0.04416329181627465,2052.9666492938995,611.4662923812866,2563.6931190490723,84330,9092,75238,75238,0,10,9448000.0
9448,9448999,22.024906648061208,38.55769261953209,0.044164444787981205,2053.081087589264,611.5278713703156,2564.0021057128906,84330,9092,75238,75238,0,10,9449000.0
9449,9449999,22.02429876930956,38.556510805414526,0.044165236460719126,2053.9472274780273,611.5915248394012,2564.155994415283,84378,9096,75282,75282,0,10,9450000.0
9450,9450999,22.02379849199201,38.55531139059184,0.04416341796237544,2054.075083255768,611.6526114940643,2564.5634765625,84378,9096,75282,75282,0,10,9451000.0
9451,9451999,22.023339112749706,38.55440735379614,0.044161078612213966,2054.191778898239,611.7143399715424,2564.931308746338,84378,9096,75282,75282,0,10,9452000.0
9452,9452999,22.02310076637523,38.553632313141485,0.04415817350992868,2054.502927303314,611.7754600048065,2565.145107269287,84390,9097,75293,75293,0,10,9453000.0
9453,9453999,22.022901100490962,38.552986638793385,0.04415658051811411,2054.9887189865112,611.8377156257629,2565.5026893615723,84414,9099,75315,75315,0,10,9454000.0
9454,9454999,22.02266050592139,38.552190928379524,0.04415660229534202,2055.2974894046783,611.8995385169983,2565.839672088623,84427,9100,75327,75327,0,10,9455000.0
9455,9455999,22.02258844992458,38.5522159185442,0.04415650033586194,2055.596975326538,611.9618031978607,2566.105369567871,84442,9101,75341,75341,0,10,9456000.0
9456,9456999,22.022477922501277,38.552319966133766,0.04417011837987661,2055.739858150482,612.033759355545,2566.4204483032227,84443,9101,75342,75342,0,10,9457000.0
9457,9457999,22.022147501920962,38.551865301885336,0.04417736946571693,2055.8905079364777,612.1042590141296,2567.437675476074,84448,9101,75347,75347,0,10,9458000.0
9458,9458999,22.021340123953383,38.55114369195274,0.04418197960210346,2056.219688653946,612.1696047782898,2567.9729080200195,84462,9102,75360,75360,0,10,9459000.0
9459,9459999,22.020443337047457,38.5498035603702,0.04418637612316745,2056.5246624946594,612.2310483455658,2568.359161376953,84495,9103,75392,75392,0,10,9460000.0
9460,9460999,22.019593176280296,38.54855529969873,0.04419080815448939,2057.0185804367065,612.2940232753754,2568.6571197509766,84509,9105,75404,75404,0,10,9461000.0
9461,9461999,22.018791287648007,38.54723544495941,0.04419278196552223,2057.1558027267456,612.3590981960297,2568.929828643799,84509,9105,75404,75404,0,10,9462000.0
9462,9462999,22.018061560962884,38.54834298167896,0.044193545126707034,2057.2772958278656,612.4213132858276,2569.310127258301,84510,9105,75405,75405,0,10,9463000.0
9463,9463999,22.017245542144977,38.54691901000897,0.04419416969352341,2057.778689622879,612.483384847641,2569.578540802002,84534,9107,75427,75427,0,10,9464000.0
9464,9464999,22.01633292122886,38.54541981235275,0.04419790895803122,2058.2768445014954,612.5460195541382,2569.7429733276367,84562,9109,75453,75453,0,10,9465000.0
9465,9465999,22.015582760011323,38.54474560716339,0.04419915148154929,2058.5911242961884,612.6074771881104,2569.967861175537,84574,9110,75464,75464,0,10,9466000.0
9466,9466999,22.01498048744536,38.5436733867471,0.04419900772498131,2058.7143099308014,612.6698908805847,2570.269920349121,84574,9110,75464,75464,0,10,9467000.0
9467,9467999,22.014340297907562,38.54240120575911,0.044199896287064,2059.021948337555,612.7315139770508,2570.4379844665527,84588,9111,75477,75477,0,10,9468000.0
9468,9468999,22.013791557535946,38.54157389711019,0.044200000152410324,2059.1518697738647,612.7933843135834,2570.694725036621,84588,9111,75477,75477,0,10,9469000.0
9469,9469999,22.013233771556866,38.540355690844564,0.04419529750246931,2059.292350292206,612.8562545776367,2570.964183807373,84588,9111,75477,75477,0,10,9470000.0
9470,9470999,22.012783334875305,38.539415045598716,0.044192101754904844,2059.602240085602,612.9193351268768,2571.120315551758,84590,9112,75478,75478,0,10,9471000.0
9471,9471999,22.012373716938736,38.53850136290657,0.04418961240489261,2059.9163212776184,612.98291182518,2571.370948791504,84602,9113,75489,75489,0,10,9472000.0
9472,9472999,22.01201004550472,38.537711501864194,0.04418575173777772,2060.416647672653,613.0450201034546,2571.5645751953125,84626,9115,75511,75511,0,10,9473000.0
9473,9473999,22.0118850247099,38.53715207866456,0.044181043779108364,2060.7254345417023,613.1074147224426,2571.930419921875,84638,9116,75522,75522,0,10,9474000.0
9474,9474999,22.01159242502142,38.536208533521126,0.044182358292237156,2061.418697118759,613.1690878868103,2572.002056121826,84675,9119,75556,75556,0,10,9475000.0
9475,9475999,22.01135622819103,38.53541879311765,0.04418055852261249,2061.72327709198,613.2303249835968,2572.2772216796875,84688,9120,75568,75568,0,10,9476000.0
9476,9476999,22.01111209322378,38.534505531885884,0.04417746795424282,2062.218982696533,613.2928807735443,2572.4651069641113,84706,9122,75584,75584,0,10,9477000.0
9477,9477999,22.010654024609885,38.53340013894958,0.04417718360493461,2062.3393652439117,613.3534662723541,2572.7917671203613,84706,9122,75584,75584,0,10,9478000.0
9478,9478999,22.01009353242244,38.532241463119654,0.044162929851880306,2062.845269680023,613.4170377254486,2573.6189002990723,84724,9124,75600,75600,0,10,9479000.0
9479,9479999,22.00945614232496,38.53098988487071,0.044150381179042575,2063.1561732292175,613.4807860851288,2574.0813789367676,84726,9125,75601,75601,0,10,9480000.0
9480,9480999,22.008908023716288,38.53002048078571,0.04414292380716345,2063.4617404937744,613.5435626506805,2574.4027671813965,84728,9126,75602,75602,0,10,9481000.0
9481,9481999,22.008415277741044,38.52885887062225,0.044131933706810234,2063.7752015590668,613.6058127880096,2574.6318855285645,84730,9127,75603,75603,0,10,9482000.0
9482,9482999,22.007933117949445,38.527971141170326,0.0441304733733181,2063.8961143493652,613.6671540737152,2574.95512008667,84731,9127,75604,75604,0,10,9483000.0
9483,9483999,22.00753943994438,38.52696185363282,0.044125983747785535,2064.388049840927,613.7304649353027,2575.162567138672,84745,9129,75616,75616,0,10,9484000.0
9484,9484999,22.00725506077319,38.52603749264085,0.0441281532326554,2064.70810174942,613.7955963611603,2575.4235649108887,84757,9130,75627,75627,0,10,9485000.0
9485,9485999,22.006941934403308,38.5252547720621,0.044125904657234094,2065.1959207057953,613.8575367927551,2575.7413635253906,84768,9132,75636,75636,0,10,9486000.0
9486,9486999,22.006890310235185,38.5246659518154,0.04412655029893098,2065.5084722042084,613.9195938110352,2576.0342979431152,84780,9133,75647,75647,0,10,9487000.0
9487,9487999,22.00694245963975,38.52423466574762,0.04412655028806722,2065.8176770210266,613.9827132225037,2576.253593444824,84792,9134,75658,75658,0,10,9488000.0
9488,9488999,22.00758259684329,38.525253612749985,0.04414286005711687,2066.1309254169464,614.0439922809601,2576.5881156921387,84795,9135,75660,75660,0,10,9489000.0
9489,9489999,22.008310622244018,38.527089875761185,0.04415708277392205,2066.436900615692,614.1069855690002,2576.850440979004,84806,9136,75670,75670,0,10,9490000.0
9490,9490999,22.00892502695081,38.52808722004062,0.044172810137300345,2066.9453303813934,614.170316696167,2576.9646797180176,84812,9138,75674,75674,0,10,9491000.0
9491,9491999,22.009810170362268,38.53005246994118,0.044189671670659125,2067.0612363815308,614.2321605682373,2577.3517150878906,84812,9138,75674,75674,0,10,9492000.0
9492,9492999,22.011145793186408,38.53345324817583,0.04421905711439744,2067.3702354431152,614.2944231033325,2577.668731689453,84825,9139,75686,75686,0,10,9493000.0
9493,9493999,22.012872825697492,38.53952672966689,0.04425244267095918,2067.867108106613,614.3563890457153,2577.958023071289,84829,9141,75688,75688,0,10,9494000.0
9494,9494999,22.01451616300945,38.54374347751257,0.044282611158981466,2068.1940240859985,614.421178817749,2578.170078277588,84831,9142,75689,75689,0,10,9495000.0
9495,9495999,22.01618906645006,38.54702836712355,0.044299549003800065,2068.3236632347107,614.4843456745148,2578.491439819336,84831,9142,75689,75689,0,10,9496000.0
9496,9496999,22.017655282789672,38.55010326867193,0.044328928973721204,2068.6304416656494,614.5455596446991,2578.812728881836,84833,9143,75690,75690,0,10,9497000.0
9497,9497999,22.018407293809005,38.551894817807586,0.04433509978465067,2068.9406378269196,614.6080513000488,2579.211925506592,84842,9144,75698,75698,0,10,9498000.0
9498,9498999,22.018051021432395,38.551293403117576,0.04433268458894324,2069.0572028160095,614.6699702739716,2580.0929641723633,84844,9144,75700,75700,0,10,9499000.0
9499,9499999,22.01762943524429,38.55117939847543,0.04433334875483441,2069.181287050247,614.7322824001312,2580.5850372314453,84845,9144,75701,75701,0,10,9500000.0
9500,9500999,22.01730120778544,38.550654012282834,0.04433124902863095,2069.6762430667877,614.7944872379303,2580.856491088867,84859,9146,75713,75713,0,10,9501000.0
9501,9501999,22.017011600176765,38.550032137865365,0.04433016187464989,2069.986136674881,614.8580017089844,2581.1408767700195,84872,9147,75725,75725,0,10,9502000.0
9502,9502999,22.016546172029585,38.5491439026678,0.044330325374773105,2070.2946059703827,614.9202919006348,2581.341636657715,84884,9148,75736,75736,0,10,9503000.0
9503,9503999,22.01613820124534,38.54834122943495,0.04432595765664782,2070.4217755794525,614.9824283123016,2581.706645965576,84884,9148,75736,75736,0,10,9504000.0
9504,9504999,22.01576133777643,38.547432717463444,0.04432555901756641,2070.7282655239105,615.0450518131256,2581.971260070801,84886,9149,75737,75737,0,10,9505000.0
9505,9505999,22.01541923319374,38.546596571537386,0.04432225168461401,2070.8559653759003,615.1061062812805,2582.237144470215,84886,9149,75737,75737,0,10,9506000.0
9506,9506999,22.015285710006708,38.5460229446195,0.044317572775793734,2071.567081451416,615.1687407493591,2582.327796936035,84903,9152,75751,75751,0,10,9507000.0
9507,9507999,22.01534781133674,38.54592288183734,0.04431428380140956,2071.879250049591,615.2299489974976,2582.671371459961,84916,9153,75763,75763,0,10,9508000.0
9508,9508999,22.01542646482197,38.54560984966075,0.04431498266112166,2071.994688510895,615.2922208309174,2583.079776763916,84917,9153,75764,75764,0,10,9509000.0
9509,9509999,22.01551671674479,38.54513643756168,0.0443143686029861,2072.1348445415497,615.3639807701111,2583.4668731689453,84917,9153,75764,75764,0,10,9510000.0
9510,9510999,22.015856627792438,38.54521490665667,0.04431416114909559,2072.6285231113434,615.4271430969238,2583.628673553467,84931,9155,75776,75776,0,10,9511000.0
9511,9511999,22.016238939230952,38.544947403823315,0.04431336531159202,2072.7464356422424,615.4878282546997,2583.9547271728516,84931,9155,75776,75776,0,10,9512000.0
9512,9512999,22.016387559025425,38.54447999846464,0.04430805119638259,2072.8692173957825,615.5492441654205,2584.2615661621094,84931,9155,75776,75776,0,10,9513000.0
9513,9513999,22.016743717901893,38.54486433120318,0.04430506354604913,2073.3746342658997,615.6117076873779,2584.5370483398438,84938,9157,75781,75781,0,10,9514000.0
9514,9514999,22.016531182548803,38.54418757946938,0.044298412703641876,2073.5041902065277,615.6733438968658,2585.4266395568848,84939,9157,75782,75782,0,10,9515000.0
9515,9515999,22.0161369279853,38.54389832041894,0.044289858412959404,2073.8164784908295,615.7356085777283,2585.988422393799,84952,9158,75794,75794,0,10,9516000.0
9516,9516999,22.015832835503254,38.54324451441713,0.04428168458869253,2074.305498600006,615.799685716629,2586.376289367676,84969,9160,75809,75809,0,10,9517000.0
9517,9517999,22.015436771779996,38.54237932832614,0.04427559228395006,2074.612113237381,615.8617038726807,2586.723773956299,84985,9161,75824,75824,0,10,9518000.0
9518,9518999,22.015140629838285,38.54231886579943,0.04426202363582932,2074.928603887558,615.9253838062286,2587.0490531921387,84999,9162,75837,75837,0,10,9519000.0
9519,9519999,22.01475640118598,38.541898431621036,0.044250196684214815,2075.05050945282,615.9864525794983,2587.4013290405273,85000,9162,75838,75838,0,10,9520000.0
9520,9520999,22.014200083555085,38.54071102626619,0.04424055746747657,2075.7521855831146,616.049923658371,2587.540298461914,85040,9165,75875,75875,0,10,9521000.0
9521,9521999,22.013793763842138,38.54048023174031,0.04423554984107436,2076.236904144287,616.1135530471802,2587.892002105713,85061,9167,75894,75894,0,10,9522000.0
9522,9522999,22.013472525625225,38.53989402061977,0.04422712641561777,2076.7374386787415,616.1763858795166,2588.2062034606934,85076,9169,75907,75907,0,10,9523000.0
9523,9523999,22.013173240897338,38.539159921681474,0.04421964188878602,2076.863131761551,616.2373790740967,2588.4376525878906,85076,9169,75907,75907,0,10,9524000.0
9524,9524999,22.01297540818813,38.53889598359497,0.04421012123533341,2077.350394964218,616.2991154193878,2588.79634475708,85102,9171,75931,75931,0,10,9525000.0
9525,9525999,22.01278547358773,38.53820893768971,0.04420253744228564,2078.0253088474274,616.3628172874451,2588.9814224243164,85140,9174,75966,75966,0,10,9526000.0
9526,9526999,22.01242363129497,38.53707452777568,0.044195424760935964,2078.883884191513,616.4411377906799,2589.0435333251953,85189,9178,76011,76011,0,10,9527000.0
9527,9527999,22.012643267055648,38.53998290051344,0.04417899656657098,2079.001937150955,616.5027158260345,2589.4375,85189,9178,76011,76011,0,10,9528000.0
9528,9528999,22.012601093416468,38.539407682150774,0.0441719352669383,2079.509054660797,616.5654315948486,2589.7054862976074,85214,9180,76034,76034,0,10,9529000.0
9529,9529999,22.012421838787745,38.538705427088644,0.044168072753290266,2079.829389810562,616.6355066299438,2590.0603065490723,85226,9181,76045,76045,0,10,9530000.0
9530,9530999,22.012204609455633,38.53789772116952,0.044163246478681084,2080.5295848846436,616.7050139904022,2590.1905632019043,85277,9184,76093,76093,0,10,9531000.0
9531,9531999,22.01219042088556,38.537436450934614,0.0441523498869425,2080.647660970688,616.7671155929565,2590.6349716186523,85277,9184,76093,76093,0,10,9532000.0
9532,9532999,22.011965989989626,38.53644557071343,0.04414400079172698,2080.9637117385864,616.8307085037231,2590.9754371643066,85289,9185,76104,76104,0,10,9533000.0
9533,9533999,22.01172770277395,38.5359004754612,0.044136903964392515,2081.2735636234283,616.8932638168335,2591.2403297424316,85302,9186,76116,76116,0,10,9534000.0
9534,9534999,22.0107684350391,38.53466367906627,0.04414341595470239,2081.4000041484833,616.9562983512878,2592.81099319458,85310,9186,76124,76124,0,10,9535000.0
9535,9535999,22.009753951851835,38.53323804943478,0.044148348446758634,2081.722072839737,617.0211138725281,2593.3849182128906,85314,9187,76127,76127,0,10,9536000.0
9536,9536999,22.008939093736448,38.532034892513195,0.04415031220124943,2082.213552713394,617.0832388401031,2593.8132247924805,85340,9189,76151,76151,0,10,9537000.0
9537,9537999,22.008169750280807,38.53093155662302,0.0441519031198645,2082.5202326774597,617.1457014083862,2594.2533264160156,85352,9190,76162,76162,0,10,9538000.0
9538,9538999,22.007557023025704,38.53023511644919,0.04414936381844825,2082.64062833786,617.2075674533844,2594.704948425293,85353,9190,76163,76163,0,10,9539000.0
9539,9539999,22.00711176468058,38.53025604975143,0.044149285402571126,2082.7565627098083,617.268584728241,2595.1016693115234,85353,9190,76163,76163,0,10,9540000.0
9540,9540999,22.006712489250376,38.53041061675694,0.044148665019685285,2083.0726232528687,617.3313615322113,2595.473445892334,85364,9191,76173,76173,0,10,9541000.0
9541,9541999,22.006408536109387,38.53035413473998,0.04414911567465751,2083.5751457214355,617.3940374851227,2595.850845336914,85390,9193,76197,76197,0,10,9542000.0
9542,9542999,22.00624609555643,38.53040861796006,0.04415326296950628,2083.907174348831,617.4604587554932,2596.1575317382812,85402,9194,76208,76208,0,10,9543000.0
9543,9543999,22.006570667097414,38.53153282954355,0.04415651179722124,2084.0250997543335,617.5223321914673,2596.4676475524902,85402,9194,76208,76208,0,10,9544000.0
9544,9544999,22.006908071855413,38.532497904538594,0.04416554386201654,2084.335975408554,617.5850396156311,2596.85737991333,85415,9195,76220,76220,0,10,9545000.0
9545,9545999,22.0075034215453,38.534095993115734,0.04417164933269302,2084.8342151641846,617.6479971408844,2597.0732383728027,85439,9197,76242,76242,0,10,9546000.0
9546,9546999,22.008263587494508,38.53634590395263,0.044175610516789865,2085.5080926418304,617.7116160392761,2597.3626251220703,85467,9200,76267,76267,0,10,9547000.0
9547,9547999,22.009188106633477,38.538546333203165,0.044180181059282564,2085.6212272644043,617.7745544910431,2597.8333129882812,85467,9200,76267,76267,0,10,9548000.0
9548,9548999,22.01028983799838,38.54107534677137,0.04418352425700023,2085.9355092048645,617.8376100063324,2598.195243835449,85479,9201,76278,76278,0,10,9549000.0
9549,9549999,22.011192487242134,38.542929225582256,0.044189099167787904,2086.636945962906,617.9011092185974,2598.3892364501953,85515,9204,76311,76311,0,10,9550000.0
9550,9550999,22.0123030806738,38.5456927598056,0.04418965279115372,2086.75461935997,617.9650390148163,2598.832489013672,85515,9204,76311,76311,0,10,9551000.0
9551,9551999,22.013424699032633,38.54788295286753,0.044192700644341665,2087.2493000030518,618.0281496047974,2599.1723442077637,85539,9206,76333,76333,0,10,9552000.0
9552,9552999,22.014279753969948,38.549345229107566,0.044195218004400405,2087.5655829906464,618.091236114502,2599.4393272399902,85546,9207,76339,76339,0,10,9553000.0
9553,9553999,22.01448640284695,38.549613288893525,0.044193500793628826,2087.8695845603943,618.1527183055878,2599.6786575317383,85558,9208,76350,76350,0,10,9554000.0
9554,9554999,22.01376197485638,38.548466503369745,0.04419660585039864,2088.3752748966217,618.2165896892548,2600.724540710449,85601,9210,76391,76391,0,10,9555000.0
9555,9555999,22.01278103276878,38.54697688421975,0.044200474656012845,2088.6981315612793,618.2795114517212,2601.2726669311523,85612,9211,76401,76401,0,10,9556000.0
9556,9556999,22.01198576265465,38.54671828362561,0.04420203006539292,2089.0122447013855,618.3432719707489,2601.6137313842773,85642,9212,76430,76430,0,10,9557000.0
9557,9557999,22.01113879964035,38.54540767409239,0.04420500419108975,2089.321606874466,618.4060823917389,2601.9545974731445,85654,9213,76441,76441,0,10,9558000.0
9558,9558999,22.01037846451125,38.5443185606008,0.044205349097058866,2089.629531145096,618.468424320221,2602.23384475708,85663,9214,76449,76449,0,10,9559000.0
9559,9559999,22.009570226518722,38.54305010680461,0.04420796209875433,2089.9374573230743,618.5319459438324,2602.477996826172,85675,9215,76460,76460,0,10,9560000.0
9560,9560999,22.008787735935716,38.54162612305412,0.044211205748219684,2090.6262109279633,618.5962338447571,2602.664234161377,85711,9218,76493,76493,0,10,9561000.0
9561,9561999,22.007951458910572,38.54022513790828,0.04421492376683456,2090.7505280971527,618.6586124897003,2603.0015754699707,85711,9218,76493,76493,0,10,9562000.0
9562,9562999,22.00727904233342,38.5389067366624,0.04421703859147108,2090.8794865608215,618.721125125885,2603.3262329101562,85711,9218,76493,76493,0,10,9563000.0
9563,9563999,22.006752133497706,38.53786000157375,0.044220689168923744,2091.0058693885803,618.7842321395874,2603.6013412475586,85711,9218,76493,76493,0,10,9564000.0
9564,9564999,22.006259205231927,38.53665656323674,0.04422600133463128,2091.3154034614563,618.8466131687164,2603.9252586364746,85717,9219,76498,76498,0,10,9565000.0
9565,9565999,22.00582854023515,38.535608850003634,0.04422636077379394,2091.4317739009857,618.9082458019257,2604.2078132629395,85717,9219,76498,76498,0,10,9566000.0
9566,9566999,22.005537949665158,38.53474860321093,0.0442237592965713,2091.9395909309387,618.9718222618103,2604.37149810791,85726,9221,76505,76505,0,10,9567000.0
9567,9567999,22.00526284876702,38.533870359041885,0.04422290405252205,2092.064576148987,619.0356810092926,2604.6806449890137,85726,9221,76505,76505,0,10,9568000.0
9568,9568999,22.0051317298062,38.53314006594996,0.044222057313807905,2092.3725748062134,619.0988507270813,2604.992290496826,85733,9222,76511,76511,0,10,9569000.0
9569,9569999,22.00489752893895,38.53232406312469,0.044222215536854126,2092.4946026802063,619.1602411270142,2605.352714538574,85733,9222,76511,76511,0,10,9570000.0
9570,9570999,22.004771665526235,38.53161993987712,0.04422025607334823,2092.79940533638,619.2216265201569,2605.586151123047,85745,9223,76522,76522,0,10,9571000.0
9571,9571999,22.004735288754695,38.531022080362476,0.04421294457000524,2093.3151948451996,619.2856965065002,2605.817070007324,85760,9225,76535,76535,0,10,9572000.0
9572,9572999,22.004491178382885,38.52998974089384,0.04420920208375234,2093.4395649433136,619.3472945690155,2606.1685791015625,85760,9225,76535,76535,0,10,9573000.0
9573,9573999,22.004011715324996,38.52882736895675,0.04420754303484897,2093.7452030181885,619.4104814529419,2606.369037628174,85772,9226,76546,76546,0,10,9574000.0
9574,9574999,22.00338351931374,38.52777817476018,0.04421285389603824,2093.885821580887,619.4756398200989,2607.6132431030273,85774,9226,76548,76548,0,10,9575000.0
9575,9575999,22.002887661847925,38.528548889967965,0.04421165262849924,2094.378413438797,619.5387082099915,2608.067783355713,85789,9228,76561,76561,0,10,9576000.0
9576,9576999,22.00214027193656,38.52745068612749,0.04421649504260883,2094.6994802951813,619.6029574871063,2608.3909492492676,85793,9229,76564,76564,0,10,9577000.0
9577,9577999,22.001412665589317,38.5264442036504,0.04421963086375946,2095.202189683914,619.6666123867035,2608.705696105957,85812,9231,76581,76581,0,10,9578000.0
9578,9578999,22.00069497575701,38.52527859847168,0.04422195554565855,2095.705796480179,619.7295987606049,2608.9118309020996,85826,9233,76593,76593,0,10,9579000.0
9579,9579999,22.000016928221225,38.52414748480314,0.04422428836124326,2096.0215167999268,619.7929582595825,2609.247386932373,85838,9234,76604,76604,0,10,9580000.0
9580,9580999,21.99922725652872,38.52270074107179,0.04422798514290427,2096.7213592529297,619.8580541610718,2609.404270172119,85854,9237,76617,76617,0,10,9581000.0
9581,9581999,21.998479899870205,38.521482901312424,0.04423008981886367,2097.0327882766724,619.9203379154205,2609.6922187805176,85865,9238,76627,76627,0,10,9582000.0
9582,9582999,21.99769591075892,38.52005115922974,0.0442337170919469,2097.162184238434,619.9819552898407,2609.980640411377,85865,9238,76627,76627,0,10,9583000.0
9583,9583999,21.99699275879179,38.51867865013164,0.04423514161086661,2097.858227968216,620.0462055206299,2610.032123565674,85883,9241,76642,76642,0,10,9584000.0
9584,9584999,21.99625324770384,38.517281544973144,0.04423705918281162,2098.1929848194122,620.1107439994812,2610.3256034851074,85895,9242,76653,76653,0,10,9585000.0
9585,9585999,21.99553329976783,38.51592119818335,0.044236232395020836,2098.4996168613434,620.1725935935974,2610.4120330810547,85906,9243,76663,76663,0,10,9586000.0
9586,9586999,21.994895993444324,38.51461751733618,0.04423521121839369,2099.010132789612,620.2371997833252,2610.618755340576,85928,9245,76683,76683,0,10,9587000.0
9587,9587999,21.99458372480034,38.51461278999696,0.044230645882484265,2099.124711036682,620.2990946769714,2610.972309112549,85928,9245,76683,76683,0,10,9588000.0
9588,9588999,21.994050697505916,38.51333682594953,0.04422594286411796,2099.426031112671,620.3610770702362,2611.2576446533203,85939,9246,76693,76693,0,10,9589000.0
9589,9589999,21.993534955433066,38.512115309442706,0.04422159234570355,2099.5554251670837,620.4237098693848,2611.5178184509277,85939,9246,76693,76693,0,10,9590000.0
9590,9590999,21.993111338971485,38.51094475329894,0.044216591907292435,2099.8639438152313,620.4851014614105,2611.8870391845703,85950,9247,76703,76703,0,10,9591000.0
9591,9591999,21.992609230456583,38.509638340750676,0.04421361188200512,2100.1787235736847,620.5491480827332,2612.2349891662598,85961,9248,76713,76713,0,10,9592000.0
9592,9592999,21.992022069249323,38.50830340513626,0.04421134307396424,2100.2932085990906,620.6111440658569,2612.4987869262695,85962,9248,76714,76714,0,10,9593000.0
9593,9593999,21.991318697403173,38.506985656840634,0.04420927313113665,2100.4101049900055,620.6724302768707,2612.7309379577637,85962,9248,76714,76714,0,10,9594000.0
9594,9594999,21.990587129879046,38.50552582619691,0.04421260181312303,2100.544382572174,620.7365555763245,2614.0463638305664,85968,9248,76720,76720,0,10,9595000.0
9595,9595999,21.98970395786791,38.50496586160774,0.04421356682244104,2100.682373046875,620.8023097515106,2614.8527297973633,85972,9248,76724,76724,0,10,9596000.0
9596,9596999,21.988811434919143,38.50342457820519,0.04421641702304169,2101.183500766754,620.8666620254517,2615.3834114074707,85989,9250,76739,76739,0,10,9597000.0
9597,9597999,21.98797680650234,38.50221126949115,0.044218279751403466,2101.6836194992065,620.9302711486816,2615.9270782470703,86002,9252,76750,76750,0,10,9598000.0
9598,9598999,21.98715552700505,38.50081891920475,0.04421824725759005,2102.0231335163116,620.99631690979,2616.417152404785,86016,9253,76763,76763,0,10,9599000.0
9599,9599999,21.986317786309716,38.499425449974005,0.04421885328307895,2102.337882041931,621.0595560073853,2616.8498497009277,86028,9254,76774,76774,0,10,9600000.0
9600,9600999,21.985706574446574,38.49825269969608,0.04421845392009138,2102.644138813019,621.1230044364929,2617.3639945983887,86031,9255,76776,76776,0,10,9601000.0
9601,9601999,21.985084816895412,38.49722072857244,0.044218572299781767,2103.1426723003387,621.1858124732971,2617.644443511963,86056,9257,76799,76799,0,10,9602000.0
9602,9602999,21.98448036472826,38.49617442335952,0.04421770471773678,2103.4528629779816,621.248379945755,2617.8834648132324,86068,9258,76810,76810,0,10,9603000.0
9603,9603999,21.9840047775622,38.495303270755,0.044213223804199675,2103.57125043869,621.311598777771,2618.352279663086,86068,9258,76810,76810,0,10,9604000.0
9604,9604999,21.98352378747541,38.49428480245667,0.04420916448162715,2103.884887456894,621.3723621368408,2618.7765502929688,86080,9259,76821,76821,0,10,9605000.0
9605,9605999,21.98334610952326,38.494007942019934,0.044201186582567886,2104.0211470127106,621.434454202652,2619.1470527648926,86081,9259,76822,76822,0,10,9606000.0
9606,9606999,21.983150407801084,38.49340262051852,0.04419607452855301,2104.327737092972,621.4978082180023,2619.5540657043457,86098,9260,76838,76838,0,10,9607000.0
9607,9607999,21.982959225228118,38.49268928675852,0.04419960055789052,2104.445638656616,621.561909198761,2620.0995445251465,86099,9260,76839,76839,0,10,9608000.0
9608,9608999,21.983065819749687,38.49249475361497,0.04419351729308907,2104.5641746520996,621.6233921051025,2620.5315895080566,86100,9260,76840,76840,0,10,9609000.0
9609,9609999,21.98294982024001,38.491711779482465,0.04418958645691762,2105.099214076996,621.6881403923035,2620.863780975342,86113,9262,76851,76851,0,10,9610000.0
9610,9610999,21.982839446490853,38.490946042144664,0.04418383894940747,2105.5970108509064,621.7512438297272,2621.3392791748047,86139,9264,76875,76875,0,10,9611000.0
9611,9611999,21.982955178800466,38.49102655099774,0.0441792239498936,2105.7267320156097,621.8142416477203,2621.7214851379395,86139,9264,76875,76875,0,10,9612000.0
9612,9612999,21.982783978692744,38.490175832802855,0.04417401688736888,2106.041089296341,621.8777070045471,2622.0706481933594,86147,9265,76882,76882,0,10,9613000.0
9613,9613999,21.982599592426524,38.48941702704552,0.04417327934883786,2106.360298395157,621.9400248527527,2622.443260192871,86149,9266,76883,76883,0,10,9614000.0
9614,9614999,21.982139380760618,38.48834022078727,0.044170790481081634,2106.6792023181915,622.002464056015,2623.3085327148438,86152,9267,76885,76885,0,10,9615000.0
9615,9615999,21.981170992491105,38.48697403564084,0.04417278930167512,2106.812729358673,622.0669634342194,2624.3185844421387,86154,9267,76887,76887,0,10,9616000.0
9616,9616999,21.98047224318454,38.48613124297448,0.04417348651442354,2106.9284245967865,622.1290428638458,2625.0005531311035,86157,9267,76890,76890,0,10,9617000.0
9617,9617999,21.979994761294215,38.48535639456192,0.0441776534832804,2107.6244778633118,622.1938190460205,2625.4221534729004,86183,9270,76913,76913,0,10,9618000.0
9618,9618999,21.980130099763034,38.486096251245655,0.04417789648933401,2107.743118286133,622.2558889389038,2625.8449745178223,86183,9270,76913,76913,0,10,9619000.0
9619,9619999,21.980530618329414,38.48677672922113,0.044175518920044676,2108.058525085449,622.3191304206848,2626.3087730407715,86197,9271,76926,76926,0,10,9620000.0
9620,9620999,21.981334719549988,38.488568543658175,0.0441746369301651,2108.3744394779205,622.3824656009674,2626.707935333252,86207,9272,76935,76935,0,10,9621000.0
9621,9621999,21.982330201043933,38.49213321622071,0.04417349100464718,2108.8663804531097,622.4448983669281,2627.007957458496,86213,9274,76939,76939,0,10,9622000.0
9622,9622999,21.98350195852566,38.495224848997644,0.044180147303579664,2109.1815152168274,622.5070950984955,2627.315963745117,86216,9275,76941,76941,0,10,9623000.0
9623,9623999,21.984877153111928,38.498193490836236,0.04418380216086315,2109.3079352378845,622.5686604976654,2627.786708831787,86217,9275,76942,76942,0,10,9624000.0
9624,9624999,21.986206229076963,38.50196496202214,0.04418722422935528,2109.4210913181305,622.6308486461639,2628.1732444763184,86217,9275,76942,76942,0,10,9625000.0
9625,9625999,21.98770286777845,38.505145302589746,0.04420624900047376,2109.7257907390594,622.693794965744,2628.4745597839355,86219,9276,76943,76943,0,10,9626000.0
9626,9626999,21.988976442097965,38.50897747219357,0.044211313826373666,2109.839179754257,622.7564127445221,2628.891647338867,86219,9276,76943,76943,0,10,9627000.0
9627,9627999,21.990349954589608,38.51179533813002,0.04422669133889834,2110.330379486084,622.8184349536896,2629.157299041748,86233,9278,76955,76955,0,10,9628000.0
9628,9628999,21.991681948298602,38.51423225294584,0.04424542482435212,2110.443596601486,622.8785479068756,2629.4886436462402,86233,9278,76955,76955,0,10,9629000.0
9629,9629999,21.993625341592555,38.51761240298417,0.04427389220666267,2110.557243347168,622.9406294822693,2630.0178871154785,86234,9278,76956,76956,0,10,9630000.0
9630,9630999,21.995251708913187,38.521243023438224,0.04429929748499839,2110.8658409118652,623.0026710033417,2630.54594039917,86247,9279,76968,76968,0,10,9631000.0
9631,9631999,21.997292895927533,38.52547185132768,0.044330345338135624,2110.9908804893494,623.0638978481293,2630.9396781921387,86247,9279,76968,76968,0,10,9632000.0
9632,9632999,21.998971187214806,38.528748254739206,0.044360490871538594,2111.515420436859,623.1266868114471,2631.189407348633,86261,9281,76980,76980,0,10,9633000.0
9633,9633999,21.99986830950562,38.529605269097054,0.044385789623931915,2111.6360387802124,623.1873898506165,2631.6084365844727,86261,9281,76980,76980,0,10,9634000.0
9634,9634999,21.999917069905507,38.52962557138993,0.044389338986121296,2111.9437007904053,623.2498300075531,2632.659698486328,86268,9282,76986,76986,0,10,9635000.0
9635,9635999,21.999495122606458,38.529643324033415,0.04438817619888791,2112.0747168064117,623.3135197162628,2633.4430198669434,86268,9282,76986,76986,0,10,9636000.0
9636,9636999,21.999090373193702,38.5296719290868,0.0443871561167285,2112.386394739151,623.3770298957825,2633.8656692504883,86275,9283,76992,76992,0,10,9637000.0
9637,9637999,21.99874346732647,38.52955359725307,0.044385435675981855,2112.699069261551,623.4401326179504,2634.368667602539,86278,9284,76994,76994,0,10,9638000.0
9638,9638999,21.99822510976987,38.528624277048735,0.04438445673726443,2113.0080423355103,623.5028285980225,2634.7226791381836,86280,9285,76995,76995,0,10,9639000.0
9639,9639999,21.997802514959854,38.52763515275793,0.04438284689751815,2113.327516078949,623.5665292739868,2635.1416397094727,86292,9286,77006,77006,0,10,9640000.0
9640,9640999,21.997431610064023,38.52680716379319,0.04438093988971614,2113.6457974910736,623.6283249855042,2635.5100593566895,86304,9287,77017,77017,0,10,9641000.0
9641,9641999,21.997134288356616,38.528004577205294,0.04437429744868393,2113.9614856243134,623.6920943260193,2635.742588043213,86316,9288,77028,77028,0,10,9642000.0
9642,9642999,21.996828173248836,38.527262476151726,0.04437115135144265,2114.0959646701813,623.7560412883759,2636.148738861084,86317,9288,77029,77029,0,10,9643000.0
9643,9643999,21.996634730559382,38.526687770494135,0.04436714590869961,2114.4205763339996,623.8196558952332,2636.444984436035,86329,9289,77040,77040,0,10,9644000.0
9644,9644999,21.99648935294962,38.52759019054482,0.044362751379559806,2114.914230823517,623.8816962242126,2636.5474739074707,86343,9291,77052,77052,0,10,9645000.0
9645,9645999,21.996219621036364,38.5267415870917,0.04435941302330981,2115.2273519039154,623.9455668926239,2636.852306365967,86355,9292,77063,77063,0,10,9646000.0
9646,9646999,21.995966775505217,38.52569285157576,0.04435748574381049,2115.553256034851,624.010039806366,2637.234401702881,86362,9293,77069,77069,0,10,9647000.0
9647,9647999,21.995897950439534,38.52495950903229,0.044355579103391385,2115.668820619583,624.0724101066589,2637.704086303711,86362,9293,77069,77069,0,10,9648000.0
9648,9648999,21.995694749794477,38.52381363866897,0.044351843412525516,2116.1745619773865,624.1349368095398,2637.9500617980957,86386,9295,77091,77091,0,10,9649000.0
9649,9649999,21.995440005759576,38.52268765528262,0.04434864266777061,2116.675308704376,624.1970703601837,2638.198097229004,86400,9297,77103,77103,0,10,9650000.0
9650,9650999,21.995086434219516,38.521513782882565,0.04434582128284614,2116.803782939911,624.2600936889648,2638.7725982666016,86400,9297,77103,77103,0,10,9651000.0
9651,9651999,21.994463102808215,38.52043573585954,0.04435144364781296,2116.932868242264,624.3250830173492,2640.090721130371,86405,9297,77108,77108,0,10,9652000.0
9652,9652999,21.993722263741855,38.51913540015186,0.04435769310762527,2117.2573244571686,624.3874728679657,2640.8921813964844,86408,9298,77110,77110,0,10,9653000.0
9653,9653999,21.992898644526086,38.517609903938705,0.044364053903063305,2117.375522375107,624.4486241340637,2641.5066146850586,86408,9298,77110,77110,0,10,9654000.0
9654,9654999,21.992178318228667,38.51633836674889,0.04436825184869442,2117.6963229179382,624.5112915039062,2641.909996032715,86421,9299,77122,77122,0,10,9655000.0
9655,9655999,21.991512143550317,38.51522101264824,0.044371193299719947,2117.8107419013977,624.571685552597,2642.352684020996,86421,9299,77122,77122,0,10,9656000.0
9656,9656999,21.99088716154137,38.51404715662252,0.04437509519549332,2117.9341056346893,624.6372809410095,2642.8154220581055,86422,9299,77123,77123,0,10,9657000.0
9657,9657999,21.99027525568164,38.51303719367379,0.044376257992435275,2118.0538082122803,624.7023484706879,2643.3114624023438,86424,9299,77125,77125,0,10,9658000.0
9658,9658999,21.98979239568641,38.511986464462936,0.04437751177611571,2118.365052461624,624.765872001648,2643.5895652770996,86431,9300,77131,77131,0,10,9659000.0
9659,9659999,21.98929695767429,38.51087779276134,0.044379696471631314,2118.6814925670624,624.8282973766327,2643.983657836914,86438,9301,77137,77137,0,10,9660000.0
9660,9660999,21.989063493053212,38.51010603951643,0.04437771547238534,2118.9956936836243,624.8905694484711,2644.3698387145996,86450,9302,77148,77148,0,10,9661000.0
9661,9661999,21.988737346570375,38.50922719405277,0.044375540431468075,2119.5082211494446,624.9536430835724,2644.5990676879883,86459,9304,77155,77155,0,10,9662000.0
9662,9662999,21.988403833370306,38.50839616836145,0.04437347556672433,2119.8318207263947,625.0175440311432,2644.9905281066895,86474,9305,77169,77169,0,10,9663000.0
9663,9663999,21.98828186393221,38.50783511452562,0.04437133557976758,2119.9537465572357,625.0804183483124,2645.437488555908,86475,9305,77170,77170,0,10,9664000.0
9664,9664999,21.98817309485855,38.50726131946719,0.04436511916614583,2120.0824930667877,625.1446440219879,2645.758399963379,86475,9305,77170,77170,0,10,9665000.0
9665,9665999,21.988118255332356,38.50684447607188,0.04435637529854741,2120.3817393779755,625.206200838089,2646.067226409912,86483,9306,77177,77177,0,10,9666000.0
9666,9666999,21.988191586311544,38.507028213617474,0.044349072374528564,2120.7021458148956,625.2710535526276,2646.454704284668,86491,9307,77184,77184,0,10,9667000.0
9667,9667999,21.988122319970458,38.50634156634032,0.044344610842187215,2121.3891501426697,625.3339982032776,2646.616596221924,86546,9310,77236,77236,0,10,9668000.0
9668,9668999,21.987792660735064,38.50530375938897,0.04434023927511277,2121.515862226486,625.3946776390076,2646.9358444213867,86547,9310,77237,77237,0,10,9669000.0
9669,9669999,21.987371790844165,38.50413915069189,0.04433711597270895,2121.826758623123,625.4571540355682,2647.136219024658,86554,9311,77243,77243,0,10,9670000.0
9670,9670999,21.986755316131482,38.5028372855055,0.04434072180916848,2122.1406066417694,625.5188980102539,2648.099437713623,86562,9312,77250,77250,0,10,9671000.0
9671,9671999,21.985749339214532,38.50146934999171,0.044348902938852075,2122.262474298477,625.5816855430603,2648.8164863586426,86562,9312,77250,77250,0,10,9672000.0
9672,9672999,21.985056285611705,38.500891406067886,0.044351815715072185,2122.3805260658264,625.6432745456696,2649.373908996582,86564,9312,77252,77252,0,10,9673000.0
9673,9673999,21.984286935046278,38.49975650697434,0.044354585949390346,2122.5092792510986,625.7066769599915,2649.8922576904297,86564,9312,77252,77252,0,10,9674000.0
9674,9674999,21.983609549432053,38.498929109458956,0.04435649773549344,2122.827393770218,625.7690606117249,2650.1856651306152,86570,9313,77257,77257,0,10,9675000.0
9675,9675999,21.98296393257788,38.497803627016026,0.04435825774242241,2122.940655231476,625.8304255008698,2650.5451316833496,86570,9313,77257,77257,0,10,9676000.0
9676,9676999,21.982468828018835,38.49677657592172,0.04435791223304819,2123.0593893527985,625.8921689987183,2651.031826019287,86570,9313,77257,77257,0,10,9677000.0
9677,9677999,21.981955547853214,38.495861505250296,0.04435773857963943,2123.180939912796,625.9526963233948,2651.4176635742188,86571,9313,77258,77258,0,10,9678000.0
9678,9678999,21.981491865115927,38.494992297668134,0.04435901922314778,2123.680056333542,626.0148048400879,2651.578639984131,86585,9315,77270,77270,0,10,9679000.0
9679,9679999,21.981024025670283,38.49425682255736,0.04435749897355412,2123.99694108963,626.076990365982,2651.9914207458496,86597,9316,77281,77281,0,10,9680000.0
9680,9680999,21.980554338323667,38.493260686767236,0.044357487429484754,2124.1077601909637,626.1370558738708,2652.326572418213,86597,9316,77281,77281,0,10,9681000.0
9681,9681999,21.980115282669356,38.49227691744686,0.04435702448525369,2124.784317970276,626.1990058422089,2652.499755859375,86628,9319,77309,77309,0,10,9682000.0
9682,9682999,21.98006782216797,38.49289405977785,0.044351069017312006,2124.915426969528,626.2615523338318,2652.866973876953,86628,9319,77309,77309,0,10,9683000.0
9683,9683999,21.97980542813764,38.49208092343831,0.04435038359044707,2125.0337557792664,626.3226199150085,2653.1673431396484,86628,9319,77309,77309,0,10,9684000.0
9684,9684999,21.979589102914215,38.49121062895296,0.04434614863875319,2125.334883928299,626.3835875988007,2653.340476989746,86640,9320,77320,77320,0,10,9685000.0
9685,9685999,21.97940328890313,38.49039945543779,0.044341183618530455,2125.642625808716,626.4456470012665,2653.686637878418,86644,9321,77323,77323,0,10,9686000.0
9686,9686999,21.979227879782137,38.4896718163163,0.04433430876230038,2126.1456236839294,626.5085973739624,2653.9275665283203,86652,9323,77329,77329,0,10,9687000.0
9687,9687999,21.97922752623259,38.489065465347416,0.04433179664945086,2126.275130033493,626.5696332454681,2654.1780128479004,86653,9323,77330,77330,0,10,9688000.0
9688,9688999,21.979098007114093,38.48834448883355,0.04432883918849506,2126.402770757675,626.6311974525452,2654.556369781494,86654,9323,77331,77331,0,10,9689000.0
9689,9689999,21.978587314451413,38.48721967543658,0.04432682924108666,2126.708680152893,626.6934311389923,2654.898162841797,86656,9324,77332,77332,0,10,9690000.0
9690,9690999,21.97805363786653,38.48592886804559,0.044327878736740156,2127.2025582790375,626.7546148300171,2655.3672523498535,86666,9326,77340,77340,0,10,9691000.0
9691,9691999,21.977360449169268,38.48470466461105,0.04432899269657864,2127.3282392024994,626.8192355632782,2656.142776489258,86667,9326,77341,77341,0,10,9692000.0
9692,9692999,21.97661602193685,38.4833926443298,0.04433305556651557,2127.6444771289825,626.8811304569244,2656.552463531494,86675,9327,77348,77348,0,10,9693000.0
9693,9693999,21.976292015332128,38.48292537259522,0.04432947354438799,2127.962881088257,626.9455344676971,2656.9111366271973,86677,9328,77349,77349,0,10,9694000.0
9694,9694999,21.97577583965998,38.48178219913493,0.04432910902291809,2128.475557088852,627.0088760852814,2657.1678047180176,86684,9330,77354,77354,0,10,9695000.0
9695,9695999,21.97556031684439,38.48108411147103,0.044325547884574656,2128.601945400238,627.0722663402557,2657.506866455078,86684,9330,77354,77354,0,10,9696000.0
9696,9696999,21.975236710503275,38.4801457939728,0.04432345483482758,2128.9059042930603,627.1343224048615,2657.80802154541,86694,9331,77363,77363,0,10,9697000.0
9697,9697999,21.974931655902417,38.47930507456605,0.04432209632868678,2129.2212867736816,627.1961073875427,2658.1241302490234,86706,9332,77374,77374,0,10,9698000.0
9698,9698999,21.974699238314518,38.47863736726526,0.044317941425000784,2129.5256140232086,627.2578983306885,2658.332389831543,86720,9333,77387,77387,0,10,9699000.0
9699,9699999,21.974348862216953,38.47749508596519,0.04431574943647354,2129.639094352722,627.3193635940552,2658.674919128418,86720,9333,77387,77387,0,10,9700000.0
9700,9700999,21.97397543400252,38.476316584098946,0.04431360675525864,2129.760054588318,627.3812692165375,2659.0016326904297,86720,9333,77387,77387,0,10,9701000.0
9701,9701999,21.973657200448788,38.47518529291391,0.044310765471019975,2130.0675914287567,627.444620847702,2659.195945739746,86732,9334,77398,77398,0,10,9702000.0
9702,9702999,21.973353563649855,38.474387195973726,0.044307244731880746,2131.1539976596832,627.5082015991211,2659.1716499328613,86791,9339,77452,77452,0,10,9703000.0
9703,9703999,21.97328954230493,38.47838703660771,0.044293506762372314,2131.670672416687,627.5772738456726,2659.4589309692383,86805,9341,77464,77464,0,10,9704000.0
9704,9704999,21.973148807673887,38.4785149569416,0.04428638721171696,2131.7894966602325,627.6412196159363,2659.752239227295,86805,9341,77464,77464,0,10,9705000.0
9705,9705999,21.972944199914792,38.477417574300276,0.044280678958948494,2131.91322016716,627.7027096748352,2660.1111335754395,86805,9341,77464,77464,0,10,9706000.0
9706,9706999,21.9726571491411,38.476315652483926,0.04427605511963384,2132.4086866378784,627.7662720680237,2660.4333000183105,86825,9343,77482,77482,0,10,9707000.0
9707,9707999,21.972294775466974,38.475048885048565,0.04427361436332289,2132.721557855606,627.8282284736633,2660.684467315674,86837,9344,77493,77493,0,10,9708000.0
9708,9708999,21.97203977763727,38.473936006947255,0.04426900446167237,2133.2232053279877,627.8896770477295,2660.79931640625,86860,9346,77514,77514,0,10,9709000.0
9709,9709999,21.971811758926705,38.47281856027825,0.04426266014715752,2133.540066719055,627.9511640071869,2661.064872741699,86862,9347,77515,77515,0,10,9710000.0
9710,9710999,21.971149423216396,38.471675443099215,0.044265964895318644,2133.662357568741,628.0130641460419,2662.1145515441895,86865,9347,77518,77518,0,10,9711000.0
9711,9711999,21.970174566685554,38.47034064727152,0.04426985229302549,2133.7796416282654,628.0752468109131,2662.7554512023926,86866,9347,77519,77519,0,10,9712000.0
9712,9712999,21.969292142632117,38.46912351803879,0.04427461294310209,2134.301041126251,628.1399238109589,2663.1002616882324,86870,9349,77521,77521,0,10,9713000.0
9713,9713999,21.968562641808596,38.468167177115234,0.04427732652497329,2134.639693260193,628.2101607322693,2663.541332244873,86882,9350,77532,77532,0,10,9714000.0
9714,9714999,21.967888274665103,38.467099611513994,0.04427981150755356,2134.947147130966,628.2720203399658,2663.854278564453,86895,9351,77544,77544,0,10,9715000.0
9715,9715999,21.967363722942267,38.46601386417443,0.044281637083288916,2135.070925474167,628.3335673809052,2664.1462173461914,86895,9351,77544,77544,0,10,9716000.0
9716,9716999,21.966721656764115,38.46472205993843,0.044284001984971844,2135.1925320625305,628.3957934379578,2664.5026092529297,86895,9351,77544,77544,0,10,9717000.0
9717,9717999,21.966034060675764,38.463442187225645,0.04428595829588955,2135.5105390548706,628.4601700305939,2664.8554725646973,86897,9352,77545,77545,0,10,9718000.0
9718,9718999,21.96553696194411,38.462454992844826,0.044286263603812714,2135.6297993659973,628.5232195854187,2665.13431930542,86898,9352,77546,77546,0,10,9719000.0
9719,9719999,21.96504603288617,38.46139010439345,0.04428828105532212,2136.124022960663,628.5836102962494,2665.298469543457,86917,9354,77563,77563,0,10,9720000.0
9720,9720999,21.964731944670103,38.460651452699565,0.0442891424676245,2136.24138879776,628.6465382575989,2665.6388549804688,86917,9354,77563,77563,0,10,9721000.0
9721,9721999,21.964360062826007,38.459822411647146,0.04429071118505157,2136.369873523712,628.7094836235046,2665.830966949463,86917,9354,77563,77563,0,10,9722000.0
9722,9722999,21.963976040997835,38.4589364462952,0.044290737164851435,2137.0592222213745,628.771669626236,2666.0235633850098,86929,9357,77572,77572,0,10,9723000.0
9723,9723999,21.963884224453782,38.45844002365881,0.044292881866977774,2137.1780304908752,628.8341379165649,2666.373779296875,86929,9357,77572,77572,0,10,9724000.0
9724,9724999,21.963745787166577,38.45791530420919,0.044293128082314004,2137.488726377487,628.8959381580353,2666.6075439453125,86941,9358,77583,77583,0,10,9725000.0
9725,9725999,21.96386895238588,38.457923268452305,0.04429742172381035,2137.625160932541,628.970921754837,2666.9594383239746,86941,9358,77583,77583,0,10,9726000.0
9726,9726999,21.964202121791576,38.45799720276926,0.04430026702277967,2137.9376339912415,629.032880783081,2667.3436851501465,86948,9359,77589,77589,0,10,9727000.0
9727,9727999,21.964656705734342,38.458344347150685,0.044302491911917374,2138.2564153671265,629.0951116085052,2667.6167793273926,86960,9360,77600,77600,0,10,9728000.0
9728,9728999,21.964884319694555,38.458197656923886,0.04430321578708252,2138.3810732364655,629.1555109024048,2667.9522247314453,86960,9360,77600,77600,0,10,9729000.0
9729,9729999,21.96473450156992,38.45789360260282,0.04430567484456993,2138.6905541419983,629.2171671390533,2668.1817932128906,86963,9361,77602,77602,0,10,9730000.0
9730,9730999,21.9640268426644,38.456899090192294,0.04430864105563126,2138.998153924942,629.27845287323,2669.3298988342285,86976,9362,77614,77614,0,10,9731000.0
9731,9731999,21.96289114163197,38.455457767804354,0.04431508865974587,2139.3099341392517,629.341427564621,2669.9225120544434,86988,9363,77625,77625,0,10,9732000.0
9732,9732999,21.961938424361694,38.45410830486426,0.04431570254453665,2139.9918851852417,629.4047338962555,2670.406524658203,87007,9366,77641,77641,0,10,9733000.0
9733,9733999,21.961018297027632,38.452694174853505,0.044319941663171214,2140.303549528122,629.4684293270111,2670.743522644043,87019,9367,77652,77652,0,10,9734000.0
9734,9734999,21.96012808652099,38.45145258616181,0.0443215917952583,2140.6090285778046,629.5304117202759,2671.0205039978027,87032,9368,77664,77664,0,10,9735000.0
9735,9735999,21.9591967337855,38.450017028883,0.04432547329851333,2141.101081132889,629.592041015625,2671.2729721069336,87056,9370,77686,77686,0,10,9736000.0
9736,9736999,21.9583017479539,38.44858562069954,0.04432860945385664,2141.6117901802063,629.6556951999664,2671.57572555542,87080,9372,77708,77708,0,10,9737000.0
9737,9737999,21.957340797932186,38.44706477200485,0.04433353457678668,2142.3113441467285,629.7196745872498,2671.864803314209,87135,9375,77760,77760,0,10,9738000.0
9738,9738999,21.956549650229924,38.44578438270975,0.04433601409170029,2142.6203322410583,629.7808470726013,2672.1532669067383,87147,9376,77771,77771,0,10,9739000.0
9739,9739999,21.955873142255847,38.44479255886166,0.04433729277935028,2142.9345693588257,629.8441925048828,2672.49373626709,87159,9377,77782,77782,0,10,9740000.0
9740,9740999,21.955306666986452,38.44378198620353,0.04433905377990943,2143.057497024536,629.9079103469849,2672.899631500244,87159,9377,77782,77782,0,10,9741000.0
9741,9741999,21.954738924087323,38.44280928009437,0.044338382667924,2143.1722700595856,629.9703094959259,2673.1526107788086,87159,9377,77782,77782,0,10,9742000.0
9742,9742999,21.954150739732412,38.441734488442215,0.04433615424581405,2143.4784626960754,630.0333442687988,2673.5382385253906,87165,9378,77787,77787,0,10,9743000.0
9743,9743999,21.953615038664225,38.440685346333694,0.044334136763859666,2143.5915229320526,630.0945744514465,2673.9577674865723,87166,9378,77788,77788,0,10,9744000.0
9744,9744999,21.9531400816537,38.43976943072031,0.044333628202309794,2144.0835638046265,630.1563239097595,2674.169692993164,87192,9380,77812,77812,0,10,9745000.0
9745,9745999,21.952834787417384,38.4391482080538,0.044331628721917093,2144.5832602977753,630.218713760376,2674.4453163146973,87216,9382,77834,77834,0,10,9746000.0
9746,9746999,21.95242165914228,38.438369244256165,0.04432919202668406,2144.706659078598,630.2820882797241,2674.9509086608887,87216,9382,77834,77834,0,10,9747000.0
9747,9747999,21.952109298606103,38.437455701639124,0.044326289234486005,2145.4034419059753,630.3436427116394,2675.0431365966797,87252,9385,77867,77867,0,10,9748000.0
9748,9748999,21.95169419944678,38.43660621079404,0.04432347783968649,2145.708034992218,630.404185295105,2675.3476066589355,87259,9386,77873,77873,0,10,9749000.0
9749,9749999,21.951252512362988,38.43560825204802,0.04432096259382812,2146.2131583690643,630.4671950340271,2675.589973449707,87283,9388,77895,77895,0,10,9750000.0
9750,9750999,21.950783217191063,38.43449637311667,0.04432242054052382,2146.5276560783386,630.5294497013092,2676.32426071167,87296,9389,77907,77907,0,10,9751000.0
9751,9751999,21.949802535730157,38.43309427857053,0.04432575376386838,2146.6447463035583,630.5914919376373,2677.0127601623535,87296,9389,77907,77907,0,10,9752000.0
9752,9752999,21.948970527477986,38.43192570596027,0.04432717921565854,2146.9600450992584,630.6531846523285,2677.484359741211,87308,9390,77918,77918,0,10,9753000.0
9753,9753999,21.948274620334477,38.430856891095,0.04432920467551993,2147.655974626541,630.715075969696,2677.834648132324,87325,9393,77932,77932,0,10,9754000.0
9754,9754999,21.94757477299589,38.43046464995965,0.04432619690060213,2147.7782640457153,630.7771339416504,2678.16597366333,87325,9393,77932,77932,0,10,9755000.0
9755,9755999,21.946924380944445,38.429645137327675,0.044326718841621204,2148.083924293518,630.8387351036072,2678.497169494629,87337,9394,77943,77943,0,10,9756000.0
9756,9756999,21.94632940357076,38.42865336158439,0.044326942563730265,2148.408197402954,630.9003903865814,2678.8500328063965,87349,9395,77954,77954,0,10,9757000.0
9757,9757999,21.945790820965623,38.427660040647005,0.044328865979787024,2149.1450650691986,630.9648475646973,2679.025978088379,87365,9398,77967,77967,0,10,9758000.0
9758,9758999,21.94539523146918,38.42727703030342,0.044333094990913535,2149.2580919265747,631.0256373882294,2679.4370613098145,87365,9398,77967,77967,0,10,9759000.0
9759,9759999,21.94501786088519,38.426797867235685,0.04433536705923968,2149.3803708553314,631.0895547866821,2679.811336517334,87365,9398,77967,77967,0,10,9760000.0
9760,9760999,21.944817258436593,38.42668985381071,0.04433912163429177,2149.7027530670166,631.1516804695129,2679.9802780151367,87381,9399,77982,77982,0,10,9761000.0
9761,9761999,21.94474781233096,38.42715214177557,0.04434338300635521,2149.8406031131744,631.215345621109,2680.4063720703125,87381,9399,77982,77982,0,10,9762000.0
9762,9762999,21.94467540121187,38.42715110005106,0.044348216627019155,2150.1660282611847,631.276614189148,2680.678550720215,87383,9400,77983,77983,0,10,9763000.0
9763,9763999,21.944877968668266,38.427667639954365,0.04435090297289512,2150.889431476593,631.3397090435028,2680.775848388672,87409,9403,78006,78006,0,10,9764000.0
9764,9764999,21.944794502179185,38.42737674678175,0.044350541732812165,2151.020984649658,631.4048385620117,2681.2310943603516,87410,9403,78007,78007,0,10,9765000.0
9765,9765999,21.94520312206963,38.42815055205011,0.0443556527634702,2151.5570738315582,631.468095779419,2681.513858795166,87434,9405,78029,78029,0,10,9766000.0
9766,9766999,21.945578504618226,38.42872041497613,0.04435525289189357,2151.6765010356903,631.53160405159,2682.024833679199,87434,9405,78029,78029,0,10,9767000.0
9767,9767999,21.94582051684584,38.42975863192577,0.044357243547020975,2152.195079088211,631.593427658081,2682.2332305908203,87448,9407,78041,78041,0,10,9768000.0
9768,9768999,21.946374279361063,38.43097834328438,0.044361401924132626,2152.5380716323853,631.6586918830872,2682.629596710205,87460,9408,78052,78052,0,10,9769000.0
9769,9769999,21.94658668394563,38.43098503168726,0.04435783555221007,2153.285816669464,631.7233307361603,2682.914649963379,87481,9411,78070,78070,0,10,9770000.0
9770,9770999,21.94652296984286,38.43073053124161,0.04435504741758545,2153.3996126651764,631.7859334945679,2683.2907905578613,87481,9411,78070,78070,0,10,9771000.0
9771,9771999,21.946055865348807,38.42990842592261,0.04435013605324056,2153.936355829239,631.850444316864,2684.5188751220703,87500,9413,78087,78087,0,10,9772000.0
9772,9772999,21.945603630898482,38.42919366186762,0.04434549819334144,2154.0577342510223,631.9141118526459,2685.264736175537,87502,9413,78089,78089,0,10,9773000.0
9773,9773999,21.945211932307053,38.42833579701264,0.044338391667386845,2154.3933124542236,631.979250907898,2685.787815093994,87517,9414,78103,78103,0,10,9774000.0
9774,9774999,21.944675702567114,38.42718886960584,0.044334726657843104,2154.925897359848,632.0427606105804,2686.169418334961,87542,9416,78126,78126,0,10,9775000.0
9775,9775999,21.944191425867274,38.42608786609908,0.04433525502623481,2155.051894903183,632.1057333946228,2686.612651824951,87542,9416,78126,78126,0,10,9776000.0
9776,9776999,21.943689434411702,38.42501842245967,0.04433250906035047,2155.577471971512,632.1686811447144,2687.0237731933594,87559,9418,78141,78141,0,10,9777000.0
9777,9777999,21.943208084232246,38.423789554058565,0.04432626413998997,2155.906362056732,632.2303605079651,2687.454963684082,87571,9419,78152,78152,0,10,9778000.0
9778,9778999,21.94274457576143,38.42267178543235,0.0443224595292836,2156.0351746082306,632.2938046455383,2687.970516204834,87572,9419,78153,78153,0,10,9779000.0
9779,9779999,21.942391884619653,38.421734227319696,0.04431715903576705,2156.156943798065,632.3556361198425,2688.3581161499023,87573,9419,78154,78154,0,10,9780000.0
9780,9780999,21.94201074615719,38.42060977086295,0.04431312320924152,2156.4851503372192,632.4195146560669,2688.8570823669434,87586,9420,78166,78166,0,10,9781000.0
9781,9781999,21.941613035641787,38.41940979103939,0.044307373266814776,2156.824586391449,632.4838600158691,2689.2910499572754,87601,9421,78180,78180,0,10,9782000.0
9782,9782999,21.941337710704822,38.41831863655604,0.04430361495971957,2157.3568115234375,632.5460510253906,2689.684196472168,87626,9423,78203,78203,0,10,9783000.0
9783,9783999,21.941310020774146,38.41877053254806,0.04429376558628273,2157.4818484783173,632.6085915565491,2690.212356567383,87626,9423,78203,78203,0,10,9784000.0
9784,9784999,21.941229716970163,38.41779293081195,0.04428389190161863,2158.017685651779,632.672176361084,2690.6808280944824,87640,9425,78215,78215,0,10,9785000.0
9785,9785999,21.94117529194623,38.41770535348229,0.04427577201681632,2158.1370379924774,632.7331700325012,2691.0919799804688,87640,9425,78215,78215,0,10,9786000.0
9786,9786999,21.94113273241161,38.416836206850974,0.044268492718669616,2158.4693427085876,632.7949652671814,2691.6437072753906,87653,9426,78227,78227,0,10,9787000.0
9787,9787999,21.941023684392196,38.416696883695494,0.044259308359452465,2158.79359292984,632.8558716773987,2692.4139404296875,87656,9427,78229,78229,0,10,9788000.0
9788,9788999,21.940470058002383,38.416110322102234,0.04425808952432064,2159.1439690589905,632.9202902317047,2693.5310859680176,87672,9428,78244,78244,0,10,9789000.0
9789,9789999,21.939995381645875,38.41581015299855,0.04425763067343025,2159.680633544922,632.9846312999725,2694.1310806274414,87687,9430,78257,78257,0,10,9790000.0
9790,9790999,21.939457366680013,38.41472563264,0.04425605573905367,2160.23770904541,633.0517227649689,2694.5916595458984,87713,9432,78281,78281,0,10,9791000.0
9791,9791999,21.93907969904265,38.41386704907019,0.04425305227714982,2160.369069814682,633.1165318489075,2695.077121734619,87716,9432,78284,78284,0,10,9792000.0
9792,9792999,21.93897366881893,38.41698355837331,0.04424157549804386,2160.905872821808,633.1816318035126,2695.415573120117,87741,9434,78307,78307,0,10,9793000.0
9793,9793999,21.938715760741683,38.416543199763424,0.04423555481618502,2161.031571626663,633.2449760437012,2695.8209381103516,87742,9434,78308,78308,0,10,9794000.0
9794,9794999,21.938576861540156,38.41619404431442,0.04423078190676166,2161.355810403824,633.3075621128082,2696.2048873901367,87754,9435,78319,78319,0,10,9795000.0
9795,9795999,21.938521867823646,38.41677230497588,0.04422377002294864,2161.6789634227753,633.3701798915863,2696.552314758301,87757,9436,78321,78321,0,10,9796000.0
9796,9796999,21.938491405679237,38.41648946657803,0.04422018182582266,2162.2189581394196,633.4324758052826,2696.691375732422,87776,9438,78338,78338,0,10,9797000.0
9797,9797999,21.938651854300556,38.41676457110792,0.04421903570611585,2162.3508245944977,633.4969475269318,2697.064052581787,87776,9438,78338,78338,0,10,9798000.0
9798,9798999,21.938705934539197,38.41665729072044,0.04421618948636563,2162.686675310135,633.558201789856,2697.370803833008,87788,9439,78349,78349,0,10,9799000.0
9799,9799999,21.938742411652782,38.416511303428436,0.04421103088200529,2162.811300754547,633.6213343143463,2697.6650733947754,87788,9439,78349,78349,0,10,9800000.0
9800,9800999,21.93873285567697,38.4162791809079,0.044210679323619106,2163.5307714939117,633.6833832263947,2697.878849029541,87819,9442,78377,78377,0,10,9801000.0
9801,9801999,21.93883369404421,38.4161395990135,0.044206971237182424,2163.6529841423035,633.7470469474792,2698.172550201416,87819,9442,78377,78377,0,10,9802000.0
9802,9802999,21.938968904803357,38.416086900317104,0.044202614020469544,2163.7839522361755,633.8098669052124,2698.5491790771484,87819,9442,78377,78377,0,10,9803000.0
9803,9803999,21.939044514337947,38.415962770688786,0.04419603662939531,2164.104478597641,633.8721685409546,2698.7756996154785,87831,9443,78388,78388,0,10,9804000.0
9804,9804999,21.939075667579118,38.415534575093126,0.04419419580677808,2165.022337436676,633.9339878559113,2698.9684257507324,87867,9447,78420,78420,0,10,9805000.0
9805,9805999,21.93892016552964,38.41472794136688,0.044188961395947635,2165.3557710647583,633.9958338737488,2699.211681365967,87870,9448,78422,78422,0,10,9806000.0
9806,9806999,21.938634523618546,38.41382636759963,0.0441874875179008,2165.685707807541,634.0590183734894,2699.8215141296387,87873,9449,78424,78424,0,10,9807000.0
9807,9807999,21.937682657292193,38.412650092094275,0.04419297272180078,2165.819445371628,634.121041059494,2700.782428741455,87875,9449,78426,78426,0,10,9808000.0
9808,9808999,21.936840175838885,38.4116010821546,0.044194893947812286,2165.9500827789307,634.1856248378754,2701.4172401428223,87876,9449,78427,78427,0,10,9809000.0
9809,9809999,21.936377346950025,38.41155277416862,0.04419085130957223,2166.280951023102,634.2494406700134,2701.7715072631836,87888,9450,78438,78438,0,10,9810000.0
9810,9810999,21.935871980722286,38.411267137324025,0.044187411012839295,2166.598898410797,634.3110733032227,2702.1319274902344,87890,9451,78439,78439,0,10,9811000.0
9811,9811999,21.93551498724448,38.41069358849979,0.04418584707077711,2166.7240109443665,634.372590303421,2702.4884033203125,87890,9451,78439,78439,0,10,9812000.0
9812,9812999,21.9350681868935,38.40992836848557,0.04418432667506167,2167.045035839081,634.4373471736908,2702.852798461914,87892,9452,78440,78440,0,10,9813000.0
9813,9813999,21.93483336908043,38.410098027208846,0.044180989109282365,2167.569253921509,634.5007481575012,2703.1299057006836,87905,9454,78451,78451,0,10,9814000.0
9814,9814999,21.93478184929282,38.410375811882545,0.04417430848072934,2167.9002089500427,634.5659074783325,2703.565906524658,87917,9455,78462,78462,0,10,9815000.0
9815,9815999,21.93485002882752,38.410947802810625,0.04417138227697326,2168.019329547882,634.6278898715973,2704.019763946533,87919,9455,78464,78464,0,10,9816000.0
9816,9816999,21.934951984163238,38.411357650580534,0.044170853716095526,2168.336178302765,634.6906111240387,2704.2785415649414,87930,9456,78474,78474,0,10,9817000.0
9817,9817999,21.935151602250535,38.41210243940344,0.04416880330513184,2168.658882856369,634.7523903846741,2704.6691551208496,87942,9457,78485,78485,0,10,9818000.0
9818,9818999,21.93520338586169,38.41228165528048,0.04416631308098895,2168.77876162529,634.814736366272,2705.1093101501465,87942,9457,78485,78485,0,10,9819000.0
9819,9819999,21.93525393080214,38.41228378030178,0.04416875953838262,2169.524586200714,634.877738237381,2705.1996116638184,87972,9460,78512,78512,0,10,9820000.0
9820,9820999,21.93532703816111,38.41235752178762,0.044164591861272307,2169.6577005386353,634.9409058094025,2705.600914001465,87972,9460,78512,78512,0,10,9821000.0
9821,9821999,21.935398501704228,38.412244551318224,0.04416411387302566,2169.79239654541,635.0069849491119,2705.8788414001465,87972,9460,78512,78512,0,10,9822000.0
9822,9822999,21.935545575796464,38.41219217533625,0.044162387952880966,2170.1169884204865,635.0693116188049,2706.1010551452637,87974,9461,78513,78513,0,10,9823000.0
9823,9823999,21.935693935465856,38.412136573321675,0.04416145009716155,2170.4367439746857,635.1314928531647,2706.276336669922,87976,9462,78514,78514,0,10,9824000.0
9824,9824999,21.93579071069317,38.41195557531545,0.04415502853459996,2170.7523107528687,635.1923937797546,2706.613178253174,87983,9463,78520,78520,0,10,9825000.0
9825,9825999,21.935744580848162,38.41154160284019,0.04415019321882452,2171.2793238162994,635.2584271430969,2706.812873840332,87997,9465,78532,78532,0,10,9826000.0
9826,9826999,21.935554626707226,38.4109699822759,0.0441515577174173,2171.4014852046967,635.3192031383514,2707.4582443237305,87999,9465,78534,78534,0,10,9827000.0
9827,9827999,21.934649696556043,38.40962106509235,0.044155879077875104,2171.937613964081,635.3814499378204,2708.113254547119,88015,9467,78548,78548,0,10,9828000.0
9828,9828999,21.933760640193427,38.4085498113314,0.044161475281976004,2172.465360403061,635.4442086219788,2708.6296577453613,88040,9469,78571,78571,0,10,9829000.0
9829,9829999,21.93288197558119,38.407393737685275,0.044166083062662564,2172.5887846946716,635.5078160762787,2709.0074462890625,88040,9469,78571,78571,0,10,9830000.0
9830,9830999,21.932054953749155,38.40598012285773,0.04416938011669991,2172.7066094875336,635.5704333782196,2709.2819747924805,88040,9469,78571,78571,0,10,9831000.0
9831,9831999,21.93125523642887,38.404696830333,0.044172434726425736,2172.832829475403,635.6335995197296,2709.563648223877,88040,9469,78571,78571,0,10,9832000.0
9832,9832999,21.930463640362646,38.40325901042738,0.04417606020839371,2172.964395046234,635.6963241100311,2709.84375,88040,9469,78571,78571,0,10,9833000.0
9833,9833999,21.92964641615336,38.40195690381653,0.04417902170457244,2173.2876210212708,635.7590024471283,2710.1578369140625,88047,9470,78577,78577,0,10,9834000.0
9834,9834999,21.928872783746247,38.400555944725006,0.044181419740545125,2173.6122612953186,635.8216135501862,2710.4013900756836,88059,9471,78588,78588,0,10,9835000.0
9835,9835999,21.92811703235318,38.39919433960258,0.04418411697596414,2173.7486526966095,635.8844389915466,2710.8443641662598,88060,9471,78589,78589,0,10,9836000.0
9836,9836999,21.927508766107408,38.39810581546198,0.044186205238118115,2174.26309299469,635.9469718933105,2711.082977294922,88082,9473,78609,78609,0,10,9837000.0
9837,9837999,21.926890616190374,38.39709510270629,0.044187574344206615,2174.3885247707367,636.0088095664978,2711.320056915283,88082,9473,78609,78609,0,10,9838000.0
9838,9838999,21.926504439156158,38.39628905331369,0.0441863836273757,2174.7048337459564,636.0719313621521,2711.5720863342285,88084,9474,78610,78610,0,10,9839000.0
9839,9839999,21.925989983484428,38.395196712356416,0.044189569791995065,2175.0315227508545,636.132848739624,2711.7915992736816,88090,9475,78615,78615,0,10,9840000.0
9840,9840999,21.925519893072178,38.394147027344495,0.044189940598763466,2175.549952030182,636.1960458755493,2712.012008666992,88109,9477,78632,78632,0,10,9841000.0
9841,9841999,21.92522264760872,38.39325072344233,0.04418968683832203,2175.6664083004,636.2577455043793,2712.470073699951,88109,9477,78632,78632,0,10,9842000.0
9842,9842999,21.925145970142168,38.392995827281986,0.04418937296844039,2175.7874982357025,636.3190305233002,2712.874168395996,88109,9477,78632,78632,0,10,9843000.0
9843,9843999,21.925161534795013,38.392764139730225,0.04419062218499192,2176.127856731415,636.3881866931915,2713.185474395752,88112,9478,78634,78634,0,10,9844000.0
9844,9844999,21.925379796223393,38.39276913640999,0.044188509883726246,2176.445293188095,636.4490871429443,2713.4074478149414,88124,9479,78645,78645,0,10,9845000.0
9845,9845999,21.925405285476092,38.39251706495836,0.0441866905946563,2176.5600867271423,636.5123536586761,2713.754177093506,88124,9479,78645,78645,0,10,9846000.0
9846,9846999,21.924798720475156,38.39144440518369,0.04419114736818197,2177.07186627388,636.5751307010651,2714.6422805786133,88143,9481,78662,78662,0,10,9847000.0
9847,9847999,21.92398089299278,38.39047858088995,0.04419819614351328,2177.1895005702972,636.638429403305,2715.1401138305664,88143,9481,78662,78662,0,10,9848000.0
9848,9848999,21.923264008494616,38.389221238734564,0.04420319178428844,2177.3118941783905,636.7010941505432,2715.587505340576,88144,9481,78663,78663,0,10,9849000.0
9849,9849999,21.92281010371053,38.38860050790892,0.04420980414550679,2177.437860250473,636.7666158676147,2715.9409103393555,88144,9481,78663,78663,0,10,9850000.0
9850,9850999,21.92229572409059,38.38749685606526,0.044215329345429155,2177.768191099167,636.8308081626892,2716.1926918029785,88146,9482,78664,78664,0,10,9851000.0
9851,9851999,21.922000481782323,38.386757094309786,0.04422110473995089,2178.0851595401764,636.892256975174,2716.4012413024902,88159,9483,78676,78676,0,10,9852000.0
9852,9852999,21.921755318531716,38.38607876796733,0.04422290656155281,2178.4300627708435,636.9649381637573,2716.725971221924,88167,9484,78683,78683,0,10,9853000.0
9853,9853999,21.921502086970488,38.38543622789757,0.04422366455686977,2178.548870563507,637.0272538661957,2717.067070007324,88167,9484,78683,78683,0,10,9854000.0
9854,9854999,21.921221687492885,38.384719452324106,0.044225470276687884,2178.853255748749,637.0881817340851,2717.2363052368164,88179,9485,78694,78694,0,10,9855000.0
9855,9855999,21.920938175360043,38.3839346040818,0.044226633513336444,2179.5611279010773,637.1501998901367,2717.406879425049,88185,9488,78697,78697,0,10,9856000.0
9856,9856999,21.920541493172358,38.38302244752781,0.04422783858693402,2179.692830324173,637.2139086723328,2717.7337913513184,88185,9488,78697,78697,0,10,9857000.0
9857,9857999,21.920148539854917,38.38207761445936,0.04422872827243962,2180.1962883472443,637.2752850055695,2717.8429985046387,88200,9490,78710,78710,0,10,9858000.0
9858,9858999,21.919794823911733,38.38112048068052,0.04423018844528015,2180.3129391670227,637.3375897407532,2718.1462783813477,88201,9490,78711,78711,0,10,9859000.0
9859,9859999,21.91954018054197,38.38036190895845,0.04422873680501893,2180.434697151184,637.3996477127075,2718.4126052856445,88202,9490,78712,78712,0,10,9860000.0
9860,9860999,21.919443853470515,38.3822082238164,0.04422608402008266,2180.5708980560303,637.4611461162567,2718.685146331787,88202,9490,78712,78712,0,10,9861000.0
9861,9861999,21.919179636895223,38.38127924871503,0.04422421592033443,2180.887528657913,637.5260643959045,2718.8786544799805,88214,9491,78723,78723,0,10,9862000.0
9862,9862999,21.91898527379174,38.380311843879646,0.044220450083106266,2181.2228832244873,637.590324640274,2719.161334991455,88225,9492,78733,78733,0,10,9863000.0
9863,9863999,21.918934347266006,38.37970324814601,0.04421901460797084,2181.733649253845,637.6529154777527,2719.3321647644043,88246,9494,78752,78752,0,10,9864000.0
9864,9864999,21.918751538956204,38.37879115786145,0.04421441917432456,2182.057369709015,637.7149336338043,2719.594482421875,88248,9495,78753,78753,0,10,9865000.0
9865,9865999,21.91840796791088,38.377824423270695,0.04421355643587632,2182.173863172531,637.7762515544891,2719.8031463623047,88248,9495,78753,78753,0,10,9866000.0
9866,9866999,21.918041431466712,38.37770769861773,0.044211081368261906,2182.495096206665,637.8390462398529,2720.8835830688477,88254,9496,78758,78758,0,10,9867000.0
9867,9867999,21.91755537544728,38.37660679665605,0.044203973129627205,2182.8038873672485,637.9016528129578,2721.4225845336914,88260,9497,78763,78763,0,10,9868000.0
9868,9868999,21.917005590424026,38.375382292527256,0.044197801222704,2183.1221718788147,637.9644584655762,2721.826560974121,88263,9498,78765,78765,0,10,9869000.0
9869,9869999,21.916473800260313,38.37421412558378,0.04419405224695849,2183.442316055298,638.0256297588348,2722.058246612549,88266,9499,78767,78767,0,10,9870000.0
9870,9870999,21.91594914734109,38.37378703806594,0.04418917856802085,2183.7541494369507,638.0868239402771,2722.30509185791,88279,9500,78779,78779,0,10,9871000.0
9871,9871999,21.915467563664123,38.372700946062366,0.04418568663113187,2183.876777648926,638.1495954990387,2722.558792114258,88279,9500,78779,78779,0,10,9872000.0
9872,9872999,21.914957552676604,38.371570297739574,0.04418177503312537,2184.1909165382385,638.2107410430908,2722.8954582214355,88282,9501,78781,78781,0,10,9873000.0
9873,9873999,21.914463001114033,38.37072153919602,0.04418017564513166,2184.3105902671814,638.2748277187347,2723.3087615966797,88282,9501,78781,78781,0,10,9874000.0
9874,9874999,21.914017028357506,38.36953838559219,0.044175093690690836,2184.4338936805725,638.3350491523743,2723.577262878418,88282,9501,78781,78781,0,10,9875000.0
9875,9875999,21.913621086937667,38.36884957013842,0.04417086790439295,2184.565095424652,638.3977582454681,2723.892822265625,88282,9501,78781,78781,0,10,9876000.0
9876,9876999,21.913276664889683,38.36784921743159,0.04416611706811646,2185.079786300659,638.4598300457001,2724.092746734619,88288,9503,78785,78785,0,10,9877000.0
9877,9877999,21.91316728431858,38.36728006082827,0.044157158253736006,2185.4004697799683,638.5228316783905,2724.265884399414,88290,9504,78786,78786,0,10,9878000.0
9878,9878999,21.91298101088848,38.3666227338835,0.04414940454399119,2185.905523300171,638.5840072631836,2724.514762878418,88294,9506,78788,78788,0,10,9879000.0
9879,9879999,21.912858223428028,38.365770121374,0.04414045776188169,2186.0336997509003,638.646644115448,2724.863838195801,88295,9506,78789,78789,0,10,9880000.0
9880,9880999,21.912832024735458,38.365958601283566,0.04413012369479463,2186.17436671257,638.7179358005524,2725.0755729675293,88295,9506,78789,78789,0,10,9881000.0
9881,9881999,21.913037504405754,38.365409259069374,0.044110935240904814,2186.2910861968994,638.7785775661469,2725.489887237549,88295,9506,78789,78789,0,10,9882000.0
9882,9882999,21.91317031661176,38.36470803923177,0.044097239597305604,2186.602672815323,638.8397033214569,2725.835662841797,88307,9507,78800,78800,0,10,9883000.0
9883,9883999,21.913214189095925,38.36407956465344,0.04408717461106437,2186.9176013469696,638.9004528522491,2726.009521484375,88311,9508,78803,78803,0,10,9884000.0
9884,9884999,21.913173269010308,38.36322405695405,0.044076282260564925,2187.253019809723,638.9628655910492,2726.2392082214355,88323,9509,78814,78814,0,10,9885000.0
9885,9885999,21.9131852985677,38.362484826495994,0.044067966499354294,2187.3744707107544,639.025381565094,2726.528579711914,88323,9509,78814,78814,0,10,9886000.0
9886,9886999,21.912824943962878,38.36195099803559,0.04406230761448637,2187.503676891327,639.088814496994,2727.174144744873,88324,9509,78815,78815,0,10,9887000.0
9887,9887999,21.912142162318748,38.362026908070106,0.04405740992847573,2187.815136194229,639.1518785953522,2727.815341949463,88327,9510,78817,78817,0,10,9888000.0
9888,9888999,21.91145377193347,38.36074526657731,0.04405477437596017,2187.935557603836,639.2145564556122,2728.357166290283,88327,9510,78817,78817,0,10,9889000.0
9889,9889999,21.910896745668424,38.35966569194417,0.044052095754064324,2188.257164955139,639.2782528400421,2728.6703186035156,88332,9511,78821,78821,0,10,9890000.0
9890,9890999,21.91022712343599,38.35845905039276,0.04405145491916074,2188.5743596553802,639.3399121761322,2728.8442420959473,88334,9512,78822,78822,0,10,9891000.0
9891,9891999,21.909760050148382,38.357464370544726,0.04404877725132905,2189.07976102829,639.4013822078705,2729.1156730651855,88348,9514,78834,78834,0,10,9892000.0
9892,9892999,21.90927438002688,38.356353762712665,0.04404552161632014,2189.5867388248444,639.464245557785,2729.393741607666,88367,9516,78851,78851,0,10,9893000.0
9893,9893999,21.90912564776843,38.35683939463061,0.04403828811381827,2189.7169885635376,639.5267839431763,2729.7039909362793,88367,9516,78851,78851,0,10,9894000.0
9894,9894999,21.9089675860778,38.356341635449546,0.044035614516992894,2189.839318752289,639.5906732082367,2730.037628173828,88367,9516,78851,78851,0,10,9895000.0
9895,9895999,21.908786611484544,38.355837557094816,0.044034966083142835,2189.967849254608,639.6532001495361,2730.3333053588867,88367,9516,78851,78851,0,10,9896000.0
9896,9896999,21.908839384480203,38.35587837330136,0.044042382503723054,2190.290546655655,639.7142071723938,2730.4564781188965,88375,9517,78858,78858,0,10,9897000.0
9897,9897999,21.909168717419604,38.356566644850574,0.04404737503640299,2190.5996129512787,639.7754480838776,2730.7266426086426,88377,9518,78859,78859,0,10,9898000.0
9898,9898999,21.909591690298818,38.35796333897353,0.044051772184406146,2190.715489387512,639.8363447189331,2731.0977821350098,88377,9518,78859,78859,0,10,9899000.0
9899,9899999,21.91017290544268,38.358989658586495,0.044060605956731336,2191.045072078705,639.8985772132874,2731.3350257873535,88389,9519,78870,78870,0,10,9900000.0
9900,9900999,21.910807351631814,38.361079025866275,0.04406527181149733,2191.1721687316895,639.9607307910919,2731.736183166504,88389,9519,78870,78870,0,10,9901000.0
9901,9901999,21.91149254197186,38.361828113181005,0.044087307544989796,2191.2988891601562,640.0217807292938,2732.074863433838,88389,9519,78870,78870,0,10,9902000.0
9902,9902999,21.91224731097653,38.36256796325396,0.04409687179344679,2191.415368795395,640.0840167999268,2732.377944946289,88389,9519,78870,78870,0,10,9903000.0
9903,9903999,21.912976858332982,38.363205913913866,0.044100925601700314,2191.542390346527,640.1471796035767,2732.629726409912,88389,9519,78870,78870,0,10,9904000.0
9904,9904999,21.91385398302292,38.36457017707322,0.044107409600034786,2192.0437548160553,640.2082588672638,2732.8629455566406,88413,9521,78892,78892,0,10,9905000.0
9905,9905999,21.914545337870333,38.36496654499074,0.0441191515739342,2192.166123867035,640.2708430290222,2733.232490539551,88413,9521,78892,78892,0,10,9906000.0
9906,9906999,21.91485476141578,38.36496471947498,0.04411779926091797,2192.2806594371796,640.3325045108795,2733.4601669311523,88413,9521,78892,78892,0,10,9907000.0
9907,9907999,21.914132960388056,38.364086959816106,0.04411999248848697,2192.4113817214966,640.393759727478,2734.822090148926,88415,9521,78894,78894,0,10,9908000.0
9908,9908999,21.913364019265476,38.362930735688735,0.04412446875869558,2192.5244538784027,640.4545829296112,2735.375949859619,88415,9521,78894,78894,0,10,9909000.0
9909,9909999,21.912825330503235,38.36220132522506,0.04412872732468398,2193.0234146118164,640.5164082050323,2735.6726875305176,88441,9523,78918,78918,0,10,9910000.0
9910,9910999,21.91223117278077,38.36117998679343,0.04413142245914903,2193.334713935852,640.5780310630798,2736.0108489990234,88454,9524,78930,78930,0,10,9911000.0
9911,9911999,21.911591749407425,38.35987789550284,0.04413497409432898,2193.6536633968353,640.6417660713196,2736.4185104370117,88488,9525,78963,78963,0,10,9912000.0
9912,9912999,21.910921963699177,38.358560641264496,0.044137566292371866,2193.9721341133118,640.7028572559357,2736.7549781799316,88502,9526,78976,78976,0,10,9913000.0
9913,9913999,21.910435265569863,38.358129722143715,0.04413751197251503,2194.286973953247,640.7652440071106,2737.1147079467773,88514,9527,78987,78987,0,10,9914000.0
9914,9914999,21.90982388034785,38.35708228562293,0.04413863706290444,2194.6041221618652,640.8259978294373,2737.396511077881,88527,9528,78999,78999,0,10,9915000.0
9915,9915999,21.909211868386727,38.355880498951464,0.04413990715326643,2194.9202992916107,640.886688709259,2737.6392097473145,88529,9529,79000,79000,0,10,9916000.0
9916,9916999,21.90875413034141,38.35482445588877,0.04413939043177362,2195.424985408783,640.948980808258,2738.0279121398926,88545,9531,79014,79014,0,10,9917000.0
9917,9917999,21.9082166031758,38.35388188258357,0.0441385093076655,2195.731458425522,641.0098924636841,2738.3211936950684,88557,9532,79025,79025,0,10,9918000.0
9918,9918999,21.907873155368026,38.35315028770465,0.04413661763979315,2196.0471816062927,641.0714542865753,2738.570903778076,88559,9533,79026,79026,0,10,9919000.0
9919,9919999,21.907659479002767,38.3521380586415,0.044133132332819014,2196.3611171245575,641.1324536800385,2738.8488998413086,88571,9534,79037,79037,0,10,9920000.0
9920,9920999,21.907500787544222,38.35132519735351,0.04412722901494692,2196.488968849182,641.1951582431793,2739.2722930908203,88573,9534,79039,79039,0,10,9921000.0
9921,9921999,21.90720853764463,38.35018413000409,0.044125467581295874,2197.0003385543823,641.2569124698639,2739.594150543213,88597,9536,79061,79061,0,10,9922000.0
9922,9922999,21.90695571144442,38.34901377498681,0.044126066209907444,2197.1278195381165,641.3213794231415,2740.008644104004,88597,9536,79061,79061,0,10,9923000.0
9923,9923999,21.906610248099557,38.34789993029101,0.04412498511044616,2197.2478501796722,641.3814260959625,2740.450710296631,88597,9536,79061,79061,0,10,9924000.0
9924,9924999,21.905799380634054,38.346530622128704,0.044127084184252485,2197.766802072525,641.4436531066895,2741.4616508483887,88622,9538,79084,79084,0,10,9925000.0
9925,9925999,21.905179925883587,38.34547349766272,0.044128743164373097,2197.889228820801,641.5049505233765,2742.0651931762695,88623,9538,79085,79085,0,10,9926000.0
9926,9926999,21.90464750547064,38.34457776553751,0.044129627921499215,2198.402570962906,641.5667023658752,2742.319004058838,88647,9540,79107,79107,0,10,9927000.0
9927,9927999,21.904037021464898,38.34329839578051,0.044129011815743246,2198.5188331604004,641.6285452842712,2742.673049926758,88647,9540,79107,79107,0,10,9928000.0
9928,9928999,21.903519820972683,38.34212481329007,0.04412707602472743,2198.8356997966766,641.6907196044922,2742.926052093506,88659,9541,79118,79118,0,10,9929000.0
9929,9929999,21.902948408003297,38.34093765055089,0.04412464433865593,2199.1630795001984,641.7535569667816,2743.119197845459,88661,9542,79119,79119,0,10,9930000.0
9930,9930999,21.902447546828572,38.339767649447616,0.04412353383129486,2199.480961084366,641.8164496421814,2743.446174621582,88673,9543,79130,79130,0,10,9931000.0
9931,9931999,21.9019361541896,38.33864522321153,0.04412259571654742,2199.6011497974396,641.8779864311218,2743.7535362243652,88673,9543,79130,79130,0,10,9932000.0
9932,9932999,21.901523849964544,38.3376786906932,0.04412018654938177,2199.7184891700745,641.9410891532898,2743.993076324463,88674,9543,79131,79131,0,10,9933000.0
9933,9933999,21.901220632546966,38.33683683151824,0.0441203256971574,2200.049945116043,642.003741979599,2744.2156677246094,88688,9544,79144,79144,0,10,9934000.0
9934,9934999,21.901041056041084,38.336216393870416,0.044119578129841686,2200.3803708553314,642.0653018951416,2744.4654579162598,88700,9545,79155,79155,0,10,9935000.0
9935,9935999,21.90086156158302,38.335912666059045,0.04411807805221757,2200.7033879756927,642.1282885074615,2744.7208366394043,88706,9546,79160,79160,0,10,9936000.0
9936,9936999,21.900744228350685,38.335379150809345,0.044117833062631284,2200.825461626053,642.1898648738861,2745.07039642334,88706,9546,79160,79160,0,10,9937000.0
9937,9937999,21.900824278302082,38.33515346613762,0.04411526994002579,2200.956771850586,642.2538778781891,2745.3720054626465,88706,9546,79160,79160,0,10,9938000.0
9938,9938999,21.9010899395407,38.33510833247502,0.044114940734166774,2201.087012052536,642.3154213428497,2745.738025665283,88707,9546,79161,79161,0,10,9939000.0
9939,9939999,21.90125936962106,38.33516093750387,0.04411687688051669,2201.3944368362427,642.3764584064484,2745.9807357788086,88719,9547,79172,79172,0,10,9940000.0
9940,9940999,21.901313270403868,38.33480015561614,0.044118762858180394,2201.7120885849,642.4379322528839,2746.229236602783,88723,9548,79175,79175,0,10,9941000.0
9941,9941999,21.901444519993696,38.33495352958962,0.044120147033609114,2201.8308634757996,642.4982724189758,2746.605609893799,88723,9548,79175,79175,0,10,9942000.0
9942,9942999,21.9012627850277,38.33424499950197,0.04411539163091038,2201.9455053806305,642.5607919692993,2746.8538208007812,88724,9548,79176,79176,0,10,9943000.0
9943,9943999,21.900436482510642,38.33322806212814,0.04411640012976592,2202.2658088207245,642.6224944591522,2748.1999702453613,88729,9549,79180,79180,0,10,9944000.0
9944,9944999,21.899435835346573,38.332044437405294,0.04412003107956408,2203.174376010895,642.6872081756592,2748.66556930542,88747,9553,79194,79194,0,10,9945000.0
9945,9945999,21.89860905341536,38.33107974609019,0.044123235911362246,2203.497041940689,642.7493221759796,2749.1124725341797,88759,9554,79205,79205,0,10,9946000.0
9946,9946999,21.897697566558946,38.32969384353022,0.04412628346717462,2204.004266023636,642.8110089302063,2749.6111946105957,88778,9556,79222,79222,0,10,9947000.0
9947,9947999,21.8970093423292,38.32857687536613,0.04412320539878145,2204.504145860672,642.872585773468,2750.0265731811523,88791,9558,79233,79233,0,10,9948000.0
9948,9948999,21.896223441352163,38.32735250578895,0.04412366226954634,2204.616093158722,642.9334182739258,2750.3827781677246,88791,9558,79233,79233,0,10,9949000.0
9949,9949999,21.895524271009403,38.32621502549563,0.04412464593679244,2204.9418172836304,642.9971315860748,2750.873737335205,88803,9559,79244,79244,0,10,9950000.0
9950,9950999,21.894928170244143,38.32527149995812,0.0441228666924528,2205.0556597709656,643.0597944259644,2751.3588256835938,88803,9559,79244,79244,0,10,9951000.0
9951,9951999,21.894441435248762,38.32479863781874,0.04411991253303482,2205.361734867096,643.1207399368286,2751.6309547424316,88815,9560,79255,79255,0,10,9952000.0
9952,9952999,21.894030067919687,38.3240329670617,0.04411597312894111,2205.4755504131317,643.1820726394653,2752.122013092041,88815,9560,79255,79255,0,10,9953000.0
9953,9953999,21.89359016352267,38.32312213723859,0.04411302340663292,2205.5952966213226,643.2433049678802,2752.614143371582,88815,9560,79255,79255,0,10,9954000.0
9954,9954999,21.893352471351164,38.32264911315226,0.04410875791606106,2205.8979482650757,643.3042552471161,2752.9165802001953,88827,9561,79266,79266,0,10,9955000.0
9955,9955999,21.89300317999092,38.32182395426907,0.04410839796473154,2206.2022132873535,643.3654415607452,2753.3955879211426,88839,9562,79277,79277,0,10,9956000.0
9956,9956999,21.89270493300077,38.32141744495588,0.04410330787641592,2206.3202786445618,643.4275777339935,2753.895580291748,88839,9562,79277,79277,0,10,9957000.0
9957,9957999,21.892508809900825,38.32080215960219,0.044096655057981216,2206.4366896152496,643.4882862567902,2754.278106689453,88839,9562,79277,79277,0,10,9958000.0
9958,9958999,21.89234077631193,38.32034867020201,0.044094437164998945,2206.738652229309,643.5498809814453,2754.6638374328613,88851,9563,79288,79288,0,10,9959000.0
9959,9959999,21.892217134115327,38.31968971858254,0.044090730926120814,2207.0646398067474,643.6142325401306,2755.0688819885254,88863,9564,79299,79299,0,10,9960000.0
9960,9960999,21.891861356154845,38.31869455063656,0.04408916153734521,2207.374705553055,643.6759173870087,2755.460666656494,88865,9565,79300,79300,0,10,9961000.0
9961,9961999,21.891618971147324,38.31796952916842,0.044085528621506276,2207.683893442154,643.7376780509949,2755.725273132324,88877,9566,79311,79311,0,10,9962000.0
9962,9962999,21.891311949619595,38.31706236214814,0.044080520783199684,2207.9934651851654,643.799177646637,2756.089988708496,88889,9567,79322,79322,0,10,9963000.0
9963,9963999,21.890725653149893,38.31598892513797,0.0440799985136745,2208.5072586536407,643.8617312908173,2757.1128158569336,88904,9569,79335,79335,0,10,9964000.0
9964,9964999,21.889672187004425,38.31447743462676,0.04408503656161178,2209.0175631046295,643.9234125614166,2757.6993446350098,88943,9571,79372,79372,0,10,9965000.0
9965,9965999,21.888734207946914,38.313180482829736,0.04408828340913551,2209.5325076580048,643.9857296943665,2758.295566558838,88953,9573,79380,79380,0,10,9966000.0
9966,9966999,21.887881283264267,38.31192243316646,0.04409141364553271,2209.651995420456,644.0479118824005,2758.778938293457,88953,9573,79380,79380,0,10,9967000.0
9967,9967999,21.887216145809706,38.31114285384278,0.044091396687987006,2209.7658245563507,644.1086461544037,2759.1407508850098,88953,9573,79380,79380,0,10,9968000.0
9968,9968999,21.886423445028722,38.30980333936438,0.04409394932566291,2210.2731935977936,644.1714706420898,2759.412872314453,88977,9575,79402,79402,0,10,9969000.0
9969,9969999,21.88562438990082,38.3083989249032,0.04409743803004784,2210.5914170742035,644.233561038971,2759.76322555542,88989,9576,79413,79413,0,10,9970000.0
9970,9970999,21.885011763090873,38.307562640778166,0.04409827389133636,2211.1097099781036,644.2962312698364,2760.14705657959,89013,9578,79435,79435,0,10,9971000.0
9971,9971999,21.884402499599613,38.306498763524885,0.044099799168453746,2211.6108758449554,644.3584580421448,2760.341766357422,89020,9580,79440,79440,0,10,9972000.0
9972,9972999,21.883978716627652,38.30584634627127,0.04409866101364046,2212.1359186172485,644.4214985370636,2760.6773414611816,89044,9582,79462,79462,0,10,9973000.0
9973,9973999,21.883735219569303,38.30570806715826,0.04409895986864487,2212.2700803279877,644.4950377941132,2761.1121826171875,89044,9582,79462,79462,0,10,9974000.0
9974,9974999,21.883319446147752,38.30501330386046,0.04410117014778603,2212.781089067459,644.5571985244751,2761.310115814209,89061,9584,79477,79477,0,10,9975000.0
9975,9975999,21.883002101123136,38.30450211758192,0.04410653358513228,2212.9194910526276,644.6299543380737,2761.7129974365234,89061,9584,79477,79477,0,10,9976000.0
9976,9976999,21.883234779445836,38.30494471522034,0.044115342482378916,2213.2331862449646,644.6945261955261,2762.1604499816895,89075,9585,79490,79490,0,10,9977000.0
9977,9977999,21.88358474663846,38.30585544406211,0.044124590341133474,2213.7424335479736,644.7575924396515,2762.5312690734863,89100,9587,79513,79513,0,10,9978000.0
9978,9978999,21.884174894762364,38.30699661736139,0.04413796321042185,2214.0533916950226,644.8197684288025,2762.867664337158,89112,9588,79524,79524,0,10,9979000.0
9979,9979999,21.884985096480737,38.307963418529766,0.044143914540061724,2214.3695907592773,644.8820908069611,2763.175178527832,89125,9589,79536,79536,0,10,9980000.0
9980,9980999,21.885569508656232,38.30865247222714,0.0441540728016111,2214.6822180747986,644.9426574707031,2763.465995788574,89138,9590,79548,79548,0,10,9981000.0
9981,9981999,21.88655460804652,38.30998890268603,0.044165437706810695,2215.0102853775024,645.0047054290771,2763.7666091918945,89150,9591,79559,79559,0,10,9982000.0
9982,9982999,21.88700310429527,38.310316561764004,0.04417090976339444,2215.323524236679,645.0664498806,2764.0822944641113,89165,9592,79573,79573,0,10,9983000.0
9983,9983999,21.88638544677553,38.30944755930759,0.04417376635167092,2215.453858613968,645.129231929779,2765.1094665527344,89167,9592,79575,79575,0,10,9984000.0
9984,9984999,21.88548004019705,38.30845900758131,0.04417784200070518,2215.980301618576,645.1935834884644,2765.5554122924805,89191,9594,79597,79597,0,10,9985000.0
9985,9985999,21.88457858126229,38.30709930231772,0.04418337280340345,2216.2913134098053,645.2561264038086,2765.9020500183105,89193,9595,79598,79598,0,10,9986000.0
9986,9986999,21.883737286777123,38.30571738391809,0.04418683038502347,2216.819941520691,645.3185977935791,2766.1676445007324,89201,9597,79604,79604,0,10,9987000.0
9987,9987999,21.882906358038156,38.3043051163878,0.044190147362086596,2217.126573562622,645.3793914318085,2766.4924545288086,89203,9598,79605,79605,0,10,9988000.0
9988,9988999,21.882193209205482,38.3032430190996,0.044191615715684085,2217.4384298324585,645.4420721530914,2766.6853256225586,89206,9599,79607,79607,0,10,9989000.0
9989,9989999,21.881398363146463,38.30178005919264,0.04419489827565526,2217.758123397827,645.5045063495636,2766.921012878418,89218,9600,79618,79618,0,10,9990000.0
9990,9990999,21.880727739655693,38.300651304929524,0.044195593064090155,2217.8811004161835,645.5679996013641,2767.244972229004,89218,9600,79618,79618,0,10,9991000.0
9991,9991999,21.880164254235858,38.299643589495474,0.04419551843660141,2217.9949691295624,645.6298840045929,2767.487861633301,89218,9600,79618,79618,0,10,9992000.0
9992,9992999,21.879598686038534,38.30016181826325,0.044193430897708,2218.320633649826,645.6940336227417,2767.6601638793945,89230,9601,79629,79629,0,10,9993000.0
9993,9993999,21.879154048277318,38.29917718119739,0.04419127545287682,2218.4505853652954,645.7553586959839,2767.9295082092285,89231,9601,79630,79630,0,10,9994000.0
9994,9994999,21.878812500149273,38.29817354815103,0.04418808429142207,2218.5875017642975,645.8264763355255,2768.086902618408,89231,9601,79630,79630,0,10,9995000.0
9995,9995999,21.8783426503206,38.29703508094105,0.0441861458809748,2218.939493894577,645.8910181522369,2768.2979850769043,89238,9602,79636,79636,0,10,9996000.0
9996,9996999,21.87810636855633,38.29713568489409,0.04417899473373854,2219.0751609802246,645.9655683040619,2768.603935241699,89238,9602,79636,79636,0,10,9997000.0
9997,9997999,21.877790364944758,38.29637340574321,0.044174691259429966,2219.597906112671,646.0279524326324,2768.7820358276367,89251,9604,79647,79647,0,10,9998000.0
9998,9998999,21.877392934474855,38.29536712072566,0.044171620792596844,2219.9149029254913,646.0896036624908,2768.9109535217285,89263,9605,79658,79658,0,10,9999000.0
9999,9999999,21.87723710223829,38.29463140067458,0.04416434303361505,2220.049111366272,646.1525349617004,2769.2513008117676,89263,9605,79658,79658,0,10,10000000.0
10000,10000999,21.876962654492992,38.29373284543934,0.04416010966616202,2220.18318772316,646.2151803970337,2769.462677001953,89263,9605,79658,79658,0,10,10001000.0
10001,10001999,21.876684343113613,38.29292320395051,0.044156521737973686,2220.5092854499817,646.2778294086456,2769.689067840576,89271,9606,79665,79665,0,10,10002000.0
10002,10002999,21.8762562936896,38.29183315992905,0.04415345854304864,2220.642917871475,646.341347694397,2769.970043182373,89271,9606,79665,79665,0,10,10003000.0
10003,10003999,21.875556168834503,38.29052775246407,0.04415402970154647,2220.771661043167,646.4046816825867,2771.3077545166016,89276,9606,79670,79670,0,10,10004000.0
10004,10004999,21.874850512921835,38.28956360897565,0.04415118466417445,2221.10231256485,646.4713351726532,2771.930202484131,89282,9607,79675,79675,0,10,10005000.0
10005,10005999,21.874156050113157,38.28854292562481,0.044148396438354776,2221.4189422130585,646.5352220535278,2772.4813194274902,89288,9608,79680,79680,0,10,10006000.0
10006,10006999,21.87365893216507,38.288141008404864,0.044144102632195925,2221.735105752945,646.5989646911621,2772.897617340088,89301,9609,79692,79692,0,10,10007000.0
10007,10007999,21.873143859798684,38.287145447697476,0.04414108027584729,2222.0571658611298,646.6631853580475,2773.218807220459,89313,9610,79703,79703,0,10,10008000.0
10008,10008999,21.87249231354733,38.28607733590278,0.04413895203745444,2222.1739616394043,646.7251069545746,2773.5017890930176,89313,9610,79703,79703,0,10,10009000.0
10009,10009999,21.87218211830183,38.285630598181726,0.044133421199313405,2222.4844629764557,646.7876391410828,2773.852725982666,89319,9611,79708,79708,0,10,10010000.0
10010,10010999,21.871819189847805,38.28512118492216,0.04412918251174269,2222.994143486023,646.8500270843506,2774.106731414795,89343,9613,79730,79730,0,10,10011000.0
10011,10011999,21.871770538457746,38.285544961696004,0.04412156078711782,2223.707004070282,646.9130344390869,2774.2256660461426,89379,9616,79763,79763,0,10,10012000.0
10012,10012999,21.871395739984862,38.28455997596492,0.04412035922394253,2224.2309324741364,646.9759850502014,2774.582450866699,89393,9618,79775,79775,0,10,10013000.0
10013,10013999,21.871565618517803,38.28510969356628,0.04411756047812643,2224.354227542877,647.0398480892181,2774.96866607666,89394,9618,79776,79776,0,10,10014000.0
10014,10014999,21.871520017802126,38.28475612273634,0.04411674171943836,2224.6736800670624,647.1026327610016,2775.1673278808594,89406,9619,79787,79787,0,10,10015000.0
10015,10015999,21.871587505278242,38.28443599576375,0.04411554395481598,2224.7914085388184,647.1646225452423,2775.5866470336914,89407,9619,79788,79788,0,10,10016000.0
10016,10016999,21.871951649531074,38.28469841330547,0.0441169960665162,2225.108252286911,647.2278695106506,2775.9757690429688,89413,9620,79793,79793,0,10,10017000.0
10017,10017999,21.872300544522894,38.28462816339946,0.04412083779534759,2225.2183611392975,647.2884945869446,2776.2951431274414,89413,9620,79793,79793,0,10,10018000.0
10018,10018999,21.872757479512043,38.2849905176261,0.04412619713486354,2225.337746858597,647.350869178772,2776.727611541748,89413,9620,79793,79793,0,10,10019000.0
10019,10019999,21.873321522142316,38.285499236988606,0.044131022705789946,2225.459617614746,647.4132499694824,2777.176067352295,89413,9620,79793,79793,0,10,10020000.0
10020,10020999,21.873858510311166,38.28571081945824,0.044137036524290685,2225.989329099655,647.4753293991089,2777.323989868164,89437,9622,79815,79815,0,10,10021000.0
10021,10021999,21.874329093377202,38.28573907743615,0.044143284359676405,2226.3140799999237,647.5365424156189,2777.5165405273438,89443,9623,79820,79820,0,10,10022000.0
10022,10022999,21.874632425680566,38.28552210617051,0.04414753404666638,2226.831810235977,647.5978670120239,2777.788631439209,89459,9625,79834,79834,0,10,10023000.0
10023,10023999,21.87442735187309,38.28480210265476,0.044149884101462034,2226.966663837433,647.6598272323608,2778.6099014282227,89460,9625,79835,79835,0,10,10024000.0
10024,10024999,21.873496916319244,38.283603706231986,0.04415030922702057,2227.2920660972595,647.7232398986816,2779.4252967834473,89465,9626,79839,79839,0,10,10025000.0
10025,10025999,21.872797103194387,38.2833691020142,0.04414939848788357,2227.420142889023,647.7885310649872,2780.0258979797363,89465,9626,79839,79839,0,10,10026000.0
10026,10026999,21.87192019566054,38.28251613455236,0.04415189428416255,2227.940362930298,647.8516755104065,2780.4430770874023,89484,9628,79856,79856,0,10,10027000.0
10027,10027999,21.871155046437057,38.28122465247671,0.04415160472792656,2228.0643067359924,647.91495013237,2780.776866912842,89484,9628,79856,79856,0,10,10028000.0
10028,10028999,21.870413901774015,38.27995850065461,0.04415034364912063,2228.381739139557,647.9775922298431,2781.0897941589355,89493,9629,79864,79864,0,10,10029000.0
10029,10029999,21.869728224999182,38.27877845962182,0.04414915233149053,2228.4998891353607,648.0420799255371,2781.4697341918945,89493,9629,79864,79864,0,10,10030000.0
10030,10030999,21.869063511911126,38.27766994101262,0.044148808975505105,2229.0178773403168,648.1049230098724,2781.7267837524414,89517,9631,79886,79886,0,10,10031000.0
10031,10031999,21.86846797853006,38.278189591061285,0.04414652567969268,2229.1402192115784,648.1686985492706,2782.124725341797,89517,9631,79886,79886,0,10,10032000.0
10032,10032999,21.86791869823332,38.27711992199403,0.044144876592086435,2229.655839920044,648.2333278656006,2782.4342727661133,89543,9633,79910,79910,0,10,10033000.0
10033,10033999,21.867508511164274,38.276285494065455,0.044142994434236416,2229.7887375354767,648.2973701953888,2782.7560424804688,89543,9633,79910,79910,0,10,10034000.0
10034,10034999,21.867292756463197,38.27579419729568,0.04414008010828063,2230.11039018631,648.3612885475159,2783.113540649414,89555,9634,79921,79921,0,10,10035000.0
10035,10035999,21.86696406421106,38.27511210876559,0.044135833960302184,2230.625999212265,648.4244594573975,2783.384323120117,89579,9636,79943,79943,0,10,10036000.0
10036,10036999,21.867026640703894,38.27499042060413,0.04413325435993065,2230.7508795261383,648.4884378910065,2783.6586685180664,89579,9636,79943,79943,0,10,10037000.0
10037,10037999,21.867049954573886,38.27470523775583,0.04413041052299904,2231.0720801353455,648.5528783798218,2783.985252380371,89581,9637,79944,79944,0,10,10038000.0
10038,10038999,21.867084393741933,38.274206980645,0.04412830193121986,2231.213004589081,648.624064207077,2784.3707847595215,89581,9637,79944,79944,0,10,10039000.0
10039,10039999,21.86739965071405,38.274236664610946,0.04412457715990903,2231.5287668704987,648.6851534843445,2784.7228050231934,89593,9638,79955,79955,0,10,10040000.0
10040,10040999,21.867612474133917,38.273872883504616,0.04412258571904948,2232.2362570762634,648.7475960254669,2784.8560485839844,89609,9641,79968,79968,0,10,10041000.0
10041,10041999,21.867733550298233,38.27340250275753,0.04412201415432304,2232.937508583069,648.8092968463898,2785.110794067383,89645,9644,80001,80001,0,10,10042000.0
10042,10042999,21.867878334870017,38.27300672848739,0.04411962812599535,2233.2563195228577,648.873161315918,2785.4548568725586,89657,9645,80012,80012,0,10,10043000.0
10043,10043999,21.867912949407344,38.273290788306255,0.04411839284979169,2233.569291114807,648.9347991943359,2785.71573638916,89663,9646,80017,80017,0,10,10044000.0
10044,10044999,21.867462571448545,38.27228880990852,0.044108729381955536,2233.7030375003815,648.9975235462189,2786.8115577697754,89664,9646,80018,80018,0,10,10045000.0
10045,10045999,21.86725624500691,38.27284454248772,0.044093105808768907,2234.020756959915,649.0605347156525,2787.3320236206055,89676,9647,80029,80029,0,10,10046000.0
10046,10046999,21.866704689847122,38.27163008684262,0.04408631934299956,2234.339600801468,649.1223073005676,2787.7915954589844,89678,9648,80030,80030,0,10,10047000.0
10047,10047999,21.866352759334855,38.270708963628955,0.04407919615311928,2234.480694293976,649.19513463974,2788.1957664489746,89680,9648,80032,80032,0,10,10048000.0
10048,10048999,21.866131730943433,38.2713318332295,0.044064901169629245,2234.598299264908,649.2579679489136,2788.645008087158,89680,9648,80032,80032,0,10,10049000.0
10049,10049999,21.86581201662797,38.2706027736958,0.044059438942362306,2234.7253952026367,649.3201968669891,2789.0068702697754,89680,9648,80032,80032,0,10,10050000.0
10050,10050999,21.865506617463414,38.269723969985925,0.04405319511035388,2235.055364370346,649.3833816051483,2789.340789794922,89692,9649,80043,80043,0,10,10051000.0
10051,10051999,21.8652240600766,38.268947776513706,0.04404817211743828,2235.754008769989,649.4464912414551,2789.4229469299316,89708,9652,80056,80056,0,10,10052000.0
10052,10052999,21.864791129886008,38.267823709908605,0.04404527683694004,2236.271376132965,649.5103213787079,2789.6291847229004,89717,9654,80063,80063,0,10,10053000.0
10053,10053999,21.864651561033618,38.26733285812527,0.04403934275703392,2236.5963401794434,649.574545621872,2789.9584312438965,89725,9655,80070,80070,0,10,10054000.0
10054,10054999,21.864433750059117,38.26644823809471,0.04403448907891894,2236.926230430603,649.6379196643829,2790.1992225646973,89737,9656,80081,80081,0,10,10055000.0
10055,10055999,21.864279252382328,38.26570637213826,0.04403113183900875,2237.061850309372,649.7019319534302,2790.458423614502,89737,9656,80081,80081,0,10,10056000.0
10056,10056999,21.86432035065913,38.26484369408104,0.0440203721191077,2237.1860842704773,649.7643711566925,2790.7946434020996,89737,9656,80081,80081,0,10,10057000.0
10057,10057999,21.8643633519887,38.263987343308344,0.044010927228329,2237.3050792217255,649.8262782096863,2791.1457710266113,89737,9656,80081,80081,0,10,10058000.0
10058,10058999,21.86462974467912,38.263398744148766,0.04399575404054057,2237.4349904060364,649.8899555206299,2791.5987243652344,89737,9656,80081,80081,0,10,10059000.0
10059,10059999,21.86488718301754,38.26276919790463,0.04397589123474377,2237.550034761429,649.9517872333527,2791.9795265197754,89738,9656,80082,80082,0,10,10060000.0
10060,10060999,21.864743317476375,38.26175537457774,0.04397191861309768,2237.6778469085693,650.0158798694611,2792.5974617004395,89739,9656,80083,80083,0,10,10061000.0
10061,10061999,21.86424135079358,38.26129293936188,0.04397724306186335,2237.803386449814,650.0799107551575,2793.39448928833,89741,9656,80085,80085,0,10,10062000.0
10062,10062999,21.86383430930695,38.26019678300789,0.04398383198649236,2238.320886850357,650.1433317661285,2793.7566871643066,89746,9658,80088,80088,0,10,10063000.0
10063,10063999,21.863404717331413,38.2590624083547,0.043988885989679205,2238.443070411682,650.2063672542572,2794.151054382324,89747,9658,80089,80089,0,10,10064000.0
10064,10064999,21.862975644918937,38.25785232719099,0.04399350711545613,2238.7631664276123,650.2701826095581,2794.4773292541504,89762,9659,80103,80103,0,10,10065000.0
10065,10065999,21.86254396622096,38.2567064132485,0.04399704796903059,2239.296303987503,650.334278345108,2794.6457557678223,89778,9661,80117,80117,0,10,10066000.0
10066,10066999,21.862130627358777,38.25553238170611,0.043999915945451495,2239.9975802898407,650.3971495628357,2794.872097015381,89784,9664,80120,80120,0,10,10067000.0
10067,10067999,21.86180462701686,38.254648548892874,0.04400064736042786,2240.322342157364,650.4622824192047,2795.2417640686035,89786,9665,80121,80121,0,10,10068000.0
10068,10068999,21.861509253517752,38.253692888862375,0.044001759028438836,2240.852011680603,650.525538444519,2795.510929107666,89800,9667,80133,80133,0,10,10069000.0
10069,10069999,21.861218267907557,38.25268576779384,0.044002122548914446,2241.3677673339844,650.5879855155945,2795.7055053710938,89824,9669,80155,80155,0,10,10070000.0
10070,10070999,21.86108294067364,38.25177557925243,0.04399889635044374,2241.690033197403,650.6526589393616,2795.950714111328,89826,9670,80156,80156,0,10,10071000.0
10071,10071999,21.860999378836897,38.25086790945793,0.04399582460560103,2242.02498960495,650.7178871631622,2796.338478088379,89839,9671,80168,80168,0,10,10072000.0
10072,10072999,21.860940196259204,38.25003841112551,0.04399321852543814,2242.362803220749,650.7813618183136,2796.572597503662,89851,9672,80179,80179,0,10,10073000.0
10073,10073999,21.860841443775275,38.24905845357856,0.04398844915831346,2242.4886643886566,650.8445224761963,2796.9027099609375,89851,9672,80179,80179,0,10,10074000.0
10074,10074999,21.860834075018346,38.24822046800675,0.04398312225644241,2242.8009099960327,650.9063248634338,2797.1603202819824,89863,9673,80190,80190,0,10,10075000.0
10075,10075999,21.860824162421384,38.24733465293322,0.04397614767024349,2243.333080291748,650.9685599803925,2797.409076690674,89868,9675,80193,80193,0,10,10076000.0
10076,10076999,21.860577534530968,38.246667266584836,0.04397291580855345,2243.4519884586334,651.0341420173645,2797.7546768188477,89868,9675,80193,80193,0,10,10077000.0
10077,10077999,21.8599915181059,38.24580414421035,0.0439778808735527,2243.585785627365,651.1017060279846,2798.4965476989746,89872,9675,80197,80197,0,10,10078000.0
10078,10078999,21.859366200915797,38.244792671475444,0.043983419785625255,2243.9172189235687,651.1654908657074,2799.0473289489746,89880,9676,80204,80204,0,10,10079000.0
10079,10079999,21.858722734797176,38.2434383629148,0.04398925462122816,2244.2356622219086,651.2280032634735,2799.3915405273438,89893,9677,80216,80216,0,10,10080000.0
10080,10080999,21.858295213637394,38.24248203183699,0.0439915027790474,2244.758325815201,651.2910203933716,2799.6061515808105,89912,9679,80233,80233,0,10,10081000.0
10081,10081999,21.857773699633647,38.24139025940742,0.043995295145642044,2244.902312040329,651.3608984947205,2799.9307403564453,89914,9679,80235,80235,0,10,10082000.0
10082,10082999,21.857315826313954,38.24043894699978,0.043997983980703315,2245.252897977829,651.4248650074005,2800.225326538086,89925,9680,80245,80245,0,10,10083000.0
10083,10083999,21.8567919509478,38.23965531483037,0.04399787468907246,2245.5708096027374,651.4880475997925,2800.471908569336,89937,9681,80256,80256,0,10,10084000.0
10084,10084999,21.856364740035016,38.23886925053301,0.04399640863227994,2245.889479160309,651.550096988678,2800.65177154541,89943,9682,80261,80261,0,10,10085000.0
10085,10085999,21.85593707530957,38.23801080415587,0.043996016523060844,2246.208331823349,651.6129145622253,2800.861469268799,89945,9683,80262,80262,0,10,10086000.0
10086,10086999,21.855614388473285,38.237027494270116,0.0439926761657754,2246.3264305591583,651.6756558418274,2801.1317405700684,89945,9683,80262,80262,0,10,10087000.0
10087,10087999,21.855468481763456,38.23643892758307,0.0439897690357679,2246.4565098285675,651.7374618053436,2801.315185546875,89945,9683,80262,80262,0,10,10088000.0
10088,10088999,21.855252390476725,38.23602329211749,0.04398557372592904,2246.972642183304,651.7994019985199,2801.564765930176,89959,9685,80274,80274,0,10,10089000.0
10089,10089999,21.855104357847026,38.23507374685348,0.043975758678863386,2247.0947675704956,651.8618233203888,2801.92276763916,89959,9685,80274,80274,0,10,10090000.0
10090,10090999,21.854980109311878,38.23430594089709,0.043966133817643804,2247.4069287776947,651.9232485294342,2802.1135787963867,89971,9686,80285,80285,0,10,10091000.0
10091,10091999,21.85502821036454,38.23374380111387,0.043954839895422815,2247.5321173667908,651.9837398529053,2802.2786598205566,89971,9686,80285,80285,0,10,10092000.0
10092,10092999,21.854903260856766,38.23294193374378,0.043947964194943734,2247.650936603546,652.046103477478,2802.5841102600098,89971,9686,80285,80285,0,10,10093000.0
10093,10093999,21.854823335216885,38.23283600806842,0.04393832310420931,2247.7821657657623,652.1095163822174,2802.8128089904785,89971,9686,80285,80285,0,10,10094000.0
10094,10094999,21.854540259001315,38.23173813826823,0.04393112631693996,2248.5123760700226,652.1728096008301,2802.8857955932617,89988,9689,80299,80299,0,10,10095000.0
10095,10095999,21.854169408221484,38.2309483319667,0.0439268751145494,2248.8302302360535,652.2366905212402,2803.3584594726562,90003,9690,80313,80313,0,10,10096000.0
10096,10096999,21.853678729466733,38.230482725491974,0.04392701744260763,2249.164567232132,652.300895690918,2804.3661041259766,90005,9691,80314,80314,0,10,10097000.0
10097,10097999,21.852672303751845,38.229070943899494,0.04393277330129319,2249.2867753505707,652.3633313179016,2804.9814071655273,90006,9691,80315,80315,0,10,10098000.0
10098,10098999,21.85182358204188,38.22793411331929,0.043935230879862286,2249.405316591263,652.4257164001465,2805.428810119629,90006,9691,80315,80315,0,10,10099000.0
10099,10099999,21.851049181346927,38.226888836774556,0.043937499991770435,2249.9173152446747,652.4876616001129,2805.7203788757324,90021,9693,80328,80328,0,10,10100000.0
10100,10100999,21.850546489717868,38.22663702898399,0.04393528865170526,2250.035399198532,652.5487456321716,2805.978660583496,90021,9693,80328,80328,0,10,10101000.0
10101,10101999,21.849955519272534,38.22648743573466,0.04394159218664462,2250.3641407489777,652.6137022972107,2806.3479957580566,90034,9694,80340,80340,0,10,10102000.0
10102,10102999,21.849620098209,38.22729823257194,0.04393896082888804,2250.6858084201813,652.6752228736877,2806.678394317627,90047,9695,80352,80352,0,10,10103000.0
10103,10103999,21.849796557742128,38.229812903620186,0.043940021277240726,2251.2092378139496,652.741646528244,2806.867889404297,90053,9697,80356,80356,0,10,10104000.0
10104,10104999,21.850020772299317,38.231597808468244,0.043958425917297594,2251.3315472602844,652.8026645183563,2807.2387504577637,90053,9697,80356,80356,0,10,10105000.0
10105,10105999,21.850260772292014,38.23342966852548,0.043958144403722144,2251.669482946396,652.8747642040253,2807.5485763549805,90064,9698,80366,80366,0,10,10106000.0
10106,10106999,21.851057089879824,38.237267858479996,0.043955746207661295,2252.2028489112854,652.9393527507782,2807.7610778808594,90088,9700,80388,80388,0,10,10107000.0
10107,10107999,21.851899016348426,38.24050812900087,0.043959589564999124,2252.338443994522,653.0036797523499,2808.025680541992,90088,9700,80388,80388,0,10,10108000.0
10108,10108999,21.85297506718117,38.24420050434534,0.04395914942745027,2252.8465547561646,653.0675382614136,2808.2902603149414,90112,9702,80410,80410,0,10,10109000.0
10109,10109999,21.85411917311327,38.24809885897897,0.04396846659253295,2253.3568189144135,653.1304078102112,2808.568199157715,90126,9704,80422,80422,0,10,10110000.0
10110,10110999,21.8556579921294,38.25340708216582,0.04397978015548376,2253.6813127994537,653.1951367855072,2808.9108352661133,90133,9705,80428,80428,0,10,10111000.0
10111,10111999,21.857407699724295,38.259222927255614,0.04399354444511239,2254.384170293808,653.2579524517059,2809.150402069092,90154,9708,80446,80446,0,10,10112000.0
10112,10112999,21.858956838933285,38.26264926554452,0.044004533339977114,2254.708569288254,653.3202698230743,2809.555351257324,90166,9709,80457,80457,0,10,10113000.0
10113,10113999,21.860423620891687,38.265632050743704,0.044013509332580525,2255.2272336483,653.3838856220245,2809.80859375,90182,9711,80471,80471,0,10,10114000.0
10114,10114999,21.861614306625263,38.26754127236256,0.04401899618306837,2255.350253343582,653.4478702545166,2810.2901306152344,90182,9711,80471,80471,0,10,10115000.0
10115,10115999,21.86226453152595,38.26887215012437,0.04401922317680973,2256.064167737961,653.5106630325317,2810.5149421691895,90208,9714,80494,80494,0,10,10116000.0
10116,10116999,21.861551667814595,38.26806807413009,0.04402580378121401,2256.3995106220245,653.5763306617737,2812.1649742126465,90225,9715,80510,80510,0,10,10117000.0
10117,10117999,21.860936636184068,38.26773381285836,0.044023798999376806,2256.919049978256,653.6397624015808,2812.869037628174,90250,9717,80533,80533,0,10,10118000.0
10118,10118999,21.860104326994946,38.26644960063387,0.044027211302290814,2257.2386980056763,653.7032070159912,2813.323928833008,90252,9718,80534,80534,0,10,10119000.0
10119,10119999,21.859429024483433,38.26532839315323,0.04402782926978921,2257.5565843582153,653.7658252716064,2813.7516288757324,90264,9719,80545,80545,0,10,10120000.0
10120,10120999,21.858783014208818,38.26446789809274,0.04402749190866728,2258.069454431534,653.8301386833191,2814.1325874328613,90278,9721,80557,80557,0,10,10121000.0
10121,10121999,21.858007508678913,38.26307777808555,0.04402951794776366,2258.3825390338898,653.8929607868195,2814.5523376464844,90290,9722,80568,80568,0,10,10122000.0
10122,10122999,21.8572591221864,38.2617764384561,0.04403223793095867,2258.50208234787,653.9560437202454,2814.934139251709,90290,9722,80568,80568,0,10,10123000.0
10123,10123999,21.856666365622512,38.260750381167995,0.04403194280294276,2259.2189004421234,654.0199732780457,2815.297016143799,90324,9725,80599,80599,0,10,10124000.0
10124,10124999,21.855982061170938,38.259538131761666,0.04403363347328981,2259.3352813720703,654.0831990242004,2815.6819801330566,90324,9725,80599,80599,0,10,10125000.0
10125,10125999,21.85544104192144,38.2584362829857,0.04403436389717663,2259.4545125961304,654.1468951702118,2815.9614181518555,90324,9725,80599,80599,0,10,10126000.0
10126,10126999,21.854911063452857,38.257319175863344,0.04403268371315028,2259.779687166214,654.2111206054688,2816.385570526123,90336,9726,80610,80610,0,10,10127000.0
10127,10127999,21.854377559684654,38.25621146351928,0.04403144825447136,2260.3066017627716,654.2745594978333,2816.5986366271973,90351,9728,80623,80623,0,10,10128000.0
10128,10128999,21.853993883695484,38.25558938321073,0.044030337870787695,2260.82647562027,654.3383135795593,2816.8509521484375,90375,9730,80645,80645,0,10,10129000.0
10129,10129999,21.853552606423616,38.254461860746495,0.04402902135955278,2260.975308418274,654.4127326011658,2817.369415283203,90375,9730,80645,80645,0,10,10130000.0
10130,10130999,21.853236454139992,38.25357228333357,0.04402927274282231,2261.2882990837097,654.4756371974945,2817.761287689209,90382,9731,80651,80651,0,10,10131000.0
10131,10131999,21.852854406967786,38.25268671668652,0.04402888829566498,2261.799586057663,654.5370473861694,2818.0411796569824,90406,9733,80673,80673,0,10,10132000.0
10132,10132999,21.852523603836662,38.25173461739696,0.044026369735029824,2261.9356133937836,654.609644651413,2818.4372596740723,90406,9733,80673,80673,0,10,10133000.0
10133,10133999,21.8521560294288,38.250811359463555,0.044024961855218536,2262.251261949539,654.671257019043,2818.7477531433105,90408,9734,80674,80674,0,10,10134000.0
10134,10134999,21.851855713254068,38.249921522601724,0.04402198176235961,2262.774240255356,654.7417888641357,2819.0525665283203,90422,9736,80686,80686,0,10,10135000.0
10135,10135999,21.851297834191303,38.24875724957366,0.04402286893042795,2263.095000743866,654.8043985366821,2819.3361434936523,90433,9737,80696,80696,0,10,10136000.0
10136,10136999,21.850482679790616,38.2473462930396,0.04403112693805766,2263.2358305454254,654.86856341362,2820.5360832214355,90435,9737,80698,80698,0,10,10137000.0
10137,10137999,21.849595472537924,38.246024270684934,0.04403653826237286,2263.752529859543,654.93150639534,2821.0659408569336,90459,9739,80720,80720,0,10,10138000.0
10138,10138999,21.848710409885378,38.24464945123335,0.044042242962013534,2264.064559698105,654.9952948093414,2821.4988136291504,90461,9740,80721,80721,0,10,10139000.0
10139,10139999,21.847835697126445,38.24351753231333,0.04404561479639424,2264.386123418808,655.0576021671295,2821.8318519592285,90472,9741,80731,80731,0,10,10140000.0
10140,10140999,21.847073025324846,38.24217857690588,0.04404839918159664,2264.7027394771576,655.1202099323273,2822.1649856567383,90474,9742,80732,80732,0,10,10141000.0
10141,10141999,21.8462949288859,38.24095969033505,0.04405309938451729,2264.8239226341248,655.1824727058411,2822.441192626953,90474,9742,80732,80732,0,10,10142000.0
10142,10142999,21.84563260727714,38.239724535036274,0.04405709567951199,2264.9496915340424,655.2452926635742,2822.833957672119,90474,9742,80732,80732,0,10,10143000.0
10143,10143999,21.844815034190173,38.238304472898484,0.04406093229139085,2265.273475408554,655.3085191249847,2823.166679382324,90486,9743,80743,80743,0,10,10144000.0
10144,10144999,21.84419799233122,38.23731322975446,0.04406361533738168,2265.8040599823,655.3723425865173,2823.2786712646484,90496,9745,80751,80751,0,10,10145000.0
10145,10145999,21.84362972276137,38.23624965368462,0.04406623672104382,2266.1171731948853,655.4342682361603,2823.566535949707,90508,9746,80762,80762,0,10,10146000.0
10146,10146999,21.84314928464962,38.2351934506884,0.044066127977453684,2266.240082502365,655.496949672699,2823.8759422302246,90508,9746,80762,80762,0,10,10147000.0
10147,10147999,21.842788221007062,38.234393400593746,0.044065377405054784,2266.7585954666138,655.5597305297852,2824.011890411377,90512,9748,80764,80764,0,10,10148000.0
10148,10148999,21.84234754321474,38.2333576198103,0.044064139399209945,2267.4906463623047,655.6247215270996,2824.2715072631836,90533,9751,80782,80782,0,10,10149000.0
10149,10149999,21.84189682538536,38.232265075537335,0.04406335685129903,2267.608484506607,655.6867661476135,2824.616386413574,90533,9751,80782,80782,0,10,10150000.0
10150,10150999,21.841587940274053,38.23154764062403,0.044061957083361136,2267.9300899505615,655.7488996982574,2824.8061561584473,90545,9752,80793,80793,0,10,10151000.0
10151,10151999,21.84129924879376,38.230686317126924,0.04405852860516091,2268.241133928299,655.8107497692108,2825.151054382324,90557,9753,80804,80804,0,10,10152000.0
10152,10152999,21.840958180106625,38.229711038946334,0.04405501823069069,2268.5715022087097,655.8745911121368,2825.5080795288086,90569,9754,80815,80815,0,10,10153000.0
10153,10153999,21.840770944194013,38.22900385176315,0.04405068029389603,2268.7015104293823,655.9368963241577,2825.8372917175293,90569,9754,80815,80815,0,10,10154000.0
10154,10154999,21.84035463450351,38.227900415526335,0.04405145076585648,2269.4155604839325,655.9993109703064,2825.9321823120117,90594,9757,80837,80837,0,10,10155000.0
10155,10155999,21.83984745134795,38.226710409644824,0.04405077361180876,2269.5369424819946,656.0604195594788,2826.3308296203613,90594,9757,80837,80837,0,10,10156000.0
10156,10156999,21.83942326487457,38.225675587360385,0.044050642492944325,2269.8627762794495,656.1247682571411,2827.362392425537,90597,9758,80839,80839,0,10,10157000.0
10157,10157999,21.83881806013724,38.22450899550704,0.044045839750447624,2269.9928934574127,656.1866669654846,2827.981834411621,90598,9758,80840,80840,0,10,10158000.0
10158,10158999,21.83821268223297,38.22334755124527,0.044043257568441074,2270.1149554252625,656.2495300769806,2828.521686553955,90600,9758,80842,80842,0,10,10159000.0
10159,10159999,21.83785567431527,38.222361262447116,0.044039309235875956,2270.2384326457977,656.3137640953064,2828.9868927001953,90600,9758,80842,80842,0,10,10160000.0
10160,10160999,21.83741643870299,38.22128967940989,0.04403495045645878,2270.357943534851,656.3757073879242,2829.3149948120117,90600,9758,80842,80842,0,10,10161000.0
10161,10161999,21.837212328574207,38.2208562717955,0.04403180744364388,2270.4802503585815,656.4374606609344,2829.6981086730957,90600,9758,80842,80842,0,10,10162000.0
10162,10162999,21.83714052918867,38.220541280971005,0.04403363782753056,2270.6023592948914,656.5018384456635,2830.0299186706543,90600,9758,80842,80842,0,10,10163000.0
10163,10163999,21.836999324157063,38.21995373599716,0.0440317787761344,2271.517646551132,656.5652639865875,2830.1966819763184,90658,9762,80896,80896,0,10,10164000.0
10164,10164999,21.83689360422397,38.21945603965863,0.04403234604493245,2271.6327838897705,656.6282076835632,2830.4655265808105,90658,9762,80896,80896,0,10,10165000.0
10165,10165999,21.836818758529695,38.21914207042172,0.04403216975383606,2271.9640262126923,656.6917667388916,2830.6756629943848,90663,9763,80900,80900,0,10,10166000.0
10166,10166999,21.837064970636273,38.21932573784463,0.044042408004082545,2272.513153076172,656.7552509307861,2830.8018531799316,90681,9765,80916,80916,0,10,10167000.0
10167,10167999,21.837431991958578,38.21973617745775,0.04404494075484944,2272.839557170868,656.8171293735504,2831.0135231018066,90692,9766,80926,80926,0,10,10168000.0
10168,10168999,21.83756898380134,38.21967868193379,0.044050374295111716,2273.1556634902954,656.8785152435303,2831.3106689453125,90697,9767,80930,80930,0,10,10169000.0
10169,10169999,21.837804779108417,38.2199460118983,0.04405435963494797,2273.864809036255,656.9397878646851,2831.49072265625,90733,9770,80963,80963,0,10,10170000.0
10170,10170999,21.83812146793711,38.220112723421856,0.04405397898839747,2274.3758442401886,657.0021727085114,2831.7264976501465,90749,9772,80977,80977,0,10,10171000.0
10171,10171999,21.838411774406932,38.22017750645247,0.04405674702613627,2274.699077606201,657.0632679462433,2832.033432006836,90751,9773,80978,80978,0,10,10172000.0
10172,10172999,21.83881755654719,38.22046064297778,0.044061828151103155,2274.8176369667053,657.1257750988007,2832.531219482422,90751,9773,80978,80978,0,10,10173000.0
10173,10173999,21.83952520467127,38.22110742755633,0.044065358308162716,2275.1362369060516,657.1882898807526,2832.7504653930664,90762,9774,80988,80988,0,10,10174000.0
10174,10174999,21.840022079720878,38.22146368448234,0.044068690931433396,2275.455368757248,657.2499701976776,2833.134479522705,90767,9775,80992,80992,0,10,10175000.0
10175,10175999,21.840442444599248,38.221637534707675,0.04406877179464108,2275.7728459835052,657.3111472129822,2833.3869094848633,90777,9776,81001,81001,0,10,10176000.0
10176,10176999,21.84044927689231,38.22109870018278,0.04406881303579657,2276.305557489395,657.3749694824219,2833.864574432373,90784,9778,81006,81006,0,10,10177000.0
10177,10177999,21.839832047736653,38.22001722575026,0.044070670604658524,2276.4220259189606,657.4353322982788,2834.300121307373,90786,9778,81008,81008,0,10,10178000.0
10178,10178999,21.839282606172258,38.219522136882894,0.04407309453825581,2276.9432768821716,657.4979746341705,2834.587184906006,90798,9780,81018,81018,0,10,10179000.0
10179,10179999,21.838687117480426,38.218336021655645,0.04408097784269349,2277.0651173591614,657.5592458248138,2834.8652534484863,90799,9780,81019,81019,0,10,10180000.0
10180,10180999,21.83819912906058,38.217193914452615,0.044081220153557865,2277.1878395080566,657.6200978755951,2835.137763977051,90800,9780,81020,81020,0,10,10181000.0
10181,10181999,21.837760041485847,38.21638198105008,0.044083165245918376,2277.3171253204346,657.681872844696,2835.3497047424316,90800,9780,81020,81020,0,10,10182000.0
10182,10182999,21.837457703447203,38.215786791219195,0.04408234372854303,2277.4381642341614,657.7432310581207,2835.5942726135254,90802,9780,81022,81022,0,10,10183000.0
10183,10183999,21.837330867852955,38.21547123523385,0.04407954489494381,2277.770937204361,657.8053679466248,2835.72013092041,90810,9781,81029,81029,0,10,10184000.0
10184,10184999,21.837698422388172,38.21640340876599,0.044089048837934186,2278.113988161087,657.8688843250275,2835.9049911499023,90817,9782,81035,81035,0,10,10185000.0
10185,10185999,21.83819726632061,38.217363700797435,0.04409585964467888,2278.8513522148132,657.9308359622955,2836.0702514648438,90846,9785,81061,81061,0,10,10186000.0
10186,10186999,21.83889484887161,38.21847216673207,0.04410610795125702,2279.1803913116455,657.9935760498047,2836.2673683166504,90851,9786,81065,81065,0,10,10187000.0
10187,10187999,21.839780502820325,38.22022266201094,0.04411473826705403,2279.4968111515045,658.0541095733643,2836.514602661133,90854,9787,81067,81067,0,10,10188000.0
10188,10188999,21.840827075076028,38.22225259265444,0.04413069257116897,2279.8202896118164,658.116307258606,2836.8188247680664,90860,9788,81072,81072,0,10,10189000.0
10189,10189999,21.84182823365736,38.223938869601206,0.04414299461353832,2280.1492404937744,658.1792593002319,2837.011371612549,90862,9789,81073,81073,0,10,10190000.0
10190,10190999,21.843185506882232,38.226424582703785,0.044146964025252644,2280.4731776714325,658.2394247055054,2837.1834754943848,90866,9790,81076,81076,0,10,10191000.0
10191,10191999,21.844378899988556,38.22812728715603,0.04414572627355917,2280.787277698517,658.3003785610199,2837.346633911133,90879,9791,81088,81088,0,10,10192000.0
10192,10192999,21.845272683495878,38.22939558921349,0.04414975065435345,2281.104225873947,658.3621346950531,2837.582004547119,90888,9792,81096,81096,0,10,10193000.0
10193,10193999,21.845334379453583,38.22991718542147,0.04414864054145662,2281.4388751983643,658.4228255748749,2838.6382026672363,90906,9793,81113,81113,0,10,10194000.0
10194,10194999,21.8448374852993,38.22884080409836,0.04414863291605897,2281.7685256004333,658.4851541519165,2839.5966835021973,90921,9794,81127,81127,0,10,10195000.0
10195,10195999,21.84428844915938,38.2276875299817,0.04414861573008466,2282.089855670929,658.5461575984955,2840.323829650879,90939,9795,81144,81144,0,10,10196000.0
10196,10196999,21.843904989896192,38.227347208009576,0.04414770087559816,2282.214227437973,658.6093785762787,2841.0624656677246,90944,9795,81149,81149,0,10,10197000.0
10197,10197999,21.843469374990992,38.22634333366522,0.04414539289475483,2282.3469910621643,658.6707999706268,2841.7030754089355,90946,9795,81151,81151,0,10,10198000.0
10198,10198999,21.843007724308425,38.225284065236984,0.04414504806503017,2282.4821515083313,658.7341458797455,2842.278533935547,90946,9795,81151,81151,0,10,10199000.0
10199,10199999,21.842465121021917,38.22416995774107,0.04414504032137678,2282.998364686966,658.7953515052795,2842.648670196533,90957,9797,81160,81160,0,10,10200000.0
10200,10200999,21.8421141445141,38.22350127816563,0.04414222697126868,2283.3078603744507,658.8559985160828,2842.9864921569824,90969,9798,81171,81171,0,10,10201000.0
10201,10201999,21.841709023384762,38.222552373985756,0.04414007542545806,2283.622155189514,658.9169981479645,2843.4113426208496,90981,9799,81182,81182,0,10,10202000.0
10202,10202999,21.84148019733755,38.22220158719244,0.04413711078390492,2283.9457335472107,658.9785919189453,2843.745506286621,90984,9800,81184,81184,0,10,10203000.0
10203,10203999,21.84117419971497,38.22122168707098,0.04413227784354712,2284.076257944107,659.0402588844299,2844.2865142822266,90984,9800,81184,81184,0,10,10204000.0
10204,10204999,21.841092143278555,38.220912343377464,0.04412887372203844,2284.216714859009,659.1101367473602,2844.855987548828,90985,9800,81185,81185,0,10,10205000.0
10205,10205999,21.841081275762072,38.22058794738312,0.04412102696118125,2284.758917570114,659.1723861694336,2845.0297355651855,90999,9802,81197,81197,0,10,10206000.0
10206,10206999,21.841257809881427,38.220479143930795,0.04411137371847795,2284.8760364055634,659.2345354557037,2845.591808319092,90999,9802,81197,81197,0,10,10207000.0
10207,10207999,21.841720760792242,38.22084293717172,0.044109128895055916,2284.9900994300842,659.2961266040802,2846.0642051696777,91001,9802,81199,81199,0,10,10208000.0
10208,10208999,21.84215361550982,38.22181630154486,0.04410459350775253,2285.5036833286285,659.3582866191864,2846.421699523926,91043,9804,81239,81239,0,10,10209000.0
10209,10209999,21.84256594472665,38.22184981708573,0.04409521049241516,2285.8290824890137,659.419853925705,2846.728057861328,91055,9805,81250,81250,0,10,10210000.0
10210,10210999,21.842726550827393,38.22148032648401,0.044086569258448116,2285.950873374939,659.4821071624756,2847.2108612060547,91056,9805,81251,81251,0,10,10211000.0
10211,10211999,21.842835670749945,38.2209645530631,0.044083186230983284,2286.07448220253,659.5441064834595,2847.6852073669434,91056,9805,81251,81251,0,10,10212000.0
10212,10212999,21.842646352777532,38.22008013921677,0.044077917469979355,2286.3845336437225,659.6057322025299,2848.1222801208496,91065,9806,81259,81259,0,10,10213000.0
10213,10213999,21.841888513875617,38.21912788278317,0.044083546194093715,2286.5195269584656,659.6689238548279,2849.6860694885254,91071,9806,81265,81265,0,10,10214000.0
10214,10214999,21.841008034837415,38.21803127283146,0.04408931012289585,2286.649073600769,659.7311403751373,2850.4935340881348,91073,9806,81267,81267,0,10,10215000.0
10215,10215999,21.840206935866632,38.216702752533955,0.04409423244834498,2286.9688239097595,659.7938377857208,2850.9262313842773,91076,9807,81269,81269,0,10,10216000.0
10216,10216999,21.839514580391693,38.215723789216,0.044094788229294024,2287.0863094329834,659.8558819293976,2851.5637855529785,91079,9807,81272,81272,0,10,10217000.0
10217,10217999,21.83889931353912,38.2145580420628,0.04409432433187421,2287.4130074977875,659.9188849925995,2852.0105171203613,91086,9808,81278,81278,0,10,10218000.0
10218,10218999,21.83823072917923,38.2132242585139,0.04409645213105606,2287.7334022521973,659.9816617965698,2852.3247451782227,91088,9809,81279,81279,0,10,10219000.0
10219,10219999,21.837670722952883,38.21222228375853,0.044099182776263235,2288.0495953559875,660.0441994667053,2852.7211570739746,91101,9810,81291,81291,0,10,10220000.0
10220,10220999,21.837115582537294,38.211211840948366,0.04410175882465028,2288.3641250133514,660.1066224575043,2853.1441040039062,91113,9811,81302,81302,0,10,10221000.0
10221,10221999,21.836482049557056,38.21000981421488,0.044103430635983765,2288.6980147361755,660.16938996315,2853.498390197754,91125,9812,81313,81313,0,10,10222000.0
10222,10222999,21.83597194901864,38.208994560885145,0.044102268688012036,2289.0161707401276,660.2298228740692,2853.807876586914,91137,9813,81324,81324,0,10,10223000.0
10223,10223999,21.83570272550333,38.209515876493896,0.04409652920764584,2289.3324031829834,660.2924909591675,2854.1642570495605,91148,9814,81334,81334,0,10,10224000.0
10224,10224999,21.835279071292906,38.20847549732737,0.04409721383020704,2289.6539299488068,660.3541874885559,2854.363739013672,91160,9815,81345,81345,0,10,10225000.0
10225,10225999,21.834846572267725,38.20744146640465,0.04409590160877486,2289.9765589237213,660.4163551330566,2854.74796295166,91172,9816,81356,81356,0,10,10226000.0
10226,10226999,21.83456006668117,38.206706743490116,0.044090548940788565,2290.2990124225616,660.4775185585022,2855.112762451172,91177,9817,81360,81360,0,10,10227000.0
10227,10227999,21.83436988817625,38.20727170190419,0.04408360551161994,2290.8081228733063,660.5386729240417,2855.3893089294434,91190,9819,81371,81371,0,10,10228000.0
10228,10228999,21.8340484684432,38.20627954284962,0.04407995906081996,2290.9237897396088,660.6008110046387,2855.800682067871,91190,9819,81371,81371,0,10,10229000.0
10229,10229999,21.83378129803159,38.20552430733937,0.04407402080492129,2291.040768623352,660.6633791923523,2856.280075073242,91191,9819,81372,81372,0,10,10230000.0
10230,10230999,21.83353915723027,38.20455881956159,0.044069912343442486,2291.1637773513794,660.7246053218842,2856.6507263183594,91191,9819,81372,81372,0,10,10231000.0
10231,10231999,21.83311236195857,38.20350521345007,0.044070032870546116,2291.4915120601654,660.7869205474854,2856.9186210632324,91204,9820,81384,81384,0,10,10232000.0
10232,10232999,21.83269411346592,38.20253921347082,0.04406714189666894,2292.19539475441,660.8497507572174,2857.155448913574,91240,9823,81417,81417,0,10,10233000.0
10233,10233999,21.832364597684425,38.20204474459822,0.04405535261294469,2292.524894952774,660.9121015071869,2858.480930328369,91246,9824,81422,81422,0,10,10234000.0
10234,10234999,21.831908880037428,38.20118005027338,0.044043742983468914,2292.8486716747284,660.9747414588928,2859.150619506836,91258,9825,81433,81433,0,10,10235000.0
10235,10235999,21.831500081252663,38.200760934031194,0.044027776057787404,2293.1751408576965,661.0375933647156,2859.6914024353027,91260,9826,81434,81434,0,10,10236000.0
10236,10236999,21.83110481084072,38.19978326724268,0.044018190881951025,2293.2921307086945,661.099728345871,2860.2148056030273,91260,9826,81434,81434,0,10,10237000.0
10237,10237999,21.83082304936029,38.19904074847689,0.044007747387712515,2293.60551071167,661.1616058349609,2860.596481323242,91273,9827,81446,81446,0,10,10238000.0
10238,10238999,21.83056634719958,38.1983036229262,0.0440029908812547,2293.7230026721954,661.2240028381348,2860.9787940979004,91273,9827,81446,81446,0,10,10239000.0
10239,10239999,21.830402295271988,38.197648664517835,0.04400002559019622,2293.8450775146484,661.2857744693756,2861.399200439453,91274,9827,81447,81447,0,10,10240000.0
10240,10240999,21.830391473046337,38.19752074851446,0.043997045343815766,2294.5570290088654,661.3485219478607,2861.6789360046387,91295,9830,81465,81465,0,10,10241000.0
10241,10241999,21.83048262155122,38.197539936938654,0.043996900337507805,2294.876500606537,661.4095044136047,2861.9225273132324,91302,9831,81471,81471,0,10,10242000.0
10242,10242999,21.83083358941634,38.19788041076172,0.04399838592754646,2295.196417093277,661.4713416099548,2862.2911415100098,91314,9832,81482,81482,0,10,10243000.0
10243,10243999,21.831281046959162,38.19820956678846,0.04401017699968568,2295.3212728500366,661.5331356525421,2862.6486320495605,91315,9832,81483,81483,0,10,10244000.0
10244,10244999,21.83190491132295,38.19898833635933,0.04401490975266231,2295.8518488407135,661.603312253952,2862.8281478881836,91331,9834,81497,81497,0,10,10245000.0
10245,10245999,21.832279806429383,38.19905700514631,0.04401672139359292,2296.1775228977203,661.6666033267975,2863.1696701049805,91343,9835,81508,81508,0,10,10246000.0
10246,10246999,21.832802571103954,38.19928880901083,0.04402124561523213,2296.2988295555115,661.7269597053528,2863.63330078125,91343,9835,81508,81508,0,10,10247000.0
10247,10247999,21.83357248608656,38.19996082699706,0.044027314744860546,2296.41632604599,661.7881801128387,2864.051082611084,91343,9835,81508,81508,0,10,10248000.0
10248,10248999,21.834308252384083,38.200399603829204,0.04404006525420823,2296.942940235138,661.8492183685303,2864.3671226501465,91367,9837,81530,81530,0,10,10249000.0
10249,10249999,21.83505922333172,38.20099383763822,0.04404531719022431,2297.4552631378174,661.9110927581787,2864.718032836914,91391,9839,81552,81552,0,10,10250000.0
10250,10250999,21.83588792335886,38.201928036234406,0.04405630451830067,2297.5811183452606,661.9725916385651,2865.221992492676,91392,9839,81553,81553,0,10,10251000.0
10251,10251999,21.836490575442145,38.20231099559263,0.044060445462382636,2297.7048528194427,662.0332078933716,2865.7011947631836,91393,9839,81554,81554,0,10,10252000.0
10252,10252999,21.83696658837052,38.203274727713605,0.04406066708472145,2298.021670818329,662.0944790840149,2866.0223121643066,91400,9840,81560,81560,0,10,10253000.0
10253,10253999,21.836601943006613,38.20269322579592,0.0440515784739951,2298.3380587100983,662.156144618988,2867.107395172119,91403,9841,81562,81562,0,10,10254000.0
10254,10254999,21.83610105501701,38.20192069616574,0.04404847800360345,2298.4585428237915,662.2174656391144,2867.7157821655273,91403,9841,81562,81562,0,10,10255000.0
10255,10255999,21.835712352181996,38.20095992484472,0.0440418951544046,2298.777907848358,662.2782652378082,2868.0318450927734,91406,9842,81564,81564,0,10,10256000.0
10256,10256999,21.83547031691146,38.20042910639474,0.04403759511129668,2298.8922398090363,662.3393831253052,2868.4432258605957,91406,9842,81564,81564,0,10,10257000.0
10257,10257999,21.835281868778505,38.20056915907103,0.04402986527979724,2299.0139701366425,662.4015090465546,2868.829032897949,91406,9842,81564,81564,0,10,10258000.0
10258,10258999,21.83484871545317,38.199464127419596,0.04402854441180504,2299.3345708847046,662.463719367981,2869.0574264526367,91409,9843,81566,81566,0,10,10259000.0
10259,10259999,21.834604603080837,38.19871929825933,0.04402457747001709,2299.4567470550537,662.5239462852478,2869.4187507629395,91409,9843,81566,81566,0,10,10260000.0
10260,10260999,21.83442394461983,38.19807546287789,0.04402305456230471,2299.7678921222687,662.5844376087189,2869.7805671691895,91422,9844,81578,81578,0,10,10261000.0
10261,10261999,21.83425844270771,38.19746012671821,0.04402406073768039,2299.8888177871704,662.6449406147003,2870.147850036621,91422,9844,81578,81578,0,10,10262000.0
10262,10262999,21.83438517802385,38.19711652262056,0.04402653741548945,2300.4017899036407,662.7054603099823,2870.353416442871,91436,9846,81590,81590,0,10,10263000.0
10263,10263999,21.834901510118048,38.19765394020417,0.04403245202973438,2300.729980945587,662.7665858268738,2870.801727294922,91449,9847,81602,81602,0,10,10264000.0
10264,10264999,21.836107494316835,38.200052940223685,0.04404489376733689,2300.8536410331726,662.8270108699799,2871.16007232666,91451,9847,81604,81604,0,10,10265000.0
10265,10265999,21.83727083334291,38.20232554872307,0.04405985330976003,2300.9708721637726,662.8880023956299,2871.560920715332,91453,9847,81606,81606,0,10,10266000.0
10266,10266999,21.83866707927377,38.20501693544995,0.04407741880164895,2301.481446504593,662.9485042095184,2871.844211578369,91467,9849,81618,81618,0,10,10267000.0
10267,10267999,21.840511718560197,38.208548457910254,0.04410838537774531,2301.599502801895,663.0091760158539,2872.2458572387695,91468,9849,81619,81619,0,10,10268000.0
10268,10268999,21.84265443672445,38.21341867984941,0.044146437412521555,2302.1207242012024,663.0696387290955,2872.550537109375,91492,9851,81641,81641,0,10,10269000.0
10269,10269999,21.84486415172126,38.21809528542432,0.044165224181908935,2302.233939886093,663.1321573257446,2872.885108947754,91493,9851,81642,81642,0,10,10270000.0
10270,10270999,21.847069562464753,38.223143823282776,0.0441914478554255,2302.5506122112274,663.1923987865448,2873.2077102661133,91495,9852,81643,81643,0,10,10271000.0
10271,10271999,21.849162469684135,38.22687975779188,0.044218093779569645,2302.664078235626,663.2521526813507,2873.5416297912598,91495,9852,81643,81643,0,10,10272000.0
10272,10272999,21.85067282262961,38.22932572259222,0.044235097019204916,2302.9812355041504,663.3119385242462,2873.794013977051,91502,9853,81649,81649,0,10,10273000.0
10273,10273999,21.850184976986306,38.22898785526072,0.044236405239832854,2303.706439971924,663.3735003471375,2874.857318878174,91522,9856,81666,81666,0,10,10274000.0
10274,10274999,21.849522787663776,38.22819857866416,0.044237039708027504,2304.2177555561066,663.4353003501892,2875.390205383301,91548,9858,81690,81690,0,10,10275000.0
10275,10275999,21.849112823230456,38.2278658249102,0.04423638157629539,2304.338935852051,663.4972813129425,2875.8545532226562,91550,9858,81692,81692,0,10,10276000.0
10276,10276999,21.84890151012729,38.22803064308215,0.0442327139094576,2304.8486609458923,663.5577485561371,2876.222686767578,91573,9860,81713,81713,0,10,10277000.0
10277,10277999,21.848524842804082,38.227372526139455,0.04423120910795186,2305.1701917648315,663.6210975646973,2876.572566986084,91575,9861,81714,81714,0,10,10278000.0
10278,10278999,21.848058828452604,38.22654004989409,0.04423221501176999,2305.2837533950806,663.6822240352631,2876.9291954040527,91575,9861,81714,81714,0,10,10279000.0
10279,10279999,21.847701073074624,38.22556108181892,0.044233370438489295,2305.406598806381,663.7432396411896,2877.284038543701,91576,9861,81715,81715,0,10,10280000.0
10280,10280999,21.84751556777871,38.22515695291752,0.0442294425813502,2305.722847700119,663.8032021522522,2877.6099433898926,91588,9862,81726,81726,0,10,10281000.0
10281,10281999,21.847316075305386,38.22464228017602,0.04422779304385016,2305.853680372238,663.8648738861084,2877.917163848877,91588,9862,81726,81726,0,10,10282000.0
10282,10282999,21.847266252290897,38.22427443519448,0.04422836589155532,2306.5740015506744,663.9267542362213,2877.945240020752,91618,9865,81753,81753,0,10,10283000.0
10283,10283999,21.84736872156577,38.22425264443593,0.044228310561315376,2306.7001917362213,663.9881746768951,2878.3877906799316,91619,9865,81754,81754,0,10,10284000.0
10284,10284999,21.847626620497085,38.2244893293633,0.04423008932206651,2306.8228812217712,664.0492589473724,2878.6924781799316,91619,9865,81754,81754,0,10,10285000.0
10285,10285999,21.847922663154584,38.22505530121935,0.04423157999063132,2307.1375999450684,664.1110806465149,2878.9216079711914,91626,9866,81760,81760,0,10,10286000.0
10286,10286999,21.848405959908465,38.225657079909745,0.044233707764580465,2307.2529816627502,664.1719796657562,2879.283233642578,91626,9866,81760,81760,0,10,10287000.0
10287,10287999,21.849333088750434,38.22768875576469,0.044238220225392255,2307.5788671970367,664.2340352535248,2879.5187187194824,91628,9867,81761,81761,0,10,10288000.0
10288,10288999,21.850215649201814,38.228906879923166,0.044250764120677744,2307.901361465454,664.2949795722961,2879.753635406494,91630,9868,81762,81762,0,10,10289000.0
10289,10289999,21.851022274069884,38.22977973660169,0.04426077592517896,2308.0138609409332,664.3560898303986,2880.095714569092,91630,9868,81762,81762,0,10,10290000.0
10290,10290999,21.851964344835334,38.23059245011585,0.04427617706610354,2308.348215818405,664.4180247783661,2880.358444213867,91641,9869,81772,81772,0,10,10291000.0
10291,10291999,21.85293894035069,38.232506296407806,0.0442831854482274,2308.6763184070587,664.4796950817108,2880.673412322998,91653,9870,81783,81783,0,10,10292000.0
10292,10292999,21.854031096419693,38.23426425169973,0.04429249010699321,2308.993107318878,664.5411851406097,2880.9323654174805,91668,9871,81797,81797,0,10,10293000.0
10293,10293999,21.853927465397238,38.23459714525153,0.04429332247032014,2309.1109573841095,664.6033260822296,2881.801055908203,91668,9871,81797,81797,0,10,10294000.0
10294,10294999,21.85323722824197,38.23379051652386,0.04429317560562418,2309.6349573135376,664.6665966510773,2882.3125953674316,91692,9873,81819,81819,0,10,10295000.0
10295,10295999,21.852533431813907,38.23265033670485,0.04429309013362859,2309.9572360515594,664.7291390895844,2882.6903762817383,91697,9874,81823,81823,0,10,10296000.0
10296,10296999,21.852000540993565,38.23194313195361,0.04429111088163873,2310.473717689514,664.7901878356934,2882.980541229248,91709,9876,81833,81833,0,10,10297000.0
10297,10297999,21.851439547077835,38.230970130830514,0.04429078206932613,2311.1894381046295,664.851945400238,2883.1001205444336,91728,9879,81849,81849,0,10,10298000.0
10298,10298999,21.85092769726659,38.2300616836884,0.04429156091603004,2311.5121240615845,664.9136896133423,2883.336624145508,91735,9880,81855,81855,0,10,10299000.0
10299,10299999,21.850490436058823,38.229185705528124,0.04428896007967875,2311.8521616458893,664.9802093505859,2883.6962814331055,91737,9881,81856,81856,0,10,10300000.0
10300,10300999,21.850039516372618,38.228204830757115,0.044288855901607804,2311.9775125980377,665.0416316986084,2884.032386779785,91737,9881,81856,81856,0,10,10301000.0
10301,10301999,21.849847600747974,38.227593963697494,0.04428938394092452,2312.487914085388,665.1025986671448,2884.1822547912598,91750,9883,81867,81867,0,10,10302000.0
10302,10302999,21.850061998214617,38.22829599354153,0.044287016445723415,2312.8087968826294,665.1646547317505,2884.5264587402344,91752,9884,81868,81868,0,10,10303000.0
10303,10303999,21.85076357043681,38.229873663933226,0.04429668556301103,2312.9270136356354,665.225900888443,2884.907482147217,91752,9884,81868,81868,0,10,10304000.0
10304,10304999,21.85189493733069,38.232767133607126,0.04430199399092971,2313.4410786628723,665.2887742519379,2885.1529121398926,91757,9886,81871,81871,0,10,10305000.0
10305,10305999,21.852673723019326,38.234247448976824,0.04430918215961843,2313.749341726303,665.3492410182953,2885.4185638427734,91766,9887,81879,81879,0,10,10306000.0
10306,10306999,21.853549155082018,38.23619160433832,0.04432163485931573,2314.461464881897,665.4099125862122,2885.569232940674,91788,9890,81898,81898,0,10,10307000.0
10307,10307999,21.85454016237611,38.23821796092597,0.04433579729282544,2314.5828351974487,665.4697034358978,2885.8604888916016,91788,9890,81898,81898,0,10,10308000.0
10308,10308999,21.85565333782388,38.24032731062067,0.04435105438824416,2314.9157371520996,665.5321156978607,2886.1420402526855,91790,9891,81899,81899,0,10,10309000.0
10309,10309999,21.856754469063457,38.242524954165134,0.04435621995007244,2315.2497811317444,665.6033508777618,2886.6442909240723,91799,9892,81907,81907,0,10,10310000.0
10310,10310999,21.857821211184184,38.244420692708545,0.04436308056635874,2315.9702360630035,665.6650514602661,2886.893699645996,91827,9895,81932,81932,0,10,10311000.0
10311,10311999,21.858712448207246,38.2457232573756,0.0443741202280008,2316.2977538108826,665.7274763584137,2887.1949729919434,91830,9896,81934,81934,0,10,10312000.0
10312,10312999,21.85945428512932,38.24753033576733,0.04438011877324921,2316.606120109558,665.7875850200653,2887.48055267334,91839,9897,81942,81942,0,10,10313000.0
10313,10313999,21.85947940254086,38.247322969161814,0.0443792072238437,2316.7264082431793,665.8498878479004,2888.3122024536133,91843,9897,81946,81946,0,10,10314000.0
10314,10314999,21.858969779776313,38.24655120490256,0.044377590877901496,2317.046459197998,665.9117739200592,2889.058868408203,91855,9898,81957,81957,0,10,10315000.0
10315,10315999,21.858445628487736,38.24614555395393,0.04437691226937601,2317.5740666389465,665.9744429588318,2889.5248222351074,91880,9900,81980,81980,0,10,10316000.0
10316,10316999,21.858169155352364,38.24631885774237,0.04437575962579543,2318.0955991744995,666.035416841507,2889.9163665771484,91893,9902,81991,81991,0,10,10317000.0
10317,10317999,21.85799149953801,38.2465688180037,0.04437418555240391,2318.6256301403046,666.0981571674347,2890.248722076416,91900,9904,81996,81996,0,10,10318000.0
10318,10318999,21.85772810029454,38.24649461412768,0.04437298324397032,2318.7454013824463,666.1584982872009,2890.577007293701,91900,9904,81996,81996,0,10,10319000.0
10319,10319999,21.85758203761947,38.24634298305177,0.04437207639593754,2319.2646102905273,666.2205052375793,2890.84236907959,91915,9906,82009,82009,0,10,10320000.0
10320,10320999,21.857390033964535,38.24590645037865,0.04437472802440212,2319.5756986141205,666.2817990779877,2891.2980461120605,91917,9907,82010,82010,0,10,10321000.0
10321,10321999,21.857106962081012,38.2452242478721,0.044376903812737956,2320.2980382442474,666.3447568416595,2891.4551391601562,91933,9910,82023,82023,0,10,10322000.0
10322,10322999,21.85698266123369,38.24467627419547,0.044380449227913954,2320.428499698639,666.4062387943268,2891.720531463623,91934,9910,82024,82024,0,10,10323000.0
10323,10323999,21.857095243296612,38.245839268744184,0.04437468230113917,2320.543027162552,666.4665949344635,2892.1036529541016,91934,9910,82024,82024,0,10,10324000.0
10324,10324999,21.856950307518538,38.24529922434638,0.044378073705677035,2320.861550807953,666.5295517444611,2892.439598083496,91937,9911,82026,82026,0,10,10325000.0
10325,10325999,21.85685726736955,38.244794582841486,0.04438202466427388,2320.977057695389,666.5906281471252,2892.786144256592,91937,9911,82026,82026,0,10,10326000.0
10326,10326999,21.85719634707876,38.24655808182578,0.0443785534736858,2321.094730615616,666.6515407562256,2893.1081924438477,91937,9911,82026,82026,0,10,10327000.0
10327,10327999,21.857452213187283,38.24670429262853,0.044387313505842685,2321.4158430099487,666.7138569355011,2893.5512924194336,91949,9912,82037,82037,0,10,10328000.0
10328,10328999,21.85763617633003,38.24645721658746,0.04438974833915754,2321.733609199524,666.774516582489,2893.979290008545,91954,9913,82041,82041,0,10,10329000.0
10329,10329999,21.858296369263588,38.247429310137065,0.04439923983961935,2322.439559698105,666.8353781700134,2894.2841987609863,91986,9916,82070,82070,0,10,10330000.0
10330,10330999,21.85845448711671,38.24721589558478,0.04440241690359514,2322.5699512958527,666.8971259593964,2894.7021827697754,91987,9916,82071,82071,0,10,10331000.0
10331,10331999,21.858929456556083,38.24873031971716,0.04437301568538954,2323.113123655319,666.9596469402313,2896.0174407958984,91992,9918,82074,82074,0,10,10332000.0
10332,10332999,21.859154729527756,38.24854348549151,0.04434552736602393,2323.2315073013306,667.0210378170013,2896.753776550293,91994,9918,82076,82076,0,10,10333000.0
10333,10333999,21.859413997315507,38.24931411207169,0.04431932077429257,2323.350346326828,667.084686756134,2897.286445617676,91996,9918,82078,82078,0,10,10334000.0
10334,10334999,21.859652895324494,38.249159783009986,0.04429663637073611,2323.8703298568726,667.1481928825378,2897.5768432617188,92015,9920,82095,82095,0,10,10335000.0
10335,10335999,21.85985670559053,38.24905834405373,0.04427648118066241,2323.990581035614,667.2104916572571,2897.9855346679688,92017,9920,82097,82097,0,10,10336000.0
10336,10336999,21.860225171719318,38.24942681112003,0.04425935043824791,2324.1144444942474,667.2725389003754,2898.510917663574,92018,9920,82098,82098,0,10,10337000.0
10337,10337999,21.860582057340743,38.249512478989246,0.0442485280133188,2324.2379529476166,667.333034992218,2898.9673805236816,92018,9920,82098,82098,0,10,10338000.0
10338,10338999,21.861662229901807,38.25231069245842,0.04424317510274478,2324.352014064789,667.393853187561,2899.3167724609375,92019,9920,82099,82099,0,10,10339000.0
10339,10339999,21.862768271829644,38.254793654519986,0.04424206857262125,2324.469474554062,667.4542667865753,2899.769111633301,92019,9920,82099,82099,0,10,10340000.0
10340,10340999,21.864435189475568,38.258357551238944,0.044265718614635574,2324.9989097118378,667.5152733325958,2900.0637855529785,92043,9922,82121,82121,0,10,10341000.0
10341,10341999,21.866244732576412,38.26302950148165,0.04427004062175055,2325.1129705905914,667.5764963626862,2900.411407470703,92043,9922,82121,82121,0,10,10342000.0
10342,10342999,21.86744299343113,38.26610975038007,0.044258903963501295,2325.4309465885162,667.6385583877563,2900.9004859924316,92049,9923,82126,82126,0,10,10343000.0
10343,10343999,21.86882514237803,38.268661884293145,0.044270101873190915,2325.5495805740356,667.700110912323,2901.462055206299,92050,9923,82127,82127,0,10,10344000.0
10344,10344999,21.870881742228462,38.27287778456767,0.0442883581157445,2326.0645463466644,667.7616555690765,2901.790168762207,92073,9925,82148,82148,0,10,10345000.0
10345,10345999,21.872622967918883,38.27727677449827,0.04431967837707673,2326.376027584076,667.823400259018,2902.185146331787,92086,9926,82160,82160,0,10,10346000.0
10346,10346999,21.874701948186487,38.28308485784211,0.04434664081611561,2326.4854259490967,667.8834071159363,2902.693286895752,92087,9926,82161,82161,0,10,10347000.0
10347,10347999,21.876818599235044,38.28785020814476,0.04440854680272832,2326.8041734695435,667.9450783729553,2903.094944000244,92100,9927,82173,82173,0,10,10348000.0
10348,10348999,21.878954456044298,38.29235786424863,0.04444692542943307,2327.325474500656,668.0071651935577,2903.480598449707,92117,9929,82188,82188,0,10,10349000.0
10349,10349999,21.88043071892768,38.2958247699145,0.04446662161762971,2327.645735025406,668.0684380531311,2903.808204650879,92122,9930,82192,82192,0,10,10350000.0
10350,10350999,21.880186524776033,38.29564008764315,0.04446523795273971,2327.767746925354,668.1293590068817,2904.9222564697266,92123,9930,82193,82193,0,10,10351000.0
10351,10351999,21.879659210683894,38.29575652593994,0.04446191610149541,2328.0915100574493,668.1925480365753,2905.4054794311523,92125,9931,82194,82194,0,10,10352000.0
10352,10352999,21.879075989294936,38.295062500179554,0.04446098639862506,2328.2130842208862,668.2553443908691,2905.7970962524414,92126,9931,82195,82195,0,10,10353000.0
10353,10353999,21.878880337919476,38.29494046481777,0.04445609106326098,2328.333596229553,668.3174560070038,2906.278106689453,92127,9931,82196,82196,0,10,10354000.0
10354,10354999,21.878534010426353,38.29452387022379,0.0444531499638986,2328.455152273178,668.3784654140472,2906.6697158813477,92127,9931,82196,82196,0,10,10355000.0
10355,10355999,21.878090089696038,38.29380640979843,0.04445176410316165,2328.771054506302,668.439327955246,2906.9246673583984,92139,9932,82207,82207,0,10,10356000.0
10356,10356999,21.877798903334295,38.29335156449352,0.044450136710892485,2329.0881967544556,668.5003614425659,2907.2865600585938,92147,9933,82214,82214,0,10,10357000.0
10357,10357999,21.87756019777881,38.29339122369843,0.04444668475184954,2329.204078435898,668.5608351230621,2907.724323272705,92148,9933,82215,82215,0,10,10358000.0
10358,10358999,21.87743653966861,38.293253481182646,0.04444382761398957,2329.517350912094,668.6225888729095,2908.009292602539,92160,9934,82226,82226,0,10,10359000.0
10359,10359999,21.87732229824653,38.293011013139335,0.04444390920344199,2329.831794023514,668.6845617294312,2908.3432807922363,92172,9935,82237,82237,0,10,10360000.0
10360,10360999,21.87742254775967,38.29313724464465,0.04444660705300418,2330.3601291179657,668.7458140850067,2908.6780586242676,92190,9937,82253,82253,0,10,10361000.0
10361,10361999,21.87788151190346,38.29364341531424,0.04445010925983772,2330.883905649185,668.8084397315979,2908.8846893310547,92206,9939,82267,82267,0,10,10362000.0
10362,10362999,21.87861617919601,38.296856030810744,0.044454295865388294,2331.0034906864166,668.8702182769775,2909.2597274780273,92206,9939,82267,82267,0,10,10363000.0
10363,10363999,21.879468715060153,38.2988042297762,0.0444667481528046,2331.328842163086,668.9321520328522,2909.6538887023926,92217,9940,82277,82277,0,10,10364000.0
10364,10364999,21.880301254122337,38.30004198117168,0.044479546171469764,2331.4496631622314,668.9944729804993,2910.093650817871,92219,9940,82279,82279,0,10,10365000.0
10365,10365999,21.88142192631053,38.301664855482784,0.044486833964192285,2331.9600069522858,669.0552163124084,2910.398193359375,92224,9942,82282,82282,0,10,10366000.0
10366,10366999,21.88242780186382,38.30273108564564,0.04449467644382887,2332.2749285697937,669.1180503368378,2910.8684997558594,92237,9943,82294,82294,0,10,10367000.0
10367,10367999,21.883704067045706,38.30522554264103,0.04450328298402473,2332.398201227188,669.179356098175,2911.2994384765625,92239,9943,82296,82296,0,10,10368000.0
10368,10368999,21.88457792387519,38.305943820601,0.04451500884026305,2332.7191026210785,669.2415964603424,2911.6133422851562,92243,9944,82299,82299,0,10,10369000.0
10369,10369999,21.885542915767726,38.30685186857493,0.04452484153790204,2333.0357704162598,669.3029537200928,2911.970016479492,92258,9945,82313,82313,0,10,10370000.0
10370,10370999,21.885278684798195,38.30609681199113,0.044525505853826974,2333.766949415207,669.3659858703613,2913.154987335205,92282,9948,82334,82334,0,10,10371000.0
10371,10371999,21.88445328955271,38.304863527494184,0.04452707790965771,2334.891178369522,669.4283607006073,2913.6518363952637,92320,9953,82367,82367,0,10,10372000.0
10372,10372999,21.884085105096876,38.30458024676601,0.04452512544173681,2335.0190789699554,669.4917638301849,2914.204818725586,92320,9953,82367,82367,0,10,10373000.0
10373,10373999,21.88357756418307,38.30373991489155,0.044523078683142425,2335.537549495697,669.5551118850708,2914.7042388916016,92324,9955,82369,82369,0,10,10374000.0
10374,10374999,21.88329053752208,38.30323032418203,0.044520675910746044,2335.6560962200165,669.6167204380035,2915.150375366211,92324,9955,82369,82369,0,10,10375000.0
10375,10375999,21.88289671413742,38.30289082506542,0.04451889053889102,2335.9810082912445,669.678692817688,2915.5219802856445,92329,9956,82373,82373,0,10,10376000.0
10376,10376999,21.88251167873863,38.30215164527187,0.04451578316904192,2336.1098437309265,669.7404353618622,2916.0329666137695,92329,9956,82373,82373,0,10,10377000.0
10377,10377999,21.882162683101175,38.30136041698728,0.04451328367413143,2336.224788427353,669.800966501236,2916.5382232666016,92329,9956,82373,82373,0,10,10378000.0
10378,10378999,21.88178500076629,38.30047998699968,0.04451676745445654,2336.7449543476105,669.8623349666595,2916.736713409424,92353,9958,82395,82395,0,10,10379000.0
10379,10379999,21.88168488501237,38.30029526983718,0.04451304375138554,2337.058828353882,669.9245181083679,2917.276958465576,92361,9959,82402,82402,0,10,10380000.0
10380,10380999,21.881631253855662,38.30015303215291,0.04450870630549053,2337.180276155472,669.9852347373962,2917.8049926757812,92361,9959,82402,82402,0,10,10381000.0
10381,10381999,21.881654119878153,38.30012836230064,0.04450409603062966,2337.2950530052185,670.047723531723,2918.1633834838867,92361,9959,82402,82402,0,10,10382000.0
10382,10382999,21.881938787006472,38.30056369537216,0.044498130360110966,2337.4051270484924,670.1079778671265,2918.638114929199,92361,9959,82402,82402,0,10,10383000.0
10383,10383999,21.882503338533976,38.30194749534393,0.04449765595496469,2337.520409345627,670.1698536872864,2919.244110107422,92362,9959,82403,82403,0,10,10384000.0
10384,10384999,21.883712755640254,38.30513663114617,0.04449911912113458,2337.8302574157715,670.2303910255432,2919.741371154785,92373,9960,82413,82413,0,10,10385000.0
10385,10385999,21.88535023381063,38.30960723445322,0.04452060299202065,2338.139354944229,670.2908120155334,2920.2250175476074,92387,9961,82426,82426,0,10,10386000.0
10386,10386999,21.88709979009472,38.31409694265178,0.04452984218644229,2338.459790468216,670.3530442714691,2920.790027618408,92389,9962,82427,82427,0,10,10387000.0
10387,10387999,21.88863014285377,38.31736401821671,0.04454428894700779,2338.577013015747,670.4140913486481,2921.334499359131,92389,9962,82427,82427,0,10,10388000.0
10388,10388999,21.890522372123943,38.32211859819482,0.044558385938855305,2338.8901143074036,670.4747247695923,2921.7989807128906,92402,9963,82439,82439,0,10,10389000.0
10389,10389999,21.892018897638334,38.324902199772076,0.04457240924218009,2339.0053718090057,670.5349299907684,2922.2206420898438,92403,9963,82440,82440,0,10,10390000.0
10390,10390999,21.892061994247022,38.32457300526895,0.04457370216079026,2339.523365020752,670.5980479717255,2923.4864921569824,92432,9965,82467,82467,0,10,10391000.0
10391,10391999,21.8915380548798,38.32347976395778,0.04457001943983441,2339.6413671970367,670.6591947078705,2924.176902770996,92432,9965,82467,82467,0,10,10392000.0
10392,10392999,21.891241433231954,38.32313245772423,0.04456396751567804,2339.968560218811,670.7224087715149,2924.640510559082,92438,9966,82472,82472,0,10,10393000.0
10393,10393999,21.891005417699226,38.322655376631424,0.04455495253833808,2340.281495809555,670.7833178043365,2925.0599365234375,92450,9967,82483,82483,0,10,10394000.0
10394,10394999,21.890742228774027,38.3219548428305,0.04454902086855261,2340.593228816986,670.8449568748474,2925.3987045288086,92452,9968,82484,82484,0,10,10395000.0
10395,10395999,21.890423625273748,38.321184519099305,0.044542890052088446,2340.710483789444,670.906626701355,2925.7392768859863,92453,9968,82485,82485,0,10,10396000.0
10396,10396999,21.89005715914659,38.32024681676228,0.04453657836018632,2341.2179148197174,670.9675214290619,2926.0509300231934,92477,9970,82507,82507,0,10,10397000.0
10397,10397999,21.889848488761558,38.319835407950066,0.04452858971340046,2341.5357196331024,671.0292706489563,2926.409336090088,92489,9971,82518,82518,0,10,10398000.0
10398,10398999,21.889584784676718,38.31888511824028,0.044523332509519564,2341.861727952957,671.0917122364044,2926.632091522217,92501,9972,82529,82529,0,10,10399000.0
10399,10399999,21.889428519563097,38.318234842455986,0.04451758867446476,2341.9754705429077,671.1519131660461,2927.0205993652344,92501,9972,82529,82529,0,10,10400000.0
10400,10400999,21.88919428648899,38.31735969083545,0.044509770250566794,2342.086775779724,671.2122209072113,2927.376335144043,92501,9972,82529,82529,0,10,10401000.0
10401,10401999,21.889019800368267,38.31659441587839,0.04450485758130829,2342.404998779297,671.2732086181641,2927.6008644104004,92506,9973,82533,82533,0,10,10402000.0
10402,10402999,21.888909611807495,38.31600597691517,0.04450139680993104,2342.726154565811,671.3339698314667,2927.913734436035,92513,9974,82539,82539,0,10,10403000.0
10403,10403999,21.888929887765464,38.315448343567724,0.04449739095768901,2343.0373978614807,671.3962104320526,2928.2434730529785,92525,9975,82550,82550,0,10,10404000.0
10404,10404999,21.8891428874371,38.31550033156233,0.04450254920824659,2343.3488335609436,671.4563012123108,2928.5235557556152,92532,9976,82556,82556,0,10,10405000.0
10405,10405999,21.889539639354652,38.315704578150864,0.044517279015423794,2343.6714901924133,671.5179452896118,2928.713321685791,92545,9977,82568,82568,0,10,10406000.0
10406,10406999,21.89023987373141,38.317255784866695,0.04452639436998096,2343.787875890732,671.5782186985016,2929.2009620666504,92546,9977,82569,82569,0,10,10407000.0
10407,10407999,21.89068392364246,38.31725958081984,0.044534647337689526,2344.3113672733307,671.6406235694885,2929.4379653930664,92573,9979,82594,82594,0,10,10408000.0
10408,10408999,21.89139161126703,38.31789613369524,0.04454524889404177,2344.426821947098,671.7007567882538,2929.736789703369,92573,9979,82594,82594,0,10,10409000.0
10409,10409999,21.891929027522917,38.318091741650946,0.044554602114274644,2344.5550186634064,671.7606451511383,2930.041633605957,92573,9979,82594,82594,0,10,10410000.0
10410,10410999,21.892569469338657,38.31876483087108,0.04456693656347477,2344.8776745796204,671.8216562271118,2930.97762298584,92589,9980,82609,82609,0,10,10411000.0
10411,10411999,21.892368511162797,38.31911153202199,0.044547499444707706,2345.194497346878,671.8839156627655,2931.7360496520996,92593,9981,82612,82612,0,10,10412000.0
10412,10412999,21.89210310097972,38.3187444441024,0.04452947610261393,2345.9021520614624,671.9454569816589,2932.1684646606445,92620,9984,82636,82636,0,10,10413000.0
10413,10413999,21.89171945613962,38.31786589393751,0.044517472836752114,2346.018149137497,672.0061824321747,2932.634696960449,92621,9984,82637,82637,0,10,10414000.0
10414,10414999,21.891331256192913,38.317047482545064,0.04450486818638244,2346.139326572418,672.0675551891327,2932.990146636963,92621,9984,82637,82637,0,10,10415000.0
10415,10415999,21.89114380872214,38.316587609789906,0.044491584128706685,2346.256071805954,672.1289172172546,2933.401378631592,92621,9984,82637,82637,0,10,10416000.0
10416,10416999,21.89082667194955,38.31563141893092,0.04447949946022045,2346.774076461792,672.1904916763306,2933.817886352539,92639,9986,82653,82653,0,10,10417000.0
10417,10417999,21.890545320100518,38.31483460396215,0.044467059556146715,2346.884302377701,672.2515079975128,2934.2331771850586,92639,9986,82653,82653,0,10,10418000.0
10418,10418999,21.89038968804946,38.314337949975375,0.04445183404095254,2347.011919736862,672.3125529289246,2934.6301612854004,92639,9986,82653,82653,0,10,10419000.0
10419,10419999,21.890142808532357,38.313876446750236,0.04444102801442473,2347.524795770645,672.3754444122314,2934.9649391174316,92646,9988,82658,82658,0,10,10420000.0
10420,10420999,21.89006363184667,38.31324335991835,0.04442823575662491,2347.6456768512726,672.4367136955261,2935.222629547119,92646,9988,82658,82658,0,10,10421000.0
10421,10421999,21.890117662935072,38.312931554585944,0.044411806648237184,2347.7628302574158,672.4979844093323,2935.690273284912,92646,9988,82658,82658,0,10,10422000.0
10422,10422999,21.89029302813119,38.31247559317787,0.044400033698691055,2347.878989458084,672.5585992336273,2936.1177406311035,92646,9988,82658,82658,0,10,10423000.0
10423,10423999,21.890473099494816,38.3122533036115,0.04438662104430835,2348.200397491455,672.620600938797,2936.391742706299,92653,9989,82664,82664,0,10,10424000.0
10424,10424999,21.890723782049243,38.312118094867245,0.044376866085739985,2348.3188660144806,672.6812858581543,2936.7575607299805,92653,9989,82664,82664,0,10,10425000.0
10425,10425999,21.890994609580375,38.31200994725332,0.04436788273763681,2348.4365434646606,672.7430052757263,2937.0477142333984,92653,9989,82664,82664,0,10,10426000.0
10426,10426999,21.891431403318954,38.31210235024781,0.04436450613063492,2348.7493455410004,672.8030724525452,2937.2476768493652,92660,9990,82670,82670,0,10,10427000.0
10427,10427999,21.89182042836604,38.31204207432664,0.044363143282386885,2348.8725311756134,672.8656332492828,2937.559467315674,92660,9990,82670,82670,0,10,10428000.0
10428,10428999,21.892450682521517,38.31247100145699,0.04435496424339025,2349.3862216472626,672.9260127544403,2937.7708625793457,92679,9992,82687,82687,0,10,10429000.0
10429,10429999,21.89341122268274,38.313161843026634,0.044345283891444987,2349.5067114830017,672.9870147705078,2938.1274490356445,92679,9992,82687,82687,0,10,10430000.0
10430,10430999,21.893806069512102,38.313125725216786,0.0443413430980959,2350.0148844718933,673.0482954978943,2938.2702865600586,92684,9994,82690,82690,0,10,10431000.0
10431,10431999,21.893700011482906,38.31268041698905,0.04433489429076276,2350.144759654999,673.1099064350128,2939.1993103027344,92686,9994,82692,82692,0,10,10432000.0
10432,10432999,21.893228485446723,38.312060373349,0.04432723797642324,2350.462390899658,673.1707701683044,2939.638473510742,92693,9995,82698,82698,0,10,10433000.0
10433,10433999,21.892928688672082,38.3113581891716,0.044320128252367086,2350.5833628177643,673.2323398590088,2940.04390335083,92693,9995,82698,82698,0,10,10434000.0
10434,10434999,21.892601795717038,38.31056629001994,0.044312897404333196,2350.9037137031555,673.294317483902,2940.2972106933594,92695,9996,82699,82699,0,10,10435000.0
10435,10435999,21.89241472184297,38.30998829578273,0.04430946092106647,2351.2153046131134,673.3547117710114,2940.48588180542,92697,9997,82700,82700,0,10,10436000.0
10436,10436999,21.892362936579627,38.30950193247767,0.04430333345475357,2351.327225923538,673.4147615432739,2940.7657470703125,92697,9997,82700,82700,0,10,10437000.0
10437,10437999,21.892135300495504,38.308875131545136,0.04430269157529576,2351.843644618988,673.4754695892334,2940.869861602783,92714,9999,82715,82715,0,10,10438000.0
10438,10438999,21.891911744103755,38.308156812264826,0.04429978399660617,2352.1675724983215,673.5379686355591,2941.1678352355957,92726,10000,82726,82726,0,10,10439000.0
10439,10439999,21.89178853419684,38.307646479682624,0.044297603778312045,2352.687041759491,673.6084990501404,2941.314197540283,92740,10002,82738,82738,0,10,10440000.0
10440,10440999,21.892027135676603,38.30950795123354,0.04429075942069083,2352.7999243736267,673.6696975231171,2941.6929817199707,92740,10002,82738,82738,0,10,10441000.0
10441,10441999,21.89233182026682,38.30958040370964,0.04429260311511507,2353.132424354553,673.7317290306091,2941.931571960449,92756,10003,82753,82753,0,10,10442000.0
10442,10442999,21.89320517316446,38.31268495202627,0.0442946955731085,2353.459323167801,673.8012959957123,2942.162078857422,92758,10004,82754,82754,0,10,10443000.0
10443,10443999,21.893875239219238,38.313982647450075,0.04428732766975951,2353.9814682006836,673.8634881973267,2942.4082412719727,92762,10006,82756,82756,0,10,10444000.0
10444,10444999,21.894601153247592,38.31472621251341,0.04429290334782565,2354.111239671707,673.9354424476624,2942.737861633301,92762,10006,82756,82756,0,10,10445000.0
10445,10445999,21.895611662583946,38.31607514695096,0.04430595938348292,2354.819330215454,673.9972143173218,2942.8965644836426,92788,10009,82779,82779,0,10,10446000.0
10446,10446999,21.896605532098967,38.31738124621304,0.0443198742046349,2354.960364818573,674.0683217048645,2943.314540863037,92788,10009,82779,82779,0,10,10447000.0
10447,10447999,21.8975412276117,38.31886587378761,0.04433303461238647,2355.27375292778,674.1298263072968,2943.728416442871,92800,10010,82790,82790,0,10,10448000.0
10448,10448999,21.898389093594446,38.32003893472236,0.04434602045300062,2355.604684829712,674.1918351650238,2943.9211044311523,92802,10011,82791,82791,0,10,10449000.0
10449,10449999,21.89951015326398,38.32191746039443,0.04435537489852115,2355.72212100029,674.2533037662506,2944.2392349243164,92802,10011,82791,82791,0,10,10450000.0
10450,10450999,21.900492485855494,38.32313923552574,0.0443686967457253,2356.03214263916,674.3136761188507,2944.5544471740723,92805,10012,82793,82793,0,10,10451000.0
10451,10451999,21.900754468101354,38.32295899792901,0.044369656410951475,2356.5617780685425,674.3743605613708,2945.0947914123535,92834,10014,82820,82820,0,10,10452000.0
10452,10452999,21.90045304314747,38.32285054252886,0.044363404043568866,2356.8774967193604,674.4351210594177,2945.7690238952637,92846,10015,82831,82831,0,10,10453000.0
10453,10453999,21.89987811594368,38.32185943530385,0.044362091741692256,2357.402210712433,674.4962422847748,2946.1314239501953,92855,10017,82838,82838,0,10,10454000.0
10454,10454999,21.899357896234672,38.32093987288607,0.04435841358307113,2357.5412788391113,674.5682108402252,2946.48681640625,92856,10017,82839,82839,0,10,10455000.0
10455,10455999,21.898959619874613,38.320253620007094,0.044353916305477914,2358.0494709014893,674.6289005279541,2946.6424980163574,92864,10019,82845,82845,0,10,10456000.0
10456,10456999,21.898404557184133,38.31899684906012,0.04435301408839187,2358.3786284923553,674.6905572414398,2946.8624267578125,92867,10020,82847,82847,0,10,10457000.0
10457,10457999,21.897950292250595,38.31798947754936,0.04435053295962166,2358.702582836151,674.7521181106567,2947.1684799194336,92899,10021,82878,82878,0,10,10458000.0
10458,10458999,21.8974987180368,38.31698067681177,0.044348804944925435,2358.8210940361023,674.8131747245789,2947.596279144287,92899,10021,82878,82878,0,10,10459000.0
10459,10459999,21.897095564298983,38.31600042454553,0.04434693816281443,2359.134847164154,674.8742492198944,2947.788719177246,92901,10022,82879,82879,0,10,10460000.0
10460,10460999,21.89683131946657,38.31531984353166,0.04434622685894518,2359.4436717033386,674.9350440502167,2947.997688293457,92913,10023,82890,82890,0,10,10461000.0
10461,10461999,21.89692125148292,38.315368302880884,0.04434523298116777,2359.568521261215,674.9952173233032,2948.3671340942383,92913,10023,82890,82890,0,10,10462000.0
10462,10462999,21.89713067440342,38.315804140846424,0.04434976874701868,2359.6925184726715,675.055125951767,2948.6022987365723,92913,10023,82890,82890,0,10,10463000.0
10463,10463999,21.8974150632479,38.31614721243905,0.04435477496747586,2360.208298921585,675.1165595054626,2948.7069511413574,92927,10025,82902,82902,0,10,10464000.0
10464,10464999,21.898255128549646,38.3186001763643,0.04436064802233097,2360.5269889831543,675.1777331829071,2948.919891357422,92943,10026,82917,82917,0,10,10465000.0
10465,10465999,21.899810655992567,38.32449251753803,0.04437224175750354,2360.846366405487,675.2378780841827,2949.174705505371,92945,10027,82918,82918,0,10,10466000.0
10466,10466999,21.90095704095193,38.32780469221453,0.044382024267224374,2361.3755633831024,675.2998156547546,2949.4038162231445,92960,10029,82931,82931,0,10,10467000.0
10467,10467999,21.902205606401537,38.33106563403931,0.04440981011758516,2362.109747171402,675.3639245033264,2949.6777572631836,92979,10032,82947,82947,0,10,10468000.0
10468,10468999,21.903478823914597,38.33464010398262,0.04443643972332778,2362.422703027725,675.4243566989899,2950.0875129699707,92981,10033,82948,82948,0,10,10469000.0
10469,10469999,21.903841062888063,38.33586567623688,0.04444928771031087,2362.7542078495026,675.4857015609741,2951.0063819885254,92993,10034,82959,82959,0,10,10470000.0
10470,10470999,21.903421369604615,38.33551517325234,0.04444981514706947,2362.880635023117,675.5476565361023,2951.557384490967,92994,10034,82960,82960,0,10,10471000.0
10471,10471999,21.903071905540724,38.33478042768252,0.044449103964198544,2362.9989511966705,675.6095850467682,2951.8941802978516,92994,10034,82960,82960,0,10,10472000.0
10472,10472999,21.903387364532836,38.335390132193396,0.04444498647721684,2363.119483947754,675.6710608005524,2952.1777839660645,92994,10034,82960,82960,0,10,10473000.0
10473,10473999,21.903436285313507,38.33531582301438,0.04444476564111177,2363.433087348938,675.7315170764923,2952.3586502075195,92996,10035,82961,82961,0,10,10474000.0
10474,10474999,21.90362318576318,38.33525688518768,0.0444393413417602,2363.753147125244,675.792722940445,2952.630844116211,93000,10036,82964,82964,0,10,10475000.0
10475,10475999,21.903737045025874,38.33525397465364,0.044435583051871896,2364.269880056381,675.8562467098236,2952.8871879577637,93014,10038,82976,82976,0,10,10476000.0
10476,10476999,21.903951431969727,38.335540685618625,0.04443269504618974,2364.9802973270416,675.9182503223419,2953.028305053711,93024,10041,82983,82983,0,10,10477000.0
10477,10477999,21.904097568334823,38.335598994425524,0.04443072916812463,2365.29399061203,675.9787793159485,2953.3171882629395,93026,10042,82984,82984,0,10,10478000.0
10478,10478999,21.904561569135275,38.33657759800724,0.044431685275317157,2365.6120409965515,676.0390577316284,2953.4776153564453,93036,10043,82993,82993,0,10,10479000.0
10479,10479999,21.904898304711136,38.337017338602344,0.04443431121528407,2365.9423995018005,676.0998129844666,2953.689395904541,93038,10044,82994,82994,0,10,10480000.0
10480,10480999,21.905451218399293,38.337920576233344,0.044436778045625736,2366.2588629722595,676.1606817245483,2954.0096893310547,93041,10045,82996,82996,0,10,10481000.0
10481,10481999,21.906013452670635,38.34016313833017,0.04443950213824799,2366.7796778678894,676.222494840622,2954.127899169922,93045,10047,82998,82998,0,10,10482000.0
10482,10482999,21.906578364448983,38.34079701439072,0.044444241174465327,2366.889212369919,676.2823939323425,2954.426368713379,93045,10047,82998,82998,0,10,10483000.0
10483,10483999,21.907511978111945,38.3423105105326,0.04445642616041823,2367.0027039051056,676.3433132171631,2954.800422668457,93045,10047,82998,82998,0,10,10484000.0
10484,10484999,21.908402152718036,38.343412095123895,0.04446116186544957,2367.3314275741577,676.4059860706329,2955.205394744873,93057,10048,83009,83009,0,10,10485000.0
10485,10485999,21.909111175561126,38.34425577880465,0.04446736782843619,2367.6513826847076,676.468273639679,2955.4539527893066,93059,10049,83010,83010,0,10,10486000.0
10486,10486999,21.91015588593056,38.346013868096776,0.04448016725176218,2367.772826194763,676.5290987491608,2955.8029251098633,93060,10049,83011,83011,0,10,10487000.0
10487,10487999,21.911040942637417,38.3474319259809,0.04448760860444467,2368.0900461673737,676.5891537666321,2956.037841796875,93063,10050,83013,83013,0,10,10488000.0
10488,10488999,21.911377733421684,38.34722329270459,0.04448829933264831,2368.204962015152,676.6506016254425,2956.272964477539,93064,10050,83014,83014,0,10,10489000.0
10489,10489999,21.911029117082073,38.34736475812234,0.04448423315246752,2368.7185077667236,676.711895942688,2957.127696990967,93087,10052,83035,83035,0,10,10490000.0
10490,10490999,21.910509444513213,38.34663363039072,0.04447981507167065,2368.843899011612,676.7740614414215,2957.6318435668945,93087,10052,83035,83035,0,10,10491000.0
10491,10491999,21.910212305311884,38.34787292608304,0.04447089546226124,2368.9640712738037,676.8366403579712,2957.9292793273926,93087,10052,83035,83035,0,10,10492000.0
10492,10492999,21.909866481328717,38.34704411771626,0.04446473712212895,2369.279152870178,676.8976068496704,2958.1858978271484,93099,10053,83046,83046,0,10,10493000.0
10493,10493999,21.90957778388792,38.346554954973335,0.04446246733154113,2369.999531984329,676.9589765071869,2958.297477722168,93120,10056,83064,83064,0,10,10494000.0
10494,10494999,21.909267100847728,38.34570052678839,0.04445980032257413,2370.1175396442413,677.0212781429291,2958.578842163086,93120,10056,83064,83064,0,10,10495000.0
10495,10495999,21.909154612655634,38.34518353937369,0.044452307186899076,2370.2363801002502,677.0830383300781,2958.9460258483887,93120,10056,83064,83064,0,10,10496000.0
10496,10496999,21.90911486914989,38.34501819230996,0.04444904499186564,2370.3542878627777,677.144927740097,2959.3261795043945,93120,10056,83064,83064,0,10,10497000.0
10497,10497999,21.909265919045733,38.3452949270938,0.04444998987732429,2370.872977733612,677.2062590122223,2959.4683723449707,93124,10058,83066,83066,0,10,10498000.0
10498,10498999,21.909495403070437,38.345580996605136,0.044459609582866655,2371.0028297901154,677.2681384086609,2959.7799186706543,93124,10058,83066,83066,0,10,10499000.0
10499,10499999,21.910220918221977,38.34924617837205,0.04447138510333015,2371.130133628845,677.3288366794586,2960.1309700012207,93125,10058,83067,83067,0,10,10500000.0
10500,10500999,21.911543925415295,38.35584725638865,0.044485518755186804,2371.242865562439,677.3889775276184,2960.372787475586,93125,10058,83067,83067,0,10,10501000.0
10501,10501999,21.912750880532002,38.3593240570159,0.04450434821913263,2371.557667016983,677.4517776966095,2960.8004570007324,93128,10059,83069,83069,0,10,10502000.0
10502,10502999,21.914102239477543,38.36272522888785,0.04452832149923813,2371.892447948456,677.5158884525299,2961.100254058838,93140,10060,83080,83080,0,10,10503000.0
10503,10503999,21.9156068971826,38.36606595330295,0.04455947287266282,2372.412851333618,677.5794117450714,2961.323802947998,93149,10062,83087,83087,0,10,10504000.0
10504,10504999,21.917546050243317,38.37029710854809,0.044602625882777414,2372.5326812267303,677.639710187912,2961.5743408203125,93149,10062,83087,83087,0,10,10505000.0
10505,10505999,21.919370581260885,38.3737732106321,0.044635821979174706,2372.853106021881,677.7004637718201,2961.9243202209473,93178,10063,83115,83115,0,10,10506000.0
10506,10506999,21.920935153421013,38.376834360892246,0.04466247242568189,2372.968500852585,677.7615554332733,2962.294990539551,93178,10063,83115,83115,0,10,10507000.0
10507,10507999,21.922540042411786,38.379506469971346,0.04469132875067017,2373.0870637893677,677.822760105133,2962.649932861328,93178,10063,83115,83115,0,10,10508000.0
10508,10508999,21.923753735976554,38.38223816492319,0.04470644814946623,2373.4038071632385,677.883029460907,2962.970546722412,93190,10064,83126,83126,0,10,10509000.0
10509,10509999,21.923645798008497,38.38216078935435,0.04469961175270876,2373.5327112674713,677.9465782642365,2964.5232276916504,93191,10064,83127,83127,0,10,10510000.0
10510,10510999,21.923252141421457,38.38141297890936,0.04468549532607147,2373.8694972991943,678.0107669830322,2965.167667388916,93203,10065,83138,83138,0,10,10511000.0
10511,10511999,21.92296028549557,38.380921922949014,0.04467671494324932,2373.9880096912384,678.0722458362579,2965.6828956604004,93204,10065,83139,83139,0,10,10512000.0
10512,10512999,21.92273345416993,38.380432203048414,0.0446644975476298,2374.308772087097,678.1337938308716,2966.1757011413574,93209,10066,83143,83143,0,10,10513000.0
10513,10513999,21.922474952501243,38.3796177544389,0.04465358808655251,2374.6320543289185,678.195475101471,2966.6181449890137,93212,10067,83145,83145,0,10,10514000.0
10514,10514999,21.92203046753096,38.378672083942355,0.0446512725133732,2374.9495363235474,678.2571353912354,2966.9289054870605,93215,10068,83147,83147,0,10,10515000.0
10515,10515999,21.921776474630192,38.37816234801446,0.044639452316971306,2375.264288663864,678.3178815841675,2967.295783996582,93227,10069,83158,83158,0,10,10516000.0
10516,10516999,21.921690428491296,38.37801582122465,0.04463951456553694,2375.9967482089996,678.3812131881714,2967.5198402404785,93249,10072,83177,83177,0,10,10517000.0
10517,10517999,21.92164596448128,38.37782808948976,0.04464344177459212,2376.524055480957,678.4422855377197,2967.797435760498,93258,10074,83184,83184,0,10,10518000.0
10518,10518999,21.92156141978805,38.377251729128126,0.044642998097748965,2376.6458537578583,678.5038819313049,2968.1543312072754,93258,10074,83184,83184,0,10,10519000.0
10519,10519999,21.921502896615014,38.37681059894388,0.04464772496722336,2376.757021665573,678.5653805732727,2968.575206756592,93258,10074,83184,83184,0,10,10520000.0
10520,10520999,21.92151893613768,38.37626836564825,0.04465199871263914,2377.0808680057526,678.6273725032806,2968.7720832824707,93260,10075,83185,83185,0,10,10521000.0
10521,10521999,21.921649357554465,38.375999434979306,0.044655656402094124,2377.4011034965515,678.6904904842377,2969.082042694092,93262,10076,83186,83186,0,10,10522000.0
10522,10522999,21.921926503129725,38.375941367935035,0.04466501894120978,2377.519977092743,678.7518875598907,2969.449993133545,93262,10076,83186,83186,0,10,10523000.0
10523,10523999,21.92216032582222,38.375930683684224,0.044677812793714855,2377.6379477977753,678.8131997585297,2969.8219032287598,93263,10076,83187,83187,0,10,10524000.0
10524,10524999,21.92245400704967,38.37578875813251,0.044685471721924164,2377.757143497467,678.8733222484589,2970.099822998047,93263,10076,83187,83187,0,10,10525000.0
10525,10525999,21.922885675945587,38.37575450465693,0.04469046683087641,2378.273329973221,678.9361991882324,2970.516674041748,93287,10078,83209,83209,0,10,10526000.0
10526,10526999,21.923249829222257,38.37544752598985,0.044697044916516715,2378.789662361145,678.996778011322,2970.7833137512207,93317,10080,83237,83237,0,10,10527000.0
10527,10527999,21.923496385121393,38.37500527000576,0.04469765326100994,2378.9040439128876,679.0581586360931,2971.134998321533,93317,10080,83237,83237,0,10,10528000.0
10528,10528999,21.923569169044796,38.37441892842474,0.04470062980869205,2379.2285714149475,679.1195065975189,2971.392864227295,93319,10081,83238,83238,0,10,10529000.0
10529,10529999,21.923211348574977,38.373361714493655,0.04470150569139564,2379.556878089905,679.1801903247833,2972.4557723999023,93335,10082,83253,83253,0,10,10530000.0
10530,10530999,21.922522840040706,38.3721199417016,0.04470216164602181,2379.680248737335,679.2411086559296,2973.132511138916,93336,10082,83254,83254,0,10,10531000.0
10531,10531999,21.92201574599144,38.371226484199525,0.04469883780199724,2379.8068063259125,679.3031678199768,2973.6268997192383,93336,10082,83254,83254,0,10,10532000.0
10532,10532999,21.92131487993314,38.36994371357492,0.04469902165418349,2380.329482793808,679.3644316196442,2973.9420204162598,93362,10084,83278,83278,0,10,10533000.0
10533,10533999,21.920851486173646,38.3691924296438,0.04469592093292463,2380.6478040218353,679.4253172874451,2974.227954864502,93364,10085,83279,83279,0,10,10534000.0
10534,10534999,21.920221093249634,38.36800396378234,0.04469495149767855,2380.7790875434875,679.4871454238892,2974.609889984131,93365,10085,83280,83280,0,10,10535000.0
10535,10535999,21.919851553508842,38.36777939893964,0.044692054882526144,2380.901791572571,679.5486435890198,2974.961456298828,93366,10085,83281,83281,0,10,10536000.0
10536,10536999,21.919370542472116,38.36663631641942,0.044690045944331014,2381.016221523285,679.6097326278687,2975.330764770508,93366,10085,83281,83281,0,10,10537000.0
10537,10537999,21.919153100766426,38.367920132971605,0.04468828479256581,2381.5301620960236,679.6707026958466,2975.5162086486816,93380,10087,83293,83293,0,10,10538000.0
10538,10538999,21.918839279719812,38.368620665728244,0.04468649092388466,2381.849949359894,679.7318208217621,2975.8257637023926,93387,10088,83299,83299,0,10,10539000.0
10539,10539999,21.918730829891935,38.36831626693305,0.04468541695380335,2381.967456817627,679.7924499511719,2976.1294174194336,93387,10088,83299,83299,0,10,10540000.0
10540,10540999,21.9185397186767,38.367603793631396,0.044684937328692276,2382.088318347931,679.8527641296387,2976.429756164551,93387,10088,83299,83299,0,10,10541000.0
10541,10541999,21.918645298477777,38.36778383504895,0.044684585168239144,2382.212776184082,679.9139356613159,2976.8522148132324,93387,10088,83299,83299,0,10,10542000.0
10542,10542999,21.919174048730554,38.36893571008489,0.04468630399507012,2382.3295311927795,679.9742150306702,2977.1886253356934,93387,10088,83299,83299,0,10,10543000.0
10543,10543999,21.919770190827037,38.36976636195025,0.044693384421544136,2382.448366880417,680.0360884666443,2977.536445617676,93387,10088,83299,83299,0,10,10544000.0
10544,10544999,21.92077552191909,38.37277030722704,0.04470609263818803,2382.567784309387,680.0972774028778,2977.963447570801,93387,10088,83299,83299,0,10,10545000.0
10545,10545999,21.921710147169474,38.374056844753724,0.04471383231529069,2382.8973758220673,680.1590414047241,2978.336078643799,93403,10089,83314,83314,0,10,10546000.0
10546,10546999,21.9226951378045,38.37528628967873,0.04472172993566603,2383.2401492595673,680.2212016582489,2978.5958404541016,93405,10090,83315,83315,0,10,10547000.0
10547,10547999,21.923481781100463,38.375964701919216,0.04472547175630093,2383.758652448654,680.2831914424896,2978.9052810668945,93414,10092,83322,83322,0,10,10548000.0
10548,10548999,21.924481940841446,38.37797304413924,0.04473176166926873,2383.8733735084534,680.3435091972351,2979.365753173828,93414,10092,83322,83322,0,10,10549000.0
10549,10549999,21.924793996003114,38.37781176415818,0.044729097929022466,2383.9959437847137,680.404468536377,2979.7398262023926,93414,10092,83322,83322,0,10,10550000.0
10550,10550999,21.9247832231022,38.37798245885841,0.044711778410165604,2384.5357568264008,680.4675590991974,2981.1727981567383,93421,10094,83327,83327,0,10,10551000.0
10551,10551999,21.925001495393573,38.37831283347494,0.044703153787535865,2384.655607700348,680.5296273231506,2982.019905090332,93422,10094,83328,83328,0,10,10552000.0
10552,10552999,21.925377278647968,38.37884873735044,0.04469458985225827,2384.777523994446,680.59166264534,2982.5231971740723,93422,10094,83328,83328,0,10,10553000.0
10553,10553999,21.925695418914273,38.3793729581113,0.044675657608779895,2385.296676635742,680.6548593044281,2983.050350189209,93447,10096,83351,83351,0,10,10554000.0
10554,10554999,21.926062218081057,38.37986217207327,0.04466503428527846,2385.414398431778,680.7156987190247,2983.5515785217285,93448,10096,83352,83352,0,10,10555000.0
10555,10555999,21.92634420121858,38.38005271279786,0.044653482723861715,2385.7311227321625,680.7767422199249,2983.99995803833,93460,10097,83363,83363,0,10,10556000.0
10556,10556999,21.926643358191917,38.38017925896638,0.044644406519019686,2385.8480422496796,680.8381884098053,2984.4577713012695,93460,10097,83363,83363,0,10,10557000.0
10557,10557999,21.92689065571272,38.380106975325745,0.044630794993031686,2386.368153333664,680.8997766971588,2984.8249893188477,93485,10099,83386,83386,0,10,10558000.0
10558,10558999,21.927293228817145,38.38051034210218,0.044619388278723915,2386.8842973709106,680.9619812965393,2985.216823577881,93509,10101,83408,83408,0,10,10559000.0
10559,10559999,21.927660978766546,38.380670004726994,0.04460861869030319,2386.9971730709076,681.0222747325897,2985.5488204956055,93509,10101,83408,83408,0,10,10560000.0
10560,10560999,21.92833465607236,38.381373757022445,0.044593371951828775,2387.319265127182,681.0842463970184,2986.0683631896973,93514,10102,83412,83412,0,10,10561000.0
10561,10561999,21.928986882060382,38.38163350388861,0.044583144835795285,2387.840893268585,681.146481513977,2986.5134239196777,93538,10104,83434,83434,0,10,10562000.0
10562,10562999,21.92961796409799,38.38214334020276,0.044579766404789,2388.163629055023,681.2076392173767,2986.915874481201,93550,10105,83445,83445,0,10,10563000.0
10563,10563999,21.930779883875687,38.38335646730015,0.044567108410217715,2388.2727053165436,681.2687842845917,2987.4349479675293,93550,10105,83445,83445,0,10,10564000.0
10564,10564999,21.93186868260354,38.38436973512197,0.04456004189722973,2388.3871626853943,681.330331325531,2987.964328765869,93550,10105,83445,83445,0,10,10565000.0
10565,10565999,21.932971001919952,38.385283166821466,0.04455737195772613,2388.707365989685,681.3929822444916,2988.3998985290527,93562,10106,83456,83456,0,10,10566000.0
10566,10566999,21.93404656476353,38.38630936267291,0.04455914861701238,2389.0269136428833,681.455135345459,2988.8749961853027,93574,10107,83467,83467,0,10,10567000.0
10567,10567999,21.935036327064633,38.3870389797404,0.04455365823213786,2389.3400428295135,681.517219543457,2989.325973510742,93586,10108,83478,83478,0,10,10568000.0
10568,10568999,21.935862044275336,38.38749563587581,0.044543478185189445,2389.454633951187,681.579078912735,2989.7899284362793,93586,10108,83478,83478,0,10,10569000.0
10569,10569999,21.936375465806837,38.387511275308526,0.04454705078482579,2389.573422431946,681.6408994197845,2990.161994934082,93586,10108,83478,83478,0,10,10570000.0
10570,10570999,21.936257021150368,38.38684183766661,0.04454356884527033,2389.6969969272614,681.703498840332,2991.32413482666,93587,10108,83479,83479,0,10,10571000.0
10571,10571999,21.935718405475075,38.38627033312375,0.04453895804072794,2389.8196811676025,681.7656943798065,2992.2015800476074,93587,10108,83479,83479,0,10,10572000.0
10572,10572999,21.935251107121065,38.385148002051174,0.0445353310190425,2389.947904109955,681.8337693214417,2992.906883239746,93587,10108,83479,83479,0,10,10573000.0
10573,10573999,21.93478190418335,38.38402617693318,0.044528932591439196,2390.2685544490814,681.8962798118591,2993.3665313720703,93602,10109,83493,83493,0,10,10574000.0
10574,10574999,21.934442125075723,38.383201562207624,0.04452377031156152,2390.7949776649475,681.9588742256165,2993.582302093506,93611,10111,83500,83500,0,10,10575000.0
10575,10575999,21.93399803153607,38.38230857240486,0.04452149224417001,2391.3177320957184,682.0217263698578,2993.8762016296387,93635,10113,83522,83522,0,10,10576000.0
10576,10576999,21.93361385606088,38.381748886487685,0.04451545756610975,2391.6464936733246,682.0842320919037,2994.297607421875,93637,10114,83523,83523,0,10,10577000.0
10577,10577999,21.93334404603735,38.38126089203025,0.044506501904704954,2392.17041683197,682.1456100940704,2994.5748443603516,93652,10116,83536,83536,0,10,10578000.0
10578,10578999,21.932868282574717,38.38013160042078,0.044507784187181154,2392.4911680221558,682.2066640853882,2994.9402389526367,93654,10117,83537,83537,0,10,10579000.0
10579,10579999,21.932610697620433,38.379435571559654,0.04450531950369285,2392.6110846996307,682.268294095993,2995.359272003174,93654,10117,83537,83537,0,10,10580000.0
10580,10580999,21.932444146894145,38.38006175567965,0.04449791170110273,2392.730901479721,682.3286905288696,2995.685070037842,93654,10117,83537,83537,0,10,10581000.0
10581,10581999,21.932291744375906,38.37945002288263,0.04449574331639783,2392.8466975688934,682.3903005123138,2996.126304626465,93654,10117,83537,83537,0,10,10582000.0
10582,10582999,21.932187770180473,38.378883582778776,0.04449439990855153,2393.1705935001373,682.4530050754547,2996.456745147705,93666,10118,83548,83548,0,10,10583000.0
10583,10583999,21.932144864928695,38.378393244769434,0.044495553759824946,2393.6900160312653,682.513904094696,2996.681312561035,93690,10120,83570,83570,0,10,10584000.0
10584,10584999,21.93233088408566,38.37898978159793,0.044492219903439434,2393.8145718574524,682.5770838260651,2997.2666244506836,93690,10120,83570,83570,0,10,10585000.0
10585,10585999,21.93273518915478,38.38243328403027,0.044487766817912555,2394.541340112686,682.6396284103394,2997.566093444824,93716,10123,83593,83593,0,10,10586000.0
10586,10586999,21.933191337307566,38.38272910242076,0.044492311063753176,2394.859118938446,682.7010626792908,2997.8905639648438,93728,10124,83604,83604,0,10,10587000.0
10587,10587999,21.933619993149968,38.382759538257226,0.04449474842660084,2395.378390789032,682.7621812820435,2998.2305030822754,93744,10126,83618,83618,0,10,10588000.0
10588,10588999,21.933934014825212,38.38262164152564,0.04449620947771116,2395.4984242916107,682.8251786231995,2998.6240005493164,93744,10126,83618,83618,0,10,10589000.0
10589,10589999,21.934164874884637,38.38236319501376,0.044497206730941374,2395.8250815868378,682.8855726718903,2998.993465423584,93756,10127,83629,83629,0,10,10590000.0
10590,10590999,21.934400602447468,38.382857495141955,0.04449591080738513,2396.7402288913727,682.9478347301483,2999.2069969177246,93809,10131,83678,83678,0,10,10591000.0
10591,10591999,21.93372947704959,38.38167915709755,0.044497929035911654,2397.0625898838043,683.0095727443695,3000.119804382324,93816,10132,83684,83684,0,10,10592000.0
10592,10592999,21.933140965944315,38.38095629114868,0.04449527011329202,2397.3903329372406,683.0707969665527,3000.7046279907227,93828,10133,83695,83695,0,10,10593000.0
10593,10593999,21.932443791083653,38.380013776681274,0.04449883369787411,2397.5256378650665,683.1409301757812,3001.154800415039,93829,10133,83696,83696,0,10,10594000.0
10594,10594999,21.931826854577878,38.37898963238301,0.04449856498590099,2397.6485493183136,683.2027621269226,3001.5495109558105,93830,10133,83697,83697,0,10,10595000.0
10595,10595999,21.93122426900507,38.37797397715592,0.0444971561442451,2397.9709811210632,683.2637150287628,3001.880226135254,93834,10134,83700,83700,0,10,10596000.0
10596,10596999,21.930563113502416,38.376741911551974,0.04449682129042076,2398.490949869156,683.324994802475,3002.180923461914,93838,10136,83702,83702,0,10,10597000.0
10597,10597999,21.930156152715316,38.376602914808736,0.04449209809083143,2399.015492916107,683.3878087997437,3002.404094696045,93852,10138,83714,83714,0,10,10598000.0
10598,10598999,21.930030602536434,38.37691928340276,0.04448958918713031,2399.3339920043945,683.4481205940247,3002.667133331299,93856,10139,83717,83717,0,10,10599000.0
10599,10599999,21.929910816171585,38.376693458839085,0.044486428671562606,2399.4612278938293,683.508544921875,3003.028018951416,93856,10139,83717,83717,0,10,10600000.0
10600,10600999,21.92994711925369,38.376550247605934,0.04448769622134385,2399.795832157135,683.5705046653748,3003.3340225219727,93870,10140,83730,83730,0,10,10601000.0
10601,10601999,21.930134966591122,38.37689383095586,0.04448659840768987,2400.312898159027,683.6313998699188,3003.5303688049316,93885,10142,83743,83743,0,10,10602000.0
10602,10602999,21.93034254057671,38.37702502093395,0.04448780817288445,2400.644620656967,683.7025170326233,3003.82027053833,93889,10143,83746,83746,0,10,10603000.0
10603,10603999,21.9306652106162,38.377475168627285,0.04448378371652817,2400.9719347953796,683.763105392456,3004.119541168213,93902,10144,83758,83758,0,10,10604000.0
10604,10604999,21.93096705334613,38.377426732434,0.04448256745843837,2401.08856344223,683.8239674568176,3004.477195739746,93902,10144,83758,83758,0,10,10605000.0
10605,10605999,21.931532538348424,38.377770155624034,0.0444799741486257,2401.4175198078156,683.8859007358551,3004.783145904541,93914,10145,83769,83769,0,10,10606000.0
10606,10606999,21.932213581365932,38.37839257553008,0.044477036162411054,2401.934479236603,683.9462802410126,3004.9453506469727,93940,10147,83793,83793,0,10,10607000.0
10607,10607999,21.932501006802163,38.378235269270164,0.044471674540803474,2402.044772386551,684.0080993175507,3005.2330207824707,93940,10147,83793,83793,0,10,10608000.0
10608,10608999,21.93257943428539,38.377799193902156,0.04446070230098553,2402.376246213913,684.069581747055,3005.58895111084,93943,10148,83795,83795,0,10,10609000.0
10609,10609999,21.93214714025161,38.37707042225315,0.04445871566046966,2402.504540205002,684.1315984725952,3007.1153564453125,93946,10148,83798,83798,0,10,10610000.0
10610,10610999,21.931625103984295,38.376356595318306,0.044458506109945284,2402.833643913269,684.1939527988434,3007.9076499938965,93948,10149,83799,83799,0,10,10611000.0
10611,10611999,21.93104860036513,38.37536286238156,0.04445822612705441,2402.945608139038,684.2556364536285,3008.457244873047,93948,10149,83799,83799,0,10,10612000.0
10612,10612999,21.930479545745907,38.37433956380844,0.04445963883145332,2403.0602991580963,684.317791223526,3008.858798980713,93948,10149,83799,83799,0,10,10613000.0
10613,10613999,21.92997584083855,38.3734337049064,0.04445900930985691,2403.387590408325,684.380695104599,3009.22074508667,93955,10150,83805,83805,0,10,10614000.0
10614,10614999,21.92939776466179,38.37248931075625,0.04445674342449735,2403.5139498710632,684.4418454170227,3009.7125205993652,93956,10150,83806,83806,0,10,10615000.0
10615,10615999,21.929020194873054,38.3719086148889,0.044458150372077565,2403.831495285034,684.5043478012085,3010.1814155578613,93971,10151,83820,83820,0,10,10616000.0
10616,10616999,21.928832892958074,38.37217148019599,0.044453552366853666,2404.1492190361023,684.5661334991455,3010.5354537963867,93983,10152,83831,83831,0,10,10617000.0
10617,10617999,21.928953622270488,38.373056787366565,0.04445981400881016,2404.269612312317,684.6279487609863,3011.0244903564453,93983,10152,83831,83831,0,10,10618000.0
10618,10618999,21.929778522413613,38.37555684500775,0.04447011742432816,2404.3824696540833,684.6896498203278,3011.4214401245117,93984,10152,83832,83832,0,10,10619000.0
10619,10619999,21.930616984566633,38.37752324075909,0.044481137945279525,2404.7085065841675,684.7515048980713,3011.771514892578,93996,10153,83843,83843,0,10,10620000.0
10620,10620999,21.931803014373163,38.38014331020995,0.04449459636899711,2405.238222837448,684.812896490097,3012.1640434265137,94012,10155,83857,83857,0,10,10621000.0
10621,10621999,21.93316631304596,38.38257310413922,0.044514412342891885,2405.351111650467,684.8741836547852,3012.6012954711914,94012,10155,83857,83857,0,10,10622000.0
10622,10622999,21.934346820069578,38.38494772472427,0.04453232139848484,2405.465172767639,684.9349009990692,3012.9832496643066,94012,10155,83857,83857,0,10,10623000.0
10623,10623999,21.935967661727712,38.387859833951644,0.044557502663215676,2405.784224510193,684.9963629245758,3013.4069023132324,94024,10156,83868,83868,0,10,10624000.0
10624,10624999,21.937743183659794,38.39087338395217,0.044577656279530586,2406.104360818863,685.0571773052216,3013.838237762451,94032,10157,83875,83875,0,10,10625000.0
10625,10625999,21.939387949373195,38.39345818231149,0.044597280549718676,2406.2243254184723,685.1186249256134,3014.222640991211,94033,10157,83876,83876,0,10,10626000.0
10626,10626999,21.941311137563446,38.396692639012855,0.04462898018229755,2406.34339928627,685.1789584159851,3014.5163040161133,94033,10157,83876,83876,0,10,10627000.0
10627,10627999,21.942779889852485,38.39883216444952,0.04464995297615659,2406.860113620758,685.2403936386108,3014.85445022583,94077,10159,83918,83918,0,10,10628000.0
10628,10628999,21.943585710772616,38.39993950269235,0.04465380417453502,2407.1931507587433,685.3020877838135,3015.8157844543457,94093,10160,83933,83933,0,10,10629000.0
10629,10629999,21.9426757515477,38.398862285084135,0.044658284330054476,2407.7262530326843,685.3660502433777,3016.7034301757812,94106,10162,83944,83944,0,10,10630000.0
10630,10630999,21.941947199217818,38.3980888619164,0.0446571649091676,2407.851917743683,685.428544998169,3017.441822052002,94106,10162,83944,83944,0,10,10631000.0
10631,10631999,21.941329123137944,38.397863858433496,0.04465625429636,2407.968994140625,685.4914016723633,3017.926124572754,94106,10162,83944,83944,0,10,10632000.0
10632,10632999,21.94071916463151,38.39699958623235,0.044655285367030007,2408.080672979355,685.552243232727,3018.3298873901367,94106,10162,83944,83944,0,10,10633000.0
10633,10633999,21.94040121657706,38.39677924464768,0.044652475269723824,2408.2068889141083,685.6143610477448,3018.8004455566406,94107,10162,83945,83945,0,10,10634000.0
10634,10634999,21.939884135542307,38.39587083613183,0.044652829856290266,2408.5298883914948,685.6761636734009,3019.205940246582,94119,10163,83956,83956,0,10,10635000.0
10635,10635999,21.93963782378958,38.39585729046773,0.04464855834931325,2408.64546751976,685.7379596233368,3019.5676498413086,94119,10163,83956,83956,0,10,10636000.0
10636,10636999,21.939429400060863,38.395702538650596,0.04464657502644054,2408.7700715065002,685.8001453876495,3020.1122398376465,94119,10163,83956,83956,0,10,10637000.0
10637,10637999,21.939589659743966,38.396300318242304,0.04464312776951462,2408.8893609046936,685.8620133399963,3020.5738945007324,94119,10163,83956,83956,0,10,10638000.0
10638,10638999,21.93963044512321,38.39639510042496,0.04464348377638794,2409.6226103305817,685.9251129627228,3020.7623138427734,94155,10166,83989,83989,0,10,10639000.0
10639,10639999,21.940070235362036,38.397239699883315,0.044643830358280234,2410.1528351306915,685.9891612529755,3021.1342582702637,94169,10168,84001,84001,0,10,10640000.0
10640,10640999,21.940652191933516,38.39974645401362,0.044641555902047436,2410.269449234009,686.0505666732788,3021.5585556030273,94169,10168,84001,84001,0,10,10641000.0
10641,10641999,21.941410467538237,38.40095612706409,0.04464229279204668,2410.3915061950684,686.1113119125366,3021.8614959716797,94169,10168,84001,84001,0,10,10642000.0
10642,10642999,21.942264120213498,38.402314240014015,0.04464738958241776,2410.5093557834625,686.1720352172852,3022.2877807617188,94169,10168,84001,84001,0,10,10643000.0
10643,10643999,21.943139344155824,38.40375299169586,0.04465193961915637,2410.6218366622925,686.2343389987946,3022.734931945801,94170,10168,84002,84002,0,10,10644000.0
10644,10644999,21.944147334885024,38.40560744107366,0.04465338166870647,2410.744565010071,686.2972829341888,3023.196689605713,94171,10168,84003,84003,0,10,10645000.0
10645,10645999,21.94533259619267,38.40738922269786,0.0446529839505454,2411.0711798667908,686.3584530353546,3023.699905395508,94183,10169,84014,84014,0,10,10646000.0
10646,10646999,21.94618391502047,38.40843741656213,0.04465747880102866,2411.185520887375,686.4195559024811,3024.148822784424,94183,10169,84014,84014,0,10,10647000.0
10647,10647999,21.946993411167266,38.40921576910336,0.044663036286871294,2411.507165670395,686.4816246032715,3024.5069999694824,94195,10170,84025,84025,0,10,10648000.0
10648,10648999,21.9475222959482,38.409526687505654,0.04466845780966244,2411.626163959503,686.5419991016388,3024.836441040039,94196,10170,84026,84026,0,10,10649000.0
10649,10649999,21.94700474396993,38.40876172898878,0.04467055621437266,2412.161612510681,686.6055533885956,3025.779510498047,94210,10172,84038,84038,0,10,10650000.0
10650,10650999,21.946082665667458,38.40750028117535,0.04467461246418025,2412.2833597660065,686.6671140193939,3026.350574493408,94210,10172,84038,84038,0,10,10651000.0
10651,10651999,21.94530273464521,38.40636033761841,0.04467908385858621,2413.0127737522125,686.7293767929077,3026.636428833008,94237,10175,84062,84062,0,10,10652000.0
10652,10652999,21.94457296054158,38.405289418610835,0.04468258465379038,2413.3362441062927,686.7910809516907,3027.1030349731445,94250,10176,84074,84074,0,10,10653000.0
10653,10653999,21.943942869229414,38.40448592413293,0.04468345417986208,2413.4510369300842,686.8519039154053,3027.4992141723633,94251,10176,84075,84075,0,10,10654000.0
10654,10654999,21.94323561736671,38.40326342594859,0.044686591973339684,2413.9767467975616,686.914201259613,3027.783622741699,94255,10178,84077,84077,0,10,10655000.0
10655,10655999,21.942664485982903,38.4022600453129,0.04468835980203911,2414.1127808094025,686.9767882823944,3028.2438354492188,94256,10178,84078,84078,0,10,10656000.0
10656,10656999,21.942289954018523,38.40172678786472,0.04468673785308386,2414.6362261772156,687.039012670517,3028.5671882629395,94265,10180,84085,84085,0,10,10657000.0
10657,10657999,21.941912865783937,38.40107220522999,0.04468613259134968,2415.156250476837,687.1013791561127,3028.8292694091797,94273,10182,84091,84091,0,10,10658000.0
10658,10658999,21.941614874943042,38.400599551277246,0.04468705717240751,2415.505333662033,687.1760642528534,3029.1312866210938,94285,10183,84102,84102,0,10,10659000.0
10659,10659999,21.941562105958553,38.4006727807303,0.04468659315876089,2415.6213908195496,687.2380475997925,3029.473003387451,94286,10183,84103,84103,0,10,10660000.0
10660,10660999,21.941591925370098,38.400459778301695,0.04468719173761104,2415.7469384670258,687.3001482486725,3029.777862548828,94286,10183,84103,84103,0,10,10661000.0
10661,10661999,21.941569458867278,38.40014811777788,0.04468791442764919,2416.270559310913,687.3635485172272,3030.0273056030273,94306,10185,84121,84121,0,10,10662000.0
10662,10662999,21.941586134950843,38.39979476008713,0.044687862108605536,2416.591334581375,687.4260673522949,3030.3402976989746,94308,10186,84122,84122,0,10,10663000.0
10663,10663999,21.941635561584647,38.39951310474183,0.04468774235374551,2416.7135529518127,687.4891095161438,3030.629123687744,94308,10186,84122,84122,0,10,10664000.0
10664,10664999,21.94191445649962,38.3994383249606,0.044686953415535635,2416.831254720688,687.550986289978,3030.9881591796875,94308,10186,84122,84122,0,10,10665000.0
10665,10665999,21.942002332699506,38.3990995877557,0.04468455643730063,2416.959664583206,687.6127412319183,3031.5008583068848,94308,10186,84122,84122,0,10,10666000.0
10666,10666999,21.942045811564785,38.39864558060297,0.044683031872136514,2417.08247089386,687.6759433746338,3031.893455505371,94309,10186,84123,84123,0,10,10667000.0
10667,10667999,21.942079142900045,38.39834385795093,0.04467880142920655,2417.398355484009,687.7379584312439,3032.1529655456543,94320,10187,84133,84133,0,10,10668000.0
10668,10668999,21.94193983179663,38.397726280750994,0.04467741049686047,2417.521968126297,687.7992904186249,3032.525535583496,94320,10187,84133,84133,0,10,10669000.0
10669,10669999,21.941675708700746,38.39699538110341,0.044670015382488604,2417.6512734889984,687.8618693351746,3033.3049354553223,94321,10187,84134,84134,0,10,10670000.0
10670,10670999,21.941350740500695,38.39640296823129,0.044653517757940575,2418.175975084305,687.9256567955017,3033.803695678711,94338,10189,84149,84149,0,10,10671000.0
10671,10671999,21.94095588627392,38.39578486226813,0.04464041736959701,2418.5008087158203,687.9883975982666,3034.1984825134277,94351,10190,84161,84161,0,10,10672000.0
10672,10672999,21.940657859196456,38.39533846702014,0.04462490036892086,2418.821843147278,688.0494766235352,3034.5211067199707,94359,10191,84168,84168,0,10,10673000.0
10673,10673999,21.940381839486474,38.39454407851779,0.04461171170704714,2419.158551931381,688.1112530231476,3034.746768951416,94366,10192,84174,84174,0,10,10674000.0
10674,10674999,21.940161908498656,38.3940064633751,0.044597990366533,2419.2741463184357,688.1720912456512,3035.1265258789062,94367,10192,84175,84175,0,10,10675000.0
10675,10675999,21.93995584126522,38.39328934558134,0.044582755447513445,2419.805603504181,688.2341051101685,3035.3364601135254,94377,10194,84183,84183,0,10,10676000.0
10676,10676999,21.939737310432832,38.392494979000986,0.044567511742777066,2419.9282348155975,688.295904636383,3035.6027641296387,94377,10194,84183,84183,0,10,10677000.0
10677,10677999,21.939480832313915,38.39173158719581,0.0445575800322604,2420.0548391342163,688.3585004806519,3035.965663909912,94377,10194,84183,84183,0,10,10678000.0
10678,10678999,21.939348183736243,38.390897078518805,0.04454048832639124,2420.1823568344116,688.4191572666168,3036.346992492676,94377,10194,84183,84183,0,10,10679000.0
10679,10679999,21.939391820421996,38.39022593768158,0.044524815593719014,2420.292793273926,688.4803042411804,3036.594944000244,94377,10194,84183,84183,0,10,10680000.0
10680,10680999,21.939529768880558,38.38977634467705,0.044515153631990545,2420.6179432868958,688.5432529449463,3036.893180847168,94384,10195,84189,84189,0,10,10681000.0
10681,10681999,21.939934188653645,38.390794392410605,0.04450362904496308,2420.7308580875397,688.6036953926086,3037.215995788574,94384,10195,84189,84189,0,10,10682000.0
10682,10682999,21.940209985187444,38.39052047782795,0.04449462515265945,2421.057745218277,688.6654732227325,3037.379348754883,94386,10196,84190,84190,0,10,10683000.0
10683,10683999,21.94097940941311,38.39116651349599,0.044482438163479965,2421.1686737537384,688.725932598114,3037.779438018799,94386,10196,84190,84190,0,10,10684000.0
10684,10684999,21.941764446755204,38.3915653073936,0.04446689062933251,2421.4879927635193,688.7877418994904,3038.020004272461,94388,10197,84191,84191,0,10,10685000.0
10685,10685999,21.942663640312258,38.392198898889085,0.04445367829501723,2422.4246456623077,688.8503594398499,3038.074878692627,94414,10201,84213,84213,0,10,10686000.0
10686,10686999,21.943636291201983,38.39288489383847,0.04444251594231219,2422.545607328415,688.9114151000977,3038.3481521606445,94414,10201,84213,84213,0,10,10687000.0
10687,10687999,21.944457447167903,38.393645506472936,0.044428625375674824,2422.6722683906555,688.9731550216675,3038.6234092712402,94414,10201,84213,84213,0,10,10688000.0
10688,10688999,21.945473204012746,38.394642715763894,0.04442344106392193,2422.7968904972076,689.0352091789246,3038.9463806152344,94414,10201,84213,84213,0,10,10689000.0
10689,10689999,21.946227639310607,38.395341852286435,0.04442119335718142,2422.906326532364,689.0963695049286,3039.2396392822266,94414,10201,84213,84213,0,10,10690000.0
10690,10690999,21.946070312434905,38.39485794959076,0.04440602631266022,2423.03049826622,689.1584737300873,3040.264678955078,94417,10201,84216,84216,0,10,10691000.0
10691,10691999,21.945649344610185,38.394746624233505,0.044393741650363916,2423.1535770893097,689.2207939624786,3040.8406105041504,94418,10201,84217,84217,0,10,10692000.0
10692,10692999,21.945225631202224,38.39430502886884,0.04438588699275525,2423.6982975006104,689.2846577167511,3041.1057624816895,94433,10203,84230,84230,0,10,10693000.0
10693,10693999,21.944941672533915,38.3937204407976,0.04437594116425203,2423.8293402194977,689.3470723628998,3041.5490531921387,94435,10203,84232,84232,0,10,10694000.0
10694,10694999,21.94452168968752,38.39268111848423,0.04436824461549971,2424.1520986557007,689.4099268913269,3041.8403816223145,94448,10204,84244,84244,0,10,10695000.0
10695,10695999,21.944212013608055,38.392056287738626,0.044363480283765466,2424.673071861267,689.4719655513763,3042.0803184509277,94462,10206,84256,84256,0,10,10696000.0
10696,10696999,21.944012220986288,38.39153124906046,0.0443538556880797,2424.792444229126,689.5341980457306,3042.494804382324,94463,10206,84257,84257,0,10,10697000.0
10697,10697999,21.943890490752324,38.39149226973556,0.044347862052797615,2425.106371641159,689.5957038402557,3042.8048820495605,94475,10207,84268,84268,0,10,10698000.0
10698,10698999,21.943968526112123,38.39160430013015,0.04436132094632739,2425.2336840629578,689.6586055755615,3043.0700073242188,94475,10207,84268,84268,0,10,10699000.0
10699,10699999,21.94421844761689,38.39207725939726,0.044357995769914726,2425.3520967960358,689.7201192378998,3043.412940979004,94475,10207,84268,84268,0,10,10700000.0
10700,10700999,21.94476851331171,38.393360357664065,0.04436973346854378,2425.4676644802094,689.7806704044342,3043.740119934082,94475,10207,84268,84268,0,10,10701000.0
10701,10701999,21.94573586911602,38.395440176890176,0.04438031849550139,2425.787584066391,689.8413782119751,3043.95694732666,94479,10208,84271,84271,0,10,10702000.0
10702,10702999,21.946581919124693,38.396675616584716,0.044389476596000454,2426.1096680164337,689.9030513763428,3044.316753387451,94481,10209,84272,84272,0,10,10703000.0
10703,10703999,21.948016040677675,38.39916763159383,0.04440711614027826,2426.4389815330505,689.9644706249237,3044.6556510925293,94483,10210,84273,84273,0,10,10704000.0
10704,10704999,21.94945755497541,38.40155592331868,0.04442336176141948,2426.7542181015015,690.0278985500336,3044.8925590515137,94495,10211,84284,84284,0,10,10705000.0
10705,10705999,21.950940428180704,38.40348487327044,0.044448650780630095,2427.078371286392,690.0888657569885,3045.207939147949,94508,10212,84296,84296,0,10,10706000.0
10706,10706999,21.952835214186834,38.40649723141658,0.044478314654642914,2427.198342323303,690.1494328975677,3045.613956451416,94508,10212,84296,84296,0,10,10707000.0
10707,10707999,21.954607833638317,38.40961965951323,0.0445126124775288,2427.314623594284,690.209902048111,3045.937171936035,94508,10212,84296,84296,0,10,10708000.0
10708,10708999,21.956261912467316,38.41155026062053,0.04454384944847478,2427.42995762825,690.270519733429,3046.2098350524902,94508,10212,84296,84296,0,10,10709000.0
10709,10709999,21.957684305253487,38.41313806658266,0.044566236376582635,2427.5434057712555,690.3318915367126,3046.6407737731934,94509,10212,84297,84297,0,10,10710000.0
10710,10710999,21.958461332730163,38.41431205662818,0.04457111051882945,2427.6644608974457,690.3925724029541,3047.6785011291504,94511,10212,84299,84299,0,10,10711000.0
10711,10711999,21.958384770782203,38.41367961010132,0.044547101854635285,2427.986780643463,690.4549670219421,3048.460964202881,94523,10213,84310,84310,0,10,10712000.0
10712,10712999,21.958393573470925,38.41303962772475,0.04452277162952323,2428.107516527176,690.5180475711823,3049.06831741333,94523,10213,84310,84310,0,10,10713000.0
10713,10713999,21.958636524112215,38.41297077304713,0.04449637348436131,2428.64501452446,690.5820634365082,3049.3416481018066,94546,10215,84331,84331,0,10,10714000.0
10714,10714999,21.95868094401405,38.41254853073411,0.04447690107350266,2428.761858224869,690.643580198288,3049.6730918884277,94546,10215,84331,84331,0,10,10715000.0
10715,10715999,21.95867890581087,38.411949619631585,0.04445666350949018,2428.8778505325317,690.7041897773743,3050.1183891296387,94546,10215,84331,84331,0,10,10716000.0
10716,10716999,21.958561396592447,38.41112199260503,0.04444515491287249,2429.0039002895355,690.7664608955383,3050.5382919311523,94546,10215,84331,84331,0,10,10717000.0
10717,10717999,21.95852770432068,38.41037751221368,0.044430673568606305,2429.129468202591,690.8268663883209,3050.856029510498,94547,10215,84332,84332,0,10,10718000.0
10718,10718999,21.958552141453687,38.40971389559743,0.04441361669675459,2429.246047258377,690.8891127109528,3051.2391624450684,94547,10215,84332,84332,0,10,10719000.0
10719,10719999,21.958626267232283,38.409473926117776,0.04441081813921055,2429.5623064041138,690.9498753547668,3051.623188018799,94551,10216,84335,84335,0,10,10720000.0
10720,10720999,21.958751219866286,38.409031678652916,0.04439623364864598,2429.6831107139587,691.0121741294861,3051.9317207336426,94551,10216,84335,84335,0,10,10721000.0
10721,10721999,21.958957795399346,38.40882290237613,0.04439122550637464,2429.8052928447723,691.074652671814,3052.3322677612305,94551,10216,84335,84335,0,10,10722000.0
10722,10722999,21.95949959166843,38.4090152669701,0.04439374844056554,2430.1248955726624,691.1351613998413,3052.6368675231934,94563,10217,84346,84346,0,10,10723000.0
10723,10723999,21.960225714014395,38.40984954443866,0.0443990362168053,2430.446004629135,691.1965193748474,3052.9496002197266,94575,10218,84357,84357,0,10,10724000.0
10724,10724999,21.961333826127525,38.41130223797974,0.04441672627631188,2430.5670483112335,691.2592928409576,3053.369525909424,94575,10218,84357,84357,0,10,10725000.0
10725,10725999,21.962729339110673,38.41310855439109,0.04442625807603329,2430.879477262497,691.3207862377167,3053.8068923950195,94588,10219,84369,84369,0,10,10726000.0
10726,10726999,21.96432958018396,38.415053274709045,0.04444694126247917,2431.2057433128357,691.3829905986786,3054.177360534668,94590,10220,84370,84370,0,10,10727000.0
10727,10727999,21.965944598094197,38.41782978789446,0.04447250563400107,2431.535279750824,691.4439537525177,3054.5351753234863,94602,10221,84381,84381,0,10,10728000.0
10728,10728999,21.967273260936082,38.41903010976928,0.04448883061219744,2431.663491487503,691.5061085224152,3054.924934387207,94602,10221,84381,84381,0,10,10729000.0
10729,10729999,21.968730321148254,38.420548428066574,0.04449498016809106,2431.9897224903107,691.5692629814148,3055.3174743652344,94633,10222,84411,84411,0,10,10730000.0
10730,10730999,21.969813255250543,38.42225059700995,0.04450386043337118,2432.1111314296722,691.62988448143,3055.662582397461,94635,10222,84413,84413,0,10,10731000.0
10731,10731999,21.969893781538314,38.421804403870404,0.04448150259807304,2432.2456550598145,691.6930146217346,3057.5010719299316,94637,10222,84415,84415,0,10,10732000.0
10732,10732999,21.96987407540274,38.421736852357355,0.044462200748965564,2432.7857451438904,691.7559497356415,3058.3030967712402,94641,10224,84417,84417,0,10,10733000.0
10733,10733999,21.969903590314555,38.421361918058956,0.04444356831260554,2432.9002816677094,691.8172147274017,3058.906322479248,94641,10224,84417,84417,0,10,10734000.0
10734,10734999,21.969902754558834,38.42097013729608,0.04442396846487495,2433.0162830352783,691.8788492679596,3059.45023727417,94641,10224,84417,84417,0,10,10735000.0
10735,10735999,21.969905622344704,38.4204578460301,0.0444103950629362,2433.13213968277,691.9413332939148,3059.970241546631,94641,10224,84417,84417,0,10,10736000.0
10736,10736999,21.96985164788607,38.41994040468704,0.044398427552202024,2433.8574306964874,692.0045156478882,3060.4468879699707,94669,10227,84442,84442,0,10,10737000.0
10737,10737999,21.9698317175329,38.419423528256424,0.04438709612717928,2434.174220085144,692.0656538009644,3060.953998565674,94682,10228,84454,84454,0,10,10738000.0
10738,10738999,21.969823271842888,38.41878673822277,0.044377259654403645,2434.2870066165924,692.1262574195862,3061.4287185668945,94682,10228,84454,84454,0,10,10739000.0
10739,10739999,21.969858612144634,38.41843626885475,0.044368402556459796,2434.6036834716797,692.1873860359192,3061.773971557617,94694,10229,84465,84465,0,10,10740000.0
10740,10740999,21.970165352780608,38.41875202813213,0.04436579365524229,2434.7173359394073,692.2490787506104,3062.2393760681152,94694,10229,84465,84465,0,10,10741000.0
10741,10741999,21.97046395247072,38.41866953637988,0.04436207334032194,2435.0294461250305,692.3101119995117,3062.5891723632812,94706,10230,84476,84476,0,10,10742000.0
10742,10742999,21.970841252340925,38.41868233599634,0.04435921935610143,2435.3486421108246,692.3714382648468,3063.065570831299,94719,10231,84488,84488,0,10,10743000.0
10743,10743999,21.971639048315225,38.420288203084596,0.04435842833680592,2435.6661026477814,692.432133436203,3063.5542793273926,94732,10232,84500,84500,0,10,10744000.0
10744,10744999,21.972544592339975,38.421387374550136,0.04436464550050234,2435.985369205475,692.4932625293732,3064.086322784424,94744,10233,84511,84511,0,10,10745000.0
10745,10745999,21.973929361762757,38.42430032375377,0.044368277769789244,2436.1005861759186,692.5538096427917,3064.6772994995117,94744,10233,84511,84511,0,10,10746000.0
10746,10746999,21.97528119458831,38.42567322686465,0.04437930384909228,2436.6259520053864,692.6151134967804,3064.981731414795,94759,10235,84524,84524,0,10,10747000.0
10747,10747999,21.976731461872696,38.42757937759376,0.04437382204558826,2436.74267411232,692.675543308258,3065.495349884033,94759,10235,84524,84524,0,10,10748000.0
10748,10748999,21.9776847114094,38.4287088497903,0.04436273433493765,2436.853766441345,692.7377097606659,3065.893768310547,94761,10235,84526,84526,0,10,10749000.0
10749,10749999,21.97741460856371,38.42835682566729,0.044352976262969634,2437.1806857585907,692.7998015880585,3067.329147338867,94774,10236,84538,84538,0,10,10750000.0
10750,10750999,21.977198892024568,38.42831583963282,0.044340872127271,2437.3050355911255,692.8608679771423,3068.094799041748,94774,10236,84538,84538,0,10,10751000.0
10751,10751999,21.97708446577062,38.42801581417971,0.04433093322356807,2437.822783470154,692.9229953289032,3068.529541015625,94799,10238,84561,84561,0,10,10752000.0
10752,10752999,21.97695529535777,38.42743226056481,0.04432930601494789,2437.9369480609894,692.9835126399994,3068.9085388183594,94799,10238,84561,84561,0,10,10753000.0
10753,10753999,21.976624606278058,38.42661480957016,0.04432635644307703,2438.2576134204865,693.0455548763275,3069.270835876465,94812,10239,84573,84573,0,10,10754000.0
10754,10754999,21.97643897336349,38.426283783632236,0.0443219481592142,2438.577450275421,693.1069843769073,3069.6709480285645,94814,10240,84574,84574,0,10,10755000.0
10755,10755999,21.97647088132496,38.42625561093739,0.0443166774240813,2438.6919932365417,693.1684091091156,3070.164073944092,94814,10240,84574,84574,0,10,10756000.0
10756,10756999,21.976498431531923,38.42602148634574,0.04431338246725791,2438.8044896125793,693.2287585735321,3070.445541381836,94814,10240,84574,84574,0,10,10757000.0
10757,10757999,21.976640687289976,38.42610443622452,0.04431041819333026,2439.3330459594727,693.2905380725861,3070.785659790039,94856,10242,84614,84614,0,10,10758000.0
10758,10758999,21.976901647608038,38.42651160897258,0.044312386332588494,2439.4583880901337,693.3527252674103,3071.165584564209,94856,10242,84614,84614,0,10,10759000.0
10759,10759999,21.977480310884037,38.427523657830314,0.044317678978171515,2439.574323415756,693.4149672985077,3071.4349937438965,94856,10242,84614,84614,0,10,10760000.0
10760,10760999,21.978153944635803,38.42875991032961,0.044322573534024245,2439.6932759284973,693.4768719673157,3071.9183349609375,94856,10242,84614,84614,0,10,10761000.0
10761,10761999,21.97928611628964,38.43085674118381,0.04434025548725773,2440.018009185791,693.5384576320648,3072.223300933838,94868,10243,84625,84625,0,10,10762000.0
10762,10762999,21.980982993923462,38.4341100652614,0.044359791210793253,2440.349716901779,693.5991230010986,3072.5034217834473,94880,10244,84636,84636,0,10,10763000.0
10763,10763999,21.982989870299264,38.4379513519699,0.04439114261344401,2440.4624285697937,693.6600453853607,3072.885265350342,94882,10244,84638,84638,0,10,10764000.0
10764,10764999,21.985192209911926,38.442566758616564,0.04441007299647204,2440.5793697834015,693.720413684845,3073.3754692077637,94882,10244,84638,84638,0,10,10765000.0
10765,10765999,21.987218254539982,38.446727030799956,0.04444075617887411,2440.698852777481,693.7806534767151,3073.8094329833984,94883,10244,84639,84639,0,10,10766000.0
10766,10766999,21.988979398124652,38.448989967359296,0.044479682949043586,2441.0269486904144,693.8424723148346,3074.1934356689453,94895,10245,84650,84650,0,10,10767000.0
10767,10767999,21.990425548431773,38.45058606451156,0.04450361125698077,2441.7481236457825,693.9032196998596,3074.3809509277344,94917,10248,84669,84669,0,10,10768000.0
10768,10768999,21.990514040378052,38.45086310956055,0.04450195288234604,2441.8740649223328,693.9655113220215,3075.7642974853516,94921,10248,84673,84673,0,10,10769000.0
10769,10769999,21.990001084245506,38.45023272841548,0.04450185218028757,2442.6255588531494,694.0290927886963,3076.296230316162,94946,10251,84695,84695,0,10,10770000.0
10770,10770999,21.98967840675762,38.449549729242705,0.044501684209270476,2442.951556444168,694.0926041603088,3076.817855834961,94950,10252,84698,84698,0,10,10771000.0
10771,10771999,21.98933850509471,38.44909097529969,0.044503190043448715,2443.0735850334167,694.1545736789703,3077.3619651794434,94950,10252,84698,84698,0,10,10772000.0
10772,10772999,21.98913875512371,38.448905903168544,0.044497335443367425,2443.1886417865753,694.2158291339874,3077.7133293151855,94950,10252,84698,84698,0,10,10773000.0
10773,10773999,21.988856706846583,38.4485000715781,0.04449252610920873,2443.32062292099,694.2773540019989,3078.1493072509766,94950,10252,84698,84698,0,10,10774000.0
10774,10774999,21.988589744161644,38.44819314922997,0.04449003998091772,2443.4399609565735,694.3380930423737,3078.566150665283,94950,10252,84698,84698,0,10,10775000.0
10775,10775999,21.988272431543002,38.44728387942511,0.04448657078318641,2443.583945274353,694.4078209400177,3078.989933013916,94950,10252,84698,84698,0,10,10776000.0
10776,10776999,21.98797289988622,38.446663149138615,0.04448419893867994,2443.901030778885,694.4695334434509,3079.254421234131,94961,10253,84708,84708,0,10,10777000.0
10777,10777999,21.987854412650872,38.446412585859036,0.044482265528564824,2444.013285636902,694.5300493240356,3079.572738647461,94961,10253,84708,84708,0,10,10778000.0
10778,10778999,21.987697771945495,38.44589331996955,0.04447871534978454,2444.535656929016,694.5920526981354,3079.792121887207,94977,10255,84722,84722,0,10,10779000.0
10779,10779999,21.98740137507013,38.445054085713274,0.0444764218468906,2444.660469532013,694.6527070999146,3080.0915451049805,94977,10255,84722,84722,0,10,10780000.0
10780,10780999,21.98718930400476,38.444345677553436,0.04447349145468449,2444.986734867096,694.7140693664551,3080.4676246643066,94979,10256,84723,84723,0,10,10781000.0
10781,10781999,21.987186690496234,38.44410365874692,0.044471015136411496,2445.115031480789,694.7842643260956,3080.755023956299,94979,10256,84723,84723,0,10,10782000.0
10782,10782999,21.98703712140128,38.44335470001046,0.04446665053564869,2445.240802049637,694.845810174942,3081.168918609619,94980,10256,84724,84724,0,10,10783000.0
10783,10783999,21.98689105508253,38.44260847364036,0.04446385084567339,2445.356703519821,694.9081385135651,3081.577606201172,94981,10256,84725,84725,0,10,10784000.0
10784,10784999,21.98702996403133,38.442244651886256,0.044455762091765716,2445.8843927383423,694.9703345298767,3081.7978286743164,95004,10258,84746,84746,0,10,10785000.0
10785,10785999,21.986949130072595,38.441666114373476,0.04445209526610927,2446.211106777191,695.0336618423462,3082.103759765625,95015,10259,84756,84756,0,10,10786000.0
10786,10786999,21.986853572825787,38.44102191294469,0.04444729880401743,2446.332094192505,695.095371723175,3082.5196838378906,95015,10259,84756,84756,0,10,10787000.0
10787,10787999,21.986712858427474,38.440248815941075,0.04444201775225609,2446.6568138599396,695.1566677093506,3082.830135345459,95027,10260,84767,84767,0,10,10788000.0
10788,10788999,21.98640798223629,38.43930344143634,0.04443782494456261,2447.180328845978,695.2188787460327,3082.984832763672,95049,10262,84787,84787,0,10,10789000.0
10789,10789999,21.98607377364849,38.4385812360039,0.044425458480462754,2447.3106105327606,695.2820706367493,3084.613082885742,95052,10262,84790,84790,0,10,10790000.0
10790,10790999,21.985525932801185,38.43793579141138,0.04442063778120675,2447.6373846530914,695.3443512916565,3085.2782669067383,95066,10263,84803,84803,0,10,10791000.0
10791,10791999,21.985069457795877,38.4368284152497,0.04441321183190261,2447.7648797035217,695.4071340560913,3085.7664833068848,95067,10263,84804,84804,0,10,10792000.0
10792,10792999,21.984677151926004,38.4358247269212,0.044405098664900056,2448.094875574112,695.4694600105286,3086.153179168701,95071,10264,84807,84807,0,10,10793000.0
10793,10793999,21.984362012858657,38.434961475147475,0.0443969884981853,2448.217409133911,695.5322978496552,3086.6988258361816,95071,10264,84807,84807,0,10,10794000.0
10794,10794999,21.984023013055133,38.43411078335206,0.04439051009705419,2448.5548088550568,695.5948202610016,3087.038562774658,95074,10265,84809,84809,0,10,10795000.0
10795,10795999,21.98363480133657,38.433034462128404,0.0443852689994364,2449.08380818367,695.6575367450714,3087.4028358459473,95080,10267,84813,84813,0,10,10796000.0
10796,10796999,21.98338316690406,38.43214795237646,0.04437767820214611,2449.2005486488342,695.7196545600891,3087.8257598876953,95081,10267,84814,84814,0,10,10797000.0
10797,10797999,21.983156496312944,38.43143496059675,0.04436945221157529,2449.531009197235,695.7822134494781,3088.130573272705,95093,10268,84825,84825,0,10,10798000.0
10798,10798999,21.98305635008813,38.430669844294385,0.044359515613099365,2449.8569371700287,695.8443892002106,3088.4523010253906,95124,10269,84855,84855,0,10,10799000.0
10799,10799999,21.98295127630168,38.43000341288285,0.044350661191422946,2450.191869497299,695.9059133529663,3088.7797088623047,95130,10270,84860,84860,0,10,10800000.0
10800,10800999,21.982884970517187,38.42928279534009,0.044341321355965024,2450.306583404541,695.9669291973114,3089.050941467285,95130,10270,84860,84860,0,10,10801000.0
10801,10801999,21.982800285295976,38.42850796468815,0.04432865625683324,2450.6409361362457,696.0299541950226,3089.481704711914,95135,10271,84864,84864,0,10,10802000.0
10802,10802999,21.982954243050283,38.42796339523835,0.044315643748596645,2450.9689095020294,696.092038154602,3089.912956237793,95148,10272,84876,84876,0,10,10803000.0
10803,10803999,21.983109121242748,38.427452572147494,0.04430285255575128,2451.2952575683594,696.1537659168243,3090.208610534668,95156,10273,84883,84883,0,10,10804000.0
10804,10804999,21.983563442021584,38.42741724200815,0.044282337074938116,2451.4085459709167,696.2148473262787,3090.630081176758,95157,10273,84884,84884,0,10,10805000.0
10805,10805999,21.983811345327602,38.42696405587349,0.044265880901684374,2451.5440316200256,696.2777018547058,3091.107593536377,95159,10273,84886,84886,0,10,10806000.0
10806,10806999,21.98405797465501,38.4266006108633,0.044248047585674355,2451.8885502815247,696.3398087024689,3091.4067039489746,95166,10274,84892,84892,0,10,10807000.0
10807,10807999,21.984241202254488,38.42605905131283,0.04423409635935216,2452.222868680954,696.4024155139923,3091.7257232666016,95168,10275,84893,84893,0,10,10808000.0
10808,10808999,21.984361340334825,38.42537990709259,0.04421752871341178,2452.3354938030243,696.4636569023132,3092.225986480713,95169,10275,84894,84894,0,10,10809000.0
10809,10809999,21.984065608063556,38.425213235901545,0.04420911437869346,2452.6627135276794,696.5260667800903,3093.2673149108887,95181,10276,84905,84905,0,10,10810000.0
10810,10810999,21.98357397211201,38.42434841836858,0.04419853356420933,2452.7825314998627,696.5886204242706,3094.1868934631348,95182,10276,84906,84906,0,10,10811000.0
10811,10811999,21.982941086000167,38.42310690736414,0.044196052193180346,2452.8983285427094,696.6505973339081,3094.8137397766113,95183,10276,84907,84907,0,10,10812000.0
10812,10812999,21.98245289128122,38.42202666960725,0.04418881345273473,2453.4210426807404,696.7133755683899,3095.052234649658,95200,10278,84922,84922,0,10,10813000.0
10813,10813999,21.982102867876854,38.421294397060116,0.044179225118960885,2453.949215888977,696.7762594223022,3095.3760871887207,95216,10280,84936,84936,0,10,10814000.0
10814,10814999,21.981590020248138,38.420366528113824,0.044175059460800026,2454.272230863571,696.8380656242371,3095.7595405578613,95228,10281,84947,84947,0,10,10815000.0
10815,10815999,21.981055841964633,38.419223475998855,0.04417167153523793,2454.8070261478424,696.9002845287323,3096.0935668945312,95242,10283,84959,84959,0,10,10816000.0
10816,10816999,21.980616665836106,38.4182719168507,0.04416821371127877,2455.1262967586517,696.9635074138641,3096.3772583007812,95254,10284,84970,84970,0,10,10817000.0
10817,10817999,21.98007590532967,38.417092143627684,0.04416605376689464,2455.6554667949677,697.0264704227448,3096.6241493225098,95268,10286,84982,84982,0,10,10818000.0
10818,10818999,21.979740544658778,38.416326223643715,0.04416372727328988,2455.983818054199,697.0894293785095,3096.9804077148438,95271,10287,84984,84984,0,10,10819000.0
10819,10819999,21.979531599039596,38.415735863491804,0.0441591255865037,2456.3007431030273,697.1521489620209,3097.2302589416504,95273,10288,84985,84985,0,10,10820000.0
10820,10820999,21.979344400786804,38.41511860646909,0.044155302642675864,2456.418237686157,697.2136716842651,3097.630081176758,95273,10288,84985,84985,0,10,10821000.0
10821,10821999,21.979585612530723,38.415294546185734,0.04415120267521655,2456.542545557022,697.2762422561646,3097.9856300354004,95273,10288,84985,84985,0,10,10822000.0
10822,10822999,21.9799561328579,38.415763394176786,0.04414745569249734,2456.671171426773,697.3374497890472,3098.285659790039,95273,10288,84985,84985,0,10,10823000.0
10823,10823999,21.98068508767631,38.41780684436835,0.04414197796392205,2456.992205619812,697.3995580673218,3098.6567764282227,95285,10289,84996,84996,0,10,10824000.0
10824,10824999,21.981161418327705,38.418630664421194,0.04413963021752598,2457.5148043632507,697.4620115756989,3099.0075149536133,95299,10291,85008,85008,0,10,10825000.0
10825,10825999,21.98221410414378,38.421033138871394,0.04414089846638747,2457.8451688289642,697.526287317276,3099.376132965088,95311,10292,85019,85019,0,10,10826000.0
10826,10826999,21.983380399746494,38.424660546897336,0.04413623058655014,2457.971558570862,697.5877335071564,3099.684280395508,95312,10292,85020,85020,0,10,10827000.0
10827,10827999,21.985014959471396,38.429532133050614,0.04414180112723742,2458.091998577118,697.6499795913696,3100.050033569336,95312,10292,85020,85020,0,10,10828000.0
10828,10828999,21.986033077747237,38.43164051857705,0.04414757731787455,2458.6119849681854,697.7117140293121,3100.360466003418,95326,10294,85032,85032,0,10,10829000.0
10829,10829999,21.986946832595233,38.43335319855301,0.04415016461868293,2458.7266840934753,697.7725083827972,3100.6941719055176,95327,10294,85033,85033,0,10,10830000.0
10830,10830999,21.98630008516521,38.43222871200123,0.04415096536014729,2459.0583515167236,697.8350923061371,3101.8661918640137,95339,10295,85044,85044,0,10,10831000.0
10831,10831999,21.985628686037444,38.43174829087529,0.044150900084593436,2459.5839471817017,697.8975961208344,3102.3043174743652,95364,10297,85067,85067,0,10,10832000.0
10832,10832999,21.984931277746213,38.430744686045394,0.04415212233286525,2459.698561191559,697.9593605995178,3102.691360473633,95364,10297,85067,85067,0,10,10833000.0
10833,10833999,21.98435860474173,38.42977785206911,0.044153981252051056,2460.0177717208862,698.021487236023,3103.0946655273438,95372,10298,85074,85074,0,10,10834000.0
10834,10834999,21.983781545549217,38.42867632278555,0.0441530537552528,2460.142639875412,698.0842082500458,3103.380043029785,95372,10298,85074,85074,0,10,10835000.0
10835,10835999,21.983248829393666,38.42798150323274,0.04415416520450233,2460.673074245453,698.1465077400208,3103.541576385498,95386,10300,85086,85086,0,10,10836000.0
10836,10836999,21.982725763299367,38.42700473193005,0.044155536971175136,2460.993289232254,698.2083320617676,3103.8930587768555,95390,10301,85089,85089,0,10,10837000.0
10837,10837999,21.982275896539395,38.426044973815934,0.0441560827418741,2461.1074538230896,698.2699389457703,3104.2721061706543,95390,10301,85089,85089,0,10,10838000.0
10838,10838999,21.981727361199113,38.42490819470054,0.04415680328531735,2461.439809322357,698.3321306705475,3104.4664154052734,95403,10302,85101,85101,0,10,10839000.0
10839,10839999,21.981319671086045,38.42406684492727,0.044154702290690295,2461.5541019439697,698.3948309421539,3104.8498306274414,95404,10302,85102,85102,0,10,10840000.0
10840,10840999,21.98098170944565,38.42337327408724,0.04415402568370641,2461.6744713783264,698.4565541744232,3105.1270751953125,95404,10302,85102,85102,0,10,10841000.0
10841,10841999,21.98070090409456,38.422538889724024,0.04415358509211753,2462.002606153488,698.5180864334106,3105.2748985290527,95416,10303,85113,85113,0,10,10842000.0
10842,10842999,21.980492156679478,38.42207659129142,0.04415100122175131,2462.13175034523,698.5807123184204,3105.6355743408203,95416,10303,85113,85113,0,10,10843000.0
10843,10843999,21.98034111412802,38.42153249017126,0.04414792864573991,2462.250295639038,698.6419970989227,3105.9445610046387,95417,10303,85114,85114,0,10,10844000.0
10844,10844999,21.980188581838156,38.421028454243746,0.04414616221392509,2462.366384744644,698.703649520874,3106.2128524780273,95417,10303,85114,85114,0,10,10845000.0
10845,10845999,21.980198196287947,38.42060634119786,0.044142268567902265,2462.698828935623,698.7655689716339,3106.5661582946777,95432,10304,85128,85128,0,10,10846000.0
10846,10846999,21.979987392930113,38.41977566104306,0.04413783566549423,2463.0285511016846,698.8272194862366,3106.909019470215,95444,10305,85139,85139,0,10,10847000.0
10847,10847999,21.979969855188084,38.419345341782034,0.04413152563699618,2463.365499019623,698.8887295722961,3107.1024322509766,95451,10306,85145,85145,0,10,10848000.0
10848,10848999,21.98008665866569,38.419047331278,0.04412613696966461,2463.901302576065,698.9498636722565,3107.304039001465,95475,10308,85167,85167,0,10,10849000.0
10849,10849999,21.980020510320333,38.41845851596368,0.044121988023121395,2464.223697900772,699.0115203857422,3107.6069374084473,95482,10309,85173,85173,0,10,10850000.0
10850,10850999,21.97958698094561,38.417384736442365,0.0441196496679076,2464.5416481494904,699.072690486908,3108.059429168701,95494,10310,85184,85184,0,10,10851000.0
10851,10851999,21.978771296639795,38.41641505643569,0.04412675482725148,2464.8715810775757,699.1342034339905,3109.0764923095703,95513,10311,85202,85202,0,10,10852000.0
10852,10852999,21.977952321170346,38.41512712996434,0.04413430915606065,2465.2178177833557,699.2041909694672,3109.6250038146973,95526,10312,85214,85214,0,10,10853000.0
10853,10853999,21.977150320060755,38.41378121919507,0.044141178771902156,2465.336843252182,699.2650835514069,3110.150764465332,95532,10312,85220,85220,0,10,10854000.0
10854,10854999,21.97644024396559,38.4125356321354,0.04414900342915773,2465.6718287467957,699.3263988494873,3110.5152702331543,95540,10313,85227,85227,0,10,10855000.0
10855,10855999,21.97601409662569,38.41241397330213,0.04414990434200583,2466.400276184082,699.3887431621552,3110.6932067871094,95558,10316,85242,85242,0,10,10856000.0
10856,10856999,21.975458931191422,38.41134446858031,0.04415336259210656,2467.362817287445,699.4523282051086,3111.0015716552734,95578,10320,85258,85258,0,10,10857000.0
10857,10857999,21.974951960440006,38.41037346143851,0.044156668101484664,2467.6781759262085,699.5128111839294,3111.496681213379,95593,10321,85272,85272,0,10,10858000.0
10858,10858999,21.974477147124624,38.40967945800085,0.04415777012500033,2467.7931571006775,699.573700428009,3111.8701934814453,95595,10321,85274,85274,0,10,10859000.0
10859,10859999,21.97419569674638,38.410283077329915,0.044154580084382444,2467.911044359207,699.6335167884827,3112.257392883301,95596,10321,85275,85275,0,10,10860000.0
10860,10860999,21.973990454059653,38.40952018232643,0.04415286401903895,2468.2354300022125,699.6953456401825,3112.643325805664,95608,10322,85286,85286,0,10,10861000.0
10861,10861999,21.97366244069643,38.40867665387085,0.04415164069716315,2468.3566138744354,699.7570006847382,3113.067939758301,95609,10322,85287,85287,0,10,10862000.0
10862,10862999,21.973364406081267,38.40766309709096,0.044149853775208414,2468.4824521541595,699.8180708885193,3113.42520904541,95610,10322,85288,85288,0,10,10863000.0
10863,10863999,21.973271963274374,38.4069308420555,0.044147116781338425,2468.6004354953766,699.8792202472687,3113.853427886963,95610,10322,85288,85288,0,10,10864000.0
10864,10864999,21.973390438232286,38.406342282180255,0.04414143954013905,2468.92639875412,699.9415657520294,3114.347499847412,95623,10323,85300,85300,0,10,10865000.0
10865,10865999,21.97355193661707,38.405980407852226,0.044133995243052615,2469.049077987671,700.0038487911224,3114.7319412231445,95623,10323,85300,85300,0,10,10866000.0
10866,10866999,21.97339470018322,38.40510312469163,0.04413250508194044,2469.5756154060364,700.0646877288818,3115.335792541504,95640,10325,85315,85315,0,10,10867000.0
10867,10867999,21.972767290602,38.40417562955122,0.04413345866703522,2469.905173063278,700.1266741752625,3116.0372314453125,95650,10326,85324,85324,0,10,10868000.0
10868,10868999,21.972140643045304,38.40306041428597,0.04413699983338337,2470.232684612274,700.1892297267914,3116.4836349487305,95660,10327,85333,85333,0,10,10869000.0
10869,10869999,21.9715209606032,38.401801350354525,0.04414225754586831,2470.344237089157,700.249226808548,3116.927013397217,95660,10327,85333,85333,0,10,10870000.0
10870,10870999,21.971030032572354,38.40098851581952,0.04414415666663585,2470.467299222946,700.3094186782837,3117.311176300049,95661,10327,85334,85334,0,10,10871000.0
10871,10871999,21.97050861464621,38.39984755434257,0.044147967127421084,2471.024097919464,700.3712038993835,3117.6545753479004,95686,10329,85357,85357,0,10,10872000.0
10872,10872999,21.970069628109894,38.398907438322354,0.0441490810236278,2471.5423963069916,700.4328720569611,3117.9567260742188,95701,10331,85370,85370,0,10,10873000.0
10873,10873999,21.969764553664657,38.39830742244736,0.044146981088378,2471.6584887504578,700.4941163063049,3118.297294616699,95702,10331,85371,85371,0,10,10874000.0
10874,10874999,21.96970686586408,38.39819352602979,0.044147300274116064,2471.7869443893433,700.5547184944153,3118.699535369873,95704,10331,85373,85373,0,10,10875000.0
10875,10875999,21.969538230488975,38.3975003577408,0.04414844262406881,2471.91309094429,700.6144306659698,3119.021141052246,95704,10331,85373,85373,0,10,10876000.0
10876,10876999,21.96929462570074,38.39689052228048,0.04414880029808621,2472.02423119545,700.6751825809479,3119.3057403564453,95704,10331,85373,85373,0,10,10877000.0
10877,10877999,21.969267567539767,38.39640604317112,0.044149124610395774,2472.355972766876,700.7377104759216,3119.609889984131,95706,10332,85374,85374,0,10,10878000.0
10878,10878999,21.96935644324495,38.39609559498837,0.04414879703365526,2472.68071269989,700.7984664440155,3119.9550285339355,95718,10333,85385,85385,0,10,10879000.0
10879,10879999,21.969386600553232,38.39558732897789,0.044148585725736766,2472.820697069168,700.8678994178772,3120.282341003418,95718,10333,85385,85385,0,10,10880000.0
10880,10880999,21.96955024787529,38.395224330974166,0.04413780639090836,2472.938138484955,700.9286677837372,3120.5934104919434,95719,10333,85386,85386,0,10,10881000.0
10881,10881999,21.96943706791146,38.39437086024252,0.04413451850140049,2473.26727437973,700.9897682666779,3120.753028869629,95728,10334,85394,85394,0,10,10882000.0
10882,10882999,21.969323683634997,38.393588461326196,0.04413315301235565,2473.596161365509,701.0514960289001,3121.102039337158,95740,10335,85405,85405,0,10,10883000.0
10883,10883999,21.96916709315833,38.393479805950584,0.044129022145213304,2473.727578639984,701.1122395992279,3121.458843231201,95741,10335,85406,85406,0,10,10884000.0
10884,10884999,21.968510946743287,38.39230974200572,0.044130207402307,2473.8648550510406,701.1734762191772,3122.3966026306152,95743,10335,85408,85408,0,10,10885000.0
10885,10885999,21.967862655552917,38.39192110637279,0.04412981351757772,2474.2074472904205,701.2358059883118,3122.835346221924,95746,10336,85410,85410,0,10,10886000.0
10886,10886999,21.967152405282352,38.39061269200631,0.04413253215248758,2474.3300998210907,701.2978882789612,3123.290496826172,95747,10336,85411,85411,0,10,10887000.0
10887,10887999,21.966537409552334,38.38941254496639,0.04413510504480367,2474.445213317871,701.3581738471985,3123.6201972961426,95748,10336,85412,85412,0,10,10888000.0
10888,10888999,21.96599487616056,38.38851122435291,0.04413588846517902,2474.7681238651276,701.4200940132141,3123.832389831543,95761,10337,85424,85424,0,10,10889000.0
10889,10889999,21.96549532033164,38.38744233305035,0.044135425130061856,2475.297144174576,701.4807481765747,3124.0246238708496,95775,10339,85436,85436,0,10,10890000.0
10890,10890999,21.96492301045978,38.386338892406414,0.04413408252992568,2475.4087982177734,701.5416970252991,3124.3327674865723,95776,10339,85437,85437,0,10,10891000.0
10891,10891999,21.96468762674426,38.38585072731026,0.04412833093646573,2475.522949695587,701.6017520427704,3124.593288421631,95776,10339,85437,85437,0,10,10892000.0
10892,10892999,21.964752110018946,38.386922192025835,0.04412143928567114,2475.8489985466003,701.6623015403748,3124.851837158203,95778,10340,85438,85438,0,10,10893000.0
10893,10893999,21.965267804920344,38.38821532435695,0.044111886742038364,2475.977701187134,701.7225155830383,3125.129928588867,95778,10340,85438,85438,0,10,10894000.0
10894,10894999,21.96630672798122,38.39187430916263,0.04410799299724688,2476.099896669388,701.7825565338135,3125.438320159912,95778,10340,85438,85438,0,10,10895000.0
10895,10895999,21.967597687428228,38.39445631756142,0.04411947861983889,2476.4282007217407,701.8440024852753,3125.717239379883,95782,10341,85441,85441,0,10,10896000.0
10896,10896999,21.96901788556394,38.39734902533375,0.04414493430461108,2476.7480459213257,701.9042310714722,3125.9232864379883,95784,10342,85442,85442,0,10,10897000.0
10897,10897999,21.97081031688554,38.401030946408895,0.0441495790616413,2477.2893216609955,701.9703948497772,3126.0709953308105,95794,10344,85450,85450,0,10,10898000.0
10898,10898999,21.972605639808048,38.40478080489337,0.044159670555495856,2477.407019853592,702.0328822135925,3126.3692474365234,95794,10344,85450,85450,0,10,10899000.0
10899,10899999,21.97433177875103,38.40786144474843,0.04417046246114931,2478.135716199875,702.0947341918945,3126.6039848327637,95822,10347,85475,85475,0,10,10900000.0
10900,10900999,21.97595608629922,38.410776891382575,0.0442110180347306,2478.4604749679565,702.1558434963226,3126.8024520874023,95824,10348,85476,85476,0,10,10901000.0
10901,10901999,21.97730469157118,38.41278735269769,0.044217756711871115,2478.5841522216797,702.2191395759583,3127.103630065918,95824,10348,85476,85476,0,10,10902000.0
10902,10902999,21.978931260918113,38.415545173854504,0.04423642073324929,2478.901339530945,702.2799754142761,3127.3577575683594,95837,10349,85488,85488,0,10,10903000.0
10903,10903999,21.97984685541851,38.4171008250758,0.04425150813362777,2479.4412541389465,702.3413965702057,3127.5676193237305,95858,10351,85507,85507,0,10,10904000.0
10904,10904999,21.979093225791548,38.41674941686148,0.044252586724507936,2480.177957057953,702.4038724899292,3128.4790802001953,95880,10354,85526,85526,0,10,10905000.0
10905,10905999,21.978415550743257,38.41646873952744,0.044250852873682245,2480.707263469696,702.4663834571838,3128.9905319213867,95884,10356,85528,85528,0,10,10906000.0
10906,10906999,21.977875205475424,38.415602705041316,0.044251357878963726,2480.837820291519,702.5287048816681,3129.3598022460938,95884,10356,85528,85528,0,10,10907000.0
10907,10907999,21.9775623028267,38.41548371673741,0.04425421508048821,2480.954554796219,702.5901565551758,3129.7404022216797,95884,10356,85528,85528,0,10,10908000.0
10908,10908999,21.9771433245709,38.41461342818062,0.04425386597715353,2481.2785387039185,702.6524286270142,3130.008243560791,95889,10357,85532,85532,0,10,10909000.0
10909,10909999,21.976927384128945,38.41447289834349,0.044252766205232,2481.8136081695557,702.715158700943,3130.2484703063965,95913,10359,85554,85554,0,10,10910000.0
10910,10910999,21.976758539695766,38.41411637766428,0.04425095845499338,2482.1364221572876,702.7767510414124,3130.474666595459,95920,10360,85560,85560,0,10,10911000.0
10911,10911999,21.976647556029995,38.41392641459401,0.04425108566438707,2482.2644572257996,702.8394384384155,3130.853561401367,95921,10360,85561,85561,0,10,10912000.0
10912,10912999,21.976828534299077,38.414328851050655,0.044248495690587086,2482.5850615501404,702.8995332717896,3131.1036949157715,95924,10361,85563,85563,0,10,10913000.0
10913,10913999,21.97689533988296,38.41423868960202,0.04424862816987607,2482.703446149826,702.9616997241974,3131.436180114746,95924,10361,85563,85563,0,10,10914000.0
10914,10914999,21.977212903182306,38.41440176690074,0.044246834068304985,2482.8317897319794,703.0233268737793,3131.7686614990234,95925,10361,85564,85564,0,10,10915000.0
10915,10915999,21.977798781550828,38.41531323391665,0.04424662471049268,2483.1641380786896,703.0883784294128,3131.947708129883,95927,10362,85565,85565,0,10,10916000.0
10916,10916999,21.9781603112984,38.4157049108503,0.044248924577886206,2483.2784106731415,703.1501808166504,3132.3381385803223,95927,10362,85565,85565,0,10,10917000.0
10917,10917999,21.978706557539297,38.41642112160271,0.04425084488422526,2483.594617843628,703.2105870246887,3132.674419403076,95939,10363,85576,85576,0,10,10918000.0
10918,10918999,21.97929055991374,38.41771063330992,0.04424801892166674,2483.916513442993,703.2705183029175,3132.9766540527344,95944,10364,85580,85580,0,10,10919000.0
10919,10919999,21.9798713738777,38.418450927318226,0.04425438158148087,2484.04065489769,703.3320112228394,3133.3547706604004,95946,10364,85582,85582,0,10,10920000.0
10920,10920999,21.98070764671792,38.420976459561096,0.044254130292561866,2484.167366027832,703.3923006057739,3133.8321533203125,95946,10364,85582,85582,0,10,10921000.0
10921,10921999,21.98135041076895,38.42195088888616,0.04425452184997458,2484.7053277492523,703.4540910720825,3134.0097694396973,95970,10366,85604,85604,0,10,10922000.0
10922,10922999,21.981879483755346,38.42274837601655,0.044252943237596876,2484.81858253479,703.514545917511,3134.355209350586,95970,10366,85604,85604,0,10,10923000.0
10923,10923999,21.9823120824932,38.422903333196395,0.044251606906631324,2485.372277736664,703.5805025100708,3134.69425201416,95993,10368,85625,85625,0,10,10924000.0
10924,10924999,21.982364842373002,38.42292763112782,0.044248467054726515,2485.7063026428223,703.6413826942444,3135.63529586792,96006,10369,85637,85637,0,10,10925000.0
10925,10925999,21.981979238975462,38.4227472428604,0.04424392588911019,2486.0407955646515,703.7049341201782,3136.5124549865723,96009,10370,85639,85639,0,10,10926000.0
10926,10926999,21.981468497116236,38.422604743977296,0.044237266263688624,2486.1569323539734,703.7659869194031,3137.0014114379883,96009,10370,85639,85639,0,10,10927000.0
10927,10927999,21.98097647989169,38.42164262320052,0.04423484496232344,2486.268858909607,703.8268532752991,3137.383800506592,96010,10370,85640,85640,0,10,10928000.0
10928,10928999,21.98056548127836,38.4210443581438,0.04423140390268698,2486.592897415161,703.8871276378632,3137.616767883301,96023,10371,85652,85652,0,10,10929000.0
10929,10929999,21.980064112369863,38.41990967733146,0.044228561283130796,2486.9207923412323,703.9488232135773,3137.898910522461,96031,10372,85659,85659,0,10,10930000.0
10930,10930999,21.979637454252398,38.41890460118178,0.04422404329589669,2487.238224029541,704.0093076229095,3138.2735900878906,96036,10373,85663,85663,0,10,10931000.0
10931,10931999,21.979223197410942,38.417975698642316,0.044220096511586426,2487.5534443855286,704.0696370601654,3138.6221199035645,96048,10374,85674,85674,0,10,10932000.0
10932,10932999,21.978972483785196,38.417229692457745,0.044214925038334685,2487.8736712932587,704.1297595500946,3138.900463104248,96050,10375,85675,85675,0,10,10933000.0
10933,10933999,21.978691814347542,38.41655956508217,0.04420870799556054,2488.1932983398438,704.1915118694305,3139.274341583252,96053,10376,85677,85677,0,10,10934000.0
10934,10934999,21.978516079855293,38.41611434765098,0.04420333011919686,2488.5204565525055,704.2533118724823,3139.5421714782715,96065,10377,85688,85688,0,10,10935000.0
10935,10935999,21.97870045793571,38.41612684992272,0.04420044109125132,2488.8406224250793,704.3152456283569,3139.857391357422,96077,10378,85699,85699,0,10,10936000.0
10936,10936999,21.979413242315715,38.41690298370313,0.04419873425838783,2489.1643850803375,704.3758664131165,3140.2558975219727,96089,10379,85710,85710,0,10,10937000.0
10937,10937999,21.980482110001837,38.418919448668184,0.04420322563246759,2489.5152230262756,704.4438264369965,3140.591625213623,96102,10380,85722,85722,0,10,10938000.0
10938,10938999,21.98184969811161,38.421253766016186,0.044208575293401386,2489.6265728473663,704.5038585662842,3141.0067405700684,96102,10380,85722,85722,0,10,10939000.0
10939,10939999,21.983374370356717,38.423851828930864,0.04421663792117847,2489.9520106315613,704.5654966831207,3141.425552368164,96109,10381,85728,85728,0,10,10940000.0
10940,10940999,21.985421376000737,38.427620022926185,0.044233983242467856,2490.0866446495056,704.6416907310486,3141.911922454834,96109,10381,85728,85728,0,10,10941000.0
10941,10941999,21.987017406743632,38.42993223511718,0.04426008696237682,2490.417492389679,704.703360080719,3142.2484245300293,96121,10382,85739,85739,0,10,10942000.0
10942,10942999,21.989130735170754,38.433161792398536,0.04428104553373291,2490.7375626564026,704.7646021842957,3142.521053314209,96138,10383,85755,85755,0,10,10943000.0
10943,10943999,21.99075431847408,38.43516931886794,0.0443064180705971,2490.8485634326935,704.8258237838745,3142.937602996826,96138,10383,85755,85755,0,10,10944000.0
10944,10944999,21.991291655851693,38.43544076558528,0.044308312506371794,2490.9784739017487,704.8877038955688,3143.7839431762695,96139,10383,85756,85756,0,10,10945000.0
10945,10945999,21.990743953416853,38.43466739563489,0.04430257834767659,2491.304250717163,704.9501535892487,3144.336570739746,96141,10384,85757,85757,0,10,10946000.0
10946,10946999,21.990287179526497,38.43382530949102,0.04429895825461416,2491.6388986110687,705.0132141113281,3144.7342109680176,96144,10385,85759,85759,0,10,10947000.0
10947,10947999,21.98989952336262,38.43294612141775,0.044295364662525594,2491.974061727524,705.0763349533081,3145.142967224121,96157,10386,85771,85771,0,10,10948000.0
10948,10948999,21.989606690129744,38.43216012923418,0.044288819651442934,2492.2938828468323,705.1382668018341,3145.3854637145996,96159,10387,85772,85772,0,10,10949000.0
10949,10949999,21.98920125189067,38.43126834165091,0.04428201862063719,2492.4107625484467,705.2003014087677,3145.7033309936523,96159,10387,85772,85772,0,10,10950000.0
10950,10950999,21.98881468169939,38.430362185938684,0.044276310812300546,2492.5364632606506,705.262770652771,3146.083423614502,96159,10387,85772,85772,0,10,10951000.0
10951,10951999,21.988394601818875,38.4293628933266,0.04427397701217706,2493.082139492035,705.3255672454834,3146.356716156006,96163,10389,85774,85774,0,10,10952000.0
10952,10952999,21.988191029678504,38.428902870803164,0.04427114794957032,2493.194913625717,705.38743019104,3146.6210441589355,96163,10389,85774,85774,0,10,10953000.0
10953,10953999,21.988052235905187,38.42840074574188,0.04427215118201655,2494.3452653884888,705.4508032798767,3146.6598320007324,96197,10394,85803,85803,0,10,10954000.0
10954,10954999,21.988003460982323,38.42830098609456,0.04426967288914985,2494.465411901474,705.513772726059,3147.10306930542,96197,10394,85803,85803,0,10,10955000.0
10955,10955999,21.988218740054915,38.428425874238165,0.04427124558975648,2494.7889342308044,705.5755577087402,3147.3629989624023,96212,10395,85817,85817,0,10,10956000.0
10956,10956999,21.98864167516755,38.42874269138915,0.04427061478455607,2494.919285058975,705.6369018554688,3147.6572494506836,96212,10395,85817,85817,0,10,10957000.0
10957,10957999,21.98929328851618,38.42947761739837,0.04428696287714973,2495.0581514835358,705.7089104652405,3148.027271270752,96213,10395,85818,85818,0,10,10958000.0
10958,10958999,21.9902722027615,38.43072732590576,0.044302720606643975,2495.169990539551,705.7691338062286,3148.465747833252,96213,10395,85818,85818,0,10,10959000.0
10959,10959999,21.991730790001796,38.43289103802021,0.04433494569961416,2495.2901997566223,705.8300120830536,3148.9344444274902,96213,10395,85818,85818,0,10,10960000.0
10960,10960999,21.992754438664903,38.43383130953419,0.04434512356810849,2495.4036355018616,705.8901884555817,3149.243606567383,96213,10395,85818,85818,0,10,10961000.0
10961,10961999,21.994025057598467,38.435889268217544,0.044358629535956595,2495.5459356307983,705.9637939929962,3149.5945205688477,96213,10395,85818,85818,0,10,10962000.0
10962,10962999,21.99537616156643,38.43741498349035,0.04436804546662321,2495.866832256317,706.0243182182312,3149.9107093811035,96226,10396,85830,85830,0,10,10963000.0
10963,10963999,21.99601232315673,38.437915289573205,0.044376457397938385,2496.4139320850372,706.0878415107727,3150.774688720703,96247,10398,85849,85849,0,10,10964000.0
10964,10964999,21.995797268691216,38.43737871230804,0.044359305300443186,2496.951103448868,706.1503310203552,3151.513874053955,96264,10400,85864,85864,0,10,10965000.0
10965,10965999,21.995609564121192,38.43652393703707,0.04434034206891857,2497.089489221573,706.2216050624847,3152.1963119506836,96265,10400,85865,85865,0,10,10966000.0
10966,10966999,21.995359963056092,38.43569709724244,0.04432867201160928,2497.431452512741,706.2880408763885,3152.606430053711,96277,10401,85876,85876,0,10,10967000.0
10967,10967999,21.995198829105203,38.43494756657458,0.04431369116219985,2497.555994987488,706.3486247062683,3152.9341621398926,96277,10401,85876,85876,0,10,10968000.0
10968,10968999,21.995158016289764,38.43422553149192,0.04429703787092154,2497.882830619812,706.4120528697968,3153.326644897461,96285,10402,85883,85883,0,10,10969000.0
10969,10969999,21.994929986938207,38.43340626522543,0.044283967114374656,2498.6714584827423,706.4789938926697,3153.5291137695312,96307,10405,85902,85902,0,10,10970000.0
10970,10970999,21.994775165636835,38.43286077152258,0.04426988691526701,2498.988673210144,706.5396888256073,3153.776138305664,96309,10406,85903,85903,0,10,10971000.0
10971,10971999,21.994662008305596,38.43210702679175,0.04425647402804567,2499.3127603530884,706.6004438400269,3154.208541870117,96321,10407,85914,85914,0,10,10972000.0
10972,10972999,21.99483536218668,38.432112733907694,0.04424290337926895,2499.4273166656494,706.6613676548004,3154.6853675842285,96321,10407,85914,85914,0,10,10973000.0
10973,10973999,21.995345219669396,38.432476202462695,0.04423444883252303,2499.547873020172,706.722461938858,3155.0215759277344,96321,10407,85914,85914,0,10,10974000.0
10974,10974999,21.996356816469707,38.4341624924711,0.04424085760403318,2499.6626830101013,706.7841794490814,3155.509532928467,96322,10407,85915,85915,0,10,10975000.0
10975,10975999,21.997661441236442,38.43634040579941,0.04425855651958843,2499.9962372779846,706.8469772338867,3155.8643226623535,96334,10408,85926,85926,0,10,10976000.0
10976,10976999,21.998833237037655,38.43819489465408,0.044269606525749516,2500.523562669754,706.9091854095459,3156.061595916748,96342,10410,85932,85932,0,10,10977000.0
10977,10977999,22.000481304215697,38.44096029333345,0.0442905380893559,2500.642650604248,706.9697144031525,3156.5821228027344,96342,10410,85932,85932,0,10,10978000.0
10978,10978999,22.002386755521172,38.44552087291297,0.04432540674610519,2500.962687730789,707.0321581363678,3156.9899826049805,96349,10411,85938,85938,0,10,10979000.0
10979,10979999,22.004794629120727,38.450565465925074,0.04436450183249652,2501.6943159103394,707.0935063362122,3157.3195419311523,96376,10414,85962,85962,0,10,10980000.0
10980,10980999,22.007519638217822,38.457288297738614,0.04440564937400926,2501.808973312378,707.1545073986053,3157.711338043213,96376,10414,85962,85962,0,10,10981000.0
10981,10981999,22.00984069183701,38.46166147058637,0.04444524719392762,2501.9264085292816,707.2159757614136,3158.134506225586,96376,10414,85962,85962,0,10,10982000.0
10982,10982999,22.012783652891564,38.467868142116615,0.04450216102776905,2502.0413966178894,707.2773456573486,3158.5654258728027,96377,10414,85963,85963,0,10,10983000.0
10983,10983999,22.014864662923568,38.47126631708501,0.04454488828647696,2502.3561470508575,707.3371651172638,3158.840099334717,96390,10415,85975,85975,0,10,10984000.0
10984,10984999,22.015040576803486,38.47142375236076,0.04453698774302117,2502.489292383194,707.3999950885773,3160.078266143799,96397,10415,85982,85982,0,10,10985000.0
10985,10985999,22.01460687466346,38.47050887676586,0.044531350897763056,2502.8232419490814,707.4614150524139,3160.6705741882324,96415,10416,85999,85999,0,10,10986000.0
10986,10986999,22.014507036260852,38.47063666681426,0.044524748113393575,2503.3543577194214,707.5248777866364,3161.0208168029785,96420,10418,86002,86002,0,10,10987000.0
10987,10987999,22.014399277737855,38.470052284761714,0.04451382643769419,2503.672542333603,707.5862114429474,3161.4870376586914,96423,10419,86004,86004,0,10,10988000.0
10988,10988999,22.014249236306995,38.469452315199796,0.044502702089174284,2503.8001499176025,707.6476817131042,3161.970729827881,96423,10419,86004,86004,0,10,10989000.0
10989,10989999,22.014056812512795,38.46877923353373,0.044493238325346796,2503.9246230125427,707.7081842422485,3162.300235748291,96423,10419,86004,86004,0,10,10990000.0
10990,10990999,22.01374361142338,38.467935320083434,0.04448658187286503,2504.4600732326508,707.7704017162323,3162.689224243164,96427,10421,86006,86006,0,10,10991000.0
10991,10991999,22.013651762534806,38.46759754927796,0.04447564476138255,2504.990693092346,707.8340318202972,3163.057544708252,96435,10423,86012,86012,0,10,10992000.0
10992,10992999,22.013534642294513,38.46695047515987,0.044468209608032216,2505.5337142944336,707.8955082893372,3163.231170654297,96459,10425,86034,86034,0,10,10993000.0
10993,10993999,22.01341899855286,38.46639124316872,0.04446218181727146,2505.65412569046,707.9576454162598,3163.6661834716797,96459,10425,86034,86034,0,10,10994000.0
10994,10994999,22.013407195666858,38.46572819853906,0.04445314757761665,2505.9830825328827,708.0199162960052,3164.049949645996,96471,10426,86045,86045,0,10,10995000.0
10995,10995999,22.013465601710624,38.46543294402437,0.04444695853840719,2506.110440969467,708.0801501274109,3164.331428527832,96471,10426,86045,86045,0,10,10996000.0
10996,10996999,22.01352997225107,38.46488164002384,0.04444131476806523,2506.8370022773743,708.1431746482849,3164.6304092407227,96497,10429,86068,86068,0,10,10997000.0
10997,10997999,22.013712321071235,38.46462957952108,0.04443562786013333,2507.1578662395477,708.2039697170258,3165.0289459228516,96510,10430,86080,86080,0,10,10998000.0
10998,10998999,22.01380803613389,38.464141583935266,0.04443391777273076,2507.684569120407,708.2648632526398,3165.2212257385254,96539,10432,86107,86107,0,10,10999000.0
10999,10999999,22.014060698150058,38.463729488495254,0.04442472119185015,2508.01474237442,708.3264565467834,3165.5719604492188,96551,10433,86118,86118,0,10,11000000.0
11000,11000999,22.014224021431154,38.46312676008633,0.04441615333560822,2508.3483622074127,708.3890852928162,3165.9421043395996,96563,10434,86129,86129,0,10,11001000.0
11001,11001999,22.014539652224787,38.46283972361344,0.04441094100410403,2508.6701097488403,708.4499170780182,3166.245464324951,96565,10435,86130,86130,0,10,11002000.0
11002,11002999,22.0148942322084,38.463356380671044,0.04440158870944555,2508.790857553482,708.5100257396698,3166.550468444824,96565,10435,86130,86130,0,10,11003000.0
11003,11003999,22.01495137754356,38.46273769656309,0.04439188084330803,2509.1217827796936,708.5713696479797,3166.845058441162,96568,10436,86132,86132,0,10,11004000.0
11004,11004999,22.01494186808177,38.4620302274338,0.0443852683795557,2509.2347390651703,708.6310226917267,3167.265655517578,96568,10436,86132,86132,0,10,11005000.0
11005,11005999,22.014571421140953,38.46189829859144,0.04439041599390414,2509.5863225460052,708.6935977935791,3168.193546295166,96580,10437,86143,86143,0,10,11006000.0
11006,11006999,22.014106161203852,38.46136393539944,0.04439220447147885,2509.706547021866,708.7547495365143,3168.75927734375,96580,10437,86143,86143,0,10,11007000.0
11007,11007999,22.013701247334662,38.46067319481124,0.04439471003533679,2510.033264398575,708.8164870738983,3169.1388092041016,96582,10438,86144,86144,0,10,11008000.0
11008,11008999,22.01321950390336,38.459671247676596,0.044395428234451084,2510.3542313575745,708.877375125885,3169.356212615967,96594,10439,86155,86155,0,10,11009000.0
11009,11009999,22.012860404455562,38.45888933937693,0.04439571189343827,2510.687338113785,708.9382231235504,3169.6217918395996,96606,10440,86166,86166,0,10,11010000.0
11010,11010999,22.01269106178604,38.45837670149405,0.04439458679919439,2511.021699666977,709.0006654262543,3170.1480598449707,96612,10441,86171,86171,0,10,11011000.0
11011,11011999,22.012535081973777,38.45779702840091,0.044392042192579306,2511.138491868973,709.0609426498413,3170.617874145508,96612,10441,86171,86171,0,10,11012000.0
11012,11012999,22.01232676874003,38.45737664508658,0.0443893955183291,2511.2581934928894,709.122412443161,3170.8647537231445,96612,10441,86171,86171,0,10,11013000.0
11013,11013999,22.012253534269284,38.45704883842905,0.04438709708537891,2511.585889339447,709.1837542057037,3171.188850402832,96616,10442,86174,86174,0,10,11014000.0
11014,11014999,22.012117379516816,38.45660164349726,0.0443850453145177,2511.698145866394,709.2448287010193,3171.5039825439453,96616,10442,86174,86174,0,10,11015000.0
11015,11015999,22.01205835703626,38.45630094845622,0.0443847038681342,2512.023066997528,709.3053064346313,3171.7666206359863,96618,10443,86175,86175,0,10,11016000.0
11016,11016999,22.011965835329544,38.4556594985172,0.04438201104422557,2512.1445167064667,709.36607837677,3172.082344055176,96618,10443,86175,86175,0,10,11017000.0
11017,11017999,22.01206829908031,38.45541126553962,0.04437996057841709,2512.4651579856873,709.426301240921,3172.329444885254,96620,10444,86176,86176,0,10,11018000.0
11018,11018999,22.012082609107733,38.45507355051304,0.044375246080003095,2512.7821118831635,709.486435174942,3172.571708679199,96622,10445,86177,86177,0,10,11019000.0
11019,11019999,22.012062215400007,38.454483037117434,0.0443721964386129,2513.1116485595703,709.5477528572083,3172.835994720459,96636,10446,86190,86190,0,10,11020000.0
11020,11020999,22.012010554384734,38.454012772747475,0.04436971112276866,2513.432385444641,709.6080589294434,3173.1199913024902,96643,10447,86196,86196,0,10,11021000.0
11021,11021999,22.01182944488626,38.453242312338844,0.04436604749288009,2513.546477794647,709.6686294078827,3173.538246154785,96643,10447,86196,86196,0,10,11022000.0
11022,11022999,22.011620391233027,38.453434831934274,0.04436326061995166,2514.0762178897858,709.7299230098724,3173.870578765869,96654,10449,86205,86205,0,10,11023000.0
11023,11023999,22.0108488459699,38.452384896920066,0.04436900552815093,2514.400369644165,709.7907228469849,3174.611957550049,96659,10450,86209,86209,0,10,11024000.0
11024,11024999,22.010073359581753,38.45105833785047,0.04437415333127914,2514.5336101055145,709.8535325527191,3175.0246086120605,96659,10450,86209,86209,0,10,11025000.0
11025,11025999,22.00930123826758,38.44977020158043,0.0443789500289814,2514.648213148117,709.9139659404755,3175.3422508239746,96659,10450,86209,86209,0,10,11026000.0
11026,11026999,22.008712248973758,38.44887370259336,0.04438309368510451,2515.3858568668365,709.975203037262,3175.4489936828613,96691,10453,86238,86238,0,10,11027000.0
11027,11027999,22.008444966127875,38.44960893799883,0.04438291733164568,2515.7250847816467,710.0372841358185,3175.6138916015625,96698,10454,86244,86244,0,10,11028000.0
11028,11028999,22.008968451393564,38.451991793499054,0.04438278458720768,2516.058487176895,710.0989329814911,3175.822895050049,96701,10455,86246,86246,0,10,11029000.0
11029,11029999,22.010024036232323,38.45623552438549,0.04439843924724496,2516.596686601639,710.1604473590851,3176.003303527832,96710,10457,86253,86253,0,10,11030000.0
11030,11030999,22.01151280469584,38.46254748610337,0.044419970934106656,2516.939065694809,710.2235600948334,3176.258659362793,96722,10458,86264,86264,0,10,11031000.0
11031,11031999,22.012599338835255,38.466622799254736,0.04443933473137274,2517.0560722351074,710.283812046051,3176.555992126465,96722,10458,86264,86264,0,10,11032000.0
11032,11032999,22.01387381283709,38.47136034840348,0.04445604820675331,2517.587342977524,710.3458242416382,3176.7751502990723,96742,10460,86282,86282,0,10,11033000.0
11033,11033999,22.015801244730188,38.47764345740358,0.044492827045476746,2517.9136548042297,710.4064128398895,3177.0294342041016,96745,10461,86284,86284,0,10,11034000.0
11034,11034999,22.017770881118295,38.48403142242331,0.0445191638789153,2518.0404753684998,710.4677040576935,3177.2921752929688,96745,10461,86284,86284,0,10,11035000.0
11035,11035999,22.020149049963162,38.4912244468183,0.04455136439885288,2518.1506781578064,710.5284805297852,3177.663661956787,96747,10461,86286,86286,0,10,11036000.0
11036,11036999,22.022613536218323,38.49803992392353,0.04458169150075464,2518.6937499046326,710.5905952453613,3177.9067916870117,96751,10463,86288,86288,0,10,11037000.0
11037,11037999,22.025715220381876,38.50630738141657,0.044619317514636325,2518.8041603565216,710.6506524085999,3178.2768211364746,96751,10463,86288,86288,0,10,11038000.0
11038,11038999,22.028495511342673,38.5131422433438,0.044652112413730904,2519.1371190547943,710.7116706371307,3178.411029815674,96753,10464,86289,86289,0,10,11039000.0
11039,11039999,22.031051432241384,38.5196767181671,0.04467523408384633,2519.2510063648224,710.7716860771179,3178.735652923584,96753,10464,86289,86289,0,10,11040000.0
11040,11040999,22.033508850003763,38.52496793572404,0.04471159334889929,2519.5734169483185,710.8328258991241,3178.958324432373,96755,10465,86290,86290,0,10,11041000.0
11041,11041999,22.035584178558125,38.52911069245542,0.044749204093171624,2520.1266524791718,710.8947463035583,3179.129325866699,96782,10467,86315,86315,0,10,11042000.0
11042,11042999,22.03524614819481,38.529387672105386,0.044747635505056116,2520.4606099128723,710.9558572769165,3180.187431335449,96788,10468,86320,86320,0,10,11043000.0
11043,11043999,22.034758054214823,38.52957158583305,0.044747104542154026,2520.5781712532043,711.0165836811066,3180.645046234131,96789,10468,86321,86321,0,10,11044000.0
11044,11044999,22.0345807344072,38.53019373551632,0.044744847478492944,2521.1166508197784,711.0787284374237,3180.7660942077637,96812,10470,86342,86342,0,10,11045000.0
11045,11045999,22.034314813319302,38.529998807456856,0.04474469348754484,2521.2395627498627,711.1407403945923,3181.1575050354004,96812,10470,86342,86342,0,10,11046000.0
11046,11046999,22.033980708274672,38.52950363415699,0.044744889127386056,2521.7731840610504,711.2042474746704,3181.3626556396484,96827,10472,86355,86355,0,10,11047000.0
11047,11047999,22.03363219567895,38.5291689715457,0.044741975798161304,2522.324407339096,711.2653501033783,3181.4925804138184,96854,10474,86380,86380,0,10,11048000.0
11048,11048999,22.033224772960562,38.52828635090035,0.044741896307067375,2522.655225276947,711.3270599842072,3181.889450073242,96856,10475,86381,86381,0,10,11049000.0
11049,11049999,22.033052042073745,38.527918094806935,0.04474030218553493,2522.7689073085785,711.3877100944519,3182.385715484619,96856,10475,86381,86381,0,10,11050000.0
11050,11050999,22.03286299923066,38.5275150212776,0.044737165760198594,2523.0955226421356,711.4504039287567,3182.6652336120605,96858,10476,86382,86382,0,10,11051000.0
11051,11051999,22.032566843537687,38.52679701300364,0.04473580713550507,2523.6379323005676,711.5123093128204,3182.9139518737793,96862,10478,86384,86384,0,10,11052000.0
11052,11052999,22.032476920536933,38.526291255907736,0.04473321282117515,2523.7510986328125,711.5730805397034,3183.3643836975098,96862,10478,86384,86384,0,10,11053000.0
11053,11053999,22.032341519548112,38.5256512866537,0.044732241889398505,2524.073535680771,711.6342840194702,3183.595615386963,96892,10479,86413,86413,0,10,11054000.0
11054,11054999,22.032331472851162,38.52551037015919,0.04472949206445287,2524.1955037117004,711.6956367492676,3183.934772491455,96892,10479,86413,86413,0,10,11055000.0
11055,11055999,22.032352775764604,38.52513104819986,0.04472783745917097,2524.321449279785,711.7574706077576,3184.2136878967285,96892,10479,86413,86413,0,10,11056000.0
11056,11056999,22.032482809867915,38.525737091048015,0.04472261376546727,2524.6423223018646,711.8179857730865,3184.4054260253906,96894,10480,86414,86414,0,10,11057000.0
11057,11057999,22.0325648092622,38.525319227194615,0.044720094468877924,2524.754626274109,711.8790955543518,3184.6972999572754,96894,10480,86414,86414,0,10,11058000.0
11058,11058999,22.03273977406405,38.52497761687038,0.0447170634059606,2525.2797436714172,711.9401469230652,3184.8988075256348,96908,10482,86426,86426,0,10,11059000.0
11059,11059999,22.032642167539716,38.52426735328737,0.04471816566374465,2525.8193242549896,712.0015525817871,3185.108501434326,96923,10484,86439,86439,0,10,11060000.0
11060,11060999,22.032563687569635,38.52369631946141,0.0447165984739204,2526.153405189514,712.0645933151245,3185.3688201904297,96925,10485,86440,86440,0,10,11061000.0
11061,11061999,22.032420955643794,38.52299966013837,0.044715334953134844,2526.6831154823303,712.1271436214447,3185.6496925354004,96949,10487,86462,86462,0,10,11062000.0
11062,11062999,22.03213256469066,38.52201258458003,0.044714175890761765,2526.8070430755615,712.1882467269897,3186.42818069458,96950,10487,86463,86463,0,10,11063000.0
11063,11063999,22.031529314534936,38.52106742091253,0.04471317061360536,2526.9298317432404,712.2508733272552,3187.0643348693848,96953,10487,86466,86466,0,10,11064000.0
11064,11064999,22.030877072317022,38.52002859508232,0.04471417070510264,2527.2567443847656,712.3129935264587,3187.3915481567383,96955,10488,86467,86467,0,10,11065000.0
11065,11065999,22.03040166996346,38.519776459363804,0.04471529164705523,2527.3760471343994,712.3752312660217,3187.6268577575684,96955,10488,86467,86467,0,10,11066000.0
11066,11066999,22.029947932652313,38.51871055827504,0.04471569898168626,2527.509358882904,712.4380834102631,3187.832176208496,96956,10488,86468,86468,0,10,11067000.0
11067,11067999,22.02948555652934,38.51766078063629,0.044715987981580274,2528.048422574997,712.5000014305115,3187.9945678710938,96970,10490,86480,86480,0,10,11068000.0
11068,11068999,22.029109612839,38.51681299099839,0.044717456761848684,2528.5999743938446,712.5616593360901,3188.152412414551,96976,10492,86484,86484,0,10,11069000.0
11069,11069999,22.028877495144776,38.51637056320772,0.04471447568019726,2528.7158765792847,712.6227235794067,3188.3484268188477,96977,10492,86485,86485,0,10,11070000.0
11070,11070999,22.028608869946343,38.515804463894675,0.04471355443985092,2528.827540397644,712.6839189529419,3188.732250213623,96977,10492,86485,86485,0,10,11071000.0
11071,11071999,22.028439073008432,38.51534623397591,0.044710212756569834,2529.3585209846497,712.7461071014404,3188.8729515075684,96981,10494,86487,86487,0,10,11072000.0
11072,11072999,22.028358563171764,38.5149946178931,0.04470742408030859,2529.687659263611,712.8086173534393,3189.030830383301,96988,10495,86493,86493,0,10,11073000.0
11073,11073999,22.028387330729473,38.51486107359677,0.044704017932327145,2529.8113441467285,712.8703708648682,3189.316707611084,96988,10495,86493,86493,0,10,11074000.0
11074,11074999,22.028235921545143,38.5141463525088,0.04470072180271556,2530.552944421768,712.9315180778503,3189.387798309326,96999,10498,86501,86501,0,10,11075000.0
11075,11075999,22.02810184743928,38.51339282064016,0.04469503612549319,2531.2868576049805,712.9933078289032,3189.416328430176,97005,10501,86504,86504,0,10,11076000.0
11076,11076999,22.028132608034632,38.51288425156693,0.04468983540413951,2531.603537082672,713.0537540912628,3189.7151260375977,97013,10502,86511,86511,0,10,11077000.0
11077,11077999,22.028315580637493,38.513622917363755,0.04467920834373751,2531.9384973049164,713.1157612800598,3189.9766387939453,97025,10503,86522,86522,0,10,11078000.0
11078,11078999,22.02855613557185,38.51337577935378,0.04467111770457721,2532.274559020996,713.1814484596252,3190.2764320373535,97032,10504,86528,86528,0,10,11079000.0
11079,11079999,22.02887874572071,38.51308903439975,0.0446653932200296,2532.384741783142,713.2414333820343,3190.5726203918457,97032,10504,86528,86528,0,10,11080000.0
11080,11080999,22.029195268872716,38.5129322768725,0.04465927183616991,2532.7212541103363,713.3041751384735,3190.769599914551,97034,10505,86529,86529,0,10,11081000.0
11081,11081999,22.029428139372822,38.51252699842396,0.04465328080164932,2532.841298341751,713.364887714386,3191.021011352539,97034,10505,86529,86529,0,10,11082000.0
11082,11082999,22.02949271084992,38.51197073402577,0.04464686527663131,2532.954721927643,713.4245066642761,3191.20365524292,97034,10505,86529,86529,0,10,11083000.0
11083,11083999,22.029157068858932,38.51191931930237,0.044645738708503635,2533.4896903038025,713.4863846302032,3191.8866806030273,97051,10507,86544,86544,0,10,11084000.0
11084,11084999,22.028462215378816,38.51162014006111,0.04464625314007009,2533.620110273361,713.5483131408691,3192.4554176330566,97052,10507,86545,86545,0,10,11085000.0
11085,11085999,22.02801883080632,38.513738319200236,0.04464067719938991,2533.739005804062,713.6101984977722,3192.7988929748535,97052,10507,86545,86545,0,10,11086000.0
11086,11086999,22.02736504080062,38.51261685991487,0.04464330665425542,2534.280687570572,713.671626329422,3192.8743743896484,97069,10509,86560,86560,0,10,11087000.0
11087,11087999,22.02687677047034,38.511713738123845,0.04464306076311886,2534.6245200634003,713.7342205047607,3193.1223526000977,97071,10510,86561,86561,0,10,11088000.0
11088,11088999,22.026421770164895,38.510979486797886,0.044644341606969395,2534.7581293582916,713.7963078022003,3193.371650695801,97071,10510,86561,86561,0,10,11089000.0
11089,11089999,22.02593538952361,38.5101337298047,0.04464534524451613,2534.8747522830963,713.8581488132477,3193.6649284362793,97071,10510,86561,86561,0,10,11090000.0
11090,11090999,22.0255237755163,38.50924588577634,0.04464450425145372,2535.40292096138,713.9190664291382,3193.8719482421875,97075,10512,86563,86563,0,10,11091000.0
11091,11091999,22.02513479865137,38.50827314301347,0.04464323500163758,2535.737851381302,713.9799690246582,3194.0778312683105,97077,10513,86564,86564,0,10,11092000.0
11092,11092999,22.024810717369792,38.50725093611128,0.04464031378591238,2536.068678855896,714.0407993793488,3194.303325653076,97079,10514,86565,86565,0,10,11093000.0
11093,11093999,22.024573403326606,38.506542354463846,0.04463431004351981,2536.398317337036,714.1024823188782,3194.5399475097656,97081,10515,86566,86566,0,10,11094000.0
11094,11094999,22.02439073133683,38.505806445869815,0.04462785487455112,2536.5176701545715,714.1626226902008,3194.795742034912,97081,10515,86566,86566,0,10,11095000.0
11095,11095999,22.02422032287789,38.505073183270994,0.04462194217546067,2536.6426978111267,714.2233898639679,3195.17977142334,97082,10515,86567,86567,0,10,11096000.0
11096,11096999,22.024048859866433,38.50420974429839,0.04461577698737906,2536.767375230789,714.2853956222534,3195.4575004577637,97082,10515,86567,86567,0,10,11097000.0
11097,11097999,22.02406617007796,38.50372951944073,0.044607199404185116,2536.884761095047,714.3469223976135,3195.730167388916,97082,10515,86567,86567,0,10,11098000.0
11098,11098999,22.024048570630566,38.50300708384064,0.044600121190522146,2537.209843635559,714.4082961082458,3195.9717750549316,97084,10516,86568,86568,0,10,11099000.0
11099,11099999,22.024195975412418,38.50249463594606,0.04459029471674114,2537.3299012184143,714.4684932231903,3196.2500190734863,97084,10516,86568,86568,0,10,11100000.0
11100,11100999,22.024276904089366,38.50194601719852,0.04458220355467324,2537.86971783638,714.5307836532593,3196.383415222168,97099,10518,86581,86581,0,10,11101000.0
11101,11101999,22.024264513850625,38.5012154197374,0.04457424631867779,2538.40544629097,714.5923225879669,3196.633834838867,97113,10520,86593,86593,0,10,11102000.0
11102,11102999,22.024362447492013,38.50053906966476,0.04456319674311571,2538.7309715747833,714.6538548469543,3196.9098320007324,97118,10521,86597,86597,0,10,11103000.0
11103,11103999,22.02429588479051,38.49975454663666,0.04455533652663801,2539.0587437152863,714.7153346538544,3197.064640045166,97120,10522,86598,86598,0,10,11104000.0
11104,11104999,22.023683873695425,38.4989950430763,0.04455493809258859,2539.386420249939,714.7771556377411,3198.1117515563965,97124,10523,86601,86601,0,10,11105000.0
11105,11105999,22.0230749658113,38.497932570243655,0.044555235650302394,2539.7188506126404,714.8382914066315,3198.4796104431152,97140,10524,86616,86616,0,10,11106000.0
11106,11106999,22.02245134911112,38.49666840469935,0.044556376159375244,2540.049823999405,714.8996112346649,3198.7085037231445,97152,10525,86627,86627,0,10,11107000.0
11107,11107999,22.022043947774506,38.49569391600494,0.0445563644547593,2540.184531211853,714.9735684394836,3199.098808288574,97152,10525,86627,86627,0,10,11108000.0
11108,11108999,22.021610405221416,38.494781633240805,0.04455415522364237,2540.310650587082,715.0355222225189,3199.417869567871,97152,10525,86627,86627,0,10,11109000.0
11109,11109999,22.02107066849202,38.493573961730135,0.04455515847660274,2540.4263532161713,715.0977327823639,3199.6563453674316,97152,10525,86627,86627,0,10,11110000.0
11110,11110999,22.0205377489315,38.49236125846301,0.04455475578114387,2540.559034347534,715.1586577892303,3199.9170684814453,97152,10525,86627,86627,0,10,11111000.0
11111,11111999,22.02021693972971,38.49153594205916,0.044552116959987065,2540.6833589076996,715.2206885814667,3200.232582092285,97152,10525,86627,86627,0,10,11112000.0
11112,11112999,22.01977045674491,38.490505965860635,0.044552727023542626,2540.8066539764404,715.2819802761078,3200.4167976379395,97152,10525,86627,86627,0,10,11113000.0
11113,11113999,22.019469601163063,38.48954018415075,0.044551232252232786,2540.9367394447327,715.3533589839935,3200.7336082458496,97152,10525,86627,86627,0,10,11114000.0
11114,11114999,22.019266088094273,38.48906002143033,0.04454918153621101,2541.0651931762695,715.4149765968323,3201.006072998047,97152,10525,86627,86627,0,10,11115000.0
11115,11115999,22.01904205519339,38.48846561691931,0.04454815667045575,2541.3869531154633,715.4753234386444,3201.1073417663574,97154,10526,86628,86628,0,10,11116000.0
11116,11116999,22.018852383895567,38.488619922068686,0.044546689694353825,2541.5123014450073,715.5366129875183,3201.3798751831055,97154,10526,86628,86628,0,10,11117000.0
11117,11117999,22.018707821487105,38.48822980886595,0.04454549999536461,2541.8484077453613,715.5985243320465,3201.607978820801,97166,10527,86639,86639,0,10,11118000.0
11118,11118999,22.01883205715496,38.48833712101955,0.04454579061542763,2541.9650778770447,715.6596240997314,3201.7877235412598,97166,10527,86639,86639,0,10,11119000.0
11119,11119999,22.01907298835823,38.4885540412047,0.04454703803345239,2542.2958233356476,715.7209103107452,3202.015369415283,97178,10528,86650,86650,0,10,11120000.0
11120,11120999,22.019354027011456,38.48848759606007,0.044551368124006174,2542.4088230133057,715.780987739563,3202.3821907043457,97178,10528,86650,86650,0,10,11121000.0
11121,11121999,22.0195079351713,38.488219042492155,0.04455266780650069,2542.5366933345795,715.8422560691833,3202.6342697143555,97178,10528,86650,86650,0,10,11122000.0
11122,11122999,22.019673093204936,38.48805589580745,0.04455493190114801,2542.869443178177,715.9045786857605,3202.8083992004395,97180,10529,86651,86651,0,10,11123000.0
11123,11123999,22.01985125070429,38.48790864857667,0.04455579494810835,2543.19669175148,715.9648933410645,3203.0317306518555,97192,10530,86662,86662,0,10,11124000.0
11124,11124999,22.019686604831733,38.48711428703254,0.044553517199942716,2543.5188126564026,716.02498960495,3203.3526878356934,97204,10531,86673,86673,0,10,11125000.0
11125,11125999,22.019415605377052,38.486861547699185,0.044531343339152096,2543.654226541519,716.0859344005585,3204.110095977783,97204,10531,86673,86673,0,10,11126000.0
11126,11126999,22.019125803577058,38.48623630301515,0.044508746053048776,2543.982567548752,716.1491701602936,3204.476448059082,97209,10532,86677,86677,0,10,11127000.0
11127,11127999,22.01882065588653,38.48542907982253,0.04448942260353361,2544.105161190033,716.2107300758362,3204.717670440674,97209,10532,86677,86677,0,10,11128000.0
11128,11128999,22.018694335130984,38.48496102229186,0.04446444250857651,2544.2168645858765,716.270934343338,3204.961414337158,97209,10532,86677,86677,0,10,11129000.0
11129,11129999,22.01853723982505,38.48420294707453,0.044445547733463764,2544.3434505462646,716.3323242664337,3205.200263977051,97209,10532,86677,86677,0,10,11130000.0
11130,11130999,22.01837919572681,38.48380612206783,0.044426164819130864,2544.6725747585297,716.3931407928467,3205.3425636291504,97221,10533,86688,86688,0,10,11131000.0
11131,11131999,22.0181558186539,38.48308364589106,0.04441188123218309,2544.799249649048,716.4533624649048,3205.5409545898438,97221,10533,86688,86688,0,10,11132000.0
11132,11132999,22.018067922266173,38.48259369100015,0.044396427795820426,2545.341086626053,716.5145347118378,3205.6504135131836,97240,10535,86705,86705,0,10,11133000.0
11133,11133999,22.017936116254273,38.48197047488898,0.04438616178598109,2545.462259531021,716.5755038261414,3205.8601989746094,97240,10535,86705,86705,0,10,11134000.0
11134,11134999,22.01772381080744,38.481310484329576,0.044379277436364495,2546.1947100162506,716.6377885341644,3206.0003395080566,97251,10538,86713,86713,0,10,11135000.0
11135,11135999,22.01779160051831,38.48100785787814,0.0443747003235051,2546.318281888962,716.6985070705414,3206.2843589782715,97251,10538,86713,86713,0,10,11136000.0
11136,11136999,22.017858938758415,38.48091104886529,0.04437771903314214,2546.657898426056,716.7604115009308,3206.375461578369,97255,10539,86716,86716,0,10,11137000.0
11137,11137999,22.017978054299,38.48070618300277,0.04437384521047283,2546.7796790599823,716.8230819702148,3206.709358215332,97255,10539,86716,86716,0,10,11138000.0
11138,11138999,22.018170242696556,38.480414208005875,0.04437396933947968,2547.1160945892334,716.8854827880859,3206.921745300293,97262,10540,86722,86722,0,10,11139000.0
11139,11139999,22.018635652190465,38.48068463584326,0.04438233510502887,2547.4445102214813,716.945916891098,3207.1723251342773,97278,10541,86737,86737,0,10,11140000.0
11140,11140999,22.01908468182593,38.481033484185104,0.04438425085764219,2547.9800906181335,717.0065927505493,3207.3551177978516,97287,10543,86744,86744,0,10,11141000.0
11141,11141999,22.019702453100724,38.48149886888345,0.04438370652098689,2548.3177399635315,717.0679278373718,3207.6229400634766,97299,10544,86755,86755,0,10,11142000.0
11142,11142999,22.020249340896438,38.481917078342995,0.044390469923091036,2548.6466085910797,717.1286940574646,3207.881492614746,97311,10545,86766,86766,0,10,11143000.0
11143,11143999,22.0209287444642,38.482340826031894,0.04440498520040537,2548.7680518627167,717.188839673996,3208.1966133117676,97311,10545,86766,86766,0,10,11144000.0
11144,11144999,22.021495654777432,38.48254625197504,0.04440220042885634,2549.0913622379303,717.2494130134583,3208.555881500244,97320,10546,86774,86774,0,10,11145000.0
11145,11145999,22.021650069650516,38.482114694483414,0.04438776582325954,2549.830666065216,717.3109223842621,3209.057716369629,97336,10549,86787,86787,0,10,11146000.0
11146,11146999,22.021701755729943,38.48207587692604,0.04436021435886117,2550.1577990055084,717.3723037242889,3209.9606895446777,97349,10550,86799,86799,0,10,11147000.0
11147,11147999,22.0218191641596,38.48191974324085,0.04432911465313505,2550.2798075675964,717.4333944320679,3210.5421829223633,97349,10550,86799,86799,0,10,11148000.0
11148,11148999,22.02205635512768,38.48216612035185,0.04429463566201208,2550.396623849869,717.4944939613342,3211.1260948181152,97350,10550,86800,86800,0,10,11149000.0
11149,11149999,22.022208376122894,38.481771646418885,0.04426313594592379,2550.51687335968,717.5566062927246,3211.5297203063965,97350,10550,86800,86800,0,10,11150000.0
11150,11150999,22.022328660842962,38.48145067962222,0.04423911840822958,2550.6505296230316,717.6186792850494,3211.9608268737793,97350,10550,86800,86800,0,10,11151000.0
11151,11151999,22.022565881787624,38.48127838105242,0.044218204428155716,2550.987229824066,717.6811275482178,3212.4276008605957,97352,10551,86801,86801,0,10,11152000.0
11152,11152999,22.022720179483816,38.48080187035472,0.04419491171067691,2551.1051301956177,717.742752790451,3212.915687561035,97352,10551,86801,86801,0,10,11153000.0
11153,11153999,22.0227809871247,38.48028937683767,0.044178910337264954,2551.460572719574,717.8086886405945,3213.2354850769043,97364,10552,86812,86812,0,10,11154000.0
11154,11154999,22.023151943440403,38.47991514078624,0.04415369362603372,2551.783962726593,717.8707258701324,3213.6655807495117,97376,10553,86823,86823,0,10,11155000.0
11155,11155999,22.02374627817381,38.47978676173949,0.04412225173998674,2551.8964607715607,717.9323842525482,3214.108039855957,97376,10553,86823,86823,0,10,11156000.0
11156,11156999,22.024468536112277,38.47997678153973,0.04409859836842378,2552.4299478530884,717.9936633110046,3214.4293823242188,97400,10555,86845,86845,0,10,11157000.0
11157,11157999,22.025239212137507,38.479979102043835,0.04406424595203673,2552.761692762375,718.0546548366547,3214.7046089172363,97408,10556,86852,86852,0,10,11158000.0
11158,11158999,22.02619011225207,38.480484563388,0.044032343137941576,2552.8704907894135,718.1155378818512,3215.106845855713,97408,10556,86852,86852,0,10,11159000.0
11159,11159999,22.02707230417642,38.480693756904344,0.044000329956584205,2553.1905314922333,718.1762652397156,3215.5331497192383,97420,10557,86863,86863,0,10,11160000.0
11160,11160999,22.028090752426337,38.48108131123313,0.0439581648648254,2553.717176914215,718.2379004955292,3215.940441131592,97434,10559,86875,86875,0,10,11161000.0
11161,11161999,22.02897951956257,38.481394767851896,0.043919944588147186,2553.837669610977,718.2989602088928,3216.4129943847656,97434,10559,86875,86875,0,10,11162000.0
11162,11162999,22.029793627093586,38.48157622627583,0.043886150977505034,2553.949000597,718.3590955734253,3216.806381225586,97434,10559,86875,86875,0,10,11163000.0
11163,11163999,22.030073348774977,38.48147823185493,0.04386235992735843,2554.2751166820526,718.4208102226257,3217.4049797058105,97437,10560,86877,86877,0,10,11164000.0
11164,11164999,22.029708887651907,38.482233465091085,0.0438523615643891,2554.5986745357513,718.4817869663239,3218.3082389831543,97468,10561,86907,86907,0,10,11165000.0
11165,11165999,22.029140118255302,38.48115382470174,0.04385166790161954,2554.712821960449,718.5428509712219,3218.8871116638184,97468,10561,86907,86907,0,10,11166000.0
11166,11166999,22.028697567198158,38.4802663165824,0.04385096560000612,2555.047660112381,718.6040501594543,3219.4000549316406,97498,10562,86936,86936,0,10,11167000.0
11167,11167999,22.028402750174653,38.479707716270326,0.04384827770303179,2555.383160829544,718.6663084030151,3219.738899230957,97510,10563,86947,86947,0,10,11168000.0
11168,11168999,22.028085951623723,38.47915454849693,0.04384385925827172,2556.1264414787292,718.7278945446014,3219.8339920043945,97536,10566,86970,86970,0,10,11169000.0
11169,11169999,22.027779761661744,38.47839789567652,0.04384278581153367,2556.244029521942,718.789651632309,3220.2119674682617,97536,10566,86970,86970,0,10,11170000.0
11170,11170999,22.027581706245794,38.47789739691596,0.04384043838740759,2556.3603847026825,718.8513917922974,3220.668972015381,97536,10566,86970,86970,0,10,11171000.0
11171,11171999,22.0272663385754,38.47709523085477,0.04384010117275172,2556.9049932956696,718.9143860340118,3220.864833831787,97554,10568,86986,86986,0,10,11172000.0
11172,11172999,22.027223173551295,38.476602089772065,0.04383947148348322,2557.4456930160522,718.975483417511,3221.1311416625977,97570,10570,87000,87000,0,10,11173000.0
11173,11173999,22.027382894492114,38.47657882123821,0.04383788291833135,2557.5754709243774,719.0361635684967,3221.5444869995117,97570,10570,87000,87000,0,10,11174000.0
11174,11174999,22.027748627293224,38.47702606288518,0.04384231287151408,2557.6974713802338,719.0975239276886,3221.8046493530273,97570,10570,87000,87000,0,10,11175000.0
11175,11175999,22.028049533304067,38.47721680055535,0.043841918271142144,2558.02530169487,719.1594424247742,3222.169116973877,97582,10571,87011,87011,0,10,11176000.0
11176,11176999,22.028599807407133,38.47781152262249,0.04385055341565314,2558.1407725811005,719.2203509807587,3222.6153259277344,97582,10571,87011,87011,0,10,11177000.0
11177,11177999,22.029159877795543,38.478586871270636,0.04385921180479724,2558.470094203949,719.2819604873657,3222.9829177856445,97584,10572,87012,87012,0,10,11178000.0
11178,11178999,22.030023173641176,38.48001278630312,0.043863385618734596,2558.583477497101,719.3421638011932,3223.3239212036133,97584,10572,87012,87012,0,10,11179000.0
11179,11179999,22.031336873719177,38.48354653963959,0.04387711861001342,2559.1234514713287,719.4037811756134,3223.683925628662,97603,10574,87029,87029,0,10,11180000.0
11180,11180999,22.032205090477035,38.48504321541566,0.043884166142132974,2559.4676814079285,719.4665911197662,3224.005687713623,97615,10575,87040,87040,0,10,11181000.0
11181,11181999,22.03353275201744,38.48733910390098,0.04390821280864454,2559.8087599277496,719.5278642177582,3224.2586708068848,97620,10576,87044,87044,0,10,11182000.0
11182,11182999,22.03494861258165,38.49030280736928,0.043923183956894096,2560.346941947937,719.5888171195984,3224.56241607666,97625,10578,87047,87047,0,10,11183000.0
11183,11183999,22.035312125740287,38.49079031422272,0.04392314964743704,2560.4698774814606,719.6503303050995,3225.3593406677246,97627,10578,87049,87049,0,10,11184000.0
11184,11184999,22.034482407810167,38.48964172833243,0.04392617599329374,2560.5891542434692,719.7117474079132,3225.9071044921875,97628,10578,87050,87050,0,10,11185000.0
11185,11185999,22.033795874485588,38.48914227418763,0.04392756314089352,2560.702938079834,719.7733821868896,3226.2313804626465,97628,10578,87050,87050,0,10,11186000.0
11186,11186999,22.03313246005436,38.48818464377014,0.04393031746285536,2560.8274273872375,719.8345565795898,3226.542079925537,97628,10578,87050,87050,0,10,11187000.0
11187,11187999,22.032762977437333,38.48795197855389,0.04392964813855782,2561.159067630768,719.8966519832611,3226.735549926758,97640,10579,87061,87061,0,10,11188000.0
11188,11188999,22.032288220130958,38.48706071000164,0.043930256357994746,2561.5007174015045,719.9577713012695,3227.0103874206543,97642,10580,87062,87062,0,10,11189000.0
11189,11189999,22.031831458903977,38.486208366172875,0.04393220771650963,2561.617089986801,720.0186631679535,3227.271774291992,97642,10580,87062,87062,0,10,11190000.0
11190,11190999,22.031476107243332,38.48562116291033,0.04393351862552586,2561.9472692012787,720.0791442394257,3227.4606170654297,97644,10581,87063,87063,0,10,11191000.0
11191,11191999,22.031128290487406,38.485024797816145,0.0439338305991831,2562.07337808609,720.1397957801819,3227.6721153259277,97644,10581,87063,87063,0,10,11192000.0
11192,11192999,22.030867599114618,38.484570782702434,0.04393369053871077,2562.4056491851807,720.2016608715057,3227.8980102539062,97656,10582,87074,87074,0,10,11193000.0
11193,11193999,22.030699092781237,38.484492363175264,0.043932423366303874,2562.7356476783752,720.2630188465118,3228.028854370117,97663,10583,87080,87080,0,10,11194000.0
11194,11194999,22.030705327583206,38.484361280088365,0.04392758831764543,2563.0761744976044,720.3244998455048,3228.2739181518555,97665,10584,87081,87081,0,10,11195000.0
11195,11195999,22.030630384527353,38.484034370796316,0.04392811032258759,2563.400225162506,720.3849132061005,3228.457622528076,97677,10585,87092,87092,0,10,11196000.0
11196,11196999,22.03060164864833,38.48406253477266,0.043924986123722864,2563.7244646549225,720.4462847709656,3228.5966415405273,97689,10586,87103,87103,0,10,11197000.0
11197,11197999,22.030662330356808,38.48397505262938,0.04392302667466397,2563.839403629303,720.5061383247375,3228.9050331115723,97689,10586,87103,87103,0,10,11198000.0
11198,11198999,22.030701972018882,38.483696790491535,0.04392089888323847,2564.170213699341,720.5676941871643,3229.1222229003906,97700,10587,87113,87113,0,10,11199000.0
11199,11199999,22.03079827358463,38.48339798610889,0.043916504770553644,2564.5066561698914,720.629588842392,3229.3302688598633,97712,10588,87124,87124,0,10,11200000.0
11200,11200999,22.03100977723007,38.48327982058109,0.043913842606954634,2564.830565214157,720.6898515224457,3229.522045135498,97724,10589,87135,87135,0,10,11201000.0
11201,11201999,22.031036889667273,38.48284544303086,0.04391180529739902,2565.584447145462,720.750687122345,3229.5874404907227,97764,10592,87172,87172,0,10,11202000.0
11202,11202999,22.031243180246868,38.48263569571011,0.04390840862988321,2565.919102668762,720.8121778964996,3229.86763381958,97776,10593,87183,87183,0,10,11203000.0
11203,11203999,22.031345917426954,38.48236709653059,0.04390627591161056,2566.462338447571,720.873594045639,3230.1257553100586,97795,10595,87200,87200,0,10,11204000.0
11204,11204999,22.031026939623022,38.48229016634123,0.043904562296604666,2566.8107397556305,720.935732126236,3231.525188446045,97798,10596,87202,87202,0,10,11205000.0
11205,11205999,22.030325693834165,38.481524562399336,0.04390432077151163,2567.135797739029,720.9970786571503,3232.059902191162,97807,10597,87210,87210,0,10,11206000.0
11206,11206999,22.029615486868124,38.48038291256393,0.04390687577749308,2567.2578315734863,721.0593836307526,3232.4970321655273,97807,10597,87210,87210,0,10,11207000.0
11207,11207999,22.0289806290991,38.47942505746873,0.04390802350366774,2567.589035511017,721.1219005584717,3232.834159851074,97809,10598,87211,87211,0,10,11208000.0
11208,11208999,22.028483997912225,38.47862684906923,0.043908501605473105,2568.1256935596466,721.182847738266,3233.0359420776367,97823,10600,87223,87223,0,10,11209000.0
11209,11209999,22.02803332096842,38.47806373278479,0.043911105342245293,2568.2534074783325,721.2439346313477,3233.3170204162598,97823,10600,87223,87223,0,10,11210000.0
11210,11210999,22.027512958674567,38.477045598075925,0.04391056419750661,2568.3685491085052,721.3044145107269,3233.685131072998,97823,10600,87223,87223,0,10,11211000.0
11211,11211999,22.02707005887502,38.476105140728194,0.04390978823373659,2568.48277258873,721.366058588028,3234.071834564209,97823,10600,87223,87223,0,10,11212000.0
11212,11212999,22.026671047144514,38.4751760249228,0.04390925206219398,2568.816108942032,721.4287972450256,3234.2839889526367,97825,10601,87224,87224,0,10,11213000.0
11213,11213999,22.026366433678696,38.4745388237208,0.04390830886687802,2568.9431722164154,721.4999666213989,3234.678134918213,97825,10601,87224,87224,0,10,11214000.0
11214,11214999,22.0259640472005,38.47358651629829,0.04390735578110683,2569.266780614853,721.5607357025146,3234.9500999450684,97827,10602,87225,87225,0,10,11215000.0
11215,11215999,22.02580699413326,38.47323504421629,0.043905835576007135,2569.5981426239014,721.6246716976166,3235.1821517944336,97839,10603,87236,87236,0,10,11216000.0
11216,11216999,22.02563759091041,38.47269156021177,0.043906298506036556,2569.709137201309,721.6850054264069,3235.5901069641113,97839,10603,87236,87236,0,10,11217000.0
11217,11217999,22.025822966955065,38.47314116749226,0.04390529974172064,2569.818844795227,721.7454228401184,3235.9645195007324,97839,10603,87236,87236,0,10,11218000.0
11218,11218999,22.026370787011686,38.474258985681466,0.043915503634143316,2569.934365272522,721.8071210384369,3236.2673568725586,97839,10603,87236,87236,0,10,11219000.0
11219,11219999,22.02733464328347,38.47597104120903,0.04392433772475135,2570.2674672603607,721.8678114414215,3236.5486907958984,97853,10604,87249,87249,0,10,11220000.0
11220,11220999,22.02831347584114,38.477467781604695,0.0439324420338032,2570.3807475566864,721.9290120601654,3236.944793701172,97853,10604,87249,87249,0,10,11221000.0
11221,11221999,22.029239637281158,38.47890125137459,0.043941044601750856,2570.5128750801086,721.99059009552,3237.193717956543,97853,10604,87249,87249,0,10,11222000.0
11222,11222999,22.030789789605,38.48193626199033,0.043957323193989595,2570.8332040309906,722.0510025024414,3237.421100616455,97855,10605,87250,87250,0,10,11223000.0
11223,11223999,22.031882536247323,38.48374393775751,0.04396656110867225,2571.1555864810944,722.1110651493073,3237.684127807617,97869,10606,87263,87263,0,10,11224000.0
11224,11224999,22.032543379271956,38.485153899595744,0.04396951769590618,2571.504772424698,722.1764118671417,3238.626304626465,97882,10607,87275,87275,0,10,11225000.0
11225,11225999,22.031851799779414,38.484020287992756,0.043969253656650054,2572.0508828163147,722.2387936115265,3239.2542419433594,97907,10609,87298,87298,0,10,11226000.0
11226,11226999,22.03143297301503,38.483220006146446,0.04396503034620791,2572.585545539856,722.300511598587,3239.6251525878906,97911,10611,87300,87300,0,10,11227000.0
11227,11227999,22.031064992922712,38.4828338307231,0.0439617078563761,2572.705649614334,722.3616724014282,3239.998836517334,97911,10611,87300,87300,0,10,11228000.0
11228,11228999,22.030589434590013,38.481900031505546,0.04396147995780686,2573.0619304180145,722.4284269809723,3240.2313079833984,97913,10612,87301,87301,0,10,11229000.0
11229,11229999,22.030137550075345,38.4809992367103,0.04396168739226769,2573.394828081131,722.4901595115662,3240.586265563965,97916,10613,87303,87303,0,10,11230000.0
11230,11230999,22.029645924778052,38.48002945084479,0.04396308952694139,2573.9473266601562,722.5519893169403,3240.8192253112793,97940,10615,87325,87325,0,10,11231000.0
11231,11231999,22.02934280474524,38.47961388827189,0.04396307640572217,2574.295559167862,722.6194376945496,3241.1816368103027,97942,10616,87326,87326,0,10,11232000.0
11232,11232999,22.029081406574804,38.47931651186237,0.04396825273289584,2574.4134080410004,722.6805276870728,3241.540138244629,97942,10616,87326,87326,0,10,11233000.0
11233,11233999,22.028951224803432,38.47912743671032,0.04397667391687565,2574.534688949585,722.7427415847778,3241.9080924987793,97942,10616,87326,87326,0,10,11234000.0
11234,11234999,22.02909769002936,38.48039290961842,0.043988670202780744,2575.3024826049805,722.8104867935181,3242.0989723205566,97977,10619,87358,87358,0,10,11235000.0
11235,11235999,22.029395667117807,38.4815210173115,0.04400781218959571,2575.427831888199,722.8711640834808,3242.41796875,97977,10619,87358,87358,0,10,11236000.0
11236,11236999,22.030381937144238,38.48495907979187,0.044032073961693285,2575.5456125736237,722.9322874546051,3242.7801475524902,97980,10619,87361,87361,0,10,11237000.0
11237,11237999,22.03154363202586,38.488522938489,0.04406188936202671,2576.0877063274384,722.9936323165894,3243.072479248047,97994,10621,87373,87373,0,10,11238000.0
11238,11238999,22.03308913449486,38.49372040436434,0.044089085451504695,2576.420137643814,723.0545899868011,3243.315933227539,97997,10622,87375,87375,0,10,11239000.0
11239,11239999,22.035348860061333,38.501923187330746,0.0441541308162674,2576.5652809143066,723.1299531459808,3243.745838165283,98000,10622,87378,87378,0,10,11240000.0
11240,11240999,22.038223088201157,38.513341438226604,0.04422713008661949,2576.8928575515747,723.1931352615356,3244.2631645202637,98014,10623,87391,87391,0,10,11241000.0
11241,11241999,22.040471670653606,38.51947485488098,0.04429098522203545,2577.2296376228333,723.2555677890778,3244.6016273498535,98016,10624,87392,87392,0,10,11242000.0
11242,11242999,22.043100202251203,38.52693412417094,0.04435734991636886,2577.55850315094,723.3175957202911,3244.9216957092285,98018,10625,87393,87393,0,10,11243000.0
11243,11243999,22.045074155743375,38.5321926256835,0.04437548479209652,2578.100912094116,723.379207611084,3245.219413757324,98036,10627,87409,87409,0,10,11244000.0
11244,11244999,22.04474929533665,38.53252183128296,0.04437687114739597,2578.2385478019714,723.4457802772522,3246.2148971557617,98037,10627,87410,87410,0,10,11245000.0
11245,11245999,22.044127414780316,38.532006907016324,0.044380450528915705,2578.358795642853,723.5070474147797,3246.647315979004,98037,10627,87410,87410,0,10,11246000.0
11246,11246999,22.043767905847062,38.53170570924524,0.04438612598314995,2578.6911532878876,723.568859577179,3247.001884460449,98040,10628,87412,87412,0,10,11247000.0
11247,11247999,22.043746397768924,38.53237993776953,0.04438315385344638,2579.0211803913116,723.6313729286194,3247.2508239746094,98042,10629,87413,87413,0,10,11248000.0
11248,11248999,22.04354382074016,38.53219775716229,0.04438343152477131,2579.364103794098,723.6998727321625,3247.5886039733887,98044,10630,87414,87414,0,10,11249000.0
11249,11249999,22.04318968617546,38.53158017099057,0.04438440407260258,2579.490291595459,723.7620947360992,3247.9180297851562,98044,10630,87414,87414,0,10,11250000.0
11250,11250999,22.043127834913104,38.531813721649804,0.0443855280520592,2579.607920885086,723.8235323429108,3248.1924018859863,98044,10630,87414,87414,0,10,11251000.0
11251,11251999,22.04327590333243,38.53226493204795,0.04438556521252113,2579.954432964325,723.8959467411041,3248.4111328125,98046,10631,87415,87415,0,10,11252000.0
11252,11252999,22.04340830848043,38.532816513929056,0.04439137064949106,2580.5115246772766,723.9580936431885,3248.628520965576,98061,10633,87428,87428,0,10,11253000.0
11253,11253999,22.04371232482176,38.53350681630522,0.04439387539177708,2580.635057926178,724.0193078517914,3248.812919616699,98061,10633,87428,87428,0,10,11254000.0
11254,11254999,22.043942578971254,38.533824953077456,0.04440335549085461,2580.967088699341,724.0801932811737,3249.033462524414,98063,10634,87429,87429,0,10,11255000.0
11255,11255999,22.0446003030529,38.53512404018902,0.044405102536749896,2581.2925896644592,724.1410474777222,3249.2707901000977,98075,10635,87440,87440,0,10,11256000.0
11256,11256999,22.045190464922957,38.53663144959177,0.0444069022082737,2581.417500972748,724.2025856971741,3249.459732055664,98075,10635,87440,87440,0,10,11257000.0
11257,11257999,22.045922458196618,38.53798676970935,0.044410692863594003,2581.555248737335,724.2648959159851,3249.750789642334,98075,10635,87440,87440,0,10,11258000.0
11258,11258999,22.04677439270119,38.539334648776816,0.044419704758036915,2582.0988795757294,724.3260924816132,3249.9006309509277,98089,10637,87452,87452,0,10,11259000.0
11259,11259999,22.047582504988753,38.540904559987304,0.044424399604921616,2582.4358336925507,724.3881208896637,3250.119228363037,98091,10638,87453,87453,0,10,11260000.0
11260,11260999,22.04855362848558,38.54321814869232,0.0444251102502492,2582.56610250473,724.4499061107635,3250.4569396972656,98091,10638,87453,87453,0,10,11261000.0
11261,11261999,22.049376261420402,38.544542342836,0.044427302228194576,2583.114037513733,724.5116231441498,3250.6261024475098,98095,10640,87455,87455,0,10,11262000.0
11262,11262999,22.049920526158004,38.545128328636146,0.04442717502812776,2583.4578354358673,724.5753946304321,3250.7887992858887,98097,10641,87456,87456,0,10,11263000.0
11263,11263999,22.05017316195423,38.54575960365885,0.044430447063505296,2583.575672149658,724.635552406311,3251.05269241333,98097,10641,87456,87456,0,10,11264000.0
11264,11264999,22.04980390978199,38.54503112118682,0.04442987538705612,2583.9015078544617,724.6969926357269,3251.677703857422,98128,10642,87486,87486,0,10,11265000.0
11265,11265999,22.049118277033326,38.54437171641711,0.04443089184511251,2584.020451784134,724.7589523792267,3252.028160095215,98128,10642,87486,87486,0,10,11266000.0
11266,11266999,22.04864027818805,38.54397974611995,0.04443210561018829,2584.133108139038,724.819783449173,3252.2626953125,98128,10642,87486,87486,0,10,11267000.0
11267,11267999,22.04817466804704,38.54378138996637,0.04443067875378004,2584.2526907920837,724.8828613758087,3252.4719619750977,98128,10642,87486,87486,0,10,11268000.0
11268,11268999,22.047704042217813,38.54323337257787,0.04442896873517588,2584.5865495204926,724.9436736106873,3252.635265350342,98157,10643,87514,87514,0,10,11269000.0
11269,11269999,22.047187374121535,38.54245660888092,0.04442915471436881,2584.9420144557953,725.00528383255,3252.8750534057617,98160,10644,87516,87516,0,10,11270000.0
11270,11270999,22.0466905660978,38.54157393751672,0.044427830904081866,2585.2952349185944,725.0739407539368,3253.0725326538086,98163,10645,87518,87518,0,10,11271000.0
11271,11271999,22.046333618576927,38.54145704447921,0.04442422454018269,2585.8374490737915,725.1351847648621,3253.1730880737305,98167,10647,87520,87520,0,10,11272000.0
11272,11272999,22.04590617228776,38.54099660481129,0.0444220827885099,2586.178657054901,725.1962223052979,3253.3207626342773,98174,10648,87526,87526,0,10,11273000.0
11273,11273999,22.045493571488382,38.54030068658989,0.044421738426461466,2586.305488586426,725.2586736679077,3253.6235847473145,98174,10648,87526,87526,0,10,11274000.0
11274,11274999,22.045088742163045,38.539634955131575,0.04442004988250203,2586.66046333313,725.3308389186859,3253.8044815063477,98176,10649,87527,87527,0,10,11275000.0
11275,11275999,22.044804135060453,38.538944114240074,0.04441739469060679,2586.9971463680267,725.3927159309387,3254.012969970703,98178,10650,87528,87528,0,10,11276000.0
11276,11276999,22.04473488430742,38.538750353938326,0.0444130177777704,2587.3223950862885,725.4534420967102,3254.2127799987793,98180,10651,87529,87529,0,10,11277000.0
11277,11277999,22.044893233259717,38.53990514922846,0.044407898592483175,2587.446051120758,725.5137450695038,3254.359664916992,98180,10651,87529,87529,0,10,11278000.0
11278,11278999,22.04490689780125,38.53958171810171,0.04440665118205045,2587.5692970752716,725.5739686489105,3254.6241188049316,98180,10651,87529,87529,0,10,11279000.0
11279,11279999,22.044948467305083,38.53914973927089,0.04440155213816055,2588.3219904899597,725.6353809833527,3254.6988105773926,98200,10654,87546,87546,0,10,11280000.0
11280,11280999,22.045113727342663,38.53891100748052,0.0443983224495631,2588.6492874622345,725.6972646713257,3254.893264770508,98202,10655,87547,87547,0,10,11281000.0
11281,11281999,22.045290967690175,38.538848763170456,0.044395778344418435,2589.1937675476074,725.7584989070892,3255.0146408081055,98208,10657,87551,87551,0,10,11282000.0
11282,11282999,22.0455488561525,38.53864312403668,0.044391300812324674,2589.532868385315,725.8192319869995,3255.117015838623,98210,10658,87552,87552,0,10,11283000.0
11283,11283999,22.04565969747843,38.53828948109969,0.04438495236684181,2589.864394426346,725.8798184394836,3255.4625205993652,98226,10659,87567,87567,0,10,11284000.0
11284,11284999,22.04551982883886,38.53755540690828,0.04438215030257686,2589.993509531021,725.9412276744843,3255.6876258850098,98226,10659,87567,87567,0,10,11285000.0
11285,11285999,22.045050479427477,38.53653575351805,0.044376291429150894,2590.1185517311096,726.0032606124878,3256.550563812256,98226,10659,87567,87567,0,10,11286000.0
11286,11286999,22.044616630491124,38.53556123532498,0.04437192937884338,2590.4565913677216,726.0666522979736,3256.894947052002,98229,10660,87569,87569,0,10,11287000.0
11287,11287999,22.044244604054743,38.53465394119163,0.044365870919253925,2590.7889952659607,726.1290123462677,3257.1102294921875,98231,10661,87570,87570,0,10,11288000.0
11288,11288999,22.043989795452703,38.533955313680494,0.044360326322106736,2591.130243062973,726.1909811496735,3257.295192718506,98243,10662,87581,87581,0,10,11289000.0
11289,11289999,22.043768049805113,38.53310508843281,0.04435376543286229,2591.8709399700165,726.2523295879364,3257.477771759033,98278,10665,87613,87613,0,10,11290000.0
11290,11290999,22.043519391313513,38.53219452948611,0.04434571594355996,2591.9931173324585,726.3166224956512,3257.792999267578,98279,10665,87614,87614,0,10,11291000.0
11291,11291999,22.043296801491486,38.53141957007246,0.04433937659118803,2592.5311329364777,726.3778858184814,3257.943000793457,98300,10667,87633,87633,0,10,11292000.0
11292,11292999,22.043165460697605,38.53071890575788,0.04433151455202511,2592.8527023792267,726.4395916461945,3258.0892372131348,98303,10668,87635,87635,0,10,11293000.0
11293,11293999,22.04307764594326,38.530118697151565,0.04432532731690375,2592.989381790161,726.502272605896,3258.3859062194824,98303,10668,87635,87635,0,10,11294000.0
11294,11294999,22.04312333006669,38.52953719098331,0.044317569875749974,2593.529717683792,726.5634534358978,3258.582633972168,98317,10670,87647,87647,0,10,11295000.0
11295,11295999,22.043252063746312,38.53006569304287,0.044307647309972054,2593.642299413681,726.624993801117,3258.824291229248,98317,10670,87647,87647,0,10,11296000.0
11296,11296999,22.043368690078374,38.5295617639308,0.04429845692346823,2603.927697658539,726.6870532035828,3259.0583686828613,98331,10672,87659,87659,0,10,11297000.0
11297,11297999,22.043605301518255,38.52920384145716,0.04428652867692229,2604.055542230606,726.7494871616364,3259.4132080078125,98331,10672,87659,87659,0,10,11298000.0
11298,11298999,22.043908505511848,38.52923726793424,0.04427946855403975,2604.6389269828796,726.8111371994019,3259.5732040405273,98345,10674,87671,87671,0,10,11299000.0
11299,11299999,22.04432105328603,38.52905612720072,0.04426864377147699,2604.9878940582275,726.8732242584229,3259.8033409118652,98347,10675,87672,87672,0,10,11300000.0
11300,11300999,22.044735388575855,38.52887864661996,0.04425515398616753,2605.351588010788,726.934476852417,3259.9512367248535,98363,10676,87687,87687,0,10,11301000.0
11301,11301999,22.045155188362422,38.52865360279149,0.04424097846664887,2605.9232261180878,726.9973027706146,3260.2320823669434,98376,10678,87698,87698,0,10,11302000.0
11302,11302999,22.045509796736507,38.52835504332881,0.0442300535224025,2606.0526762008667,727.0589363574982,3260.6461334228516,98377,10678,87699,87699,0,10,11303000.0
11303,11303999,22.04528876045341,38.527710884114335,0.044223396547441784,2606.1830711364746,727.123067855835,3261.772861480713,98378,10678,87700,87700,0,10,11304000.0
11304,11304999,22.04509998617569,38.52736046038364,0.04421783086334996,2606.7625637054443,727.1863615512848,3262.222843170166,98384,10680,87704,87704,0,10,11305000.0
11305,11305999,22.0448764611962,38.527238264723955,0.044217356080962,2606.8923046588898,727.2496919631958,3262.5940017700195,98385,10680,87705,87705,0,10,11306000.0
11306,11306999,22.044739265377967,38.52681239554349,0.044207028217975175,2607.2399916648865,727.3113906383514,3262.830913543701,98387,10681,87706,87706,0,10,11307000.0
11307,11307999,22.044573518112202,38.5263395781476,0.04420312667522641,2608.0315074920654,727.3763415813446,3263.055335998535,98413,10684,87729,87729,0,10,11308000.0
11308,11308999,22.044462648584915,38.52625387736934,0.044201683484363485,2608.833184480667,727.4433181285858,3263.1995544433594,98439,10687,87752,87752,0,10,11309000.0
11309,11309999,22.044492708622638,38.52666696600791,0.044199386216063896,2608.968313932419,727.5058374404907,3263.571559906006,98439,10687,87752,87752,0,10,11310000.0
11310,11310999,22.04562421242227,38.531760522850284,0.044218615780331594,2609.545441389084,727.5705621242523,3263.7779541015625,98472,10689,87783,87783,0,10,11311000.0
11311,11311999,22.047262285391774,38.537490825305625,0.044250965212837334,2609.896369457245,727.6321563720703,3264.11328125,98480,10690,87790,87790,0,10,11312000.0
11312,11312999,22.049109464616087,38.54325271595989,0.04427817629810882,2610.291720867157,727.6956179141998,3264.391368865967,98493,10691,87802,87802,0,10,11313000.0
11313,11313999,22.05070890629552,38.548245436412536,0.04430542435852314,2610.413763999939,727.7575225830078,3264.6389923095703,98493,10691,87802,87802,0,10,11314000.0
11314,11314999,22.052383793668998,38.5533230999909,0.04433290789782751,2610.5436024665833,727.820234298706,3265.002468109131,98493,10691,87802,87802,0,10,11315000.0
11315,11315999,22.05395219997766,38.557196334289436,0.044364718340092146,2610.8995213508606,727.883339881897,3265.253837585449,98500,10692,87808,87808,0,10,11316000.0
11316,11316999,22.0555931478327,38.560825774483504,0.04438417171074749,2611.7276468276978,727.9468834400177,3265.4649620056152,98529,10695,87834,87834,0,10,11317000.0
11317,11317999,22.057299525301772,38.5643993984198,0.04440392415818384,2611.842854499817,728.0078513622284,3265.794013977051,98529,10695,87834,87834,0,10,11318000.0
11318,11318999,22.05919557176032,38.56823517213997,0.04442733207999616,2611.9644038677216,728.0689618587494,3266.226676940918,98529,10695,87834,87834,0,10,11319000.0
11319,11319999,22.06098126653313,38.57245705928049,0.044447299391233486,2612.7718756198883,728.1321265697479,3266.396671295166,98549,10698,87851,87851,0,10,11320000.0
11320,11320999,22.062748524766498,38.575449403675265,0.04447123457506985,2612.8984060287476,728.1952340602875,3266.7905235290527,98549,10698,87851,87851,0,10,11321000.0
11321,11321999,22.064020733468254,38.57749022393703,0.04448706784107537,2613.689797639847,728.2566621303558,3267.0014991760254,98579,10701,87878,87878,0,10,11322000.0
11322,11322999,22.063947284485867,38.57744828409343,0.04448801582541906,2613.825763463974,728.3188626766205,3268.513526916504,98580,10701,87879,87879,0,10,11323000.0
11323,11323999,22.063424739568624,38.57712236167763,0.04449300778394416,2613.9534237384796,728.3823897838593,3269.158290863037,98580,10701,87879,87879,0,10,11324000.0
11324,11324999,22.063013488693684,38.57691824960932,0.044496567780888396,2614.302769422531,728.4444060325623,3269.584217071533,98592,10702,87890,87890,0,10,11325000.0
11325,11325999,22.06252710810268,38.57604171902564,0.04449876983134282,2614.4294197559357,728.5064814090729,3270.08943939209,98592,10702,87890,87890,0,10,11326000.0
11326,11326999,22.062157816443577,38.57539235762972,0.044497964180383986,2614.5526192188263,728.5707743167877,3270.5249824523926,98592,10702,87890,87890,0,10,11327000.0
11327,11327999,22.06172820813236,38.57463328915877,0.04449949946148046,2614.6714432239532,728.6324360370636,3270.9081382751465,98592,10702,87890,87890,0,10,11328000.0
11328,11328999,22.061366404036768,38.5736912158695,0.04449983869652585,2614.791362285614,728.6950936317444,3271.387496948242,98592,10702,87890,87890,0,10,11329000.0
11329,11329999,22.061342072205232,38.573634377361024,0.04449874774412188,2615.364675283432,728.757495880127,3271.7992057800293,98603,10704,87899,87899,0,10,11330000.0
11330,11330999,22.06118797264607,38.57338388340903,0.04449898916885098,2616.1878638267517,728.8204078674316,3271.9415321350098,98629,10707,87922,87922,0,10,11331000.0
11331,11331999,22.0609396766332,38.572635964433694,0.0444990971883108,2616.526056289673,728.8834512233734,3272.2674827575684,98641,10708,87933,87933,0,10,11332000.0
11332,11332999,22.06086798415061,38.57222298269592,0.04449946821587236,2616.8689711093903,728.9449028968811,3272.613742828369,98643,10709,87934,87934,0,10,11333000.0
11333,11333999,22.060759567783574,38.57180550926675,0.04450021911046198,2617.4423818588257,729.0094051361084,3272.889190673828,98667,10711,87956,87956,0,10,11334000.0
11334,11334999,22.060716535003852,38.571410650556444,0.04450038824722369,2617.7976326942444,729.0712039470673,3273.2705574035645,98679,10712,87967,87967,0,10,11335000.0
11335,11335999,22.060530611050176,38.570674827524826,0.044498998146755064,2617.915138244629,729.1343319416046,3273.673839569092,98679,10712,87967,87967,0,10,11336000.0
11336,11336999,22.060523959354907,38.570164709608065,0.04449866362487298,2618.042411327362,729.1968085765839,3274.030014038086,98679,10712,87967,87967,0,10,11337000.0
11337,11337999,22.060552204848918,38.569693871647246,0.044498251314616155,2618.1723647117615,729.2605125904083,3274.4607543945312,98679,10712,87967,87967,0,10,11338000.0
11338,11338999,22.060732412941373,38.569504160344984,0.04449563704789439,2618.527217388153,729.3228185176849,3274.844654083252,98681,10713,87968,87968,0,10,11339000.0
11339,11339999,22.060881660809216,38.56912146658578,0.04449168865939679,2619.0988399982452,729.3858695030212,3275.0570640563965,98695,10715,87980,87980,0,10,11340000.0
11340,11340999,22.060936007512343,38.568686593723584,0.04449006998107097,2619.2212131023407,729.4483425617218,3275.3879890441895,98695,10715,87980,87980,0,10,11341000.0
11341,11341999,22.061015695733218,38.56842465047727,0.044487383006351466,2619.5633461475372,729.5096125602722,3275.7428131103516,98707,10716,87991,87991,0,10,11342000.0
11342,11342999,22.06090610582186,38.56775441486275,0.04448298703161391,2619.9182679653168,729.5707926750183,3276.260841369629,98720,10717,88003,88003,0,10,11343000.0
11343,11343999,22.06091307117854,38.56730497552807,0.044451384894843016,2620.4891760349274,729.633504152298,3277.228702545166,98737,10719,88018,88018,0,10,11344000.0
11344,11344999,22.060846436478236,38.566979435712696,0.04442441852951229,2621.072079896927,729.6968109607697,3277.74617767334,98751,10721,88030,88030,0,10,11345000.0
11345,11345999,22.06085602458627,38.56680994637899,0.04439776844156651,2621.1966643333435,729.7612845897675,3278.1502113342285,98751,10721,88030,88030,0,10,11346000.0
11346,11346999,22.060952440580156,38.56669078317356,0.044370479958367515,2621.5402734279633,729.8238391876221,3278.5065155029297,98763,10722,88041,88041,0,10,11347000.0
11347,11347999,22.061002021520622,38.56799852628678,0.044356790071252594,2621.6613788604736,729.8877055644989,3278.901168823242,98763,10722,88041,88041,0,10,11348000.0
11348,11348999,22.060922701494064,38.56745362092266,0.04433757950500017,2622.2376828193665,729.9510688781738,3279.256996154785,98777,10724,88053,88053,0,10,11349000.0
11349,11349999,22.06090004043655,38.56693626145871,0.044316443043442844,2622.5968854427338,730.0161299705505,3279.4999351501465,98784,10725,88059,88059,0,10,11350000.0
11350,11350999,22.06091080547606,38.566532013109004,0.04429627418136306,2622.9445605278015,730.0776989459991,3279.8058013916016,98796,10726,88070,88070,0,10,11351000.0
11351,11351999,22.060944849118307,38.56599667278647,0.044278653191213935,2623.062804222107,730.1384513378143,3280.1457595825195,98796,10726,88070,88070,0,10,11352000.0
11352,11352999,22.06103009825402,38.56544083898712,0.04426160496391607,2623.1939702033997,730.2003266811371,3280.424861907959,98796,10726,88070,88070,0,10,11353000.0
11353,11353999,22.06123196842328,38.56498904696217,0.04423920669730608,2623.316145181656,730.2627279758453,3280.8025398254395,98798,10726,88072,88072,0,10,11354000.0
11354,11354999,22.061594723030137,38.56521962372536,0.04422033970753303,2623.4432566165924,730.3267064094543,3281.1655082702637,98798,10726,88072,88072,0,10,11355000.0
11355,11355999,22.062013140517397,38.56522599750697,0.04419943399126902,2623.5646276474,730.3886685371399,3281.4156761169434,98798,10726,88072,88072,0,10,11356000.0
11356,11356999,22.062463301642595,38.565070570262776,0.044186882813277095,2623.9131577014923,730.449704170227,3281.653408050537,98810,10727,88083,88083,0,10,11357000.0
11357,11357999,22.063326327692277,38.56572626262499,0.04417780136476801,2624.694706916809,730.513001203537,3281.8311080932617,98826,10730,88096,88096,0,10,11358000.0
11358,11358999,22.06426811091077,38.566353494470164,0.04417018134885908,2625.0358085632324,730.5743088722229,3282.137233734131,98838,10731,88107,88107,0,10,11359000.0
11359,11359999,22.06507194302301,38.56670992813341,0.044163246668045386,2625.382203578949,730.636727809906,3282.4530143737793,98850,10732,88118,88118,0,10,11360000.0
11360,11360999,22.065852586018995,38.56713099448021,0.04416117971712863,2625.735726594925,730.698714017868,3282.749454498291,98852,10733,88119,88119,0,10,11361000.0
11361,11361999,22.066874366367784,38.56789541346575,0.04416328557537208,2626.089018344879,730.7606699466705,3283.081645965576,98854,10734,88120,88120,0,10,11362000.0
11362,11362999,22.06773248930525,38.56837953485159,0.0441677126544372,2626.432494878769,730.8230793476105,3283.3317375183105,98866,10735,88131,88131,0,10,11363000.0
11363,11363999,22.067785221886616,38.56823065716124,0.04416368781075253,2626.7946031093597,730.8861932754517,3284.413303375244,98877,10736,88141,88141,0,10,11364000.0
11364,11364999,22.067365039653467,38.567897689749124,0.04415998770296381,2627.1403906345367,730.9516081809998,3284.88143157959,98884,10737,88147,88147,0,10,11365000.0
11365,11365999,22.06717711861903,38.56773483398992,0.04414939758546066,2627.2661895751953,731.015207529068,3285.2663230895996,98885,10737,88148,88148,0,10,11366000.0
11366,11366999,22.06695221936087,38.56707352601558,0.044141978137987814,2627.6215267181396,731.0806658267975,3285.6104011535645,98887,10738,88149,88149,0,10,11367000.0
11367,11367999,22.066736356017746,38.56644506528525,0.04413458806322479,2627.9645574092865,731.1432225704193,3285.8779830932617,98898,10739,88159,88159,0,10,11368000.0
11368,11368999,22.066378586874453,38.56544619164342,0.04412791930410387,2628.310291528702,731.2059209346771,3286.168212890625,98900,10740,88160,88160,0,10,11369000.0
11369,11369999,22.066084909499047,38.564718535493476,0.044123269987423774,2629.1001567840576,731.269761800766,3286.3104362487793,98921,10743,88178,88178,0,10,11370000.0
11370,11370999,22.065809495817025,38.56383852442351,0.044118026301472324,2629.2279722690582,731.3322012424469,3286.6965942382812,98921,10743,88178,88178,0,10,11371000.0
11371,11371999,22.065574621716568,38.56453563052678,0.04411097560136723,2629.5726408958435,731.3941295146942,3286.92333984375,98923,10744,88179,88179,0,10,11372000.0
11372,11372999,22.06536899328317,38.56432592401141,0.04410784904701892,2629.9131643772125,731.4548618793488,3287.1181983947754,98934,10745,88189,88189,0,10,11373000.0
11373,11373999,22.06514347289934,38.56361594145905,0.044103896571421775,2630.042994260788,731.5167577266693,3287.414207458496,98934,10745,88189,88189,0,10,11374000.0
11374,11374999,22.06515039405071,38.56377668863813,0.044102232219611404,2630.3867552280426,731.5804834365845,3287.5991973876953,98936,10746,88190,88190,0,10,11375000.0
11375,11375999,22.065159990542117,38.56517461170173,0.04409630367366191,2630.5116946697235,731.6429688930511,3287.9525413513184,98936,10746,88190,88190,0,10,11376000.0
11376,11376999,22.065202013261583,38.564802916065645,0.04409120139081135,2630.648209810257,731.705593585968,3288.268970489502,98936,10746,88190,88190,0,10,11377000.0
11377,11377999,22.065243801208933,38.564255959221164,0.04408944995510666,2630.7758836746216,731.7676372528076,3288.569969177246,98936,10746,88190,88190,0,10,11378000.0
11378,11378999,22.06538024293868,38.5640866610922,0.044091636918216826,2631.3444452285767,731.8306901454926,3288.8202018737793,98954,10748,88206,88206,0,10,11379000.0
11379,11379999,22.065860644348668,38.56556226406871,0.04409370611340058,2631.6910214424133,731.8951234817505,3289.2151641845703,98965,10749,88216,88216,0,10,11380000.0
11380,11380999,22.06615012453222,38.565389829802164,0.04409733954836137,2632.0487294197083,731.9583208560944,3289.452217102051,98967,10750,88217,88217,0,10,11381000.0
11381,11381999,22.066340530529803,38.565190829193114,0.04410535340971855,2632.173051595688,732.0204694271088,3289.773063659668,98967,10750,88217,88217,0,10,11382000.0
11382,11382999,22.066618737108442,38.56507688050152,0.04410663113677593,2632.292777776718,732.082109451294,3290.026679992676,98967,10750,88217,88217,0,10,11383000.0
11383,11383999,22.06668060586869,38.56471889095788,0.04410684661130848,2632.4147522449493,732.1433897018433,3290.298080444336,98968,10750,88218,88218,0,10,11384000.0
11384,11384999,22.066078589225548,38.56498250575736,0.04410427040812348,2632.769005537033,732.2056531906128,3290.8579750061035,98976,10751,88225,88225,0,10,11385000.0
11385,11385999,22.06540046640024,38.56405850182669,0.044103573402476726,2633.5427901744843,732.2684462070465,3291.068347930908,98992,10754,88238,88238,0,10,11386000.0
11386,11386999,22.06493528684514,38.56352116737024,0.044103203193442075,2634.113229036331,732.3309617042542,3291.206195831299,99004,10756,88248,88248,0,10,11387000.0
11387,11387999,22.064624883910398,38.56334627203619,0.044099090318312606,2634.2394318580627,732.3924086093903,3291.455020904541,99004,10756,88248,88248,0,10,11388000.0
11388,11388999,22.064204784705566,38.56242051701901,0.04409554595340237,2634.372752904892,732.4542758464813,3291.6542434692383,99004,10756,88248,88248,0,10,11389000.0
11389,11389999,22.063731060533406,38.56141882879206,0.044093040035744324,2634.7211191654205,732.516654253006,3291.7949028015137,99014,10757,88257,88257,0,10,11390000.0
11390,11390999,22.063359928516793,38.56055612472667,0.04408983322266102,2635.0621523857117,732.578516960144,3291.9261207580566,99016,10758,88258,88258,0,10,11391000.0
11391,11391999,22.06302837601334,38.559722517621886,0.04408696367341969,2635.404206752777,732.6419081687927,3292.041572570801,99018,10759,88259,88259,0,10,11392000.0
11392,11392999,22.062961304542274,38.559706507383474,0.04408618631097849,2635.5331687927246,732.7037441730499,3292.21834564209,99019,10759,88260,88260,0,10,11393000.0
11393,11393999,22.06311766053292,38.55995156193155,0.04409531230937247,2635.6718802452087,732.7655718326569,3292.4468269348145,99020,10759,88261,88261,0,10,11394000.0
11394,11394999,22.063474620051757,38.5603158425261,0.04410195259847094,2635.79599404335,732.8273322582245,3292.7714653015137,99021,10759,88262,88262,0,10,11395000.0
11395,11395999,22.064292903235934,38.5614370431437,0.04412498952564914,2636.140193939209,732.8885798454285,3292.929126739502,99028,10760,88268,88268,0,10,11396000.0
11396,11396999,22.06549408326387,38.564466193987535,0.044137230286716456,2636.904345035553,732.9512660503387,3292.96630859375,99053,10763,88290,88290,0,10,11397000.0
11397,11397999,22.067289700907427,38.56795209947471,0.044166386708572536,2637.252637386322,733.0132513046265,3293.1934547424316,99060,10764,88296,88296,0,10,11398000.0
11398,11398999,22.068969056703228,38.57156433742179,0.04417932351905329,2637.5966036319733,733.07524061203,3293.270290374756,99076,10765,88311,88311,0,10,11399000.0
11399,11399999,22.070855927476558,38.5757994287511,0.044198658364732024,2638.141212940216,733.1373128890991,3293.371597290039,99084,10767,88317,88317,0,10,11400000.0
11400,11400999,22.072890725665694,38.579692760523216,0.04422685023251827,2638.2728147506714,733.1986138820648,3293.6050872802734,99084,10767,88317,88317,0,10,11401000.0
11401,11401999,22.07470520503249,38.58343784129845,0.04423945719639222,2638.6410360336304,733.269246339798,3293.7114181518555,99089,10768,88321,88321,0,10,11402000.0
11402,11402999,22.076418458559704,38.58651258993938,0.0442523695975543,2638.985112428665,733.3309206962585,3293.8497581481934,99096,10769,88327,88327,0,10,11403000.0
11403,11403999,22.0779132862477,38.58924403209425,0.04426811434286482,2639.527415752411,733.3915429115295,3293.98136138916,99108,10771,88337,88337,0,10,11404000.0
11404,11404999,22.078474796971044,38.590068101715225,0.04426737151876303,2639.679473400116,733.4611279964447,3295.0473289489746,99109,10771,88338,88338,0,10,11405000.0
11405,11405999,22.078259576805202,38.5902976431398,0.04425966802836867,2639.802657365799,733.523894071579,3295.9839210510254,99111,10771,88340,88340,0,10,11406000.0
11406,11406999,22.07812425197546,38.589946202832756,0.044250640455246626,2640.3897104263306,733.5994884967804,3296.572292327881,99125,10773,88352,88352,0,10,11407000.0
11407,11407999,22.078080005913147,38.58977075206705,0.04423955477930541,2640.5227224826813,733.6619527339935,3297.147590637207,99127,10773,88354,88354,0,10,11408000.0
11408,11408999,22.07788256097878,38.58917990207267,0.04423358450219861,2640.878974914551,733.7268977165222,3297.540412902832,99129,10774,88355,88355,0,10,11409000.0
11409,11409999,22.07757424421581,38.58848205943535,0.044229311470403654,2641.6720349788666,733.7920033931732,3297.879871368408,99136,10777,88359,88359,0,10,11410000.0
11410,11410999,22.07742647742762,38.58818481321858,0.04422198225956808,2642.217463493347,733.853711605072,3298.2528343200684,99158,10779,88379,88379,0,10,11411000.0
11411,11411999,22.077232456623413,38.58756501962168,0.04421381406161673,2642.3404767513275,733.9187366962433,3298.7443656921387,99160,10779,88381,88381,0,10,11412000.0
11412,11412999,22.07714250566701,38.58740765253488,0.04420850479644867,2642.4686563014984,733.9804816246033,3299.1261444091797,99161,10779,88382,88382,0,10,11413000.0
11413,11413999,22.07700230292352,38.58706043102263,0.04420425714127163,2642.5975198745728,734.0422132015228,3299.4753074645996,99162,10779,88383,88383,0,10,11414000.0
11414,11414999,22.076941451722604,38.58664922178771,0.044200300258727454,2642.937872171402,734.1032500267029,3299.7935791015625,99175,10780,88395,88395,0,10,11415000.0
11415,11415999,22.076937715363268,38.58625841213786,0.04419362796591164,2643.05543589592,734.1637659072876,3300.164318084717,99175,10780,88395,88395,0,10,11416000.0
11416,11416999,22.077060614419572,38.5862575348359,0.04418694965266734,2643.40123462677,734.2255058288574,3300.5996742248535,99182,10781,88401,88401,0,10,11417000.0
11417,11417999,22.07719254413611,38.585969575531244,0.04418349401839905,2643.738219022751,734.2890977859497,3300.821533203125,99184,10782,88402,88402,0,10,11418000.0
11418,11418999,22.077370695380118,38.58600950517413,0.044177989173848076,2643.8630805015564,734.350132226944,3301.250045776367,99184,10782,88402,88402,0,10,11419000.0
11419,11419999,22.077648803652668,38.58592865262879,0.044171540733701,2643.9813482761383,734.4133203029633,3301.609230041504,99184,10782,88402,88402,0,10,11420000.0
11420,11420999,22.078086300729982,38.58594826480079,0.04415784864112304,2644.328464269638,734.4753339290619,3301.933349609375,99186,10783,88403,88403,0,10,11421000.0
11421,11421999,22.078248656658364,38.58557944289766,0.044151725528979946,2644.67045879364,734.5360903739929,3302.285717010498,99189,10784,88405,88405,0,10,11422000.0
11422,11422999,22.078553950958714,38.5853207838629,0.04414768970788019,2644.7855751514435,734.5974178314209,3302.65047454834,99189,10784,88405,88405,0,10,11423000.0
11423,11423999,22.078909882579467,38.58503060626043,0.044141595084982166,2644.9011042118073,734.6589953899384,3303.201259613037,99190,10784,88406,88406,0,10,11424000.0
11424,11424999,22.078993786764958,38.584568125362445,0.044139310433880086,2645.0293147563934,734.7195432186127,3303.5457344055176,99190,10784,88406,88406,0,10,11425000.0
11425,11425999,22.078466897131317,38.583676122211585,0.04413919413883971,2645.3730249404907,734.7813332080841,3304.916759490967,99203,10785,88418,88418,0,10,11426000.0
11426,11426999,22.07791558889522,38.58291030224761,0.04413921727972858,2645.491344690323,734.8435482978821,3305.7332801818848,99203,10785,88418,88418,0,10,11427000.0
11427,11427999,22.077524281229486,38.583004031496394,0.044135211108936256,2645.825979232788,734.9058709144592,3306.2265243530273,99211,10786,88425,88425,0,10,11428000.0
11428,11428999,22.077093406649894,38.5820920143798,0.044134489830906176,2646.158855676651,734.9667348861694,3306.6398315429688,99223,10787,88436,88436,0,10,11429000.0
11429,11429999,22.076999233949525,38.58212417430495,0.0441331225663788,2646.4984197616577,735.0275356769562,3307.031711578369,99225,10788,88437,88437,0,10,11430000.0
11430,11430999,22.076911150126083,38.582492070239205,0.044127954420252746,2647.044309616089,735.0885436534882,3307.492820739746,99243,10790,88453,88453,0,10,11431000.0
11431,11431999,22.077522545864607,38.58512925891753,0.04411520360883492,2647.3747203350067,735.1515884399414,3307.9002990722656,99252,10791,88461,88461,0,10,11432000.0
11432,11432999,22.07846884135253,38.58892405349172,0.04410655996333823,2647.926384449005,735.2124841213226,3308.1306648254395,99267,10793,88474,88474,0,10,11433000.0
11433,11433999,22.079268623771448,38.59187215569379,0.04409845122736078,2648.267962694168,735.2752001285553,3308.5665893554688,99278,10794,88484,88484,0,10,11434000.0
11434,11434999,22.08016872619602,38.594916326952976,0.044093209867872796,2648.822827577591,735.3375930786133,3308.922939300537,99302,10796,88506,88506,0,10,11435000.0
11435,11435999,22.080935141685657,38.59711975782276,0.04409162973330538,2649.1522886753082,735.3982937335968,3309.2317962646484,99314,10797,88517,88517,0,10,11436000.0
11436,11436999,22.081677678590218,38.59919155458125,0.04409378936766395,2649.2733719348907,735.4584195613861,3309.6643447875977,99314,10797,88517,88517,0,10,11437000.0
11437,11437999,22.082521895087876,38.60117948310913,0.04409352221546392,2649.605302095413,735.5199694633484,3310.080146789551,99321,10798,88523,88523,0,10,11438000.0
11438,11438999,22.08348163797301,38.603641073519945,0.04409482338457249,2649.730045557022,735.5811786651611,3310.6028366088867,99321,10798,88523,88523,0,10,11439000.0
11439,11439999,22.084443269317294,38.60514227226674,0.044094149839278285,2650.272439956665,735.6417126655579,3310.94291305542,99325,10800,88525,88525,0,10,11440000.0
11440,11440999,22.08536675877932,38.60654043807834,0.04409699659652799,2650.3900904655457,735.702986240387,3311.3553771972656,99325,10800,88525,88525,0,10,11441000.0
11441,11441999,22.086120390776188,38.60753103856239,0.04410444434677874,2650.942384958267,735.7644546031952,3311.695281982422,99339,10802,88537,88537,0,10,11442000.0
11442,11442999,22.08656454899,38.60800032998809,0.044102918056645346,2651.2856998443604,735.8251488208771,3312.5155639648438,99351,10803,88548,88548,0,10,11443000.0
11443,11443999,22.08601928134357,38.607028127909636,0.04410011766548361,2651.6202986240387,735.8870241641998,3313.2274169921875,99355,10804,88551,88551,0,10,11444000.0
11444,11444999,22.085582240986778,38.606268957116164,0.04410065722069845,2651.7361028194427,735.948536157608,3313.75577545166,99355,10804,88551,88551,0,10,11445000.0
11445,11445999,22.085201203101537,38.60546747706188,0.04409648948705103,2652.2822115421295,736.0100166797638,3314.0450439453125,99372,10806,88566,88566,0,10,11446000.0
11446,11446999,22.084707799834284,38.60446665510082,0.044095095178660504,2653.252720594406,736.072411775589,3314.1928520202637,99420,10810,88610,88610,0,10,11447000.0
11447,11447999,22.084271215233414,38.60362896421,0.04409415506925385,2653.5923397541046,736.1334300041199,3314.5206451416016,99431,10811,88620,88620,0,10,11448000.0
11448,11448999,22.0839849346056,38.60338736141078,0.04408849006310678,2653.7161614894867,736.1937189102173,3314.8250045776367,99431,10811,88620,88620,0,10,11449000.0
11449,11449999,22.08369404144369,38.60279877433039,0.04408400833771475,2654.053204059601,736.2557301521301,3315.1264572143555,99450,10812,88638,88638,0,10,11450000.0
11450,11450999,22.083462877977794,38.60271883690272,0.044082592138745214,2654.399308681488,736.3183083534241,3315.3807945251465,99462,10813,88649,88649,0,10,11451000.0
11451,11451999,22.083252731468754,38.60240444890971,0.044077802679403644,2654.957277059555,736.380687713623,3315.570972442627,99470,10815,88655,88655,0,10,11452000.0
11452,11452999,22.08314120426224,38.6019663503612,0.044073140811722644,2655.5111939907074,736.4432015419006,3315.8783073425293,99484,10817,88667,88667,0,10,11453000.0
11453,11453999,22.083192647220088,38.6024101171505,0.044066825482157124,2655.6283237934113,736.5037994384766,3316.2666816711426,99485,10817,88668,88668,0,10,11454000.0
11454,11454999,22.08341267673146,38.602400245723246,0.04406701183598283,2655.7512526512146,736.565158367157,3316.5707054138184,99485,10817,88668,88668,0,10,11455000.0
11455,11455999,22.0836502876314,38.602247446699,0.04406750679351934,2656.5100116729736,736.6259803771973,3316.8176879882812,99521,10820,88701,88701,0,10,11456000.0
11456,11456999,22.083841003730814,38.60195415032484,0.0440643068079436,2656.626622438431,736.6882848739624,3317.2479095458984,99521,10820,88701,88701,0,10,11457000.0
11457,11457999,22.08416462089838,38.60208755972944,0.044061235257538245,2656.9844694137573,736.7495198249817,3317.57027053833,99535,10821,88714,88714,0,10,11458000.0
11458,11458999,22.084521844077543,38.60213607331692,0.04405792618400428,2657.1002056598663,736.8119494915009,3317.9280738830566,99535,10821,88714,88714,0,10,11459000.0
11459,11459999,22.085197415267313,38.602449059391134,0.044051268877024596,2657.437766313553,736.8731956481934,3318.276393890381,99537,10822,88715,88715,0,10,11460000.0
11460,11460999,22.085627495692425,38.602351418424696,0.04403922965586171,2657.7672464847565,736.9348680973053,3318.683059692383,99539,10823,88716,88716,0,10,11461000.0
11461,11461999,22.085841416381168,38.60227223135063,0.044030155900052326,2658.528458595276,736.9961040019989,3318.8714485168457,99560,10826,88734,88734,0,10,11462000.0
11462,11462999,22.085538270572645,38.601897641315574,0.044028050176012856,2658.6494245529175,737.056928396225,3319.7905807495117,99561,10826,88735,88735,0,10,11463000.0
11463,11463999,22.08505958336225,38.6017563302527,0.04402975385390129,2659.206618785858,737.1182577610016,3320.23099899292,99567,10828,88739,88739,0,10,11464000.0
11464,11464999,22.084870926618645,38.60181055631286,0.04403422314059313,2659.5436928272247,737.1798675060272,3320.6888580322266,99573,10829,88744,88744,0,10,11465000.0
11465,11465999,22.085160036664547,38.6028315321096,0.04403574510148445,2659.6669223308563,737.2409691810608,3321.1120376586914,99573,10829,88744,88744,0,10,11466000.0
11466,11466999,22.085588059561125,38.60466886410778,0.04403316106635713,2659.7867505550385,737.3013069629669,3321.4390258789062,99573,10829,88744,88744,0,10,11467000.0
11467,11467999,22.08607456942066,38.60632181656957,0.04403350935152517,2660.1264595985413,737.3638668060303,3321.686103820801,99575,10830,88745,88745,0,10,11468000.0
11468,11468999,22.08681159003742,38.608704417548815,0.044032065496751205,2660.459509372711,737.4240591526031,3321.994026184082,99587,10831,88756,88756,0,10,11469000.0
11469,11469999,22.087247214803455,38.61007946793653,0.04402828037295037,2660.5883917808533,737.4841201305389,3322.346035003662,99587,10831,88756,88756,0,10,11470000.0
11470,11470999,22.087890921794347,38.611866433118564,0.04402836004299593,2660.912437915802,737.544056892395,3322.537456512451,99599,10832,88767,88767,0,10,11471000.0
11471,11471999,22.088291483661468,38.61315587246361,0.04402666636527597,2661.4570786952972,737.6049511432648,3322.793170928955,99613,10834,88779,88779,0,10,11472000.0
11472,11472999,22.0891336028768,38.61546280445806,0.0440244602437222,2661.7902026176453,737.6663262844086,3323.167106628418,99615,10835,88780,88780,0,10,11473000.0
11473,11473999,22.08963647138644,38.6161597210425,0.04402399977702187,2662.134485721588,737.7274160385132,3323.4492149353027,99617,10836,88781,88781,0,10,11474000.0
11474,11474999,22.090080776210186,38.61835269230511,0.04401996433938915,2662.2567369937897,737.78986120224,3323.7954139709473,99617,10836,88781,88781,0,10,11475000.0
11475,11475999,22.09051455269228,38.61944434169592,0.04401807992073736,2662.805026292801,737.8508594036102,3324.093563079834,99644,10838,88806,88806,0,10,11476000.0
11476,11476999,22.090988381548147,38.62054336948117,0.044018362183226856,2663.1356167793274,737.911235332489,3324.455898284912,99656,10839,88817,88817,0,10,11477000.0
11477,11477999,22.091665151294322,38.62230266158405,0.04402621093513037,2663.7091965675354,737.9729807376862,3324.704086303711,99661,10841,88820,88820,0,10,11478000.0
11478,11478999,22.0921747541822,38.623144226777804,0.04403172409517209,2664.267524957657,738.0344924926758,3325.138946533203,99685,10843,88842,88842,0,10,11479000.0
11479,11479999,22.093020118865667,38.62597618272441,0.04403877074865448,2664.5995168685913,738.0965204238892,3325.5374069213867,99717,10844,88873,88873,0,10,11480000.0
11480,11480999,22.094221872525242,38.62953401530187,0.044049570182119746,2664.9279503822327,738.156923532486,3325.8539085388184,99729,10845,88884,88884,0,10,11481000.0
11481,11481999,22.09495927950173,38.63110858524204,0.044054225966631666,2665.685836315155,738.2184493541718,3325.970645904541,99755,10848,88907,88907,0,10,11482000.0
11482,11482999,22.09523664650371,38.63299791774475,0.04404406239334446,2665.816474199295,738.2803118228912,3326.952751159668,99757,10848,88909,88909,0,10,11483000.0
11483,11483999,22.0953337794104,38.6342624181715,0.044039914978299066,2665.934587240219,738.3427803516388,3327.497283935547,99757,10848,88909,88909,0,10,11484000.0
11484,11484999,22.09530732093847,38.63456462981962,0.04404497493279802,2666.054421186447,738.403281211853,3327.9156227111816,99757,10848,88909,88909,0,10,11485000.0
11485,11485999,22.095517384373824,38.635530867826425,0.04404041693640692,2666.1715881824493,738.464403629303,3328.3533325195312,99757,10848,88909,88909,0,10,11486000.0
11486,11486999,22.09573012831781,38.636598067852255,0.044035166929361824,2666.2939109802246,738.5256187915802,3328.712417602539,99757,10848,88909,88909,0,10,11487000.0
11487,11487999,22.095660704370356,38.63609600443554,0.044033234876655114,2666.629414319992,738.5878915786743,3328.9829025268555,99759,10849,88910,88910,0,10,11488000.0
11488,11488999,22.0957452402044,38.63591090998591,0.04403304874479286,2666.969512939453,738.6485457420349,3329.3466148376465,99764,10850,88914,88914,0,10,11489000.0
11489,11489999,22.09568294931862,38.63549648361372,0.04403000978164984,2667.0938246250153,738.7104544639587,3329.668655395508,99764,10850,88914,88914,0,10,11490000.0
11490,11490999,22.09552895730704,38.634844285496115,0.044028756528275204,2667.214574575424,738.7717177867889,3329.980495452881,99764,10850,88914,88914,0,10,11491000.0
11491,11491999,22.095570857077355,38.6347217845167,0.04402433433558883,2667.760105609894,738.8335046768188,3330.0803833007812,99778,10852,88926,88926,0,10,11492000.0
11492,11492999,22.095543976841313,38.634229169930634,0.04402078226406714,2668.309510231018,738.894275188446,3330.3997497558594,99794,10854,88940,88940,0,10,11493000.0
11493,11493999,22.09562008335568,38.63395636833674,0.044020360585099616,2668.6548812389374,738.9614593982697,3330.7399368286133,99806,10855,88951,88951,0,10,11494000.0
11494,11494999,22.095784111642473,38.633767453327536,0.04401837838592426,2668.764781475067,739.0212643146515,3331.0018348693848,99806,10855,88951,88951,0,10,11495000.0
11495,11495999,22.09590721368015,38.6334812605556,0.044018958708860856,2668.881388902664,739.0830380916595,3331.3202056884766,99806,10855,88951,88951,0,10,11496000.0
11496,11496999,22.09614383711024,38.63340506743323,0.04401615041130835,2669.222095966339,739.1432054042816,3331.549575805664,99818,10856,88962,88962,0,10,11497000.0
11497,11497999,22.096392499960537,38.63318600788722,0.044012234170729525,2669.3324389457703,739.2027785778046,3331.825183868408,99818,10856,88962,88962,0,10,11498000.0
11498,11498999,22.096649602800554,38.63377157495899,0.04400384668154966,2669.667534828186,739.2628049850464,3332.0225868225098,99830,10857,88973,88973,0,10,11499000.0
11499,11499999,22.096943516132285,38.63350017012398,0.04399804621113068,2670.000556707382,739.3240163326263,3332.405818939209,99837,10858,88979,88979,0,10,11500000.0
11500,11500999,22.09715426303946,38.63302874699237,0.04399287765206217,2670.1140551567078,739.3838634490967,3332.77693939209,99837,10858,88979,88979,0,10,11501000.0
11501,11501999,22.09740163675029,38.632891172488925,0.04398936566030531,2670.440728664398,739.4436092376709,3332.959545135498,99839,10859,88980,88980,0,10,11502000.0
11502,11502999,22.09695957913293,38.6319685089527,0.04397759357952802,2670.5763454437256,739.5044581890106,3333.805595397949,99840,10859,88981,88981,0,10,11503000.0
11503,11503999,22.096372285440573,38.63093114361052,0.04397658468351795,2670.694881916046,739.5652856826782,3334.1650161743164,99841,10859,88982,88982,0,10,11504000.0
11504,11504999,22.09591260352818,38.6300081861353,0.043971658833061644,2671.2373929023743,739.627283334732,3334.3528633117676,99845,10861,88984,88984,0,10,11505000.0
11505,11505999,22.095468341773604,38.628958242712145,0.04396773034448531,2671.5748245716095,739.6896748542786,3334.7193336486816,99853,10862,88991,88991,0,10,11506000.0
11506,11506999,22.09509244840567,38.628089280748,0.043964938642310436,2672.3335857391357,739.7507724761963,3334.879779815674,99872,10865,89007,89007,0,10,11507000.0
11507,11507999,22.09470408122834,38.62702151221929,0.043960669728798085,2672.916623353958,739.8143725395203,3335.0545654296875,99878,10867,89011,89011,0,10,11508000.0
11508,11508999,22.09449445004654,38.62674273114165,0.043952873820709004,2673.0399539470673,739.8753287792206,3335.4105224609375,99878,10867,89011,89011,0,10,11509000.0
11509,11509999,22.094158748806066,38.625698959264604,0.04394967151085194,2673.166561603546,739.9354946613312,3335.651824951172,99878,10867,89011,89011,0,10,11510000.0
11510,11510999,22.09382861015731,38.624736810098,0.04394772840606953,2673.501466989517,739.9971606731415,3335.802932739258,99894,10868,89026,89026,0,10,11511000.0
11511,11511999,22.093695413134117,38.624130867281806,0.043943369667097665,2673.832642555237,740.0581710338593,3335.9981994628906,99896,10869,89027,89027,0,10,11512000.0
11512,11512999,22.093694717898256,38.623887171553754,0.043942248820628915,2673.956262111664,740.1198761463165,3336.3514671325684,99896,10869,89027,89027,0,10,11513000.0
11513,11513999,22.09374477603226,38.623446335321226,0.04394005132184031,2674.5000932216644,740.1806635856628,3336.471965789795,99900,10871,89029,89029,0,10,11514000.0
11514,11514999,22.09400944798674,38.62367242234246,0.04392331350358314,2674.635464668274,740.2489674091339,3336.714542388916,99900,10871,89029,89029,0,10,11515000.0
11515,11515999,22.094202391602714,38.62369582330983,0.04391342348665361,2674.982001066208,740.3115391731262,3336.8907165527344,99902,10872,89030,89030,0,10,11516000.0
11516,11516999,22.094578662039222,38.62387270913619,0.043904078833413185,2675.1079471111298,740.3716742992401,3337.084285736084,99902,10872,89030,89030,0,10,11517000.0
11517,11517999,22.095078867340522,38.624206433297374,0.0438877898343244,2675.867612361908,740.433717250824,3337.3031997680664,99919,10875,89044,89044,0,10,11518000.0
11518,11518999,22.095697109875427,38.62444286156665,0.04386960687931052,2676.2007145881653,740.4942827224731,3337.509204864502,99926,10876,89050,89050,0,10,11519000.0
11519,11519999,22.09633382884979,38.62488462554227,0.04386328790010263,2676.7529842853546,740.5560171604156,3337.6677169799805,99948,10878,89070,89070,0,10,11520000.0
11520,11520999,22.096897710669886,38.625146700284894,0.04386487259272742,2677.093784570694,740.6193902492523,3337.836326599121,99953,10879,89074,89074,0,10,11521000.0
11521,11521999,22.097392338102196,38.62540053057333,0.04386669566851864,2677.207984685898,740.6813156604767,3338.212375640869,99953,10879,89074,89074,0,10,11522000.0
11522,11522999,22.097231503735525,38.624744631666495,0.04386788903281491,2677.5530745983124,740.7417345046997,3338.837631225586,99984,10880,89104,89104,0,10,11523000.0
11523,11523999,22.09665839926669,38.62385964086119,0.04386531302873353,2677.895199775696,740.8043115139008,3339.385509490967,99987,10881,89106,89106,0,10,11524000.0
11524,11524999,22.096116167712804,38.62292128474886,0.04386398670055314,2678.2248079776764,740.866949558258,3339.8119316101074,99989,10882,89107,89107,0,10,11525000.0
11525,11525999,22.095590768424625,38.62209961954333,0.043863643878948144,2678.7755682468414,740.9283061027527,3340.12837600708,100004,10884,89120,89120,0,10,11526000.0
11526,11526999,22.095137692190885,38.62103873638012,0.04386326397153861,2679.54057598114,740.990960597992,3340.1820106506348,100035,10887,89148,89148,0,10,11527000.0
11527,11527999,22.09467176873675,38.61991614309198,0.043860181438203694,2679.876492500305,741.0528540611267,3340.413776397705,100047,10888,89159,89159,0,10,11528000.0
11528,11528999,22.09431316055141,38.619599572203505,0.04385889371441565,2680.219878435135,741.1156883239746,3340.686347961426,100049,10889,89160,89160,0,10,11529000.0
11529,11529999,22.093934504281034,38.618600287083204,0.04385619824482179,2680.771993160248,741.1767604351044,3340.8936500549316,100056,10891,89165,89165,0,10,11530000.0
11530,11530999,22.09358380806714,38.61776104910355,0.043855657333003784,2681.3254494667053,741.2385740280151,3341.0904808044434,100070,10893,89177,89177,0,10,11531000.0
11531,11531999,22.09332988045066,38.61701477204098,0.04385212363162605,2681.878024816513,741.2995266914368,3341.255771636963,100094,10895,89199,89199,0,10,11532000.0
11532,11532999,22.09346437490083,38.617206948647414,0.04385044450075781,2682.0009965896606,741.359888792038,3341.4555854797363,100094,10895,89199,89199,0,10,11533000.0
11533,11533999,22.093890055272176,38.618784933571014,0.043846365550089805,2682.1290340423584,741.4211871623993,3341.767833709717,100094,10895,89199,89199,0,10,11534000.0
11534,11534999,22.094525988403127,38.61924383639003,0.043847589559087075,2682.4643857479095,741.4828236103058,3342.0550575256348,100096,10896,89200,89200,0,10,11535000.0
11535,11535999,22.095008580729687,38.61980124867806,0.04385610186903233,2682.800580739975,741.5432593822479,3342.2418327331543,100103,10897,89206,89206,0,10,11536000.0
11536,11536999,22.096085738202472,38.621864764043586,0.04386307264512679,2683.150685787201,741.6048536300659,3342.553756713867,100105,10898,89207,89207,0,10,11537000.0
11537,11537999,22.096909869880644,38.62292243396156,0.043870048767590375,2683.2623150348663,741.6649038791656,3342.9792556762695,100106,10898,89208,89208,0,10,11538000.0
11538,11538999,22.098188303528357,38.62497669925478,0.043880969529785596,2683.3942239284515,741.7263071537018,3343.3909301757812,100106,10898,89208,89208,0,10,11539000.0
11539,11539999,22.09926265763657,38.62658133246086,0.04389285999342629,2683.9392437934875,741.7870078086853,3343.578113555908,100136,10900,89236,89236,0,10,11540000.0
11540,11540999,22.100663090388117,38.62928204885354,0.043913172121376354,2684.063700437546,741.848236322403,3344.065128326416,100136,10900,89236,89236,0,10,11541000.0
11541,11541999,22.102359032166497,38.63216142450978,0.04393642315447488,2684.1807663440704,741.9097330570221,3344.5467948913574,100137,10900,89237,89237,0,10,11542000.0
11542,11542999,22.10370902653514,38.634260314250284,0.0439487818523282,2684.2980892658234,741.9719893932343,3344.8445014953613,100137,10900,89237,89237,0,10,11543000.0
11543,11543999,22.103572675766998,38.63421546820868,0.04393943050948679,2684.4307293891907,742.0337710380554,3346.1520385742188,100137,10900,89237,89237,0,10,11544000.0
11544,11544999,22.10301528037192,38.6334056074503,0.043937607625727404,2685.2017090320587,742.0970952510834,3346.716541290283,100150,10903,89247,89247,0,10,11545000.0
11545,11545999,22.10266953909425,38.632759534823684,0.04393117725208562,2685.5583012104034,742.1675128936768,3347.086238861084,100152,10904,89248,89248,0,10,11546000.0
11546,11546999,22.10238115107496,38.63212462853866,0.04392756653770724,2685.6809763908386,742.2297215461731,3347.5051307678223,100152,10904,89248,89248,0,10,11547000.0
11547,11547999,22.102177885949985,38.63153126242948,0.043922153694226584,2686.014677286148,742.2920815944672,3347.752960205078,100164,10905,89259,89259,0,10,11548000.0
11548,11548999,22.1018396979503,38.63072009056513,0.04391882918291401,2686.3433668613434,742.3538632392883,3348.0293731689453,100166,10906,89260,89260,0,10,11549000.0
11549,11549999,22.101683428906963,38.630128403260755,0.04391312164592309,2686.6756525039673,742.4155144691467,3348.436233520508,100178,10907,89271,89271,0,10,11550000.0
11550,11550999,22.101470611758636,38.62945572824996,0.04391079921599528,2686.788817167282,742.4767966270447,3348.8274879455566,100178,10907,89271,89271,0,10,11551000.0
11551,11551999,22.1013374595558,38.62911175101264,0.04390929315468706,2687.1303102970123,742.5386991500854,3349.0964736938477,100191,10908,89283,89283,0,10,11552000.0
11552,11552999,22.101324808860006,38.62903438306016,0.04390721058971625,2687.2525067329407,742.599684715271,3349.4833335876465,100191,10908,89283,89283,0,10,11553000.0
11553,11553999,22.10147810038851,38.62914642927257,0.04390802121354642,2688.016667366028,742.662478685379,3349.757579803467,100217,10911,89306,89306,0,10,11554000.0
11554,11554999,22.101918015717462,38.63003758703328,0.04391522272273507,2688.136338710785,742.7248396873474,3350.057430267334,100217,10911,89306,89306,0,10,11555000.0
11555,11555999,22.10217124023142,38.63011943941096,0.043924464567028254,2688.471661567688,742.7863762378693,3350.4327278137207,100219,10912,89307,89307,0,10,11556000.0
11556,11556999,22.102683459245068,38.630997872406645,0.04392556878971443,2688.8073654174805,742.8466076850891,3350.838466644287,100231,10913,89318,89318,0,10,11557000.0
11557,11557999,22.103108881588497,38.63158560186578,0.04393009764655165,2689.351831436157,742.9085907936096,3351.1604194641113,100246,10915,89331,89331,0,10,11558000.0
11558,11558999,22.103593546067966,38.63183191799279,0.04393268364748504,2689.6894636154175,742.9707591533661,3351.475944519043,100258,10916,89342,89342,0,10,11559000.0
11559,11559999,22.104161882259458,38.63293502475867,0.04394235784591327,2689.8084874153137,743.0327455997467,3351.9400939941406,100258,10916,89342,89342,0,10,11560000.0
11560,11560999,22.104690373835666,38.63316591204236,0.043943059537046025,2689.9338879585266,743.0957188606262,3352.3144874572754,100258,10916,89342,89342,0,10,11561000.0
11561,11561999,22.10507603923212,38.633142474786546,0.043946848530777016,2690.271326303482,743.1587629318237,3352.561511993408,100270,10917,89353,89353,0,10,11562000.0
11562,11562999,22.105566824660173,38.6334722707081,0.04395005360030724,2690.3860535621643,743.219836473465,3352.976360321045,100270,10917,89353,89353,0,10,11563000.0
11563,11563999,22.105415222949997,38.63269199566553,0.04394748700250328,2690.501087665558,743.2815008163452,3353.5461463928223,100271,10917,89354,89354,0,10,11564000.0
11564,11564999,22.104986446822142,38.63178202473529,0.04393921136738432,2691.0482153892517,743.3446934223175,3354.1713943481445,100283,10919,89364,89364,0,10,11565000.0
11565,11565999,22.104626904707516,38.63108256380876,0.04392944567312951,2691.1675419807434,743.4073917865753,3354.642333984375,100283,10919,89364,89364,0,10,11566000.0
11566,11566999,22.104152106219146,38.63005210235313,0.04392422927951001,2691.7203595638275,743.4701492786407,3354.944625854492,100308,10921,89387,89387,0,10,11567000.0
11567,11567999,22.103923007286507,38.629542827795746,0.04391591450243393,2692.0582480430603,743.5317089557648,3355.1753997802734,100320,10922,89398,89398,0,10,11568000.0
11568,11568999,22.10357819286082,38.62859958840423,0.043910040522179505,2693.0416762828827,743.5938591957092,3355.323516845703,100345,10926,89419,89419,0,10,11569000.0
11569,11569999,22.10323688121519,38.627680730835976,0.04390378606647605,2693.3736941814423,743.6556763648987,3355.6648330688477,100357,10927,89430,89430,0,10,11570000.0
11570,11570999,22.10298531682281,38.62691732205586,0.043899557452105276,2693.931887626648,743.7191388607025,3355.9235649108887,100366,10929,89437,89437,0,10,11571000.0
11571,11571999,22.102832523676764,38.62671982631683,0.043893329257607805,2694.0521347522736,743.7813129425049,3356.2256965637207,100367,10929,89438,89438,0,10,11572000.0
11572,11572999,22.102808960456233,38.62654675639022,0.04388464156613392,2694.626316547394,743.8446428775787,3356.3433837890625,100381,10931,89450,89450,0,10,11573000.0
11573,11573999,22.103002697035905,38.626336778715554,0.04387702158101514,2694.7437081336975,743.9069855213165,3356.7878913879395,100381,10931,89450,89450,0,10,11574000.0
11574,11574999,22.103076704510077,38.627137767502184,0.04386852322790724,2694.8708670139313,743.9687902927399,3357.0552825927734,100382,10931,89451,89451,0,10,11575000.0
11575,11575999,22.10324631389795,38.62677209197091,0.043864513227246826,2694.9924211502075,744.030298948288,3357.279685974121,100382,10931,89451,89451,0,10,11576000.0
11576,11576999,22.103688677536276,38.62676643777561,0.04385333222522092,2695.768837451935,744.0916562080383,3357.4136505126953,100408,10934,89474,89474,0,10,11577000.0
11577,11577999,22.1041357465568,38.626593330924415,0.04383837695538895,2696.1018221378326,744.153698682785,3357.7427864074707,100410,10935,89475,89475,0,10,11578000.0
11578,11578999,22.104772273261723,38.626665873436075,0.04380894678283642,2696.2194759845734,744.2156882286072,3358.110725402832,100410,10935,89475,89475,0,10,11579000.0
11579,11579999,22.105216597478183,38.62667107700302,0.04379029282254665,2696.9969062805176,744.2781655788422,3358.2770652770996,100426,10938,89488,89488,0,10,11580000.0
11580,11580999,22.105466795000513,38.62628678622344,0.04376503995163439,2697.115883588791,744.3403432369232,3358.6277809143066,100426,10938,89488,89488,0,10,11581000.0
11581,11581999,22.105296422387553,38.625496502476764,0.04375523185304042,2697.243124485016,744.4018702507019,3359.3532180786133,100426,10938,89488,89488,0,10,11582000.0
11582,11582999,22.104787189410565,38.62447454117442,0.04374961834513158,2697.5933747291565,744.4647674560547,3359.95170211792,100428,10939,89489,89489,0,10,11583000.0
11583,11583999,22.104564722012203,38.62391423771984,0.04374015132900977,2698.15425658226,744.529913187027,3360.3883171081543,100462,10941,89521,89521,0,10,11584000.0
11584,11584999,22.104228390015393,38.622935180313284,0.04373043940183152,2698.713026046753,744.5934562683105,3360.7608032226562,100469,10943,89526,89526,0,10,11585000.0
11585,11585999,22.103822514897015,38.62199283206387,0.04372817358647929,2698.848354578018,744.6573095321655,3361.2215843200684,100469,10943,89526,89526,0,10,11586000.0
11586,11586999,22.10338193590005,38.620966892030125,0.04372419840373909,2698.974865436554,744.7215392589569,3361.5264282226562,100469,10943,89526,89526,0,10,11587000.0
11587,11587999,22.103065104183454,38.62072776656697,0.04371935607650501,2699.310459136963,744.7841985225677,3361.8665466308594,100481,10944,89537,89537,0,10,11588000.0
11588,11588999,22.10320998098106,38.62172862784646,0.04371738976241146,2699.6525139808655,744.8476490974426,3362.280830383301,100486,10945,89541,89541,0,10,11589000.0
11589,11589999,22.10351408607256,38.62390834267045,0.043732216230312204,2700.208106994629,744.9102594852448,3362.573329925537,100490,10947,89543,89543,0,10,11590000.0
11590,11590999,22.10415310214471,38.626481030513254,0.04375974973607388,2700.5570363998413,744.9745783805847,3362.882598876953,100492,10948,89544,89544,0,10,11591000.0
11591,11591999,22.105160871691243,38.631248430393185,0.04377831185148895,2700.676453113556,745.039792060852,3363.4075088500977,100492,10948,89544,89544,0,10,11592000.0
11592,11592999,22.1061200391159,38.63393458723263,0.0438026556149157,2701.2318789958954,745.1024923324585,3363.7031173706055,100506,10950,89556,89556,0,10,11593000.0
11593,11593999,22.107414855507912,38.63750477736097,0.04382712198996175,2701.3520786762238,745.1665163040161,3363.952121734619,100506,10950,89556,89556,0,10,11594000.0
11594,11594999,22.10880155811478,38.640841279907384,0.04385258936218628,2701.707326889038,745.2310118675232,3364.3494606018066,100517,10951,89566,89566,0,10,11595000.0
11595,11595999,22.110001796271813,38.643102503697634,0.04388418911150016,2702.2588143348694,745.2952065467834,3364.664077758789,100536,10953,89583,89583,0,10,11596000.0
11596,11596999,22.111819736165106,38.64788586647282,0.04392304817350967,2702.60435295105,745.3580090999603,3365.0180435180664,100552,10954,89598,89598,0,10,11597000.0
11597,11597999,22.113179597851637,38.650969652481145,0.04395011918376657,2702.7265214920044,745.4207122325897,3365.2816467285156,100552,10954,89598,89598,0,10,11598000.0
11598,11598999,22.114678785982868,38.65436137024622,0.04397743074307692,2702.8509135246277,745.4824602603912,3365.6950454711914,100552,10954,89598,89598,0,10,11599000.0
11599,11599999,22.116112553386323,38.65748749479887,0.04400631067916827,2702.9735531806946,745.544427394867,3366.080894470215,100552,10954,89598,89598,0,10,11600000.0
11600,11600999,22.116821848317603,38.65874064435994,0.04401061131002981,2703.0901021957397,745.6059937477112,3366.8145713806152,100554,10954,89600,89600,0,10,11601000.0
11601,11601999,22.11607666740074,38.657957750559824,0.04401348186828968,2703.21865773201,745.6693835258484,3367.561721801758,100555,10954,89601,89601,0,10,11602000.0
11602,11602999,22.115401096791828,38.65742582089435,0.04401548219506268,2703.5630509853363,745.7319431304932,3368.005718231201,100557,10955,89602,89602,0,10,11603000.0
11603,11603999,22.114929680170672,38.65707549939322,0.0440149131640758,2703.918443441391,745.7964742183685,3368.4034423828125,100569,10956,89613,89613,0,10,11604000.0
11604,11604999,22.114718754452184,38.65805444593851,0.04401136016462048,2704.033321619034,745.8588311672211,3368.765033721924,100569,10956,89613,89613,0,10,11605000.0
11605,11605999,22.11470965896426,38.65909826845592,0.044011363822344385,2704.594253063202,745.9237232208252,3368.991874694824,100578,10958,89620,89620,0,10,11606000.0
11606,11606999,22.114920102023664,38.66109705019305,0.04401368553854479,2704.7108285427094,745.9868040084839,3369.3795127868652,100579,10958,89621,89621,0,10,11607000.0
11607,11607999,22.11558865024979,38.66467479351605,0.04401657254728575,2705.2678911685944,746.0497624874115,3369.5539016723633,100596,10960,89636,89636,0,10,11608000.0
11608,11608999,22.116520760943228,38.66877752617044,0.04401738372048514,2705.82004070282,746.1138126850128,3369.8897552490234,100620,10962,89658,89658,0,10,11609000.0
11609,11609999,22.11744899596078,38.672465234382464,0.04402000968207609,2706.1536042690277,746.1764843463898,3370.1512908935547,100622,10963,89659,89659,0,10,11610000.0
11610,11610999,22.118347278610056,38.67586051917987,0.044030359805187214,2706.711460351944,746.2393083572388,3370.298641204834,100650,10965,89685,89685,0,10,11611000.0
11611,11611999,22.119036983622514,38.678214137927164,0.04404096395718782,2706.8384354114532,746.3023610115051,3370.70841217041,100650,10965,89685,89685,0,10,11612000.0
11612,11612999,22.119905598356656,38.68104272568928,0.04403901556293999,2707.406648159027,746.3665733337402,3370.9775581359863,100677,10967,89710,89710,0,10,11613000.0
11613,11613999,22.120667320275416,38.683194974303944,0.04404170104267102,2707.528583049774,746.4294555187225,3371.409854888916,100678,10967,89711,89711,0,10,11614000.0
11614,11614999,22.121397651936142,38.68479646306949,0.0440396106724269,2708.1036806106567,746.4926173686981,3371.770782470703,100692,10969,89723,89723,0,10,11615000.0
11615,11615999,22.122181427859022,38.68605795559467,0.044047548637696554,2708.440133333206,746.5550026893616,3372.1014709472656,100704,10970,89734,89734,0,10,11616000.0
11616,11616999,22.123015036668786,38.687538466750254,0.04405390389784147,2708.9956634044647,746.6163649559021,3372.4872093200684,100720,10972,89748,89748,0,10,11617000.0
11617,11617999,22.12379093009249,38.6893779649,0.0440544255005384,2709.118350505829,746.6813337802887,3372.787887573242,100720,10972,89748,89748,0,10,11618000.0
11618,11618999,22.12444360617635,38.690137831863275,0.04406034931015257,2709.472193956375,746.745760679245,3373.101490020752,100722,10973,89749,89749,0,10,11619000.0
11619,11619999,22.124968679026978,38.69067023269879,0.04406504602037675,2709.811301469803,746.8095593452454,3373.375659942627,100729,10974,89755,89755,0,10,11620000.0
11620,11620999,22.125118065643097,38.69058085039797,0.04406232725467485,2709.9296972751617,746.8711004257202,3373.900680541992,100729,10974,89755,89755,0,10,11621000.0
11621,11621999,22.12446750762707,38.68985806502147,0.044060820258654765,2710.0534904003143,746.9341003894806,3374.8050422668457,100730,10974,89756,89756,0,10,11622000.0
11622,11622999,22.12370549724827,38.68880770720131,0.04406313251232863,2710.392297744751,746.9979658126831,3375.254051208496,100732,10975,89757,89757,0,10,11623000.0
11623,11623999,22.12309449172909,38.68786638706681,0.04406229625277258,2710.513874053955,747.0604665279388,3375.6062355041504,100732,10975,89757,89757,0,10,11624000.0
11624,11624999,22.122655363389025,38.68741452738621,0.04405896199325876,2710.6394798755646,747.122879743576,3375.9410667419434,100732,10975,89757,89757,0,10,11625000.0
11625,11625999,22.122157354283758,38.686578185605725,0.0440562693806994,2710.759260416031,747.1848349571228,3376.2566146850586,100732,10975,89757,89757,0,10,11626000.0
11626,11626999,22.121681864280117,38.68573980191915,0.044054413512238266,2710.8782794475555,747.2468240261078,3376.6341819763184,100732,10975,89757,89757,0,10,11627000.0
11627,11627999,22.121196996328305,38.684858581600814,0.04405282431614266,2710.994725227356,747.3095247745514,3376.9698638916016,100732,10975,89757,89757,0,10,11628000.0
11628,11628999,22.12075828472955,38.68417098691029,0.04405067088715131,2711.551244497299,747.3716459274292,3377.1800422668457,100746,10977,89769,89769,0,10,11629000.0
11629,11629999,22.120426944702064,38.683437697203466,0.04404861699413354,2711.8853690624237,747.4337599277496,3377.424514770508,100748,10978,89770,89770,0,10,11630000.0
11630,11630999,22.12024298190863,38.68312500520065,0.04404570164486432,2712.0046606063843,747.4953784942627,3377.656562805176,100748,10978,89770,89770,0,10,11631000.0
11631,11631999,22.12013358013321,38.68291085077004,0.04404004916659554,2712.1259524822235,747.5570864677429,3378.038547515869,100748,10978,89770,89770,0,10,11632000.0
11632,11632999,22.119957437997538,38.682425782660175,0.04403712104027624,2712.2540254592896,747.6193716526031,3378.3875579833984,100748,10978,89770,89770,0,10,11633000.0
11633,11633999,22.11969665440725,38.68173933822291,0.04403703535691983,2712.3662798404694,747.6810245513916,3378.61922454834,100748,10978,89770,89770,0,10,11634000.0
11634,11634999,22.119860270303203,38.681640402907206,0.04402862760473225,2712.481302499771,747.7431778907776,3378.943313598633,100748,10978,89770,89770,0,10,11635000.0
11635,11635999,22.12004247469368,38.68151345490123,0.04401850019881526,2713.0448503494263,747.8050353527069,3379.1319274902344,100767,10980,89787,89787,0,10,11636000.0
11636,11636999,22.1202160223222,38.68115252878991,0.044006696161245085,2713.1621294021606,747.8666441440582,3379.4809799194336,100768,10980,89788,89788,0,10,11637000.0
11637,11637999,22.12059613278352,38.68143348228094,0.04399329750344183,2713.9736161231995,747.9300198554993,3379.553783416748,100789,10983,89806,89806,0,10,11638000.0
11638,11638999,22.120944452551992,38.68178178055127,0.043976938545930655,2714.322234392166,747.9921057224274,3379.874599456787,100791,10984,89807,89807,0,10,11639000.0
11639,11639999,22.12128917982619,38.68157214629733,0.0439610820529307,2714.6517808437347,748.0551552772522,3380.2290229797363,100803,10985,89818,89818,0,10,11640000.0
11640,11640999,22.12156305270404,38.68112352595497,0.04394126472065962,2714.98197388649,748.1165175437927,3380.477252960205,100805,10986,89819,89819,0,10,11641000.0
11641,11641999,22.12097922286642,38.68002387393609,0.04394108403946728,2715.1053869724274,748.1782715320587,3381.3626251220703,100806,10986,89820,89820,0,10,11642000.0
11642,11642999,22.120247854919405,38.678992734839355,0.043941984296323566,2715.227983236313,748.2403044700623,3381.7703437805176,100806,10986,89820,89820,0,10,11643000.0
11643,11643999,22.11959605572414,38.67790671639954,0.043943895230553975,2715.5698668956757,748.3035674095154,3382.1232948303223,100818,10987,89831,89831,0,10,11644000.0
11644,11644999,22.119000259185473,38.676971451575966,0.043942755217207696,2715.6883165836334,748.3653819561005,3382.3897018432617,100818,10987,89831,89831,0,10,11645000.0
11645,11645999,22.118328810501563,38.67585685692339,0.043943272115708365,2716.459559202194,748.4282217025757,3382.456775665283,100834,10990,89844,89844,0,10,11646000.0
11646,11646999,22.117796014266823,38.674812641354386,0.04394411180989366,2717.238091945648,748.4910416603088,3382.5112648010254,100862,10993,89869,89869,0,10,11647000.0
11647,11647999,22.117312712447156,38.674269376774106,0.04394369110275287,2717.5754935741425,748.5538322925568,3382.6405334472656,100869,10994,89875,89875,0,10,11648000.0
11648,11648999,22.116898778884263,38.67381791782705,0.043942659688577135,2717.694323539734,748.615757226944,3383.0093994140625,100869,10994,89875,89875,0,10,11649000.0
11649,11649999,22.11655844307095,38.67327875562226,0.0439393255600804,2718.03440785408,748.6793377399445,3383.2557334899902,100871,10995,89876,89876,0,10,11650000.0
11650,11650999,22.11617494537424,38.67243721520245,0.04393895783622448,2718.6064817905426,748.7420680522919,3383.4592933654785,100885,10997,89888,89888,0,10,11651000.0
11651,11651999,22.11581893498426,38.67178823159743,0.043935848197109606,2718.941668510437,748.8040001392365,3383.7152061462402,100899,10998,89901,89901,0,10,11652000.0
11652,11652999,22.11566247531669,38.671178647882165,0.04393071737315257,2719.4961388111115,748.8669328689575,3383.8304595947266,100910,11000,89910,89910,0,10,11653000.0
11653,11653999,22.115635144914908,38.671058819127005,0.04392404419153029,2719.6168808937073,748.9293916225433,3384.103172302246,100910,11000,89910,89910,0,10,11654000.0
11654,11654999,22.115595228970527,38.670591063066084,0.04391425241483282,2719.7355604171753,748.9912416934967,3384.3528747558594,100910,11000,89910,89910,0,10,11655000.0
11655,11655999,22.115802850293715,38.67070128947819,0.043906950515351095,2720.736671447754,749.0554502010345,3384.397243499756,100938,11004,89934,89934,0,10,11656000.0
11656,11656999,22.115980367209982,38.67066274855602,0.04389916289671625,2720.854835510254,749.1172623634338,3384.789665222168,100938,11004,89934,89934,0,10,11657000.0
11657,11657999,22.116118924466406,38.67040015691365,0.04389356434797376,2721.204327583313,749.1794919967651,3385.0377044677734,100950,11005,89945,89945,0,10,11658000.0
11658,11658999,22.11630158866284,38.670121421547414,0.043886201859471896,2721.5419049263,749.2416276931763,3385.2129287719727,100962,11006,89956,89956,0,10,11659000.0
11659,11659999,22.116475715864276,38.66980954445208,0.04387161416426433,2721.8756947517395,749.3033201694489,3385.3674545288086,100977,11007,89970,89970,0,10,11660000.0
11660,11660999,22.1164970495417,38.669431264255955,0.043859993270518594,2721.991933107376,749.3659152984619,3385.650016784668,100977,11007,89970,89970,0,10,11661000.0
11661,11661999,22.116338832010857,38.66872680076312,0.043857061648306384,2722.9810268878937,749.4290323257446,3385.8140983581543,101002,11011,89991,89991,0,10,11662000.0
11662,11662999,22.11571941194717,38.66794975895335,0.04385732542820031,2723.103018760681,749.4921727180481,3386.7890014648438,101002,11011,89991,89991,0,10,11663000.0
11663,11663999,22.115101444556544,38.66716752876907,0.04385914282577652,2723.4456176757812,749.5546102523804,3387.169589996338,101004,11012,89992,89992,0,10,11664000.0
11664,11664999,22.114489785833143,38.666100509581554,0.04386217361536848,2723.7971065044403,749.6188178062439,3387.384380340576,101006,11013,89993,89993,0,10,11665000.0
11665,11665999,22.113956037140444,38.66541530428596,0.04386290121633252,2723.910327196121,749.6803841590881,3387.644256591797,101006,11013,89993,89993,0,10,11666000.0
11666,11666999,22.113502344954217,38.66461306210127,0.043861771253422055,2724.250333070755,749.742484331131,3387.8837928771973,101018,11014,90004,90004,0,10,11667000.0
11667,11667999,22.112979871802146,38.66357255824003,0.04386429008005133,2724.8168902397156,749.8054885864258,3388.0193252563477,101022,11016,90006,90006,0,10,11668000.0
11668,11668999,22.112464967416322,38.662640703789044,0.043865880246445554,2724.9353148937225,749.8669857978821,3388.2767181396484,101022,11016,90006,90006,0,10,11669000.0
11669,11669999,22.11204932657654,38.66184142426578,0.04386698520143417,2725.484240293503,749.9289042949677,3388.4136390686035,101036,11018,90018,90018,0,10,11670000.0
11670,11670999,22.11168117457689,38.66109311095078,0.04386635738076328,2726.042929172516,749.9905309677124,3388.6192016601562,101050,11020,90030,90030,0,10,11671000.0
11671,11671999,22.11161153993005,38.66250465304232,0.04385849919842688,2726.166620492935,750.0518608093262,3388.8364791870117,101050,11020,90030,90030,0,10,11672000.0
11672,11672999,22.111508235599796,38.662447651950124,0.0438537318726655,2726.5113010406494,750.1138219833374,3389.0890769958496,101062,11021,90041,90041,0,10,11673000.0
11673,11673999,22.111456309778333,38.66272674608699,0.04385294273023588,2726.8659479618073,750.176023721695,3389.2389221191406,101074,11022,90052,90052,0,10,11674000.0
11674,11674999,22.1119753503621,38.66550279054154,0.04385391371930514,2727.1977727413177,750.2385330200195,3389.4169731140137,101081,11023,90058,90058,0,10,11675000.0
11675,11675999,22.11306396228715,38.66850273027866,0.04386112029772726,2727.756452322006,750.299412727356,3389.585273742676,101095,11025,90070,90070,0,10,11676000.0
11676,11676999,22.1144151991315,38.674391516208374,0.04387287435871978,2728.3231813907623,750.361732006073,3389.7092475891113,101099,11027,90072,90072,0,10,11677000.0
11677,11677999,22.11584466299229,38.67877166578628,0.04387799585117658,2728.4435484409332,750.4228713512421,3389.9522590637207,101099,11027,90072,90072,0,10,11678000.0
11678,11678999,22.117235761884473,38.682245625224546,0.04388496788317808,2728.5572435855865,750.4829521179199,3390.2720832824707,101100,11027,90073,90073,0,10,11679000.0
11679,11679999,22.118809660649575,38.68686527463805,0.04389605451326861,2728.6761231422424,750.5442523956299,3390.574924468994,101100,11027,90073,90073,0,10,11680000.0
11680,11680999,22.12049387051498,38.69065349848492,0.043911207691401444,2729.2262465953827,750.6062338352203,3390.8160972595215,101116,11029,90087,90087,0,10,11681000.0
11681,11681999,22.12141580246336,38.692156503855095,0.043915423388275365,2729.7800624370575,750.6677877902985,3390.964298248291,101141,11031,90110,90110,0,10,11682000.0
11682,11682999,22.1213417918127,38.69348834571938,0.043914521331962275,2730.336371898651,750.7290906906128,3391.8660583496094,101146,11033,90113,90113,0,10,11683000.0
11683,11683999,22.120748672290045,38.692878836064665,0.04391625444520619,2730.89275431633,750.791139125824,3392.266975402832,101150,11035,90115,90115,0,10,11684000.0
11684,11684999,22.120302126720652,38.692128571461794,0.04392251868986108,2731.0222492218018,750.8525578975677,3392.5627212524414,101151,11035,90116,90116,0,10,11685000.0
11685,11685999,22.120122934310917,38.691829474785685,0.04392663788811113,2731.5772314071655,750.9146394729614,3392.7869033813477,101165,11037,90128,90128,0,10,11686000.0
11686,11686999,22.119976364189842,38.69149647229331,0.043928928094854935,2731.915545463562,750.9755847454071,3393.083652496338,101170,11038,90132,90132,0,10,11687000.0
11687,11687999,22.11987271057905,38.69130151534427,0.04393103899879758,2732.266332626343,751.0369889736176,3393.2901496887207,101172,11039,90133,90133,0,10,11688000.0
11688,11688999,22.119822617348948,38.691116875756684,0.04392951381121479,2732.383683681488,751.1000096797943,3393.649990081787,101172,11039,90133,90133,0,10,11689000.0
11689,11689999,22.119872902282303,38.69122097615575,0.043926754893193865,2732.5076825618744,751.160915851593,3394.0537071228027,101172,11039,90133,90133,0,10,11690000.0
11690,11690999,22.120276389666465,38.6920589216235,0.04392694739405767,2732.634380340576,751.2232174873352,3394.328125,101172,11039,90133,90133,0,10,11691000.0
11691,11691999,22.120486437357464,38.69227227669043,0.04392880248619746,2732.9779963493347,751.2846899032593,3394.578842163086,101179,11040,90139,90139,0,10,11692000.0
11692,11692999,22.12088581935912,38.69276237407224,0.043931140763544985,2733.318431377411,751.3466672897339,3394.833595275879,101191,11041,90150,90150,0,10,11693000.0
11693,11693999,22.121793738276228,38.694795102329486,0.04394302131264971,2733.8741097450256,751.4087035655975,3395.005771636963,101198,11043,90155,90155,0,10,11694000.0
11694,11694999,22.12270953362792,38.69685520473859,0.04395617198101642,2733.995589733124,751.4714891910553,3395.404842376709,101198,11043,90155,90155,0,10,11695000.0
11695,11695999,22.12355385290821,38.69849323971726,0.043970958119483705,2734.3324456214905,751.5332517623901,3395.657112121582,101205,11044,90161,90161,0,10,11696000.0
11696,11696999,22.12463930338191,38.70170844155872,0.04397894189893348,2734.8960473537445,751.594206571579,3395.8896255493164,101215,11046,90169,90169,0,10,11697000.0
11697,11697999,22.125927513396334,38.70558811617555,0.04399227569299302,2735.0092141628265,751.6545367240906,3396.208797454834,101215,11046,90169,90169,0,10,11698000.0
11698,11698999,22.12724187530177,38.70871302490534,0.044002423203585495,2735.133183002472,751.7163410186768,3396.648540496826,101215,11046,90169,90169,0,10,11699000.0
11699,11699999,22.12851331214302,38.71183027869623,0.04401549612628364,2735.6949479579926,751.7787218093872,3396.8898010253906,101229,11048,90181,90181,0,10,11700000.0
11700,11700999,22.129496513330572,38.71325449513973,0.04402879909326807,2736.2455904483795,751.8409180641174,3397.1108016967773,101238,11050,90188,90188,0,10,11701000.0
11701,11701999,22.130190139806842,38.71458352551365,0.04403800656784518,2736.3580780029297,751.9008486270905,3397.3642501831055,101238,11050,90188,90188,0,10,11702000.0
11702,11702999,22.130160399917916,38.7144847667374,0.04403817393354459,2736.9141018390656,751.9628500938416,3398.072120666504,101244,11052,90192,90192,0,10,11703000.0
11703,11703999,22.129830246847483,38.713929368882546,0.0440354674929484,2737.035187482834,752.0254502296448,3398.656967163086,101244,11052,90192,90192,0,10,11704000.0
11704,11704999,22.129608928342286,38.714296718107775,0.04402667841703167,2737.3755390644073,752.0872745513916,3398.946647644043,101256,11053,90203,90203,0,10,11705000.0
11705,11705999,22.1292014082871,38.71339618894994,0.04402627449013308,2737.960925102234,752.1527383327484,3399.0658073425293,101270,11055,90215,90215,0,10,11706000.0
11706,11706999,22.12887488803039,38.71248623923269,0.044022306383231236,2738.334630250931,752.220456123352,3399.3586044311523,101272,11056,90216,90216,0,10,11707000.0
11707,11707999,22.128738100235093,38.71250093259064,0.044015839631256215,2738.671598672867,752.2827990055084,3399.62459564209,101274,11057,90217,90217,0,10,11708000.0
11708,11708999,22.128568048719178,38.7119215775077,0.04400876516618801,2738.793667078018,752.3457601070404,3399.922393798828,101274,11057,90217,90217,0,10,11709000.0
11709,11709999,22.128665635667385,38.71178044867627,0.044007840293659006,2739.13751411438,752.4081001281738,3400.2095108032227,101280,11058,90222,90222,0,10,11710000.0
11710,11710999,22.128899512022834,38.711925788948484,0.04400709813111847,2739.6949515342712,752.4704236984253,3400.425552368164,101301,11060,90241,90241,0,10,11711000.0
11711,11711999,22.129148562777754,38.711830197861175,0.04400549689352673,2740.0346648693085,752.5323448181152,3400.68310546875,101308,11061,90247,90247,0,10,11712000.0
11712,11712999,22.129485402036163,38.711789553747664,0.044002369642289985,2740.1656568050385,752.5943791866302,3400.969539642334,101308,11061,90247,90247,0,10,11713000.0
11713,11713999,22.129874998484695,38.71185992933729,0.043997519979427024,2740.2851989269257,752.6561930179596,3401.3290977478027,101308,11061,90247,90247,0,10,11714000.0
11714,11714999,22.130369778346076,38.71184613682811,0.0439950961195944,2740.622308254242,752.7188098430634,3401.5982513427734,101310,11062,90248,90248,0,10,11715000.0
11715,11715999,22.13073463306186,38.711570762382955,0.043985529034389015,2740.742931842804,752.7804055213928,3401.9176750183105,101310,11062,90248,90248,0,10,11716000.0
11716,11716999,22.131452167212505,38.71281330040976,0.04397105892383468,2740.8806574344635,752.8506546020508,3402.235210418701,101310,11062,90248,90248,0,10,11717000.0
11717,11717999,22.131996999883196,38.712939707899324,0.04395458927505436,2741.213926076889,752.9121389389038,3402.486183166504,101322,11063,90259,90259,0,10,11718000.0
11718,11718999,22.132488256857155,38.712871761297976,0.04394111466911499,2741.549222946167,752.9728643894196,3402.7979431152344,101324,11064,90260,90260,0,10,11719000.0
11719,11719999,22.132728199303905,38.71282018933491,0.04393676043627737,2741.8822145462036,753.0332012176514,3403.0506172180176,101337,11065,90272,90272,0,10,11720000.0
11720,11720999,22.132540203673585,38.71259517696572,0.043925180573640255,2742.460146188736,753.0958461761475,3404.0360794067383,101362,11067,90295,90295,0,10,11721000.0
11721,11721999,22.132423918108397,38.71204749690623,0.043908811830257855,2742.798864841461,753.1578915119171,3404.568817138672,101375,11068,90307,90307,0,10,11722000.0
11722,11722999,22.132372102540455,38.7116805388753,0.043897877833770416,2742.916477918625,753.2200155258179,3405.004196166992,101376,11068,90308,90308,0,10,11723000.0
11723,11723999,22.13220193148945,38.71089219971633,0.043889121248160134,2743.0379304885864,753.2821707725525,3405.2743225097656,101376,11068,90308,90308,0,10,11724000.0
11724,11724999,22.132080065763542,38.71033067066195,0.043881777877067485,2743.160356760025,753.345011472702,3405.6304092407227,101377,11068,90309,90309,0,10,11725000.0
11725,11725999,22.131956466104683,38.70992191171682,0.043872067460865805,2743.285220146179,753.4072759151459,3405.906162261963,101378,11068,90310,90310,0,10,11726000.0
11726,11726999,22.131903799442863,38.709672370495895,0.04386584907789004,2743.404402732849,753.4699046611786,3406.211154937744,101378,11068,90310,90310,0,10,11727000.0
11727,11727999,22.131773571328065,38.709113890731096,0.043856977201473635,2743.5293712615967,753.5313167572021,3406.401336669922,101378,11068,90310,90310,0,10,11728000.0
11728,11728999,22.131645921758842,38.708394921483475,0.04385034006461319,2743.868355035782,753.5932123661041,3406.6461067199707,101390,11069,90321,90321,0,10,11729000.0
11729,11729999,22.131673751017942,38.70811612062527,0.043844831168831755,2744.2141478061676,753.6553637981415,3406.850788116455,101392,11070,90322,90322,0,10,11730000.0
11730,11730999,22.131808855522387,38.70827065815366,0.04383657883784475,2744.3280663490295,753.7163896560669,3407.0637435913086,101392,11070,90322,90322,0,10,11731000.0
11731,11731999,22.131750644655302,38.70762001343952,0.04382785627800723,2744.4578428268433,753.7784423828125,3407.351016998291,101392,11070,90322,90322,0,10,11732000.0
11732,11732999,22.13184859576992,38.707157002853364,0.04382006835299401,2744.5866611003876,753.8393080234528,3407.6371459960938,101392,11070,90322,90322,0,10,11733000.0
11733,11733999,22.13191207169336,38.706542561268755,0.04381205056517268,2744.941625356674,753.9102833271027,3407.7884063720703,101404,11071,90333,90333,0,10,11734000.0
11734,11734999,22.13229862474453,38.706536300068606,0.043800735520270084,2745.279745578766,753.9726800918579,3407.9883575439453,101416,11072,90344,90344,0,10,11735000.0
11735,11735999,22.13253320604197,38.70614385651298,0.04378972839595163,2745.422972202301,754.0477175712585,3408.3819847106934,101416,11072,90344,90344,0,10,11736000.0
11736,11736999,22.13283546281642,38.70749774782027,0.043776049843701315,2745.757659673691,754.110869884491,3408.62984085083,101428,11073,90355,90355,0,10,11737000.0
11737,11737999,22.133015549160156,38.707047398894254,0.04375981169346255,2745.8777685165405,754.1731843948364,3408.7960815429688,101428,11073,90355,90355,0,10,11738000.0
11738,11738999,22.133176896531026,38.70664844668264,0.04374665877633821,2746.2135121822357,754.2353336811066,3409.043785095215,101430,11074,90356,90356,0,10,11739000.0
11739,11739999,22.132946557920217,38.70577280283828,0.043740653325775036,2747.4590198993683,754.2997217178345,3409.3677673339844,101464,11079,90385,90385,0,10,11740000.0
11740,11740999,22.132285463996315,38.705085548745416,0.043741040827982136,2747.80411362648,754.3635160923004,3409.8992042541504,101477,11080,90397,90397,0,10,11741000.0
11741,11741999,22.131602717793267,38.7040122710795,0.043743500704376936,2748.3878886699677,754.4272170066833,3410.290096282959,101499,11082,90417,90417,0,10,11742000.0
11742,11742999,22.131171274217643,38.70346338058838,0.043742301069856215,2748.7491042613983,754.4937143325806,3410.6797828674316,101501,11083,90418,90418,0,10,11743000.0
11743,11743999,22.130779238458818,38.70309491679286,0.04374113961190618,2749.326382637024,754.5577628612518,3410.9113960266113,101506,11085,90421,90421,0,10,11744000.0
11744,11744999,22.130403847222773,38.70221280857125,0.04374029557130932,2749.4522004127502,754.6199707984924,3411.233612060547,101506,11085,90421,90421,0,10,11745000.0
11745,11745999,22.129954467082758,38.70127811993749,0.04374119619888006,2749.581199645996,754.6837427616119,3411.535327911377,101506,11085,90421,90421,0,10,11746000.0
11746,11746999,22.129745678001026,38.70078245301606,0.04373946956616004,2749.7113840579987,754.7459423542023,3411.7562217712402,101506,11085,90421,90421,0,10,11747000.0
11747,11747999,22.129459104667475,38.699995144146136,0.043738339386840686,2750.0439541339874,754.8071315288544,3411.9915504455566,101518,11086,90432,90432,0,10,11748000.0
11748,11748999,22.129244138306774,38.69927537700387,0.043737645650376744,2750.3838827610016,754.8681614398956,3412.20792388916,101522,11087,90435,90435,0,10,11749000.0
11749,11749999,22.128983639989066,38.69859639730971,0.04373686584815062,2750.5040724277496,754.9293518066406,3412.4163818359375,101522,11087,90435,90435,0,10,11750000.0
11750,11750999,22.12886637341788,38.69820066898624,0.043735496844607424,2751.0815460681915,754.9924943447113,3412.6281204223633,101541,11089,90452,90452,0,10,11751000.0
11751,11751999,22.128776044213318,38.69770588013587,0.043733967415221175,2751.2289917469025,755.0691237449646,3412.9091453552246,101541,11089,90452,90452,0,10,11752000.0
11752,11752999,22.12869626709416,38.6972295843256,0.04373383982816936,2751.354700088501,755.1305804252625,3413.154853820801,101541,11089,90452,90452,0,10,11753000.0
11753,11753999,22.12863444780634,38.696582970730276,0.043730454862394796,2751.491376399994,755.1929979324341,3413.4569091796875,101541,11089,90452,90452,0,10,11754000.0
11754,11754999,22.128631991582292,38.69609200586895,0.043727589057532934,2751.836870908737,755.2551848888397,3413.6753273010254,101548,11090,90458,90458,0,10,11755000.0
11755,11755999,22.128590516453187,38.69551436533696,0.04372170020182098,2751.9709615707397,755.3176069259644,3413.9464111328125,101548,11090,90458,90458,0,10,11756000.0
11756,11756999,22.12879551485786,38.69547493847219,0.04371240284588551,2752.3099553585052,755.3796091079712,3414.182159423828,101560,11091,90469,90469,0,10,11757000.0
11757,11757999,22.12875493385011,38.694759853745815,0.04370779522015367,2752.4372732639313,755.4419991970062,3414.5383834838867,101560,11091,90469,90469,0,10,11758000.0
11758,11758999,22.128654975737124,38.69394617559987,0.043701687588713956,2752.780072450638,755.5031354427338,3414.841728210449,101562,11092,90470,90470,0,10,11759000.0
11759,11759999,22.12848491990057,38.693344435734026,0.04369953020678963,2752.8942494392395,755.5658128261566,3415.1493644714355,101562,11092,90470,90470,0,10,11760000.0
11760,11760999,22.12803470059743,38.69236371773676,0.04369515113174438,2753.0224299430847,755.6289129257202,3416.0779037475586,101563,11092,90471,90471,0,10,11761000.0
11761,11761999,22.127681132151558,38.692256626690856,0.04368429115700545,2753.3625235557556,755.6917450428009,3416.6890182495117,101567,11093,90474,90474,0,10,11762000.0
11762,11762999,22.127193114132034,38.69126108457937,0.04367828552714992,2753.7055191993713,755.7549700737,3417.1328163146973,101580,11094,90486,90486,0,10,11763000.0
11763,11763999,22.12686830860063,38.6909681492868,0.04367288424260429,2753.8248212337494,755.8186910152435,3417.7064323425293,101581,11094,90487,90487,0,10,11764000.0
11764,11764999,22.126550021138637,38.69015576491793,0.04366637623805525,2754.3973746299744,755.8822791576385,3418.0093421936035,101590,11096,90494,90494,0,10,11765000.0
11765,11765999,22.12634003513325,38.68922386473443,0.04366032003531184,2754.520047187805,755.9450061321259,3418.387798309326,101590,11096,90494,90494,0,10,11766000.0
11766,11766999,22.126197366968395,38.68841912405316,0.04365212183734091,2754.639364719391,756.0072538852692,3418.8874435424805,101591,11096,90495,90495,0,10,11767000.0
11767,11767999,22.126061233053864,38.68762626650675,0.04364471578960227,2754.7596440315247,756.0694296360016,3419.365749359131,101592,11096,90496,90496,0,10,11768000.0
11768,11768999,22.126009012961013,38.68707308380217,0.043637261989781906,2755.093540430069,756.1319410800934,3419.764575958252,101604,11097,90507,90507,0,10,11769000.0
11769,11769999,22.126022124204052,38.68684475011177,0.0436261076947102,2755.208266019821,756.1941096782684,3420.1189155578613,101604,11097,90507,90507,0,10,11770000.0
11770,11770999,22.126133608585228,38.68621184710891,0.043609359394671365,2755.3238427639008,756.2565705776215,3420.4976539611816,101604,11097,90507,90507,0,10,11771000.0
11771,11771999,22.126309927170134,38.68568486967071,0.04359569294032528,2755.665098667145,756.3198959827423,3420.832695007324,101616,11098,90518,90518,0,10,11772000.0
11772,11772999,22.126389920361323,38.68504091532918,0.043581193916459204,2755.7892384529114,756.3820366859436,3421.1256408691406,101617,11098,90519,90519,0,10,11773000.0
11773,11773999,22.126687623459983,38.68457267376092,0.04356312398524842,2756.341710329056,756.4441843032837,3421.377788543701,101631,11100,90531,90531,0,10,11774000.0
11774,11774999,22.127079301643388,38.68424993634742,0.04354472521506303,2756.690398454666,756.50670337677,3421.7015953063965,101643,11101,90542,90542,0,10,11775000.0
11775,11775999,22.12757323070955,38.68398676362108,0.04352365459802632,2757.481613636017,756.5684535503387,3421.9321365356445,101661,11104,90557,90557,0,10,11776000.0
11776,11776999,22.12797669237767,38.683708924558196,0.043505447183712964,2757.817325592041,756.632462978363,3422.2560386657715,101673,11105,90568,90568,0,10,11777000.0
11777,11777999,22.128271769044066,38.683177529221425,0.043485984348918594,2758.379115819931,756.6935985088348,3422.5000190734863,101690,11107,90583,90583,0,10,11778000.0
11778,11778999,22.12841841572,38.68251248035955,0.04347301072315224,2758.4938519001007,756.7562584877014,3422.9307403564453,101690,11107,90583,90583,0,10,11779000.0
11779,11779999,22.128270386548817,38.68167367176066,0.043465085057526,2758.838624238968,756.819216966629,3423.648754119873,101699,11108,90591,90591,0,10,11780000.0
11780,11780999,22.12786721708276,38.68077165237674,0.04345783125991931,2758.962431192398,756.8827886581421,3424.445888519287,101700,11108,90592,90592,0,10,11781000.0
11781,11781999,22.127494977948498,38.680035114592656,0.043452112747444094,2759.313495159149,756.9444010257721,3424.890567779541,101702,11109,90593,90593,0,10,11782000.0
11782,11782999,22.12720894000764,38.679173424457915,0.04344395136522006,2759.4412994384766,757.0068295001984,3425.429542541504,101702,11109,90593,90593,0,10,11783000.0
11783,11783999,22.12710924929082,38.678755830989395,0.04343620247179225,2759.5636773109436,757.0688371658325,3425.750473022461,101702,11109,90593,90593,0,10,11784000.0
11784,11784999,22.127115301289535,38.67825239631302,0.04342648919025249,2759.687319755554,757.1317486763,3426.1614303588867,101702,11109,90593,90593,0,10,11785000.0
11785,11785999,22.127014363665847,38.677595766802966,0.043422321396636154,2760.243758201599,757.194687128067,3426.455924987793,101721,11111,90610,90610,0,10,11786000.0
11786,11786999,22.127065100244838,38.67714697661985,0.04342133604749321,2760.369490623474,757.2572596073151,3426.887493133545,101721,11111,90610,90610,0,10,11787000.0
11787,11787999,22.127216902201386,38.67763058819241,0.04341377922904022,2761.159195423126,757.3204362392426,3427.0902519226074,101746,11114,90632,90632,0,10,11788000.0
11788,11788999,22.12738543238054,38.67739995448359,0.04341449987156221,2761.29474568367,757.3847110271454,3427.474781036377,101746,11114,90632,90632,0,10,11789000.0
11789,11789999,22.127536542497616,38.677378752204596,0.04341333373336875,2761.635220527649,757.4472179412842,3427.7310523986816,101762,11115,90647,90647,0,10,11790000.0
11790,11790999,22.127760810745368,38.67697156949644,0.043409013361668136,2762.204052209854,757.5100018978119,3428.0069694519043,101776,11117,90659,90659,0,10,11791000.0
11791,11791999,22.1280638105744,38.67704620421034,0.04340539844051583,2762.5669338703156,757.5836842060089,3428.3889350891113,101783,11118,90665,90665,0,10,11792000.0
11792,11792999,22.128408259123653,38.67690347994403,0.04340663054904648,2762.9018778800964,757.6449284553528,3428.690528869629,101795,11119,90676,90676,0,10,11793000.0
11793,11793999,22.12878799171805,38.676743393735485,0.043405851994444467,2763.01718378067,757.7075369358063,3429.0334815979004,101795,11119,90676,90676,0,10,11794000.0
11794,11794999,22.129420396814048,38.67754618832203,0.043402582128332035,2763.369933605194,757.7696948051453,3429.3637351989746,101797,11120,90677,90677,0,10,11795000.0
11795,11795999,22.13012428163657,38.677690213826125,0.043396668375991765,2763.7061591148376,757.8323318958282,3429.7587966918945,101799,11121,90678,90678,0,10,11796000.0
11796,11796999,22.13075069863578,38.67773314440156,0.04338805575725935,2764.2579522132874,757.895180940628,3430.030284881592,101823,11123,90700,90700,0,10,11797000.0
11797,11797999,22.13102578565417,38.67727125131923,0.04338867197774199,2764.37761425972,757.9582438468933,3430.3525314331055,101825,11123,90702,90702,0,10,11798000.0
11798,11798999,22.131192487204974,38.67680505157547,0.04338530199466295,2764.720876455307,758.0206429958344,3430.7380142211914,101837,11124,90713,90713,0,10,11799000.0
11799,11799999,22.130971739367794,38.67590504928818,0.04338315997198039,2765.5047187805176,758.0833051204681,3431.33097076416,101859,11127,90732,90732,0,10,11800000.0
11800,11800999,22.130650609500947,38.675481515012024,0.04338556135891425,2765.852980852127,758.1461145877838,3431.8684692382812,101862,11128,90734,90734,0,10,11801000.0
11801,11801999,22.13033196259208,38.67497546753555,0.04338540801760038,2766.190465927124,758.2071130275726,3432.137348175049,101874,11129,90745,90745,0,10,11802000.0
11802,11802999,22.13000007188863,38.67442340130926,0.04338623465620106,2766.9918913841248,758.2700009346008,3432.359401702881,101902,11132,90770,90770,0,10,11803000.0
11803,11803999,22.129857201066223,38.67456181362917,0.04338535684097855,2767.336170434952,758.3325765132904,3432.5762100219727,101904,11133,90771,90771,0,10,11804000.0
11804,11804999,22.129802535562767,38.67438855648184,0.043385559360967885,2767.6747670173645,758.3936266899109,3432.792507171631,101916,11134,90782,90782,0,10,11805000.0
11805,11805999,22.129576347953268,38.6738410140095,0.04338653098310663,2767.8105158805847,758.4551825523376,3433.071147918701,101916,11134,90782,90782,0,10,11806000.0
11806,11806999,22.129471209845896,38.67378396742474,0.043385468102612235,2768.376636505127,758.5177245140076,3433.2469177246094,101920,11136,90784,90784,0,10,11807000.0
11807,11807999,22.129377824921487,38.673415853583876,0.04338520103493204,2768.7133762836456,758.5786740779877,3433.4720344543457,101924,11137,90787,90787,0,10,11808000.0
11808,11808999,22.129387505845223,38.67342557427987,0.043384053620981855,2769.0603024959564,758.6401143074036,3433.6286125183105,101936,11138,90798,90798,0,10,11809000.0
11809,11809999,22.1294449066476,38.67340975368849,0.04338938996551622,2770.0613720417023,758.7024202346802,3433.7389335632324,101971,11142,90829,90829,0,10,11810000.0
11810,11810999,22.12951087512224,38.673122619092005,0.043386356002777626,2770.402001142502,758.7633543014526,3434.06245803833,101989,11143,90846,90846,0,10,11811000.0
11811,11811999,22.129693044659053,38.67335419840899,0.043388698366030876,2770.7636184692383,758.8267047405243,3434.462833404541,102001,11144,90857,90857,0,10,11812000.0
11812,11812999,22.129852263898048,38.67330178019778,0.043384916286113295,2770.8961822986603,758.8874621391296,3434.769645690918,102001,11144,90857,90857,0,10,11813000.0
11813,11813999,22.130152423542402,38.673431831816806,0.04338653310193008,2771.237689971924,758.9492943286896,3435.040367126465,102013,11145,90868,90868,0,10,11814000.0
11814,11814999,22.130365952945123,38.67331635138864,0.04338258982640608,2771.3630859851837,759.011777639389,3435.3840942382812,102013,11145,90868,90868,0,10,11815000.0
11815,11815999,22.13074071305943,38.67412185296236,0.04337341371415104,2771.4766595363617,759.0728600025177,3435.8270874023438,102014,11145,90869,90869,0,10,11816000.0
11816,11816999,22.131117378363676,38.67439552557205,0.04336793095099467,2771.5984332561493,759.1334822177887,3436.1044998168945,102014,11145,90869,90869,0,10,11817000.0
11817,11817999,22.13128312267072,38.6740813146968,0.043363933602053484,2771.71519613266,759.1951117515564,3436.3931312561035,102014,11145,90869,90869,0,10,11818000.0
11818,11818999,22.1313793084924,38.673667373570375,0.04336047349534711,2772.0494742393494,759.2579159736633,3436.8499908447266,102028,11146,90882,90882,0,10,11819000.0
11819,11819999,22.131156016128653,38.67295491862654,0.04335632806967915,2772.8452095985413,759.3202815055847,3437.4484825134277,102060,11149,90911,90911,0,10,11820000.0
11820,11820999,22.130697708577337,38.672418479491014,0.04335393723090275,2773.4824969768524,759.462828874588,3438.352108001709,102062,11150,90912,90912,0,10,11821000.0
11821,11821999,22.130268613214998,38.67200635284492,0.043349340829584415,2773.8419132232666,759.6286392211914,3439.009822845459,102062,11150,90912,90912,0,10,11822000.0
11822,11822999,22.129826840942272,38.671265665586375,0.04334570229080115,2775.2453274726868,759.8508560657501,3439.4240684509277,102076,11151,90925,90925,0,10,11823000.0
11823,11823999,22.129446124528865,38.67056130743967,0.043343710800489266,2776.243413925171,760.0229001045227,3439.753936767578,102080,11152,90928,90928,0,10,11824000.0
11824,11824999,22.129127994902568,38.66982844608962,0.04334067314029333,2776.9773836135864,760.1705765724182,3440.067283630371,102082,11153,90929,90929,0,10,11825000.0
11825,11825999,22.128826354522854,38.66935326576624,0.04333654914767304,2777.1119532585144,760.2364490032196,3440.5062408447266,102082,11153,90929,90929,0,10,11826000.0
11826,11826999,22.128460181702952,38.66843407100783,0.0433351796400232,2777.465907096863,760.3029084205627,3440.8409538269043,102094,11154,90940,90940,0,10,11827000.0
11827,11827999,22.12815055190049,38.66756906283466,0.0433342685606799,2777.815972328186,760.3694498538971,3441.221954345703,102096,11155,90941,90941,0,10,11828000.0
11828,11828999,22.12793254238145,38.66673279917322,0.04333281026246083,2778.177274465561,760.4357590675354,3441.645679473877,102098,11156,90942,90942,0,10,11829000.0
11829,11829999,22.127783861125362,38.666101914425504,0.04332943961501423,2778.305535554886,760.5020167827606,3441.9386978149414,102098,11156,90942,90942,0,10,11830000.0
11830,11830999,22.127861729400117,38.66588017803787,0.043327555768877146,2778.6601004600525,760.5677332878113,3442.327892303467,102110,11157,90953,90953,0,10,11831000.0
11831,11831999,22.128102221886287,38.66599067040153,0.04332233851800049,2779.0134670734406,760.6336078643799,3442.6847229003906,102122,11158,90964,90964,0,10,11832000.0
11832,11832999,22.128130309348737,38.66552640858385,0.04331814061862982,2779.5987236499786,760.6996624469757,3442.90877532959,102146,11160,90986,90986,0,10,11833000.0
11833,11833999,22.12823366660315,38.66509249075496,0.043316279065303886,2779.726423025131,760.765222787857,3443.355667114258,102147,11160,90987,90987,0,10,11834000.0
11834,11834999,22.128416655657524,38.66482555449835,0.043309096507353595,2780.328113794327,760.832189321518,3443.6429443359375,102171,11162,91009,91009,0,10,11835000.0
11835,11835999,22.128681558508184,38.66528511226864,0.04329772454598768,2780.9151759147644,760.8986115455627,3443.8731575012207,102185,11164,91021,91021,0,10,11836000.0
11836,11836999,22.128788850709167,38.66485786345923,0.043289010339663814,2781.044222831726,760.9662072658539,3444.1613693237305,102185,11164,91021,91021,0,10,11837000.0
11837,11837999,22.128826952658,38.66414450986577,0.04328131842883676,2781.1771097183228,761.0322873592377,3444.4500885009766,102185,11164,91021,91021,0,10,11838000.0
11838,11838999,22.128932563890228,38.663494248383905,0.04327140046726263,2781.5507261753082,761.1046779155731,3444.8203468322754,102193,11165,91028,91028,0,10,11839000.0
11839,11839999,22.128778971253865,38.6626459364036,0.0432640278706069,2782.1623089313507,761.1775810718536,3445.032829284668,102206,11167,91039,91039,0,10,11840000.0
11840,11840999,22.128396644684443,38.66189367059808,0.0432588709044589,2782.7556014060974,761.245099067688,3446.116497039795,102213,11169,91044,91044,0,10,11841000.0
11841,11841999,22.128050035473294,38.66108356071612,0.0432529781814579,2783.358726978302,761.312912940979,3446.6395301818848,102228,11171,91057,91057,0,10,11842000.0
11842,11842999,22.12773292896828,38.66053731795258,0.04324936837669735,2783.4813179969788,761.3798999786377,3447.0962409973145,102228,11171,91057,91057,0,10,11843000.0
11843,11843999,22.12746883537977,38.659918292314444,0.04324530795982606,2784.0842950344086,761.4473667144775,3447.3302307128906,102253,11173,91080,91080,0,10,11844000.0
11844,11844999,22.12726861337458,38.65946943905179,0.04324167633624898,2784.684480190277,761.5144164562225,3447.635009765625,102268,11175,91093,91093,0,10,11845000.0
11845,11845999,22.12700015962291,38.658652052036814,0.04323805675341541,2785.052912712097,761.5819897651672,3448.1248359680176,102281,11176,91105,91105,0,10,11846000.0
11846,11846999,22.126765835402917,38.65778854784727,0.04323460089712139,2785.183955192566,761.6490633487701,3448.6270713806152,102281,11176,91105,91105,0,10,11847000.0
11847,11847999,22.126473706449353,38.656897726613145,0.043232218796208643,2785.3095519542694,761.7146689891815,3449.028388977051,102282,11176,91106,91106,0,10,11848000.0
11848,11848999,22.12621012954649,38.65612744127893,0.043230215924687676,2785.663459777832,761.7805807590485,3449.283950805664,102294,11177,91117,91117,0,10,11849000.0
11849,11849999,22.126051900288576,38.655646324363545,0.04322905247135311,2785.8093962669373,761.8564596176147,3449.692485809326,102296,11177,91119,91119,0,10,11850000.0
11850,11850999,22.125810305273443,38.6547574388303,0.04322626581789302,2785.941954612732,761.9237415790558,3450.018123626709,102296,11177,91119,91119,0,10,11851000.0
11851,11851999,22.12579271693535,38.654164535360124,0.04322428784311305,2786.533948659897,761.9913711547852,3450.2499656677246,102310,11179,91131,91131,0,10,11852000.0
11852,11852999,22.12595911466744,38.653684944484304,0.0432166029496589,2786.898192167282,762.0590341091156,3450.549663543701,102322,11180,91142,91142,0,10,11853000.0
11853,11853999,22.126299249563736,38.65333107130816,0.04319577460181123,2787.248570919037,762.1265609264374,3450.9157638549805,102324,11181,91143,91143,0,10,11854000.0
11854,11854999,22.126505433305486,38.65292888607381,0.0431844341992047,2788.082731485367,762.1949124336243,3451.213180541992,102350,11184,91166,91166,0,10,11855000.0
11855,11855999,22.126658186425324,38.65286016299128,0.043173511319524405,2788.448662519455,762.2615842819214,3451.533000946045,102362,11185,91177,91177,0,10,11856000.0
11856,11856999,22.126511477815914,38.65233471038231,0.04316189701415163,2789.3885486125946,762.4756631851196,3452.3616104125977,102372,11186,91186,91186,0,10,11857000.0
11857,11857999,22.12613021481247,38.65147188288932,0.0431596958774626,2790.7447686195374,762.6169278621674,3452.9497833251953,102402,11188,91214,91214,0,10,11858000.0
11858,11858999,22.12569554083864,38.650484998878106,0.04316140399524426,2791.127435684204,762.6899874210358,3453.5104446411133,102420,11189,91231,91231,0,10,11859000.0
11859,11859999,22.125375242116117,38.649719394518236,0.043157330557669904,2791.4818329811096,762.7535469532013,3453.818744659424,102423,11190,91233,91233,0,10,11860000.0
11860,11860999,22.125069132233655,38.64881667244769,0.04315545585160496,2791.620274782181,762.8235714435577,3454.338611602783,102425,11190,91235,91235,0,10,11861000.0
11861,11861999,22.12472887150286,38.64824912857918,0.04315489152045393,2791.74751496315,762.8879470825195,3454.8023567199707,102427,11190,91237,91237,0,10,11862000.0
11862,11862999,22.12439838348529,38.647510634688736,0.04315217137723526,2792.095616579056,762.9530761241913,3455.237503051758,102441,11191,91250,91250,0,10,11863000.0
11863,11863999,22.124040614554644,38.64684673067138,0.043150317295405305,2792.6571974754333,763.0148088932037,3455.377544403076,102458,11193,91265,91265,0,10,11864000.0
11864,11864999,22.123712796266876,38.645970032948796,0.043147534654292996,2792.774418592453,763.076639175415,3455.773338317871,102458,11193,91265,91265,0,10,11865000.0
11865,11865999,22.12338247968525,38.64521528431974,0.043144243556832884,2793.11611533165,763.139271736145,3456.009635925293,102478,11194,91284,91284,0,10,11866000.0
11866,11866999,22.12313011839212,38.644359580826524,0.04313973628177814,2793.2382526397705,763.2018005847931,3456.2513885498047,102478,11194,91284,91284,0,10,11867000.0
11867,11867999,22.122925464414923,38.64371088680048,0.04313604435196383,2793.3565344810486,763.2628910541534,3456.5751876831055,102478,11194,91284,91284,0,10,11868000.0
11868,11868999,22.122819582249456,38.64307541819966,0.043129558367546506,2793.7127850055695,763.3255252838135,3456.8529319763184,102490,11195,91295,91295,0,10,11869000.0
11869,11869999,22.122827269736078,38.6425992010527,0.04312438846935729,2794.48601937294,763.387957572937,3456.9587326049805,102506,11198,91308,91308,0,10,11870000.0
11870,11870999,22.123082702609953,38.6425216237385,0.043112133732439495,2794.8257970809937,763.449868440628,3457.270793914795,102508,11199,91309,91309,0,10,11871000.0
11871,11871999,22.123288273781043,38.642369810019616,0.0430959939127723,2794.9469830989838,763.5108563899994,3457.734474182129,102508,11199,91309,91309,0,10,11872000.0
11872,11872999,22.123434280250805,38.64195297942644,0.04308207018898602,2795.064013004303,763.5721354484558,3458.070400238037,102509,11199,91310,91310,0,10,11873000.0
11873,11873999,22.123658760172564,38.6416441003013,0.04305918923168761,2795.6429262161255,763.6351046562195,3458.220386505127,102533,11201,91332,91332,0,10,11874000.0
11874,11874999,22.123705776735914,38.64121981790761,0.043041640147786664,2796.210423707962,763.696982383728,3458.4624366760254,102547,11203,91344,91344,0,10,11875000.0
11875,11875999,22.123520738480877,38.64064118505724,0.04303227866232773,2796.333131313324,763.7583541870117,3459.1578407287598,102548,11203,91345,91345,0,10,11876000.0
11876,11876999,22.122905641453656,38.64015120297922,0.04303160389257421,2796.6841235160828,763.8200068473816,3459.549057006836,102551,11204,91347,91347,0,10,11877000.0
11877,11877999,22.122237890698948,38.63914867143677,0.04303572045530368,2797.0263390541077,763.8816983699799,3459.7329635620117,102558,11205,91353,91353,0,10,11878000.0
11878,11878999,22.12162172494419,38.638193932340414,0.0430384427157523,2797.8237228393555,763.9454336166382,3459.770347595215,102585,11208,91377,91377,0,10,11879000.0
11879,11879999,22.121118847141886,38.637346228634165,0.04303935682938653,2798.1636443138123,764.0074524879456,3459.944408416748,102587,11209,91378,91378,0,10,11880000.0
11880,11880999,22.120556260956356,38.636384454863894,0.043039265060813126,2798.5130727291107,764.0701184272766,3460.185989379883,102591,11210,91381,91381,0,10,11881000.0
11881,11881999,22.120014626015788,38.6354188414298,0.04304068462097799,2798.637686252594,764.1307835578918,3460.3971099853516,102591,11210,91381,91381,0,10,11882000.0
11882,11882999,22.1196216454587,38.6346031166729,0.04304035401080908,2799.20321393013,764.1937007904053,3460.5684776306152,102605,11212,91393,91393,0,10,11883000.0
11883,11883999,22.119604461299847,38.63430586946585,0.04303602037366783,2799.3307707309723,764.2568490505219,3460.808307647705,102606,11212,91394,91394,0,10,11884000.0
11884,11884999,22.119679665840337,38.634335445229645,0.04303307519437771,2800.107929468155,764.3184187412262,3460.8850860595703,102613,11215,91398,91398,0,10,11885000.0
11885,11885999,22.119784534946806,38.6342077154927,0.04303199253647916,2800.664767742157,764.3794703483582,3461.121292114258,102641,11217,91424,91424,0,10,11886000.0
11886,11886999,22.12007489800515,38.63410503859475,0.043031346721421726,2800.9985098838806,764.4418089389801,3461.4200859069824,102643,11218,91425,91425,0,10,11887000.0
11887,11887999,22.120570132642516,38.634555976037305,0.04303490856997405,2801.340279817581,764.5040051937103,3461.6162452697754,102646,11219,91427,91427,0,10,11888000.0
11888,11888999,22.12100220114858,38.63488897083075,0.043034632360133496,2801.6820430755615,764.566258430481,3461.794750213623,102657,11220,91437,91437,0,10,11889000.0
11889,11889999,22.121952859755762,38.63623083469028,0.04303055645985887,2802.238536119461,764.629537820816,3462.0121726989746,102671,11222,91449,91449,0,10,11890000.0
11890,11890999,22.122640810858567,38.636773670153566,0.04302568535772777,2803.0294280052185,764.6926715373993,3462.194477081299,102697,11225,91472,91472,0,10,11891000.0
11891,11891999,22.12330447975222,38.63838897856591,0.04301597983934502,2803.5874428749084,764.7546439170837,3462.4098320007324,102711,11227,91484,91484,0,10,11892000.0
11892,11892999,22.123881022564714,38.6386089467473,0.04300875168989715,2804.3818650245667,764.817804813385,3462.755172729492,102741,11230,91511,91511,0,10,11893000.0
11893,11893999,22.12436263575147,38.63851999907119,0.043001076922070114,2804.5088877677917,764.882257938385,3463.151584625244,102741,11230,91511,91511,0,10,11894000.0
11894,11894999,22.124546543282882,38.63820501645688,0.04299457031082521,2804.858911752701,764.94642329216,3463.5095138549805,102743,11231,91512,91512,0,10,11895000.0
11895,11895999,22.124328646859606,38.63746682710385,0.0429910347023601,2804.9856593608856,765.0085844993591,3464.2810859680176,102746,11231,91515,91515,0,10,11896000.0
11896,11896999,22.123653599913112,38.63647305214469,0.04299453823837629,2805.124768972397,765.0813939571381,3464.8732566833496,102747,11231,91516,91516,0,10,11897000.0
11897,11897999,22.12304060950857,38.635380776378234,0.043001717461618516,2805.915059328079,765.1437458992004,3465.0167503356934,102756,11234,91522,91522,0,10,11898000.0
11898,11898999,22.122500381401043,38.63437799696105,0.043004482266514876,2806.4975485801697,765.2067408561707,3465.288242340088,102771,11236,91535,91535,0,10,11899000.0
11899,11899999,22.12197737497292,38.633895912809216,0.04300479363592602,2806.838757276535,765.2682654857635,3465.595443725586,102775,11237,91538,91538,0,10,11900000.0
11900,11900999,22.12148626307234,38.63281763120367,0.0430093671222026,2806.9670469760895,765.3373093605042,3465.9495239257812,102775,11237,91538,91538,0,10,11901000.0
11901,11901999,22.120968369102442,38.6317577278448,0.043010969869743954,2807.0880098342896,765.4002828598022,3466.318302154541,102776,11237,91539,91539,0,10,11902000.0
11902,11902999,22.12058124581724,38.63102005905261,0.04301422192034676,2807.220480442047,765.4625172615051,3466.6271591186523,102777,11237,91540,91540,0,10,11903000.0
11903,11903999,22.120183743292447,38.63012403794153,0.04301601515888176,2807.5910527706146,765.5370600223541,3466.815143585205,102779,11238,91541,91541,0,10,11904000.0
11904,11904999,22.119867369428324,38.62932826178096,0.043020139574264316,2807.928244113922,765.6001446247101,3467.100498199463,102781,11239,91542,91542,0,10,11905000.0
11905,11905999,22.11976116209607,38.62878756634665,0.04302151701794987,2808.0515928268433,765.661337852478,3467.463279724121,102781,11239,91542,91542,0,10,11906000.0
11906,11906999,22.120210301464656,38.62952001032646,0.04302850537710523,2808.1638734340668,765.7229163646698,3467.701591491699,102781,11239,91542,91542,0,10,11907000.0
11907,11907999,22.12095628462513,38.630700843947714,0.043046091748132564,2808.725816965103,765.784738779068,3467.9195594787598,102786,11241,91545,91545,0,10,11908000.0
11908,11908999,22.1217731937706,38.63184050939342,0.043067876243412795,2808.844797372818,765.8479056358337,3468.3989181518555,102787,11241,91546,91546,0,10,11909000.0
11909,11909999,22.12244312358451,38.63271986364496,0.04308720624865581,2809.6348214149475,765.9096562862396,3468.5011558532715,102804,11244,91560,91560,0,10,11910000.0
11910,11910999,22.12316322430344,38.63346797236491,0.04310238932205612,2809.7575895786285,765.971738576889,3468.819648742676,102804,11244,91560,91560,0,10,11911000.0
11911,11911999,22.12402527502866,38.634315167405376,0.043114358928248664,2810.5417132377625,766.0344235897064,3469.015235900879,102822,11247,91575,91575,0,10,11912000.0
11912,11912999,22.12449207075219,38.63458810108099,0.04311805654798906,2810.894532442093,766.0972845554352,3469.3199195861816,102824,11248,91576,91576,0,10,11913000.0
11913,11913999,22.12483720574703,38.63449110519818,0.04312649891037856,2811.679443836212,766.1600849628448,3469.50532913208,102840,11251,91589,91589,0,10,11914000.0
11914,11914999,22.124944045057724,38.634019651541955,0.043131773922064576,2812.2532806396484,766.2232105731964,3469.7980918884277,102844,11253,91591,91591,0,10,11915000.0
11915,11915999,22.124396903185595,38.63341916814327,0.043129961167465924,2812.3781321048737,766.286557674408,3470.798698425293,102844,11253,91591,91591,0,10,11916000.0
11916,11916999,22.123802802706134,38.6329835662881,0.043129366475768705,2812.718006372452,766.349118232727,3471.2335090637207,102846,11254,91592,91592,0,10,11917000.0
11917,11917999,22.123202564975223,38.631953135909626,0.043131160876634045,2812.8396832942963,766.412202835083,3471.6287231445312,102846,11254,91592,91592,0,10,11918000.0
11918,11918999,22.12268018142865,38.630947152167145,0.043132629570165615,2813.1989436149597,766.4740698337555,3471.806480407715,102848,11255,91593,91593,0,10,11919000.0
11919,11919999,22.122143433928304,38.62983099685668,0.04313100896846955,2813.546689748764,766.5367124080658,3472.1744422912598,102879,11256,91623,91623,0,10,11920000.0
11920,11920999,22.12158645631211,38.628778251788205,0.043131106903357974,2813.66974401474,766.6002159118652,3472.4738235473633,102879,11256,91623,91623,0,10,11921000.0
11921,11921999,22.121021502982277,38.62768675276911,0.04313103053320633,2814.0155284404755,766.6631779670715,3472.740089416504,102881,11257,91624,91624,0,10,11922000.0
11922,11922999,22.12054375167783,38.62669519016947,0.04312954005988978,2814.82590842247,766.7289974689484,3472.945655822754,102903,11260,91643,91643,0,10,11923000.0
11923,11923999,22.120253771183243,38.6261375288344,0.043126539990659296,2814.952202796936,766.7922286987305,3473.317600250244,102903,11260,91643,91643,0,10,11924000.0
11924,11924999,22.11982832390904,38.62515220523253,0.043124606187242676,2815.9583485126495,766.8555397987366,3473.357677459717,102921,11264,91657,91657,0,10,11925000.0
11925,11925999,22.119459034850617,38.6242128959999,0.043119284347748366,2816.7479860782623,766.9192674160004,3473.787166595459,102948,11267,91681,91681,0,10,11926000.0
11926,11926999,22.119141457974266,38.62335955733958,0.04311498165695293,2817.0968379974365,766.9829196929932,3474.175304412842,102955,11268,91687,91687,0,10,11927000.0
11927,11927999,22.11897178110612,38.623089412137034,0.043110506268024595,2817.212725877762,767.0454521179199,3474.452705383301,102955,11268,91687,91687,0,10,11928000.0
11928,11928999,22.11877260636961,38.62222320363598,0.04310661481282385,2817.552093267441,767.1076533794403,3474.8622970581055,102967,11269,91698,91698,0,10,11929000.0
11929,11929999,22.118751559977028,38.62179234099177,0.04309951786909738,2817.901086330414,767.1722679138184,3475.220527648926,102974,11270,91704,91704,0,10,11930000.0
11930,11930999,22.118641190768223,38.62102692968494,0.04309676316758626,2818.2367391586304,767.233481168747,3475.6468467712402,102976,11271,91705,91705,0,10,11931000.0
11931,11931999,22.11847071514971,38.62018667072943,0.04309012908309118,2818.574931383133,767.2960476875305,3476.146339416504,102989,11272,91717,91717,0,10,11932000.0
11932,11932999,22.11834584964064,38.61940818461542,0.043085152733631116,2819.1521644592285,767.3580939769745,3476.5271759033203,103003,11274,91729,91729,0,10,11933000.0
11933,11933999,22.118180274151083,38.618740043986996,0.04307931178685542,2819.4878363609314,767.4191091060638,3477.0459022521973,103016,11275,91741,91741,0,10,11934000.0
11934,11934999,22.117904359951673,38.61811642287632,0.04307906723394417,2819.6165959835052,767.4807476997375,3478.2322883605957,103017,11275,91742,91742,0,10,11935000.0
11935,11935999,22.11702209299906,38.61686122884937,0.04308473378828004,2819.966578245163,767.54363489151,3479.3691024780273,103020,11276,91744,91744,0,10,11936000.0
11936,11936999,22.116274818981886,38.61613490077027,0.04308818482191401,2820.544898033142,767.6088342666626,3480.051773071289,103044,11278,91766,91766,0,10,11937000.0
11937,11937999,22.115516966973573,38.615063706139495,0.04309399444762474,2820.8892152309418,767.6718406677246,3480.653495788574,103057,11279,91778,91778,0,10,11938000.0
11938,11938999,22.114913900796658,38.61592344463111,0.0430929212523945,2821.231491088867,767.7340853214264,3481.082790374756,103069,11280,91789,91789,0,10,11939000.0
11939,11939999,22.11429410191558,38.61488887004688,0.04309378454130519,2821.571214199066,767.7957644462585,3481.6730155944824,103078,11281,91797,91797,0,10,11940000.0
11940,11940999,22.113619075551924,38.61383948282974,0.043095834852306836,2821.919950723648,767.8575620651245,3482.246795654297,103090,11282,91808,91808,0,10,11941000.0
11941,11941999,22.112959715575467,38.61299419110915,0.043097493142529975,2822.4891159534454,767.9198291301727,3482.6542434692383,103104,11284,91820,91820,0,10,11942000.0
11942,11942999,22.112457387544872,38.61215964899307,0.043096832425201015,2823.0552937984467,767.9824237823486,3483.0589179992676,103129,11286,91843,91843,0,10,11943000.0
11943,11943999,22.11186680683402,38.61106166671829,0.043097466278398056,2823.1691403388977,768.0430912971497,3483.46976852417,103129,11286,91843,91843,0,10,11944000.0
11944,11944999,22.11127097311579,38.61010770634624,0.04309853515114237,2823.737137556076,768.1049070358276,3483.720157623291,103150,11288,91862,91862,0,10,11945000.0
11945,11945999,22.1107713341391,38.609243793675674,0.04309648065097005,2823.8570594787598,768.1685802936554,3484.246322631836,103151,11288,91863,91863,0,10,11946000.0
11946,11946999,22.110241113943086,38.60823487065668,0.04309676354543457,2824.6630413532257,768.2392482757568,3484.5856285095215,103187,11291,91896,91896,0,10,11947000.0
11947,11947999,22.10981925239936,38.60805026377303,0.043094658681465,2824.7744040489197,768.3011033535004,3484.8920288085938,103187,11291,91896,91896,0,10,11948000.0
11948,11948999,22.109468903051187,38.607349030491356,0.043094146405450395,2825.112250804901,768.3640785217285,3485.38814163208,103189,11292,91897,91897,0,10,11949000.0
11949,11949999,22.109241509820524,38.60680631205978,0.043090745444323564,2825.2296874523163,768.4271652698517,3485.86873626709,103189,11292,91897,91897,0,10,11950000.0
11950,11950999,22.109198388413436,38.60699426645665,0.04308520019866657,2825.566256046295,768.4891679286957,3486.3437881469727,103201,11293,91908,91908,0,10,11951000.0
11951,11951999,22.108992602711194,38.60637528254305,0.04308080445175422,2825.9027462005615,768.5501039028168,3486.612861633301,103213,11294,91919,91919,0,10,11952000.0
11952,11952999,22.108766747185612,38.605737314377976,0.0430761684279688,2826.703456878662,768.6132109165192,3486.8654441833496,103234,11297,91937,91937,0,10,11953000.0
11953,11953999,22.108728073447743,38.60535958026226,0.04307002141053107,2826.8216173648834,768.6758499145508,3487.3684272766113,103234,11297,91937,91937,0,10,11954000.0
11954,11954999,22.108659971561345,38.60515904248398,0.043066084435879004,2826.946293592453,768.7373735904694,3488.0799293518066,103236,11297,91939,91939,0,10,11955000.0
11955,11955999,22.108170223255637,38.60425360127672,0.043065151547447944,2827.740912914276,768.8003604412079,3488.817569732666,103267,11300,91967,91967,0,10,11956000.0
11956,11956999,22.107553895464925,38.603151357677135,0.04306748722644271,2828.317148923874,768.863461971283,3489.283592224121,103287,11302,91985,91985,0,10,11957000.0
11957,11957999,22.107061111809635,38.60243700607826,0.04306829193732509,2828.4421503543854,768.9271595478058,3489.839912414551,103288,11302,91986,91986,0,10,11958000.0
11958,11958999,22.106700819606257,38.60194774060735,0.043066159770030255,2828.7865238189697,768.9898500442505,3490.186347961426,103290,11303,91987,91987,0,10,11959000.0
11959,11959999,22.10624422013301,38.60255459906499,0.043061755171156735,2828.920260667801,769.0523104667664,3490.632183074951,103290,11303,91987,91987,0,10,11960000.0
11960,11960999,22.105801489309403,38.60171952582176,0.043061123574258175,2829.0597774982452,769.1276502609253,3491.0417251586914,103290,11303,91987,91987,0,10,11961000.0
11961,11961999,22.105410305379333,38.601435603172064,0.043056400952702134,2829.4123179912567,769.1888597011566,3491.310806274414,103302,11304,91998,91998,0,10,11962000.0
11962,11962999,22.104898251016774,38.60035899287306,0.043055787850330596,2829.553611755371,769.2629334926605,3491.6910705566406,103302,11304,91998,91998,0,10,11963000.0
11963,11963999,22.104518415535466,38.599539603889305,0.04305258612091467,2829.8960275650024,769.3255593776703,3491.9248008728027,103309,11305,92004,92004,0,10,11964000.0
11964,11964999,22.104194683885865,38.59876499171803,0.04305110838696824,2830.013294696808,769.3877379894257,3492.2065086364746,103310,11305,92005,92005,0,10,11965000.0
11965,11965999,22.103961408170285,38.5979466196998,0.04304458302611458,2830.7934124469757,769.4502992630005,3492.4079513549805,103326,11308,92018,92018,0,10,11966000.0
11966,11966999,22.103842485930137,38.59725653227073,0.043039854251047616,2831.3634362220764,769.5116603374481,3492.7324409484863,103350,11310,92040,92040,0,10,11967000.0
11967,11967999,22.103800907510173,38.596757656216376,0.04303474168486965,2831.4799914360046,769.5737082958221,3492.9713821411133,103350,11310,92040,92040,0,10,11968000.0
11968,11968999,22.104066165240496,38.59672306134268,0.04302338994646038,2831.8280580043793,769.6357700824738,3493.219871520996,103362,11311,92051,92051,0,10,11969000.0
11969,11969999,22.10442922131629,38.59674579943147,0.04301696015297507,2832.1769559383392,769.6982679367065,3493.489303588867,103364,11312,92052,92052,0,10,11970000.0
11970,11970999,22.10466696435511,38.596450533340466,0.04300941218996668,2832.29252243042,769.7607741355896,3493.8474731445312,103364,11312,92052,92052,0,10,11971000.0
11971,11971999,22.104849365579184,38.59591977633806,0.043001942999802534,2832.855194091797,769.8223571777344,3494.034797668457,103378,11314,92064,92064,0,10,11972000.0
11972,11972999,22.105098517479263,38.595588748891856,0.042989911473655495,2832.99259352684,769.8946266174316,3494.4480628967285,103379,11314,92065,92065,0,10,11973000.0
11973,11973999,22.10528334242581,38.59524628095957,0.04297923604555054,2833.333983182907,769.956821680069,3494.770751953125,103381,11315,92066,92066,0,10,11974000.0
11974,11974999,22.10521098056487,38.594694209369386,0.04297346755424092,2833.899810552597,770.0191123485565,3494.996768951416,103396,11317,92079,92079,0,10,11975000.0
11975,11975999,22.104715242859655,38.5937218237535,0.04297108144808848,2834.483892440796,770.0840277671814,3496.4910926818848,103419,11319,92100,92100,0,10,11976000.0
11976,11976999,22.104109545905256,38.59260211852235,0.042973380271959294,2834.8342576026917,770.1476457118988,3497.102798461914,103435,11320,92115,92115,0,10,11977000.0
11977,11977999,22.103614903655625,38.59159443268133,0.042972270834939374,2835.1816997528076,770.2121903896332,3497.711883544922,103447,11321,92126,92126,0,10,11978000.0
11978,11978999,22.103202608851888,38.59063482996444,0.04297069440782364,2835.3017539978027,770.2750360965729,3498.200054168701,103447,11321,92126,92126,0,10,11979000.0
11979,11979999,22.10275695661932,38.58961869674638,0.04296986220618382,2835.423182249069,770.3373191356659,3498.6420135498047,103447,11321,92126,92126,0,10,11980000.0
11980,11980999,22.102355963101637,38.58872968080165,0.04296862032825344,2836.0015847682953,770.4015159606934,3499.0762367248535,103473,11323,92150,92150,0,10,11981000.0
11981,11981999,22.10195913562427,38.58770972198349,0.04296655558775386,2836.7937972545624,770.4642159938812,3499.4531784057617,103479,11326,92153,92153,0,10,11982000.0
11982,11982999,22.101661993387715,38.58715690691802,0.042964246893010816,2836.9149839878082,770.528103351593,3499.9396781921387,103480,11326,92154,92154,0,10,11983000.0
11983,11983999,22.10134008179522,38.58620910285992,0.04296377553947628,2837.262228012085,770.5913305282593,3500.375255584717,103492,11327,92165,92165,0,10,11984000.0
11984,11984999,22.1011177693407,38.58531276493965,0.04296244466844823,2837.384133577347,770.6531610488892,3500.7744178771973,103492,11327,92165,92165,0,10,11985000.0
11985,11985999,22.1010482793897,38.584544802265754,0.04295590996694865,2837.728935241699,770.7168488502502,3501.249481201172,103494,11328,92166,92166,0,10,11986000.0
11986,11986999,22.101030642667666,38.58388044432929,0.04295133649156313,2837.8515198230743,770.7789635658264,3501.7967224121094,103495,11328,92167,92167,0,10,11987000.0
11987,11987999,22.10135752044272,38.58365619739401,0.04293428657913345,2838.20006108284,770.8420932292938,3502.326431274414,103506,11329,92177,92177,0,10,11988000.0
11988,11988999,22.101583779751138,38.58313631596403,0.042924620741245034,2838.3178446292877,770.9052400588989,3502.9382934570312,103506,11329,92177,92177,0,10,11989000.0
11989,11989999,22.10175083710486,38.58301699462477,0.042912513991473,2838.434398174286,770.9669346809387,3503.476459503174,103506,11329,92177,92177,0,10,11990000.0
11990,11990999,22.101684402069864,38.58271917189981,0.04290880580856449,2839.0218317508698,771.0309031009674,3504.3804931640625,103537,11331,92206,92206,0,10,11991000.0
11991,11991999,22.10135692227491,38.58214410426252,0.04290937477708745,2839.594521045685,771.0932807922363,3504.928192138672,103559,11333,92226,92226,0,10,11992000.0
11992,11992999,22.1010175190147,38.58137620459194,0.04291394190556774,2839.938488483429,771.1555607318878,3505.349136352539,103565,11334,92231,92231,0,10,11993000.0
11993,11993999,22.100669322359394,38.58043877231588,0.04291813497865726,2840.288714170456,771.21741771698,3505.629997253418,103573,11335,92238,92238,0,10,11994000.0
11994,11994999,22.100231760322867,38.579567255230835,0.04292099178485165,2840.8640055656433,771.2801356315613,3505.8316535949707,103588,11337,92251,92251,0,10,11995000.0
11995,11995999,22.099862409235385,38.578626490067755,0.042925748868296365,2840.9881772994995,771.3422274589539,3506.2054290771484,103590,11337,92253,92253,0,10,11996000.0
11996,11996999,22.09956329858845,38.57783519735287,0.04292509960760971,2841.1125395298004,771.4041893482208,3506.5368003845215,103593,11337,92256,92256,0,10,11997000.0
11997,11997999,22.09937268922258,38.577183015933244,0.04292241684609455,2841.232079744339,771.4653956890106,3506.828899383545,103594,11337,92257,92257,0,10,11998000.0
11998,11998999,22.099254307743458,38.57664492714645,0.04291692286722426,2841.348619222641,771.5265185832977,3507.111583709717,103595,11337,92258,92258,0,10,11999000.0
11999,11999999,22.099094894206914,38.57584722521721,0.04291042216806196,2841.471447467804,771.5880835056305,3507.4497413635254,103597,11337,92260,92260,0,10,12000000.0
12000,12000999,22.099113935965185,38.57505824710181,0.04290458397875507,2841.8168177604675,771.6499693393707,3507.73917388916,103606,11338,92268,92268,0,10,12001000.0
12001,12001999,22.099213933166535,38.57444010830445,0.04289475687962452,2842.3926873207092,771.7112441062927,3507.9157943725586,103611,11340,92271,92271,0,10,12002000.0
12002,12002999,22.09949031385534,38.57391741841321,0.042880110144695394,2842.531361103058,771.7855293750763,3508.219551086426,103612,11340,92272,92272,0,10,12003000.0
12003,12003999,22.099477966260018,38.573195023540116,0.042872675582173336,2842.891534805298,771.8487911224365,3508.4584350585938,103622,11341,92281,92281,0,10,12004000.0
12004,12004999,22.099326542204945,38.57231418205606,0.042868297947873946,2843.2333846092224,771.9091820716858,3508.774600982666,103629,11342,92287,92287,0,10,12005000.0
12005,12005999,22.098726134296747,38.571798583447226,0.04287215460466309,2843.3631410598755,771.9717223644257,3510.1217002868652,103632,11342,92290,92290,0,10,12006000.0
12006,12006999,22.098290857749245,38.57380580113271,0.04287142123466281,2843.4853360652924,772.0331857204437,3511.021884918213,103635,11342,92293,92293,0,10,12007000.0
12007,12007999,22.097722698913294,38.57279876635758,0.04288021555000043,2844.060920715332,772.0973443984985,3511.6832733154297,103657,11344,92313,92313,0,10,12008000.0
12008,12008999,22.097231546098133,38.57195941200226,0.0428854289773577,2844.1931612491608,772.1608295440674,3512.253273010254,103657,11344,92313,92313,0,10,12009000.0
12009,12009999,22.096612025823926,38.570826827810265,0.0428945657391584,2844.3166081905365,772.222954750061,3512.8191680908203,103659,11344,92315,92315,0,10,12010000.0
12010,12010999,22.09601866007643,38.569764596649314,0.042899338997738345,2844.435941696167,772.2855448722839,3513.2496490478516,103660,11344,92316,92316,0,10,12011000.0
12011,12011999,22.095453547618206,38.56875683277656,0.04290428062727536,2844.5544135570526,772.3478639125824,3513.748161315918,103660,11344,92316,92316,0,10,12012000.0
12012,12012999,22.09489401814803,38.56817341532789,0.04290674736571598,2844.9170610904694,772.409898519516,3514.1535568237305,103672,11345,92327,92327,0,10,12013000.0
12013,12013999,22.094349829816494,38.56706069595632,0.042910098793928375,2845.035829305649,772.4733693599701,3514.499412536621,103672,11345,92327,92327,0,10,12014000.0
12014,12014999,22.09386251233741,38.56607945303342,0.04291162974904272,2845.6133942604065,772.5368151664734,3514.818878173828,103679,11347,92332,92332,0,10,12015000.0
12015,12015999,22.093368470982234,38.56522881641731,0.04291575278030857,2845.967418193817,772.601446390152,3515.250461578369,103681,11348,92333,92333,0,10,12016000.0
12016,12016999,22.092865170328505,38.56422487428082,0.04291872339313185,2846.5399453639984,772.663703918457,3515.548999786377,103698,11350,92348,92348,0,10,12017000.0
12017,12017999,22.092500424303534,38.56338401659192,0.04292000672429974,2846.8866431713104,772.7264714241028,3515.984764099121,103701,11351,92350,92350,0,10,12018000.0
12018,12018999,22.092199395000634,38.56251339635929,0.04292082887179882,2847.452706336975,772.788916349411,3516.310199737549,103735,11353,92382,92382,0,10,12019000.0
12019,12019999,22.091920782767907,38.56161534886441,0.04292015840692531,2847.798393011093,772.8509016036987,3516.7796173095703,103737,11354,92383,92383,0,10,12020000.0
12020,12020999,22.091588023436653,38.5607311102191,0.04291983429707702,2848.1367287635803,772.9129729270935,3517.0942153930664,103745,11355,92390,92390,0,10,12021000.0
12021,12021999,22.09123323971613,38.5597392131931,0.04291986739855724,2848.4907534122467,772.975841999054,3517.408676147461,103747,11356,92391,92391,0,10,12022000.0
12022,12022999,22.090680868438564,38.558659986830754,0.04292111779533758,2848.8428399562836,773.0386109352112,3517.8917274475098,103760,11357,92403,92403,0,10,12023000.0
12023,12023999,22.090082184020755,38.55772225687135,0.042923005173522544,2848.9797480106354,773.1015810966492,3518.9416885375977,103760,11357,92403,92403,0,10,12024000.0
12024,12024999,22.089198365416458,38.557067155749785,0.04292834713723759,2849.1036746501923,773.1649172306061,3520.0436401367188,103762,11357,92405,92405,0,10,12025000.0
12025,12025999,22.088310838841377,38.555859469543215,0.0429367043727541,2849.8959290981293,773.2277972698212,3520.5707092285156,103779,11360,92419,92419,0,10,12026000.0
12026,12026999,22.087478182383684,38.554720554044835,0.04294444862989488,2850.0132098197937,773.2906959056854,3521.173198699951,103779,11360,92419,92419,0,10,12027000.0
12027,12027999,22.086711835066577,38.553910225073736,0.04294888344632397,2850.3638882637024,773.3545634746552,3521.608127593994,103781,11361,92420,92420,0,10,12028000.0
12028,12028999,22.08604866138092,38.553231488033816,0.042951308303084135,2850.478975534439,773.4168794155121,3522.021625518799,103782,11361,92421,92421,0,10,12029000.0
12029,12029999,22.085285827807162,38.55209821002901,0.04295561177782892,2850.825182199478,773.4787797927856,3522.5232009887695,103786,11362,92424,92424,0,10,12030000.0
12030,12030999,22.08453673708429,38.551033577620416,0.04295959533125082,2851.1657316684723,773.5413157939911,3522.9737854003906,103790,11363,92427,92427,0,10,12031000.0
12031,12031999,22.083891263867216,38.549984406554735,0.04296211799520788,2851.281994819641,773.6040189266205,3523.426040649414,103790,11363,92427,92427,0,10,12032000.0
12032,12032999,22.083215139570314,38.548877064573695,0.042961975343929204,2851.8399119377136,773.6672587394714,3523.7266426086426,103804,11365,92439,92439,0,10,12033000.0
12033,12033999,22.082643496221273,38.547868448750535,0.042961789497417247,2851.958105802536,773.7298927307129,3524.194808959961,103804,11365,92439,92439,0,10,12034000.0
12034,12034999,22.08207908538484,38.54706935384567,0.04296166533020129,2852.3030717372894,773.7920722961426,3524.513324737549,103835,11366,92469,92469,0,10,12035000.0
12035,12035999,22.081474859370392,38.54605343410821,0.04296426510817963,2852.4198393821716,773.8534076213837,3524.8161697387695,103835,11366,92469,92469,0,10,12036000.0
12036,12036999,22.080953022251872,38.545121168099215,0.042965987538405526,2852.5355088710785,773.9159026145935,3525.2500343322754,103835,11366,92469,92469,0,10,12037000.0
12037,12037999,22.080443218810846,38.54417265083669,0.042967790620453306,2852.8894503116608,773.9782226085663,3525.648365020752,103837,11367,92470,92470,0,10,12038000.0
12038,12038999,22.080005056613068,38.543394659670085,0.04296981103142672,2853.2334961891174,774.0413265228271,3526.1522064208984,103839,11368,92471,92471,0,10,12039000.0
12039,12039999,22.079511438813565,38.542434546990286,0.042970512524206805,2853.5968635082245,774.1043653488159,3526.48433303833,103851,11369,92482,92482,0,10,12040000.0
12040,12040999,22.078911715145747,38.541491233984424,0.04297507133594736,2853.718186378479,774.1655702590942,3526.91561126709,103851,11369,92482,92482,0,10,12041000.0
12041,12041999,22.078278223803217,38.54037995866084,0.04297845325317229,2854.2772073745728,774.2283034324646,3527.2570991516113,103866,11371,92495,92495,0,10,12042000.0
12042,12042999,22.077540424398702,38.539148704347674,0.042985021976830295,2854.62548995018,774.2917399406433,3528.467514038086,103875,11372,92503,92503,0,10,12043000.0
12043,12043999,22.076696855490813,38.538226005355625,0.04299246994817518,2854.9720945358276,774.3547086715698,3529.223258972168,103888,11373,92515,92515,0,10,12044000.0
12044,12044999,22.07591453976079,38.53713090611119,0.042999318681970156,2855.5408647060394,774.417649269104,3529.727283477783,103893,11375,92518,92518,0,10,12045000.0
12045,12045999,22.07514229889249,38.53591269567244,0.04300729491176314,2855.89671254158,774.4816241264343,3530.2608375549316,103895,11376,92519,92519,0,10,12046000.0
12046,12046999,22.07437654005064,38.53463489266873,0.04301416419066373,2856.4724564552307,774.5447480678558,3530.585060119629,103900,11378,92522,92522,0,10,12047000.0
12047,12047999,22.073672742521033,38.53348918501641,0.043019588686858734,2856.828048467636,774.6073558330536,3530.9228286743164,103912,11379,92533,92533,0,10,12048000.0
12048,12048999,22.072934274386274,38.532400347462136,0.043025722964240454,2856.9486842155457,774.6695470809937,3531.3736686706543,103913,11379,92534,92534,0,10,12049000.0
12049,12049999,22.072251919467565,38.53142968479453,0.043030246739302,2857.2877192497253,774.7322382926941,3531.8605880737305,103915,11380,92535,92535,0,10,12050000.0
12050,12050999,22.07163927023605,38.53031980012868,0.04303398288198357,2858.0923507213593,774.7939105033875,3532.157516479492,103931,11383,92548,92548,0,10,12051000.0
12051,12051999,22.071059497006477,38.52919639024783,0.04303644206594914,2858.4450249671936,774.8560788631439,3532.4341773986816,103943,11384,92559,92559,0,10,12052000.0
12052,12052999,22.070585817066085,38.528144689636626,0.043038816630413756,2858.5619769096375,774.9177808761597,3532.778953552246,103943,11384,92559,92559,0,10,12053000.0
12053,12053999,22.069982130288597,38.52711352745163,0.04304204819251112,2858.913685798645,774.9801006317139,3533.077808380127,103945,11385,92560,92560,0,10,12054000.0
12054,12054999,22.0694516467079,38.526034202087814,0.043045038721684414,2859.263592004776,775.041933298111,3533.408416748047,103957,11386,92571,92571,0,10,12055000.0
12055,12055999,22.06907681569446,38.52507939013643,0.04304540819803648,2859.829072713852,775.1042242050171,3533.6456413269043,103971,11388,92583,92583,0,10,12056000.0
12056,12056999,22.068939321203523,38.5243611251839,0.0430412656325152,2860.1684985160828,775.1659429073334,3534.139778137207,103973,11389,92584,92584,0,10,12057000.0
12057,12057999,22.068622002330493,38.52338857837224,0.043040776425225635,2860.2868638038635,775.2265133857727,3534.591335296631,103973,11389,92584,92584,0,10,12058000.0
12058,12058999,22.068250030117955,38.522393061492146,0.04304077393510475,2860.84854722023,775.2875382900238,3534.880760192871,104006,11391,92615,92615,0,10,12059000.0
12059,12059999,22.067844346662664,38.521377066486025,0.043042301898602364,2861.635598421097,775.349616765976,3535.2292976379395,104022,11394,92628,92628,0,10,12060000.0
12060,12060999,22.0674386286467,38.522080820880106,0.04304072615958976,2861.7617020606995,775.4108355045319,3535.715377807617,104022,11394,92628,92628,0,10,12061000.0
12061,12061999,22.06679731029647,38.52241999656989,0.043042573539994855,2862.3265855312347,775.4732830524445,3536.6189346313477,104041,11396,92645,92645,0,10,12062000.0
12062,12062999,22.06607556439323,38.52165376722132,0.04304395114881898,2862.6751523017883,775.5351984500885,3537.0657958984375,104046,11397,92649,92649,0,10,12063000.0
12063,12063999,22.065335937556036,38.520472161237045,0.04304925553194883,2863.0276222229004,775.5977461338043,3537.4511375427246,104053,11398,92655,92655,0,10,12064000.0
12064,12064999,22.064681054869798,38.51972998186947,0.04305138868734326,2863.144994497299,775.6598062515259,3537.7953720092773,104053,11398,92655,92655,0,10,12065000.0
12065,12065999,22.064101278993597,38.518754701686454,0.04305365551964002,2863.2646543979645,775.7220597267151,3538.1356506347656,104053,11398,92655,92655,0,10,12066000.0
12066,12066999,22.06357536728217,38.51770002608923,0.04305730941868502,2863.3796401023865,775.784420967102,3538.522575378418,104054,11398,92656,92656,0,10,12067000.0
12067,12067999,22.063007295880002,38.51668769861927,0.043061666681077915,2863.729709625244,775.8465905189514,3538.8168144226074,104067,11399,92668,92668,0,10,12068000.0
12068,12068999,22.06269353469943,38.516042038813715,0.04306312791187539,2864.7526462078094,775.9092099666595,3538.9314727783203,104084,11403,92681,92681,0,10,12069000.0
12069,12069999,22.06238697689054,38.515351160343975,0.04306522843881255,2864.867085456848,775.9705657958984,3539.3004455566406,104084,11403,92681,92681,0,10,12070000.0
12070,12070999,22.06223155166059,38.51510341750028,0.043065328466056485,2864.9904313087463,776.0326845645905,3539.6985054016113,104084,11403,92681,92681,0,10,12071000.0
12071,12071999,22.062264103477485,38.51563312177426,0.043063727994958056,2865.1040995121,776.0939478874207,3539.97220993042,104084,11403,92681,92681,0,10,12072000.0
12072,12072999,22.062228434836562,38.51554280735598,0.04306201718819369,2865.8924658298492,776.1563575267792,3540.20166015625,104107,11406,92701,92701,0,10,12073000.0
12073,12073999,22.06224482286181,38.515608203150904,0.043062021153412844,2866.458385705948,776.2184824943542,3540.5541038513184,104122,11408,92714,92714,0,10,12074000.0
12074,12074999,22.062445633522024,38.516050602105565,0.043057575084348376,2867.0391631126404,776.2817816734314,3540.9173622131348,104138,11410,92728,92728,0,10,12075000.0
12075,12075999,22.062565573767042,38.516142762008414,0.04305692341124534,2867.386349439621,776.3442742824554,3541.351852416992,104150,11411,92739,92739,0,10,12076000.0
12076,12076999,22.062753337312103,38.51643157566727,0.043054138363022076,2868.406597137451,776.4071009159088,3541.5293312072754,104173,11415,92758,92758,0,10,12077000.0
12077,12077999,22.062990259756127,38.51652460021587,0.043054461656429455,2868.9735581874847,776.4693927764893,3541.883140563965,104188,11417,92771,92771,0,10,12078000.0
12078,12078999,22.062971665515136,38.51615695126924,0.04305439165801572,2869.315511226654,776.5321576595306,3542.2749824523926,104191,11418,92773,92773,0,10,12079000.0
12079,12079999,22.06251162901113,38.515266385522864,0.043057679595468135,2870.114045858383,776.5933172702789,3543.1159858703613,104239,11421,92818,92818,0,10,12080000.0
12080,12080999,22.061780382589372,38.51448688528653,0.04306236695982857,2870.246957540512,776.6568698883057,3543.7950286865234,104239,11421,92818,92818,0,10,12081000.0
12081,12081999,22.06110196148297,38.51351237464104,0.04306726576903852,2871.0526192188263,776.7188591957092,3544.176357269287,104265,11424,92841,92841,0,10,12082000.0
12082,12082999,22.060394591748377,38.51227955837138,0.04307357537973566,2871.3993854522705,776.781133890152,3544.6606369018555,104273,11425,92848,92848,0,10,12083000.0
12083,12083999,22.059747116826248,38.511406084681525,0.04307578461131267,2871.5155308246613,776.8432829380035,3545.095558166504,104273,11425,92848,92848,0,10,12084000.0
12084,12084999,22.059109011173852,38.51028476024142,0.0430791917285418,2872.3403141498566,776.9078924655914,3545.3379135131836,104307,11428,92879,92879,0,10,12085000.0
12085,12085999,22.058407029763885,38.5090973277887,0.043084154559642984,2872.6875529289246,776.9695007801056,3545.7640495300293,104319,11429,92890,92890,0,10,12086000.0
12086,12086999,22.05780660940788,38.508029719986766,0.04308645165906466,2872.809076309204,777.0317771434784,3546.2122230529785,104319,11429,92890,92890,0,10,12087000.0
12087,12087999,22.05721414825845,38.50693843951013,0.04308925357732463,2872.928570508957,777.0932219028473,3546.628978729248,104319,11429,92890,92890,0,10,12088000.0
12088,12088999,22.05671660275869,38.50589236873908,0.0430912342100781,2873.2711799144745,777.154767036438,3546.866600036621,104322,11430,92892,92892,0,10,12089000.0
12089,12089999,22.0562086295183,38.504879989181894,0.04309201308806432,2873.6159076690674,777.2165138721466,3547.2850914001465,104333,11431,92902,92902,0,10,12090000.0
12090,12090999,22.055704884479567,38.503857700796594,0.04309317837048465,2874.1792278289795,777.2775394916534,3547.5352478027344,104337,11433,92904,92904,0,10,12091000.0
12091,12091999,22.055227870668492,38.502888395094075,0.043093706761714534,2874.976078271866,777.3396184444427,3547.6494331359863,104365,11436,92929,92929,0,10,12092000.0
12092,12092999,22.054726500033624,38.50180521166722,0.04309327645529659,2875.3249237537384,777.4017577171326,3548.054531097412,104377,11437,92940,92940,0,10,12093000.0
12093,12093999,22.05441555817995,38.50100595043082,0.04309129084826835,2875.4548819065094,777.4643311500549,3548.4683799743652,104377,11437,92940,92940,0,10,12094000.0
12094,12094999,22.05409204289786,38.500101268469024,0.04308912561905054,2875.576911211014,777.5256617069244,3548.952007293701,104380,11437,92943,92943,0,10,12095000.0
12095,12095999,22.053684220621644,38.499061056780945,0.043088401126890497,2876.381063938141,777.5875768661499,3549.0761337280273,104416,11440,92976,92976,0,10,12096000.0
12096,12096999,22.053210871576496,38.49796746765364,0.04308701129816328,2876.49432182312,777.6503765583038,3549.5123748779297,104416,11440,92976,92976,0,10,12097000.0
12097,12097999,22.05271353647306,38.49693474010831,0.04308544705854833,2876.842567920685,777.711391210556,3549.901885986328,104421,11441,92980,92980,0,10,12098000.0
12098,12098999,22.052141269154387,38.496283659370306,0.04308734493321864,2877.192050933838,777.7738938331604,3550.851718902588,104435,11442,92993,92993,0,10,12099000.0
12099,12099999,22.051536665614634,38.49619542649664,0.04309072341089626,2877.765727996826,777.8357725143433,3551.3401527404785,104440,11444,92996,92996,0,10,12100000.0
12100,12100999,22.05083797357313,38.49552796480227,0.043096268677269234,2877.899765253067,777.8996622562408,3551.8897132873535,104440,11444,92996,92996,0,10,12101000.0
12101,12101999,22.050303318038413,38.494619006459835,0.04309861392301384,2878.019557237625,777.9618346691132,3552.3178939819336,104440,11444,92996,92996,0,10,12102000.0
12102,12102999,22.04973174471272,38.49361628113713,0.04310244221846038,2878.588259935379,778.0248894691467,3552.62446975708,104444,11446,92998,92998,0,10,12103000.0
12103,12103999,22.049210694262026,38.492847924812104,0.04310408100255414,2878.9273884296417,778.184522151947,3552.9722061157227,104458,11447,93011,93011,0,10,12104000.0
12104,12104999,22.04877486972012,38.49212392331725,0.0431054758193512,2879.042317390442,778.2446944713593,3553.3094787597656,104459,11447,93012,93012,0,10,12105000.0
12105,12105999,22.048406907967546,38.49130368860722,0.04310788754704176,2879.620870113373,778.3057136535645,3553.5236282348633,104484,11449,93035,93035,0,10,12106000.0
12106,12106999,22.048150451201913,38.49081928106912,0.043109777532541305,2879.976475715637,778.3680555820465,3553.8952865600586,104487,11450,93037,93037,0,10,12107000.0
12107,12107999,22.04792758083426,38.49027937561922,0.04311173229746279,2880.5438141822815,778.4295873641968,3554.230327606201,104493,11452,93041,93041,0,10,12108000.0
12108,12108999,22.047892313114264,38.4905902876877,0.043108618604795756,2880.6595640182495,778.4908862113953,3554.6117820739746,104494,11452,93042,93042,0,10,12109000.0
12109,12109999,22.047974868692776,38.490497280946634,0.04310838768251579,2880.776402950287,778.5520968437195,3555.0267601013184,104497,11452,93045,93045,0,10,12110000.0
12110,12110999,22.048033663010212,38.49036788115543,0.04310778835989193,2881.3437464237213,778.6136047840118,3555.424945831299,104512,11454,93058,93058,0,10,12111000.0
12111,12111999,22.048008461734245,38.489929455005175,0.043106298034293666,2881.6863663196564,778.6742503643036,3555.7842178344727,104515,11455,93060,93060,0,10,12112000.0
12112,12112999,22.047871323770924,38.4893352613624,0.043102540328735284,2882.0382108688354,778.7365505695343,3556.9067878723145,104521,11456,93065,93065,0,10,12113000.0
12113,12113999,22.047343038242506,38.48833411265899,0.043105263964043794,2882.8371403217316,778.7986118793488,3557.6765327453613,104529,11459,93070,93070,0,10,12114000.0
12114,12114999,22.04690445557517,38.487698633909055,0.04310584230156622,2883.19397854805,778.8613240718842,3558.1447677612305,104532,11460,93072,93072,0,10,12115000.0
12115,12115999,22.046459457933587,38.4874032468306,0.043104356641499475,2883.3317182064056,778.9312171936035,3558.5797538757324,104532,11460,93072,93072,0,10,12116000.0
12116,12116999,22.046161192771432,38.487039739811074,0.0431031472522907,2883.6756160259247,778.9925456047058,3558.8886108398438,104542,11461,93081,93081,0,10,12117000.0
12117,12117999,22.04577517910685,38.48634184252133,0.043101856118964554,2884.048182964325,779.0593276023865,3559.2510833740234,104544,11462,93082,93082,0,10,12118000.0
12118,12118999,22.045358473429573,38.485477902032606,0.04310234017508452,2884.1706342697144,779.1216325759888,3559.7132987976074,104545,11462,93083,93083,0,10,12119000.0
12119,12119999,22.044970996324803,38.484665451646975,0.04310401072552117,2884.5210733413696,779.1844923496246,3560.007556915283,104547,11463,93084,93084,0,10,12120000.0
12120,12120999,22.04464213559876,38.483987808019464,0.043102454993748096,2884.6428620815277,779.2454612255096,3560.305953979492,104547,11463,93084,93084,0,10,12121000.0
12121,12121999,22.04446638929136,38.48350176885137,0.04309863512349732,2884.7624385356903,779.3067698478699,3560.6485595703125,104547,11463,93084,93084,0,10,12122000.0
12122,12122999,22.04426318047392,38.483937183056156,0.04309201770826887,2885.1161193847656,779.3695695400238,3560.9985694885254,104557,11464,93093,93093,0,10,12123000.0
12123,12123999,22.04399735819792,38.48337561831138,0.04308908012522639,2885.2348539829254,779.4306719303131,3561.2777404785156,104557,11464,93093,93093,0,10,12124000.0
12124,12124999,22.04374783776483,38.48260015508699,0.04308668209857669,2886.0236513614655,779.4931683540344,3561.474765777588,104567,11467,93100,93100,0,10,12125000.0
12125,12125999,22.043446663387375,38.481654042884045,0.04308445617607981,2886.590619325638,779.5548412799835,3561.909767150879,104577,11469,93108,93108,0,10,12126000.0
12126,12126999,22.04328703975224,38.48103161837522,0.04307968370533655,2886.94597864151,779.6165130138397,3562.3986892700195,104589,11470,93119,93119,0,10,12127000.0
12127,12127999,22.043038881309595,38.480892906372766,0.043074701099859114,2887.295170068741,779.6791203022003,3562.6433296203613,104591,11471,93120,93120,0,10,12128000.0
12128,12128999,22.04267774298057,38.47993056520864,0.04307506854413201,2887.4213292598724,779.7404952049255,3563.0916061401367,104591,11471,93120,93120,0,10,12129000.0
12129,12129999,22.042110217410244,38.47880041155694,0.04307649481129361,2887.985490322113,779.8015825748444,3563.379222869873,104614,11473,93141,93141,0,10,12130000.0
12130,12130999,22.0414742476877,38.478088895315075,0.043080354818569866,2888.124814271927,779.8651578426361,3564.6550254821777,104615,11473,93142,93142,0,10,12131000.0
12131,12131999,22.0407747983417,38.47784193245885,0.04308300823360112,2888.2433800697327,779.9274442195892,3565.4935417175293,104617,11473,93144,93144,0,10,12132000.0
12132,12132999,22.04014816152886,38.47800567615561,0.043085418142771004,2888.362696170807,779.9885876178741,3565.9382934570312,104617,11473,93144,93144,0,10,12133000.0
12133,12133999,22.039484771693175,38.477215248615316,0.043087880476638585,2888.4785759449005,780.0502009391785,3566.4047622680664,104617,11473,93144,93144,0,10,12134000.0
12134,12134999,22.038906203645517,38.476274951938294,0.04309038066159199,2888.5994198322296,780.1110763549805,3566.8225135803223,104619,11473,93146,93146,0,10,12135000.0
12135,12135999,22.038382487111637,38.475485238268305,0.043094164898330956,2888.9535732269287,780.1739418506622,3567.24946975708,104631,11474,93157,93157,0,10,12136000.0
12136,12136999,22.03766582839869,38.47433560234329,0.04309771281653085,2889.0681138038635,780.235668182373,3567.627769470215,104631,11474,93157,93157,0,10,12137000.0
12137,12137999,22.037159545090635,38.47376473571027,0.04309760976399646,2889.405848503113,780.2982740402222,3568.000312805176,104643,11475,93168,93168,0,10,12138000.0
12138,12138999,22.036627410720453,38.47305140187939,0.04309724485165911,2890.195470571518,780.3609118461609,3568.290096282959,104655,11478,93177,93177,0,10,12139000.0
12139,12139999,22.036150592760215,38.47234353154144,0.043098415066180173,2890.762456178665,780.4245188236237,3568.530055999756,104679,11480,93199,93199,0,10,12140000.0
12140,12140999,22.03581734697719,38.47186138452548,0.043097403280471513,2891.342642068863,780.4862995147705,3568.9326972961426,104703,11482,93221,93221,0,10,12141000.0
12141,12141999,22.03551412313615,38.47133875872282,0.043096066418572,2891.9197800159454,780.5503146648407,3569.3409271240234,104727,11484,93243,93243,0,10,12142000.0
12142,12142999,22.035478154529066,38.471105899405515,0.04309445768106179,2892.726144552231,780.6173341274261,3569.702869415283,104752,11487,93265,93265,0,10,12143000.0
12143,12143999,22.03580021634842,38.471539016822746,0.04309384797142246,2892.845598459244,780.678952217102,3570.239025115967,104753,11487,93266,93266,0,10,12144000.0
12144,12144999,22.036475812011627,38.47238169261019,0.043100503792643186,2893.414575815201,780.7407574653625,3570.711483001709,104778,11489,93289,93289,0,10,12145000.0
12145,12145999,22.037181832937563,38.473324463001354,0.043095772438480284,2893.977876663208,780.8045082092285,3571.2086486816406,104803,11491,93312,93312,0,10,12146000.0
12146,12146999,22.037619127334192,38.47353342211901,0.04309401063541307,2894.332792043686,780.8690333366394,3571.6821060180664,104815,11492,93323,93323,0,10,12147000.0
12147,12147999,22.03791771365626,38.47356823845209,0.0430898562020966,2894.706566095352,780.9340240955353,3572.11279296875,104817,11493,93324,93324,0,10,12148000.0
12148,12148999,22.03800381422632,38.47326979984482,0.043088038812782115,2894.8175950050354,780.994882106781,3572.4932823181152,104817,11493,93324,93324,0,10,12149000.0
12149,12149999,22.037559127159717,38.473109673648935,0.043084397482139214,2895.847201347351,781.0577962398529,3573.278553009033,104845,11497,93348,93348,0,10,12150000.0
12150,12150999,22.037308082604525,38.47370690542356,0.04308189657342554,2895.9841759204865,781.1208071708679,3573.8560752868652,104847,11497,93350,93350,0,10,12151000.0
12151,12151999,22.03731919915005,38.4745528518214,0.04308749675307022,2896.3365445137024,781.1841540336609,3574.3161811828613,104853,11498,93355,93355,0,10,12152000.0
12152,12152999,22.03729116994961,38.475034379659704,0.04308978953996767,2896.4674954414368,781.2462997436523,3574.715362548828,104855,11498,93357,93357,0,10,12153000.0
12153,12153999,22.037597967505164,38.477085918284416,0.043088216143569724,2896.82245016098,781.3097658157349,3575.061721801758,104858,11499,93359,93359,0,10,12154000.0
12154,12154999,22.03802159285075,38.47869391470318,0.043086919341409624,2897.613317966461,781.3727583885193,3575.3322257995605,104875,11502,93373,93373,0,10,12155000.0
12155,12155999,22.038430643566496,38.479916847366084,0.04308802875454343,2898.189909696579,781.4367320537567,3575.795322418213,104889,11504,93385,93385,0,10,12156000.0
12156,12156999,22.038675247064855,38.48079591676771,0.043092554062033606,2898.532610654831,781.4990544319153,3576.1499671936035,104895,11505,93390,93390,0,10,12157000.0
12157,12157999,22.03908704381894,38.48166380985993,0.04310096056767876,2899.554820537567,781.5632374286652,3576.410457611084,104919,11509,93410,93410,0,10,12158000.0
12158,12158999,22.039330094102386,38.48192166988908,0.043105255913097995,2900.1208567619324,781.6267898082733,3576.737781524658,104946,11511,93435,93435,0,10,12159000.0
12159,12159999,22.039531744808187,38.481955223453305,0.043104131377705635,2900.4801490306854,781.6893112659454,3577.0802154541016,104948,11512,93436,93436,0,10,12160000.0
12160,12160999,22.039829408745693,38.48211782375494,0.04309885009535086,2901.2778928279877,781.7521951198578,3577.32706451416,104969,11515,93454,93454,0,10,12161000.0
12161,12161999,22.03997994836803,38.482084320416575,0.04309572556628005,2901.6250314712524,781.8158493041992,3577.8046112060547,104976,11516,93460,93460,0,10,12162000.0
12162,12162999,22.04017613786367,38.481931490873905,0.04309170467890222,2901.7374217510223,781.8780853748322,3578.19132232666,104976,11516,93460,93460,0,10,12163000.0
12163,12163999,22.04047204658658,38.481835385079,0.04308320735930615,2902.529376268387,781.9413108825684,3578.3960037231445,104982,11519,93463,93463,0,10,12164000.0
12164,12164999,22.040535798302216,38.48137152735791,0.04307758001845641,2902.8752269744873,782.0031967163086,3578.7665824890137,104990,11520,93470,93470,0,10,12165000.0
12165,12165999,22.04039921469702,38.48061658535257,0.04307303222448455,2903.454534292221,782.0671105384827,3579.0332412719727,105005,11522,93483,93483,0,10,12166000.0
12166,12166999,22.040241574612224,38.48016050923656,0.043062193045816155,2903.812744617462,782.1307249069214,3579.983196258545,105016,11523,93493,93493,0,10,12167000.0
12167,12167999,22.0398118236874,38.479332077513625,0.04305532489704855,2904.1776974201202,782.2021431922913,3580.567150115967,105018,11524,93494,93494,0,10,12168000.0
12168,12168999,22.03940498666223,38.47839390368389,0.043044581663367776,2905.1990220546722,782.2643775939941,3580.8946266174316,105033,11528,93505,93505,0,10,12169000.0
12169,12169999,22.039138623124984,38.47756116637335,0.04303169126046802,2905.5803661346436,782.3288240432739,3581.4078102111816,105038,11529,93509,93509,0,10,12170000.0
12170,12170999,22.03882858409902,38.47670301710998,0.04302016325737168,2906.3747792243958,782.3928101062775,3581.71484375,105052,11532,93520,93520,0,10,12171000.0
12171,12171999,22.038452314019114,38.47573992261796,0.04301222836445362,2906.949505329132,782.4555456638336,3582.0633392333984,105059,11534,93525,93525,0,10,12172000.0
12172,12172999,22.038233243034302,38.47493714738138,0.04299920333801366,2907.5246109962463,782.5192856788635,3582.414970397949,105075,11536,93539,93539,0,10,12173000.0
12173,12173999,22.037947923029165,38.47406224379411,0.042990999326718016,2907.647810935974,782.5813233852386,3582.8021965026855,105075,11536,93539,93539,0,10,12174000.0
12174,12174999,22.037669748922195,38.47315826173473,0.042983579953100426,2908.001151561737,782.6444211006165,3583.1123390197754,105087,11537,93550,93550,0,10,12175000.0
12175,12175999,22.03742719436885,38.47236294509584,0.04297668649947961,2908.129916906357,782.7075304985046,3583.460403442383,105088,11537,93551,93551,0,10,12176000.0
12176,12176999,22.037213077855807,38.47152926129839,0.04296815925255415,2908.4705770015717,782.7695715427399,3583.7851181030273,105100,11538,93562,93562,0,10,12177000.0
12177,12177999,22.037023473857648,38.47089977647153,0.042961364697934545,2908.5998940467834,782.8320543766022,3584.1785049438477,105100,11538,93562,93562,0,10,12178000.0
12178,12178999,22.036824362476917,38.47006892322295,0.04295517727027698,2908.9564855098724,782.8941669464111,3584.507049560547,105102,11539,93563,93563,0,10,12179000.0
12179,12179999,22.03665075804611,38.46943607693829,0.04294690183571226,2909.0683970451355,782.9562287330627,3584.871971130371,105102,11539,93563,93563,0,10,12180000.0
12180,12180999,22.036581941929185,38.46885874506143,0.04293618899684015,2909.6591889858246,783.0194327831268,3585.1204109191895,105126,11541,93585,93585,0,10,12181000.0
