,n_samples,MAE,RMSE,R2,time_learning,time_predicting,memory,n_nodes,n_branches,n_leaves,n_active_leaves,n_inactive_leaves,height,total_observed_weight
0,999,19.867015928127724,38.00448242008178,-0.01782475739203293,0.3701951503753662,0.06339216232299805,0.49860382080078125,3,1,2,2,0,2,1000.0
1,1999,20.8843967220431,42.95187161421621,-0.008044686439066417,0.7926332950592041,0.11995196342468262,0.554107666015625,3,1,2,2,0,2,2000.0
2,2999,20.100442043894578,39.64253763871351,-0.0027343882439858636,1.1085400581359863,0.2111523151397705,1.0723457336425781,16,2,14,14,0,3,3000.0
3,3999,20.331337733015673,44.59224465306392,0.0030623004383657504,1.4027059078216553,0.26390695571899414,1.9140968322753906,16,2,14,14,0,3,4000.0
4,4999,19.887145815600572,42.07681729952291,0.003704539984327404,1.6974024772644043,0.3172893524169922,2.574230194091797,16,2,14,14,0,3,5000.0
5,5999,19.51443079245598,40.618604895969206,0.004156896876601812,2.0728931427001953,0.3711392879486084,2.4949302673339844,19,3,16,16,0,3,6000.0
6,6999,19.462291324079814,39.52640417392981,0.005307746676753822,2.429882764816284,0.42541003227233887,2.510448455810547,20,4,16,16,0,4,7000.0
7,7999,19.66021154439532,39.00738442588309,0.005531458901030795,2.8087637424468994,0.47994542121887207,2.5604209899902344,20,4,16,16,0,4,8000.0
8,8999,20.03309939398553,39.18159191019022,0.008418299310291588,3.2166004180908203,0.5774633884429932,2.332477569580078,22,5,17,17,0,4,9000.0
9,9999,20.58459111505751,39.8205324560269,0.012476505982947028,3.5028252601623535,0.6313841342926025,2.8626747131347656,22,5,17,17,0,4,10000.0
10,10999,20.73325389626183,39.44956564968678,0.019768838315513015,3.833317756652832,0.6866965293884277,2.8085975646972656,26,7,19,19,0,5,11000.0
11,11999,20.8783226908439,39.08878379236783,0.026358708858770563,4.184695720672607,0.7418491840362549,2.7437477111816406,27,8,19,19,0,6,12000.0
12,12999,21.380941558890214,40.267490327366396,0.03572687572956401,4.499792814254761,0.7975733280181885,3.022846221923828,27,8,19,19,0,6,13000.0
13,13999,21.89366335615111,40.61946819995299,0.04943795483755342,4.906259775161743,0.852271556854248,2.848278045654297,27,8,19,19,0,6,14000.0
14,14999,22.366526935325474,41.01417101400695,0.05538979394737942,5.318551301956177,0.9070682525634766,2.9652671813964844,27,8,19,19,0,6,15000.0
15,15999,22.560421749880522,40.894524948749876,0.05952033444674909,5.640243053436279,0.9633371829986572,3.215221405029297,27,8,19,19,0,6,16000.0
16,16999,22.903117331850577,41.2674008072004,0.06577864809229383,5.978666067123413,1.0190613269805908,3.080646514892578,28,9,19,19,0,7,17000.0
17,17999,23.23255313370371,41.25024523173541,0.06492430353051815,6.324512481689453,1.0752477645874023,3.071338653564453,28,9,19,19,0,7,18000.0
18,18999,23.300459725004814,40.95567535927363,0.0632388204130917,6.650951623916626,1.1321141719818115,3.082019805908203,29,10,19,19,0,8,19000.0
19,19999,23.113558158458538,40.61746427761776,0.06114184645021348,6.945295333862305,1.187690019607544,3.560619354248047,32,11,21,21,0,8,20000.0
20,20999,22.811934270727846,40.29257194983077,0.05976019272482791,7.308670997619629,1.2416751384735107,3.6917686462402344,47,12,35,35,0,8,21000.0
21,21999,22.53954716759064,39.803668429592726,0.058991986744967195,7.589221239089966,1.2972815036773682,4.8304290771484375,48,12,36,36,0,8,22000.0
22,22999,22.32748041454608,39.5649610390967,0.05730264076681146,7.806967496871948,1.352813482284546,5.647880554199219,48,12,36,36,0,8,23000.0
23,23999,22.112592372971363,39.077207546626845,0.05739969873448203,8.166852235794067,1.408214807510376,5.801033020019531,48,12,36,36,0,8,24000.0
24,24999,21.886275829366728,38.65097372818522,0.057498769452895004,8.339873313903809,1.4632012844085693,6.737892150878906,48,12,36,36,0,8,25000.0
25,25999,21.713313609048477,38.336835299476505,0.05658888294654607,8.754339933395386,1.5193939208984375,6.344200134277344,48,12,36,36,0,8,26000.0
26,26999,21.576771159862453,38.01165665665681,0.05518398528622115,9.224287509918213,1.57505464553833,5.824928283691406,48,12,36,36,0,8,27000.0
27,27999,21.43630218584267,37.724543300967945,0.054703005355079215,9.626660346984863,1.6302235126495361,5.952850341796875,48,12,36,36,0,8,28000.0
28,28999,21.32203022880481,37.61179593438767,0.05319857380215365,9.873119831085205,1.6853961944580078,6.426521301269531,48,12,36,36,0,8,29000.0
29,29999,21.225909157546784,37.355017481155365,0.051981562224909905,10.10468602180481,1.7396295070648193,6.867023468017578,51,13,38,38,0,8,30000.0
30,30999,21.162104799683178,37.49897516936139,0.050912878553234786,10.491390943527222,1.7962219715118408,6.597797393798828,51,13,38,38,0,8,31000.0
31,31999,21.071083285530975,37.25043197548739,0.050500760471517636,10.860281705856323,1.8526809215545654,6.522785186767578,51,13,38,38,0,8,32000.0
32,32999,21.024803699910446,37.140196479285464,0.04965902783024201,11.153803586959839,1.9099745750427246,6.798259735107422,51,13,38,38,0,8,33000.0
33,33999,20.967982251205736,36.96801817806126,0.04954652081971023,11.416046380996704,1.9644596576690674,6.959484100341797,55,15,40,40,0,8,34000.0
34,34999,20.921206515158293,36.842808155565855,0.04920677818762076,11.907914400100708,2.0204415321350098,6.583538055419922,55,15,40,40,0,8,35000.0
35,35999,20.922754305449644,36.72018339160493,0.04882148878590764,12.28544020652771,2.0754380226135254,6.313327789306641,57,16,41,41,0,8,36000.0
36,36999,20.8792114038142,36.55698164785698,0.04885258177528673,12.593986749649048,2.1301417350769043,6.471523284912109,57,16,41,41,0,8,37000.0
37,37999,20.850397993485267,36.37370554036166,0.048366025897475184,13.010138988494873,2.185809373855591,6.200481414794922,57,16,41,41,0,8,38000.0
38,38999,20.806673828927195,36.211629187272486,0.04781527737521929,13.269946575164795,2.241307258605957,6.709934234619141,57,16,41,41,0,8,39000.0
39,39999,20.731137756348886,36.01983389438315,0.04806286352661027,13.623531579971313,2.2966148853302,6.772899627685547,57,16,41,41,0,8,40000.0
40,40999,20.640691546741046,35.88072197105932,0.04789556907774073,13.950010061264038,2.408926486968994,7.048549652099609,60,17,43,43,0,8,41000.0
41,41999,20.495836436117415,35.6217681700906,0.0483262132223905,14.294781923294067,2.4645376205444336,7.143604278564453,60,17,43,43,0,8,42000.0
42,42999,20.362215551973136,35.39846345608734,0.04865692089918794,14.614490509033203,2.5193984508514404,7.332836151123047,60,17,43,43,0,8,43000.0
43,43999,20.21575403553612,35.14678089737141,0.04916217218243912,14.93789005279541,2.5749566555023193,7.379871368408203,63,18,45,45,0,8,44000.0
44,44999,20.095362910958283,34.94372406124997,0.04972431288616219,15.336395025253296,2.6286768913269043,7.199634552001953,63,18,45,45,0,8,45000.0
45,45999,19.954461383889683,34.687905557891035,0.05055743351553943,15.677043199539185,2.682762384414673,7.304798126220703,63,18,45,45,0,8,46000.0
46,46999,19.83084212885431,34.47018972564954,0.050828655791110955,16.073508977890015,2.7526113986968994,7.279842376708984,63,18,45,45,0,8,47000.0
47,47999,19.728251836927264,34.35140288782614,0.050703937115113784,16.39613628387451,2.8103034496307373,7.542499542236328,65,19,46,46,0,8,48000.0
48,48999,19.671542296850788,34.34453908628386,0.049802834005379215,16.757943153381348,2.8673667907714844,7.262821197509766,67,21,46,46,0,8,49000.0
49,49999,19.60057731094179,34.31213130808447,0.04930923635176587,17.103246212005615,2.937837839126587,7.571819305419922,67,21,46,46,0,8,50000.0
50,50999,19.572277510806178,34.280724977845516,0.04845777462579015,17.32219934463501,2.9951438903808594,8.155986785888672,67,21,46,46,0,8,51000.0
51,51999,19.53724320506889,34.16897326312337,0.04980867398354305,17.77142024040222,3.05173921585083,7.545215606689453,69,22,47,47,0,8,52000.0
52,52999,19.481692798155642,34.04781449293416,0.050058098513972915,18.11471700668335,3.1153957843780518,7.858470916748047,69,22,47,47,0,8,53000.0
53,53999,19.464084166622893,34.0128125737038,0.04961693027622316,18.454299449920654,3.1708641052246094,7.951564788818359,69,22,47,47,0,8,54000.0
54,54999,19.450954400566193,33.95651524887494,0.05007162281038391,18.799856424331665,3.2886319160461426,8.000507354736328,69,22,47,47,0,8,55000.0
55,55999,19.455075599278473,33.920583448306175,0.05058699522605514,19.15251588821411,3.3449666500091553,7.980419158935547,69,22,47,47,0,8,56000.0
56,56999,19.459255255103773,33.878411510064396,0.05039246494302185,19.477738857269287,3.4020164012908936,8.164955139160156,115,23,92,92,0,8,57000.0
57,57999,19.476645221753554,33.84679466993136,0.0497896320031298,19.821812629699707,3.4589264392852783,8.072044372558594,116,24,92,92,0,8,58000.0
58,58999,19.4783645056221,33.78182470164564,0.04970569962231175,20.154163122177124,3.5168356895446777,8.237869262695312,116,24,92,92,0,8,59000.0
59,59999,19.502622031516964,33.7448201510651,0.04887122666295507,20.451029777526855,3.5734784603118896,8.111572265625,121,27,94,94,0,9,60000.0
60,60999,19.544357380308522,33.881176536578906,0.04759250334110876,20.73904037475586,3.6311445236206055,8.697006225585938,122,27,95,95,0,9,61000.0
61,61999,19.48403775198706,33.76843262093116,0.04761252491386925,20.98069715499878,3.749568223953247,9.405914306640625,126,28,98,98,0,9,62000.0
62,62999,19.40591692680022,33.67966745117874,0.04764670847295438,21.348400115966797,3.8047220706939697,9.447479248046875,126,28,98,98,0,9,63000.0
63,63999,19.3388800133466,33.62092940327408,0.04744874299281787,21.734466075897217,3.859545946121216,9.399505615234375,126,28,98,98,0,9,64000.0
64,64999,19.27308697623216,33.490141333450445,0.046726617959798045,21.99376082420349,3.9157419204711914,9.945075988769531,126,28,98,98,0,9,65000.0
65,65999,19.248846029970807,33.47842973714012,0.046127083092081134,22.26403284072876,3.9715936183929443,10.377853393554688,126,28,98,98,0,9,66000.0
66,66999,19.237834521136236,33.52993782667544,0.045262435739211404,22.700618028640747,4.0273096561431885,9.973854064941406,128,29,99,99,0,9,67000.0
67,67999,19.222585522343177,33.487622650768905,0.044633664137928575,23.005064010620117,4.083845138549805,9.739311218261719,132,32,100,100,0,9,68000.0
68,68999,19.285655062886388,33.583386757321236,0.043761687970881535,23.42874240875244,4.139559745788574,9.862838745117188,132,32,100,100,0,9,69000.0
69,69999,19.357275497894083,33.928606013606526,0.043046702937584835,23.808109760284424,4.196104288101196,9.72509765625,134,33,101,101,0,9,70000.0
70,70999,19.437806177612895,34.08288068615722,0.04863745140040521,24.105388879776,4.253236532211304,9.834854125976562,136,34,102,102,0,9,71000.0
71,71999,19.543670158985943,34.25946456209549,0.05277332091319287,24.481577157974243,4.309953212738037,9.870536804199219,136,34,102,102,0,9,72000.0
72,72999,19.63817301447992,34.645148549092006,0.05239366121428224,24.857657194137573,4.367359638214111,9.710098266601562,140,35,105,105,0,9,73000.0
73,73999,19.723866887149754,34.87617137639189,0.057375984299756655,25.126301050186157,4.424523830413818,10.137458801269531,140,35,105,105,0,9,74000.0
74,74999,19.827527140698802,35.01586327452243,0.05864031902173794,25.45598602294922,4.551649570465088,10.173416137695312,141,36,105,105,0,9,75000.0
75,75999,19.93662550146256,35.148214993354195,0.06013412328603762,25.834925889968872,4.610321283340454,9.903915405273438,145,37,108,108,0,9,76000.0
76,76999,20.096116655522362,35.63493754864951,0.05858496996611129,26.311408758163452,4.6678102016448975,9.310127258300781,147,38,109,109,0,9,77000.0
77,77999,20.252782151322428,35.836692180436174,0.059247828207628084,26.51177716255188,4.7261269092559814,10.027351379394531,148,39,109,109,0,9,78000.0
78,78999,20.38244009651069,35.98847748143795,0.05974964461058152,26.81500506401062,4.7846174240112305,10.310897827148438,148,39,109,109,0,9,79000.0
79,79999,20.529364371957985,36.130362176485576,0.05926737475281141,27.17372179031372,4.842739582061768,10.324623107910156,148,39,109,109,0,9,80000.0
80,80999,20.633795512064015,36.201830300531995,0.05942176303113034,27.509445667266846,4.90050196647644,10.274375915527344,149,40,109,109,0,10,81000.0
81,81999,20.644609816465927,36.20278419037365,0.0580767860000555,27.80081796646118,4.964660167694092,11.289085388183594,161,42,119,119,0,10,82000.0
82,82999,20.61634762994648,36.189611505669596,0.057596771442424255,28.064406633377075,5.0226452350616455,11.963752746582031,161,42,119,119,0,10,83000.0
83,83999,20.572142976921604,36.08035201925635,0.057616660556639165,28.339468002319336,5.080393314361572,12.370292663574219,161,42,119,119,0,10,84000.0
84,84999,20.547064860215507,36.00609893874235,0.05722986489254833,28.74463152885437,5.138561248779297,12.294563293457031,179,45,134,134,0,10,85000.0
85,85999,20.56509445718886,36.05233600883528,0.05694124660726896,28.92318892478943,5.201982259750366,13.536018371582031,181,46,135,135,0,10,86000.0
86,86999,20.55392038724183,36.00176544714352,0.05654348948220611,29.189220190048218,5.259275913238525,14.34649658203125,187,48,139,139,0,10,87000.0
87,87999,20.59820329688966,36.05621500130825,0.05687979656876618,29.504892826080322,5.315659046173096,14.624946594238281,189,49,140,140,0,10,88000.0
88,88999,20.64298956953271,36.11610128378859,0.05687230701660262,29.725648880004883,5.374198913574219,15.298538208007812,190,49,141,141,0,10,89000.0
89,89999,20.69540889959153,36.158674939040644,0.05767669088694194,30.007553100585938,5.43147349357605,15.45306396484375,192,50,142,142,0,10,90000.0
90,90999,20.760938634834837,36.23268924571208,0.05787095416939536,30.40104579925537,5.489426374435425,14.840751647949219,200,54,146,146,0,10,91000.0
91,91999,20.8429493894511,36.34900554448647,0.05895964346734006,30.71292471885681,5.546892881393433,15.165451049804688,200,54,146,146,0,10,92000.0
92,92999,20.9510866295908,36.568166486358166,0.06046584205787742,31.012067079544067,5.605424642562866,15.315330505371094,204,56,148,148,0,10,93000.0
93,93999,21.03990384205763,36.68726844155822,0.061538535989642984,31.39202642440796,5.663622617721558,15.569999694824219,206,57,149,149,0,10,94000.0
94,94999,21.110976135637905,36.75274474719267,0.0628505989937459,31.536553382873535,5.721299171447754,16.655860900878906,206,57,149,149,0,10,95000.0
95,95999,21.204277909464654,36.87537762728555,0.06578264477839912,32.07167720794678,5.77975869178772,15.737228393554688,208,58,150,150,0,10,96000.0
96,96999,21.315361101823814,37.01611252508917,0.06725961975118955,32.29012632369995,5.837438106536865,16.550125122070312,208,58,150,150,0,10,97000.0
97,97999,21.440313750561906,37.31714334364883,0.06807493731695036,32.564831495285034,5.89443302154541,16.68378448486328,212,60,152,152,0,10,98000.0
98,98999,21.552070704383997,37.46465837524883,0.06924719581136274,32.9632294178009,5.953808784484863,16.554824829101562,214,61,153,153,0,10,99000.0
99,99999,21.671384967667304,37.63448422339323,0.07057004589149796,33.20453143119812,6.011751651763916,17.14350128173828,214,61,153,153,0,10,100000.0
100,100999,21.761424623532086,37.71772561483734,0.07155911236773282,33.53403115272522,6.1708784103393555,17.19744873046875,216,62,154,154,0,10,101000.0
101,101999,21.819148254190218,37.75276302790369,0.07076732605439273,33.99418330192566,6.229214429855347,17.11309051513672,222,62,160,160,0,10,102000.0
102,102999,21.798214090545684,37.69444869251126,0.07022448132244874,34.294713735580444,6.284960746765137,17.52581787109375,224,63,161,161,0,10,103000.0
103,103999,21.787589448849236,37.698918126180175,0.06945963428759472,34.568809270858765,6.341644763946533,18.166221618652344,224,63,161,161,0,10,104000.0
104,104999,21.75883701455254,37.669773353096424,0.06879450377100693,34.87255144119263,6.3977460861206055,18.38800048828125,226,64,162,162,0,10,105000.0
105,105999,21.72686373996291,37.60797191644329,0.06867481616021909,35.26989483833313,6.455435037612915,17.975196838378906,232,67,165,165,0,10,106000.0
106,106999,21.690582079701322,37.53786516497665,0.0682023363819334,35.579334020614624,6.512812376022339,18.371536254882812,234,68,166,166,0,10,107000.0
107,107999,21.644903343800998,37.43724736237938,0.06810739057289983,36.05837321281433,6.570610046386719,18.212417602539062,235,69,166,166,0,10,108000.0
108,108999,21.622715977285242,37.5246464279155,0.06711180868860567,36.33284950256348,6.628133773803711,18.87297821044922,235,69,166,166,0,10,109000.0
109,109999,21.5885894710216,37.45793587204393,0.06696095685199377,36.62713050842285,6.6865034103393555,19.163192749023438,236,70,166,166,0,10,110000.0
110,110999,21.56533682138739,37.388528191841225,0.06671093512534965,36.90753889083862,6.743788480758667,19.593788146972656,236,70,166,166,0,10,111000.0
111,111999,21.552518862931272,37.453103033712395,0.06627399721587401,37.44182300567627,6.801772117614746,18.805519104003906,236,70,166,166,0,10,112000.0
112,112999,21.53376372626507,37.38722681113498,0.0659037669859317,37.72079682350159,6.859792470932007,19.30158233642578,236,70,166,166,0,10,113000.0
113,113999,21.516016649040935,37.33752440265983,0.06566774860251368,38.055991411209106,6.918111562728882,19.540687561035156,236,70,166,166,0,10,114000.0
114,114999,21.51102430091438,37.30572009685525,0.06517819759952526,38.45606851577759,6.978207111358643,19.221847534179688,237,71,166,166,0,10,115000.0
115,115999,21.49734807995047,37.24722314161273,0.06489584801139692,38.797773122787476,7.037681579589844,19.26458740234375,238,72,166,166,0,10,116000.0
116,116999,21.4844131172807,37.18208250726657,0.06468410810839542,39.16745209693909,7.096218585968018,19.383682250976562,238,72,166,166,0,10,117000.0
117,117999,21.47223686513948,37.169643819889586,0.06436919294255838,39.55378293991089,7.279874563217163,19.60308837890625,238,72,166,166,0,10,118000.0
118,118999,21.444652172496227,37.10867403462661,0.064059582570556,39.906081438064575,7.343365430831909,19.804611206054688,238,72,166,166,0,10,119000.0
119,119999,21.4075063123487,37.04437522282148,0.06390373011779205,40.162009954452515,7.415842533111572,20.91388702392578,246,73,173,173,0,10,120000.0
120,120999,21.36295818155185,36.95895219027709,0.06417163229013201,40.46435475349426,7.47269868850708,21.368896484375,246,73,173,173,0,10,121000.0
121,121999,21.306449865283522,36.86197311277269,0.06433457156331757,40.81849002838135,7.529564619064331,21.553192138671875,246,73,173,173,0,10,122000.0
122,122999,21.257484015099905,36.78906913366354,0.06453453080695681,41.09754395484924,7.586700439453125,21.761215209960938,248,74,174,174,0,10,123000.0
123,123999,21.212420974230298,36.70886561885528,0.06454519870945474,41.50124430656433,7.644138336181641,21.198043823242188,254,77,177,177,0,10,124000.0
124,124999,21.168876103445516,36.69236559763679,0.06454054050851432,41.76853346824646,7.702077150344849,21.738243103027344,254,77,177,177,0,10,125000.0
125,125999,21.13294400052575,36.63277889576185,0.06430715887852956,42.09468340873718,7.760950326919556,21.704124450683594,258,79,179,179,0,10,126000.0
126,126999,21.10015355354879,36.57090809526504,0.06402852206404841,42.35718822479248,7.950782775878906,22.0679931640625,260,80,180,180,0,10,127000.0
127,127999,21.066375920644536,36.5069588197705,0.06371999868205314,42.66868805885315,8.014471530914307,22.35906219482422,260,80,180,180,0,10,128000.0
128,128999,21.04140204110313,36.446191636994946,0.06351674025872878,43.012632846832275,8.07233715057373,22.279678344726562,261,81,180,180,0,10,129000.0
129,129999,21.01867347474774,36.39742476501301,0.06327685057287546,43.36675262451172,8.131064414978027,22.150909423828125,322,83,239,239,0,10,130000.0
130,130999,20.990625820990445,36.35337274084071,0.06311629488027448,43.76091384887695,8.190326929092407,22.05596160888672,322,83,239,239,0,10,131000.0
131,131999,20.98954298579155,36.416068973869784,0.06282911067461994,44.026227951049805,8.249501943588257,22.691627502441406,322,83,239,239,0,10,132000.0
132,132999,20.983194726818457,36.39648287729835,0.06243739062770004,44.27756428718567,8.30922245979309,23.05211639404297,323,84,239,239,0,10,133000.0
133,133999,20.995315922010782,36.41466975922482,0.06230104976517925,44.77070069313049,8.368634700775146,22.50237274169922,323,84,239,239,0,10,134000.0
134,134999,21.024043454167384,36.44960676755771,0.06199907029795815,45.22336435317993,8.429307222366333,21.91468048095703,324,85,239,239,0,10,135000.0
135,135999,21.043740488388814,36.45284259538397,0.062083929601464805,45.66943311691284,8.488099575042725,22.19762420654297,329,86,243,243,0,10,136000.0
136,136999,21.066390852896376,36.47306127938075,0.06189432673298223,45.98109149932861,8.54718828201294,22.46685791015625,329,86,243,243,0,10,137000.0
137,137999,21.09702065664039,36.5594501875266,0.0615271268815647,46.246071338653564,8.608033657073975,23.00054931640625,329,86,243,243,0,10,138000.0
138,138999,21.119989286937106,36.557077829917766,0.06091656609513041,46.768035650253296,8.667548894882202,22.649459838867188,329,86,243,243,0,10,139000.0
139,139999,21.155531173295234,36.58513815132704,0.05847350643931659,47.050599098205566,8.728375911712646,23.352806091308594,329,86,243,243,0,10,140000.0
140,140999,21.170002999712732,36.55237142392578,0.056497245089493386,47.338565826416016,8.787917137145996,23.903602600097656,329,86,243,243,0,10,141000.0
141,141999,21.1731226024989,36.50517997304758,0.05573178349891783,47.671135902404785,8.848371982574463,24.19879150390625,329,86,243,243,0,10,142000.0
142,142999,21.152899307698107,36.43746775655504,0.05533646847302742,47.99658226966858,8.90830683708191,24.051475524902344,339,88,251,251,0,10,143000.0
143,143999,21.132981484238403,36.40237811869071,0.054852623190576155,48.40810799598694,8.969053506851196,23.989395141601562,339,88,251,251,0,10,144000.0
144,144999,21.10813249099442,36.34009471647506,0.05429293619537723,48.72055506706238,9.03084421157837,24.205856323242188,340,89,251,251,0,10,145000.0
145,145999,21.087627486959345,36.28499666635661,0.053865262445697004,49.2364068031311,9.093947172164917,24.297286987304688,340,89,251,251,0,10,146000.0
146,146999,21.068619117703022,36.23544141780916,0.053520626091053236,49.567118883132935,9.15561819076538,24.56066131591797,340,89,251,251,0,10,147000.0
147,147999,21.04362343431951,36.170588358330136,0.05333128989876801,50.02716088294983,9.21652603149414,24.193466186523438,340,89,251,251,0,10,148000.0
148,148999,21.024369208640685,36.13316537892845,0.053241879645221535,50.32140374183655,9.279095649719238,24.267044067382812,343,91,252,252,0,11,149000.0
149,149999,21.003244919955122,36.07494096727565,0.05323338179607828,50.69074988365173,9.340855836868286,24.44451141357422,343,91,252,252,0,11,150000.0
150,150999,20.989769123670595,36.047239669488356,0.05314669980530651,51.00859522819519,9.402472019195557,24.540435791015625,344,92,252,252,0,12,151000.0
151,151999,20.970696274590107,36.00183622249475,0.053173691198927675,51.329352617263794,9.465615510940552,24.8084716796875,344,92,252,252,0,12,152000.0
152,152999,20.953193631789834,35.960479885740774,0.053029199467864774,51.70664072036743,9.528283834457397,24.87903594970703,344,92,252,252,0,12,153000.0
153,153999,20.940899763254087,35.91520395701157,0.05309070567830154,52.04656100273132,9.591155767440796,25.09851837158203,344,92,252,252,0,12,154000.0
154,154999,20.92557891024992,35.85888769664447,0.05308663563916327,52.45736503601074,9.65420126914978,24.8194580078125,345,93,252,252,0,13,155000.0
155,155999,20.904019214385674,35.79445363848105,0.053298249770937445,52.838634967803955,9.718421936035156,24.747642517089844,345,93,252,252,0,13,156000.0
156,156999,20.885471213185024,35.741967852783695,0.05344890391454782,53.343974351882935,9.782076120376587,24.215377807617188,345,93,252,252,0,13,157000.0
157,157999,20.868077976030772,35.7047988963983,0.05336711272733208,53.60578441619873,9.994668960571289,24.632308959960938,346,94,252,252,0,14,158000.0
158,158999,20.83822721719136,35.64144859290634,0.05342351870385842,53.921249866485596,10.057209491729736,24.90943145751953,346,94,252,252,0,14,159000.0
159,159999,20.821734423818253,35.58339201834708,0.05318637088829947,54.20040988922119,10.11528754234314,25.818031311035156,347,94,253,253,0,14,160000.0
160,160999,20.795847073206147,35.51571445775535,0.05302493467086822,54.44462847709656,10.174567461013794,26.29155731201172,349,95,254,254,0,14,161000.0
161,161999,20.761529441452936,35.4434490330134,0.05300860258565809,54.792755365371704,10.234350204467773,26.271484375,351,96,255,255,0,14,162000.0
162,162999,20.728628068736818,35.3751501158256,0.05300280712019445,55.05093240737915,10.293344974517822,26.663551330566406,353,97,256,256,0,14,163000.0
163,163999,20.699179016799306,35.32917618979399,0.05294078615048736,55.42883086204529,10.355119228363037,26.06897735595703,368,101,267,267,0,14,164000.0
164,164999,20.65576638066259,35.24994371278699,0.053165391220532765,55.8560791015625,10.420811414718628,25.878311157226562,372,103,269,269,0,14,165000.0
165,165999,20.623405561376078,35.190567792389245,0.05339336177425136,56.08804655075073,10.478497505187988,26.523941040039062,372,103,269,269,0,14,166000.0
166,166999,20.595321105223178,35.12508322665984,0.053524570006023175,56.60484313964844,10.537178039550781,26.57061767578125,372,103,269,269,0,14,167000.0
167,167999,20.563018902405815,35.075738957454604,0.053614551489985285,57.01178574562073,10.597050189971924,26.425704956054688,372,103,269,269,0,14,168000.0
168,168999,20.535379363401816,35.02312308289426,0.053813459202420755,57.28578567504883,10.65699553489685,26.8564453125,372,103,269,269,0,14,169000.0
169,169999,20.519545194600532,35.05652315178085,0.0536586211507496,57.76204323768616,10.722493171691895,26.392807006835938,376,105,271,271,0,14,170000.0
170,170999,20.508690723115727,35.052863917651145,0.05355458066640395,58.02055501937866,10.781414985656738,26.73296356201172,378,106,272,272,0,14,171000.0
171,171999,20.50149533654529,35.045123518967735,0.05338887151828675,58.414878606796265,10.841349840164185,26.59729766845703,378,106,272,272,0,14,172000.0
172,172999,20.496773334482175,35.04899458542015,0.05319791018039832,58.88968539237976,10.901622295379639,26.294784545898438,378,106,272,272,0,14,173000.0
173,173999,20.49637611806838,35.04126774865961,0.05302395581194175,59.20123362541199,10.962372303009033,26.566734313964844,378,106,272,272,0,14,174000.0
174,174999,20.500653266366797,35.04318398854026,0.052825533521452916,59.45710897445679,11.021801948547363,26.93114471435547,380,107,273,273,0,14,175000.0
175,175999,20.504505396609648,35.04544857747937,0.05294574220259318,59.81125855445862,11.083167552947998,27.74744415283203,380,107,273,273,0,14,176000.0
176,176999,20.50862602831514,35.045717993700336,0.05316278623344184,60.23294758796692,11.14173150062561,27.282470703125,382,108,274,274,0,14,177000.0
177,177999,20.506062656019303,35.0288479390769,0.05317841385345745,60.617608070373535,11.201679468154907,27.19029998779297,384,109,275,275,0,14,178000.0
178,178999,20.48723672865527,34.98675713181435,0.053178978967815205,60.86670804023743,11.260696649551392,27.599090576171875,390,111,279,279,0,14,179000.0
179,179999,20.478867542776968,34.964053972670186,0.05278026049254836,61.19386959075928,11.32207703590393,28.180526733398438,393,111,282,282,0,14,180000.0
180,180999,20.457218504144816,34.908839097802215,0.05253640250417346,61.66209101676941,11.397531747817993,28.299102783203125,393,111,282,282,0,14,181000.0
181,181999,20.42165857853692,34.83979456843633,0.05265407424625801,61.98123288154602,11.47125768661499,28.7755126953125,395,112,283,283,0,14,182000.0
182,182999,20.389082468145887,34.78159243406299,0.052635393728193036,62.21037149429321,11.532392501831055,29.380157470703125,395,112,283,283,0,14,183000.0
183,183999,20.35877802930381,34.73238637901965,0.05267877090560302,62.66916060447693,11.593597412109375,28.975814819335938,395,112,283,283,0,14,184000.0
184,184999,20.320289967878356,34.66556004723465,0.05293883853076464,63.023555278778076,11.656607389450073,28.756454467773438,413,115,298,298,0,14,185000.0
185,185999,20.284065459799518,34.602265512156414,0.0530692138096327,63.511664152145386,11.718141555786133,28.901519775390625,415,116,299,299,0,14,186000.0
186,186999,20.240553500351652,34.53408597637179,0.05339705223165314,63.872722148895264,11.7821524143219,28.959014892578125,415,116,299,299,0,14,187000.0
187,187999,20.1983106662749,34.47012197062724,0.0536866421845984,64.19166326522827,11.846180200576782,28.972007751464844,416,117,299,299,0,14,188000.0
188,188999,20.161557600469642,34.41799239249266,0.05391084067850038,64.63198566436768,11.90790605545044,28.574913024902344,418,118,300,300,0,14,189000.0
189,189999,20.12362146903047,34.38345451100352,0.053921414343081175,65.04971313476562,11.970146179199219,28.37023162841797,420,119,301,301,0,14,190000.0
190,190999,20.08280261294253,34.32039593509812,0.05407523985599616,65.2636387348175,12.033567428588867,29.377548217773438,435,120,315,315,0,14,191000.0
191,191999,20.050831691201296,34.28669674475905,0.05403269920990439,65.53878355026245,12.097055673599243,30.08222198486328,436,120,316,316,0,14,192000.0
192,192999,20.019751279821445,34.243458801043126,0.05411483590820554,65.88061833381653,12.159718036651611,30.349952697753906,447,121,326,326,0,14,193000.0
193,193999,19.994574486946426,34.20446346046869,0.05422338840625052,66.07436347007751,12.221925735473633,31.15772247314453,447,121,326,326,0,14,194000.0
194,194999,19.970089587621143,34.164368033514414,0.05428279299285588,66.35036039352417,12.284069061279297,31.530670166015625,447,121,326,326,0,14,195000.0
195,195999,19.961983291860367,34.14918367473832,0.054099507354610665,67.00657963752747,12.350449085235596,31.334129333496094,447,121,326,326,0,14,196000.0
196,196999,19.94674073336728,34.119514791277574,0.054079492769611104,67.34001922607422,12.415884971618652,31.57958984375,447,121,326,326,0,14,197000.0
197,197999,19.934753823362403,34.09712626949745,0.054027352069070056,67.61514472961426,12.480337142944336,31.943275451660156,447,121,326,326,0,14,198000.0
198,198999,19.91476155031578,34.061118356541755,0.054187727812679776,67.998854637146,12.543524265289307,31.682388305664062,449,122,327,327,0,14,199000.0
199,199999,19.938875770675853,34.05486043348639,0.05248655042973993,68.40465927124023,12.609518051147461,32.08733367919922,452,122,330,330,0,14,200000.0
200,200999,19.95816565871031,34.05431518883395,0.05091337326872458,68.651202917099,12.672887086868286,32.936622619628906,453,122,331,331,0,14,201000.0
201,201999,19.95562442564654,34.02276872772666,0.05019499532149363,69.05155110359192,12.737321615219116,32.50872802734375,457,124,333,333,0,14,202000.0
202,202999,19.934039550263414,33.99799450415451,0.05029592349264689,69.32681846618652,12.801415920257568,33.0396728515625,459,125,334,334,0,14,203000.0
203,203999,19.90366442966616,33.94800754813437,0.05049441131493926,69.68717885017395,12.867388486862183,32.83143615722656,475,127,348,348,0,14,204000.0
204,204999,19.873950515765273,33.90154642375404,0.0511062145258111,69.92342352867126,12.93188190460205,34.146026611328125,478,127,351,351,0,14,205000.0
205,205999,19.84990599752113,33.862177519956546,0.05123802664240151,70.31960415840149,12.99718976020813,35.18675994873047,478,127,351,351,0,14,206000.0
206,206999,19.824944074574184,33.82118537262981,0.0517468713423197,70.65069270133972,13.061995029449463,35.35508728027344,481,128,353,353,0,14,207000.0
207,207999,19.80720364282678,33.8076306099823,0.05209446463592016,70.9157190322876,13.127001762390137,35.772132873535156,483,129,354,354,0,14,208000.0
208,208999,19.78130371488436,33.76348509235619,0.05244520863322377,71.32094025611877,13.193001985549927,35.49028778076172,485,130,355,355,0,14,209000.0
209,209999,19.770160258463847,33.743749863878975,0.05301915903056331,71.77529382705688,13.266117334365845,35.26378631591797,487,131,356,356,0,14,210000.0
210,210999,19.758570777705824,33.76540122583591,0.052936952376508306,72.06837916374207,13.331937551498413,35.72245788574219,489,132,357,357,0,14,211000.0
211,211999,19.745604653812098,33.74195420455187,0.053314000350455304,72.31790018081665,13.398530960083008,36.305023193359375,489,132,357,357,0,14,212000.0
212,212999,19.742051443299975,33.75457518435316,0.05316488344144177,72.558100938797,13.464443445205688,36.85987091064453,489,132,357,357,0,14,213000.0
213,213999,19.740676320096977,33.770187084905395,0.053165872710313256,73.06841540336609,13.532272815704346,36.16084289550781,489,132,357,357,0,14,214000.0
214,214999,19.753444344465453,33.802516623686714,0.053840837143732334,73.48887205123901,13.598323583602905,35.804832458496094,493,134,359,359,0,14,215000.0
215,215999,19.766417050455853,33.827521149761765,0.05443965531255246,73.7814724445343,13.664729356765747,36.0355224609375,497,136,361,361,0,14,216000.0
216,216999,19.77925409161948,33.85172802586891,0.055040562636454404,74.06381297111511,13.7310209274292,36.498077392578125,497,136,361,361,0,14,217000.0
217,217999,19.79193701762885,33.870871777311905,0.0555282657016648,74.49017572402954,14.009788751602173,36.45512390136719,497,136,361,361,0,14,218000.0
218,218999,19.81622125612311,33.91410039966267,0.055385731480892875,74.7810914516449,14.075566291809082,36.82069396972656,497,136,361,361,0,14,219000.0
219,219999,19.814212607173793,33.89574448196174,0.05516710886997456,75.09266376495361,14.142520666122437,37.06730651855469,514,138,376,376,0,14,220000.0
220,220999,19.804286903895722,33.882524139755105,0.05465059730746691,75.39926719665527,14.203299045562744,37.39582061767578,517,139,378,378,0,14,221000.0
221,221999,19.795029660942454,33.86542605393877,0.053761269805555845,75.69545245170593,14.264467716217041,38.00202941894531,533,141,392,392,0,14,222000.0
222,222999,19.793425824728832,33.84312671242351,0.05268334627908233,75.98533844947815,14.327102661132812,38.754112243652344,534,141,393,393,0,14,223000.0
223,223999,19.80651592515993,33.85585857931314,0.05118896038358123,76.23880577087402,14.388572692871094,39.237892150878906,538,143,395,395,0,14,224000.0
224,224999,19.818640493796963,33.85152480443143,0.05008761231648662,76.48507499694824,14.44934606552124,39.941795349121094,538,143,395,395,0,14,225000.0
225,225999,19.83786629615641,33.84701441172797,0.04878745279705454,76.8013870716095,14.512146711349487,40.09991455078125,540,144,396,396,0,14,226000.0
226,226999,19.85545890191325,33.85580417371518,0.047764840164156275,77.18053007125854,14.576348543167114,40.130340576171875,542,145,397,397,0,14,227000.0
227,227999,19.877706175586244,33.868149134449695,0.04667688566860706,77.45358967781067,14.637709140777588,40.50847625732422,544,146,398,398,0,14,228000.0
228,228999,19.89508792335774,33.89388203370385,0.04627902519697802,78.09384107589722,14.703245401382446,39.9345703125,552,150,402,402,0,14,229000.0
229,229999,19.906520692523767,33.90688353043559,0.04663936209042896,78.34090828895569,14.765114068984985,40.714576721191406,552,150,402,402,0,14,230000.0
230,230999,19.925116622056716,33.94349388340362,0.04703048868137394,78.60654401779175,14.826469421386719,41.099952697753906,554,151,403,403,0,14,231000.0
231,231999,19.945157411553872,33.96850043315453,0.04741310239051366,79.19160342216492,14.888282775878906,39.53053283691406,570,155,415,415,0,14,232000.0
232,232999,19.972471635968,34.03018528663139,0.04773950396900861,79.39976978302002,14.952749729156494,40.55055236816406,570,155,415,415,0,14,233000.0
233,233999,20.005333049263847,34.10457480532819,0.04896977613721609,79.77112746238708,15.015109062194824,40.50596618652344,572,156,416,416,0,14,234000.0
234,234999,20.04734145189917,34.22944138721738,0.05003045101385695,80.0962061882019,15.078822612762451,40.80371856689453,572,156,416,416,0,14,235000.0
235,235999,20.089181650611476,34.356269898574105,0.051372771753332436,80.39421200752258,15.141576051712036,40.98033905029297,576,158,418,418,0,14,236000.0
236,236999,20.143370025439292,34.507959464861834,0.052783371630580556,80.68820333480835,15.204650163650513,41.07453155517578,580,160,420,420,0,14,237000.0
237,237999,20.179241242587626,34.56389520436689,0.05410915229832569,81.1279661655426,15.270779848098755,40.933258056640625,580,160,420,420,0,14,238000.0
238,238999,20.20972292968637,34.60756733363445,0.055363648540916355,81.38404750823975,15.335350036621094,41.58403015136719,580,160,420,420,0,14,239000.0
239,239999,20.217598030149247,34.633267896481165,0.055314451609748794,82.10146450996399,15.400469541549683,41.61023712158203,585,160,425,425,0,14,240000.0
240,240999,20.207525037818392,34.626310522464266,0.05514972782299288,82.51750779151917,15.463329315185547,41.815208435058594,586,160,426,426,0,14,241000.0
241,241999,20.194790236987963,34.597822940775984,0.05518890201613147,82.85892963409424,15.527061462402344,41.93889617919922,588,161,427,427,0,14,242000.0
242,242999,20.183472774651175,34.592537925719114,0.05499812299951623,83.2671914100647,15.590863704681396,41.946067810058594,588,161,427,427,0,14,243000.0
243,243999,20.17231987350794,34.5722300461887,0.05496111021519268,83.59152030944824,15.65403437614441,42.19105529785156,590,162,428,428,0,14,244000.0
244,244999,20.159750459276882,34.54580494191911,0.054901572597800485,84.03255009651184,15.71895694732666,41.96232604980469,592,163,429,429,0,14,245000.0
245,245999,20.14877034387766,34.52148104438731,0.054815994929294565,84.39703178405762,15.783549785614014,42.26966857910156,592,163,429,429,0,14,246000.0
246,246999,20.1410484122987,34.51279975400405,0.054693903680379075,84.73138785362244,15.847693920135498,42.41282653808594,593,164,429,429,0,14,247000.0
247,247999,20.13374079949438,34.49591335670955,0.0545991151981019,85.09608054161072,15.911914587020874,42.73851776123047,608,165,443,443,0,14,248000.0
248,248999,20.12802809184583,34.48146030681845,0.05460045621899223,85.34863519668579,15.978062868118286,43.60002899169922,619,167,452,452,0,14,249000.0
249,249999,20.122166692631435,34.46407383650924,0.05455174427019094,85.56114459037781,16.044644117355347,44.292274475097656,634,169,465,465,0,14,250000.0
250,250999,20.118038523410025,34.45011066671453,0.054650829410762825,85.8496823310852,16.10914635658264,44.891571044921875,634,169,465,465,0,14,251000.0
251,251999,20.111436854977963,34.43192210910964,0.05478094408134937,86.05109786987305,16.17269539833069,45.646461486816406,634,169,465,465,0,14,252000.0
252,252999,20.11074628250352,34.41663215281316,0.05487082026360668,86.47923970222473,16.238179445266724,45.48413848876953,634,169,465,465,0,14,253000.0
253,253999,20.104879046119127,34.39469366795398,0.055056492649017796,87.11219048500061,16.306020736694336,45.415687561035156,638,171,467,467,0,14,254000.0
254,254999,20.101609966297232,34.37917967894045,0.055213351511704034,87.53072142601013,16.372342348098755,45.32670593261719,640,172,468,468,0,14,255000.0
255,255999,20.092560183588393,34.35067592383174,0.055229324806327806,87.72946858406067,16.43974733352661,46.38722229003906,647,173,474,474,0,14,256000.0
256,256999,20.087268097260555,34.35020380705566,0.055112554342048314,88.02178406715393,16.50359320640564,47.148109436035156,649,173,476,476,0,14,257000.0
257,257999,20.085952152177246,34.34885461582303,0.055006865941206295,88.28074240684509,16.56639838218689,47.69386291503906,665,175,490,490,0,14,258000.0
258,258999,20.080537629728685,34.33685725587001,0.05512487377981534,88.45396900177002,16.62881898880005,48.85697937011719,667,176,491,491,0,14,259000.0
259,259999,20.0758817078633,34.32354621569702,0.05516511957033832,88.72386384010315,16.690734148025513,49.52210998535156,668,176,492,492,0,14,260000.0
260,260999,20.081668652668252,34.35975834895915,0.05530752573535813,89.0737693309784,16.75348162651062,49.63019561767578,670,177,493,493,0,14,261000.0
261,261999,20.085577571010287,34.37945075856165,0.05535775091553241,89.40308737754822,16.818894147872925,49.95610809326172,671,177,494,494,0,14,262000.0
262,262999,20.092767991932057,34.390047302572235,0.0554882606159931,89.68047142028809,16.880250692367554,50.34930419921875,671,177,494,494,0,14,263000.0
263,263999,20.106100608421364,34.41028312161864,0.055526702198914424,90.04806399345398,16.94216561317444,50.078575134277344,675,179,496,496,0,14,264000.0
264,264999,20.125195851354682,34.43860191983959,0.0558260669008982,90.41984868049622,17.005877256393433,50.027427673339844,690,181,509,509,0,14,265000.0
265,265999,20.148780097189892,34.51269890158684,0.05559432511126394,90.73896622657776,17.071261644363403,50.22510528564453,692,182,510,510,0,14,266000.0
266,266999,20.165789202793693,34.534378070478446,0.05588884304210351,91.35540556907654,17.13811421394348,50.449989318847656,692,182,510,510,0,14,267000.0
267,267999,20.183439812218708,34.551465029301625,0.05622028296353376,91.72838115692139,17.202646493911743,50.35901641845703,696,184,512,512,0,14,268000.0
268,268999,20.202551238855985,34.57585935702618,0.05659963032493032,91.97263550758362,17.266971349716187,50.9993896484375,696,184,512,512,0,14,269000.0
269,269999,20.220219754116876,34.59569465499372,0.057072537651548405,92.33479690551758,17.33218288421631,51.051719665527344,698,185,513,513,0,14,270000.0
270,270999,20.260547144556764,34.678522346756885,0.05743930169188127,92.71789503097534,17.397568225860596,50.53631591796875,706,189,517,517,0,14,271000.0
271,271999,20.277823743751664,34.69152209453135,0.057922213724494465,93.04027533531189,17.462440490722656,50.65815734863281,711,191,520,520,0,14,272000.0
272,272999,20.295624423680266,34.697168674971365,0.05841946837043788,93.31168627738953,17.528398036956787,50.98186492919922,714,193,521,521,0,14,273000.0
273,273999,20.315908716578413,34.75608048804551,0.05791414283462193,93.69173240661621,17.591792106628418,51.21281433105469,725,195,530,530,0,14,274000.0
274,274999,20.34180975589032,34.814823624342004,0.057817155418513067,93.94393134117126,17.65733003616333,52.09391784667969,727,195,532,532,0,14,275000.0
275,275999,20.35377660317517,34.88241835247294,0.05799146453687176,94.28608798980713,17.726508378982544,52.77916717529297,743,196,547,547,0,14,276000.0
276,276999,20.36898065992177,34.90638714533526,0.05800021716425263,94.5283727645874,17.794898986816406,53.61137390136719,743,196,547,547,0,14,277000.0
277,277999,20.384996112237552,34.93291987193019,0.05801702241437301,94.92219853401184,17.86259913444519,53.698951721191406,744,196,548,548,0,14,278000.0
278,278999,20.40601801481964,34.97247016655559,0.05856315151705316,95.14888143539429,17.92960500717163,54.40637969970703,746,197,549,549,0,14,279000.0
279,279999,20.423013151095887,34.99434483671605,0.05924263270542007,95.44080066680908,17.99368691444397,54.7960205078125,747,197,550,550,0,14,280000.0
280,280999,20.44646765537908,35.024857234100004,0.05997596797499083,95.8518979549408,18.356112003326416,54.75872802734375,747,197,550,550,0,14,281000.0
281,281999,20.474076852097447,35.09102891459623,0.0609942296827356,96.12539601325989,18.42135238647461,55.16834259033203,749,198,551,551,0,14,282000.0
282,282999,20.50414933716462,35.15868483996517,0.06216796543397207,96.60868406295776,18.48710823059082,54.595672607421875,751,199,552,552,0,14,283000.0
283,283999,20.53797886568814,35.21815967549829,0.06399871304459259,96.91971230506897,18.55182957649231,54.95665740966797,753,200,553,553,0,14,284000.0
284,284999,20.57369581018601,35.2775666569847,0.06592209645304947,97.10531973838806,18.617568969726562,55.67084503173828,755,201,554,554,0,14,285000.0
285,285999,20.605502159902386,35.312866280961764,0.06770573653696499,97.48532104492188,18.683286428451538,55.33665466308594,759,203,556,556,0,14,286000.0
286,286999,20.6508929630496,35.391300108497084,0.07000281141802067,97.8150143623352,18.749370336532593,55.629615783691406,759,203,556,556,0,14,287000.0
287,287999,20.6876284729312,35.43961820418139,0.07218973169851428,98.16295170783997,18.81901240348816,55.81458282470703,759,203,556,556,0,14,288000.0
288,288999,20.732387654238075,35.534065339653594,0.0746393278168268,98.49269223213196,18.882667303085327,56.11302947998047,759,203,556,556,0,14,289000.0
289,289999,20.78386772332701,35.618988971591946,0.0778718748660483,98.8418378829956,18.947920560836792,56.146629333496094,759,203,556,556,0,14,290000.0
290,290999,20.835266882141273,35.705995854997326,0.08038783905200064,99.27533841133118,19.014277696609497,55.37383270263672,767,207,560,560,0,14,291000.0
291,291999,20.883262855076943,35.77735410922068,0.08261556844881757,99.63853001594543,19.080066442489624,55.377601623535156,769,208,561,561,0,14,292000.0
292,292999,20.910041472696058,35.80941251294394,0.08405160681279489,99.93391108512878,19.146121740341187,55.893898010253906,781,209,572,572,0,14,293000.0
293,293999,20.922533411713026,35.84557964066164,0.08321762544152689,100.2521378993988,19.20634913444519,56.654022216796875,786,209,577,577,0,14,294000.0
294,294999,20.919119455998466,35.8504398958192,0.08283160297054937,100.5634114742279,19.268349647521973,57.085838317871094,787,209,578,578,0,14,295000.0
295,295999,20.9162962631544,35.84764307143739,0.08257853372104695,100.9005675315857,19.641117095947266,57.399261474609375,790,210,580,580,0,14,296000.0
296,296999,20.915940878039173,35.842660143868144,0.08234896229632693,101.19761514663696,19.702198266983032,57.79624938964844,790,210,580,580,0,14,297000.0
297,297999,20.91279668153866,35.82983230060734,0.08236552443502843,101.54601049423218,19.76602578163147,57.68006896972656,794,212,582,582,0,14,298000.0
298,298999,20.911285303314088,35.823357846387076,0.082304824557213,101.88849139213562,19.82818031311035,57.58519744873047,814,216,598,598,0,14,299000.0
299,299999,20.91031544352735,35.8122818520314,0.0821069781464171,102.28422617912292,19.890101671218872,57.46240234375,816,217,599,599,0,14,300000.0
300,300999,20.90735203986809,35.79496249245339,0.08189957581605378,102.55650520324707,19.950718641281128,58.116615295410156,816,217,599,599,0,14,301000.0
301,301999,20.905668771775566,35.78429932519814,0.08181397380307442,102.94066572189331,20.013927936553955,57.93389129638672,821,219,602,602,0,14,302000.0
302,302999,20.90183383125406,35.76783063317094,0.08175596285347275,103.26221466064453,20.077441930770874,58.34667205810547,821,219,602,602,0,14,303000.0
303,303999,20.896759885903272,35.749071980042906,0.08168593377037014,103.53716444969177,20.14127469062805,58.806419372558594,828,220,608,608,0,14,304000.0
304,304999,20.896973639247125,35.7416670175361,0.08164301027017962,103.81678223609924,20.201215744018555,59.133575439453125,828,220,608,608,0,14,305000.0
305,305999,20.8960013653468,35.73178934489199,0.08160268759894906,104.11029958724976,20.265912532806396,59.54594421386719,828,220,608,608,0,14,306000.0
306,306999,20.894122351417113,35.717359221270456,0.0817126148194407,104.57184958457947,20.32899570465088,59.14581298828125,842,221,621,621,0,14,307000.0
307,307999,20.89756349365584,35.71458358078881,0.08178538840469862,105.05624961853027,20.391594886779785,58.642242431640625,844,222,622,622,0,14,308000.0
308,308999,20.909273241234356,35.74585679808354,0.08210403996058546,105.42721462249756,20.453704357147217,58.70219421386719,846,223,623,623,0,14,309000.0
309,309999,20.924327825002678,35.80088731423507,0.08236068721004419,105.77116823196411,20.518408060073853,58.92713165283203,846,223,623,623,0,14,310000.0
310,310999,20.928253801229733,35.81736458197256,0.08246327365146333,106.01238346099854,20.580989837646484,59.526275634765625,846,223,623,623,0,14,311000.0
311,311999,20.931453792503085,35.8403779394551,0.08267252210275,106.71937704086304,20.645138025283813,59.60395050048828,846,223,623,623,0,14,312000.0
312,312999,20.925970510773116,35.879263127875156,0.0823841082692206,106.92006182670593,20.70741367340088,60.643768310546875,861,225,636,636,0,14,313000.0
313,313999,20.919827020884124,35.88691074697235,0.0821585602460676,107.194744348526,20.772207021713257,61.34375,864,225,639,639,0,14,314000.0
314,314999,20.92304240831468,35.91245085183243,0.08276724039452144,107.59737062454224,20.83876657485962,61.22943878173828,869,227,642,642,0,14,315000.0
315,315999,20.919371427271315,35.927108866784494,0.08330063719467695,107.84889221191406,20.90574836730957,61.898216247558594,869,227,642,642,0,14,316000.0
316,316999,20.91918604140475,35.932476706046046,0.08415708394734112,108.20180797576904,20.970600605010986,61.91340637207031,871,228,643,643,0,14,317000.0
317,317999,20.9142956195054,35.93108335049372,0.0849576965056672,108.60302305221558,21.03470253944397,61.77143096923828,873,229,644,644,0,14,318000.0
318,318999,20.91641284960335,35.949932085838164,0.08515110588939212,108.98262214660645,21.09828495979309,61.87909698486328,873,229,644,644,0,14,319000.0
319,319999,20.9181652758711,35.95769575914923,0.08576965330275343,109.27855801582336,21.164445400238037,62.06902313232422,877,231,646,646,0,14,320000.0
320,320999,20.921161660588563,35.964556033826454,0.08576085606836881,109.61577939987183,21.232837677001953,62.26445770263672,879,232,647,647,0,14,321000.0
321,321999,20.921302524984487,35.95989212915333,0.08555422880728358,109.98803949356079,21.301652669906616,62.26893615722656,880,233,647,647,0,14,322000.0
322,322999,20.9264700902831,35.96323639966381,0.0853661384603438,110.32968306541443,21.369243621826172,62.62303924560547,880,233,647,647,0,14,323000.0
323,323999,20.93352813684378,36.00612262695958,0.0849899669798686,110.66062378883362,21.435322523117065,62.89024353027344,880,233,647,647,0,14,324000.0
324,324999,20.935548020168685,35.99849853785177,0.08499545256565189,110.98462152481079,21.50172233581543,63.024147033691406,881,234,647,647,0,14,325000.0
325,325999,20.931344269298563,35.98214320207572,0.08525978641556575,111.34846186637878,21.57158637046814,63.025779724121094,892,235,657,657,0,14,326000.0
326,326999,20.939473252647485,35.986572535384205,0.08525421832024394,111.78725075721741,21.637922048568726,62.828392028808594,892,235,657,657,0,14,327000.0
327,327999,20.941997039355666,35.980490880434466,0.08542889094268458,112.10966467857361,21.70320415496826,62.92388916015625,894,236,658,658,0,14,328000.0
328,328999,20.9425575946552,35.97273293343859,0.08555655172159193,112.46217513084412,21.771112203598022,62.9476318359375,897,237,660,660,0,14,329000.0
329,329999,20.934015692293187,35.95012399703376,0.085884329860475,112.842698097229,21.83913540840149,62.96336364746094,899,238,661,661,0,14,330000.0
330,330999,20.92524400497826,35.92803872075145,0.08589504312849727,113.16432046890259,21.90422248840332,63.23075866699219,899,238,661,661,0,14,331000.0
331,331999,20.926528318498335,35.94277850753916,0.08544095603078317,113.50256490707397,22.31859588623047,63.72322082519531,919,241,678,678,0,14,332000.0
332,332999,20.914215263310858,35.921205721661764,0.08532814276830736,113.75694179534912,22.38581871986389,64.41778564453125,929,242,687,687,0,14,333000.0
333,333999,20.903843890804392,35.90157218055533,0.08530710707372935,114.02231121063232,22.450178623199463,65.04778289794922,944,243,701,701,0,14,334000.0
334,334999,20.89348969916273,35.89089617002031,0.08540309655709066,114.33128643035889,22.51845669746399,65.88787841796875,944,243,701,701,0,14,335000.0
335,335999,20.88326845965024,35.874413784335964,0.0855528394035181,114.67262935638428,22.58382248878479,66.1479263305664,949,245,704,704,0,14,336000.0
336,336999,20.880885448975143,35.88108372825956,0.08553690623957977,114.90579843521118,22.650373458862305,66.89767456054688,950,245,705,705,0,14,337000.0
337,337999,20.873874252318142,35.86470990884359,0.08565711177503943,115.16608166694641,22.71716284751892,67.49751281738281,953,246,707,707,0,14,338000.0
338,338999,20.873047905028542,35.85915118342671,0.08575811782446785,115.3950309753418,22.782947778701782,68.00326538085938,955,247,708,708,0,14,339000.0
339,339999,20.86937286318565,35.845720772324,0.08598913529370589,115.7830126285553,22.85123038291931,67.8221664428711,957,248,709,709,0,14,340000.0
340,340999,20.87214342244841,35.845072486795424,0.08620506331913891,116.12507939338684,22.91689157485962,67.93427276611328,959,249,710,710,0,14,341000.0
341,341999,20.880323125517688,35.85254308489186,0.08641342553762088,116.41743040084839,22.98094153404236,68.4358901977539,961,250,711,711,0,14,342000.0
342,342999,20.902339781319274,35.889617762262844,0.08677834751748259,116.70609188079834,23.0451602935791,68.583984375,965,252,713,713,0,14,343000.0
343,343999,20.920999419334084,35.915637876514054,0.08705150471294554,116.94067764282227,23.110197067260742,69.1755599975586,965,252,713,713,0,14,344000.0
344,344999,20.948813587758696,35.957006096731924,0.08752184731132795,117.36387896537781,23.175662517547607,68.9468994140625,967,253,714,714,0,14,345000.0
345,345999,20.974493878192074,35.998200590777046,0.08815807442419143,117.71383595466614,23.2408185005188,68.96977233886719,969,254,715,715,0,14,346000.0
346,346999,21.001675796115723,36.03485850518552,0.08885649793365236,118.05825161933899,23.307594299316406,69.21186828613281,971,255,716,716,0,14,347000.0
347,347999,21.041360510185502,36.102455304018015,0.0900769036923772,118.66174817085266,23.375334978103638,69.8111801147461,973,256,717,717,0,14,348000.0
348,348999,21.066730731206604,36.13440823856479,0.09087385582523577,118.93386197090149,23.44032907485962,70.13838958740234,975,257,718,718,0,14,349000.0
349,349999,21.09863427949617,36.17294940702324,0.09184899455012885,119.39412593841553,23.511033058166504,69.74671936035156,979,259,720,720,0,15,350000.0
350,350999,21.118298371739385,36.197776209844996,0.09229804788781726,119.7274444103241,23.581257104873657,69.99018096923828,981,260,721,721,0,15,351000.0
351,351999,21.115303689438402,36.18985990011975,0.09203963911577684,119.93715262413025,23.64341711997986,70.98069763183594,997,262,735,735,0,15,352000.0
352,352999,21.108960317473127,36.174886240572135,0.09181487685699319,120.21294736862183,23.709099054336548,71.76753234863281,1004,262,742,742,0,15,353000.0
353,353999,21.10031366887314,36.15655965684816,0.09161443222818388,120.46156907081604,23.770866632461548,72.6410140991211,1022,263,759,759,0,15,354000.0
354,354999,21.095003326873137,36.13686368456253,0.09129996834221832,120.75514674186707,23.835713386535645,73.26020812988281,1022,263,759,759,0,15,355000.0
355,355999,21.103018798120992,36.13782035522063,0.09069652524848992,121.04884457588196,23.898176908493042,73.7227554321289,1022,263,759,759,0,15,356000.0
356,356999,21.109255874401672,36.13245023317851,0.09047584359888561,121.39285182952881,23.96590280532837,73.6705551147461,1029,266,763,763,0,15,357000.0
357,357999,21.11186397344198,36.12147936040962,0.09036350702279927,121.63995742797852,24.028303146362305,74.42686462402344,1029,266,763,763,0,15,358000.0
358,358999,21.11123142835954,36.10676122820076,0.09031223480295103,121.95868158340454,24.091845989227295,74.28050231933594,1052,270,782,782,0,15,359000.0
359,359999,21.11131053877668,36.09510480675214,0.09027459043524777,122.35496807098389,24.155803442001343,73.77129364013672,1063,274,789,789,0,15,360000.0
360,360999,21.11144189267581,36.08675157614403,0.09036943455217128,122.66508960723877,24.220670461654663,74.0975112915039,1065,275,790,790,0,15,361000.0
361,361999,21.112851439185494,36.077955253103646,0.09055495700152416,123.01843476295471,24.286054372787476,74.22166442871094,1067,276,791,791,0,15,362000.0
362,362999,21.111759650864798,36.06617754139112,0.0906192971844918,123.38719940185547,24.349891424179077,74.39352416992188,1067,276,791,791,0,15,363000.0
363,363999,21.11408051253041,36.057617430180386,0.0906144690723627,123.72474789619446,24.415600538253784,74.46499633789062,1076,278,798,798,0,15,364000.0
364,364999,21.115837412189936,36.049403510730066,0.09047492781397759,124.41632890701294,24.478440523147583,74.89928436279297,1076,278,798,798,0,15,365000.0
365,365999,21.119434956744044,36.0416746440127,0.09048978354010773,124.81527328491211,24.542344093322754,74.71086883544922,1078,279,799,799,0,15,366000.0
366,366999,21.126813379360286,36.04027089482765,0.09049002048643606,125.19111514091492,24.60485816001892,74.76408386230469,1078,279,799,799,0,15,367000.0
367,367999,21.132620636870048,36.039349267451655,0.09042756350009795,125.52795171737671,24.666019678115845,74.90653228759766,1081,280,801,801,0,15,368000.0
368,368999,21.13774294507636,36.03476899954366,0.09032838165801971,125.87282276153564,24.728540420532227,74.78430938720703,1085,282,803,803,0,15,369000.0
369,369999,21.13974724294179,36.02532484568279,0.09030974343375597,126.20190715789795,24.794394731521606,75.01522827148438,1087,283,804,804,0,15,370000.0
370,370999,21.147253677376447,36.019742839408046,0.0901916671669355,126.51087188720703,24.858410120010376,75.2066650390625,1090,284,806,806,0,15,371000.0
371,371999,21.14494952534825,36.0103000622258,0.08996464624940503,126.93766927719116,24.923343896865845,75.58667755126953,1098,284,814,814,0,15,372000.0
372,372999,21.13366814341214,36.01178860600466,0.08986041733479433,127.27293944358826,24.986910343170166,75.94873809814453,1103,285,818,818,0,15,373000.0
373,373999,21.11616487328291,35.98625777912033,0.0899721942578785,127.64868521690369,25.05135440826416,76.23123931884766,1106,285,821,821,0,15,374000.0
374,374999,21.09755338727633,35.95499336940669,0.09005047827162482,127.9964029788971,25.116031408309937,76.52110290527344,1106,285,821,821,0,15,375000.0
375,375999,21.081237202078587,35.929840793593414,0.09006069878440925,128.33154296875,25.17953372001648,76.91261291503906,1106,285,821,821,0,15,376000.0
376,376999,21.06679324087184,35.917173897941986,0.08998415882137312,128.77866077423096,25.24604058265686,76.62627410888672,1108,286,822,822,0,15,377000.0
377,377999,21.051746331781874,35.902383105964645,0.08994983576336169,129.1123926639557,25.309728384017944,76.85923767089844,1110,287,823,823,0,15,378000.0
378,378999,21.033204336881727,35.871358822486926,0.090033757330519,129.49254822731018,25.376540184020996,76.85398864746094,1113,289,824,824,0,15,379000.0
379,379999,21.017918977755908,35.84542596300863,0.09005183595804622,129.80198502540588,25.441207885742188,77.12033081054688,1117,291,826,826,0,15,380000.0
380,380999,21.008781949841264,35.83701038043996,0.08992781602851474,130.1619062423706,25.507214546203613,77.31099700927734,1117,291,826,826,0,15,381000.0
381,381999,20.995940863659477,35.8154412220057,0.08988855927023964,130.52061295509338,25.57726764678955,77.57354736328125,1119,292,827,827,0,15,382000.0
382,382999,20.98793554001421,35.818045041737506,0.08988941825833041,130.9212703704834,25.6452214717865,77.47833251953125,1121,293,828,828,0,15,383000.0
383,383999,20.97731971831055,35.79682215642066,0.08991125035090486,131.30213165283203,25.71157717704773,77.67623138427734,1121,293,828,828,0,15,384000.0
384,384999,20.966165541914812,35.773547536439295,0.08997410185673105,131.68157839775085,25.782719373703003,77.58446502685547,1124,295,829,829,0,15,385000.0
385,385999,20.954009795535217,35.74763037283382,0.09002222684596506,131.99294757843018,25.84824252128601,78.05656433105469,1124,295,829,829,0,15,386000.0
386,386999,20.940601184162574,35.724488255275716,0.0900626264150528,132.38092160224915,25.91663956642151,78.0338134765625,1127,296,831,831,0,15,387000.0
387,387999,20.924592071737347,35.697744356593496,0.09014427806822223,132.67531275749207,26.39849328994751,78.461181640625,1129,297,832,832,0,15,388000.0
388,388999,20.925468004542733,35.733764599054524,0.08986849459294932,132.94402623176575,26.460959434509277,79.49437713623047,1145,298,847,847,0,15,389000.0
389,389999,20.924392284489187,35.736245645654876,0.08999900288408957,133.19318461418152,26.523271560668945,80.34849548339844,1150,299,851,851,0,15,390000.0
390,390999,20.922046740454363,35.72931246406012,0.0900061018507301,133.4446666240692,26.586511611938477,81.02922821044922,1161,300,861,861,0,15,391000.0
391,391999,20.92884696648632,35.74076048728874,0.0901379728287024,133.630229473114,26.646770238876343,82.13043975830078,1162,300,862,862,0,15,392000.0
392,392999,20.94203871978639,35.774022170025056,0.09022374631147134,133.92402005195618,26.7082998752594,82.43659973144531,1170,301,869,869,0,15,393000.0
393,393999,20.961172174909148,35.81957006462416,0.09099144274610016,134.16617727279663,26.77132296562195,83.19111633300781,1174,303,871,871,0,15,394000.0
394,394999,20.985851770896467,35.871360894984015,0.09189536332101822,134.41920042037964,26.835862398147583,83.77627563476562,1178,304,874,874,0,15,395000.0
395,395999,21.011959644724488,35.92084682134737,0.09264276961889883,134.6868314743042,26.898661851882935,84.37776184082031,1178,304,874,874,0,15,396000.0
396,396999,21.04014981105489,35.97354303388275,0.09366604079781604,134.9422664642334,26.961710691452026,84.77730560302734,1180,305,875,875,0,15,397000.0
397,397999,21.076855136140797,36.04983546163132,0.09510602861513318,135.38024139404297,27.02583360671997,84.43562316894531,1182,306,876,876,0,15,398000.0
398,398999,21.105872784214725,36.100713418212784,0.09645889031068378,135.71025586128235,27.08926272392273,84.50009155273438,1187,308,879,879,0,15,399000.0
399,399999,21.141622469503794,36.193084394911764,0.09737657114121201,135.9716296195984,27.153584957122803,84.79393005371094,1191,310,881,881,0,15,400000.0
400,400999,21.177711347509902,36.255333626802646,0.09838298210697838,136.34936833381653,27.218522787094116,84.98841857910156,1191,310,881,881,0,15,401000.0
401,401999,21.215634118310728,36.31399087807969,0.09981867284319335,136.56753420829773,27.282363176345825,85.5915298461914,1193,311,882,882,0,15,402000.0
402,402999,21.25660309837785,36.402548362799685,0.10079687019985029,136.9246609210968,27.351421356201172,85.59342956542969,1197,313,884,884,0,15,403000.0
403,403999,21.298425402642046,36.465766290230526,0.10232663392089725,137.27271056175232,27.41798996925354,85.67388153076172,1204,314,890,890,0,15,404000.0
404,404999,21.340556394829207,36.542652015375275,0.10352118091790585,137.66523003578186,27.482253789901733,85.53573608398438,1207,315,892,892,0,15,405000.0
405,405999,21.37255524314108,36.58268140047669,0.10437164498435836,137.99489212036133,27.548104763031006,85.8891830444336,1207,315,892,892,0,15,406000.0
406,406999,21.388951681431728,36.598169731624864,0.10477680658368493,138.65982127189636,27.609845399856567,86.86006164550781,1220,316,904,904,0,15,407000.0
407,407999,21.39174943149985,36.614485265950506,0.10432300234820091,138.93173384666443,27.673903226852417,87.53163146972656,1241,319,922,922,0,15,408000.0
408,408999,21.39341349211311,36.6425574939153,0.10412201554641765,139.07517051696777,27.739322423934937,89.18035888671875,1245,319,926,926,0,15,409000.0
409,409999,21.39429799098635,36.649575603137876,0.10393021054704121,139.33851528167725,27.803162097930908,89.74325561523438,1248,320,928,928,0,15,410000.0
410,410999,21.396536973323766,36.65500392035065,0.10378809755468554,139.64524817466736,27.867950677871704,89.94989013671875,1252,322,930,930,0,15,411000.0
411,411999,21.396114600138553,36.65265691997384,0.10367489516552231,139.86169052124023,27.93440079689026,90.68082427978516,1255,323,932,932,0,15,412000.0
412,412999,21.394607152306765,36.644782627540614,0.10365325323339991,140.1998393535614,28.00303339958191,90.77682495117188,1259,325,934,934,0,15,413000.0
413,413999,21.391241115743675,36.63139575941347,0.10368638871269698,140.55939054489136,28.07028865814209,90.96168518066406,1260,325,935,935,0,15,414000.0
414,414999,21.39176252264605,36.619860191038484,0.10359990412833442,140.82325720787048,28.136415243148804,91.40077209472656,1263,326,937,937,0,15,415000.0
415,415999,21.39075365944429,36.61041472191325,0.10361568988454362,141.24819421768188,28.202567100524902,91.15505981445312,1265,327,938,938,0,15,416000.0
416,416999,21.389810707069802,36.605091878353726,0.1034980025272566,141.5249252319336,28.269850254058838,91.664306640625,1265,327,938,938,0,15,417000.0
417,417999,21.389003157420248,36.59276803552008,0.10342821119053613,141.9425277709961,28.335082530975342,91.26522064208984,1272,329,943,943,0,15,418000.0
418,418999,21.387896400478116,36.578883520498934,0.10330046751616051,142.26396203041077,28.401431560516357,91.55913543701172,1272,329,943,943,0,15,419000.0
419,419999,21.38914047530986,36.57070285110441,0.10326097592363737,142.5340497493744,28.46866250038147,91.98234558105469,1274,330,944,944,0,15,420000.0
420,420999,21.390032602763522,36.60227651453334,0.1029551697231541,142.968759059906,28.53650975227356,91.89417266845703,1274,330,944,944,0,15,421000.0
421,421999,21.394498040419936,36.621182938063136,0.10272106365115141,143.23812770843506,28.602720975875854,92.22984313964844,1276,331,945,945,0,15,422000.0
422,422999,21.397063245735847,36.614123609258094,0.10265381284895692,143.48412704467773,28.669283390045166,92.87539672851562,1276,331,945,945,0,15,423000.0
423,423999,21.39407636989193,36.59688366268686,0.10261492148476581,143.9497253894806,28.7357177734375,92.49795532226562,1276,331,945,945,0,15,424000.0
424,424999,21.393030052577565,36.583542225036226,0.10257698837795193,144.49538230895996,28.80193305015564,91.83685302734375,1276,331,945,945,0,15,425000.0
425,425999,21.39173531300566,36.56954046263699,0.10252904261286844,144.9614703655243,28.86755919456482,91.55177307128906,1276,331,945,945,0,15,426000.0
426,426999,21.385007646114303,36.54635751435305,0.10243282637191065,145.20437502861023,28.93214440345764,92.37532806396484,1276,331,945,945,0,15,427000.0
427,427999,21.37082936443974,36.52461341834201,0.102378829818769,145.4450454711914,29.478036642074585,93.86072540283203,1295,331,964,964,0,15,428000.0
428,428999,21.354336599346478,36.4982956783593,0.102385125382503,145.6890528202057,29.540152072906494,94.63996124267578,1298,331,967,967,0,15,429000.0
429,429999,21.338210709039156,36.47646909806266,0.10243126115251289,145.9495885372162,29.601295232772827,94.98284149169922,1304,334,970,970,0,15,430000.0
430,430999,21.319876851674657,36.44937340911591,0.10247964737698967,146.172114610672,29.66150665283203,95.61427307128906,1306,335,971,971,0,15,431000.0
431,431999,21.30456224860877,36.422172250449144,0.10250026974257853,146.55312156677246,29.72435688972473,95.33015441894531,1312,337,975,975,0,15,432000.0
432,432999,21.289458993705843,36.40406053859933,0.10248546792428492,146.94109964370728,29.78728485107422,94.9533462524414,1322,341,981,981,0,15,433000.0
433,433999,21.270964464478215,36.3752855471289,0.10254115383570384,147.14694046974182,29.85074806213379,95.7003402709961,1326,343,983,983,0,15,434000.0
434,434999,21.254280922709878,36.3485764126748,0.10259015188032361,147.51839327812195,29.91620397567749,95.7859878540039,1328,344,984,984,0,15,435000.0
435,435999,21.236589690600724,36.32059833649744,0.10268549735513577,147.8121120929718,29.977596759796143,96.21248626708984,1328,344,984,984,0,15,436000.0
436,436999,21.220161095913134,36.29359453255721,0.10279247531630142,148.11430764198303,30.040452241897583,96.4994125366211,1330,345,985,985,0,15,437000.0
437,437999,21.20321185892094,36.268533496369805,0.10285347976837467,148.5222942829132,30.10335612297058,96.54627990722656,1330,345,985,985,0,15,438000.0
438,438999,21.18799818507585,36.24609035697151,0.10289953440074129,148.8999376296997,30.16793394088745,96.53384399414062,1330,345,985,985,0,15,439000.0
439,439999,21.171390201512992,36.219428854467516,0.10299673688455013,149.16847443580627,30.230016231536865,96.99624633789062,1330,345,985,985,0,15,440000.0
440,440999,21.154726762151675,36.19120673300748,0.10310983494782577,149.57281303405762,30.29561996459961,96.76435852050781,1336,347,989,989,0,15,441000.0
441,441999,21.13718525651867,36.16131248991622,0.10322462830518064,149.83511304855347,30.36086344718933,97.19351959228516,1338,348,990,990,0,15,442000.0
442,442999,21.123073777095538,36.13764512379062,0.10328380867199216,150.18879580497742,30.425979614257812,97.36466979980469,1338,348,990,990,0,15,443000.0
443,443999,21.10629369338342,36.109583657400854,0.10338004402558687,150.5679817199707,30.490787029266357,97.38093566894531,1338,348,990,990,0,15,444000.0
444,444999,21.08923751993553,36.08180146547185,0.10349432702688233,150.97638535499573,30.556787729263306,97.22168731689453,1340,349,991,991,0,15,445000.0
445,445999,21.07382012449045,36.05725145297873,0.10361659213851704,151.29371309280396,30.620583057403564,97.36164093017578,1343,350,993,993,0,15,446000.0
446,446999,21.055840515469324,36.02898830933654,0.10377777131044874,151.6763734817505,30.68305778503418,97.44232940673828,1359,352,1007,1007,0,15,447000.0
447,447999,21.039005000987142,36.01541122810043,0.10378655147907356,151.89752626419067,30.75062656402588,98.48467254638672,1365,353,1012,1012,0,15,448000.0
448,448999,21.01776513640039,35.985112952525064,0.10395425460156693,152.15797066688538,30.814520120620728,99.14252471923828,1370,354,1016,1016,0,15,449000.0
449,449999,20.99871645047591,35.965758666679044,0.10404379597959479,152.48704481124878,30.879685401916504,99.31668090820312,1373,355,1018,1018,0,15,450000.0
450,450999,20.97952030064839,35.94109440761727,0.10418333524901024,152.76152300834656,30.945131540298462,99.72991180419922,1375,356,1019,1019,0,15,451000.0
451,451999,20.962522762538967,35.91395922762559,0.10431413705348358,153.6037619113922,31.011773586273193,100.1342544555664,1375,356,1019,1019,0,15,452000.0
452,452999,20.94493017596304,35.891432903266036,0.10439185242496551,153.94674372673035,31.07611584663391,100.16963958740234,1377,357,1020,1020,0,15,453000.0
453,453999,20.925881809092697,35.865069383124826,0.10451485395434001,154.22713136672974,31.1438090801239,100.6880111694336,1377,357,1020,1020,0,15,454000.0
454,454999,20.909254258967763,35.840292641315244,0.10462129839914203,154.5499382019043,31.210631608963013,100.92206573486328,1377,357,1020,1020,0,15,455000.0
455,455999,20.89046731589632,35.815160567185316,0.10475681944890158,154.96087217330933,31.273914098739624,100.57820892333984,1379,358,1021,1021,0,15,456000.0
456,456999,20.871916866557832,35.789626256761096,0.10484565539225799,155.24499917030334,31.342453002929688,101.16044616699219,1379,358,1021,1021,0,15,457000.0
457,457999,20.85578127329517,35.775062753557144,0.10482968090842815,155.73967361450195,31.406748056411743,100.62064361572266,1379,358,1021,1021,0,15,458000.0
458,458999,20.837249147561973,35.745300839672836,0.10495824988980129,155.96586775779724,31.472505807876587,101.07947540283203,1380,359,1021,1021,0,15,459000.0
459,459999,20.821459668895997,35.72427153447131,0.1049744617700138,156.34690642356873,31.54884123802185,101.11334228515625,1386,361,1025,1025,0,15,460000.0
460,460999,20.805950660625804,35.69992692346003,0.10503062349223247,156.7170901298523,31.614800453186035,100.89056396484375,1390,363,1027,1027,0,15,461000.0
461,461999,20.791385593936944,35.674553801534806,0.10506711973413696,157.03748869895935,31.68286967277527,101.20506286621094,1390,363,1027,1027,0,15,462000.0
462,462999,20.777725251745345,35.64981323487338,0.1051111368956773,157.2736620903015,31.746724843978882,101.79817962646484,1390,363,1027,1027,0,15,463000.0
463,463999,20.765656591835448,35.62824747153966,0.10515360216681635,157.64763283729553,31.81180477142334,101.81876373291016,1390,363,1027,1027,0,15,464000.0
464,464999,20.75318857212272,35.605168684011254,0.10518667043356589,158.00958108901978,31.878994703292847,101.62445831298828,1410,365,1045,1045,0,15,465000.0
465,465999,20.742298905590072,35.585544153513766,0.10521752524800354,158.3678686618805,31.945468187332153,101.61051177978516,1413,366,1047,1047,0,15,466000.0
466,466999,20.724815241681764,35.55782432244026,0.10531075267892598,158.75013780593872,32.00906300544739,101.3651123046875,1417,368,1049,1049,0,15,467000.0
467,467999,20.70768321049814,35.53203616962116,0.10535380480618395,159.03714656829834,32.07492160797119,102.3167724609375,1433,369,1064,1064,0,15,468000.0
468,468999,20.692663781599418,35.52125949344074,0.1053361354647705,159.2854986190796,32.14067363739014,103.17841339111328,1454,371,1083,1083,0,15,469000.0
469,469999,20.67908811185362,35.49978333072303,0.1053473696910161,159.49082016944885,32.207125425338745,104.38772583007812,1456,371,1085,1085,0,15,470000.0
470,470999,20.665369068215206,35.47674557646105,0.10540023962401701,159.6903600692749,32.275038957595825,105.3158187866211,1456,371,1085,1085,0,15,471000.0
471,471999,20.655387488425582,35.47057466251434,0.10533634584791396,160.03047728538513,32.33979296684265,105.26396942138672,1463,374,1089,1089,0,15,472000.0
472,472999,20.643082853042976,35.44974103167067,0.10537368786335455,160.27899837493896,32.40605616569519,105.8371810913086,1465,375,1090,1090,0,15,473000.0
473,473999,20.63002646202041,35.433620023409105,0.10536946171122841,160.46213555335999,32.472657680511475,106.62227630615234,1479,376,1103,1103,0,15,474000.0
474,474999,20.621491104785356,35.43781957551867,0.10523801307670544,160.89673590660095,32.539515256881714,106.48377990722656,1480,376,1104,1104,0,15,475000.0
475,475999,20.613549237631133,35.4307633163527,0.10502374738652531,161.1964852809906,32.60699462890625,107.0719985961914,1480,376,1104,1104,0,15,476000.0
476,476999,20.60541013520177,35.42387073596613,0.10487743201410948,161.5472173690796,32.67563533782959,106.9928207397461,1484,378,1106,1106,0,15,477000.0
477,477999,20.594663912733274,35.403314207347556,0.10483892387042482,161.95214080810547,32.73948049545288,106.71989440917969,1488,380,1108,1108,0,15,478000.0
478,478999,20.58520143042336,35.38662387204004,0.10477430831165069,162.7231957912445,32.809985637664795,107.60436248779297,1488,380,1108,1108,0,15,479000.0
479,479999,20.576833031365922,35.368880928457784,0.10471170624645698,163.11594796180725,32.87933897972107,107.56785583496094,1488,380,1108,1108,0,15,480000.0
480,480999,20.566365854470007,35.34803256429528,0.10468573824148819,163.48341870307922,32.94952082633972,107.49432373046875,1494,383,1111,1111,0,15,481000.0
481,481999,20.56032265899967,35.33574983908558,0.10460278602742235,163.81866884231567,33.02044057846069,107.9185562133789,1494,383,1111,1111,0,15,482000.0
482,482999,20.554394966838345,35.32126051722064,0.10454963268882123,164.06551575660706,33.08939576148987,108.58361053466797,1494,383,1111,1111,0,15,483000.0
483,483999,20.549452517481736,35.30988855072352,0.10445692288305752,164.38202047348022,33.16167616844177,108.83734130859375,1494,383,1111,1111,0,15,484000.0
484,484999,20.544503794333757,35.297890522981035,0.10436249876466497,164.84767866134644,33.231860876083374,108.63603973388672,1494,383,1111,1111,0,15,485000.0
485,485999,20.540468394211615,35.286377571778544,0.10426989925809416,165.23471212387085,33.30190706253052,108.5951156616211,1498,385,1113,1113,0,15,486000.0
486,486999,20.535421093579654,35.27394450416087,0.10416270935695493,165.66535758972168,33.380370140075684,108.47837829589844,1500,386,1114,1114,0,15,487000.0
487,487999,20.52381535912457,35.255696264256834,0.10413333678079695,165.98160409927368,33.448235511779785,109.22477722167969,1517,387,1130,1130,0,15,488000.0
488,488999,20.515696464396484,35.25402281067938,0.1039762483954948,166.23073267936707,33.513017654418945,110.20417022705078,1541,389,1152,1152,0,15,489000.0
489,489999,20.50481241281229,35.244858184837256,0.10391091305585254,166.40368509292603,33.57801175117493,111.60045623779297,1554,390,1164,1164,0,15,490000.0
490,490999,20.49295070215721,35.22263747714285,0.10393384866441424,166.6143147945404,33.64223766326904,112.63468170166016,1557,391,1166,1166,0,15,491000.0
491,491999,20.48568304089425,35.2218259935655,0.10382218120625375,166.8194477558136,33.706522941589355,113.46997833251953,1571,393,1178,1178,0,15,492000.0
492,492999,20.478156348848916,35.20704825987224,0.10383558693660633,167.14460635185242,33.773956060409546,113.32726287841797,1583,397,1186,1186,0,15,493000.0
493,493999,20.470350309905704,35.19293407416934,0.10379577801655682,167.40793561935425,33.8400239944458,114.0349349975586,1587,398,1189,1189,0,15,494000.0
494,494999,20.462285248496038,35.18072272326373,0.10374451592934553,167.74777603149414,33.90614199638367,113.96992492675781,1602,403,1199,1199,0,15,495000.0
495,495999,20.453095272038297,35.16147044574197,0.10369714747789194,167.99262404441833,33.9734582901001,114.8617935180664,1602,403,1199,1199,0,15,496000.0
496,496999,20.446598877953306,35.15021945122582,0.10360908764964993,168.21570420265198,34.039281606674194,115.39250183105469,1606,405,1201,1201,0,15,497000.0
497,497999,20.44111191543019,35.14031872423362,0.10356452951560091,168.5947003364563,34.106085538864136,115.44882202148438,1608,406,1202,1202,0,15,498000.0
498,498999,20.43819683976167,35.132491186210316,0.10348536884553927,169.00514769554138,34.174412965774536,115.4655990600586,1610,407,1203,1203,0,15,499000.0
499,499999,20.43968336728993,35.1402913528156,0.10336734746912557,169.32951021194458,34.23871469497681,115.62332153320312,1613,408,1205,1205,0,15,500000.0
500,500999,20.43897190001117,35.13477412756415,0.10329881456094903,169.56050276756287,34.30298614501953,116.18598937988281,1615,409,1206,1206,0,15,501000.0
501,501999,20.443566510254247,35.14317489130832,0.10324153467780983,169.89026165008545,34.36820197105408,116.51337432861328,1615,409,1206,1206,0,15,502000.0
502,502999,20.453910417912372,35.15967027717604,0.10346318339589566,170.2720022201538,34.431042432785034,116.28211975097656,1619,411,1208,1208,0,15,503000.0
503,503999,20.45931728628223,35.19482371414336,0.10341950126337618,171.17132234573364,34.496402978897095,116.61270904541016,1623,412,1211,1211,0,15,504000.0
504,504999,20.464362118587,35.201754899386984,0.10337570488529435,171.49649381637573,34.563509941101074,116.8063735961914,1625,413,1212,1212,0,15,505000.0
505,505999,20.470246007375955,35.208468277421055,0.10362137176782937,171.88434481620789,34.629581928253174,116.60520935058594,1631,415,1216,1216,0,15,506000.0
506,506999,20.474699505620926,35.24312189521145,0.10345360232567602,172.08747816085815,34.697641372680664,117.44822692871094,1631,415,1216,1216,0,15,507000.0
507,507999,20.473814988157894,35.238184361765455,0.10361662601891442,172.48632144927979,34.76336860656738,117.28374481201172,1635,417,1218,1218,0,15,508000.0
508,508999,20.467158646974475,35.24457704580879,0.10365537286289483,172.80010223388672,34.831552028656006,118.00953674316406,1653,419,1234,1234,0,15,509000.0
509,509999,20.457412019827117,35.231808022713295,0.10393336221789296,173.16226959228516,34.89919996261597,118.2331314086914,1667,421,1246,1246,0,15,510000.0
510,510999,20.447751086735412,35.223145742618435,0.1040332075533511,173.52252888679504,34.96555995941162,118.66557312011719,1669,421,1248,1248,0,15,511000.0
511,511999,20.439613423140266,35.2097087893119,0.10411002153307358,173.89667749404907,35.029361724853516,118.81769561767578,1670,421,1249,1249,0,15,512000.0
512,512999,20.433397281586426,35.204989668788265,0.1042524394213653,174.2048556804657,35.09379577636719,119.27119445800781,1670,421,1249,1249,0,15,513000.0
513,513999,20.425889919411958,35.194050459837534,0.10422492788367976,174.61475348472595,35.15783071517944,119.05702209472656,1674,423,1251,1251,0,15,514000.0
514,514999,20.419299970219175,35.180112369545014,0.10426963978862891,174.90426778793335,35.222472190856934,119.36323547363281,1675,424,1251,1251,0,15,515000.0
515,515999,20.410608238801352,35.164155649506775,0.10422577590274118,175.2600383758545,35.290807247161865,119.45039367675781,1696,428,1268,1268,0,15,516000.0
516,516999,20.403085090781346,35.15175422986055,0.10433249240571962,175.4999647140503,35.357505798339844,120.5302505493164,1700,429,1271,1271,0,15,517000.0
517,517999,20.395554606238566,35.13803199863552,0.10434943405189312,175.68714332580566,35.422828912734985,121.42604064941406,1703,430,1273,1273,0,15,518000.0
518,518999,20.386514118104724,35.12284041552199,0.10455229665473365,176.02754545211792,35.493587255477905,121.80062866210938,1724,431,1293,1293,0,15,519000.0
519,519999,20.377086644485857,35.10469225617474,0.10463218238765015,176.32541584968567,35.55960559844971,122.20256042480469,1724,431,1293,1293,0,15,520000.0
520,520999,20.373317989310472,35.14760799048235,0.10435783786789099,176.83815813064575,35.625770807266235,121.508544921875,1726,432,1294,1294,0,15,521000.0
521,521999,20.369156452650643,35.13582475081269,0.10445265717395769,177.12720894813538,35.69128084182739,121.95181274414062,1730,434,1296,1296,0,15,522000.0
522,522999,20.36330755747289,35.13710176626086,0.10435392442331981,177.33151602745056,35.75774168968201,122.7948989868164,1730,434,1296,1296,0,15,523000.0
523,523999,20.352747656988345,35.11817799920931,0.10446047207985831,177.62526082992554,35.823217153549194,123.35084533691406,1730,434,1296,1296,0,15,524000.0
524,524999,20.342616504653968,35.09887718568612,0.10453339570577957,178.01526165008545,35.88953733444214,123.49072265625,1732,435,1297,1297,0,15,525000.0
525,525999,20.33920805972352,35.120533460379,0.10429935643890131,178.2243893146515,35.95188093185425,124.77608489990234,1749,436,1313,1313,0,15,526000.0
526,526999,20.330063273969273,35.103961456995165,0.10429896793104132,178.47996544837952,36.014580726623535,125.64601135253906,1755,436,1319,1319,0,15,527000.0
527,527999,20.32268631343307,35.091699834516774,0.10428821591297766,178.68238878250122,36.075963735580444,126.6053237915039,1769,437,1332,1332,0,15,528000.0
528,528999,20.313378896372242,35.078452624988216,0.10427616240441928,178.90243244171143,36.137712717056274,127.41481018066406,1774,439,1335,1335,0,15,529000.0
529,529999,20.307451484446755,35.06883640941946,0.10421811776124301,179.15169739723206,36.20039701461792,128.01680755615234,1777,440,1337,1337,0,15,530000.0
530,530999,20.303138312843746,35.070996174602776,0.10403357232576615,179.41664743423462,36.26259112358093,128.61223602294922,1804,441,1363,1363,0,15,531000.0
531,531999,20.296565325196315,35.06265436547217,0.10391438881996073,179.67249202728271,36.328476667404175,129.00882720947266,1808,443,1365,1365,0,15,532000.0
532,532999,20.291059068169833,35.08639070125766,0.1036116301660246,180.6234269142151,36.393911838531494,129.26810455322266,1810,444,1366,1366,0,15,533000.0
533,533999,20.28596038191913,35.084329313853445,0.10345158898833529,180.96600031852722,36.45778799057007,129.5471649169922,1810,444,1366,1366,0,15,534000.0
534,534999,20.280188367054716,35.06886784644197,0.1034622629281805,181.24087238311768,36.52221131324768,130.09844207763672,1810,444,1366,1366,0,15,535000.0
535,535999,20.2758095214635,35.06582852179509,0.10338482493660972,181.6299660205841,36.58605170249939,129.96150970458984,1812,445,1367,1367,0,15,536000.0
536,536999,20.274156964886377,35.06821398086783,0.10328830429780755,181.8961465358734,36.658214807510376,130.53793334960938,1812,445,1367,1367,0,15,537000.0
537,537999,20.27851190425975,35.07755049431453,0.10308040559921017,182.36869549751282,36.72335481643677,130.06066131591797,1814,446,1368,1368,0,15,538000.0
538,538999,20.282996524648386,35.08411617476803,0.10293717009738201,182.59878969192505,36.788230419158936,130.65460205078125,1814,446,1368,1368,0,15,539000.0
539,539999,20.284297337983176,35.08489356399676,0.10284535482702406,182.8868613243103,36.85356378555298,130.8408203125,1818,448,1370,1370,0,15,540000.0
540,540999,20.289514544645943,35.111068900974715,0.10257934150180636,183.211487531662,36.91941595077515,130.89710998535156,1820,449,1371,1371,0,15,541000.0
541,541999,20.290913817775337,35.107034412320246,0.10247024313883768,183.6590223312378,36.98222064971924,130.60913848876953,1822,450,1372,1372,0,15,542000.0
542,542999,20.291181088827038,35.1032083954831,0.10244756393845511,183.99800848960876,37.04757738113403,130.3946762084961,1829,453,1376,1376,0,15,543000.0
543,543999,20.287656760945886,35.09162646826542,0.10236206503247924,184.22848963737488,37.11518597602844,131.06342315673828,1830,454,1376,1376,0,15,544000.0
544,544999,20.282391769171735,35.08287375793484,0.1022936246813877,184.54010152816772,37.183497190475464,131.92850494384766,1846,455,1391,1391,0,15,545000.0
545,545999,20.272441564105613,35.07926757294628,0.10223567143849388,184.80952835083008,37.249998807907104,132.85890197753906,1864,456,1408,1408,0,15,546000.0
546,546999,20.26205582752579,35.061214760367,0.10221935132776239,184.94480538368225,37.31274366378784,134.47727966308594,1868,456,1412,1412,0,15,547000.0
547,547999,20.253270191615606,35.05728816950153,0.10212034645478962,185.17481923103333,37.37556338310242,135.0388946533203,1873,458,1415,1415,0,15,548000.0
548,548999,20.24469599389681,35.041733258835706,0.10206278762888876,185.35619688034058,37.44178581237793,135.9214096069336,1875,459,1416,1416,0,15,549000.0
549,549999,20.236986013948673,35.02778919626958,0.10200728124110914,185.75849318504333,37.50788497924805,135.7317123413086,1880,461,1419,1419,0,15,550000.0
550,550999,20.231122356820546,35.013223804108605,0.10196318919035285,185.95470476150513,37.57542037963867,136.6790771484375,1880,461,1419,1419,0,15,551000.0
551,551999,20.229482466474956,35.00773294933643,0.1018473789697586,186.32145428657532,37.64380431175232,136.802978515625,1881,461,1420,1420,0,15,552000.0
552,552999,20.22370422869053,34.994606703267486,0.1018131397592047,186.75936579704285,37.70593976974487,136.53343200683594,1881,461,1420,1420,0,15,553000.0
553,553999,20.221074899168425,34.984373695055936,0.10178207464097755,187.06549382209778,37.773600578308105,136.71106719970703,1885,463,1422,1422,0,15,554000.0
554,554999,20.219393977496644,34.979142972056785,0.10171093281891364,187.29225325584412,37.8380970954895,137.19561767578125,1887,464,1423,1423,0,15,555000.0
555,555999,20.21595010394857,34.969034784095264,0.10175318072609818,187.68435263633728,37.90305161476135,136.7983169555664,1895,468,1427,1427,0,15,556000.0
556,556999,20.212024545352953,34.9579149208886,0.10180053844252324,187.88666439056396,37.970027446746826,137.69728088378906,1895,468,1427,1427,0,15,557000.0
557,557999,20.206762486923072,34.94528569710706,0.10186937461028278,188.17711853981018,38.033647298812866,138.0352783203125,1895,468,1427,1427,0,15,558000.0
558,558999,20.204322268989156,34.93743876136338,0.10192502985878937,188.66216230392456,38.102492809295654,137.53868865966797,1897,469,1428,1428,0,15,559000.0
559,559999,20.200236456772917,34.92759567407937,0.10200734915215148,188.86103653907776,38.16919755935669,138.43032836914062,1897,469,1428,1428,0,15,560000.0
560,560999,20.196570771857363,34.91786303250637,0.10209014300123664,189.25612139701843,38.23484826087952,138.28968048095703,1899,470,1429,1429,0,15,561000.0
561,561999,20.195818798747105,34.91459922729688,0.10217023887026344,189.6081030368805,38.299822092056274,138.11502075195312,1903,472,1431,1431,0,15,562000.0
562,562999,20.194551069161612,34.90838445162924,0.10219808902062855,190.16015243530273,38.36503076553345,137.14344787597656,1907,474,1433,1433,0,15,563000.0
563,563999,20.193636361163353,34.9030934073146,0.10219139016017742,191.0901119709015,38.43048620223999,137.74717712402344,1909,475,1434,1434,0,15,564000.0
564,564999,20.18888554701332,34.89329390435499,0.10207252193543948,191.2800214290619,38.495128870010376,139.16532135009766,1933,475,1458,1458,0,15,565000.0
565,565999,20.17913391784862,34.88129410990892,0.10196545128659995,191.45990538597107,38.556716442108154,140.74004364013672,1936,475,1461,1461,0,15,566000.0
566,566999,20.16798389452363,34.86518910920666,0.10197921035676527,191.60027480125427,38.617999792099,141.9988250732422,1940,475,1465,1465,0,15,567000.0
567,567999,20.157718235699534,34.854388046141686,0.10197369760950004,191.8972029685974,38.68003964424133,142.22798919677734,1947,478,1469,1469,0,15,568000.0
568,568999,20.14594325350092,34.834983332048346,0.10199378699328043,192.07181644439697,38.741321086883545,143.18881225585938,1947,478,1469,1469,0,15,569000.0
569,569999,20.136069146924534,34.81885971226974,0.10203684550375403,192.44524598121643,38.806257486343384,142.83153533935547,1955,482,1473,1473,0,15,570000.0
570,570999,20.12386288008109,34.79882397420646,0.10207585443523604,192.81757020950317,38.8711473941803,143.03466033935547,1959,484,1475,1475,0,15,571000.0
571,571999,20.112685940249097,34.781080103748344,0.10213183317786068,193.04488945007324,38.93505048751831,143.75078582763672,1961,485,1476,1476,0,15,572000.0
572,572999,20.1003708337074,34.76185779974404,0.10216987847706527,193.31174182891846,39.00011467933655,144.13936614990234,1963,486,1477,1477,0,15,573000.0
573,573999,20.091283637413575,34.7455001114407,0.10218259433774202,193.6273226737976,39.06201505661011,144.3477020263672,1963,486,1477,1477,0,15,574000.0
574,574999,20.08034651836389,34.726015829661286,0.10221152480914542,193.890296459198,39.12252235412598,144.64859008789062,1965,487,1478,1478,0,15,575000.0
575,575999,20.072337346742458,34.74458236921587,0.1020135194932803,194.28340935707092,39.18532848358154,144.04978942871094,1973,491,1482,1482,0,15,576000.0
576,576999,20.0610313232103,34.724487351298855,0.10202931814384064,194.62372875213623,39.24897861480713,144.35567474365234,1973,491,1482,1482,0,15,577000.0
577,577999,20.05286646707949,34.70858148451007,0.10202202618643741,194.8124430179596,39.31037259101868,145.14761352539062,1973,491,1482,1482,0,15,578000.0
578,578999,20.04323789376617,34.69143196434198,0.10201045277714949,195.17111611366272,39.3756058216095,145.14972686767578,1978,492,1486,1486,0,15,579000.0
579,579999,20.036289785458877,34.67826144760258,0.10197232480944651,195.57261848449707,39.443464040756226,144.89794158935547,1987,494,1493,1493,0,15,580000.0
580,580999,20.03044110079857,34.684593786680004,0.10183900610323593,195.90957498550415,39.50915575027466,145.19741821289062,1987,494,1493,1493,0,15,581000.0
581,581999,20.021804274013448,34.66729671207338,0.10186330184558212,196.3150191307068,39.57581281661987,144.98894500732422,1991,496,1495,1495,0,15,582000.0
582,582999,20.014455686300767,34.65156685830743,0.10188972348098957,196.77426481246948,39.64186954498291,144.6375961303711,1993,497,1496,1496,0,15,583000.0
583,583999,20.004033449679472,34.63407145021438,0.10194816664548856,197.11518573760986,39.711899518966675,144.9948959350586,1993,497,1496,1496,0,15,584000.0
584,584999,19.99644930387084,34.63565436010501,0.10190540451405228,197.38461446762085,39.77840518951416,146.01136016845703,2009,498,1511,1511,0,15,585000.0
585,585999,19.98473670129657,34.6155676456085,0.10189818514925753,197.6514184474945,39.84497666358948,146.87171173095703,2013,499,1514,1514,0,15,586000.0
586,586999,19.97479887377175,34.611520495517524,0.10186885647559873,197.8273401260376,39.91108059883118,148.27306365966797,2034,500,1534,1534,0,15,587000.0
587,587999,19.964929765530343,34.596626593654904,0.1018769575501911,198.04724073410034,39.97723150253296,149.3343963623047,2035,500,1535,1535,0,15,588000.0
588,588999,19.957197519404733,34.58499142568035,0.10181629775673129,198.2909381389618,40.04533362388611,149.72987365722656,2041,503,1538,1538,0,15,589000.0
589,589999,19.950657862033694,34.57253953650015,0.10180711158220013,198.56816411018372,40.113603830337524,149.97740936279297,2048,506,1542,1542,0,15,590000.0
590,590999,19.943862726363257,34.565344851699145,0.10177946966993312,198.84383821487427,40.182393074035645,150.60003662109375,2050,507,1543,1543,0,15,591000.0
591,591999,19.93694825351369,34.54995002217767,0.10178668798396828,199.15021395683289,40.24951457977295,151.06665802001953,2051,507,1544,1544,0,15,592000.0
592,592999,19.93031106706893,34.53599887445488,0.10182362636661768,199.42850542068481,40.31875538825989,151.58856964111328,2051,507,1544,1544,0,15,593000.0
593,593999,19.92321583582405,34.52285376171101,0.10185511522552204,199.9112846851349,40.38790822029114,150.97084045410156,2055,509,1546,1546,0,15,594000.0
594,594999,19.920265988108962,34.521311945535636,0.10181377183351115,200.37585186958313,41.199249505996704,150.55320739746094,2061,512,1549,1549,0,15,595000.0
595,595999,19.916265573267477,34.516819052819436,0.10175020628508369,200.5919966697693,41.26758003234863,151.27523803710938,2065,514,1551,1551,0,15,596000.0
596,596999,19.91248494994957,34.50572675234248,0.10178427860374883,200.90867018699646,41.335508584976196,151.58575439453125,2067,515,1552,1552,0,15,597000.0
597,597999,19.907796666929,34.4958148471868,0.10178964139911517,201.2238154411316,41.40480923652649,151.98262786865234,2074,516,1558,1558,0,15,598000.0
598,598999,19.90305383779416,34.483988869440694,0.10181437530202275,201.53909492492676,41.476887702941895,152.4414825439453,2074,516,1558,1558,0,15,599000.0
599,599999,19.901348591043472,34.47691872689921,0.10180727329770956,201.74613857269287,41.54502820968628,153.24646759033203,2074,516,1558,1558,0,15,600000.0
600,600999,19.897896979125964,34.466918900286956,0.10183820696308532,202.15707278251648,41.61358857154846,153.16545867919922,2074,516,1558,1558,0,15,601000.0
601,601999,19.895573007024055,34.457125940621744,0.10181981606201218,202.52878403663635,41.68434810638428,153.19412994384766,2099,517,1582,1582,0,15,602000.0
602,602999,19.89151176433004,34.44518091219645,0.10178304950883554,202.99757862091064,41.7531259059906,152.76641082763672,2103,519,1584,1584,0,15,603000.0
603,603999,19.88753940559844,34.4412495734157,0.10168133603868001,203.35621571540833,41.82392454147339,153.08875274658203,2103,519,1584,1584,0,15,604000.0
604,604999,19.880421972041823,34.42631250507979,0.10174197959015008,203.63928723335266,41.89302086830139,154.00140380859375,2115,520,1595,1595,0,15,605000.0
605,605999,19.87235678143524,34.41339866928512,0.10163929100069768,203.9758243560791,41.96089744567871,154.42176055908203,2128,522,1606,1606,0,15,606000.0
606,606999,19.86569012614036,34.40079204243213,0.10156449547644886,204.24221348762512,42.028050661087036,155.08623504638672,2146,523,1623,1623,0,15,607000.0
607,607999,19.858710507417257,34.38920013314677,0.10148283131251468,204.4574179649353,42.09545850753784,156.21070861816406,2154,524,1630,1630,0,15,608000.0
608,608999,19.85369593730921,34.3786327483119,0.10140656568003636,204.8493685722351,42.16284680366516,156.3768539428711,2156,525,1631,1631,0,15,609000.0
609,609999,19.848454768257657,34.36704437597644,0.10138076521837502,205.0808129310608,42.23000907897949,157.20252990722656,2158,526,1632,1632,0,15,610000.0
610,610999,19.844993392477694,34.3644596799879,0.101266916205078,205.35940599441528,42.2986364364624,157.74422454833984,2160,527,1633,1633,0,15,611000.0
611,611999,19.839619649750837,34.352430222729005,0.10118790367226849,205.70743584632874,42.36728239059448,157.72743225097656,2166,530,1636,1636,0,15,612000.0
612,612999,19.835960359539534,34.34557579889524,0.10109991900813065,205.97539854049683,42.437570571899414,158.25363159179688,2171,532,1639,1639,0,15,613000.0
613,613999,19.831020205333708,34.334763223935376,0.10103329767051394,206.2416455745697,42.506810903549194,158.94123077392578,2171,532,1639,1639,0,15,614000.0
614,614999,19.829901769236653,34.33108589824111,0.10095621681371625,206.59410905838013,42.57547640800476,159.1739501953125,2171,532,1639,1639,0,15,615000.0
615,615999,19.831074141627102,34.32871712459511,0.10094503660723053,206.83881068229675,42.64323401451111,159.8462142944336,2171,532,1639,1639,0,15,616000.0
616,616999,19.835382682415915,34.331070219667,0.10115105046926565,207.35625743865967,42.71273899078369,159.2151336669922,2172,533,1639,1639,0,15,617000.0
617,617999,19.845417699709134,34.36861399797198,0.1014833651016741,207.72200202941895,42.78474545478821,159.1007080078125,2180,537,1643,1643,0,15,618000.0
618,618999,19.85507219222748,34.38207040638656,0.10172722869924589,208.00974440574646,42.85574817657471,159.7067413330078,2180,537,1643,1643,0,15,619000.0
619,619999,19.86968786704789,34.403995353407346,0.10188524699607837,208.22244834899902,42.92639994621277,160.56920623779297,2180,537,1643,1643,0,15,620000.0
620,620999,19.883812577282978,34.42127115035099,0.10192311855359837,208.64186215400696,42.99617099761963,160.17191314697266,2186,540,1646,1646,0,15,621000.0
621,621999,19.893833464632035,34.43060158905675,0.10188656263938123,208.99285125732422,43.0668158531189,160.462158203125,2186,540,1646,1646,0,15,622000.0
622,622999,19.906867094166802,34.4454257455212,0.10192046400920318,209.3298659324646,43.136122941970825,160.6295928955078,2188,541,1647,1647,0,15,623000.0
623,623999,19.91508749714225,34.44670690451121,0.10191896399798128,209.68522715568542,43.20720863342285,160.89783477783203,2190,542,1648,1648,0,15,624000.0
624,624999,19.912857231731998,34.43842896419464,0.10181599901347649,209.90949392318726,43.271939516067505,162.25897216796875,2211,543,1668,1668,0,15,625000.0
625,625999,19.910135167252914,34.43112840807474,0.1016293974797966,210.2004430294037,43.336071491241455,163.18124389648438,2231,544,1687,1687,0,15,626000.0
626,626999,19.908783030962493,34.428182801653406,0.10149962620174946,210.43251395225525,43.40182399749756,164.18560791015625,2235,544,1691,1691,0,15,627000.0
627,627999,19.906346629815477,34.421167298138634,0.1013591817401438,210.6591386795044,43.46571683883667,165.16226959228516,2235,544,1691,1691,0,15,628000.0
628,628999,19.90514417752933,34.4211177144252,0.10122284660966119,210.92556953430176,43.53116798400879,165.80084991455078,2237,545,1692,1692,0,15,629000.0
629,629999,19.90276424029231,34.410751876266154,0.10117140575981476,211.14223837852478,43.596110820770264,166.51333618164062,2241,547,1694,1694,0,15,630000.0
630,630999,19.899501555949968,34.40103937420683,0.10116596577911097,212.22513365745544,43.661261796951294,166.7847137451172,2252,551,1701,1701,0,15,631000.0
631,631999,19.89995650835666,34.42493081151968,0.1009222883071671,212.52921676635742,43.73241901397705,167.23253631591797,2256,553,1703,1703,0,15,632000.0
632,632999,19.899965286199954,34.41891982975069,0.10086131035187762,212.8328080177307,43.79867649078369,167.52669525146484,2263,555,1708,1708,0,15,633000.0
633,633999,19.899461376193653,34.41723320058496,0.10078671557390917,213.11768198013306,43.86464715003967,168.00955963134766,2267,557,1710,1710,0,15,634000.0
634,634999,19.899564006256934,34.4102839000281,0.1007715668699426,213.6198182106018,43.93221139907837,167.3964385986328,2271,559,1712,1712,0,15,635000.0
635,635999,19.902209065836708,34.407610546488705,0.1007185732862087,213.911780834198,43.99960780143738,167.75521850585938,2310,563,1747,1747,0,15,636000.0
636,636999,19.906364938457113,34.43065574823008,0.10064409734063018,214.15604066848755,44.06537079811096,168.48725128173828,2310,563,1747,1747,0,15,637000.0
637,637999,19.90831037290247,34.427005408469974,0.10060590726852348,214.4869110584259,44.13170838356018,168.86688995361328,2310,563,1747,1747,0,15,638000.0
638,638999,19.913352735295888,34.427555762575096,0.10065976382613384,214.82241034507751,44.19813799858093,169.0073699951172,2312,564,1748,1748,0,15,639000.0
639,639999,19.92067723592087,34.434728446320975,0.10072385301032905,215.02487230300903,44.26490616798401,169.73524475097656,2314,565,1749,1749,0,15,640000.0
640,640999,19.926993527671225,34.43761393809809,0.10078382476769188,215.48138117790222,44.33150029182434,169.39378356933594,2316,566,1750,1750,0,15,641000.0
641,641999,19.93275548455478,34.43802496572029,0.1007861544693962,215.98661375045776,44.39876317977905,169.08951568603516,2316,566,1750,1750,0,15,642000.0
642,642999,19.941130225809605,34.44310723655545,0.1008628209909802,216.2237091064453,44.46600842475891,169.91840362548828,2316,566,1750,1750,0,15,643000.0
643,643999,19.94570170144712,34.43958491666647,0.10088265803683205,216.44010400772095,44.53332018852234,170.70282745361328,2316,566,1750,1750,0,15,644000.0
644,644999,19.94754358622854,34.43411539141754,0.10076423796608758,216.76549458503723,44.605095863342285,171.5167465209961,2328,567,1761,1761,0,15,645000.0
645,645999,19.945775910274154,34.443650022797506,0.10057463140753842,217.05064129829407,44.6713182926178,172.3477020263672,2331,568,1763,1763,0,15,646000.0
646,646999,19.944645189537916,34.43812619180858,0.10048750597826195,217.3450448513031,44.737911224365234,173.03522491455078,2333,568,1765,1765,0,15,647000.0
647,647999,19.94227498997878,34.43622825986403,0.10038796551059559,217.62333035469055,44.803282260894775,173.47826385498047,2336,569,1767,1767,0,15,648000.0
648,648999,19.939089924821452,34.424962050814855,0.10035464761277701,217.94485139846802,44.880977392196655,174.16778564453125,2351,570,1781,1781,0,15,649000.0
649,649999,19.93762013986839,34.41749185719734,0.10029378041732873,218.35903191566467,44.94811987876892,174.15985870361328,2355,572,1783,1783,0,15,650000.0
650,650999,19.936444478735414,34.410377426025974,0.10023583446759776,218.68033981323242,45.02195191383362,174.83758544921875,2356,572,1784,1784,0,15,651000.0
651,651999,19.935704729650276,34.40772841833043,0.10012927845717257,218.9676914215088,45.088321685791016,175.34593200683594,2358,573,1785,1785,0,15,652000.0
652,652999,19.935374672613037,34.41259068959376,0.10005206439234482,219.2694206237793,45.157639026641846,175.66281127929688,2362,575,1787,1787,0,15,653000.0
653,653999,19.93812889981151,34.4125218505211,0.10005022504191297,219.5994462966919,45.22639560699463,175.927490234375,2363,576,1787,1787,0,15,654000.0
654,654999,19.940715155355115,34.41341624221242,0.1000514743665939,219.94395565986633,45.29491448402405,176.3311309814453,2363,576,1787,1787,0,15,655000.0
655,655999,19.942446608520736,34.40830585568961,0.10004097903297249,220.29182839393616,45.36361002922058,176.5857925415039,2365,577,1788,1788,0,15,656000.0
656,656999,19.945908053243475,34.40959085549547,0.10014464483602914,220.64240527153015,45.43238186836243,176.80197143554688,2367,578,1789,1789,0,15,657000.0
657,657999,19.952779963449547,34.420750591075254,0.10015142261744436,220.99305200576782,45.501362800598145,177.14749145507812,2367,578,1789,1789,0,15,658000.0
658,658999,19.96334664854394,34.45078434531959,0.0999719394659574,221.32175064086914,45.571438789367676,177.3738784790039,2371,580,1791,1791,0,15,659000.0
659,659999,19.968978549879836,34.47048171381052,0.09981079989037822,221.59720182418823,45.63981890678406,177.6461944580078,2378,582,1796,1796,0,15,660000.0
660,660999,19.9719098616589,34.468606960298885,0.0997275838575512,221.98609900474548,45.70871615409851,177.66236114501953,2379,583,1796,1796,0,15,661000.0
661,661999,19.970915333317336,34.47179723405101,0.09954254202299184,222.26590967178345,45.77591013908386,178.683837890625,2392,584,1808,1808,0,15,662000.0
662,662999,19.970316309878445,34.47913275426466,0.09939426856316314,222.54507112503052,45.842331886291504,179.55047607421875,2400,585,1815,1815,0,15,663000.0
663,663999,19.96598053282776,34.47915769439572,0.09936933969399286,222.82461404800415,45.90872383117676,180.01698303222656,2402,586,1816,1816,0,15,664000.0
664,664999,19.9619544827018,34.4744251269076,0.09929467743369269,223.1077606678009,45.9743914604187,180.57266235351562,2402,586,1816,1816,0,15,665000.0
665,665999,19.957749113841125,34.46509658799236,0.09925311973513429,223.43077850341797,46.04126453399658,180.8154525756836,2405,587,1818,1818,0,15,666000.0
666,666999,19.953254846717,34.458496282942114,0.09921255152462338,223.76780152320862,46.108022928237915,180.98670196533203,2410,589,1821,1821,0,15,667000.0
667,667999,19.95112250200586,34.458188614293334,0.09908754996345326,224.1322259902954,46.17533349990845,181.1141815185547,2412,590,1822,1822,0,15,668000.0
668,668999,19.949420101982618,34.45240844664356,0.09900171023820936,224.43421387672424,46.24119448661804,181.63755798339844,2412,590,1822,1822,0,15,669000.0
669,669999,19.948947291215934,34.457256215817715,0.09885475091502893,224.8121371269226,46.32099008560181,181.9381332397461,2412,590,1822,1822,0,15,670000.0
670,670999,19.949898250796807,34.47462365838011,0.0986441459018601,226.118994474411,46.38725399971008,181.71204376220703,2414,591,1823,1823,0,15,671000.0
671,671999,19.948825583592274,34.46963021009179,0.09854499836091479,226.55069828033447,46.45560932159424,181.4891586303711,2433,594,1839,1839,0,15,672000.0
672,672999,19.947947587655563,34.4646095391043,0.09848601437392535,226.79130387306213,46.522563219070435,182.47521209716797,2434,594,1840,1840,0,15,673000.0
673,673999,19.945402859837323,34.458038248132716,0.09839712707074555,227.0328733921051,46.59068989753723,183.36170196533203,2434,594,1840,1840,0,15,674000.0
674,674999,19.94651781987349,34.480902218598615,0.09820750191846472,227.23332047462463,46.65784668922424,184.18810272216797,2434,594,1840,1840,0,15,675000.0
675,675999,19.946847972566815,34.47962675822315,0.09813089212343984,227.4436900615692,46.724586486816406,184.9890899658203,2434,594,1840,1840,0,15,676000.0
676,676999,19.947928903713755,34.47516133018094,0.09804116177297661,227.84020161628723,46.79239749908447,184.77264404296875,2438,596,1842,1842,0,15,677000.0
677,677999,19.951191153050605,34.485999283492355,0.09791105934057809,228.22398161888123,46.85970139503479,184.72795867919922,2439,597,1842,1842,0,15,678000.0
678,678999,19.95132193320045,34.481014494115534,0.09782351493730523,228.69019484519958,46.92899227142334,184.53216552734375,2440,597,1843,1843,0,15,679000.0
679,679999,19.950485745744494,34.47428454817803,0.0977896350188473,228.91224908828735,46.99568438529968,185.21831512451172,2441,598,1843,1843,0,15,680000.0
680,680999,19.951264560642823,34.47490354154329,0.09751738424579803,229.1585397720337,47.06306600570679,186.41259002685547,2450,598,1852,1852,0,15,681000.0
681,681999,19.950816682746453,34.47681684390919,0.0972797996341822,229.42755246162415,47.12982940673828,187.25607299804688,2453,599,1854,1854,0,15,682000.0
682,682999,19.951428340863544,34.47599495447313,0.096979806792867,229.65822863578796,47.19606018066406,188.07615661621094,2456,599,1857,1857,0,15,683000.0
683,683999,19.95235908329857,34.475239788797566,0.09672882014250994,229.95329308509827,47.26154088973999,188.31238555908203,2460,601,1859,1859,0,15,684000.0
684,684999,19.95301543560251,34.47446591131787,0.09654798670102116,230.31548714637756,47.32825016975403,188.38314819335938,2462,602,1860,1860,0,15,685000.0
685,685999,19.95500184609692,34.472756205795555,0.0964120236047572,230.70037698745728,47.39511704444885,188.22402954101562,2466,604,1862,1862,0,15,686000.0
686,686999,19.95463489901264,34.464623955114746,0.09631477370473818,230.98740792274475,47.462199449539185,188.84010314941406,2466,604,1862,1862,0,15,687000.0
687,687999,19.958281434230212,34.47221343656564,0.09613602953590428,231.36239504814148,47.52893567085266,188.67086029052734,2470,606,1864,1864,0,15,688000.0
688,688999,19.961823079124674,34.47709116285833,0.09607465321324116,231.69549560546875,47.59695768356323,189.0063705444336,2470,606,1864,1864,0,15,689000.0
689,689999,19.962885872249547,34.471958059785884,0.09599717239734062,232.10559940338135,47.66529393196106,188.87796020507812,2472,607,1865,1865,0,15,690000.0
690,690999,19.96809286352348,34.473163734671516,0.09601535463125621,232.45222687721252,47.73229742050171,189.20233154296875,2472,607,1865,1865,0,15,691000.0
691,691999,19.97117344359757,34.47311053769173,0.09594807298859676,232.73712015151978,47.80067467689514,189.83155059814453,2487,608,1879,1879,0,15,692000.0
692,692999,19.97487761330086,34.4716860221153,0.0959397149086535,233.01650953292847,47.8689751625061,190.44015502929688,2488,609,1879,1879,0,15,693000.0
693,693999,19.979890792562898,34.473308875407014,0.09586036941066833,233.25626373291016,47.93697905540466,191.21595001220703,2488,609,1879,1879,0,15,694000.0
694,694999,19.98598997255019,34.476742568826346,0.09584853874012667,233.64108037948608,48.00562143325806,191.38336944580078,2488,609,1879,1879,0,15,695000.0
695,695999,19.99336453479672,34.481010783706516,0.09589969420646194,233.887300491333,48.07405686378479,192.07701873779297,2489,609,1880,1880,0,15,696000.0
696,696999,20.00087297674919,34.4849887256762,0.09590522054561113,234.21656131744385,48.142290353775024,192.23460388183594,2491,610,1881,1881,0,15,697000.0
697,697999,20.004881335097814,34.48252819847728,0.09589917610788001,234.56307220458984,48.21163034439087,192.40928649902344,2491,610,1881,1881,0,15,698000.0
698,698999,20.011172037148658,34.4824655078922,0.09581397450065066,235.0100040435791,48.28095245361328,192.17560577392578,2491,610,1881,1881,0,15,699000.0
699,699999,20.0146888962212,34.47870217650571,0.09575364212194581,235.32908248901367,48.35035967826843,192.43456268310547,2492,611,1881,1881,0,15,700000.0
700,700999,20.01455735002326,34.47430546435809,0.09566545251502445,235.47926115989685,48.41783595085144,194.26807403564453,2513,611,1902,1902,0,15,701000.0
701,701999,20.007642524451487,34.465803165709396,0.0956392435941329,235.68156814575195,48.48778676986694,195.7733154296875,2514,611,1903,1903,0,15,702000.0
702,702999,20.000871863738073,34.457625788035685,0.09565488466914362,235.8541932106018,48.55177402496338,196.75110626220703,2519,612,1907,1907,0,15,703000.0
703,703999,19.994437533420765,34.45491386160006,0.095610505171976,236.09749388694763,48.61623787879944,197.383544921875,2523,614,1909,1909,0,15,704000.0
704,704999,19.995520547807143,34.49672436781339,0.09544182722116323,236.34958505630493,48.68061304092407,197.85740661621094,2527,616,1911,1911,0,15,705000.0
705,705999,19.999844635391092,34.51040913540135,0.09536404155907185,236.69496059417725,48.74549746513367,197.96786499023438,2531,618,1913,1913,0,15,706000.0
706,706999,20.00782589142563,34.536714757279675,0.09545155099697111,236.98294925689697,48.81040549278259,198.38983154296875,2535,620,1915,1915,0,15,707000.0
707,707999,20.019491040934884,34.57011071423359,0.09569906728540634,237.25577425956726,48.87688875198364,198.67809295654297,2541,623,1918,1918,0,15,708000.0
708,708999,20.032108544841357,34.60207095835573,0.09585209855522403,237.54825472831726,48.941901206970215,199.20303344726562,2541,623,1918,1918,0,15,709000.0
709,709999,20.044969097443808,34.64170946408514,0.09589666044202172,237.78473258018494,49.00715494155884,199.83441162109375,2541,623,1918,1918,0,15,710000.0
710,710999,20.058845024210534,34.67936126263634,0.09634764481224445,238.357652425766,49.073554039001465,198.4770965576172,2553,629,1924,1924,0,15,711000.0
711,711999,20.06937476376432,34.70458874349917,0.09686337329612782,238.64211702346802,49.14561867713928,199.12020874023438,2555,630,1925,1925,0,15,712000.0
712,712999,20.08019082279215,34.72445792874376,0.09715946298100808,238.8642394542694,49.21234059333801,199.73735809326172,2559,632,1927,1927,0,15,713000.0
713,713999,20.090288257675066,34.74499629082859,0.09748684216618697,239.15571355819702,49.28639769554138,200.30188369750977,2562,633,1929,1929,0,15,714000.0
714,714999,20.099361688020803,34.75549760804252,0.09800369588782354,239.48513197898865,50.29982924461365,200.4418601989746,2597,636,1961,1961,0,15,715000.0
715,715999,20.111985258404523,34.77754345428324,0.09809942020325657,239.92782425880432,50.367380142211914,200.27887344360352,2628,637,1991,1991,0,15,716000.0
716,716999,20.124837182593954,34.79601341968808,0.09824636764301764,240.29475378990173,50.43544554710388,200.19673538208008,2632,639,1993,1993,0,15,717000.0
717,717999,20.134930727549758,34.80823335824106,0.0985541527829994,240.73412013053894,50.50227117538452,200.0659294128418,2634,640,1994,1994,0,15,718000.0
718,718999,20.14425884984131,34.816575105539386,0.09881905987488293,241.04399704933167,50.57201862335205,200.60054397583008,2636,641,1995,1995,0,15,719000.0
719,719999,20.14793169813723,34.81697704331543,0.09859119237329905,241.3304979801178,50.639649868011475,201.53354263305664,2647,642,2005,2005,0,15,720000.0
720,720999,20.149748372508487,34.828296618695255,0.09837112247761415,241.55242037773132,50.7071852684021,202.65375900268555,2649,643,2006,2006,0,15,721000.0
721,721999,20.150278947983942,34.825418859022534,0.09823600674767607,241.7921462059021,50.773601055145264,203.46232223510742,2649,643,2006,2006,0,15,722000.0
722,722999,20.15129978604963,34.82799151486897,0.09807900578565976,242.10416078567505,50.840487003326416,203.76108169555664,2651,644,2007,2007,0,15,723000.0
723,723999,20.153184452979858,34.82756260122481,0.09796521767763411,242.48044967651367,50.90866780281067,203.65991592407227,2657,647,2010,2010,0,15,724000.0
724,724999,20.15407874639522,34.82439730577092,0.09784293382148157,242.88413667678833,50.975669622421265,203.58502578735352,2661,649,2012,2012,0,15,725000.0
725,725999,20.155551358852012,34.82102293076538,0.0977199376562573,243.08804774284363,51.04177451133728,204.49018478393555,2661,649,2012,2012,0,15,726000.0
726,726999,20.155867734506334,34.81440280572863,0.09766465287353743,243.4804425239563,51.10967540740967,204.60505294799805,2661,649,2012,2012,0,15,727000.0
727,727999,20.15479533023386,34.80708085236854,0.09759350775333675,243.78172850608826,51.175830364227295,205.0710334777832,2661,649,2012,2012,0,15,728000.0
728,728999,20.155401019093198,34.80374150026657,0.09747874211434848,244.03243470191956,51.24361038208008,205.6599998474121,2661,649,2012,2012,0,15,729000.0
729,729999,20.15466683033097,34.79864485023603,0.097391842968646,244.54387736320496,51.31479215621948,204.94018936157227,2662,650,2012,2012,0,15,730000.0
730,730999,20.152985210474753,34.79004009695327,0.09731409837388139,244.929203748703,51.382471323013306,204.98187637329102,2675,652,2023,2023,0,15,731000.0
731,731999,20.154400133424687,34.811345810987305,0.09711040994460796,245.26832795143127,51.45114493370056,205.30132675170898,2676,652,2024,2024,0,15,732000.0
732,732999,20.152614373141414,34.80466695724219,0.09704605344144412,245.47098636627197,51.51820778846741,206.12848281860352,2677,652,2025,2025,0,15,733000.0
733,733999,20.15239911727217,34.797336586618776,0.09697551123119674,245.8192822933197,51.58623242378235,206.3196678161621,2677,652,2025,2025,0,15,734000.0
734,734999,20.15108739909891,34.787894738897144,0.09692106719973814,246.30850291252136,51.65525150299072,205.9476661682129,2708,653,2055,2055,0,15,735000.0
735,735999,20.153517104878578,34.78444453482474,0.09688109596503447,246.60943961143494,51.72275424003601,206.4040870666504,2708,653,2055,2055,0,15,736000.0
736,736999,20.154712882508615,34.77888239324079,0.09681426053341602,246.94267892837524,51.7916476726532,206.6360740661621,2708,653,2055,2055,0,15,737000.0
737,737999,20.153481247363406,34.770990943870125,0.09677095755777243,247.42082452774048,51.85950684547424,206.2760353088379,2708,653,2055,2055,0,15,738000.0
738,738999,20.152359470506536,34.762771713935116,0.09668508406710241,247.76282334327698,51.92795968055725,206.61094284057617,2709,653,2056,2056,0,15,739000.0
739,739999,20.15345565651839,34.78796631541911,0.09641241045715865,247.98852276802063,51.994962215423584,207.99554824829102,2721,654,2067,2067,0,15,740000.0
740,740999,20.149270227831188,34.81614431999883,0.09637292409360565,248.24038338661194,52.063060998916626,208.74123764038086,2734,656,2078,2078,0,15,741000.0
741,741999,20.14196578320224,34.810674709730336,0.09687286394117423,248.4719750881195,52.13264060020447,209.88542556762695,2735,656,2079,2079,0,15,742000.0
742,742999,20.13609061625681,34.806884817872515,0.09752506469492894,248.725998878479,52.20151734352112,210.58242416381836,2736,656,2080,2080,0,15,743000.0
743,743999,20.130175816788086,34.800227380180786,0.09757837848524076,249.07734084129333,52.269593477249146,210.75954818725586,2738,657,2081,2081,0,15,744000.0
744,744999,20.123131278304786,34.79093592242054,0.09741676710400393,249.46565866470337,52.338194608688354,211.08882522583008,2804,659,2145,2145,0,15,745000.0
745,745999,20.11975674340966,34.79465973565104,0.09745529546044884,249.67163586616516,52.407461643218994,211.98437881469727,2804,659,2145,2145,0,15,746000.0
746,746999,20.114766424755977,34.79049248785263,0.0971539971304003,249.98799872398376,52.4775447845459,212.03708267211914,2809,661,2148,2148,0,15,747000.0
747,747999,20.112137161845737,34.79469347259909,0.09684835259598779,250.30330061912537,52.54719638824463,212.25068283081055,2813,663,2150,2150,0,15,748000.0
748,748999,20.1070161511452,34.79074531710892,0.09669695565411984,250.749427318573,52.617467164993286,211.96875381469727,2817,665,2152,2152,0,15,749000.0
749,749999,20.105918699048615,34.79201857510952,0.09657392347243421,251.0723316669464,52.68825936317444,212.21928024291992,2825,667,2158,2158,0,15,750000.0
750,750999,20.103463453963155,34.79042395170793,0.09672252452241581,251.27042722702026,52.75824165344238,213.31972122192383,2825,667,2158,2158,0,15,751000.0
751,751999,20.09902771853995,34.78096915808462,0.0967044123003119,251.53958773612976,52.833943128585815,213.84967422485352,2827,668,2159,2159,0,15,752000.0
752,752999,20.096160014161786,34.77826324214645,0.09643732180076092,251.90100812911987,52.904043436050415,213.99904251098633,2858,669,2189,2189,0,15,753000.0
753,753999,20.096710095194254,34.78125260096106,0.09623966146056284,252.36106705665588,52.975738763809204,213.75941848754883,2858,669,2189,2189,0,15,754000.0
754,754999,20.096241551589234,34.779798812192624,0.09615957297931643,252.66349840164185,53.045257568359375,214.24309921264648,2858,669,2189,2189,0,15,755000.0
755,755999,20.09708940243407,34.77948067221253,0.09608323749873537,252.99439334869385,53.1148784160614,214.64574813842773,2858,669,2189,2189,0,15,756000.0
756,756999,20.09901119934571,34.780239866271444,0.09590979129515931,253.40453004837036,53.18504571914673,214.4446144104004,2860,670,2190,2190,0,15,757000.0
757,757999,20.099183770556365,34.77836231306805,0.09587334996430363,253.797345161438,53.25735116004944,214.47814559936523,2860,670,2190,2190,0,15,758000.0
758,758999,20.098512514697497,34.774794146759135,0.0957433901646133,254.02915287017822,53.32669687271118,215.16957473754883,2862,671,2191,2191,0,15,759000.0
759,759999,20.09715344226504,34.77214794189327,0.09564027937892139,254.27089142799377,53.394366979599,216.3728904724121,2877,671,2206,2206,0,15,760000.0
760,760999,20.08952629944934,34.76551317419281,0.09562304246543218,254.51893615722656,53.460105180740356,217.35522079467773,2886,672,2214,2214,0,15,761000.0
761,761999,20.08159383655722,34.753043782239736,0.0956045391780872,254.775621175766,53.52430605888367,218.29850387573242,2891,672,2219,2219,0,15,762000.0
762,762999,20.0763855561718,34.75939995692424,0.09545261924866666,256.07353472709656,53.588950395584106,219.04328536987305,2894,673,2221,2221,0,15,763000.0
763,763999,20.070928250037017,34.755310690495506,0.0953725022581926,256.32835054397583,53.65594148635864,219.94354629516602,2895,673,2222,2222,0,15,764000.0
764,764999,20.06527414915473,34.74816948933133,0.09531080809515591,256.5623915195465,53.72220325469971,220.69280624389648,2897,674,2223,2223,0,15,765000.0
765,765999,20.061780330484293,34.7450929028778,0.09526013868935901,256.8263189792633,53.78756856918335,221.42958450317383,2899,675,2224,2224,0,15,766000.0
766,766999,20.05731675872447,34.741464067148655,0.0952306979825206,257.150426864624,53.85356307029724,221.5482063293457,2909,678,2231,2231,0,15,767000.0
767,767999,20.053418641695078,34.73692405741443,0.09519532782720352,257.3789846897125,53.9197039604187,222.2686653137207,2911,679,2232,2232,0,15,768000.0
768,768999,20.048783573267148,34.72838547310908,0.09523664051016023,257.67342495918274,53.98530626296997,222.3373146057129,2917,682,2235,2235,0,15,769000.0
769,769999,20.046952549086136,34.726184729577064,0.09521742141659106,258.03505063056946,54.05332040786743,222.36719131469727,2921,684,2237,2237,0,15,770000.0
770,770999,20.045920085604266,34.721604084131585,0.09527206630884799,258.42733120918274,54.12142872810364,222.13737869262695,2927,687,2240,2240,0,15,771000.0
771,771999,20.044459760544253,34.72395109519586,0.09519781571335617,258.68662548065186,54.19276571273804,222.70329666137695,2930,688,2242,2242,0,15,772000.0
772,772999,20.04226733338504,34.71871678315405,0.0952619197837149,259.01658630371094,54.261038064956665,223.05447006225586,2963,690,2273,2273,0,15,773000.0
773,773999,20.04188863215298,34.71410662536436,0.0953484540531021,259.31529784202576,54.32854652404785,223.5564842224121,2963,690,2273,2273,0,15,774000.0
774,774999,20.04250791891384,34.71382131373621,0.09546548984160064,259.6799750328064,54.39735150337219,223.44050216674805,2973,693,2280,2280,0,15,775000.0
775,775999,20.04286077873784,34.709381487437724,0.09561020014689947,260.03137159347534,54.46589159965515,223.75423049926758,2973,693,2280,2280,0,15,776000.0
776,776999,20.045703086559953,34.737057327287175,0.0954909545190833,260.42100977897644,54.532830476760864,223.87250137329102,2973,693,2280,2280,0,15,777000.0
777,777999,20.04723955381203,34.7348415978773,0.0955250718768268,260.7250409126282,54.60054659843445,224.27740859985352,2973,693,2280,2280,0,15,778000.0
778,778999,20.04969361210882,34.73480374288374,0.09559554656097546,261.0516200065613,54.66859436035156,224.60991287231445,2973,693,2280,2280,0,15,779000.0
779,779999,20.05030922575149,34.73853688213215,0.0954523885493922,261.3952569961548,54.73558807373047,225.0288963317871,2973,693,2280,2280,0,15,780000.0
780,780999,20.046331773604813,34.74888048199027,0.09527882531721521,261.72588753700256,54.80142688751221,225.8475456237793,2984,694,2290,2290,0,15,781000.0
781,781999,20.039038729755244,34.737485805905436,0.09527426291290164,261.9803116321564,54.86917471885681,226.87189102172852,2984,694,2290,2290,0,15,782000.0
782,782999,20.031022123737134,34.730354784303564,0.09526099078567818,262.311514377594,54.9361412525177,227.31193923950195,2986,695,2291,2291,0,15,783000.0
783,783999,20.02381141058448,34.7226577066837,0.09522485445603646,262.7468671798706,55.005146503448486,227.35110092163086,3018,696,2322,2322,0,15,784000.0
784,784999,20.019064275342593,34.72966771303401,0.09511538515158235,263.1428725719452,55.07304859161377,227.40288162231445,3020,697,2323,2323,0,15,785000.0
785,785999,20.01358860928728,34.72085712625588,0.09508682094684917,263.45159339904785,55.1403329372406,227.83172225952148,3022,698,2324,2324,0,15,786000.0
786,786999,20.008861198934397,34.712941513344525,0.09503738231435532,263.8926384449005,55.207069873809814,227.4284324645996,3025,700,2325,2325,0,15,787000.0
787,787999,20.005159560391085,34.72334018760656,0.09487680037868496,264.20433926582336,55.27480673789978,228.11262893676758,3040,702,2338,2338,0,15,788000.0
788,788999,19.99996130203287,34.73516357961913,0.09476294638085614,264.39980959892273,55.344282388687134,229.25810623168945,3043,703,2340,2340,0,15,789000.0
789,789999,19.994346845474315,34.72693905264674,0.09472141255855848,264.648948431015,55.413471698760986,230.0096778869629,3045,703,2342,2342,0,15,790000.0
790,790999,19.989169556824596,34.719086296983775,0.0946978428456221,264.99733304977417,55.48482012748718,230.2951316833496,3047,704,2343,2343,0,15,791000.0
791,791999,19.98538450219682,34.71559718379283,0.09467396411715023,265.25027680397034,55.55398941040039,230.94137954711914,3047,704,2343,2343,0,15,792000.0
792,792999,19.980338688332324,34.70974042055449,0.09467612695587535,265.7140574455261,55.623358488082886,230.61716079711914,3049,705,2344,2344,0,15,793000.0
793,793999,19.97722697883329,34.703752799384134,0.09464761907021102,265.9596676826477,55.69169545173645,231.2370262145996,3051,706,2345,2345,0,15,794000.0
794,794999,19.97081245770702,34.690792259339574,0.09469930344447719,266.39536595344543,55.761035442352295,230.99229049682617,3053,707,2346,2346,0,15,795000.0
795,795999,19.9661241080502,34.68159241037988,0.09472612241096035,266.7044322490692,55.830928564071655,231.47637557983398,3053,707,2346,2346,0,15,796000.0
796,796999,19.96025730675406,34.669030716503244,0.09473296863724412,267.1152205467224,55.90033030509949,231.38539505004883,3057,709,2348,2348,0,15,797000.0
797,797999,19.952582971829738,34.656907777655896,0.09475648191011787,267.2948923110962,55.96629548072815,232.88676071166992,3068,710,2358,2358,0,15,798000.0
798,798999,19.941116358418792,34.63987717088605,0.09487497454645089,267.60234117507935,56.03304052352905,233.5373878479004,3085,712,2373,2373,0,15,799000.0
799,799999,19.933220163749805,34.643167737629646,0.0948033589934475,267.83409333229065,56.10012912750244,234.71805953979492,3085,712,2373,2373,0,15,800000.0
800,800999,19.925164710931284,34.63574492213373,0.09483269639819003,268.0545094013214,56.16716289520264,235.57975387573242,3087,713,2374,2374,0,15,801000.0
801,801999,19.919006188436335,34.63394779600606,0.09478649491318847,268.2600562572479,56.23460125923157,236.51482009887695,3088,713,2375,2375,0,15,802000.0
802,802999,19.91115469972137,34.62180495281641,0.09479078559141141,268.47855019569397,56.30146336555481,237.2292594909668,3091,714,2377,2377,0,15,803000.0
803,803999,19.902416509867532,34.60859286789426,0.09480477555324685,268.8303921222687,56.367796659469604,237.17675399780273,3095,716,2379,2379,0,15,804000.0
804,804999,19.895844088064287,34.60058832879597,0.0947877852961474,269.14755964279175,56.436667680740356,237.58290481567383,3095,716,2379,2379,0,15,805000.0
805,805999,19.890735703514952,34.592701402079626,0.09471731920988102,269.4890856742859,56.50298190116882,237.73551559448242,3097,717,2380,2380,0,15,806000.0
806,806999,19.88574911741886,34.586675790507186,0.0946778312021489,269.77371048927307,56.57096838951111,238.12895584106445,3099,718,2381,2381,0,15,807000.0
807,807999,19.882649735639127,34.59671386334054,0.0945195868530232,270.1708083152771,56.64088249206543,237.87953567504883,3103,720,2383,2383,0,15,808000.0
808,808999,19.877573680383783,34.5903536526234,0.09444100471768824,270.49407410621643,56.708964824676514,238.1516227722168,3103,720,2383,2383,0,15,809000.0
809,809999,19.873483464067803,34.58441176656949,0.09437206791455266,270.87432765960693,56.778669357299805,238.12583541870117,3136,722,2414,2414,0,15,810000.0
810,810999,19.86913828939984,34.580617493841714,0.09428085228364136,271.2769594192505,56.84816217422485,238.19537734985352,3138,723,2415,2415,0,15,811000.0
811,811999,19.86646391541015,34.5769519969169,0.09418240457058069,271.63804268836975,56.916706562042236,238.50152969360352,3138,723,2415,2415,0,15,812000.0
812,812999,19.86230244440314,34.56905376335621,0.09414363199654519,273.0818552970886,56.98553228378296,238.82739639282227,3157,725,2432,2432,0,15,813000.0
813,813999,19.860690015280404,34.56542018619809,0.09404122378221258,273.3698592185974,57.053860664367676,239.50329971313477,3157,725,2432,2432,0,15,814000.0
814,814999,19.857580916446796,34.558000405780135,0.0939645222346025,273.7627248764038,57.12273645401001,239.65336990356445,3158,725,2433,2433,0,15,815000.0
815,815999,19.85270284184276,34.547256178751354,0.09392231400311268,273.9767005443573,57.19066095352173,240.49188613891602,3158,725,2433,2433,0,15,816000.0
816,816999,19.85271225230521,34.56115119646172,0.09371935164651035,274.25549268722534,57.257319688797,241.38117599487305,3168,726,2442,2442,0,15,817000.0
817,817999,19.84646093264001,34.54953997148265,0.09366454112291822,274.48036456108093,57.324288845062256,242.6683006286621,3182,727,2455,2455,0,15,818000.0
818,818999,19.840690207442957,34.53989736555121,0.09365642335907809,274.6538543701172,57.393319606781006,244.01662826538086,3183,727,2456,2456,0,15,819000.0
819,819999,19.836222544946626,34.52904174524038,0.09365613588254751,275.01874256134033,57.460939168930054,244.1499137878418,3187,729,2458,2458,0,15,820000.0
820,820999,19.833542113856687,34.52590728379325,0.09361815718599664,275.30398893356323,57.52764940261841,244.69114303588867,3187,729,2458,2458,0,15,821000.0
821,821999,19.832689761281703,34.52100647494316,0.09358305871009376,275.6005811691284,57.59456729888916,245.11013412475586,3192,731,2461,2461,0,15,822000.0
822,822999,19.832367860606404,34.516791023323414,0.0935876563867637,275.80853629112244,57.661678314208984,245.91769790649414,3192,731,2461,2461,0,15,823000.0
823,823999,19.833956908237862,34.51607708034359,0.09363947740388756,276.22927069664,57.73125195503235,245.61981582641602,3197,733,2464,2464,0,15,824000.0
824,824999,19.836139631724997,34.526069767969,0.09365313625880634,276.5511417388916,57.79905867576599,245.98962783813477,3199,734,2465,2465,0,15,825000.0
825,825999,19.838805804459046,34.52751915353151,0.09381148632438341,276.9288513660431,57.86756920814514,246.03959274291992,3201,735,2466,2466,0,15,826000.0
826,826999,19.844072633554923,34.53717815683394,0.0939301846731575,277.44225430488586,57.93629026412964,245.48591232299805,3207,738,2469,2469,0,15,827000.0
827,827999,19.847169766311215,34.53933612624445,0.09400341508405496,277.6698076725006,58.00496220588684,246.23129653930664,3209,739,2470,2470,0,15,828000.0
828,828999,19.85164415352893,34.54117803885578,0.09408110952713156,277.9770610332489,58.073413610458374,246.51349258422852,3209,739,2470,2470,0,15,829000.0
829,829999,19.85636038610486,34.54667132136653,0.09422095284863163,278.3459448814392,58.142107248306274,246.5815544128418,3211,740,2471,2471,0,15,830000.0
830,830999,19.861814408295253,34.5528580772606,0.0944171044965163,278.7368586063385,58.21031832695007,246.78573989868164,3211,740,2471,2471,0,15,831000.0
831,831999,19.867408854396118,34.55751077687185,0.09448529368183844,279.02981090545654,58.27928113937378,247.22204971313477,3211,740,2471,2471,0,15,832000.0
832,832999,19.874325796119678,34.56561354545167,0.09461960647043388,279.4215259552002,58.348461389541626,246.7746696472168,3219,744,2475,2475,0,15,833000.0
833,833999,19.881633525928475,34.57292243936445,0.09476270706747592,279.8005418777466,58.41862750053406,246.78710556030273,3221,745,2476,2476,0,15,834000.0
834,834999,19.88435261520926,34.572353547974856,0.09489902441004572,280.2264482975006,58.4869589805603,246.6411476135254,3223,746,2477,2477,0,15,835000.0
835,835999,19.88624942034775,34.56823637614284,0.09492045811237615,280.47419691085815,58.557777881622314,247.3485221862793,3223,746,2477,2477,0,15,836000.0
836,836999,19.88598675306092,34.56639961930316,0.0947421541019855,280.74799489974976,58.62374234199524,248.53239059448242,3245,747,2498,2498,0,15,837000.0
837,837999,19.88485513367978,34.57156221618258,0.09466591882946018,281.0212881565094,58.688621282577515,249.5096092224121,3261,748,2513,2513,0,15,838000.0
838,838999,19.88419381859029,34.57432712626633,0.09458395022462573,281.21719884872437,58.75333571434021,250.56453323364258,3261,748,2513,2513,0,15,839000.0
839,839999,19.88521914577768,34.57595252243206,0.09450783789095141,281.54133462905884,58.82123374938965,250.77856063842773,3267,751,2516,2516,0,15,840000.0
840,840999,19.887546686068266,34.57593760915707,0.0944379083650353,281.8642032146454,58.885721921920776,250.85272598266602,3275,755,2520,2520,0,15,841000.0
841,841999,19.890448406106838,34.5840421496563,0.0943787550230687,282.173246383667,58.9542121887207,250.92180252075195,3285,760,2525,2525,0,15,842000.0
842,842999,19.892710409115995,34.59168078170996,0.09439831473133609,282.4486758708954,59.021137714385986,251.71704483032227,3287,761,2526,2526,0,15,843000.0
843,843999,19.90037189379413,34.626250618570175,0.09420057489359857,282.7349557876587,59.087265968322754,252.40935897827148,3287,761,2526,2526,0,15,844000.0
844,844999,19.907743968100068,34.65719843113402,0.0942026053892473,283.0977976322174,59.153921127319336,252.5024299621582,3294,762,2532,2532,0,15,845000.0
845,845999,19.921861209835644,34.710537022661605,0.0942623271343731,283.50480937957764,59.22113823890686,252.3356056213379,3298,764,2534,2534,0,15,846000.0
846,846999,19.934642981672813,34.76256150218138,0.09420919826368834,283.77141189575195,59.28757047653198,253.02953720092773,3298,764,2534,2534,0,15,847000.0
847,847999,19.95039179513774,34.81597944754686,0.09430113205589485,284.14033246040344,59.35625123977661,253.15732192993164,3300,765,2535,2535,0,15,848000.0
848,848999,19.96331400478749,34.85131303058301,0.09466237139435651,284.38485169410706,59.421539068222046,253.93032455444336,3300,765,2535,2535,0,15,849000.0
849,849999,19.98173924969297,34.90481065456757,0.0947920086554318,284.72790455818176,59.48998808860779,253.90301132202148,3306,768,2538,2538,0,15,850000.0
850,850999,19.99869937250383,34.95804763724635,0.0950415206017039,285.1403157711029,59.5580313205719,253.69189834594727,3310,770,2540,2540,0,15,851000.0
851,851999,20.01762407035493,35.00421246191508,0.09548679029464635,285.60265469551086,59.62643241882324,252.8865089416504,3322,776,2546,2546,0,15,852000.0
852,852999,20.02835016117532,35.02445369901049,0.09536797927845819,285.8829438686371,59.69271898269653,253.77624130249023,3332,777,2555,2555,0,15,853000.0
853,853999,20.04889273305226,35.11635676051836,0.09494497785900713,286.12760496139526,59.75862240791321,254.83852767944336,3333,777,2556,2556,0,15,854000.0
854,854999,20.0762860038266,35.219072639388614,0.09512079966138853,286.43916392326355,59.826212882995605,255.10940170288086,3341,779,2562,2562,0,15,855000.0
855,855999,20.098465525338202,35.29068439814125,0.09534500104002785,286.77929306030273,59.89714217185974,255.35277938842773,3345,781,2564,2564,0,15,856000.0
856,856999,20.121407072354817,35.35976281046019,0.09561073129668529,287.13455724716187,59.964417457580566,255.33786392211914,3349,783,2566,2566,0,15,857000.0
857,857999,20.141718662727833,35.41164621978739,0.09555660865818982,287.63188457489014,60.03207468986511,254.99583053588867,3382,785,2597,2597,0,15,858000.0
858,858999,20.163644593942557,35.46187200579271,0.09554532723040299,287.920716047287,60.10036492347717,255.4835319519043,3396,786,2610,2610,0,15,859000.0
859,859999,20.1828116339607,35.50171267249492,0.09579748234834284,288.15497159957886,60.16941022872925,256.7050361633301,3397,786,2611,2611,0,15,860000.0
860,860999,20.20165768526679,35.53549152162253,0.09615388033044237,288.39988803863525,60.23609256744385,257.63039779663086,3397,786,2611,2611,0,15,861000.0
861,861999,20.2146590008283,35.55326987972689,0.09617166099931096,288.7087104320526,60.30551195144653,257.99389266967773,3399,787,2612,2612,0,15,862000.0
862,862999,20.232421867057106,35.58255322594034,0.0965038403043309,289.0323202610016,60.37276291847229,258.2290229797363,3402,788,2614,2614,0,15,863000.0
863,863999,20.248910672871325,35.630729708066745,0.09676527501939514,289.42132019996643,61.66718530654907,258.3469429016113,3402,788,2614,2614,0,15,864000.0
864,864999,20.26983463553041,35.69121318138376,0.09717968315665959,289.7166154384613,61.73736333847046,258.8375816345215,3402,788,2614,2614,0,15,865000.0
865,865999,20.288070511002797,35.71458044052876,0.09743171334069933,289.92337584495544,61.80562138557434,259.7319450378418,3402,788,2614,2614,0,15,866000.0
866,866999,20.30803778751825,35.7553373340274,0.09785137530804089,290.3501901626587,61.874972343444824,259.5962257385254,3402,788,2614,2614,0,15,867000.0
867,867999,20.324860326586297,35.777390325177386,0.09818822141967987,290.69053959846497,61.9462788105011,259.7219581604004,3404,789,2615,2615,0,15,868000.0
868,868999,20.340202613621244,35.802722862856754,0.09811129817558017,291.1084086894989,62.015997648239136,260.01477432250977,3412,789,2623,2623,0,15,869000.0
869,869999,20.35570616626352,35.8596308296924,0.09793995319036064,291.374858379364,62.08460330963135,261.0823783874512,3430,791,2639,2639,0,15,870000.0
870,870999,20.36625034972762,35.89497388286833,0.09829848916230233,291.5827667713165,62.154027223587036,262.84186935424805,3431,791,2640,2640,0,15,871000.0
871,871999,20.377227079955663,35.91489959794172,0.09878492240516801,291.7780566215515,62.22228121757507,264.07729721069336,3431,791,2640,2640,0,15,872000.0
872,872999,20.39058865477214,35.94472031515383,0.09924569708562958,292.0386598110199,62.29175162315369,264.60263442993164,3437,793,2644,2644,0,15,873000.0
873,873999,20.404425786813583,35.97803722018205,0.1006707414946395,292.3437216281891,62.36228036880493,265.18091201782227,3440,794,2646,2646,0,15,874000.0
874,874999,20.41458030161258,35.993426709550796,0.10148243723650519,292.58497977256775,62.43133807182312,265.93982315063477,3440,794,2646,2646,0,15,875000.0
875,875999,20.427716957600797,36.02059045102524,0.10324268874514564,292.9134428501129,62.50093746185303,266.17316818237305,3443,795,2648,2648,0,15,876000.0
876,876999,20.44289799268333,36.04748281661538,0.10416346317962666,293.20679807662964,62.57170915603638,266.6930122375488,3443,795,2648,2648,0,15,877000.0
877,877999,20.46066367862848,36.095928494679924,0.10565442030746386,293.58183121681213,62.64259195327759,266.6180839538574,3445,796,2649,2649,0,15,878000.0
878,878999,20.47933346383838,36.13080339237411,0.10670493403047931,293.9589295387268,62.71260476112366,266.3858833312988,3453,800,2653,2653,0,15,879000.0
879,879999,20.49495193756643,36.156604366097135,0.10761118146654247,294.2290894985199,62.78167796134949,266.9141426086426,3455,801,2654,2654,0,15,880000.0
880,880999,20.51192275450693,36.186017861307555,0.10917866918161923,294.6165223121643,62.85269069671631,266.86215591430664,3457,802,2655,2655,0,15,881000.0
881,881999,20.529704974527046,36.22025631249786,0.10968651851520028,295.1535584926605,62.92382001876831,266.3075294494629,3459,803,2656,2656,0,15,882000.0
882,882999,20.550139622714937,36.260524928620946,0.11125512321659015,295.49171209335327,62.99512434005737,266.7704887390137,3459,803,2656,2656,0,15,883000.0
883,883999,20.568101751492012,36.28975932076462,0.11215405050565075,295.81572818756104,63.065664291381836,266.99118423461914,3461,804,2657,2657,0,15,884000.0
884,884999,20.58431176635698,36.31309750319066,0.11272104110145442,296.11411118507385,63.13516688346863,267.5332145690918,3461,804,2657,2657,0,15,885000.0
885,885999,20.60029920513242,36.33691665420333,0.1134926147550317,296.48210525512695,63.204758405685425,267.60480880737305,3463,805,2658,2658,0,15,886000.0
886,886999,20.620406256630833,36.38263093847602,0.11415306261925096,296.82893776893616,63.274507999420166,267.9089775085449,3463,805,2658,2658,0,15,887000.0
887,887999,20.634940789967885,36.39803531381791,0.11455175127332018,297.1773142814636,63.34682869911194,268.15837478637695,3463,805,2658,2658,0,15,888000.0
888,888999,20.646265316162015,36.42059513982641,0.11457061330391749,297.5208592414856,63.41451072692871,268.78762435913086,3478,806,2672,2672,0,15,889000.0
889,889999,20.645797864845704,36.42345333531198,0.11446598390864338,297.7586133480072,63.478275299072266,269.91833877563477,3488,806,2682,2682,0,15,890000.0
890,890999,20.650766635064077,36.44695793689461,0.11428943402767044,297.93890166282654,63.54404592514038,271.4869041442871,3508,807,2701,2701,0,15,891000.0
891,891999,20.65674319005159,36.45890380758571,0.11417379181868659,298.11790108680725,63.609469175338745,272.6755256652832,3511,808,2703,2703,0,15,892000.0
892,892999,20.660808340189273,36.46649490349846,0.11405500358578613,298.27661204338074,63.674915075302124,273.94760513305664,3511,808,2703,2703,0,15,893000.0
893,893999,20.66569159465841,36.47371191475353,0.11402264553330566,298.5399706363678,63.73995757102966,274.50642013549805,3516,810,2706,2706,0,15,894000.0
894,894999,20.669494569780934,36.477266680847805,0.11396104376401717,298.8268222808838,63.80569887161255,275.0805473327637,3518,811,2707,2707,0,15,895000.0
895,895999,20.674761809626343,36.48390697370182,0.11401192264640536,299.192706823349,63.873605728149414,274.9823875427246,3526,815,2711,2711,0,15,896000.0
896,896999,20.679347770317282,36.49001461760695,0.11405013738176739,299.4553871154785,63.940306663513184,275.69794845581055,3526,815,2711,2711,0,15,897000.0
897,897999,20.68643394336625,36.50392705465246,0.1142546645772965,299.75537514686584,64.00633144378662,276.0622138977051,3530,817,2713,2713,0,15,898000.0
898,898999,20.69439893608029,36.51486913937407,0.11465377526432219,300.113418340683,64.07489776611328,276.2144432067871,3533,818,2715,2715,0,15,899000.0
899,899999,20.699464409270334,36.52130872778272,0.11481629354488754,300.4966866970062,64.14187335968018,276.4116859436035,3533,818,2715,2715,0,15,900000.0
900,900999,20.706978277043472,36.530392739274326,0.11512126661779598,300.8650093078613,64.20831608772278,276.0688819885254,3544,823,2721,2721,0,15,901000.0
901,901999,20.714088960316914,36.540466287193496,0.11542667602810874,301.2264447212219,64.27716541290283,276.32380294799805,3546,824,2722,2722,0,15,902000.0
902,902999,20.724606691605256,36.55513963958053,0.11592951424414866,301.57815980911255,64.34371018409729,276.586727142334,3546,824,2722,2722,0,15,903000.0
903,903999,20.73633635051495,36.57255716428483,0.1166501399718336,301.82137060165405,64.40966725349426,277.1306495666504,3548,825,2723,2723,0,15,904000.0
904,904999,20.74917824807361,36.58958449286027,0.11702390356153003,302.20697498321533,64.479407787323,277.37268447875977,3548,825,2723,2723,0,15,905000.0
905,905999,20.76039103457059,36.60278956897957,0.11746287253739263,302.5595693588257,64.54797554016113,277.3777046203613,3552,827,2725,2725,0,15,906000.0
906,906999,20.772973528994278,36.62144995495424,0.118103548720774,302.9592764377594,64.61656713485718,277.34225845336914,3554,828,2726,2726,0,15,907000.0
907,907999,20.788035250689575,36.6415358697391,0.11881060913621133,303.3394892215729,64.68369483947754,277.5621528625488,3554,828,2726,2726,0,15,908000.0
908,908999,20.794967588407406,36.64443876727224,0.11921648619678604,303.6599872112274,64.75015473365784,278.1945610046387,3555,828,2727,2727,0,15,909000.0
909,909999,20.7998993967487,36.66505033256412,0.11900775873375613,303.980521440506,64.81656694412231,279.0348701477051,3568,830,2738,2738,0,15,910000.0
910,910999,20.801757059626382,36.6666798400834,0.11889332873804082,304.2228989601135,64.88357043266296,279.9819679260254,3568,830,2738,2738,0,15,911000.0
911,911999,20.805257887923545,36.67029015193627,0.11885005244920399,304.49629187583923,64.94976091384888,280.72136306762695,3582,831,2751,2751,0,15,912000.0
912,912999,20.80997161375327,36.68066827469891,0.11877080800152551,304.76848554611206,65.01854038238525,281.51501846313477,3585,832,2753,2753,0,15,913000.0
913,913999,20.811578229690475,36.679702083429014,0.11876193784801148,305.0821087360382,65.08627390861511,281.839054107666,3589,834,2755,2755,0,15,914000.0
914,914999,20.81425213417327,36.68098459376153,0.11872901803376368,305.3339521884918,65.15442728996277,282.6467094421387,3589,834,2755,2755,0,15,915000.0
915,915999,20.81685742253059,36.681378569205904,0.11872720473286935,305.6156129837036,65.22082209587097,283.14887619018555,3592,835,2757,2757,0,15,916000.0
916,916999,20.82090503146411,36.689280422040426,0.11866739083939137,306.03650856018066,65.28848791122437,282.96047592163086,3596,837,2759,2759,0,15,917000.0
917,917999,20.82370737673527,36.690386268955855,0.11872037248723188,306.3462767601013,65.35626077651978,283.515682220459,3597,837,2760,2760,0,15,918000.0
918,918999,20.832192355783796,36.72881974262466,0.11863036957877193,306.6805069446564,65.4242479801178,283.79602432250977,3599,838,2761,2761,0,15,919000.0
919,919999,20.83594268251147,36.729767155853125,0.11863445590449195,308.28189277648926,65.49345278739929,284.1809272766113,3601,839,2762,2762,0,15,920000.0
920,920999,20.84132433657326,36.732903146966834,0.11866580373391111,308.6102628707886,65.5635495185852,284.31442642211914,3603,841,2762,2762,0,15,921000.0
921,921999,20.846880360097714,36.73607672178497,0.11866066464293867,308.971431016922,65.63363122940063,284.52934646606445,3634,842,2792,2792,0,15,922000.0
922,922999,20.854579835196507,36.74931689612602,0.11871267518337925,309.3819136619568,65.70215392112732,284.37366104125977,3638,844,2794,2794,0,15,923000.0
923,923999,20.86067515020181,36.752628935439425,0.1187026184384693,309.74374747276306,65.77151536941528,284.3851737976074,3644,847,2797,2797,0,15,924000.0
924,924999,20.866746687498193,36.7566301543504,0.11874476709347981,310.1743311882019,65.83974814414978,284.22109603881836,3646,848,2798,2798,0,15,925000.0
925,925999,20.873006485965817,36.75966072209876,0.11888121290626108,310.46106219291687,65.90839290618896,284.74386978149414,3648,849,2799,2799,0,15,926000.0
926,926999,20.87064203415028,36.75337870276888,0.11881004945115559,310.6998760700226,65.97583556175232,285.84009170532227,3660,850,2810,2810,0,15,927000.0
927,927999,20.86629500498779,36.75092189938364,0.11872927499373676,310.91877579689026,66.04101276397705,286.76388931274414,3663,851,2812,2812,0,15,928000.0
928,928999,20.86379262415682,36.748003300848275,0.11861366781506011,311.2801375389099,66.1083574295044,287.4498481750488,3677,852,2825,2825,0,15,929000.0
929,929999,20.858908866051323,36.73881255754353,0.11858881693795309,311.49013209342957,66.17496609687805,288.4987983703613,3677,852,2825,2825,0,15,930000.0
930,930999,20.85633462541818,36.73259162826402,0.11854535528849408,311.7169349193573,66.24287581443787,289.3283576965332,3679,853,2826,2826,0,15,931000.0
931,931999,20.851544289768587,36.72501535811935,0.1185207150316645,311.9442570209503,66.31004118919373,290.0632133483887,3682,854,2828,2828,0,15,932000.0
932,932999,20.846888011083955,36.7164555609098,0.11848283057841125,312.20725774765015,66.37674903869629,290.4540367126465,3687,856,2831,2831,0,15,933000.0
933,933999,20.844988899870444,36.731416293022086,0.11832704488790624,312.5471339225769,66.44406461715698,290.72433853149414,3687,856,2831,2831,0,15,934000.0
934,934999,20.841725367234893,36.72223098055071,0.11827919863251679,312.8898079395294,66.51090741157532,290.8482322692871,3691,858,2833,2833,0,15,935000.0
935,935999,20.839952183026067,36.72054222733456,0.11816948968349128,313.18233036994934,66.57697057723999,291.3707466125488,3691,858,2833,2833,0,15,936000.0
936,936999,20.836802942997117,36.713690149403355,0.11810196634653725,313.5350067615509,66.64475846290588,291.53007888793945,3693,859,2834,2834,0,15,937000.0
937,937999,20.83689483826853,36.71307218004631,0.11807175935281022,314.011892080307,66.71412658691406,290.86760330200195,3699,862,2837,2837,0,15,938000.0
938,938999,20.837099122359025,36.71798250147602,0.11798517611156112,314.41887307167053,66.78255772590637,290.8462333679199,3701,863,2838,2838,0,15,939000.0
939,939999,20.8384743511332,36.71825028109741,0.11799826976130079,314.8195939064026,66.8500759601593,290.75068283081055,3705,865,2840,2840,0,15,940000.0
940,940999,20.841493055625335,36.72330730162447,0.11791420248214457,315.0911078453064,66.9185905456543,291.2765235900879,3707,866,2841,2841,0,15,941000.0
941,941999,20.84178991734105,36.721465137774075,0.11783327228582363,315.30646896362305,66.99079060554504,292.09875869750977,3707,866,2841,2841,0,15,942000.0
942,942999,20.844086894290925,36.721194012961625,0.11781975319047289,315.6311559677124,67.0582320690155,292.20090103149414,3709,867,2842,2842,0,15,943000.0
943,943999,20.844249506787577,36.71856804778306,0.11774824866915234,316.0190374851227,67.12754011154175,292.0893669128418,3711,868,2843,2843,0,15,944000.0
944,944999,20.845632905575446,36.7229983477817,0.11761538820783313,316.4959888458252,67.19736456871033,291.73122787475586,3715,870,2845,2845,0,15,945000.0
945,945999,20.845682933583316,36.720466603805946,0.11754905614066746,316.82287979125977,67.26625204086304,292.3547019958496,3721,870,2851,2851,0,15,946000.0
946,946999,20.84435833820066,36.728176118580514,0.1173971799716903,317.14527916908264,67.33336305618286,292.89946365356445,3726,871,2855,2855,0,15,947000.0
947,947999,20.83863524148635,36.71934678141347,0.11738657191478874,317.3934371471405,67.39888572692871,293.72514724731445,3726,871,2855,2855,0,15,948000.0
948,948999,20.83219247141313,36.708867110870784,0.11738603431385575,317.76479291915894,67.46484923362732,293.7914695739746,3730,873,2857,2857,0,15,949000.0
949,949999,20.829102407644065,36.70838559801322,0.11728600941004963,318.11847138404846,67.5310411453247,294.13378524780273,3730,873,2857,2857,0,15,950000.0
950,950999,20.82442212681812,36.700426613589705,0.11725742960050145,318.4463336467743,67.59721326828003,294.3711967468262,3734,875,2859,2859,0,15,951000.0
951,951999,20.82004456672811,36.691404746782915,0.11721796443215948,318.7978866100311,67.66443538665771,294.6931571960449,3734,875,2859,2859,0,15,952000.0
952,952999,20.815934837148795,36.683603764439766,0.11717050943804541,319.1515357494354,67.73180222511292,295.0760307312012,3750,877,2873,2873,0,15,953000.0
953,953999,20.81176377094574,36.67528553640636,0.11712300741848691,319.3086099624634,67.79966855049133,296.35859298706055,3751,877,2874,2874,0,15,954000.0
954,954999,20.80862164716889,36.671759868325395,0.11704628566343256,319.5090126991272,67.86751294136047,297.1715965270996,3751,877,2874,2874,0,15,955000.0
955,955999,20.806292620663385,36.66575481779516,0.11699860936605977,319.9243071079254,67.93601632118225,296.91809463500977,3755,879,2876,2876,0,15,956000.0
956,956999,20.804212982891436,36.66044341416253,0.11695806802985564,320.3806116580963,68.00568962097168,296.08369064331055,3769,886,2883,2883,0,15,957000.0
957,957999,20.803355846861606,36.65661190919461,0.11694024856611362,320.7812530994415,68.07667517662048,296.0055122375488,3775,889,2886,2886,0,15,958000.0
958,958999,20.80226789327782,36.65152453958796,0.11687317662268737,321.06231665611267,68.14689064025879,296.6577033996582,3777,890,2887,2887,0,15,959000.0
959,959999,20.80356687962867,36.65125432586887,0.11684911706899881,321.35043144226074,68.21645402908325,297.1238212585449,3777,890,2887,2887,0,15,960000.0
960,960999,20.806557757671957,36.65657004559212,0.1167753291050555,321.6712086200714,68.28789710998535,297.4388618469238,3779,891,2888,2888,0,15,961000.0
961,961999,20.8090309464745,36.657933827701754,0.1166888694010555,322.0111925601959,68.35763454437256,297.71753311157227,3779,891,2888,2888,0,15,962000.0
962,962999,20.810184750466735,36.65548325488774,0.11670762894876197,322.3972215652466,68.43011808395386,297.6463203430176,3781,892,2889,2889,0,15,963000.0
963,963999,20.813262914431334,36.65562595494313,0.11667923118200985,322.7966163158417,68.50132656097412,297.46940994262695,3785,894,2891,2891,0,15,964000.0
964,964999,20.816239820328438,36.65444759301633,0.11665690459056288,323.18361592292786,68.5702760219574,297.6008491516113,3785,894,2891,2891,0,15,965000.0
965,965999,20.815490769012403,36.64748063817599,0.11668749104201448,323.463693857193,68.64035630226135,298.1013526916504,3787,895,2892,2892,0,15,966000.0
966,966999,20.8160159446139,36.64970781459941,0.116560667352967,323.76948595046997,68.70895099639893,298.86243057250977,3813,898,2915,2915,0,15,967000.0
967,967999,20.80801638041135,36.63997649235783,0.11654859554612662,323.91603684425354,68.77317762374878,300.5382881164551,3815,898,2917,2917,0,15,968000.0
968,968999,20.79975632131158,36.62834104695307,0.1165549887389995,324.0675106048584,68.8374400138855,301.70007705688477,3815,898,2917,2917,0,15,969000.0
969,969999,20.792278488130165,36.619201847888924,0.11655389446770714,324.3537709712982,68.90172362327576,302.1196632385254,3819,900,2919,2919,0,15,970000.0
970,970999,20.785198189514762,36.608374659460836,0.11653135406512027,324.6058895587921,68.96671414375305,302.5118751525879,3825,903,2922,2922,0,15,971000.0
971,971999,20.777726465896784,36.595748083748745,0.1165231201847522,324.91016125679016,69.03326511383057,302.68173599243164,3831,906,2925,2925,0,15,972000.0
972,972999,20.76988533791713,36.583649078901374,0.11652800274125241,325.29513788223267,69.1011095046997,302.68371200561523,3839,910,2929,2929,0,15,973000.0
973,973999,20.762772938120555,36.572766537792006,0.11651532100306317,325.4539897441864,69.16597628593445,303.75539779663086,3839,910,2929,2929,0,15,974000.0
974,974999,20.755794872251638,36.56085835096002,0.11650069025807352,325.8093755245209,69.2320282459259,303.59778213500977,3845,913,2932,2932,0,15,975000.0
975,975999,20.749727456678816,36.5498235273814,0.11646599512453526,326.16279673576355,69.29806399345398,303.6204948425293,3855,915,2940,2940,0,15,976000.0
976,976999,20.744205492421724,36.543763492785,0.11643881979413029,326.5894229412079,69.36397814750671,303.55260848999023,3855,915,2940,2940,0,15,977000.0
977,977999,20.737937787466322,36.53192052705083,0.11643289333223839,327.0134506225586,69.43107533454895,303.61035537719727,3855,915,2940,2940,0,15,978000.0
978,978999,20.734312811515597,36.54820399295722,0.1162301329273745,327.3165819644928,69.4998128414154,303.9895896911621,3888,917,2971,2971,0,15,979000.0
979,979999,20.729620502287116,36.53975314272403,0.1161646088730035,327.6119179725647,69.56639122962952,304.39582443237305,3888,917,2971,2971,0,15,980000.0
980,980999,20.723725670312007,36.528900005382305,0.11615074838495498,328.11731028556824,69.6332757472992,303.79836654663086,3892,919,2973,2973,0,15,981000.0
981,981999,20.721188624419618,36.52413633980911,0.11608035657417926,328.3510682582855,69.69883966445923,304.5496025085449,3892,919,2973,2973,0,15,982000.0
982,982999,20.717263540310586,36.51651381338044,0.11604828892417784,328.69021248817444,69.76505780220032,304.8144187927246,3892,919,2973,2973,0,15,983000.0
983,983999,20.71224087546471,36.50682053742001,0.11602898952502805,328.98463463783264,69.83263373374939,305.1655158996582,3894,920,2974,2974,0,15,984000.0
984,984999,20.70860932460867,36.49848879858483,0.11599934597926354,329.3724822998047,69.89934825897217,305.05778884887695,3896,921,2975,2975,0,15,985000.0
985,985999,20.703804333729725,36.4886749575714,0.11597338813888514,329.9335241317749,69.96660423278809,304.5019950866699,3896,921,2975,2975,0,15,986000.0
986,986999,20.69841428841262,36.478100083509,0.11595212504479602,331.66722774505615,70.03412318229675,304.9671821594238,3898,922,2976,2976,0,15,987000.0
987,987999,20.701053534099735,36.4969699280889,0.1157076846815932,331.896377325058,70.0999219417572,306.14350509643555,3909,923,2986,2986,0,15,988000.0
988,988999,20.708925774266245,36.53208592556689,0.11536889384548188,332.15422105789185,70.16621732711792,306.9777488708496,3926,925,3001,3001,0,15,989000.0
989,989999,20.719707274545208,36.5904028000943,0.11514125306714496,332.3553750514984,70.23283052444458,308.2271308898926,3927,925,3002,3002,0,15,990000.0
990,990999,20.722041579399797,36.595883598217355,0.11508758081638293,332.63579273223877,70.29974174499512,308.7582130432129,3933,928,3005,3005,0,15,991000.0
991,991999,20.724860916769835,36.59910010138374,0.11498521576044107,332.85553193092346,70.36787986755371,309.56377029418945,3935,929,3006,3006,0,15,992000.0
992,992999,20.731035261008625,36.61105549776165,0.1148197505416434,333.1892545223236,70.43517851829529,309.6317481994629,3942,932,3010,3010,0,15,993000.0
993,993999,20.73437956262881,36.61562194219988,0.1146861615096405,333.47690415382385,70.50286054611206,310.1946220397949,3943,932,3011,3011,0,15,994000.0
994,994999,20.736991605597073,36.62190170993107,0.11457821331012874,333.75145649909973,70.57119417190552,310.6612968444824,3945,933,3012,3012,0,15,995000.0
995,995999,20.739688486900896,36.62531529268537,0.1144579700199242,334.20527505874634,70.6400556564331,310.38793563842773,3947,934,3013,3013,0,15,996000.0
996,996999,20.74187588428072,36.627405744561806,0.11437514272159699,334.4541916847229,70.70847916603088,310.9535102844238,3980,936,3044,3044,0,15,997000.0
997,997999,20.743876525701147,36.62565277268613,0.11429463217335922,334.84193110466003,70.77652406692505,310.9933433532715,3980,936,3044,3044,0,15,998000.0
998,998999,20.74621532239475,36.62849897036506,0.11416080275012219,335.283075094223,70.8449456691742,310.8670768737793,3982,937,3045,3045,0,15,999000.0
999,999999,20.74989201440009,36.6340798238413,0.1140037893212742,335.6563003063202,70.9126489162445,310.8939781188965,3984,938,3046,3046,0,15,1000000.0
1000,1000999,20.75083900928658,36.63296139322381,0.1138337538389339,335.95925092697144,70.98063635826111,311.4400520324707,3984,938,3046,3046,0,15,1001000.0
1001,1001999,20.754019497099513,36.64319818811372,0.11370045784353655,336.2776412963867,71.05046105384827,311.69294357299805,4015,939,3076,3076,0,15,1002000.0
1002,1002999,20.757111141085485,36.644425726305876,0.1135604906661779,336.66324949264526,71.11990332603455,311.70569229125977,4015,939,3076,3076,0,15,1003000.0
1003,1003999,20.75876483531847,36.64257300007802,0.11345994474189236,337.07142782211304,71.18773484230042,311.60849380493164,4015,939,3076,3076,0,15,1004000.0
1004,1004999,20.76156083365483,36.640460087898,0.11335024002918503,337.49439883232117,71.25690221786499,311.4242515563965,4017,940,3077,3077,0,15,1005000.0
1005,1005999,20.76316741865078,36.637802206378105,0.11323652812509477,337.8328113555908,71.32597613334656,311.7531852722168,4019,941,3078,3078,0,15,1006000.0
1006,1006999,20.765170050633493,36.64234759280466,0.11311002884455057,338.1211528778076,71.39408850669861,312.22775650024414,4019,941,3078,3078,0,15,1007000.0
1007,1007999,20.763236288201167,36.636544569839856,0.1130482588826357,338.3455271720886,71.46095561981201,313.38013076782227,4030,942,3088,3088,0,15,1008000.0
1008,1008999,20.759042926192176,36.633670317624464,0.11298213704806603,338.5825192928314,71.52759766578674,314.2842674255371,4031,942,3089,3089,0,15,1009000.0
1009,1009999,20.754350594954357,36.62764708256868,0.11293292074615224,338.8617126941681,71.5953266620636,314.76364517211914,4033,943,3090,3090,0,15,1010000.0
1010,1010999,20.750201810991058,36.62292033077794,0.11288559876005833,339.1398882865906,71.66335487365723,315.2856864929199,4035,944,3091,3091,0,15,1011000.0
1011,1011999,20.74687532824167,36.617714983954535,0.11282727544362192,339.5571641921997,71.73312067985535,315.0050468444824,4039,946,3093,3093,0,15,1012000.0
1012,1012999,20.743001776967112,36.61073919118427,0.11278240174894538,339.91786670684814,71.80207014083862,315.2333106994629,4041,947,3094,3094,0,15,1013000.0
1013,1013999,20.7402018745157,36.6039741130571,0.11274312719883572,340.26525497436523,71.8705358505249,315.59653091430664,4041,947,3094,3094,0,15,1014000.0
1014,1014999,20.737337462951878,36.599608732523,0.11269705563431254,340.60301065444946,71.9388747215271,315.92431259155273,4074,949,3125,3125,0,15,1015000.0
1015,1015999,20.734459700775673,36.59359542962072,0.11264009598400437,340.9585189819336,72.00724077224731,315.76028060913086,4078,952,3126,3126,0,15,1016000.0
1016,1016999,20.73280413772549,36.58929942976375,0.1126168200263471,341.3342967033386,72.07776808738708,315.62649154663086,4082,954,3128,3128,0,15,1017000.0
1017,1017999,20.73495756093268,36.59023548440647,0.11264745373134455,341.7945272922516,72.14931774139404,315.35139083862305,4086,956,3130,3130,0,15,1018000.0
1018,1018999,20.737512099754518,36.59512466242454,0.11267995047850421,342.08115816116333,72.21986651420593,316.0019645690918,4086,956,3130,3130,0,15,1019000.0
1019,1019999,20.740422342895048,36.59652029870969,0.1127233124883289,342.393515586853,72.28941869735718,316.4310874938965,4086,956,3130,3130,0,15,1020000.0
1020,1020999,20.74285008744095,36.596910052609,0.11277411498747691,342.7816331386566,72.35991501808167,316.5117378234863,4086,956,3130,3130,0,15,1021000.0
1021,1021999,20.747588765650203,36.60117179432487,0.1128035027359583,343.2046217918396,72.43228721618652,316.2519111633301,4088,957,3131,3131,0,16,1022000.0
1022,1022999,20.751930127373086,36.60449986042268,0.11285324446956102,343.51473212242126,72.50378012657166,316.7614326477051,4088,957,3131,3131,0,16,1023000.0
1023,1023999,20.756749721079107,36.60515169435676,0.11287138981602451,343.8597602844238,72.57574152946472,316.9346504211426,4089,958,3131,3131,0,17,1024000.0
1024,1024999,20.76097020256535,36.60483501052622,0.11288705413072364,344.2868483066559,72.64727854728699,316.8248100280762,4089,958,3131,3131,0,17,1025000.0
1025,1025999,20.767354612063905,36.609461379339685,0.11286484714141654,344.63501238822937,72.71982383728027,317.0994071960449,4089,958,3131,3131,0,17,1026000.0
1026,1026999,20.770928891010268,36.608860883709816,0.11285318634648633,345.04329228401184,72.79206943511963,316.9851188659668,4089,958,3131,3131,0,17,1027000.0
1027,1027999,20.77285717122394,36.60531623142073,0.1127961232942033,345.4751958847046,72.86279487609863,316.89643478393555,4089,958,3131,3131,0,17,1028000.0
1028,1028999,20.76720886004288,36.5975611464006,0.11276003290726,345.69440603256226,72.9285798072815,318.2491035461426,4107,959,3148,3148,0,17,1029000.0
1029,1029999,20.76222013746431,36.59170336044006,0.11271734564919944,345.87654638290405,72.9934434890747,319.81139755249023,4132,960,3172,3172,0,17,1030000.0
1030,1030999,20.758012852258556,36.58418504876584,0.11268442277554602,346.03122997283936,73.06296372413635,321.3092918395996,4135,960,3175,3175,0,17,1031000.0
1031,1031999,20.75286590376148,36.57470550150547,0.11267595820136345,346.22053503990173,73.12838959693909,322.458553314209,4140,961,3179,3179,0,17,1032000.0
1032,1032999,20.747700387533577,36.56626456122286,0.11264814977469839,346.41053915023804,73.19268131256104,323.4693794250488,4142,962,3180,3180,0,17,1033000.0
1033,1033999,20.74368450877454,36.55909875951261,0.11262047691671284,346.7790846824646,73.25824117660522,323.60505294799805,4146,964,3182,3182,0,17,1034000.0
1034,1034999,20.739444251477025,36.55246988663844,0.11257667033053242,347.0677366256714,73.32512044906616,323.8395576477051,4159,968,3191,3191,0,17,1035000.0
1035,1035999,20.735257828188637,36.54735423723813,0.11254319079450248,347.3321154117584,73.39233064651489,324.6171226501465,4161,969,3192,3192,0,17,1036000.0
1036,1036999,20.731906300062633,36.543806913567735,0.11248451307929663,347.62389492988586,73.45981788635254,324.8187828063965,4175,973,3202,3202,0,17,1037000.0
1037,1037999,20.729509784161788,36.538392823602834,0.11242321205284433,347.8765392303467,73.52588295936584,325.4159126281738,4177,974,3203,3203,0,17,1038000.0
1038,1038999,20.727539250126522,36.532041814505384,0.1123976121536926,348.32311272621155,73.59245729446411,325.1697654724121,4186,976,3210,3210,0,17,1039000.0
1039,1039999,20.725562492538007,36.527224692777544,0.11235142573092205,348.8367705345154,73.66550183296204,324.77309799194336,4188,977,3211,3211,0,17,1040000.0
1040,1040999,20.725210958971342,36.52605697727117,0.11229757575100219,349.123165845871,73.73380136489868,325.11340713500977,4193,979,3214,3214,0,17,1041000.0
1041,1041999,20.724766635748495,36.522140663389834,0.11221879745087981,349.3745365142822,73.80236482620239,325.858097076416,4193,979,3214,3214,0,17,1042000.0
1042,1042999,20.72581463199343,36.52049326081559,0.11218396774443273,349.71836042404175,73.86960911750793,325.8999824523926,4197,981,3216,3216,0,17,1043000.0
1043,1043999,20.72831402394811,36.52234195163576,0.11214315347024506,349.9652099609375,73.93571090698242,326.4665718078613,4199,982,3217,3217,0,17,1044000.0
1044,1044999,20.729135742961308,36.52215308168172,0.11209397399842347,350.3758134841919,74.00674104690552,326.5589256286621,4201,983,3218,3218,0,17,1045000.0
1045,1045999,20.73107227587261,36.522136087491134,0.11201917153868157,350.63276505470276,74.07481980323792,327.2194480895996,4201,983,3218,3218,0,17,1046000.0
1046,1046999,20.73408020449025,36.52378482999733,0.1120080269351571,351.0615289211273,74.1420361995697,326.9399833679199,4205,985,3220,3220,0,17,1047000.0
1047,1047999,20.73688850154963,36.523238757114804,0.11197621241690214,351.46875858306885,74.21105408668518,327.08005142211914,4205,985,3220,3220,0,17,1048000.0
1048,1048999,20.73563211110623,36.516198103687806,0.1119494295445278,351.75429034233093,74.27989554405212,327.6068992614746,4209,987,3222,3222,0,17,1049000.0
1049,1049999,20.732874145962636,36.51342138324577,0.11188276728958613,352.0353059768677,74.34785914421082,328.63891983032227,4220,988,3232,3232,0,17,1050000.0
1050,1050999,20.728977798212078,36.506403531904475,0.11188663568379109,352.3770577907562,74.4152443408966,329.25546646118164,4274,989,3285,3285,0,17,1051000.0
1051,1051999,20.722972599087413,36.49598424225963,0.11189743015358455,352.69249963760376,74.48131823539734,330.0043525695801,4274,989,3285,3285,0,17,1052000.0
1052,1052999,20.72084784435666,36.489870265968534,0.11182830203297445,352.98582577705383,74.54847407341003,330.70571517944336,4277,990,3287,3287,0,17,1053000.0
1053,1053999,20.717191658518033,36.481523241695086,0.11179133981330536,353.373183965683,74.61553192138672,330.8416633605957,4281,992,3289,3289,0,17,1054000.0
1054,1054999,20.717114118785428,36.48461224234815,0.11168631202845403,353.6989998817444,74.68317103385925,331.4204292297363,4281,992,3289,3289,0,17,1055000.0
1055,1055999,20.718175486892168,36.49471141022713,0.11155937547011996,354.09366750717163,74.7513747215271,331.1749076843262,4317,996,3321,3321,0,17,1056000.0
1056,1056999,20.721362607327258,36.50767039440009,0.11146798017006276,354.4522604942322,74.82030487060547,331.47136306762695,4320,998,3322,3322,0,17,1057000.0
1057,1057999,20.7289558761277,36.54800905666367,0.11201541803964277,356.42570543289185,74.88971662521362,331.5830192565918,4320,998,3322,3322,0,17,1058000.0
1058,1058999,20.735468961616792,36.56126761674906,0.11199970619187993,356.8111786842346,74.96013116836548,331.57217025756836,4324,1000,3324,3324,0,17,1059000.0
1059,1059999,20.74220530078013,36.59070926021624,0.11184101647914946,357.1327815055847,75.03099513053894,332.053897857666,4324,1000,3324,3324,0,17,1060000.0
1060,1060999,20.750031893279207,36.61928831950694,0.11160443886846283,357.4653420448303,75.09991908073425,332.4025230407715,4355,1001,3354,3354,0,17,1061000.0
1061,1061999,20.76211800770064,36.66081631131251,0.11151023918642633,357.9782135486603,75.1706440448761,331.9005928039551,4361,1004,3357,3357,0,17,1062000.0
1062,1062999,20.774130430282348,36.69148557863443,0.11140351994411413,358.3601162433624,75.24039697647095,331.90307235717773,4364,1006,3358,3358,0,17,1063000.0
1063,1063999,20.78652071502591,36.724558159563195,0.1112512509927176,358.7407658100128,75.31479001045227,331.95685958862305,4367,1008,3359,3359,0,17,1064000.0
1064,1064999,20.79341243042682,36.740030593034746,0.11091640172548733,358.98391795158386,75.38619422912598,333.0013999938965,4376,1008,3368,3368,0,17,1065000.0
1065,1065999,20.79723303824113,36.7558592339337,0.110743501495004,359.3012273311615,75.45156478881836,333.4394340515137,4379,1009,3370,3370,0,17,1066000.0
1066,1066999,20.801882601917104,36.77185942924042,0.11062789245342586,359.56424021720886,75.51751184463501,334.3054542541504,4399,1011,3388,3388,0,17,1067000.0
1067,1067999,20.807028042796,36.79036985585909,0.11054876642790512,359.7465567588806,75.58303904533386,335.600154876709,4401,1012,3389,3389,0,17,1068000.0
1068,1068999,20.810336551480507,36.79516718390599,0.11047240103138156,360.02715826034546,75.64928674697876,336.2634086608887,4402,1012,3390,3390,0,17,1069000.0
1069,1069999,20.81728422190797,36.818169367983494,0.11043154349504469,360.21736431121826,75.71518206596375,337.2538948059082,4404,1012,3392,3392,0,17,1070000.0
1070,1070999,20.821802068403805,36.83155815452774,0.11047424289437358,360.5067512989044,75.78116393089294,337.5093574523926,4406,1013,3393,3393,0,17,1071000.0
1071,1071999,20.826607882237337,36.8404941425163,0.11055251246875519,360.90832448005676,75.84833312034607,337.4995994567871,4408,1014,3394,3394,0,17,1072000.0
1072,1072999,20.83186880293665,36.84704746635819,0.11068140894837064,361.2062261104584,75.91803765296936,337.9364814758301,4408,1014,3394,3394,0,17,1073000.0
1073,1073999,20.84002282262526,36.87277075768709,0.11069993335470774,361.56374049186707,75.9848165512085,338.1888008117676,4408,1014,3394,3394,0,17,1074000.0
1074,1074999,20.851662549335817,36.915260813947235,0.1106820410846896,361.87232995033264,76.05274248123169,338.20934677124023,4415,1017,3398,3398,0,17,1075000.0
1075,1075999,20.8625256511851,36.93255828589675,0.11071521188712707,362.43126916885376,76.11997675895691,337.4809684753418,4419,1019,3400,3400,0,17,1076000.0
1076,1076999,20.876334903712337,36.95979474566289,0.11077837451060446,362.7355613708496,76.19267773628235,338.0037498474121,4419,1019,3400,3400,0,17,1077000.0
1077,1077999,20.89017710610087,36.98918718144853,0.11097438030561857,363.0168011188507,76.2605619430542,338.5788764953613,4419,1019,3400,3400,0,17,1078000.0
1078,1078999,20.90586564656685,37.032484531686165,0.11106335088211594,363.35429525375366,76.32764673233032,338.6806526184082,4421,1020,3401,3401,0,17,1079000.0
1079,1079999,20.922501412684916,37.07261798398664,0.11123233512338282,363.7778334617615,76.39752173423767,338.44687271118164,4423,1021,3402,3402,0,17,1080000.0
1080,1080999,20.942118328185288,37.121385861987726,0.1114102800084299,364.2309913635254,76.46471500396729,338.34194564819336,4425,1022,3403,3403,0,17,1081000.0
1081,1081999,20.96164164918001,37.182654921807604,0.11157999857062106,364.6109263896942,76.53456234931946,338.4688911437988,4429,1024,3405,3405,0,17,1082000.0
1082,1082999,20.96847212395118,37.195189373221474,0.11146300128492337,364.8361005783081,76.60120248794556,339.5136070251465,4441,1026,3415,3415,0,17,1083000.0
1083,1083999,20.96854011447865,37.19767732124928,0.11137313027624052,365.1066608428955,76.6672375202179,340.15864181518555,4441,1026,3415,3415,0,17,1084000.0
1084,1084999,20.970600069445947,37.21260335000156,0.11123658725462016,365.48042130470276,76.73411726951599,340.27326583862305,4443,1027,3416,3416,0,17,1085000.0
1085,1085999,20.972352829368724,37.21916041805724,0.11112791165419977,365.79774618148804,76.80069184303284,340.63452529907227,4445,1028,3417,3417,0,17,1086000.0
1086,1086999,20.974117482946088,37.22145584703662,0.11106327585634235,366.1083824634552,76.86881017684937,341.01174545288086,4447,1029,3418,3418,0,17,1087000.0
1087,1087999,20.977371473517593,37.24346988271583,0.11089123773191445,366.46371388435364,76.93682599067688,340.96408462524414,4453,1032,3421,3421,0,17,1088000.0
1088,1088999,20.981956287527243,37.2504743133466,0.11080816774604374,366.75596356391907,77.00407409667969,341.4976463317871,4453,1032,3421,3421,0,17,1089000.0
1089,1089999,20.98587264267416,37.25549183166129,0.1107334747640849,367.10595655441284,77.07117080688477,341.73449325561523,4453,1032,3421,3421,0,17,1090000.0
1090,1090999,20.99247303284904,37.267141778722994,0.11064729354515235,367.45372676849365,77.13926100730896,341.99433517456055,4453,1032,3421,3421,0,17,1091000.0
1091,1091999,21.00106242624785,37.28204319340734,0.1105766698899977,367.93097019195557,77.2066113948822,341.43771743774414,4455,1034,3421,3421,0,17,1092000.0
1092,1092999,21.01102969320899,37.29354630401405,0.1105910901612519,368.2812297344208,77.27552318572998,341.67021560668945,4471,1036,3435,3435,0,17,1093000.0
1093,1093999,21.019893775188475,37.30655462481168,0.11067252917309267,368.476763010025,77.34407067298889,342.8957176208496,4474,1037,3437,3437,0,17,1094000.0
1094,1094999,21.02907807279098,37.31698852543658,0.1106995877939071,368.7719929218292,77.41377711296082,343.49650955200195,4475,1037,3438,3438,0,17,1095000.0
1095,1095999,21.04099802417404,37.34500352307113,0.11074671407054903,369.14793848991394,77.48327684402466,343.66557693481445,4477,1038,3439,3439,0,17,1096000.0
1096,1096999,21.053066260978202,37.36181752916904,0.11091660817260729,369.4021427631378,77.55356168746948,344.3004035949707,4477,1038,3439,3439,0,17,1097000.0
1097,1097999,21.064330610619013,37.374169888081205,0.11101742870181919,369.74674367904663,77.62607860565186,344.55192947387695,4477,1038,3439,3439,0,17,1098000.0
1098,1098999,21.07357196290128,37.38282471212324,0.11115689374396087,370.24970984458923,77.69517707824707,344.0649223327637,4481,1040,3441,3441,0,17,1099000.0
1099,1099999,21.084332973567612,37.393577243874,0.11122086113026952,370.4183750152588,77.76613163948059,345.0301094055176,4482,1040,3442,3442,0,17,1100000.0
1100,1100999,21.091937975123273,37.398373477341735,0.11132179569753908,370.7642114162445,77.83522081375122,345.2524223327637,4482,1040,3442,3442,0,17,1101000.0
1101,1101999,21.098778670656728,37.40136186719381,0.11135129889378903,371.1951560974121,77.90521597862244,344.90478134155273,4485,1042,3443,3443,0,17,1102000.0
1102,1102999,21.09915089165894,37.39940003343213,0.11127072998429932,371.5318555831909,77.97167682647705,346.0039939880371,4506,1042,3464,3464,0,17,1103000.0
1103,1103999,21.095411977911038,37.397940565578295,0.11122545770657266,371.680438041687,78.03681802749634,347.4982490539551,4508,1042,3466,3466,0,17,1104000.0
1104,1104999,21.091669967096287,37.39180321336772,0.11117938407405392,371.8661677837372,78.10131049156189,348.5202751159668,4508,1042,3466,3466,0,17,1105000.0
1105,1105999,21.090636624191994,37.39017526919778,0.1111132344781296,372.1467318534851,78.16588640213013,348.82951736450195,4516,1046,3470,3470,0,17,1106000.0
1106,1106999,21.09133026948686,37.39049292401069,0.11106031960919205,372.399307012558,78.23129296302795,349.26882553100586,4522,1049,3473,3473,0,17,1107000.0
1107,1107999,21.090756651169997,37.38694626302099,0.11102867551788775,372.71115946769714,78.29831051826477,349.43236923217773,4530,1053,3477,3477,0,17,1108000.0
1108,1108999,21.090503329192003,37.38526331865372,0.11095616235356842,373.02175545692444,78.36347341537476,349.7657051086426,4534,1055,3479,3479,0,17,1109000.0
1109,1109999,21.08843308273809,37.37930129129005,0.11097260169479184,373.32987356185913,78.4290406703949,350.3273277282715,4534,1055,3479,3479,0,17,1110000.0
1110,1110999,21.086171231413573,37.37249096323249,0.11092669224377283,373.6386663913727,78.49442410469055,350.6184730529785,4538,1057,3481,3481,0,17,1111000.0
1111,1111999,21.08575149709965,37.36805834419926,0.11092822759075449,374.0944149494171,78.56348419189453,350.3301582336426,4542,1058,3484,3484,0,17,1112000.0
1112,1112999,21.08687308618071,37.366748707317065,0.11095521939348008,374.39568424224854,78.62977886199951,350.8104591369629,4542,1058,3484,3484,0,17,1113000.0
1113,1113999,21.08434834261304,37.36045352782326,0.11094195363492176,374.73745369911194,78.6991286277771,350.9859733581543,4546,1060,3486,3486,0,17,1114000.0
1114,1114999,21.08451707720572,37.35965177385555,0.11096224965226276,375.15096259117126,78.76649117469788,350.8933753967285,4548,1061,3487,3487,0,17,1115000.0
1115,1115999,21.08334211984753,37.35335094488778,0.11091076653202381,375.4433569908142,78.83216428756714,351.24245834350586,4550,1062,3488,3488,0,17,1116000.0
1116,1116999,21.082431298136864,37.349713850605646,0.11089427988169975,375.91747283935547,78.89844083786011,350.5568733215332,4558,1066,3492,3492,0,17,1117000.0
1117,1117999,21.081526052509158,37.343472181153565,0.11084464877611189,376.1232831478119,78.96469354629517,351.4428520202637,4558,1066,3492,3492,0,17,1118000.0
1118,1118999,21.08021953460281,37.33686992641664,0.1108133848728381,376.6540322303772,79.0320553779602,350.87305068969727,4558,1066,3492,3492,0,17,1119000.0
1119,1119999,21.07807754879479,37.330068280868616,0.11076042439929346,377.08216428756714,79.10031151771545,350.7650260925293,4558,1066,3492,3492,0,17,1120000.0
1120,1120999,21.076630193297248,37.3238591996339,0.11072795313108241,377.5503590106964,79.16835427284241,350.6564826965332,4558,1066,3492,3492,0,17,1121000.0
1121,1121999,21.07367523776128,37.31533108814526,0.11066761187657248,377.81204986572266,79.23493552207947,351.2527656555176,4562,1068,3494,3494,0,17,1122000.0
1122,1122999,21.071525736577684,37.30797699047818,0.1106143449874023,378.09231519699097,79.30231213569641,351.9970283508301,4571,1069,3502,3502,0,17,1123000.0
1123,1123999,21.065582682315185,37.305772867820984,0.1105897096856081,378.35153889656067,79.369225025177,352.8595848083496,4576,1070,3506,3506,0,17,1124000.0
1124,1124999,21.058129776285327,37.299060153513274,0.11060158185553304,378.58332991600037,79.4363100528717,353.68571853637695,4590,1071,3519,3519,0,17,1125000.0
1125,1125999,21.052207385085847,37.29255315089488,0.11060399424038703,378.88619112968445,79.50446939468384,354.2910499572754,4596,1074,3522,3522,0,17,1126000.0
1126,1126999,21.046407762205497,37.28783192786751,0.11056750044530916,379.10566210746765,79.57206201553345,355.2480278015137,4598,1075,3523,3523,0,17,1127000.0
1127,1127999,21.039588605974227,37.278149129407296,0.11057251796537093,379.3827109336853,79.64020800590515,355.7813377380371,4603,1077,3526,3526,0,17,1128000.0
1128,1128999,21.033425356340718,37.26787632508223,0.11058777930673147,379.61182856559753,79.7065258026123,356.5702095031738,4604,1077,3527,3527,0,17,1129000.0
1129,1129999,21.02753785067399,37.259941190961534,0.11059367014896271,379.8615839481354,79.77314782142639,357.1866874694824,4605,1077,3528,3528,0,17,1130000.0
1130,1130999,21.02250353810316,37.257190060159914,0.11054414768050613,380.25474190711975,79.84064388275146,357.0329475402832,4609,1079,3530,3530,0,17,1131000.0
1131,1131999,21.016704936192504,37.24752233078581,0.11054730097039289,380.61953806877136,79.91077041625977,357.2433967590332,4611,1080,3531,3531,0,17,1132000.0
1132,1132999,21.011132886577634,37.23825398418531,0.11054931340203977,380.9094445705414,79.9799907207489,357.60012435913086,4613,1081,3532,3532,0,17,1133000.0
1133,1133999,21.006306385502516,37.22979088510789,0.11055469732626921,381.399667263031,80.0481653213501,357.1185493469238,4615,1082,3533,3533,0,17,1134000.0
1134,1134999,21.001690550836138,37.22155453818314,0.11054594986978505,383.50316762924194,80.11599493026733,357.1443901062012,4615,1082,3533,3533,0,17,1135000.0
1135,1135999,20.99830775231992,37.21691366565128,0.11050441917052856,383.7957682609558,80.18434047698975,357.6331977844238,4615,1082,3533,3533,0,17,1136000.0
1136,1136999,20.99522610999457,37.2135937177743,0.11042983600684086,384.1479482650757,80.25254011154175,357.835262298584,4615,1082,3533,3533,0,17,1137000.0
1137,1137999,20.990775335164347,37.20411052592615,0.11039672761255781,384.43457078933716,80.32097959518433,358.1564826965332,4617,1083,3534,3534,0,17,1138000.0
1138,1138999,20.989526130527356,37.20188690492779,0.11032209750244926,384.7670407295227,80.38957071304321,358.4098930358887,4619,1084,3535,3535,0,17,1139000.0
1139,1139999,20.98747561313466,37.19527750889895,0.1102848029976693,385.0555646419525,80.45713305473328,358.8582649230957,4619,1084,3535,3535,0,17,1140000.0
1140,1140999,20.986885557452204,37.19180889122947,0.11021086657615276,385.53139638900757,80.5261127948761,358.39638900756836,4621,1085,3536,3536,0,17,1141000.0
1141,1141999,20.985162731716624,37.18583736233244,0.11016853152559603,385.91459035873413,80.59631848335266,358.5466423034668,4621,1085,3536,3536,0,17,1142000.0
1142,1142999,20.98360562161447,37.180180257168296,0.11012148069090033,386.3437542915344,80.66525721549988,358.5556526184082,4621,1085,3536,3536,0,17,1143000.0
1143,1143999,20.984780790592765,37.183109728271724,0.1100750780799633,386.67910623550415,80.73395824432373,358.798282623291,4624,1087,3537,3537,0,17,1144000.0
1144,1144999,20.98490339842616,37.185850141622154,0.11005192512902484,386.9764006137848,80.80456638336182,359.2016258239746,4626,1088,3538,3538,0,17,1145000.0
1145,1145999,20.98546498563037,37.18565901478513,0.11006984413179355,387.423184633255,80.87590956687927,358.9641227722168,4628,1089,3539,3539,0,17,1146000.0
1146,1146999,20.988857606623515,37.195650969237576,0.11000995364322108,387.70285820961,80.94774460792542,359.45959091186523,4634,1091,3543,3543,0,17,1147000.0
1147,1147999,20.990726290519483,37.20202435580917,0.10992117090979359,387.99547719955444,81.02160501480103,359.8227653503418,4638,1093,3545,3545,0,17,1148000.0
1148,1148999,20.995166062911196,37.21122266968769,0.10991144578276846,388.59881234169006,81.09268355369568,358.4255180358887,4648,1098,3550,3550,0,17,1149000.0
1149,1149999,21.001169932880625,37.22360366024023,0.11002357431879906,388.8416037559509,81.16532182693481,359.16440200805664,4650,1099,3551,3551,0,17,1150000.0
1150,1150999,21.008289222196183,37.24239754228199,0.11024502347557574,389.2553517818451,81.2384705543518,358.9837226867676,4654,1101,3553,3553,0,17,1151000.0
1151,1151999,21.01483421210499,37.25005662550021,0.11038036858530476,389.65591526031494,81.31265354156494,359.2588539123535,4654,1101,3553,3553,0,17,1152000.0
1152,1152999,21.02372182517823,37.26977709756148,0.11063804587785775,389.95407366752625,81.38513612747192,359.7909812927246,4654,1101,3553,3553,0,17,1153000.0
1153,1153999,21.03593493157628,37.293459659494864,0.11086105353389242,390.262323141098,81.46315097808838,360.37282943725586,4654,1101,3553,3553,0,17,1154000.0
1154,1154999,21.044976710033303,37.30843305769503,0.11117324610590296,390.65057349205017,81.53547143936157,360.29721450805664,4668,1102,3566,3566,0,17,1155000.0
1155,1155999,21.053154863544442,37.32128550979845,0.11135431684908415,391.03973865509033,81.60686659812927,360.34316635131836,4670,1103,3567,3567,0,17,1156000.0
1156,1156999,21.063386622835225,37.33743249960977,0.11157144136214137,391.4417278766632,81.67992568016052,360.0326957702637,4677,1107,3570,3570,0,17,1157000.0
1157,1157999,21.076388864579965,37.36627115857866,0.11193319775202315,391.8078052997589,81.75392818450928,360.15981674194336,4686,1109,3577,3577,0,17,1158000.0
1158,1158999,21.089192604191155,37.39542242707994,0.11225558275906755,392.1748411655426,81.82740950584412,360.21361923217773,4690,1111,3579,3579,0,17,1159000.0
1159,1159999,21.104307146590685,37.4253837960595,0.11256552079713877,392.62504529953003,81.9010169506073,359.9998588562012,4692,1112,3580,3580,0,17,1160000.0
1160,1160999,21.117713720616948,37.4469945002068,0.1127527940557791,393.01811504364014,81.97437119483948,360.1879234313965,4692,1112,3580,3580,0,17,1161000.0
1161,1161999,21.131991857708954,37.46784756306477,0.11307369174151771,393.3720121383667,82.04901075363159,360.39340591430664,4693,1113,3580,3580,0,18,1162000.0
1162,1162999,21.145287258502538,37.49012486156065,0.11320608059100179,393.6623229980469,82.12254309654236,361.0204048156738,4693,1113,3580,3580,0,18,1163000.0
1163,1163999,21.14745309678285,37.49894805592072,0.1130754898177394,393.9537196159363,82.18672513961792,361.61401748657227,4695,1114,3581,3581,0,18,1164000.0
1164,1164999,21.148839253842205,37.50761855501155,0.1129314463872566,394.34775948524475,82.25189876556396,361.5999946594238,4730,1117,3613,3613,0,18,1165000.0
1165,1165999,21.151538210573126,37.512948737785116,0.11285181563635782,394.6919422149658,82.32423853874207,361.8216896057129,4734,1119,3615,3615,0,18,1166000.0
1166,1166999,21.15534022581589,37.52052456440933,0.11279526164175213,395.20222520828247,82.39669990539551,361.3189811706543,4738,1121,3617,3617,0,18,1167000.0
1167,1167999,21.158482288479178,37.5402733065566,0.11266532796213269,395.5737273693085,82.46326637268066,361.5292320251465,4771,1123,3648,3648,0,18,1168000.0
1168,1168999,21.16211571223537,37.54372810906926,0.11262645199667476,395.9068329334259,82.53561353683472,362.017879486084,4802,1124,3678,3678,0,18,1169000.0
1169,1169999,21.167928212356866,37.55445847777355,0.11259768647346202,396.2936370372772,82.60339522361755,362.05410385131836,4804,1125,3679,3679,0,18,1170000.0
1170,1170999,21.17424090081431,37.565023104511766,0.11258403583586996,396.6153838634491,82.67413139343262,362.1462287902832,4810,1128,3682,3682,0,18,1171000.0
1171,1171999,21.1793256991874,37.572929465163284,0.11256463970472386,396.8297715187073,82.74140644073486,362.93581771850586,4810,1128,3682,3682,0,18,1172000.0
1172,1172999,21.188791309234926,37.59236062927383,0.11263842801474655,397.32931089401245,82.8109803199768,362.37234115600586,4814,1130,3684,3684,0,18,1173000.0
1173,1173999,21.201248472555037,37.61727818962925,0.11276446284324926,397.7648878097534,82.88126921653748,362.05710220336914,4849,1133,3716,3716,0,18,1174000.0
1174,1174999,21.210095975407473,37.631669347090664,0.11283774788776113,398.20347118377686,82.95232820510864,361.7656135559082,4867,1137,3730,3730,0,18,1175000.0
1175,1175999,21.220906328989546,37.65247572890493,0.1129529963082323,398.4530951976776,83.02247333526611,362.4697685241699,4867,1137,3730,3730,0,18,1176000.0
1176,1176999,21.231921648228806,37.6737872092134,0.11302941622708895,398.71334648132324,83.08978080749512,363.08557510375977,4867,1137,3730,3730,0,18,1177000.0
1177,1177999,21.24601690244758,37.70378294542596,0.11327887803648451,399.06313252449036,83.15829992294312,363.1670036315918,4871,1139,3732,3732,0,18,1178000.0
1178,1178999,21.254982839203713,37.71640539176623,0.11336950115801281,399.45693826675415,83.23074340820312,363.2939109802246,4871,1139,3732,3732,0,18,1179000.0
1179,1179999,21.266161895675715,37.73904096403618,0.11346655395837679,399.7992293834686,83.30110430717468,363.3764762878418,4875,1141,3734,3734,0,18,1180000.0
1180,1180999,21.279473391962867,37.760773661022185,0.11374707100290571,400.217387676239,83.37122130393982,363.23989486694336,4877,1142,3735,3735,0,18,1181000.0
1181,1181999,21.28908743622882,37.77100281512006,0.11394028738395101,400.7237162590027,83.44023609161377,362.8783378601074,4880,1143,3737,3737,0,18,1182000.0
1182,1182999,21.296496802538,37.77971982413807,0.11399453755494071,401.07404708862305,83.51092958450317,363.1467704772949,4882,1144,3738,3738,0,18,1183000.0
1183,1183999,21.298427259192376,37.7859816535601,0.11381296004967678,401.41608214378357,83.58190536499023,363.7075996398926,4882,1144,3738,3738,0,18,1184000.0
1184,1184999,21.298416857417106,37.78443500612113,0.11379479446747753,401.674747467041,83.65152263641357,364.47565841674805,4882,1144,3738,3738,0,18,1185000.0
1185,1185999,21.298289938733575,37.78456967334775,0.11375712570828433,402.05948758125305,83.72213935852051,364.4460334777832,4886,1146,3740,3740,0,18,1186000.0
1186,1186999,21.298075864325792,37.78330409939783,0.11370941341538698,402.5827422142029,83.79158306121826,364.0205497741699,4886,1146,3740,3740,0,18,1187000.0
1187,1187999,21.29653446960714,37.77881547642598,0.11372104859576049,402.89061164855957,83.86172103881836,364.548770904541,4886,1146,3740,3740,0,18,1188000.0
1188,1188999,21.29509323647639,37.77354801873748,0.11369378268675212,403.20992255210876,83.93178820610046,364.98640060424805,4886,1146,3740,3740,0,18,1189000.0
1189,1189999,21.2939952471336,37.77066358742121,0.11365431364035417,403.57079315185547,84.00156092643738,365.02234268188477,4888,1147,3741,3741,0,18,1190000.0
1190,1190999,21.29355278188052,37.769444058724986,0.1136097435002833,403.8667736053467,84.07281851768494,365.32685470581055,4890,1148,3742,3742,0,18,1191000.0
1191,1191999,21.293819457238243,37.77608430039582,0.11352835454559518,404.20296907424927,84.14445805549622,365.6035270690918,4892,1149,3743,3743,0,18,1192000.0
1192,1192999,21.292924671802226,37.77103835267358,0.11353697023515041,404.72932958602905,84.21586585044861,364.9264717102051,4893,1150,3743,3743,0,18,1193000.0
1193,1193999,21.293022498731677,37.766562053799774,0.11354998999182586,405.0206434726715,84.28857398033142,365.48230361938477,4893,1150,3743,3743,0,18,1194000.0
1194,1194999,21.293510357207996,37.762938970061555,0.11352779142006486,405.2817087173462,84.36087727546692,366.11772537231445,4893,1150,3743,3743,0,18,1195000.0
1195,1195999,21.29355174607085,37.75740344514259,0.11353753615936057,405.72713589668274,84.43270874023438,365.8170280456543,4895,1151,3744,3744,0,18,1196000.0
1196,1196999,21.294980338399778,37.75387218804169,0.11353871106652902,406.12840485572815,84.50382280349731,365.9350776672363,4896,1151,3745,3745,0,18,1197000.0
1197,1197999,21.29531880811078,37.74787612667162,0.11351362091468609,406.46525979042053,84.57919502258301,366.4436454772949,4896,1151,3745,3745,0,18,1198000.0
1198,1198999,21.295531950256844,37.74261071784336,0.11350437289338844,406.97133803367615,84.65019059181213,365.90217208862305,4898,1152,3746,3746,0,18,1199000.0
1199,1199999,21.29605587055905,37.738681426160106,0.11348775052992621,407.2918128967285,84.72314214706421,366.20840072631836,4899,1153,3746,3746,0,18,1200000.0
1200,1200999,21.2939997395707,37.739132443318134,0.1134184722826509,407.7168848514557,84.79343438148499,366.2055549621582,4901,1154,3747,3747,0,18,1201000.0
1201,1201999,21.291598862350344,37.74591780630613,0.11335824709529518,408.09375,84.86284399032593,366.403018951416,4908,1155,3753,3753,0,18,1202000.0
1202,1202999,21.28940243993682,37.742397997944174,0.11333360504676326,408.54625248908997,84.93164324760437,366.19550704956055,4910,1156,3754,3754,0,18,1203000.0
1203,1203999,21.28535174566753,37.73412517024695,0.11335468066176568,408.90328645706177,85.00090599060059,366.4695930480957,4910,1156,3754,3754,0,18,1204000.0
1204,1204999,21.28152045245994,37.729569398491066,0.11335813859379062,409.32414960861206,85.07280087471008,366.55530166625977,4910,1156,3754,3754,0,18,1205000.0
1205,1205999,21.277984932038628,37.722945530910565,0.11336169727177858,409.82849287986755,85.14252877235413,366.09072494506836,4912,1157,3755,3755,0,18,1206000.0
1206,1206999,21.27309968776654,37.714390108033506,0.11336637029559371,410.21934366226196,85.21185350418091,366.1797218322754,4912,1157,3755,3755,0,18,1207000.0
1207,1207999,21.267824428389464,37.70408746521558,0.11338390323034808,410.5052523612976,85.2823498249054,366.6050834655762,4914,1158,3756,3756,0,18,1208000.0
1208,1208999,21.26380110372717,37.69534423522063,0.11337317837517913,410.79206466674805,85.3500964641571,366.99975967407227,4916,1159,3757,3757,0,18,1209000.0
1209,1209999,21.258819814392066,37.685564181710554,0.11337702618987588,411.05000925064087,85.41751146316528,367.5543327331543,4916,1159,3757,3757,0,18,1210000.0
1210,1210999,21.254572404590384,37.67746623587442,0.11335580656633559,411.40777945518494,85.48637056350708,367.544132232666,4916,1159,3757,3757,0,18,1211000.0
1211,1211999,21.25057938162519,37.670458803847765,0.11333616865137208,411.90533995628357,85.55504274368286,366.92846298217773,4918,1160,3758,3758,0,18,1212000.0
1212,1212999,21.24766368217609,37.66506944686107,0.11331555659848169,412.1987884044647,85.62246537208557,367.3971290588379,4918,1160,3758,3758,0,18,1213000.0
1213,1213999,21.244982397773512,37.66083549667145,0.1132945790763461,412.6229326725006,85.69123315811157,367.12883377075195,4920,1161,3759,3759,0,18,1214000.0
1214,1214999,21.242998263683837,37.65650889535904,0.11326493497940915,413.04867935180664,85.75980544090271,366.8947334289551,4922,1162,3760,3760,0,18,1215000.0
1215,1215999,21.240994638297707,37.65080876109306,0.11325376557706346,413.3647520542145,85.82986450195312,367.17702865600586,4922,1162,3760,3760,0,18,1216000.0
1216,1216999,21.239896288610687,37.647349084144004,0.11322864640466157,413.84413623809814,85.8992612361908,366.68869400024414,4923,1163,3760,3760,0,18,1217000.0
1217,1217999,21.237833960439588,37.641795030751666,0.11320943818244689,414.29443883895874,85.96983504295349,366.41942977905273,4927,1165,3762,3762,0,18,1218000.0
1218,1218999,21.236650885732292,37.63670402556744,0.11317860430870208,414.6080868244171,86.03956508636475,366.7960395812988,4927,1165,3762,3762,0,18,1219000.0
1219,1219999,21.234910517717378,37.6314210503619,0.11316672646823955,414.9071054458618,86.10846948623657,367.2194633483887,4927,1165,3762,3762,0,18,1220000.0
1220,1220999,21.23428679181597,37.63003722590743,0.11307585768910344,415.29912304878235,86.17927527427673,367.3639030456543,4927,1165,3762,3762,0,18,1221000.0
1221,1221999,21.232359141063803,37.62398758445567,0.11299539997311214,417.5190713405609,86.24959015846252,367.2917289733887,4927,1165,3762,3762,0,18,1222000.0
1222,1222999,21.230299400531585,37.61896983360163,0.11292545121896358,417.91893887519836,86.31815934181213,367.20907974243164,4933,1168,3765,3765,0,18,1223000.0
1223,1223999,21.226780647791077,37.61001339639952,0.11290391227140906,418.2265303134918,86.38633298873901,367.54873275756836,4935,1169,3766,3766,0,18,1224000.0
1224,1224999,21.222413922381115,37.601552778315394,0.1128848222748211,418.60922956466675,86.458087682724,367.6741523742676,4935,1169,3766,3766,0,18,1225000.0
1225,1225999,21.218216917692043,37.592195435605696,0.11287427878525291,418.91990399360657,86.52823066711426,368.04831314086914,4935,1169,3766,3766,0,18,1226000.0
1226,1226999,21.214957677656503,37.58500848015469,0.11286448575807895,419.3691110610962,86.59753274917603,367.884578704834,4935,1169,3766,3766,0,18,1227000.0
1227,1227999,21.210478454115712,37.57552770625639,0.1128653938114692,419.6540665626526,86.667156457901,368.18298721313477,4937,1170,3767,3767,0,18,1228000.0
1228,1228999,21.206770535112256,37.570695412373645,0.11284516911700349,420.17311787605286,86.73827838897705,367.514102935791,4941,1172,3769,3769,0,18,1229000.0
1229,1229999,21.202357642412903,37.56139552090998,0.11286254241888438,420.4173858165741,86.80686974525452,368.041690826416,4943,1173,3770,3770,0,18,1230000.0
1230,1230999,21.20060934874921,37.55805115116987,0.1128653792420149,420.954304933548,86.87710404396057,367.5358772277832,4943,1173,3770,3770,0,18,1231000.0
1231,1231999,21.198169227008016,37.55446707809923,0.11291638130966453,421.2847867012024,86.94742321968079,367.90588760375977,4943,1173,3770,3770,0,18,1232000.0
1232,1232999,21.195356760682696,37.54866093762936,0.11294523788811561,421.6222152709961,87.01795148849487,367.9387321472168,4944,1174,3770,3770,0,18,1233000.0
1233,1233999,21.192861622256824,37.54453802497277,0.11295160287862327,421.990793466568,87.08847284317017,367.9430732727051,4948,1176,3772,3772,0,18,1234000.0
1234,1234999,21.19160966719147,37.54282154127311,0.11295207914597605,422.2820153236389,87.16115736961365,368.2073783874512,4949,1177,3772,3772,0,18,1235000.0
1235,1235999,21.191980166356583,37.543490108168996,0.11296824962954266,422.7046504020691,87.23241114616394,367.98637771606445,4951,1178,3773,3773,0,18,1236000.0
1236,1236999,21.191435635568492,37.54096483489645,0.11299136588668712,423.0878314971924,87.30313396453857,368.0392036437988,4953,1179,3774,3774,0,18,1237000.0
1237,1237999,21.190816492701067,37.538068759552615,0.11299484100127977,423.42611956596375,87.37479615211487,368.289005279541,4955,1180,3775,3775,0,18,1238000.0
1238,1238999,21.191111066435298,37.536408813077884,0.11302562428037399,423.7215664386749,87.4441339969635,368.7214012145996,4955,1180,3775,3775,0,18,1239000.0
1239,1239999,21.19090819239596,37.53377168944447,0.11301864273850315,424.06856656074524,87.51381206512451,368.97268295288086,4955,1180,3775,3775,0,18,1240000.0
1240,1240999,21.190545154348403,37.537432083372465,0.11297061447601198,424.69412088394165,87.58532953262329,367.8421974182129,4957,1181,3776,3776,0,18,1241000.0
1241,1241999,21.194266247857097,37.54353257079511,0.11231376324768172,424.99851298332214,87.65362048149109,368.62529373168945,4958,1181,3777,3777,0,18,1242000.0
1242,1242999,21.195473790171416,37.54297788961696,0.1119720964506189,425.40802907943726,87.7202525138855,368.78734970092773,4958,1181,3777,3777,0,18,1243000.0
1243,1243999,21.195773646548744,37.54082154771236,0.11165054603001323,425.70410108566284,87.78784990310669,369.33908462524414,4958,1181,3777,3777,0,18,1244000.0
1244,1244999,21.19775058430604,37.541126744612754,0.11125676025665687,425.94604873657227,87.85520148277283,370.22643661499023,4958,1181,3777,3777,0,18,1245000.0
1245,1245999,21.197437904741616,37.53602273796964,0.11105963347345726,426.19775223731995,87.92183256149292,370.6730842590332,4960,1182,3778,3778,0,18,1246000.0
1246,1246999,21.196950506954366,37.532616294548966,0.11081820981259571,426.63492608070374,87.98853373527527,370.2474479675293,4964,1184,3780,3780,0,18,1247000.0
1247,1247999,21.196356614225124,37.528124280643624,0.11065078175276144,426.9607779979706,88.05697274208069,370.7250328063965,4964,1184,3780,3780,0,18,1248000.0
1248,1248999,21.1963406688807,37.52470590370165,0.11043854998159297,427.3962097167969,88.12387347221375,370.498477935791,4966,1185,3781,3781,0,18,1249000.0
1249,1249999,21.194883925522017,37.519479012532216,0.11030015718452768,427.6773612499237,88.19303297996521,370.8204917907715,4970,1187,3783,3783,0,18,1250000.0
1250,1250999,21.19441496949621,37.51810245121102,0.11013364412244908,428.10238766670227,88.26064133644104,370.6263847351074,4970,1187,3783,3783,0,18,1251000.0
1251,1251999,21.19494282670184,37.51472306350115,0.10996952015420547,428.4134986400604,88.32933640480042,371.093692779541,4970,1187,3783,3783,0,18,1252000.0
1252,1252999,21.194393799874323,37.51098089374139,0.10986876741971563,428.7259187698364,88.39742136001587,371.2443733215332,4974,1189,3785,3785,0,18,1253000.0
1253,1253999,21.193493158234883,37.50752643834535,0.10978046134208219,429.2020421028137,88.46678566932678,370.794620513916,4976,1190,3786,3786,0,18,1254000.0
1254,1254999,21.19241972664078,37.50304900885983,0.10970611232332828,429.72105169296265,88.53444719314575,370.28869247436523,4978,1191,3787,3787,0,18,1255000.0
1255,1255999,21.19252313943939,37.50038074717251,0.10964259393003639,430.0146403312683,88.60290241241455,370.81332778930664,4978,1191,3787,3787,0,18,1256000.0
1256,1256999,21.192989568771747,37.510663040120804,0.10950250243881898,430.32298254966736,88.6708116531372,371.17568588256836,4978,1191,3787,3787,0,18,1257000.0
1257,1257999,21.192882958933676,37.50788618119656,0.1094194454390861,430.56479573249817,88.739586353302,371.7454032897949,4980,1192,3788,3788,0,18,1258000.0
1258,1258999,21.192600342765555,37.504550834463515,0.10937153608897432,431.06261110305786,88.80757474899292,371.03158950805664,4986,1195,3791,3791,0,18,1259000.0
1259,1259999,21.192198341639415,37.5007822302247,0.10932213266371671,431.3213996887207,88.87771534919739,371.6646308898926,4986,1195,3791,3791,0,18,1260000.0
1260,1260999,21.190392861381877,37.495380531720606,0.10931470370120722,431.7145712375641,88.94513249397278,371.6387062072754,4988,1196,3792,3792,0,18,1261000.0
1261,1261999,21.18787889407703,37.488667165520695,0.10931758394353419,432.1122989654541,89.01195788383484,371.81794357299805,4988,1196,3792,3792,0,18,1262000.0
1262,1262999,21.185843346840393,37.4825289959087,0.10927928827599864,432.46012783050537,89.08052253723145,372.0948600769043,4988,1196,3792,3792,0,18,1263000.0
1263,1263999,21.184249699167168,37.47665956340987,0.10924620621765335,432.8090407848358,89.15132856369019,372.132511138916,4991,1198,3793,3793,0,18,1264000.0
1264,1264999,21.18312524778199,37.47146533646687,0.10921504766600554,433.1149652004242,89.22140502929688,372.7295951843262,5009,1201,3808,3808,0,18,1265000.0
1265,1265999,21.18434266336294,37.47161210235312,0.10918389981734522,433.3075907230377,89.29033136367798,373.8510398864746,5009,1201,3808,3808,0,18,1266000.0
1266,1266999,21.18742740632165,37.47373349763106,0.1091683584436276,433.59517550468445,89.36042284965515,374.3781318664551,5012,1202,3810,3810,0,18,1267000.0
1267,1267999,21.190406556118766,37.47598260016689,0.10912566148254133,433.9294738769531,89.43019437789917,374.60566329956055,5014,1203,3811,3811,0,18,1268000.0
1268,1268999,21.193346893792675,37.478337914724705,0.10908946972562916,434.3228359222412,89.4997169971466,374.661434173584,5015,1203,3812,3812,0,18,1269000.0
1269,1269999,21.196758264396514,37.48145247706027,0.10903932514170378,434.61717438697815,89.56909441947937,374.96261978149414,5017,1204,3813,3813,0,18,1270000.0
1270,1270999,21.19996623271946,37.48446123875854,0.10900015443776934,435.0087881088257,89.64057064056396,374.88650131225586,5023,1207,3816,3816,0,18,1271000.0
1271,1271999,21.20431892931553,37.4891971520585,0.10894971010651544,435.3125603199005,89.70976567268372,375.3103828430176,5023,1207,3816,3816,0,18,1272000.0
1272,1272999,21.208080900055457,37.49370627861482,0.10894348358576422,435.61755752563477,89.77946209907532,375.748836517334,5023,1207,3816,3816,0,18,1273000.0
1273,1273999,21.21097027111978,37.49415240313134,0.10898732647541287,436.07761788368225,89.85002708435059,375.31618881225586,5029,1210,3819,3819,0,18,1274000.0
1274,1274999,21.214307980844517,37.496072318475136,0.10898240717297392,436.4883954524994,89.92052555084229,375.1041374206543,5033,1212,3821,3821,0,18,1275000.0
1275,1275999,21.217852172644413,37.49846256809741,0.10901077281059668,436.8318154811859,89.99396967887878,375.47021102905273,5033,1212,3821,3821,0,18,1276000.0
1276,1276999,21.22129454370334,37.50080716887677,0.10905130508216443,437.1179223060608,90.06408715248108,375.8600959777832,5035,1213,3822,3822,0,18,1277000.0
1277,1277999,21.225448098974443,37.508703862555485,0.10904060221604117,437.51988673210144,90.13597202301025,375.89172744750977,5035,1213,3822,3822,0,18,1278000.0
1278,1278999,21.22950890909253,37.5164170713709,0.10902187628914461,437.8574712276459,90.20727920532227,376.13903427124023,5035,1213,3822,3822,0,18,1279000.0
1279,1279999,21.232805639065482,37.518132866935495,0.10903074230381693,438.2367763519287,90.27798414230347,376.2113456726074,5035,1213,3822,3822,0,18,1280000.0
1280,1280999,21.236462545633646,37.520415296282735,0.10901332950730391,438.61702847480774,90.34874749183655,376.2852668762207,5038,1214,3824,3824,0,18,1281000.0
1281,1281999,21.237482835081444,37.51841066525226,0.10900304889163559,439.014466047287,90.41869378089905,376.307674407959,5038,1214,3824,3824,0,18,1282000.0
1282,1282999,21.237688107661675,37.514485109262,0.10887768238206508,439.50175285339355,90.48796105384827,376.0058937072754,5041,1215,3826,3826,0,18,1283000.0
1283,1283999,21.236329372717496,37.511065474906715,0.10869239993646396,439.94914054870605,90.56012105941772,375.90954208374023,5043,1216,3827,3827,0,18,1284000.0
1284,1284999,21.233062877201913,37.505268495497866,0.10859374099016172,440.1943485736847,90.6295440196991,376.65160751342773,5043,1216,3827,3827,0,18,1285000.0
1285,1285999,21.23090567301193,37.50364401043019,0.10851109301809314,440.56382632255554,90.7030291557312,376.4494514465332,5051,1220,3831,3831,0,18,1286000.0
1286,1286999,21.227338054861757,37.49468921726786,0.10847892193233855,440.8598222732544,90.77339959144592,376.7811851501465,5084,1222,3862,3862,0,18,1287000.0
1287,1287999,21.22235534239019,37.484599516534196,0.1084969567473637,441.3214931488037,90.84486627578735,376.33346939086914,5118,1224,3894,3894,0,18,1288000.0
1288,1288999,21.21829501376093,37.47619878766703,0.10847631385751277,441.6969735622406,90.91621661186218,376.1811943054199,5124,1227,3897,3897,0,18,1289000.0
1289,1289999,21.21432687486255,37.47462573632231,0.10842161325649102,442.1420726776123,90.98772716522217,375.9878273010254,5128,1229,3899,3899,0,18,1290000.0
1290,1290999,21.209731553617143,37.466549482589805,0.10840596033448113,442.5322787761688,91.06028366088867,376.0830192565918,5130,1230,3900,3900,0,18,1291000.0
1291,1291999,21.20530947202775,37.46052728057459,0.10840727430427788,442.7794542312622,91.13188362121582,376.7273368835449,5132,1231,3901,3901,0,18,1292000.0
1292,1292999,21.202086513133466,37.45946348532881,0.1083759750496982,443.09514808654785,91.20440363883972,377.06855392456055,5132,1231,3901,3901,0,18,1293000.0
1293,1293999,21.19809755611759,37.452187486529084,0.10836549192316436,443.5249328613281,91.27623963356018,376.55315017700195,5138,1234,3904,3904,0,18,1294000.0
1294,1294999,21.19368140316131,37.44515852461353,0.10838280625060415,443.9097602367401,91.34859871864319,376.71047592163086,5138,1234,3904,3904,0,18,1295000.0
1295,1295999,21.190373449072034,37.44085421477367,0.1083790454365352,444.2947506904602,91.4207694530487,376.7759208679199,5138,1234,3904,3904,0,18,1296000.0
1296,1296999,21.18664830586104,37.434445943,0.10838468318821759,444.5561728477478,91.49125099182129,377.4026985168457,5138,1234,3904,3904,0,18,1297000.0
1297,1297999,21.184075282319114,37.42956376461278,0.1084005980455045,445.0838794708252,91.56344175338745,376.91809463500977,5138,1234,3904,3904,0,18,1298000.0
1298,1298999,21.181363126769078,37.4235289170943,0.10840481415863512,445.33568692207336,91.63544821739197,377.596736907959,5138,1234,3904,3904,0,18,1299000.0
1299,1299999,21.179528656305763,37.41949899674557,0.1083783016385802,445.6036238670349,91.70625257492065,378.04680252075195,5138,1234,3904,3904,0,18,1300000.0
1300,1300999,21.17652946629738,37.41398007000767,0.10836142094733636,446.1525456905365,91.77959394454956,377.1723747253418,5142,1236,3906,3906,0,18,1301000.0
1301,1301999,21.175349265647398,37.41102493265864,0.1083389123516647,446.55227541923523,91.8510627746582,377.24785232543945,5142,1236,3906,3906,0,18,1302000.0
1302,1302999,21.17295410129391,37.405833543425565,0.10832395906617909,447.0355734825134,91.92484974861145,376.97665786743164,5142,1236,3906,3906,0,18,1303000.0
1303,1303999,21.168737898185473,37.39743264099279,0.1083367853792695,447.3075592517853,91.99272012710571,377.65343856811523,5144,1237,3907,3907,0,18,1304000.0
1304,1304999,21.164535723922242,37.39030416338316,0.10832757566004136,447.72119545936584,92.05895829200745,377.68400955200195,5146,1238,3908,3908,0,18,1305000.0
1305,1305999,21.16065852261012,37.38618318200592,0.10829634094275298,448.15779757499695,92.12506699562073,377.5417060852051,5148,1239,3909,3909,0,18,1306000.0
1306,1306999,21.15682840243653,37.38042506633438,0.10827092248506853,448.5232973098755,92.19166111946106,377.8155174255371,5148,1239,3909,3909,0,18,1307000.0
1307,1307999,21.15292439317405,37.37275997555081,0.10822702790071093,448.9555022716522,92.25832748413086,377.6717109680176,5152,1241,3911,3911,0,18,1308000.0
1308,1308999,21.149892139568095,37.365685321557706,0.1081525202720155,451.08633184432983,92.32539749145508,378.3714714050293,5152,1241,3911,3911,0,18,1309000.0
1309,1309999,21.14741586473021,37.35782185863558,0.10809198094802253,451.2953510284424,92.3926568031311,379.0963935852051,5154,1242,3912,3912,0,18,1310000.0
1310,1310999,21.14388903227771,37.349776365788266,0.10800618062369172,451.5828413963318,92.46171045303345,379.4624824523926,5156,1243,3913,3913,0,18,1311000.0
1311,1311999,21.1406284242167,37.344354365142614,0.10794825966342325,451.9099133014679,92.52948641777039,379.57021713256836,5160,1245,3915,3915,0,18,1312000.0
1312,1312999,21.136965001237346,37.33900033955054,0.10788602502959921,452.33107328414917,92.59701180458069,379.3176460266113,5164,1247,3917,3917,0,18,1313000.0
1313,1313999,21.133372354945184,37.3325520511092,0.1078433837174797,452.7680284976959,92.66531562805176,379.2692985534668,5164,1247,3917,3917,0,18,1314000.0
1314,1314999,21.129682450192927,37.32476393168982,0.10780615393683246,453.1425504684448,92.7347195148468,379.3583183288574,5166,1248,3918,3918,0,18,1315000.0
1315,1315999,21.12589149739901,37.31765845133614,0.10777153717052279,453.41946244239807,92.80383205413818,379.6686134338379,5170,1250,3920,3920,0,18,1316000.0
1316,1316999,21.122050418444832,37.3101207308585,0.10772964130014118,453.9723262786865,92.87238264083862,378.860164642334,5174,1252,3922,3922,0,18,1317000.0
1317,1317999,21.119531051473675,37.30410880417635,0.10767405376198347,454.2295527458191,92.94001483917236,379.5648384094238,5174,1252,3922,3922,0,18,1318000.0
1318,1318999,21.117442636814403,37.304883797386644,0.10757878183963443,454.58352851867676,93.00808882713318,379.7197074890137,5174,1252,3922,3922,0,18,1319000.0
1319,1319999,21.116269921977015,37.300885851624244,0.10751646506517643,454.7967269420624,93.07651233673096,380.45559310913086,5174,1252,3922,3922,0,18,1320000.0
1320,1320999,21.116675615175335,37.301374948926906,0.10741316237844978,455.3191123008728,93.1451518535614,379.90742111206055,5174,1252,3922,3922,0,18,1321000.0
1321,1321999,21.116229762969514,37.2994048290088,0.10733018001221417,455.71707010269165,93.21606922149658,379.91125869750977,5174,1252,3922,3922,0,18,1322000.0
1322,1322999,21.11740588344273,37.29881027496372,0.10723644060893889,456.11633682250977,93.28563594818115,379.7337989807129,5178,1254,3924,3924,0,18,1323000.0
1323,1323999,21.116649778411688,37.29699465312057,0.1071530572093854,456.42099928855896,93.35459756851196,380.2301597595215,5178,1254,3924,3924,0,18,1324000.0
1324,1324999,21.11373454027317,37.28971154560003,0.10711903883431906,456.8178493976593,93.42337155342102,380.2677421569824,5180,1255,3925,3925,0,18,1325000.0
1325,1325999,21.110519559230415,37.291751099393224,0.10705441255177928,457.21020007133484,93.4934709072113,380.4773597717285,5182,1256,3926,3926,0,18,1326000.0
1326,1326999,21.106290888612588,37.293562453875786,0.10700588307028536,457.5852451324463,93.56369113922119,380.76171493530273,5182,1256,3926,3926,0,18,1327000.0
1327,1327999,21.1011074642871,37.28687177646455,0.10700575032151027,457.94765973091125,93.63425302505493,381.0649833679199,5182,1256,3926,3926,0,18,1328000.0
1328,1328999,21.0963226416792,37.28242399803339,0.10698741931493905,458.22366309165955,93.70274043083191,381.2537727355957,5188,1259,3929,3929,0,18,1329000.0
1329,1329999,21.09070251462924,37.2733480015731,0.10699955920057491,458.65499997138977,93.77579164505005,381.1249198913574,5191,1260,3931,3931,0,18,1330000.0
1330,1330999,21.08519342243124,37.26461179466296,0.10700859125554874,459.03081727027893,93.84712934494019,381.1563529968262,5196,1262,3934,3934,0,18,1331000.0
1331,1331999,21.07925766461614,37.25585035939267,0.10702047622166566,459.412700176239,93.91780972480774,381.2204170227051,5198,1263,3935,3935,0,18,1332000.0
1332,1332999,21.07360757044579,37.24618304284479,0.10703505363860122,459.807644367218,93.98987603187561,381.32986068725586,5198,1263,3935,3935,0,18,1333000.0
1333,1333999,21.068299122762983,37.23784176159541,0.10704127849917366,460.1841495037079,94.05962634086609,381.3730354309082,5200,1264,3936,3936,0,18,1334000.0
1334,1334999,21.064360276651154,37.232912167431685,0.10702177496923237,460.52659606933594,94.13349533081055,381.73039627075195,5200,1264,3936,3936,0,18,1335000.0
1335,1335999,21.06151896558278,37.23175888713792,0.10698299019385271,460.98756217956543,94.20472812652588,381.48698806762695,5200,1264,3936,3936,0,18,1336000.0
1336,1336999,21.05875970800304,37.22790364223362,0.10695498341800613,461.37401962280273,94.27684450149536,381.4561347961426,5202,1265,3937,3937,0,18,1337000.0
1337,1337999,21.05559277317453,37.222707190126854,0.10694875135195037,461.7479033470154,94.34984374046326,381.60805892944336,5202,1265,3937,3937,0,18,1338000.0
1338,1338999,21.05490454294143,37.222450315621515,0.10691531790655184,462.1619465351105,94.4202287197113,381.5599021911621,5202,1265,3937,3937,0,18,1339000.0
1339,1339999,21.053210824574975,37.223515770285836,0.10689174741842378,462.5146481990814,94.49173617362976,381.67187881469727,5204,1266,3938,3938,0,18,1340000.0
1340,1340999,21.050927145203158,37.22065991007347,0.10687249372832774,462.99251985549927,94.5634036064148,381.3314399719238,5206,1267,3939,3939,0,18,1341000.0
1341,1341999,21.04778003571662,37.214023475493875,0.10688224147248315,463.3312895298004,94.63271188735962,381.6560859680176,5206,1267,3939,3939,0,18,1342000.0
1342,1342999,21.04415057007894,37.20695026217942,0.10687879374547671,463.58911061286926,94.7027792930603,382.51306533813477,5206,1267,3939,3939,0,18,1343000.0
1343,1343999,21.0396778859776,37.20036082572304,0.10689562557898036,463.9058141708374,94.76987671852112,382.95043563842773,5208,1268,3940,3940,0,18,1344000.0
1344,1344999,21.035251491220638,37.19283528868093,0.10691266152495815,464.3031373023987,94.83730244636536,383.02294540405273,5210,1269,3941,3941,0,18,1345000.0
1345,1345999,21.031604730024252,37.19261620336734,0.10688902695482327,464.6711494922638,94.90595984458923,383.2488899230957,5210,1269,3941,3941,0,18,1346000.0
1346,1346999,21.02864097480542,37.18591872025914,0.10688756981016978,465.2076904773712,94.97342920303345,382.2553520202637,5216,1272,3944,3944,0,18,1347000.0
1347,1347999,21.02568122188528,37.17925596761796,0.10688180610082687,465.6179232597351,95.04126858711243,382.1336784362793,5222,1275,3947,3947,0,18,1348000.0
1348,1348999,21.022280265940275,37.17244280998548,0.10686915719335732,465.950719833374,95.1086962223053,382.46837997436523,5224,1276,3948,3948,0,18,1349000.0
1349,1349999,21.019580004868686,37.17055838170461,0.10683244509420275,466.2511250972748,95.17799878120422,382.80107498168945,5226,1277,3949,3949,0,18,1350000.0
1350,1350999,21.0179931643341,37.17127078086039,0.10676957251401797,466.4892199039459,95.24709987640381,383.44900131225586,5228,1278,3950,3950,0,18,1351000.0
1351,1351999,21.015211305580355,37.16566415663896,0.10674899699162776,466.83799719810486,95.31660437583923,383.5798683166504,5228,1278,3950,3950,0,18,1352000.0
1352,1352999,21.012014529962496,37.158738402525316,0.10672686926951025,467.119845867157,95.38455724716187,383.9915351867676,5230,1279,3951,3951,0,18,1353000.0
1353,1353999,21.009914770259645,37.15549051586413,0.10668913224775145,467.51294207572937,95.45351576805115,383.62045669555664,5236,1282,3954,3954,0,18,1354000.0
1354,1354999,21.00843919031255,37.162975321797326,0.10659673422248317,467.865109205246,95.52148962020874,383.9167289733887,5236,1282,3954,3954,0,18,1355000.0
1355,1355999,21.007202832163223,37.15874096159913,0.10656899813278364,468.330584526062,95.58969306945801,383.58251571655273,5236,1282,3954,3954,0,18,1356000.0
1356,1356999,21.005608617531795,37.154497028917525,0.10654868217602198,468.66596245765686,95.65808415412903,383.7108573913574,5239,1283,3956,3956,0,18,1357000.0
1357,1357999,21.006216311955054,37.16189722584395,0.10646968033263782,469.1075165271759,95.7302234172821,383.5521659851074,5239,1283,3956,3956,0,18,1358000.0
1358,1358999,21.005601265263,37.159240043803216,0.10643004716940019,469.40508699417114,95.79975318908691,383.9392280578613,5239,1283,3956,3956,0,18,1359000.0
1359,1359999,21.005246205953124,37.15670181367817,0.10638603567447902,469.75093936920166,95.86801147460938,384.1170539855957,5239,1283,3956,3956,0,18,1360000.0
1360,1360999,21.0044779071908,37.15284989308177,0.10635530834434637,470.1680257320404,95.93672585487366,383.9993553161621,5241,1284,3957,3957,0,18,1361000.0
1361,1361999,21.002768297420612,37.147191710253466,0.10633459099727627,470.5724210739136,96.0078980922699,383.907039642334,5243,1285,3958,3958,0,18,1362000.0
1362,1362999,21.005307574185192,37.14879718528215,0.10611862546563144,470.9121296405792,96.07584071159363,384.27067947387695,5245,1286,3959,3959,0,18,1363000.0
1363,1363999,21.006857300941732,37.147824886876066,0.10592248196475484,471.3442060947418,96.14656066894531,384.4041175842285,5245,1286,3959,3959,0,18,1364000.0
1364,1364999,21.008562174963725,37.14973014453923,0.1057599475661255,471.7424554824829,96.21467089653015,384.4304084777832,5247,1287,3960,3960,0,18,1365000.0
1365,1365999,21.009576051244608,37.14889548496446,0.10564983835090624,472.1684582233429,96.28510046005249,384.04653549194336,5255,1291,3964,3964,0,18,1366000.0
1366,1366999,21.009860332050955,37.146938306310474,0.10557925705425697,472.59319496154785,96.35412263870239,383.87424087524414,5259,1293,3966,3966,0,18,1367000.0
1367,1367999,21.01199963085386,37.149287532157885,0.10552342198206333,472.8668460845947,96.42432188987732,384.5730628967285,5259,1293,3966,3966,0,18,1368000.0
1368,1368999,21.012291219679557,37.14806411037332,0.10546140661099845,473.1315610408783,96.4945216178894,385.163516998291,5259,1293,3966,3966,0,18,1369000.0
1369,1369999,21.013186580226847,37.14768805823281,0.10544197434135105,473.50807881355286,96.56343364715576,385.1012382507324,5261,1294,3967,3967,0,18,1370000.0
1370,1370999,21.012951431878097,37.14448200226697,0.10544789903610419,473.9292109012604,96.63263034820557,385.06055068969727,5263,1295,3968,3968,0,18,1371000.0
1371,1371999,21.012616689566265,37.14014239377469,0.1054373050147075,474.31001806259155,96.7086923122406,385.31020736694336,5263,1295,3968,3968,0,18,1372000.0
1372,1372999,21.01276228253689,37.13855746695796,0.1054371505582461,474.631325006485,96.77767372131348,385.5867500305176,5265,1296,3969,3969,0,18,1373000.0
1373,1373999,21.012996202897472,37.136103645355234,0.10536449296542116,475.06315755844116,96.848135471344,385.344051361084,5267,1297,3970,3970,0,18,1374000.0
1374,1374999,21.013266711621345,37.13499603530995,0.10534438255628398,475.3593282699585,96.91764259338379,385.79687881469727,5270,1298,3972,3972,0,18,1375000.0
1375,1375999,21.012209183898836,37.129371347937266,0.10529842188908389,475.80451011657715,96.98852825164795,385.4938316345215,5275,1300,3975,3975,0,18,1376000.0
1376,1376999,21.0111467566443,37.125328609976,0.10527705214069416,476.1614181995392,97.05816268920898,385.6125068664551,5277,1301,3976,3976,0,18,1377000.0
1377,1377999,21.010008273056737,37.12107311537028,0.10530183323060682,476.5879395008087,97.13174486160278,385.5332450866699,5279,1302,3977,3977,0,18,1378000.0
1378,1378999,21.00994050697899,37.119912222776115,0.10527241884721372,476.90461254119873,97.20234513282776,385.8489646911621,5279,1302,3977,3977,0,18,1379000.0
1379,1379999,21.00941978894751,37.115190503577075,0.10524077784278241,477.29956316947937,97.2736587524414,385.8280830383301,5279,1302,3977,3977,0,18,1380000.0
1380,1380999,21.008648394965796,37.109997562663885,0.10524794349498834,477.640869140625,97.34516477584839,385.91867446899414,5281,1303,3978,3978,0,18,1381000.0
1381,1381999,21.00672144166121,37.103067947191555,0.10523083421510171,478.0818591117859,97.41460752487183,385.6506690979004,5283,1304,3979,3979,0,18,1382000.0
1382,1382999,21.004249601779588,37.095916131026755,0.10520579965515087,478.5197901725769,97.48466277122498,385.53635025024414,5285,1305,3980,3980,0,18,1383000.0
1383,1383999,21.00519371301448,37.0964333704965,0.10491538376266085,478.77637791633606,97.55341124534607,386.2903175354004,5287,1306,3981,3981,0,18,1384000.0
1384,1384999,21.009427330042715,37.098284355921,0.10444483854680331,479.0678436756134,97.62261962890625,386.9030342102051,5289,1307,3982,3982,0,18,1385000.0
1385,1385999,21.012223223810498,37.09913538049179,0.10408219454814904,479.36825585365295,97.69104862213135,387.538516998291,5289,1307,3982,3982,0,18,1386000.0
1386,1386999,21.01616627823238,37.10223634425071,0.10367704785413934,479.8198790550232,97.75826501846313,387.4182243347168,5291,1308,3983,3983,0,18,1387000.0
1387,1387999,21.01764121213614,37.099355073113095,0.1034080525443104,480.10031962394714,97.83110785484314,387.92517471313477,5295,1310,3985,3985,0,18,1388000.0
1388,1388999,21.019306557759887,37.09684162939495,0.10319930391518817,480.3200030326843,97.89715671539307,388.7054252624512,5295,1310,3985,3985,0,18,1389000.0
1389,1389999,21.01983637206699,37.09348092206235,0.10296080361808624,480.7865903377533,97.96478486061096,388.37665939331055,5297,1311,3986,3986,0,18,1390000.0
1390,1390999,21.01938355588896,37.087979727976126,0.10283401408432202,481.1649866104126,98.03177547454834,388.3151512145996,5335,1315,4020,4020,0,18,1391000.0
1391,1391999,21.01888911221771,37.08360496765523,0.10270778735173025,481.4777443408966,98.09897184371948,388.29785537719727,5343,1319,4024,4024,0,18,1392000.0
1392,1392999,21.017568103993835,37.07788059874049,0.10261231640999646,481.866361618042,98.16638278961182,388.37446212768555,5345,1320,4025,4025,0,18,1393000.0
1393,1393999,21.016624550080618,37.073441753773814,0.10249582603029583,482.1566994190216,98.23452138900757,388.79784774780273,5347,1321,4026,4026,0,18,1394000.0
1394,1394999,21.016708747066733,37.072338855767754,0.10236768458281686,482.63999676704407,98.30213236808777,388.2942924499512,5352,1323,4029,4029,0,18,1395000.0
1395,1395999,21.018091441742595,37.076804608849514,0.10223891533999507,484.83417105674744,98.36930871009827,388.81911849975586,5352,1323,4029,4029,0,18,1396000.0
1396,1396999,21.02176708409179,37.087121624831795,0.10206721310172062,485.1471948623657,98.4385278224945,389.0363883972168,5358,1326,4032,4032,0,18,1397000.0
1397,1397999,21.026161111239958,37.098642227550386,0.10191858848702928,485.51473212242126,98.50866103172302,389.24655532836914,5358,1326,4032,4032,0,18,1398000.0
1398,1398999,21.031082997705745,37.110455034923774,0.10177064749164633,485.990430355072,98.57967281341553,388.9907875061035,5358,1326,4032,4032,0,18,1399000.0
1399,1399999,21.034921226469393,37.11480568709623,0.1016901294072785,486.4248912334442,98.65125560760498,388.88137435913086,5363,1328,4035,4035,0,18,1400000.0
1400,1400999,21.040707100911717,37.12609752763941,0.10157273314104587,486.7091248035431,98.7183530330658,389.4460258483887,5376,1329,4047,4047,0,18,1401000.0
1401,1401999,21.04350369115,37.129424750228345,0.10148025985720455,487.1103219985962,98.78756213188171,389.2546577453613,5380,1331,4049,4049,0,18,1402000.0
1402,1402999,21.047077137125157,37.13330717505516,0.10140747241105974,487.4756588935852,98.85712194442749,389.43339920043945,5380,1331,4049,4049,0,18,1403000.0
1403,1403999,21.049266629289637,37.13743626409722,0.10133326011327193,487.80434107780457,98.92433047294617,389.7416648864746,5382,1332,4050,4050,0,18,1404000.0
1404,1404999,21.056450504893306,37.14426343067488,0.10063989401083084,488.14511609077454,98.99227809906006,390.1831932067871,5383,1332,4051,4051,0,18,1405000.0
1405,1405999,21.064847195522805,37.14904596340348,0.10001402860787545,488.4482595920563,99.06296277046204,390.56460189819336,5385,1333,4052,4052,0,18,1406000.0
1406,1406999,21.07252687515122,37.15369797511095,0.0993770214647548,488.8563678264618,99.13153505325317,390.276309967041,5391,1336,4055,4055,0,18,1407000.0
1407,1407999,21.076285506532283,37.15549117931963,0.09893859159677132,489.3788595199585,99.19989013671875,389.4883155822754,5400,1340,4060,4060,0,18,1408000.0
1408,1408999,21.075144663426318,37.150016240194304,0.09881222685714641,489.6578948497772,99.27049207687378,389.9685401916504,5402,1341,4061,4061,0,18,1409000.0
1409,1409999,21.07447310045283,37.146161734840696,0.09864319846888803,489.9883334636688,99.34057879447937,390.09579849243164,5406,1343,4063,4063,0,18,1410000.0
1410,1410999,21.071993520960728,37.139850896777325,0.09854393135363593,490.3518226146698,99.41021776199341,390.1285820007324,5410,1345,4065,4065,0,18,1411000.0
1411,1411999,21.06969976740393,37.13473026005329,0.09846162482995124,490.7687315940857,99.4810962677002,389.9604682922363,5415,1347,4068,4068,0,18,1412000.0
1412,1412999,21.06816114079214,37.131950060060795,0.09834086479645299,491.11270332336426,99.55156302452087,390.08940505981445,5417,1348,4069,4069,0,18,1413000.0
1413,1413999,21.065790631342665,37.12868187291825,0.09828025785432781,491.4946138858795,99.62035799026489,390.0876045227051,5419,1349,4070,4070,0,18,1414000.0
1414,1414999,21.0672370848834,37.13949095910457,0.098160467599814,491.91513657569885,99.68914747238159,389.90070724487305,5421,1350,4071,4071,0,18,1415000.0
1415,1415999,21.068699928678956,37.155082412792005,0.09802993970657481,492.22954964637756,99.75984454154968,390.1354179382324,5427,1353,4074,4074,0,18,1416000.0
1416,1416999,21.069540387089937,37.15894554851707,0.09799513740497512,492.5572159290314,99.82951521873474,390.4748420715332,5427,1353,4074,4074,0,18,1417000.0
1417,1417999,21.07251754650516,37.17050619503673,0.0979353359249523,492.84836864471436,99.89961767196655,390.9760398864746,5427,1353,4074,4074,0,18,1418000.0
1418,1418999,21.075413434590473,37.18151908241691,0.09785693279448782,493.28610372543335,99.96956968307495,390.74425888061523,5427,1353,4074,4074,0,18,1419000.0
1419,1419999,21.07737040957388,37.18633234913317,0.09779793062961273,493.79059410095215,100.04106020927429,390.40063858032227,5427,1353,4074,4074,0,18,1420000.0
1420,1420999,21.08316435176772,37.204527688299855,0.09773995879207087,494.07517170906067,100.11076927185059,390.8634223937988,5427,1353,4074,4074,0,18,1421000.0
1421,1421999,21.08836738024198,37.214483670033715,0.09772498086915404,494.44264101982117,100.18014335632324,391.039737701416,5429,1354,4075,4075,0,18,1422000.0
1422,1422999,21.093253553793776,37.22233161970264,0.09771985329263366,494.78558707237244,100.24904179573059,391.1731834411621,5431,1355,4076,4076,0,18,1423000.0
1423,1423999,21.099323756456624,37.232780425847885,0.09764649191217645,495.1745204925537,100.31865692138672,390.8979377746582,5436,1357,4079,4079,0,18,1424000.0
1424,1424999,21.100207293735107,37.23215167876277,0.09760833164680982,495.5822911262512,100.40171980857849,391.0226631164551,5436,1357,4079,4079,0,18,1425000.0
1425,1425999,21.11403310340524,37.26200726176411,0.09618348218659478,495.9443154335022,100.47303318977356,391.2060127258301,5442,1360,4082,4082,0,18,1426000.0
1426,1426999,21.12293644540915,37.277987874071016,0.09529102807367895,496.2322850227356,100.54235005378723,391.8102684020996,5446,1362,4084,4084,0,18,1427000.0
1427,1427999,21.13142149661021,37.292145742903415,0.09434216908590876,496.57791352272034,100.61435842514038,391.91504287719727,5451,1364,4087,4087,0,18,1428000.0
1428,1428999,21.139388690899512,37.3089826932637,0.09336081004440355,496.9066905975342,100.68403005599976,392.1227607727051,5458,1367,4091,4091,0,18,1429000.0
1429,1429999,21.144041220937904,37.315431450006834,0.0928393826311541,497.18466424942017,100.75498604774475,392.6618766784668,5460,1368,4092,4092,0,18,1430000.0
1430,1430999,21.148693348486567,37.32265309141595,0.09220030853290828,497.5347294807434,100.82712650299072,392.93464279174805,5460,1368,4092,4092,0,18,1431000.0
1431,1431999,21.15166961315791,37.32454852931824,0.09187096209575485,497.87336683273315,100.89779615402222,392.95046615600586,5464,1370,4094,4094,0,18,1432000.0
1432,1432999,21.15439160030151,37.330365299813735,0.0913409013518498,498.4246301651001,100.96934390068054,392.2098045349121,5472,1374,4098,4098,0,18,1433000.0
1433,1433999,21.154789516991784,37.32837488363295,0.09117978244419223,498.66456055641174,101.04159188270569,392.94421005249023,5478,1375,4103,4103,0,18,1434000.0
1434,1434999,21.15567162118385,37.32729026049525,0.09100195992692717,499.17954182624817,101.1140820980072,392.2467155456543,5482,1377,4105,4105,0,18,1435000.0
1435,1435999,21.156308998169912,37.32667393838962,0.09079813253349955,499.42267417907715,101.18800830841064,392.8302803039551,5486,1379,4107,4107,0,18,1436000.0
1436,1436999,21.156664768260917,37.3259630130529,0.09068896154723538,499.87602972984314,101.25995016098022,392.38054275512695,5493,1382,4111,4111,0,18,1437000.0
1437,1437999,21.157455447909207,37.32577198786527,0.09050689292253877,500.26973366737366,101.33242893218994,392.49709701538086,5493,1382,4111,4111,0,18,1438000.0
1438,1438999,21.158473611516047,37.326396640554464,0.09041286426044415,500.6109335422516,101.40513205528259,392.68712997436523,5495,1383,4112,4112,0,18,1439000.0
1439,1439999,21.160601974731037,37.32704675595094,0.09031222693559726,500.9895327091217,101.47940158843994,392.8396110534668,5495,1383,4112,4112,0,18,1440000.0
1440,1440999,21.162814841413464,37.32986386603396,0.09024753526147533,501.29716658592224,101.55211019515991,393.19826889038086,5495,1383,4112,4112,0,18,1441000.0
1441,1441999,21.16547564823078,37.33233599522392,0.0902349876724644,501.74179458618164,101.62717747688293,392.90146255493164,5499,1385,4114,4114,0,18,1442000.0
1442,1442999,21.167155158337266,37.3330608168696,0.09015739174518012,502.0051646232605,101.70018029212952,393.4848747253418,5499,1385,4114,4114,0,18,1443000.0
1443,1443999,21.17006676226322,37.33616891017756,0.09009067990458508,502.4586820602417,101.77351379394531,393.1414375305176,5504,1387,4117,4117,0,18,1444000.0
1444,1444999,21.17375091025026,37.34343082909096,0.09006775009741275,502.8916075229645,101.84523892402649,393.0194892883301,5506,1388,4118,4118,0,18,1445000.0
1445,1445999,21.17491988626252,37.34143135587572,0.0900544707409332,503.24111771583557,101.9179253578186,393.3336982727051,5506,1388,4118,4118,0,18,1446000.0
1446,1446999,21.17589044541851,37.34095619504964,0.08987299179260577,503.52804827690125,101.98520803451538,394.00988388061523,5506,1388,4118,4118,0,18,1447000.0
1447,1447999,21.176837624194984,37.348140381246225,0.0896458101039127,503.85049629211426,102.0505952835083,394.3074836730957,5510,1390,4120,4120,0,18,1448000.0
1448,1448999,21.176628545592234,37.34480423053865,0.08949569773587196,504.15102672576904,102.11769413948059,394.746395111084,5511,1390,4121,4121,0,18,1449000.0
1449,1449999,21.178720730074073,37.3468584015321,0.08933213369564241,504.55947184562683,102.18417119979858,394.3997611999512,5519,1394,4125,4125,0,18,1450000.0
1450,1450999,21.181359696581534,37.348307890449426,0.089176264283223,504.9715428352356,102.25310516357422,394.5182075500488,5521,1395,4126,4126,0,18,1451000.0
1451,1451999,21.183723287616168,37.350419218917445,0.08900309096803871,505.2520399093628,102.32295083999634,394.9937171936035,5523,1396,4127,4127,0,18,1452000.0
1452,1452999,21.1859279022716,37.35001431677668,0.08886207690565473,505.4980480670929,102.39194059371948,395.58317947387695,5527,1398,4129,4129,0,18,1453000.0
1453,1453999,21.186810017766103,37.36868786504859,0.08869358089190649,505.88871121406555,102.45986723899841,395.500789642334,5531,1400,4131,4131,0,18,1454000.0
1454,1454999,21.187711269495804,37.369455044687754,0.0886479482023147,506.2735347747803,102.52772521972656,395.56235122680664,5534,1401,4133,4133,0,18,1455000.0
1455,1455999,21.189127088137905,37.37009588683525,0.08855373239229414,506.5369379520416,102.59598565101624,396.1884422302246,5534,1401,4133,4133,0,18,1456000.0
1456,1456999,21.191175905190143,37.38382634839778,0.08848063658122629,506.8731701374054,102.66740441322327,396.38161849975586,5536,1402,4134,4134,0,18,1457000.0
1457,1457999,21.192894666257597,37.386362609341575,0.08839105329966002,507.22816014289856,102.73687219619751,396.40271377563477,5538,1403,4135,4135,0,18,1458000.0
1458,1458999,21.195539551561605,37.40179457937324,0.08833661912159707,507.66800928115845,102.80510520935059,396.0828666687012,5540,1404,4136,4136,0,18,1459000.0
1459,1459999,21.19968286426334,37.42337782545864,0.08830104898675983,508.0885615348816,102.87620639801025,396.1015434265137,5540,1404,4136,4136,0,18,1460000.0
1460,1460999,21.20268106040233,37.44397802992645,0.0881656204528346,508.38435220718384,102.94447064399719,396.5935401916504,5540,1404,4136,4136,0,18,1461000.0
1461,1461999,21.20589915962885,37.4499143074325,0.08804903190537494,508.7654712200165,103.01188921928406,396.6958427429199,5540,1404,4136,4136,0,18,1462000.0
1462,1462999,21.209997572679697,37.46218566472518,0.08793041636706445,509.1030173301697,103.0811357498169,396.79602432250977,5544,1406,4138,4138,0,18,1463000.0
1463,1463999,21.213367605977016,37.464293690096895,0.08781416551957721,509.5151033401489,103.1492395401001,396.92380142211914,5544,1406,4138,4138,0,18,1464000.0
1464,1464999,21.216798806426542,37.47240383845285,0.08772054847684008,509.8589940071106,103.21804237365723,397.06352615356445,5548,1408,4140,4140,0,18,1465000.0
1465,1465999,21.22217440908916,37.487861302531904,0.08755862476186482,510.14397716522217,103.2893705368042,397.8613929748535,5552,1408,4144,4144,0,18,1466000.0
1466,1466999,21.225776982771322,37.49870914396436,0.08749168711941258,510.70317125320435,103.36038327217102,397.4112129211426,5556,1408,4148,4148,0,18,1467000.0
1467,1467999,21.23273569755428,37.51849829403453,0.0873411520458709,510.9807050228119,103.43584275245667,398.13747787475586,5556,1408,4148,4148,0,18,1468000.0
1468,1468999,21.236175747209113,37.52550137975822,0.08729415164428633,511.3758680820465,103.50511479377747,398.0987663269043,5559,1409,4150,4150,0,18,1469000.0
1469,1469999,21.24093560142608,37.53386449475509,0.08725522233994931,511.946471452713,103.5759220123291,397.2642250061035,5563,1411,4152,4152,0,18,1470000.0
1470,1470999,21.24740468722566,37.54413428502485,0.08724603745352688,512.2617485523224,103.64955282211304,397.8823661804199,5563,1411,4152,4152,0,18,1471000.0
1471,1471999,21.25494909139685,37.559172616142355,0.08721356174433359,512.6185657978058,103.72583198547363,398.11440658569336,5565,1412,4153,4153,0,18,1472000.0
1472,1472999,21.26183960011502,37.58254437205086,0.08719294287646195,512.8762640953064,103.79434943199158,398.6677131652832,5565,1412,4153,4153,0,18,1473000.0
1473,1473999,21.267363525170573,37.59047128986981,0.08718345786133219,513.2719008922577,103.86490106582642,398.7878608703613,5565,1412,4153,4153,0,18,1474000.0
1474,1474999,21.274809486807772,37.60610222019052,0.08720646406845789,513.6192684173584,103.93612694740295,398.89777755737305,5566,1413,4153,4153,0,18,1475000.0
1475,1475999,21.283692782903735,37.624594498599215,0.0871711864709176,513.8923156261444,104.00717544555664,399.32878494262695,5572,1415,4157,4157,0,18,1476000.0
1476,1476999,21.292119125003808,37.63722745390117,0.08728547163035183,514.1914072036743,104.07842016220093,399.8089714050293,5572,1415,4157,4157,0,18,1477000.0
1477,1477999,21.300414368530515,37.64783418799237,0.0873038852146617,514.6182887554169,104.14865326881409,399.45217514038086,5576,1417,4159,4159,0,18,1478000.0
1478,1478999,21.30786460364778,37.666959578718554,0.08729547174767838,515.0260417461395,104.2186849117279,399.3890190124512,5576,1417,4159,4159,0,18,1479000.0
1479,1479999,21.316686531504672,37.68243383862719,0.08739091619791162,515.6150770187378,104.28963208198547,398.7045555114746,5576,1417,4159,4159,0,18,1480000.0
1480,1480999,21.31942723277633,37.685226481162225,0.08733479991956916,515.8211977481842,104.35805010795593,399.8329200744629,5576,1417,4159,4159,0,18,1481000.0
1481,1481999,21.31863262885967,37.68742509282817,0.08726764449629154,516.1859381198883,104.42736458778381,400.0501823425293,5586,1419,4167,4167,0,18,1482000.0
1482,1482999,21.3170906855968,37.686699446176064,0.08719957233498699,516.5261669158936,104.49629068374634,400.1811637878418,5591,1421,4170,4170,0,18,1483000.0
1483,1483999,21.314602378619284,37.68447071982132,0.08715465793027422,516.7882354259491,104.56346464157104,400.8056449890137,5591,1421,4170,4170,0,18,1484000.0
1484,1484999,21.31337302610892,37.68274116905,0.08710446625785317,517.1763532161713,104.63285875320435,400.75129318237305,5593,1422,4171,4171,0,18,1485000.0
1485,1485999,21.31091969381409,37.680181061931926,0.08709734291834337,517.6787974834442,104.70389556884766,400.2093391418457,5600,1424,4176,4176,0,18,1486000.0
1486,1486999,21.308299003975694,37.674288956296245,0.08707582307615935,517.9805500507355,104.77315402030945,400.6470069885254,5600,1424,4176,4176,0,18,1487000.0
1487,1487999,21.30651215805963,37.671240194357665,0.08703849746861703,520.3518719673157,104.84187865257263,400.74670028686523,5600,1424,4176,4176,0,18,1488000.0
1488,1488999,21.30660068720526,37.67290514146028,0.0870154987999906,520.6514270305634,104.90972518920898,401.1951713562012,5600,1424,4176,4176,0,18,1489000.0
1489,1489999,21.307352674205863,37.68049121595828,0.08693450365955557,520.9880294799805,104.9782931804657,401.3252983093262,5602,1425,4177,4177,0,18,1490000.0
1490,1490999,21.307820897144282,37.68304072160438,0.08687776383778811,521.42600274086,105.04689741134644,400.9972038269043,5604,1426,4178,4178,0,18,1491000.0
1491,1491999,21.30742824496827,37.68271367384158,0.08684978405717836,521.9469110965729,105.1160900592804,400.4112205505371,5606,1427,4179,4179,0,18,1492000.0
1492,1492999,21.308174602135047,37.684802468190746,0.0868252672452069,522.3434603214264,105.18606686592102,400.31193923950195,5608,1428,4180,4180,0,18,1493000.0
1493,1493999,21.309657135584306,37.68741812593618,0.08681544564121602,522.7281329631805,105.25439476966858,400.30505752563477,5610,1429,4181,4181,0,18,1494000.0
1494,1494999,21.312469431986646,37.69162028784897,0.08680899872377845,523.0112047195435,105.32373595237732,400.789852142334,5610,1429,4181,4181,0,18,1495000.0
1495,1495999,21.315227369063923,37.697250317804794,0.0868242222441662,523.4419112205505,105.39248490333557,400.5378074645996,5612,1430,4182,4182,0,18,1496000.0
1496,1496999,21.316777239746184,37.697445287118946,0.08683533597076298,523.7244646549225,105.46105575561523,401.0948143005371,5612,1430,4182,4182,0,18,1497000.0
1497,1497999,21.32092003983188,37.70778854239398,0.08681051229705061,524.1753356456757,105.52984237670898,400.658504486084,5613,1431,4182,4182,0,18,1498000.0
1498,1498999,21.325081117809095,37.7133613577566,0.08687898055089449,524.422770023346,105.59955406188965,401.3359184265137,5613,1431,4182,4182,0,18,1499000.0
1499,1499999,21.32726828064146,37.714625717744376,0.08689660661974741,524.8151936531067,105.67462348937988,401.3061637878418,5617,1433,4184,4184,0,18,1500000.0
1500,1500999,21.32812611660952,37.7230477752567,0.08685590800842502,525.1377336978912,105.7443675994873,401.8554801940918,5618,1433,4185,4185,0,18,1501000.0
1501,1501999,21.327597103143507,37.729126186560634,0.08674490513128186,525.5918855667114,105.8153464794159,401.819881439209,5620,1434,4186,4186,0,18,1502000.0
1502,1502999,21.324644496304064,37.72452410921532,0.08670927065598588,525.8584372997284,105.88469290733337,402.6619300842285,5620,1434,4186,4186,0,18,1503000.0
1503,1503999,21.32186626714381,37.718272663820876,0.08667136728128355,526.1217522621155,105.95397448539734,403.2641258239746,5621,1434,4187,4187,0,18,1504000.0
1504,1504999,21.31940242636038,37.71290357802282,0.08663311738730228,526.5805084705353,106.02405977249146,402.9817695617676,5623,1435,4188,4188,0,18,1505000.0
1505,1505999,21.317806847468873,37.71370939756608,0.08656503634602519,526.9361963272095,106.09475111961365,403.1878852844238,5656,1437,4219,4219,0,18,1506000.0
1506,1506999,21.315312144215177,37.70911339913732,0.08653046851737467,527.3244082927704,106.1658034324646,403.1374320983887,5658,1438,4220,4220,0,18,1507000.0
1507,1507999,21.31307891122985,37.70548144824841,0.08648279462085162,527.7129685878754,106.23596930503845,403.2707710266113,5658,1438,4220,4220,0,18,1508000.0
1508,1508999,21.310919153264457,37.70036036003621,0.08645393860012252,528.1300659179688,106.30892992019653,403.149715423584,5660,1439,4221,4221,0,18,1509000.0
1509,1509999,21.308693095157,37.6951604593317,0.08643225398740118,528.3456614017487,106.37793254852295,403.9547004699707,5660,1439,4221,4221,0,18,1510000.0
1510,1510999,21.306798595520615,37.68967494499636,0.08641321490785003,528.6964292526245,106.44862127304077,404.2070960998535,5687,1440,4247,4247,0,18,1511000.0
1511,1511999,21.305327425558193,37.687567820367114,0.08640489787935901,529.0863373279572,106.51997947692871,404.2573432922363,5687,1440,4247,4247,0,18,1512000.0
1512,1512999,21.30343396275025,37.68470567754744,0.08640367342571365,529.4731080532074,106.58992624282837,404.2046928405762,5689,1441,4248,4248,0,18,1513000.0
1513,1513999,21.302578330084504,37.68175471828848,0.08638463079764569,529.7803931236267,106.66317772865295,404.53551864624023,5689,1441,4248,4248,0,18,1514000.0
1514,1514999,21.30200400231301,37.68227316306339,0.08637742597497156,530.0887787342072,106.7342050075531,404.6561470031738,5693,1443,4250,4250,0,18,1515000.0
1515,1515999,21.30181002830477,37.679646543717716,0.08638245960131874,530.4813861846924,106.80614304542542,404.6295051574707,5693,1443,4250,4250,0,18,1516000.0
1516,1516999,21.301470991974302,37.6771882454027,0.08640236963775094,530.9967086315155,106.87842297554016,404.0026741027832,5697,1445,4252,4252,0,18,1517000.0
1517,1517999,21.302617788098704,37.676798650107976,0.08641401219721323,531.387481212616,106.94840884208679,404.106746673584,5697,1445,4252,4252,0,18,1518000.0
1518,1518999,21.304641976756383,37.677372160291306,0.08641807418521574,531.7016973495483,107.01769948005676,404.4679298400879,5697,1445,4252,4252,0,18,1519000.0
1519,1519999,21.30638568277835,37.6783206421074,0.0864414996339885,532.0043749809265,107.08904814720154,404.78637313842773,5697,1445,4252,4252,0,18,1520000.0
1520,1520999,21.306877346703438,37.67720955192215,0.08646718451509572,532.485818862915,107.16141676902771,404.518611907959,5697,1445,4252,4252,0,18,1521000.0
1521,1521999,21.305726280650905,37.6732471330748,0.08646962903269717,532.6973543167114,107.23020505905151,405.54753494262695,5698,1445,4253,4253,0,18,1522000.0
1522,1522999,21.30161942037041,37.676130635474,0.08643941557822599,532.8990836143494,107.29586553573608,406.4742240905762,5698,1445,4253,4253,0,18,1523000.0
1523,1523999,21.297003016558357,37.672646316407366,0.08643893031647676,533.2532413005829,107.3619499206543,406.7072563171387,5698,1445,4253,4253,0,18,1524000.0
1524,1524999,21.291238986262837,37.66425136500518,0.0864703405137297,533.6453957557678,107.43127107620239,406.6296501159668,5701,1446,4255,4255,0,18,1525000.0
1525,1525999,21.286141406314204,37.655973740678604,0.0864945722125009,534.0941038131714,107.50124454498291,406.58330154418945,5701,1446,4255,4255,0,18,1526000.0
1526,1526999,21.281730399950764,37.64941416514647,0.08650629231341134,534.4870195388794,107.56899070739746,406.701602935791,5701,1446,4255,4255,0,18,1527000.0
1527,1527999,21.277353829234276,37.64211211834149,0.0865239550323903,534.789176940918,107.63454151153564,407.0032081604004,5701,1446,4255,4255,0,18,1528000.0
1528,1528999,21.272860116283617,37.634348198334976,0.08654177392634788,535.2677719593048,107.70233225822449,406.71816635131836,5703,1447,4256,4256,0,18,1529000.0
1529,1529999,21.26879142946543,37.62731868409299,0.08655553481222655,535.6348760128021,107.76951026916504,406.76279067993164,5708,1449,4259,4259,0,18,1530000.0
1530,1530999,21.264837836283576,37.622146789486024,0.08655701868211085,535.9283854961395,107.83566045761108,407.17211532592773,5708,1449,4259,4259,0,18,1531000.0
1531,1531999,21.261456176161342,37.616262570156294,0.08656692703515756,536.3556187152863,107.90406942367554,407.038143157959,5708,1449,4259,4259,0,18,1532000.0
1532,1532999,21.257356959154126,37.60897867264845,0.08658421644988412,536.6190831661224,107.97320985794067,407.61364364624023,5708,1449,4259,4259,0,18,1533000.0
1533,1533999,21.25391158524969,37.601922540891664,0.08658624141221904,536.8779375553131,108.0400903224945,408.07605361938477,5708,1449,4259,4259,0,18,1534000.0
1534,1534999,21.250217428237683,37.59656041826756,0.08658121352600101,537.3232421875,108.1090579032898,407.71567153930664,5710,1450,4260,4260,0,18,1535000.0
1535,1535999,21.247922613636206,37.59238118039032,0.0865664104667857,537.6536419391632,108.17600321769714,407.9348335266113,5710,1450,4260,4260,0,18,1536000.0
1536,1536999,21.246753283891366,37.590116930040395,0.0865594750237143,538.2619440555573,108.24473905563354,406.88012313842773,5712,1451,4261,4261,0,18,1537000.0
1537,1537999,21.244729487835084,37.58585908290582,0.08656361123597378,538.5107614994049,108.31125450134277,407.5447883605957,5712,1451,4261,4261,0,18,1538000.0
1538,1538999,21.243300132366326,37.58139610179473,0.08655692615467903,538.8859238624573,108.37792491912842,407.60681533813477,5712,1451,4261,4261,0,18,1539000.0
1539,1539999,21.24195795829884,37.57750407596908,0.08654744962166472,539.3823382854462,108.44482922554016,407.1271553039551,5712,1451,4261,4261,0,18,1540000.0
1540,1540999,21.2406006681287,37.57402318831196,0.08655127623584802,539.6504514217377,108.51279330253601,407.65219497680664,5712,1451,4261,4261,0,18,1541000.0
1541,1541999,21.23821929210638,37.56859728326491,0.08654535244180228,539.9362547397614,108.57923579216003,408.03870010375977,5712,1451,4261,4261,0,18,1542000.0
1542,1542999,21.23534918139404,37.561487306793055,0.08650547860429791,540.3545296192169,108.64594650268555,407.9437370300293,5716,1453,4263,4263,0,18,1543000.0
1543,1543999,21.23484698696208,37.56071569621729,0.08636569005416139,540.8575282096863,108.7166154384613,407.4139518737793,5718,1454,4264,4264,0,18,1544000.0
1544,1544999,21.233794034972345,37.55574433297883,0.08625811517127657,541.1090466976166,108.78424096107483,408.00954818725586,5720,1455,4265,4265,0,18,1545000.0
1545,1545999,21.231754344375172,37.550668433096725,0.08617333111281666,541.7084767818451,108.85404419898987,406.6013984680176,5741,1462,4279,4279,0,18,1546000.0
1546,1546999,21.230380260454965,37.546802853442706,0.08611645024740144,541.945719242096,108.92445731163025,407.4595146179199,5744,1463,4281,4281,0,18,1547000.0
1547,1547999,21.23054609507805,37.54619786277467,0.08604176874802649,542.2358438968658,108.9956283569336,408.0127983093262,5744,1463,4281,4281,0,18,1548000.0
1548,1548999,21.231409993042554,37.54689362372503,0.08596996128021461,542.6081140041351,109.06618595123291,408.04597091674805,5746,1464,4282,4282,0,18,1549000.0
1549,1549999,21.232748764375593,37.55343920902246,0.0858547838907271,542.8990767002106,109.13453960418701,408.38396072387695,5748,1465,4283,4283,0,18,1550000.0
1550,1550999,21.233067089015773,37.55608194665768,0.0858206384784298,543.3115036487579,109.20571613311768,408.088321685791,5754,1468,4286,4286,0,18,1551000.0
1551,1551999,21.235659729674,37.56745684825569,0.08577242624476678,543.8257687091827,109.27615118026733,407.5569725036621,5758,1470,4288,4288,0,18,1552000.0
1552,1552999,21.23686391260856,37.57369250547162,0.08569881448717354,544.2184519767761,109.34548258781433,407.6008415222168,5760,1471,4289,4289,0,18,1553000.0
1553,1553999,21.240806457444346,37.59260389368845,0.08567451048229957,544.4650959968567,109.41575312614441,408.2707099914551,5760,1471,4289,4289,0,18,1554000.0
1554,1554999,21.24498329160692,37.60815026268402,0.0857766949561386,544.8069169521332,109.48640942573547,408.3308982849121,5762,1472,4290,4290,0,18,1555000.0
1555,1555999,21.248342090864877,37.6201227586008,0.08582250144962167,545.1699829101562,109.55676984786987,408.4906425476074,5762,1472,4290,4290,0,18,1556000.0
1556,1556999,21.250632579223506,37.6271270219235,0.0859380907790307,545.5580551624298,109.62686085700989,408.449764251709,5764,1473,4291,4291,0,18,1557000.0
1557,1557999,21.253227096119772,37.63558309325763,0.0860255259515984,545.933758020401,109.69853162765503,408.4959602355957,5766,1474,4292,4292,0,18,1558000.0
1558,1558999,21.254901650809682,37.63823031351906,0.08605120575381331,546.3217895030975,109.76816463470459,408.6236000061035,5766,1474,4292,4292,0,18,1559000.0
1559,1559999,21.258065189920277,37.644206429502034,0.0860294717043284,546.5705981254578,109.8386538028717,409.2106819152832,5766,1474,4292,4292,0,18,1560000.0
1560,1560999,21.261374486676875,37.65263963490915,0.0859661707314191,547.0602111816406,109.91085529327393,408.8431510925293,5766,1474,4292,4292,0,18,1561000.0
1561,1561999,21.264647032205687,37.65743829930574,0.08592004063304814,547.4103579521179,109.98009371757507,409.10087966918945,5766,1474,4292,4292,0,18,1562000.0
1562,1562999,21.263548903927035,37.654148377773375,0.08590058365186592,547.9293744564056,110.05291533470154,408.3521919250488,5772,1477,4295,4295,0,18,1563000.0
1563,1563999,21.265391838854,37.65446113041015,0.0858065781021966,548.2424590587616,110.12680840492249,408.70107650756836,5774,1478,4296,4296,0,18,1564000.0
1564,1564999,21.265366069226932,37.65604397636392,0.08574214412760195,548.6029345989227,110.19975304603577,408.9289665222168,5774,1478,4296,4296,0,18,1565000.0
1565,1565999,21.265495045174948,37.656351505494115,0.08570685347640905,548.9743895530701,110.2727062702179,408.82036209106445,5782,1481,4301,4301,0,18,1566000.0
1566,1566999,21.267123034750377,37.658760395631816,0.08569064477660548,549.2807240486145,110.34413933753967,409.22832107543945,5784,1482,4302,4302,0,18,1567000.0
1567,1567999,21.268950074748847,37.65983033182417,0.08565216336825121,549.7220678329468,110.41841673851013,408.9539604187012,5788,1484,4304,4304,0,19,1568000.0
1568,1568999,21.270430247093767,37.660967992377955,0.08565289170817991,550.1034290790558,110.4913854598999,408.9989433288574,5790,1485,4305,4305,0,19,1569000.0
1569,1569999,21.27265234291686,37.66327391525008,0.08566789043546053,550.3638458251953,110.56518816947937,409.6518135070801,5790,1485,4305,4305,0,19,1570000.0
1570,1570999,21.273987021678817,37.66413875786341,0.08571285553119101,550.6314826011658,110.63858914375305,410.2053413391113,5790,1485,4305,4305,0,19,1571000.0
1571,1571999,21.276420261139993,37.66623364972706,0.08571140480591466,551.0982577800751,110.71328163146973,409.9735298156738,5792,1486,4306,4306,0,19,1572000.0
1572,1572999,21.279754545918006,37.67034272985382,0.08580004301727062,551.6242790222168,110.78947472572327,409.03969955444336,5799,1490,4309,4309,0,20,1573000.0
1573,1573999,21.284943845079304,37.68708087747174,0.085909375714192,552.0048441886902,110.86442971229553,409.13882064819336,5812,1491,4321,4321,0,20,1574000.0
1574,1574999,21.289929172582237,37.69438723254581,0.08604151526943848,552.2973434925079,110.93850684165955,409.90275955200195,5812,1491,4321,4321,0,20,1575000.0
1575,1575999,21.296864723465468,37.71153407041243,0.08609960423961005,552.710334777832,111.01268219947815,409.9554557800293,5812,1491,4321,4321,0,20,1576000.0
1576,1576999,21.30525088554457,37.73334103694076,0.08617009325050506,553.0360827445984,111.08810210227966,410.31574630737305,5817,1493,4324,4324,0,20,1577000.0
1577,1577999,21.311908710638725,37.741588499694835,0.08625235597391134,553.5279519557953,111.16377401351929,409.8169593811035,5820,1495,4325,4325,0,21,1578000.0
1578,1578999,21.317250488557793,37.747016619200785,0.08641216292960008,553.8393242359161,111.23862886428833,410.325252532959,5820,1495,4325,4325,0,21,1579000.0
1579,1579999,21.32542001886678,37.757775875011575,0.08656215374948473,554.124493598938,111.31303358078003,410.90002059936523,5820,1495,4325,4325,0,21,1580000.0
1580,1580999,21.332924972529028,37.766096211885475,0.08668555565796843,554.442170381546,111.38758373260498,411.2642478942871,5820,1495,4325,4325,0,21,1581000.0
1581,1581999,21.340773208826217,37.774385394088476,0.0869028735664592,554.7968871593475,111.46308159828186,411.1765327453613,5823,1497,4326,4326,0,22,1582000.0
1582,1582999,21.34901028910624,37.783544086876674,0.08709486271766476,555.2763493061066,111.53965067863464,410.78100204467773,5825,1498,4327,4327,0,22,1583000.0
1583,1583999,21.35166158076541,37.784484758162726,0.0871454739381603,555.7881574630737,111.61228632926941,410.32170486450195,5831,1501,4330,4330,0,22,1584000.0
1584,1584999,21.347114634262724,37.776459836135025,0.08715461918846512,556.0183613300323,111.67765736579895,411.1624565124512,5831,1501,4330,4330,0,22,1585000.0
1585,1585999,21.342530973239597,37.76824162674465,0.08715655372830089,556.3724691867828,111.74362969398499,411.3212547302246,5833,1502,4331,4331,0,22,1586000.0
1586,1586999,21.339576614642137,37.76308692669632,0.08713825688290278,558.6469950675964,111.81075048446655,412.0536994934082,5834,1502,4332,4332,0,22,1587000.0
1587,1587999,21.337459751866472,37.76083554733433,0.08708876101216156,559.0987920761108,111.87849545478821,411.75351333618164,5836,1503,4333,4333,0,22,1588000.0
1588,1588999,21.336224780352385,37.75768914762341,0.08704176930000529,559.4944362640381,111.94748425483704,411.69394302368164,5842,1506,4336,4336,0,22,1589000.0
1589,1589999,21.334578942947722,37.75241841357685,0.0870055942071537,559.8098790645599,112.01558208465576,412.08352279663086,5842,1506,4336,4336,0,22,1590000.0
1590,1590999,21.332306703440736,37.74592438863854,0.08696724044130255,560.109522819519,112.08351802825928,412.3561668395996,5844,1507,4337,4337,0,22,1591000.0
1591,1591999,21.330643310917484,37.74121154582805,0.08693333730676289,560.6604886054993,112.1509177684784,411.37024307250977,5854,1512,4342,4342,0,22,1592000.0
1592,1592999,21.32910400647187,37.73829859328544,0.08690329640999406,560.8822999000549,112.21839809417725,412.2549934387207,5854,1512,4342,4342,0,22,1593000.0
1593,1593999,21.328055812822974,37.73553345484549,0.08687830814801811,561.1579923629761,112.28566145896912,412.66340255737305,5854,1512,4342,4342,0,22,1594000.0
1594,1594999,21.327914099778752,37.73379764700309,0.0868563289390647,561.5674886703491,112.35340881347656,412.3342399597168,5860,1515,4345,4345,0,22,1595000.0
1595,1595999,21.328582115455134,37.732663643543944,0.08688231346625219,562.1503169536591,112.42324686050415,411.4775733947754,5866,1518,4348,4348,0,22,1596000.0
1596,1596999,21.330079972081936,37.73887675396666,0.08689680994572835,562.474027633667,112.49200582504272,411.5765037536621,5872,1521,4351,4351,0,22,1597000.0
1597,1597999,21.33186230556482,37.74032363953695,0.08692494213364554,562.7858440876007,112.55973601341248,412.0701103210449,5872,1521,4351,4351,0,22,1598000.0
1598,1598999,21.335966693723062,37.74698609508658,0.0869436552268038,563.0702118873596,112.62767124176025,412.5778388977051,5872,1521,4351,4351,0,22,1599000.0
1599,1599999,21.340569194538876,37.75484139764648,0.08694888740521689,563.5126974582672,112.69581937789917,412.24978256225586,5880,1524,4356,4356,0,22,1600000.0
1600,1600999,21.34590274472502,37.76171175730649,0.08698771744967204,563.8015966415405,112.76318883895874,412.72243881225586,5882,1525,4357,4357,0,22,1601000.0
1601,1601999,21.35229119149854,37.77247548061135,0.08700401061617524,564.0798101425171,112.83766579627991,413.3360252380371,5882,1525,4357,4357,0,22,1602000.0
1602,1602999,21.362279131532105,37.80661453330685,0.08693599057696344,564.3017206192017,112.90587639808655,414.02460861206055,5882,1525,4357,4357,0,22,1603000.0
1603,1603999,21.367009181887504,37.811789919873085,0.08696276986025853,564.7594237327576,112.97415208816528,413.62488174438477,5884,1526,4358,4358,0,22,1604000.0
1604,1604999,21.370990322178795,37.81940635348816,0.08659921118586411,565.1546709537506,113.04383659362793,413.9245262145996,5884,1526,4358,4358,0,22,1605000.0
1605,1605999,21.377917294380026,37.83864469252951,0.08615083728777384,565.606368303299,113.11465644836426,413.67760848999023,5888,1528,4360,4360,0,22,1606000.0
1606,1606999,21.381285450590397,37.84802381507091,0.08597296624657047,565.9887835979462,113.18751645088196,413.81755447387695,5890,1529,4361,4361,0,22,1607000.0
1607,1607999,21.38339817799505,37.852895878556104,0.08585154039203224,566.3502058982849,113.2598876953125,414.1407585144043,5893,1530,4363,4363,0,22,1608000.0
1608,1608999,21.384792600486005,37.85127071685671,0.08577111981865115,566.727011680603,113.33018684387207,414.2365379333496,5895,1531,4364,4364,0,22,1609000.0
1609,1609999,21.386031570873907,37.852136661202735,0.08570697334504074,567.1749210357666,113.40236830711365,413.91877365112305,5899,1533,4366,4366,0,22,1610000.0
1610,1610999,21.388244201629526,37.85658478945721,0.08562198452035352,567.4879579544067,113.47364020347595,414.47692489624023,5899,1533,4366,4366,0,22,1611000.0
1611,1611999,21.390440997810185,37.85896351037768,0.08552789625320112,567.9127452373505,113.54611730575562,414.53432846069336,5899,1533,4366,4366,0,22,1612000.0
1612,1612999,21.39206216629075,37.85836913413354,0.08544131272545419,568.1731560230255,113.62005519866943,415.0940818786621,5900,1534,4366,4366,0,22,1613000.0
1613,1613999,21.394678266557637,37.86090460924402,0.0853687568738627,568.5801084041595,113.692791223526,414.96035385131836,5902,1535,4367,4367,0,22,1614000.0
1614,1614999,21.3976935152172,37.862976276162215,0.08531072834160625,568.9499070644379,113.76665830612183,415.2198371887207,5902,1535,4367,4367,0,22,1615000.0
1615,1615999,21.400984966762994,37.87394946189867,0.0852132518658647,569.3077454566956,113.8391900062561,415.4567756652832,5902,1535,4367,4367,0,22,1616000.0
1616,1616999,21.40255010638633,37.87270882062719,0.08517451006134713,569.6789100170135,113.91309094429016,415.3772087097168,5905,1537,4368,4368,0,22,1617000.0
1617,1617999,21.405201303801412,37.87405262720426,0.08512482431741031,570.0359258651733,113.98762726783752,415.6800346374512,5905,1537,4368,4368,0,22,1618000.0
1618,1618999,21.406821600979587,37.87206146790793,0.08508493426773034,570.4968898296356,114.06181931495667,415.3849754333496,5908,1538,4370,4370,0,22,1619000.0
1619,1619999,21.408265956809032,37.870474426851224,0.08506236693383651,570.9479277133942,114.1362316608429,415.14611434936523,5909,1539,4370,4370,0,22,1620000.0
1620,1620999,21.41029175150255,37.877716873173625,0.08498502133951846,571.368323802948,114.2119414806366,415.1764793395996,5909,1539,4370,4370,0,22,1621000.0
1621,1621999,21.41075966549179,37.87463814105615,0.08496470342196161,571.6818430423737,114.28661513328552,415.6403999328613,5909,1539,4370,4370,0,22,1622000.0
1622,1622999,21.411746673726952,37.87116746911303,0.08482006646298879,572.0981311798096,114.35731053352356,415.7802391052246,5909,1539,4370,4370,0,22,1623000.0
1623,1623999,21.419318302750277,37.876275748435084,0.08447477017168004,572.4084520339966,114.42619204521179,416.31562423706055,5973,1541,4432,4432,0,22,1624000.0
1624,1624999,21.423324669485254,37.87543550284123,0.0841830319715815,572.7901656627655,114.49431443214417,416.55517959594727,5981,1544,4437,4437,0,22,1625000.0
1625,1625999,21.42671837036117,37.87766311043113,0.08387970104540576,573.1373717784882,114.56392359733582,416.7958564758301,5985,1546,4439,4439,0,22,1626000.0
1626,1626999,21.430378260717077,37.87961755559777,0.08359951446392733,573.5514938831329,114.63216733932495,416.954647064209,5989,1548,4441,4441,0,22,1627000.0
1627,1627999,21.43141189898766,37.876789102502066,0.08343781922282434,573.8230617046356,114.70077919960022,417.4654960632324,5993,1550,4443,4443,0,22,1628000.0
1628,1628999,21.43269434562382,37.87489371421287,0.08321179210487495,574.0195205211639,114.76840138435364,418.4378852844238,5993,1550,4443,4443,0,22,1629000.0
1629,1629999,21.43253317574058,37.870264498100575,0.0831097195592474,574.4906070232391,114.83670806884766,418.09133529663086,5995,1551,4444,4444,0,22,1630000.0
1630,1630999,21.432149712032725,37.869788819596224,0.08296894464182969,574.770777463913,114.90440630912781,418.47829818725586,6001,1554,4447,4447,0,22,1631000.0
1631,1631999,21.430761995154075,37.86464654580082,0.08289017279242317,575.0911140441895,114.97142815589905,418.80868911743164,6003,1555,4448,4448,0,22,1632000.0
1632,1632999,21.42966823795833,37.86225367797173,0.08279590048154573,575.3895280361176,115.03895020484924,419.2157325744629,6005,1556,4449,4449,0,22,1633000.0
1633,1633999,21.428687441992523,37.85932735397379,0.08270440198538875,575.7589149475098,115.10681343078613,419.0271873474121,6011,1559,4452,4452,0,22,1634000.0
1634,1634999,21.427514876007795,37.854900634411415,0.08263775421981767,576.1015908718109,115.17678380012512,419.140926361084,6015,1561,4454,4454,0,22,1635000.0
1635,1635999,21.425834002134362,37.85061473369016,0.08258221626805551,576.5674440860748,115.24553060531616,418.8538932800293,6019,1563,4456,4456,0,22,1636000.0
1636,1636999,21.424685626137418,37.85050602346631,0.08247915381122473,576.896646976471,115.31410932540894,419.0910835266113,6024,1565,4459,4459,0,22,1637000.0
1637,1637999,21.425313958437968,37.86106163571959,0.08235196652180021,577.1830744743347,115.38337755203247,419.75068283081055,6024,1565,4459,4459,0,22,1638000.0
1638,1638999,21.42411491349809,37.85728206123536,0.08229647994278888,577.4843900203705,115.4513840675354,420.2044258117676,6024,1565,4459,4459,0,22,1639000.0
1639,1639999,21.423749481514534,37.85466986087149,0.08223715118856922,577.855973482132,115.52017617225647,420.36687088012695,6055,1566,4489,4489,0,22,1640000.0
1640,1640999,21.4224473858616,37.84971405268092,0.08219248719970484,578.2641534805298,115.59060430526733,420.39465713500977,6057,1567,4490,4490,0,22,1641000.0
1641,1641999,21.42103681725974,37.85016653029027,0.08212370059005847,578.6686401367188,115.66115403175354,420.5620460510254,6057,1567,4490,4490,0,22,1642000.0
1642,1642999,21.42223022084162,37.84971743353159,0.08194044254121502,578.9598872661591,115.72999000549316,421.12631607055664,6059,1568,4491,4491,0,22,1643000.0
1643,1643999,21.42733053506887,37.85112107732059,0.08160524895573307,579.417799949646,115.80003213882446,420.78310775756836,6063,1570,4493,4493,0,22,1644000.0
1644,1644999,21.42922933322419,37.85098500335928,0.08145034803785978,579.718425989151,115.86923289299011,421.22803115844727,6065,1571,4494,4494,0,22,1645000.0
1645,1645999,21.429435833030833,37.85007940949221,0.08128587542798849,580.1794056892395,115.93904614448547,420.8368110656738,6072,1574,4498,4498,0,22,1646000.0
1646,1646999,21.429068628885965,37.86336726452354,0.0811562011058331,580.4194622039795,116.00813841819763,421.3973579406738,6076,1576,4500,4500,0,22,1647000.0
1647,1647999,21.427533039344052,37.85926426156157,0.08107636030520415,580.6990571022034,116.07847762107849,421.8845558166504,6078,1577,4501,4501,0,22,1648000.0
1648,1648999,21.424908951849652,37.85279487108372,0.08102371248082463,580.9771010875702,116.14942193031311,422.20478439331055,6082,1579,4503,4503,0,22,1649000.0
1649,1649999,21.421675782051757,37.84620818933662,0.0809955700478392,581.3499898910522,116.22072434425354,422.22722244262695,6086,1581,4505,4505,0,22,1650000.0
1650,1650999,21.418823673161587,37.839757808775616,0.08096543046776405,581.7827270030975,116.29223012924194,421.79958724975586,6124,1585,4539,4539,0,22,1651000.0
1651,1651999,21.415847350968214,37.8339401191232,0.0809182964223848,582.2329876422882,116.36284065246582,421.3239860534668,6132,1589,4543,4543,0,22,1652000.0
1652,1652999,21.412742337082825,37.827735444169384,0.08089104113681789,582.444500207901,116.43328380584717,422.25771713256836,6132,1589,4543,4543,0,22,1653000.0
1653,1653999,21.410011893264393,37.822394155569434,0.08085603880368875,582.855740070343,116.50430035591125,422.1708641052246,6136,1591,4545,4545,0,22,1654000.0
1654,1654999,21.407493287532517,37.816530160372004,0.0808104385942936,583.2423274517059,116.57679557800293,422.1176948547363,6138,1592,4546,4546,0,22,1655000.0
1655,1655999,21.4053407686438,37.81195214026832,0.08077228261388048,583.6313264369965,116.64856290817261,422.1376762390137,6138,1592,4546,4546,0,22,1656000.0
1656,1656999,21.404723159622627,37.80934146078132,0.08071983358801404,583.9835543632507,116.72136282920837,422.30028915405273,6140,1593,4547,4547,0,22,1657000.0
1657,1657999,21.405923721946465,37.80838449743251,0.08062359879447334,584.3955812454224,116.7933578491211,422.0894355773926,6144,1595,4549,4549,0,22,1658000.0
1658,1658999,21.406924598811,37.80767927326229,0.08055456949233564,584.815292596817,116.86402177810669,422.0255470275879,6144,1595,4549,4549,0,22,1659000.0
1659,1659999,21.40889833544598,37.809666449609296,0.08047926814487727,585.1493515968323,116.93618035316467,422.4658546447754,6144,1595,4549,4549,0,22,1660000.0
1660,1660999,21.409587740664893,37.807848498818565,0.08042478165165656,585.3547208309174,117.00553178787231,423.2075843811035,6144,1595,4549,4549,0,22,1661000.0
1661,1661999,21.409802303912567,37.80571927885904,0.08038484072142416,585.6849050521851,117.07726454734802,423.27770614624023,6147,1597,4550,4550,0,22,1662000.0
1662,1662999,21.40998272459544,37.80340282754551,0.08034184379122888,586.0839512348175,117.14909362792969,423.27477645874023,6147,1597,4550,4550,0,22,1663000.0
1663,1663999,21.408255276933176,37.79872289980042,0.08028614397962752,586.3792688846588,117.21839141845703,423.8815498352051,6148,1597,4551,4551,0,22,1664000.0
1664,1664999,21.406047157888345,37.79476345384704,0.08024899354323434,586.639251947403,117.28484654426575,424.4651908874512,6148,1597,4551,4551,0,22,1665000.0
1665,1665999,21.402301190668844,37.78808742515565,0.08025280169679583,586.9284880161285,117.35220050811768,424.82201766967773,6150,1598,4552,4552,0,22,1666000.0
1666,1666999,21.398618692371947,37.78527491320876,0.08023059402419475,587.5273151397705,117.41937923431396,423.6488227844238,6159,1602,4557,4557,0,22,1667000.0
1667,1667999,21.394579192811072,37.7787376022287,0.0802237477350023,587.8574430942535,117.48673915863037,424.0364418029785,6161,1603,4558,4558,0,22,1668000.0
1668,1668999,21.390903768032302,37.77254162558461,0.08021795023195355,588.1614315509796,117.55341601371765,424.54926681518555,6161,1603,4558,4558,0,22,1669000.0
1669,1669999,21.387650073874465,37.76649436311763,0.08020154570858673,588.488997220993,117.62368202209473,424.56167221069336,6167,1606,4561,4561,0,22,1670000.0
1670,1670999,21.384185445355364,37.760174862732505,0.08019201667334941,588.8815574645996,117.69090104103088,424.61904525756836,6198,1607,4591,4591,0,22,1671000.0
1671,1671999,21.380548859687977,37.75328584058705,0.08018824437163719,589.2171993255615,117.76016306877136,424.62360763549805,6202,1609,4593,4593,0,22,1672000.0
1672,1672999,21.376484650125946,37.745911421678976,0.08020642806370215,589.541273355484,117.8271050453186,424.7657585144043,6206,1611,4595,4595,0,22,1673000.0
1673,1673999,21.37251798236293,37.739841394348254,0.08020332294849686,589.8244462013245,117.8974757194519,425.34296798706055,6206,1611,4595,4595,0,22,1674000.0
1674,1674999,21.368511246954466,37.73278722904462,0.08021204452483499,590.0925133228302,117.96415686607361,425.7895317077637,6206,1611,4595,4595,0,22,1675000.0
1675,1675999,21.365145802472643,37.72651633029619,0.08021223956678214,590.6370012760162,118.03237581253052,425.026065826416,6206,1611,4595,4595,0,22,1676000.0
1676,1676999,21.361455494494788,37.719854278350084,0.08020688060148318,591.1704471111298,118.102548122406,424.31335830688477,6210,1613,4597,4597,0,22,1677000.0
1677,1677999,21.358654608116485,37.71481412015759,0.08019735368762182,591.4689607620239,118.16948533058167,424.86230087280273,6210,1613,4597,4597,0,22,1678000.0
1678,1678999,21.35811135198833,37.71315592224473,0.08015192694448259,591.8098773956299,118.23743295669556,425.1075096130371,6210,1613,4597,4597,0,22,1679000.0
1679,1679999,21.358395507700216,37.71648383746281,0.08010091908505601,592.1411459445953,118.3063108921051,425.26379013061523,6212,1614,4598,4598,0,22,1680000.0
1680,1680999,21.358263894464265,37.71881471332468,0.08007813088074833,592.4869811534882,118.375164270401,425.52502822875977,6212,1614,4598,4598,0,22,1681000.0
1681,1681999,21.358764021407072,37.721044896971655,0.0800353680907574,592.8161041736603,118.44375920295715,425.6778755187988,6214,1615,4599,4599,0,22,1682000.0
1682,1682999,21.35762832515303,37.71684456025496,0.08004105010127827,593.1497793197632,118.51259446144104,425.9358329772949,6214,1615,4599,4599,0,22,1683000.0
1683,1683999,21.356016132836302,37.71188407179585,0.08002773381553274,593.4925870895386,118.58139204978943,426.0852165222168,6214,1615,4599,4599,0,22,1684000.0
1684,1684999,21.352713306597366,37.70540365905328,0.08002204917117484,593.8716425895691,118.65053105354309,426.45456314086914,6214,1615,4599,4599,0,22,1685000.0
1685,1685999,21.348254576996688,37.697967688597856,0.08004991592562183,596.315370798111,118.71967244148254,427.0206642150879,6214,1615,4599,4599,0,22,1686000.0
1686,1686999,21.344606097911246,37.69149285575672,0.08007641494067119,596.623587846756,118.78721618652344,427.3842430114746,6214,1615,4599,4599,0,22,1687000.0
1687,1687999,21.34149679142158,37.68559261992097,0.0800798275082858,597.0239601135254,118.85727310180664,427.18193435668945,6222,1619,4603,4603,0,22,1688000.0
1688,1688999,21.338676358798455,37.680380284520844,0.08008452985542336,597.4480700492859,118.92747163772583,426.9286766052246,6226,1621,4605,4605,0,22,1689000.0
1689,1689999,21.336588953342556,37.678355513454136,0.08009754714179396,597.8216896057129,118.9962546825409,426.9596061706543,6228,1622,4606,4606,0,22,1690000.0
1690,1690999,21.335365033726625,37.676338378834814,0.08011050081246607,598.1054413318634,119.06586837768555,427.50888442993164,6228,1622,4606,4606,0,22,1691000.0
1691,1691999,21.33458610596902,37.67609193063735,0.08010322108544088,598.4877502918243,119.1357069015503,427.5246696472168,6230,1623,4607,4607,0,22,1692000.0
1692,1692999,21.334025136394896,37.680259105235784,0.08007019504655388,598.884551525116,119.20476961135864,427.1803092956543,6236,1626,4610,4610,0,22,1693000.0
1693,1693999,21.3352913602585,37.69518663563611,0.0800591656929619,599.2294869422913,119.28026103973389,427.51010513305664,6238,1627,4611,4611,0,22,1694000.0
1694,1694999,21.335798528804062,37.69807662289743,0.080186411202531,599.5106093883514,119.34924149513245,428.0516777038574,6238,1627,4611,4611,0,22,1695000.0
1695,1695999,21.338979984853776,37.71117216618844,0.08026482033617499,599.7976360321045,119.41892433166504,428.3572120666504,6240,1628,4612,4612,0,22,1696000.0
1696,1696999,21.340392646705897,37.718210351368604,0.08039028105069257,600.1800673007965,119.48823547363281,428.1058464050293,6244,1630,4614,4614,0,22,1697000.0
1697,1697999,21.34141293550546,37.72222213803726,0.08049546089675774,600.6901562213898,119.55896520614624,427.52236557006836,6246,1631,4615,4615,0,22,1698000.0
1698,1698999,21.343131954276405,37.727916221672224,0.0806318612244743,601.1652483940125,119.62910795211792,427.357120513916,6246,1631,4615,4615,0,22,1699000.0
1699,1699999,21.346189869242366,37.739235186221826,0.08066423907063613,601.4972081184387,119.69879722595215,427.5075874328613,6251,1633,4618,4618,0,22,1700000.0
1700,1700999,21.348197813055254,37.74360257673665,0.08076815950728755,601.6631627082825,119.77001023292542,428.4734916687012,6251,1633,4618,4618,0,22,1701000.0
1701,1701999,21.351551144502384,37.74975874130633,0.08082227829251787,602.0447115898132,119.84005165100098,428.52749252319336,6251,1633,4618,4618,0,22,1702000.0
1702,1702999,21.35533179488299,37.75675194440528,0.08081984467863723,602.4769167900085,119.91101050376892,428.30138778686523,6253,1634,4619,4619,0,22,1703000.0
1703,1703999,21.357158008712695,37.75796558315485,0.0808800538681288,602.8767101764679,119.98111176490784,428.4388008117676,6253,1634,4619,4619,0,22,1704000.0
1704,1704999,21.359073615449223,37.7711221923072,0.080818072832053,603.220376253128,120.05051374435425,428.58835220336914,6255,1635,4620,4620,0,22,1705000.0
1705,1705999,21.357303343706615,37.77298064265945,0.08075369399559684,603.5505094528198,120.11991810798645,429.26606369018555,6269,1637,4632,4632,0,22,1706000.0
1706,1706999,21.353091145308476,37.766138599971725,0.08075702494692949,603.8438813686371,120.18914294242859,429.93747329711914,6269,1637,4632,4632,0,22,1707000.0
1707,1707999,21.348769234812107,37.75902222114629,0.08077553873833787,604.0391707420349,120.25753688812256,431.13457107543945,6285,1638,4647,4647,0,22,1708000.0
1708,1708999,21.345238704886324,37.75764554055428,0.0807656216929662,604.2841913700104,120.32530307769775,432.07233810424805,6290,1639,4651,4651,0,22,1709000.0
1709,1709999,21.342173256874222,37.752990672712656,0.08076336268979378,604.5623161792755,120.39291071891785,432.6022071838379,6292,1640,4652,4652,0,22,1710000.0
1710,1710999,21.338941450088523,37.74778018241728,0.08076637044908164,604.8781616687775,120.46305823326111,433.0228385925293,6296,1642,4654,4654,0,22,1711000.0
1711,1711999,21.336773778647487,37.74363751351115,0.08075564193583396,605.1349864006042,120.53274512290955,433.554874420166,6296,1642,4654,4654,0,22,1712000.0
1712,1712999,21.334869332693554,37.739837149841485,0.08074472172641434,605.4910550117493,120.6029999256134,433.6308403015137,6301,1644,4657,4657,0,22,1713000.0
1713,1713999,21.333080775968096,37.73551448497673,0.08075167269085803,605.7747206687927,120.67172813415527,434.0300178527832,6303,1645,4658,4658,0,22,1714000.0
1714,1714999,21.331571097071215,37.74645140038707,0.08071002395147597,606.2577817440033,120.74194478988647,433.6187400817871,6305,1646,4659,4659,0,22,1715000.0
1715,1715999,21.331286426294618,37.74551147048747,0.08070523952459685,606.685756444931,120.81261038780212,433.52668380737305,6307,1647,4660,4660,0,22,1716000.0
1716,1716999,21.33069815695746,37.7441439917159,0.08071242195145623,606.9949259757996,120.88358807563782,433.9593849182129,6309,1648,4661,4661,0,22,1717000.0
1717,1717999,21.33154804392664,37.75205838788264,0.08068551968675908,607.1994135379791,120.95354676246643,434.8084373474121,6309,1648,4661,4661,0,22,1718000.0
1718,1718999,21.332937371297483,37.75526054697552,0.0807081040157045,607.6330301761627,121.02307391166687,434.5658531188965,6309,1648,4661,4661,0,22,1719000.0
1719,1719999,21.3344500908603,37.758276666612765,0.08071115747049185,608.0434763431549,121.09435510635376,434.52971267700195,6311,1649,4662,4662,0,22,1720000.0
1720,1720999,21.338029645599832,37.76523179883796,0.08073770067923092,608.4277718067169,121.1644697189331,434.59365463256836,6313,1650,4663,4663,0,22,1721000.0
1721,1721999,21.34248819134109,37.77965420519467,0.0807220929342547,608.7916550636292,121.23328375816345,434.5696907043457,6317,1652,4665,4665,0,22,1722000.0
1722,1722999,21.346807833225675,37.79227817790376,0.08077563334054239,609.1310904026031,121.3034074306488,434.8407859802246,6319,1653,4666,4666,0,22,1723000.0
1723,1723999,21.350098094531898,37.79810066671897,0.0808054471607722,609.5454530715942,121.37329483032227,434.45447158813477,6327,1657,4670,4670,0,22,1724000.0
1724,1724999,21.354021789777374,37.80533981683072,0.08083406768422852,609.9391193389893,121.44540929794312,434.5766716003418,6331,1659,4672,4672,0,22,1725000.0
1725,1725999,21.35445842277816,37.80477045556724,0.08084452206137727,610.1991202831268,121.51426672935486,435.54623794555664,6340,1659,4681,4681,0,22,1726000.0
1726,1726999,21.350138209908227,37.79846754543178,0.08085571384549517,610.5335781574249,121.57941222190857,436.0798149108887,6358,1661,4697,4697,0,22,1727000.0
1727,1727999,21.346224481090513,37.79335539334073,0.08086529898268158,610.8276901245117,121.64688897132874,436.97238540649414,6367,1661,4706,4706,0,22,1728000.0
1728,1728999,21.343129810530964,37.79303333256337,0.08083532438137275,611.1039021015167,121.71281313896179,437.86349868774414,6370,1662,4708,4708,0,22,1729000.0
1729,1729999,21.340319730266856,37.78937075241201,0.08083352091225426,611.3258187770844,121.77861261367798,438.9861717224121,6406,1663,4743,4743,0,22,1730000.0
1730,1730999,21.33849771890858,37.785619901873936,0.08082314972787841,611.5886490345001,121.84488916397095,439.72189712524414,6411,1665,4746,4746,0,22,1731000.0
1731,1731999,21.336342031198996,37.78052173905676,0.08081652468019329,611.8223392963409,121.91012120246887,440.63842391967773,6413,1666,4747,4747,0,22,1732000.0
1732,1732999,21.333869042320785,37.77566925409763,0.08080736007659994,612.1913847923279,121.97663116455078,440.76452255249023,6419,1669,4750,4750,0,22,1733000.0
1733,1733999,21.331690237715407,37.77120640776274,0.0807974451125465,612.4600269794464,122.04176664352417,441.25646591186523,6425,1672,4753,4753,0,22,1734000.0
1734,1734999,21.33112253630652,37.77059620963131,0.08079280095943175,612.7291283607483,122.10818290710449,441.7490348815918,6429,1674,4755,4755,0,22,1735000.0
1735,1735999,21.330870450317683,37.770462398741444,0.08078874416180737,612.9547741413116,122.17558145523071,442.4348564147949,6440,1676,4764,4764,0,22,1736000.0
1736,1736999,21.331224340124063,37.78330673089965,0.08075675930722792,613.3453056812286,122.24490904808044,442.40808486938477,6442,1677,4765,4765,0,22,1737000.0
1737,1737999,21.331208993793,37.78280375177153,0.08077153605790488,613.8797328472137,122.31260180473328,441.9629020690918,6444,1678,4766,4766,0,22,1738000.0
1738,1738999,21.331656891076417,37.782992802149245,0.08078268335982075,614.2996788024902,122.38038754463196,441.9645347595215,6447,1679,4768,4768,0,22,1739000.0
1739,1739999,21.33167338648761,37.782262170734334,0.0808112571298798,614.5419044494629,122.44825220108032,442.7096366882324,6449,1680,4769,4769,0,22,1740000.0
1740,1740999,21.33346057350367,37.78501716601838,0.08079896232225525,614.8919093608856,122.52163553237915,442.87456130981445,6453,1682,4771,4771,0,22,1741000.0
1741,1741999,21.33551019550558,37.7883710727228,0.08083301402242649,615.2231948375702,122.58942103385925,443.2056999206543,6455,1683,4772,4772,0,22,1742000.0
1742,1742999,21.339172396961427,37.795968855738785,0.08088921619638689,615.592050075531,122.65580701828003,443.2445640563965,6457,1684,4773,4773,0,22,1743000.0
1743,1743999,21.34387666024556,37.815916055900225,0.08085049374820596,615.890988111496,122.72234964370728,443.692440032959,6459,1685,4774,4774,0,22,1744000.0
1744,1744999,21.347455689707683,37.82349163484906,0.0808525899190452,616.2546169757843,122.7929413318634,443.83472061157227,6463,1687,4776,4776,0,22,1745000.0
1745,1745999,21.349850582644812,37.82726961514098,0.08081883033600545,616.6122636795044,122.86170792579651,443.93972396850586,6465,1688,4777,4777,0,22,1746000.0
1746,1746999,21.349110273554576,37.827658046180716,0.08075821515885417,617.0896213054657,122.92907404899597,444.1955680847168,6475,1689,4786,4786,0,22,1747000.0
1747,1747999,21.348040088351688,37.828162009029285,0.08079066137309754,617.3810379505157,122.99546027183533,445.1155433654785,6491,1690,4801,4801,0,22,1748000.0
1748,1748999,21.34560627129846,37.82446595760587,0.08081663072419398,617.588947057724,123.063312292099,446.5145683288574,6493,1690,4803,4803,0,22,1749000.0
1749,1749999,21.34389062847321,37.82395046297904,0.08081794396267039,617.7908942699432,123.13211703300476,447.5443916320801,6497,1691,4806,4806,0,22,1750000.0
1750,1750999,21.34249387270455,37.82322534484786,0.08080298701255462,617.9964225292206,123.20117712020874,448.54553604125977,6498,1691,4807,4807,0,22,1751000.0
1751,1751999,21.341491327875055,37.82530623289658,0.08077282431350008,618.31418633461,123.26859879493713,448.9502067565918,6502,1693,4809,4809,0,22,1752000.0
1752,1752999,21.340908799211856,37.82472360239208,0.08079153677339479,618.5979762077332,123.33892726898193,449.48698806762695,6503,1693,4810,4810,0,22,1753000.0
1753,1753999,21.339453617793996,37.82185720047895,0.08081918539887734,619.1331686973572,123.40743732452393,448.9187126159668,6507,1695,4812,4812,0,22,1754000.0
1754,1754999,21.338321883273377,37.8194908380587,0.08087566374583499,619.4350790977478,123.47646999359131,449.38195419311523,6509,1696,4813,4813,0,22,1755000.0
1755,1755999,21.337479586436217,37.818485943145056,0.08088743483985061,619.7649831771851,123.5474100112915,449.7076072692871,6511,1697,4814,4814,0,22,1756000.0
1756,1756999,21.3365927905381,37.8174592012736,0.080893542104017,620.1087987422943,123.61643362045288,449.8540153503418,6513,1698,4815,4815,0,22,1757000.0
1757,1757999,21.337157935275663,37.82456252843507,0.08092781170292773,620.5459859371185,123.68620085716248,449.71989822387695,6546,1700,4846,4846,0,22,1758000.0
1758,1758999,21.337328085348034,37.82300325593264,0.0809221051918213,620.8946018218994,123.75467944145203,450.06359481811523,6546,1700,4846,4846,0,22,1759000.0
1759,1759999,21.33878143992264,37.82326092874857,0.08088649643662793,621.2808220386505,123.82434797286987,450.04159927368164,6548,1701,4847,4847,0,22,1760000.0
1760,1760999,21.339692138059274,37.82234234250958,0.08089633684399855,621.6207547187805,123.8933367729187,450.3348274230957,6550,1702,4848,4848,0,22,1761000.0
1761,1761999,21.34223102115381,37.82450410107202,0.0809081962262419,622.1598830223083,123.96220088005066,449.6883430480957,6552,1703,4849,4849,0,22,1762000.0
1762,1762999,21.34378777132882,37.82464711973947,0.08089440752814536,622.4829382896423,124.03442454338074,450.2106285095215,6552,1703,4849,4849,0,22,1763000.0
1763,1763999,21.346019276751832,37.82972102037596,0.08087254155016455,622.8431198596954,124.10305309295654,450.51315689086914,6552,1703,4849,4849,0,22,1764000.0
1764,1764999,21.343553457700448,37.82476372751163,0.08086182641657147,623.090517282486,124.17322206497192,451.66232681274414,6567,1704,4863,4863,0,22,1765000.0
1765,1765999,21.33967399979171,37.82049864289327,0.08086414106219664,623.3223249912262,124.23918843269348,452.7210578918457,6574,1706,4868,4868,0,22,1766000.0
1766,1766999,21.336307858220238,37.81757949095623,0.08086090773368282,623.5920717716217,124.30439925193787,453.40351486206055,6577,1706,4871,4871,0,22,1767000.0
1767,1767999,21.333881188539884,37.81492320402892,0.08082867991761089,623.8930504322052,124.37157273292542,453.8997230529785,6593,1708,4885,4885,0,22,1768000.0
1768,1768999,21.33109391606789,37.811831056051325,0.08079935349155376,624.1900179386139,124.43737030029297,454.21640396118164,6597,1710,4887,4887,0,22,1769000.0
1769,1769999,21.32811693988708,37.80716442274938,0.08077561195192684,624.5331327915192,124.50470542907715,454.52917098999023,6602,1712,4890,4890,0,22,1770000.0
1770,1770999,21.325451992441106,37.80226429363469,0.08074459125810907,624.8286333084106,124.57248187065125,455.02033615112305,6636,1714,4922,4922,0,22,1771000.0
1771,1771999,21.323487143241575,37.801049301286525,0.08069344656633992,625.1042597293854,124.64012408256531,455.6154670715332,6639,1715,4924,4924,0,22,1772000.0
1772,1772999,21.322390538558576,37.7984095202332,0.08062988830944962,625.4186072349548,124.70680618286133,456.1410942077637,6639,1715,4924,4924,0,22,1773000.0
1773,1773999,21.32101469791477,37.796415964985826,0.08057764062899786,625.8438913822174,124.77476716041565,456.1042594909668,6639,1715,4924,4924,0,22,1774000.0
1774,1774999,21.320227244961128,37.79374288596426,0.08053120030331717,626.1769375801086,124.84201383590698,456.3097114562988,6641,1716,4925,4925,0,22,1775000.0
1775,1775999,21.320249100490468,37.79448658783103,0.08048019623332969,626.5872509479523,124.91056227684021,456.22961044311523,6644,1717,4927,4927,0,22,1776000.0
1776,1776999,21.321404830818686,37.79861719901537,0.08042545415138391,626.8270609378815,124.97663521766663,456.9158744812012,6644,1717,4927,4927,0,22,1777000.0
1777,1777999,21.322364276736845,37.79937383982515,0.08036944285164571,627.1577031612396,125.0430474281311,457.12805557250977,6644,1717,4927,4927,0,22,1778000.0
1778,1778999,21.32503891094338,37.80519232719598,0.08032616696336248,627.4071795940399,125.10943627357483,457.6609916687012,6644,1717,4927,4927,0,22,1779000.0
1779,1779999,21.328322062021975,37.81059554588809,0.08026900999656361,627.7459411621094,125.1780252456665,457.7815132141113,6646,1718,4928,4928,0,22,1780000.0
1780,1780999,21.33311825161862,37.820321713616536,0.08025074584115044,628.1939077377319,125.24689650535583,457.5797462463379,6646,1718,4928,4928,0,22,1781000.0
1781,1781999,21.338885081842545,37.83271734334701,0.08019689407766828,630.8775181770325,125.31610703468323,457.4576072692871,6649,1720,4929,4929,0,22,1782000.0
1782,1782999,21.344923764380976,37.844984008797525,0.08013904550277651,631.2089052200317,125.38513517379761,457.68872451782227,6652,1721,4931,4931,0,22,1783000.0
1783,1783999,21.348305192558772,37.848866128781516,0.08011304278471665,631.5836932659149,125.45236659049988,457.78149032592773,6655,1722,4933,4933,0,22,1784000.0
1784,1784999,21.34716370558342,37.84522565121157,0.08010461067228036,631.9181485176086,125.52287340164185,458.3328742980957,6667,1724,4943,4943,0,22,1785000.0
1785,1785999,21.344042968895813,37.842270528880505,0.08008406893442377,632.2094852924347,125.58870458602905,459.0660743713379,6667,1724,4943,4943,0,22,1786000.0
1786,1786999,21.340534175356552,37.837186850973474,0.08008215187615075,632.4291558265686,125.65586876869202,460.23349380493164,6682,1725,4957,4957,0,22,1787000.0
1787,1787999,21.337820078206207,37.83427007369631,0.08007407222643759,632.5861239433289,125.7227611541748,461.5485649108887,6682,1725,4957,4957,0,22,1788000.0
1788,1788999,21.335970872992164,37.83204405982995,0.08005061232128163,632.9037806987762,125.78947067260742,461.72307205200195,6689,1728,4961,4961,0,22,1789000.0
1789,1789999,21.33445917525499,37.829114927062044,0.08003536303799241,633.1664233207703,125.85752415657043,462.3283500671387,6693,1730,4963,4963,0,22,1790000.0
1790,1790999,21.331780407600284,37.82316485203666,0.08002979405119182,633.6347994804382,125.9271891117096,462.0814628601074,6693,1730,4963,4963,0,22,1791000.0
1791,1791999,21.329832977219066,37.819304546134916,0.08002511617408825,633.8850500583649,125.99400639533997,462.7723960876465,6694,1730,4964,4964,0,22,1792000.0
1792,1792999,21.327115732558255,37.81327676994609,0.08003183147262694,634.2887082099915,126.06098937988281,462.6121253967285,6696,1731,4965,4965,0,22,1793000.0
1793,1793999,21.325986290036127,37.82016179579366,0.07996474716366853,634.623420715332,126.1298975944519,462.89318466186523,6696,1731,4965,4965,0,22,1794000.0
1794,1794999,21.325199484835206,37.81738175347416,0.07997118514103563,635.1307034492493,126.19812798500061,462.3852653503418,6698,1732,4966,4966,0,22,1795000.0
1795,1795999,21.323445069851118,37.81229419535966,0.07997033807549958,635.4743604660034,126.26529431343079,462.65378189086914,6698,1732,4966,4966,0,22,1796000.0
1796,1796999,21.322549967414542,37.80924615203016,0.07995945155978568,635.7355434894562,126.33543610572815,463.2161979675293,6698,1732,4966,4966,0,22,1797000.0
1797,1797999,21.321151728416353,37.804674187842345,0.07996404193849393,636.0417900085449,126.4029176235199,463.54382705688477,6705,1733,4972,4972,0,22,1798000.0
1798,1798999,21.31989430190317,37.80077260131546,0.07996413577280836,636.4706535339355,126.47034430503845,463.26366806030273,6705,1733,4972,4972,0,22,1799000.0
1799,1799999,21.31922179714363,37.79762839732745,0.07997966981171678,636.8401834964752,126.53944087028503,463.3805351257324,6707,1734,4973,4973,0,22,1800000.0
1800,1800999,21.31887718996565,37.80346496911958,0.07996815270355606,637.1369156837463,126.60700964927673,463.7038764953613,6709,1735,4974,4974,0,22,1801000.0
1801,1801999,21.317906541532164,37.800235996588206,0.07998019143566704,637.4802260398865,126.6747989654541,463.9229316711426,6709,1735,4974,4974,0,22,1802000.0
1802,1802999,21.31747387599938,37.796802476586535,0.07999144557945082,637.8169498443604,126.74222540855408,464.06116104125977,6709,1735,4974,4974,0,22,1803000.0
1803,1803999,21.315845787094567,37.792041691065755,0.08002187289432205,638.2513978481293,126.80997157096863,463.98898696899414,6709,1735,4974,4974,0,22,1804000.0
1804,1804999,21.31359482165882,37.786888710651795,0.0800327136333796,638.7215459346771,126.88037467002869,463.6351737976074,6711,1736,4975,4975,0,22,1805000.0
1805,1805999,21.311671053006247,37.78385069109538,0.07997251710798503,638.972865819931,126.9463860988617,465.2113914489746,6736,1737,4999,4999,0,22,1806000.0
1806,1806999,21.307637353915595,37.778425645933126,0.07998335173166593,639.2240469455719,127.01038265228271,466.2497673034668,6737,1737,5000,5000,0,22,1807000.0
1807,1807999,21.30583544860376,37.77749830656062,0.07995795537010619,639.4094536304474,127.07419037818909,467.3042106628418,6739,1738,5001,5001,0,22,1808000.0
1808,1808999,21.305975320681043,37.780405945643224,0.07994033667892475,639.7268798351288,127.14027786254883,467.64929580688477,6743,1740,5003,5003,0,22,1809000.0
1809,1809999,21.304774642166695,37.78133065821831,0.07994148580362559,640.0309998989105,127.20692229270935,467.950252532959,6749,1743,5006,5006,0,22,1810000.0
1810,1810999,21.304311179407726,37.782388465267495,0.080003408616665,640.2955074310303,127.27300715446472,468.6197624206543,6751,1744,5007,5007,0,22,1811000.0
1811,1811999,21.304816805050294,37.784674879129994,0.08005834683541924,640.7231752872467,127.34068560600281,468.52294540405273,6757,1747,5010,5010,0,22,1812000.0
1812,1812999,21.30494126093324,37.783741236797844,0.08012998350665856,640.9615297317505,127.4078733921051,469.3140983581543,6759,1748,5011,5011,0,22,1813000.0
1813,1813999,21.30408103337925,37.7821656937751,0.08014730209048948,641.3142623901367,127.4753110408783,469.0934410095215,6769,1753,5016,5016,0,22,1814000.0
1814,1814999,21.303400765298793,37.78195600812537,0.08019313073421097,641.606306552887,127.54229378700256,469.64746475219727,6771,1754,5017,5017,0,22,1815000.0
1815,1815999,21.30418292878584,37.784750441388084,0.08026554675845177,641.9042127132416,127.60760259628296,470.1259651184082,6771,1754,5017,5017,0,22,1816000.0
1816,1816999,21.304131248955137,37.782894202838435,0.0803079590145871,642.3403949737549,127.67555236816406,470.1426811218262,6771,1754,5017,5017,0,22,1817000.0
1817,1817999,21.30407559515658,37.78127742735066,0.08029819988832809,642.6245903968811,127.7422742843628,470.6759147644043,6773,1755,5018,5018,0,22,1818000.0
1818,1818999,21.306053779568103,37.788534083818654,0.08029269768264402,642.9629874229431,127.81007957458496,470.69753646850586,6777,1757,5020,5020,0,22,1819000.0
1819,1819999,21.30732724125744,37.788146686833755,0.08027224341551198,643.3888664245605,127.87653255462646,470.5355339050293,6779,1758,5021,5021,0,22,1820000.0
1820,1820999,21.308760618250513,37.787904572397196,0.08025773462094876,643.6862304210663,127.94235515594482,471.00988388061523,6781,1759,5022,5022,0,22,1821000.0
1821,1821999,21.311255973960908,37.790125302689084,0.08027556364733457,644.0582280158997,128.00923538208008,471.32178115844727,6781,1759,5022,5022,0,22,1822000.0
1822,1822999,21.31336656688823,37.79057746418358,0.08025115841167774,644.374897480011,128.07619428634644,471.65019607543945,6783,1760,5023,5023,0,22,1823000.0
1823,1823999,21.317951873734888,37.796006914287744,0.08026262354483682,644.7603442668915,128.14410758018494,471.78410720825195,6783,1760,5023,5023,0,22,1824000.0
1824,1824999,21.32029872049306,37.796550134524075,0.08027722362703626,645.1086838245392,128.2130389213562,472.0615348815918,6784,1760,5024,5024,0,22,1825000.0
1825,1825999,21.319509664593088,37.79337977226968,0.0802540721517464,645.4515221118927,128.27952241897583,472.7273139953613,6793,1760,5033,5033,0,22,1826000.0
1826,1826999,21.31557616170171,37.78950484002547,0.08025085930313547,645.823974609375,128.34659934043884,473.16118240356445,6810,1762,5048,5048,0,22,1827000.0
1827,1827999,21.311929259051915,37.784806246923154,0.0802557155213941,646.0058052539825,128.41389989852905,474.4726371765137,6814,1763,5051,5051,0,22,1828000.0
1828,1828999,21.310120960956244,37.78476587887458,0.08022830076023357,646.1584839820862,128.48037481307983,475.8488426208496,6814,1763,5051,5051,0,22,1829000.0
1829,1829999,21.3066686732615,37.7783108469341,0.08022279074152638,646.3837008476257,128.54696917533875,476.5083351135254,6816,1764,5052,5052,0,22,1830000.0
1830,1830999,21.30505766354036,37.78628974560996,0.08015067216728378,646.745530128479,128.61515021324158,476.5829963684082,6821,1766,5055,5055,0,22,1831000.0
1831,1831999,21.30322524414842,37.7820999043071,0.08014351126223929,647.0888710021973,128.68219804763794,476.76652908325195,6823,1767,5056,5056,0,22,1832000.0
1832,1832999,21.302172771492017,37.78127472386465,0.08011573156851137,647.420952796936,128.74865198135376,477.0139503479004,6826,1768,5058,5058,0,22,1833000.0
1833,1833999,21.30128917724685,37.77839407179305,0.0801090953744561,647.7337441444397,128.81661748886108,477.459659576416,6826,1768,5058,5058,0,22,1834000.0
1834,1834999,21.3012846075009,37.777485408808474,0.08009967475920743,648.0611162185669,128.8845043182373,477.61711502075195,6828,1769,5059,5059,0,22,1835000.0
1835,1835999,21.302955563272118,37.778803032219066,0.08011942482430368,648.3854041099548,128.95161294937134,477.85122299194336,6830,1770,5060,5060,0,22,1836000.0
1836,1836999,21.304420543115427,37.78070744854839,0.08017081716962549,648.9220309257507,129.01964116096497,477.20727157592773,6834,1772,5062,5062,0,22,1837000.0
1837,1837999,21.306496552603285,37.783366945596434,0.0802114288844279,649.2135941982269,129.08647441864014,477.5537223815918,6839,1774,5065,5065,0,22,1838000.0
1838,1838999,21.308800426102994,37.78589398370472,0.08023820791506275,649.5562083721161,129.15495991706848,477.7276039123535,6839,1774,5065,5065,0,22,1839000.0
1839,1839999,21.31234156279287,37.79029807902381,0.08030643200107768,649.8338451385498,129.22318696975708,478.14413833618164,6841,1775,5066,5066,0,22,1840000.0
1840,1840999,21.316438605451356,37.79758536559261,0.08037189209280071,650.1739664077759,129.2911319732666,478.2980079650879,6841,1775,5066,5066,0,22,1841000.0
1841,1841999,21.321962185925212,37.80536294884476,0.08046157101457785,650.6313886642456,129.35961890220642,478.1324882507324,6843,1776,5067,5067,0,22,1842000.0
1842,1842999,21.327394630440303,37.811373217315534,0.0805522928876824,650.9938387870789,129.42858600616455,478.3903923034668,6876,1778,5098,5098,0,22,1843000.0
1843,1843999,21.33411980099627,37.82082728558177,0.08065017462560675,651.4440450668335,129.49766421318054,478.1968803405762,6878,1779,5099,5099,0,22,1844000.0
1844,1844999,21.34095020568594,37.84014161123876,0.08069446671769731,651.7020058631897,129.5668683052063,478.8139762878418,6880,1780,5100,5100,0,22,1845000.0
1845,1845999,21.34462080716546,37.84499511598862,0.08073855089044268,651.9630718231201,129.63483691215515,479.43061447143555,6880,1780,5100,5100,0,22,1846000.0
1846,1846999,21.34443189988069,37.84280405167394,0.08070756298056592,652.2995467185974,129.70262455940247,480.0157356262207,6893,1782,5111,5111,0,22,1847000.0
1847,1847999,21.340857327626235,37.837859085443945,0.08070319316502728,652.5393266677856,129.76965999603271,480.9106025695801,6894,1782,5112,5112,0,22,1848000.0
1848,1848999,21.337213706778403,37.83162404445175,0.0807003402309856,652.7882926464081,129.83673357963562,481.6320457458496,6895,1782,5113,5113,0,22,1849000.0
1849,1849999,21.33407931164749,37.82776763056267,0.08070153305630978,653.0881037712097,129.90356302261353,482.01235580444336,6895,1782,5113,5113,0,22,1850000.0
1850,1850999,21.33109110608851,37.82282141153417,0.08068745340063777,653.5055675506592,129.97228336334229,481.83952713012695,6899,1784,5115,5115,0,22,1851000.0
1851,1851999,21.328469290676757,37.81728959086317,0.0806768157065243,653.9019668102264,130.03996324539185,481.972957611084,6901,1785,5116,5116,0,22,1852000.0
1852,1852999,21.325440587750457,37.8118224495618,0.08067352533933225,654.2107894420624,130.10830307006836,482.40796279907227,6901,1785,5116,5116,0,22,1853000.0
1853,1853999,21.32296780177325,37.80697219711824,0.08065977378134193,654.5656163692474,130.17646408081055,482.64462661743164,6901,1785,5116,5116,0,22,1854000.0
1854,1854999,21.32104888972016,37.802180812396855,0.08064669531235857,654.9288582801819,130.24455618858337,482.6021537780762,6903,1787,5116,5116,0,22,1855000.0
1855,1855999,21.320372800466874,37.799639403131984,0.08062258539928391,655.338249206543,130.3148136138916,482.49968338012695,6905,1788,5117,5117,0,22,1856000.0
1856,1856999,21.319126588397985,37.796029780209714,0.08061061970087202,655.7448072433472,130.38413381576538,482.53342056274414,6905,1788,5117,5117,0,22,1857000.0
1857,1857999,21.31889125843258,37.794965278976896,0.08061228163346468,656.1189484596252,130.45416021347046,482.40990829467773,6911,1791,5120,5120,0,22,1858000.0
1858,1858999,21.3184656139514,37.79261341401305,0.0806833421580212,656.3718147277832,130.52575635910034,483.11886978149414,6911,1791,5120,5120,0,22,1859000.0
1859,1859999,21.31949377705444,37.794260666662545,0.08073525445526564,656.8240456581116,130.596009016037,482.93481826782227,6915,1793,5122,5122,0,22,1860000.0
1860,1860999,21.320764900927507,37.794283159591984,0.08075761860739483,657.1188156604767,130.6669566631317,483.41940689086914,6915,1793,5122,5122,0,22,1861000.0
1861,1861999,21.32353210079374,37.79732221197949,0.0808151871908458,657.6831052303314,130.73928546905518,482.823184967041,6917,1794,5123,5123,0,22,1862000.0
1862,1862999,21.325440778257793,37.79809807795468,0.08091763996392742,657.9821965694427,130.8087899684906,483.14033126831055,6918,1795,5123,5123,0,22,1863000.0
1863,1863999,21.327928795383865,37.7990929478297,0.08099870456038516,658.3877108097076,130.88164615631104,483.10190200805664,6920,1796,5124,5124,0,22,1864000.0
1864,1864999,21.331579842948486,37.80242244896945,0.08101692488938916,658.745964050293,130.95214104652405,483.2967414855957,6920,1796,5124,5124,0,22,1865000.0
1865,1865999,21.33471483206072,37.804253732361104,0.08103907670060817,659.1659021377563,131.02536010742188,483.0903434753418,6923,1798,5125,5125,0,22,1866000.0
1866,1866999,21.33649422723972,37.803315126486886,0.08103574662442325,659.5062599182129,131.09687638282776,483.3232078552246,6925,1799,5126,5126,0,22,1867000.0
1867,1867999,21.333952480130144,37.803706607131545,0.08102496910005708,659.7514555454254,131.16405081748962,484.41421127319336,6943,1800,5143,5143,0,22,1868000.0
1868,1868999,21.32980077014741,37.8040045361171,0.08065842243757448,659.983505487442,131.2298641204834,485.77672958374023,6968,1801,5167,5167,0,22,1869000.0
1869,1869999,21.326634675636118,37.8033171564479,0.08059749666464278,660.2162210941315,131.2947986125946,486.95495223999023,6976,1802,5174,5174,0,22,1870000.0
1870,1870999,21.322953329397908,37.79749872529697,0.08060634843357994,660.3941884040833,131.35987210273743,488.25451278686523,6976,1802,5174,5174,0,22,1871000.0
1871,1871999,21.319273427273792,37.79104731046271,0.08061340342419432,660.566269159317,131.42421340942383,489.55398178100586,6981,1802,5179,5179,0,22,1872000.0
1872,1872999,21.315491348309248,37.78491706552593,0.08061795289902984,660.873987197876,131.48911905288696,490.15988540649414,6984,1803,5181,5181,0,22,1873000.0
1873,1873999,21.312075287014583,37.77822297982038,0.08064192214480648,661.1667153835297,131.55590438842773,490.6374626159668,6986,1804,5182,5182,0,22,1874000.0
1874,1874999,21.309332139607438,37.773978844905464,0.080632571430719,661.5256617069244,131.62282252311707,490.8531684875488,6992,1807,5185,5185,0,22,1875000.0
1875,1875999,21.30701503794046,37.768825120307454,0.08063881516443627,661.7573781013489,131.68871808052063,491.6062355041504,6996,1809,5187,5187,0,22,1876000.0
1876,1876999,21.30505584062543,37.765467572535634,0.08062946334540155,662.067734003067,131.75488686561584,491.84143447875977,7000,1811,5189,5189,0,22,1877000.0
1877,1877999,21.303365718589905,37.76383481466509,0.08060932796044817,662.3540782928467,131.82190918922424,492.25461196899414,7004,1813,5191,5191,0,22,1878000.0
1878,1878999,21.302236911421545,37.76181171855773,0.08061630732553227,662.811295747757,131.88947010040283,491.9913749694824,7006,1814,5192,5192,0,22,1879000.0
1879,1879999,21.301496967211218,37.75980082007337,0.08062188440651796,663.0444538593292,131.9565393924713,492.77807998657227,7008,1815,5193,5193,0,22,1880000.0
1880,1880999,21.301263621565138,37.76329791863896,0.08063702580024124,663.311363697052,132.02287435531616,493.35422134399414,7009,1815,5194,5194,0,22,1881000.0
1881,1881999,21.30098778557108,37.76172921408021,0.08064192628595523,663.6442987918854,132.09097981452942,493.46538162231445,7013,1817,5196,5196,0,22,1882000.0
1882,1882999,21.301909314240913,37.76134165936111,0.08065904805271396,663.9179406166077,132.1587975025177,493.97868728637695,7015,1818,5197,5197,0,22,1883000.0
1883,1883999,21.301664089850366,37.75891160034306,0.08074237940734474,664.2579216957092,132.22657418251038,494.1803398132324,7017,1819,5198,5198,0,22,1884000.0
1884,1884999,21.303178780818115,37.759905028520016,0.08080976626665215,667.1930394172668,132.293927192688,493.83212661743164,7021,1821,5200,5200,0,22,1885000.0
1885,1885999,21.304203315763978,37.7592820408578,0.0808587335409906,667.5116665363312,132.36054253578186,494.0894966125488,7025,1823,5202,5202,0,22,1886000.0
1886,1886999,21.304465820536933,37.75712479584606,0.08090388154678729,667.8531460762024,132.4270839691162,494.35180282592773,7027,1824,5203,5203,0,22,1887000.0
1887,1887999,21.30477872774843,37.754887386197915,0.0809401602012515,668.2445116043091,132.49423909187317,494.3592720031738,7029,1825,5204,5204,0,22,1888000.0
1888,1888999,21.302218027731904,37.74925129309242,0.08093763643273155,668.513504743576,132.56057286262512,495.3627510070801,7042,1827,5215,5215,0,22,1889000.0
1889,1889999,21.29798120580695,37.74256757863824,0.08095751824688424,668.7582161426544,132.62593269348145,496.34599685668945,7044,1827,5217,5217,0,22,1890000.0
1890,1890999,21.295556653708804,37.73933191003798,0.08095126332732028,669.013587474823,132.69136357307434,497.0218696594238,7044,1827,5217,5217,0,22,1891000.0
1891,1891999,21.292374240981243,37.73357672935543,0.08095412573854566,669.3744361400604,132.75923776626587,497.22939682006836,7044,1827,5217,5217,0,22,1892000.0
1892,1892999,21.289211340807274,37.727651388112825,0.08094783737149303,669.7268514633179,132.82549142837524,497.49194717407227,7045,1827,5218,5218,0,22,1893000.0
1893,1893999,21.286865179539024,37.72365369924215,0.08093595359188688,670.0969831943512,132.89242506027222,497.4533500671387,7049,1829,5220,5220,0,22,1894000.0
1894,1894999,21.284357137717407,37.72146550416812,0.08092256566940825,670.3906426429749,132.96034932136536,498.0094337463379,7049,1829,5220,5220,0,22,1895000.0
1895,1895999,21.282100304726523,37.71895901345626,0.08090824298314059,670.7801134586334,133.02728247642517,498.0226020812988,7051,1830,5221,5221,0,22,1896000.0
1896,1896999,21.279709030832755,37.714184931668065,0.0808981926969482,671.1206052303314,133.09481596946716,498.1842231750488,7052,1831,5221,5221,0,22,1897000.0
1897,1897999,21.27697664465566,37.70907027681626,0.0808881689284332,671.5552325248718,133.16301274299622,497.9748115539551,7056,1833,5223,5223,0,22,1898000.0
1898,1898999,21.27535058557168,37.705953225343976,0.08086304779778253,671.8976585865021,133.2309808731079,498.259090423584,7056,1833,5223,5223,0,22,1899000.0
1899,1899999,21.273260139750363,37.70392415973104,0.08084475487963572,672.2933194637299,133.30001544952393,498.29472732543945,7058,1834,5224,5224,0,22,1900000.0
1900,1900999,21.2706836050006,37.69807701439735,0.080838314580299,672.6016099452972,133.36773872375488,498.7201728820801,7058,1834,5224,5224,0,22,1901000.0
1901,1901999,21.2686623728285,37.69319106153477,0.08083119542492934,672.8988664150238,133.43517804145813,499.1323432922363,7058,1834,5224,5224,0,22,1902000.0
1902,1902999,21.2673439581408,37.68907789101749,0.08081974357884958,673.2912783622742,133.5046215057373,499.0228385925293,7059,1835,5224,5224,0,22,1903000.0
1903,1903999,21.26668094907561,37.68568752426471,0.08081437538484948,673.8035500049591,133.57423043251038,498.61469650268555,7061,1836,5225,5225,0,22,1904000.0
1904,1904999,21.265037121274197,37.68083955123111,0.08081414146543375,674.155900478363,133.64228510856628,498.8381996154785,7061,1836,5225,5225,0,22,1905000.0
1905,1905999,21.263404678259544,37.67612276433305,0.08081079225831989,674.4945621490479,133.71055722236633,498.97094345092773,7062,1837,5225,5225,0,22,1906000.0
1906,1906999,21.260367543741637,37.67101570165415,0.08081039743992513,674.8999207019806,133.78251910209656,499.4289436340332,7075,1838,5237,5237,0,22,1907000.0
1907,1907999,21.2560456989893,37.66576561230483,0.08083120588389758,675.1659669876099,133.84875679016113,500.22375106811523,7082,1840,5242,5242,0,22,1908000.0
1908,1908999,21.251614004205496,37.66070629085747,0.0808575934922614,675.3996305465698,133.91518139839172,501.0221061706543,7082,1840,5242,5242,0,22,1909000.0
1909,1909999,21.247462788242498,37.655364351288554,0.08087673522651073,675.7129337787628,133.98244500160217,501.3584098815918,7084,1841,5243,5243,0,22,1910000.0
1910,1910999,21.243137795928575,37.64931066372078,0.08090928090673999,676.0388286113739,134.04896545410156,501.8877983093262,7099,1842,5257,5257,0,22,1911000.0
1911,1911999,21.239052890428514,37.64266188272439,0.08094861276852416,676.3975148200989,134.11688375473022,502.1528129577637,7116,1844,5272,5272,0,22,1912000.0
1912,1912999,21.2343548122967,37.63535887899071,0.08098099716703766,676.7443079948425,134.18772959709167,502.7737464904785,7119,1845,5274,5274,0,22,1913000.0
1913,1913999,21.23063863989797,37.62930808191815,0.0810026474938561,677.0696272850037,134.25436162948608,503.22167587280273,7121,1846,5275,5275,0,22,1914000.0
1914,1914999,21.227330050141703,37.628570867214236,0.08099520926611037,677.2641985416412,134.32226133346558,504.15908432006836,7123,1847,5276,5276,0,22,1915000.0
1915,1915999,21.224370444165444,37.625138688623956,0.08098832843834725,677.5400390625,134.3900010585785,504.69692611694336,7125,1848,5277,5277,0,22,1916000.0
1916,1916999,21.22105079589842,37.61986899334101,0.0809959536646534,677.9150204658508,134.45644354820251,504.5983543395996,7129,1850,5279,5279,0,22,1917000.0
1917,1917999,21.218114045169106,37.61566229991214,0.0809993383744182,678.2751297950745,134.52346181869507,504.77033615112305,7131,1851,5280,5280,0,22,1918000.0
1918,1918999,21.215899109550193,37.62450695278774,0.0809236212053801,678.5283899307251,134.59085130691528,505.5032386779785,7131,1851,5280,5280,0,22,1919000.0
1919,1919999,21.21399134126374,37.6218321378278,0.08091067960549403,678.905713558197,134.65850400924683,505.7227973937988,7132,1851,5281,5281,0,22,1920000.0
1920,1920999,21.212782096106825,37.62099452633236,0.08088672853361567,679.2480340003967,134.72540664672852,506.03227615356445,7132,1851,5281,5281,0,22,1921000.0
1921,1921999,21.211097610918188,37.62036896877164,0.08087270432877192,679.6196949481964,134.79262590408325,506.07614517211914,7134,1852,5282,5282,0,22,1922000.0
1922,1922999,21.208831046955012,37.615409065527935,0.0808756442155627,679.9181444644928,134.8625066280365,506.5786552429199,7134,1852,5282,5282,0,22,1923000.0
1923,1923999,21.20733932748654,37.61211737558499,0.08087980098988568,680.2105767726898,134.9297058582306,506.98647689819336,7134,1852,5282,5282,0,22,1924000.0
1924,1924999,21.205062625089457,37.60766347147429,0.08086492897798969,680.5561053752899,134.99678301811218,507.0834159851074,7136,1853,5283,5283,0,22,1925000.0
1925,1925999,21.2026063082174,37.602876077581755,0.08086439920163269,680.9476590156555,135.06760907173157,507.0964546203613,7148,1856,5292,5292,0,22,1926000.0
1926,1926999,21.198991057209433,37.600039621696254,0.08085359172073825,681.1883735656738,135.13422513008118,508.2005805969238,7159,1857,5302,5302,0,22,1927000.0
1927,1927999,21.193753925888096,37.59545251577164,0.08086736568391573,681.4757425785065,135.20026183128357,508.8974494934082,7159,1857,5302,5302,0,22,1928000.0
1928,1928999,21.18878826106479,37.5888177271642,0.08089058438896168,681.7568967342377,135.2669620513916,509.7573127746582,7176,1859,5317,5317,0,22,1929000.0
1929,1929999,21.184666523980177,37.58483923401951,0.08090239750040651,681.9069821834564,135.33417916297913,511.0962715148926,7176,1859,5317,5317,0,22,1930000.0
1930,1930999,21.180232527370308,37.57824574495321,0.08091961719010032,682.1335918903351,135.40140175819397,511.8728218078613,7179,1860,5319,5319,0,22,1931000.0
1931,1931999,21.175651755601862,37.57123592140561,0.08094115559563864,682.5798318386078,135.4690215587616,511.5420722961426,7183,1862,5321,5321,0,22,1932000.0
1932,1932999,21.171462980896514,37.56444860355707,0.08095271129977488,682.7749574184418,135.53657364845276,512.3828468322754,7183,1862,5321,5321,0,22,1933000.0
1933,1933999,21.16726112501042,37.5583517913778,0.08096599394273674,683.1966848373413,135.60333776474,512.2398643493652,7183,1862,5321,5321,0,22,1934000.0
1934,1934999,21.1635195968732,37.553018366375525,0.08096669412903257,683.5783619880676,135.6751766204834,512.3102378845215,7187,1864,5323,5323,0,22,1935000.0
1935,1935999,21.159269842761248,37.546640568539665,0.08098474256188981,683.949741601944,135.7428834438324,512.1821174621582,7195,1867,5328,5328,0,22,1936000.0
1936,1936999,21.155691258218305,37.540887151435044,0.08099557339903118,684.3685369491577,135.8114354610443,512.192310333252,7195,1867,5328,5328,0,22,1937000.0
1937,1937999,21.153012484562538,37.538224811175745,0.08098984420991762,684.6644637584686,135.88011717796326,512.6155128479004,7195,1867,5328,5328,0,22,1938000.0
1938,1938999,21.14922136025193,37.53284838199521,0.08099800460192208,684.9624853134155,135.95420670509338,513.0542411804199,7195,1867,5328,5328,0,22,1939000.0
1939,1939999,21.14610195519022,37.527301229425035,0.08100326480832509,685.4439771175385,136.02189779281616,512.5764808654785,7195,1867,5328,5328,0,22,1940000.0
1940,1940999,21.143142535299372,37.52312610776363,0.08100071365969164,685.7761790752411,136.09095239639282,512.680347442627,7199,1869,5330,5330,0,22,1941000.0
1941,1941999,21.140771207772246,37.5194291904414,0.08100055176910204,686.1480286121368,136.15857577323914,512.8180351257324,7199,1869,5330,5330,0,22,1942000.0
1942,1942999,21.138174287786356,37.514221870427754,0.0810007799735617,686.4414710998535,136.22711491584778,513.2898292541504,7199,1869,5330,5330,0,22,1943000.0
1943,1943999,21.136294037692455,37.513791021535916,0.08097387845162907,686.9151511192322,136.2964208126068,512.8172264099121,7203,1871,5332,5332,0,22,1944000.0
1944,1944999,21.133819505226423,37.50847828003673,0.08098402309258712,687.233011007309,136.36418843269348,513.1835975646973,7203,1871,5332,5332,0,22,1945000.0
1945,1945999,21.131095460974333,37.50314641578917,0.08098722419433668,687.6569097042084,136.43668150901794,513.204517364502,7203,1871,5332,5332,0,22,1946000.0
1946,1946999,21.127764862704908,37.49738684386367,0.08098632212826007,688.1212713718414,136.50801944732666,513.1284523010254,7203,1871,5332,5332,0,22,1947000.0
1947,1947999,21.124565046843536,37.49190843084007,0.08098853714667431,688.3152782917023,136.5735297203064,514.9370918273926,7227,1871,5356,5356,0,22,1948000.0
1948,1948999,21.11974059020983,37.485699592531006,0.08100407031414392,688.4622826576233,136.63821268081665,516.3400840759277,7227,1871,5356,5356,0,22,1949000.0
1949,1949999,21.11507954338253,37.479372295257676,0.08102418622937202,688.687136888504,136.70305371284485,516.9938697814941,7231,1873,5358,5358,0,22,1950000.0
1950,1950999,21.111206769962216,37.475307434162445,0.08102551625313381,688.9521670341492,136.76761031150818,517.5528907775879,7237,1876,5361,5361,0,22,1951000.0
1951,1951999,21.10718038833295,37.468575635563944,0.08103874736268701,689.2232995033264,136.83474898338318,517.982234954834,7241,1878,5363,5363,0,22,1952000.0
1952,1952999,21.103075471101576,37.462152915485184,0.08104973742489929,689.5823657512665,136.90137267112732,518.158634185791,7245,1880,5365,5365,0,22,1953000.0
1953,1953999,21.099017118196997,37.4557733420159,0.08106871753646439,689.9246025085449,136.96842694282532,518.4936408996582,7249,1882,5367,5367,0,22,1954000.0
1954,1954999,21.094836781514136,37.44869491812756,0.08108232308745333,690.2219026088715,137.03474712371826,518.9559059143066,7249,1882,5367,5367,0,22,1955000.0
1955,1955999,21.090966830514983,37.443871530069266,0.0810780525392214,690.5811429023743,137.10335779190063,519.1813621520996,7249,1882,5367,5367,0,22,1956000.0
1956,1956999,21.087224028608667,37.43832516714701,0.0810981983744018,690.9098794460297,137.16883373260498,519.3703422546387,7251,1883,5368,5368,0,22,1957000.0
1957,1957999,21.08449046445272,37.43544068477365,0.08108923216748032,691.2013971805573,137.2352979183197,519.8143272399902,7251,1883,5368,5368,0,22,1958000.0
1958,1958999,21.08122548512335,37.4325311132516,0.08107786149141027,691.4889478683472,137.3029704093933,520.1833076477051,7253,1884,5369,5369,0,22,1959000.0
1959,1959999,21.078195180214603,37.4280755378132,0.08109672601254769,691.8217091560364,137.36919832229614,520.3829231262207,7255,1885,5370,5370,0,22,1960000.0
1960,1960999,21.075351961091247,37.42273265479886,0.08109459731627977,692.1606020927429,137.43436288833618,520.4905052185059,7257,1886,5371,5371,0,22,1961000.0
1961,1961999,21.07265740334225,37.417039964859875,0.0810986245448323,692.6368288993835,137.50230145454407,519.9896583557129,7263,1889,5374,5374,0,22,1962000.0
1962,1962999,21.070553867578134,37.41302243216836,0.08111172694425273,693.0698833465576,137.57074236869812,519.8236274719238,7267,1890,5377,5377,0,22,1963000.0
1963,1963999,21.068673413073288,37.409323246029324,0.0811019645054255,693.4103808403015,137.6396484375,519.9660758972168,7269,1891,5378,5378,0,22,1964000.0
1964,1964999,21.0661556930602,37.40397386327359,0.0811026823900931,693.8476395606995,137.7066798210144,519.7732963562012,7273,1893,5380,5380,0,22,1965000.0
1965,1965999,21.06490439845322,37.40354922339988,0.08109208522012523,694.3177237510681,137.77373695373535,519.4536170959473,7275,1894,5381,5381,0,22,1966000.0
1966,1966999,21.062233487829122,37.397991617344935,0.08109464028058166,694.4818804264069,137.84062218666077,520.5429801940918,7275,1894,5381,5381,0,22,1967000.0
1967,1967999,21.060361272145332,37.393515946632824,0.08110000555534991,694.7252161502838,137.90868043899536,521.3327293395996,7275,1894,5381,5381,0,22,1968000.0
1968,1968999,21.059918252350972,37.39630933326621,0.08106157645654999,694.9585883617401,137.9757843017578,522.5193138122559,7287,1895,5392,5392,0,22,1969000.0
1969,1969999,21.06024825614992,37.404027032245025,0.08104393759212847,695.2543828487396,138.04132676124573,523.1199150085449,7289,1895,5394,5394,0,22,1970000.0
1970,1970999,21.06056336706507,37.40522221777664,0.08108794503896521,695.5349252223969,138.1102216243744,523.9863243103027,7306,1897,5409,5409,0,22,1971000.0
1971,1971999,21.061959870485236,37.40862220256689,0.08119993916060797,695.7602093219757,138.17745876312256,524.9618721008301,7308,1898,5410,5410,0,22,1972000.0
1972,1972999,21.062799515888113,37.41138256490787,0.08135157223987666,696.1800429821014,138.24537777900696,524.598331451416,7321,1904,5417,5417,0,22,1973000.0
1973,1973999,21.06613566129771,37.422894661936745,0.08154428734283803,696.390636920929,138.31445264816284,525.5024070739746,7323,1905,5418,5418,0,22,1974000.0
1974,1974999,21.069326073973617,37.431457978360775,0.0817650133221548,696.6286933422089,138.38198518753052,526.2862434387207,7324,1905,5419,5419,0,22,1975000.0
1975,1975999,21.071807673588726,37.438647804616224,0.08197744229006076,697.0250296592712,138.44939041137695,525.9900398254395,7333,1909,5424,5424,0,22,1976000.0
1976,1976999,21.07382563532493,37.44377883239384,0.08218774820100072,697.3572976589203,138.51735067367554,526.279109954834,7335,1910,5425,5425,0,22,1977000.0
1977,1977999,21.07671424448365,37.45109841974072,0.08240314504347634,697.7820053100586,138.58566975593567,526.3624000549316,7335,1910,5425,5425,0,22,1978000.0
1978,1978999,21.07973040762252,37.45810881381545,0.08265136632607961,698.0767798423767,138.65278458595276,526.9618339538574,7335,1910,5425,5425,0,22,1979000.0
1979,1979999,21.083132285232097,37.47050662891409,0.08281055674184357,698.499449968338,138.72220134735107,526.7928276062012,7337,1911,5426,5426,0,22,1980000.0
1980,1980999,21.08632024160795,37.47667900175079,0.08289403856850242,698.7503616809845,138.79132103919983,527.3861351013184,7337,1911,5426,5426,0,22,1981000.0
1981,1981999,21.089506674383525,37.48049307061304,0.08294719785678739,699.0850396156311,138.86026430130005,527.678897857666,7337,1911,5426,5426,0,22,1982000.0
1982,1982999,21.093211744179737,37.487199893689045,0.08310423526446364,699.6884438991547,138.92943334579468,526.595760345459,7352,1915,5437,5437,0,22,1983000.0
1983,1983999,21.0973639681667,37.49521403403846,0.08314509123747815,700.0225257873535,138.99737668037415,527.0208549499512,7352,1915,5437,5437,0,22,1984000.0
1984,1984999,21.101074270098593,37.50135031721534,0.08322674308335332,700.3183968067169,139.06576323509216,527.5639305114746,7354,1916,5438,5438,0,22,1985000.0
1985,1985999,21.105908936574615,37.51113378111509,0.083300314437461,700.6536247730255,139.1357934474945,527.9127311706543,7354,1916,5438,5438,0,22,1986000.0
1986,1986999,21.110507734832062,37.51609570331535,0.08329101488807189,700.8906345367432,139.2031478881836,528.5484504699707,7356,1917,5439,5439,0,22,1987000.0
1987,1987999,21.11302501419555,37.516896270841265,0.08325526037337916,701.325270652771,139.2709310054779,528.4071083068848,7358,1918,5440,5440,0,22,1988000.0
1988,1988999,21.11027602824396,37.51544842424224,0.08322222041480831,701.5568323135376,139.3406093120575,529.8059501647949,7386,1920,5466,5466,0,22,1989000.0
1989,1989999,21.10777418600469,37.510860513380244,0.08322113597454783,701.7080376148224,139.4084436893463,531.3304481506348,7387,1920,5467,5467,0,22,1990000.0
1990,1990999,21.107161487125875,37.510884201810384,0.08320906687747032,701.9727993011475,139.47714948654175,532.1196784973145,7388,1920,5468,5468,0,22,1991000.0
1991,1991999,21.1057399363513,37.50739936979418,0.0832024675802987,702.1699604988098,139.54632472991943,532.9557762145996,7391,1921,5470,5470,0,22,1992000.0
1992,1992999,21.106374018711065,37.5082933240767,0.0831711005615895,702.6821784973145,139.61716604232788,532.2139472961426,7403,1927,5476,5476,0,22,1993000.0
1993,1993999,21.106832898958107,37.508504255030374,0.08318665463079522,702.905773639679,139.6883795261383,533.2564811706543,7403,1927,5476,5476,0,22,1994000.0
1994,1994999,21.108219357435424,37.51048836325172,0.08320386904176458,703.2393386363983,139.7585391998291,533.5875053405762,7405,1928,5477,5477,0,22,1995000.0
1995,1995999,21.110275765202736,37.51265542273249,0.08321166073789565,703.6228737831116,139.82796478271484,533.5467185974121,7412,1931,5481,5481,0,22,1996000.0
1996,1996999,21.11379796496883,37.51876035183804,0.08323553138918616,704.0931432247162,142.57330417633057,533.307788848877,7418,1934,5484,5484,0,22,1997000.0
1997,1997999,21.115998474880882,37.52205887084211,0.0833599961687117,704.3892664909363,142.6437451839447,533.9951057434082,7420,1935,5485,5485,0,22,1998000.0
1998,1998999,21.11954543756147,37.52835421544701,0.083569384856925,704.6410164833069,142.7143099308014,534.6971626281738,7422,1936,5486,5486,0,22,1999000.0
1999,1999999,21.123754880408953,37.53534108438111,0.0836951875336116,704.9783360958099,142.7853503227234,535.0482215881348,7422,1936,5486,5486,0,22,2000000.0
2000,2000999,21.12952785974097,37.54603207828462,0.0838066005707987,705.239904165268,142.8555600643158,535.6304206848145,7422,1936,5486,5486,0,22,2001000.0
2001,2001999,21.134868833404337,37.55571165974803,0.08395723241746433,705.7468252182007,142.92601823806763,535.2994117736816,7422,1936,5486,5486,0,22,2002000.0
2002,2002999,21.13921143356766,37.561750541570696,0.08416012131950734,706.051013469696,142.99552512168884,535.712833404541,7422,1936,5486,5486,0,22,2003000.0
2003,2003999,21.14469450244075,37.57684368394226,0.08425509826457378,706.4219415187836,143.0651135444641,535.886302947998,7422,1936,5486,5486,0,22,2004000.0
2004,2004999,21.150204213806983,37.58310891460648,0.08436671792246975,706.8147072792053,143.13580870628357,535.9525947570801,7422,1936,5486,5486,0,22,2005000.0
2005,2005999,21.156194644652494,37.591252743531,0.08448039232391447,707.168511390686,143.2064757347107,536.1651573181152,7424,1937,5487,5487,0,22,2006000.0
2006,2006999,21.163390174427164,37.601322308305384,0.08462123668061927,707.5540270805359,143.27825045585632,536.2048835754395,7426,1938,5488,5488,0,22,2007000.0
2007,2007999,21.167281477494203,37.604287842494514,0.08477381754183744,707.9106905460358,143.34895181655884,536.4002418518066,7426,1938,5488,5488,0,22,2008000.0
2008,2008999,21.168205829343666,37.60682726818606,0.08477244650418303,708.171128988266,143.41714596748352,537.498218536377,7449,1940,5509,5509,0,22,2009000.0
2009,2009999,21.164747701713264,37.60485659932809,0.08476446486827405,708.3957471847534,143.48181200027466,538.6184959411621,7460,1940,5520,5520,0,22,2010000.0
2010,2010999,21.161389564813508,37.59983441504819,0.08477430907761951,708.6524114608765,143.5468270778656,539.4242134094238,7468,1941,5527,5527,0,22,2011000.0
2011,2011999,21.158407225941353,37.59564020498799,0.08476570827450736,709.0422255992889,143.61291360855103,539.725643157959,7472,1942,5530,5530,0,22,2012000.0
2012,2012999,21.155825844808124,37.60325885486204,0.08469667486181265,709.2335307598114,143.68098044395447,540.9489784240723,7474,1942,5532,5532,0,22,2013000.0
2013,2013999,21.152446696357554,37.596936555449865,0.08469489256446605,709.5480482578278,143.7485568523407,541.5093955993652,7479,1944,5535,5535,0,22,2014000.0
2014,2014999,21.14959089109799,37.5920999703594,0.08468260271292338,709.7912740707397,143.81497597694397,542.1952323913574,7484,1946,5538,5538,0,22,2015000.0
2015,2015999,21.14703356169861,37.58701508281358,0.08467545907930074,710.1007466316223,143.88065934181213,542.727481842041,7488,1948,5540,5540,0,22,2016000.0
2016,2016999,21.14428086242671,37.58178773792436,0.08467164917288406,710.3982236385345,143.94668698310852,543.2008934020996,7492,1950,5542,5542,0,22,2017000.0
2017,2017999,21.142614206085213,37.580334307583385,0.08465549496087921,710.7206873893738,144.01506543159485,543.3749198913574,7498,1953,5545,5545,0,22,2018000.0
2018,2018999,21.141040272612624,37.57656039489858,0.08466472108327461,710.9659008979797,144.08216524124146,544.1158485412598,7500,1954,5546,5546,0,22,2019000.0
2019,2019999,21.140201685710252,37.57415736981626,0.08467492361533502,711.3852097988129,144.14945363998413,544.0028190612793,7502,1955,5547,5547,0,22,2020000.0
2020,2020999,21.14033137068904,37.5721707733915,0.08467222969947119,711.7234461307526,144.21741557121277,544.2298316955566,7504,1956,5548,5548,0,22,2021000.0
2021,2021999,21.140814632082826,37.572431897864995,0.08468106049408108,711.9394729137421,144.2833399772644,545.0513877868652,7505,1956,5549,5549,0,22,2022000.0
2022,2022999,21.1420554815868,37.57368227577496,0.08470017746426917,712.2231342792511,144.3506350517273,545.4656257629395,7507,1957,5550,5550,0,22,2023000.0
2023,2023999,21.144919515259225,37.58032181488307,0.0847472170652791,712.7238984107971,144.41976499557495,544.992748260498,7538,1958,5580,5580,0,22,2024000.0
2024,2024999,21.150321656633015,37.59305313948094,0.08481061681945645,713.0494782924652,144.48639297485352,545.5200157165527,7538,1958,5580,5580,0,22,2025000.0
2025,2025999,21.15655381978062,37.60452450217511,0.08491981295848672,713.451789855957,144.5534737110138,545.5406761169434,7538,1958,5580,5580,0,22,2026000.0
2026,2026999,21.161960905276803,37.617629517185776,0.08497102881212426,713.7744734287262,144.6219027042389,546.0097618103027,7545,1959,5586,5586,0,22,2027000.0
2027,2027999,21.165509090616716,37.622658779239735,0.08500169354964993,714.0219902992249,144.68830227851868,546.5473442077637,7549,1961,5588,5588,0,22,2028000.0
2028,2028999,21.166373763191842,37.62249807993102,0.08506341732283018,714.4373309612274,144.7559471130371,546.5434074401855,7551,1962,5589,5589,0,22,2029000.0
2029,2029999,21.165528635132986,37.62234885070796,0.08502018653435695,714.674574136734,144.82324314117432,547.765079498291,7564,1963,5601,5601,0,22,2030000.0
2030,2030999,21.16347434486656,37.61868787660321,0.08503158306989367,714.9277336597443,144.88951754570007,548.5643196105957,7565,1963,5602,5602,0,22,2031000.0
2031,2031999,21.160793814177698,37.61450349072346,0.08504208078754572,715.2476391792297,144.9558925628662,548.9843940734863,7565,1963,5602,5602,0,22,2032000.0
2032,2032999,21.159621152831612,37.61532793503678,0.08502108461346936,715.6356585025787,145.02321577072144,549.1721153259277,7573,1964,5609,5609,0,22,2033000.0
2033,2033999,21.157553809227217,37.610839637956786,0.08501332481550328,716.0695924758911,145.0903754234314,548.953197479248,7579,1967,5612,5612,0,22,2034000.0
2034,2034999,21.15564308162406,37.60688907672843,0.08499414744011147,716.3972249031067,145.15823698043823,549.3850746154785,7579,1967,5612,5612,0,22,2035000.0
2035,2035999,21.15440008204944,37.60351513232547,0.08498150737862697,716.7734274864197,145.2257924079895,549.4291954040527,7586,1970,5616,5616,0,22,2036000.0
2036,2036999,21.153246613938826,37.603926801831435,0.08496254349876764,717.1061129570007,145.2933337688446,549.7124900817871,7588,1972,5616,5616,0,22,2037000.0
2037,2037999,21.151909379663422,37.60193751733742,0.08493654914647808,717.5484471321106,145.36311984062195,549.5886726379395,7590,1973,5617,5617,0,22,2038000.0
2038,2038999,21.151202185101457,37.60454118221512,0.08489626216680424,717.9551723003387,145.4327187538147,549.6025886535645,7592,1974,5618,5618,0,22,2039000.0
2039,2039999,21.150782240074573,37.60717101348889,0.0848563511861321,718.3692829608917,145.50075268745422,549.5137596130371,7594,1975,5619,5619,0,22,2040000.0
2040,2040999,21.149279706264974,37.602520187606736,0.08483309961853835,718.6845135688782,145.5699586868286,550.0731086730957,7594,1975,5619,5619,0,22,2041000.0
2041,2041999,21.14831942935759,37.599213377703386,0.08482034061541555,719.0082914829254,145.63906335830688,550.460994720459,7594,1975,5619,5619,0,22,2042000.0
2042,2042999,21.147732489387195,37.595925255896454,0.08480876626097045,719.4051139354706,145.70725059509277,550.4620704650879,7596,1976,5620,5620,0,22,2043000.0
2043,2043999,21.14737706228521,37.59584617646868,0.08478530626636427,719.7091362476349,145.77602577209473,550.7033576965332,7598,1978,5620,5620,0,22,2044000.0
2044,2044999,21.146360808207564,37.595308357631,0.08477595908534741,720.247588634491,145.84577131271362,550.2665901184082,7598,1978,5620,5620,0,22,2045000.0
2045,2045999,21.145336738172215,37.59106687275106,0.08475922206776021,720.597305059433,145.9165334701538,550.5179100036621,7600,1979,5621,5621,0,22,2046000.0
2046,2046999,21.143453152638216,37.585796351939464,0.08475068947219955,721.0625088214874,145.98605155944824,550.3288841247559,7600,1979,5621,5621,0,22,2047000.0
2047,2047999,21.139886009833045,37.58019467471914,0.08475223827226408,721.2492201328278,146.05354189872742,551.8854637145996,7618,1980,5638,5638,0,22,2048000.0
2048,2048999,21.137970891580245,37.58046349293748,0.08470528321332527,721.4712393283844,146.11943173408508,553.1213493347168,7635,1982,5653,5653,0,22,2049000.0
2049,2049999,21.135882533357332,37.57654843746767,0.08470920666259751,721.6923372745514,146.18577241897583,554.1510734558105,7637,1983,5654,5654,0,22,2050000.0
2050,2050999,21.13378295358148,37.57381281534842,0.08469767175026577,721.9264698028564,146.25368928909302,554.9985008239746,7639,1984,5655,5655,0,22,2051000.0
2051,2051999,21.131783988714567,37.56988340673638,0.08468581924172491,722.273595571518,146.3202428817749,555.2126731872559,7645,1986,5659,5659,0,22,2052000.0
2052,2052999,21.129753928727588,37.570423917267206,0.08465588306229965,722.5604538917542,146.387446641922,555.6992683410645,7650,1988,5662,5662,0,22,2053000.0
2053,2053999,21.12997617285152,37.57347702089724,0.08463680778710991,722.8042652606964,146.45473885536194,556.4210090637207,7652,1988,5664,5664,0,22,2054000.0
2054,2054999,21.13000205210014,37.57666042629685,0.08461737664515301,723.265790939331,146.521897315979,556.1339073181152,7654,1989,5665,5665,0,22,2055000.0
2055,2055999,21.130335085414185,37.57726376106003,0.08458711127516161,723.5740764141083,146.5898895263672,556.4815788269043,7665,1991,5674,5674,0,22,2056000.0
2056,2056999,21.132364161249694,37.58374729137472,0.0845953437385153,724.0432553291321,146.65893721580505,555.9966316223145,7673,1995,5678,5678,0,22,2057000.0
2057,2057999,21.134212868513906,37.59145859933762,0.08462623555179216,724.3747193813324,146.7264108657837,556.2865257263184,7675,1996,5679,5679,0,22,2058000.0
2058,2058999,21.137845865419607,37.599638859303916,0.08467521401333633,724.6214005947113,146.79517364501953,557.0062599182129,7675,1996,5679,5679,0,22,2059000.0
2059,2059999,21.141839764932193,37.61122099300359,0.08471510732275,724.9851429462433,146.86235737800598,557.0644798278809,7679,1998,5681,5681,0,22,2060000.0
2060,2060999,21.14517363314212,37.61809566868477,0.08477515576805894,725.34375,146.9298620223999,557.3517036437988,7681,1999,5682,5682,0,22,2061000.0
2061,2061999,21.1481832263652,37.622049585579596,0.0847834971795639,725.812459230423,146.9992847442627,556.972713470459,7685,2001,5684,5684,0,22,2062000.0
2062,2062999,21.15332012190282,37.63240617776771,0.08484203456947026,726.1554675102234,147.06909799575806,557.2661018371582,7687,2002,5685,5685,0,22,2063000.0
2063,2063999,21.15767055013613,37.64513947017195,0.08491973819234921,726.4455237388611,147.13670134544373,557.8528327941895,7689,2003,5686,5686,0,22,2064000.0
2064,2064999,21.162364741344557,37.65384967703944,0.08493066889863643,726.6811907291412,147.2044596672058,558.5378913879395,7693,2004,5689,5689,0,22,2065000.0
2065,2065999,21.165469061933308,37.66242254582297,0.08476924715749656,727.0277690887451,147.27298617362976,558.743953704834,7694,2005,5689,5689,0,22,2066000.0
2066,2066999,21.16663753525689,37.67676167912687,0.0844781010711998,727.3505220413208,147.34057307243347,559.395679473877,7707,2007,5700,5700,0,22,2067000.0
2067,2067999,21.165673466856123,37.67617495416476,0.08445131604720901,727.634818315506,147.40733122825623,559.9382743835449,7711,2008,5703,5703,0,22,2068000.0
2068,2068999,21.16520943040658,37.67414512792992,0.08442773049806984,728.0029859542847,147.4757125377655,560.171085357666,7711,2008,5703,5703,0,22,2069000.0
2069,2069999,21.164835385036206,37.6736233069862,0.08441507115339264,728.3274383544922,147.5431845188141,560.4014930725098,7716,2010,5706,5706,0,22,2070000.0
2070,2070999,21.165125757908335,37.67802549914188,0.08437266341240846,728.7433860301971,147.61159014701843,560.1588249206543,7722,2013,5709,5709,0,22,2071000.0
2071,2071999,21.165003337344924,37.67725173971787,0.08436082562240255,729.0847084522247,147.67792558670044,560.5420112609863,7722,2013,5709,5709,0,22,2072000.0
2072,2072999,21.165328439714738,37.67650843726132,0.08436264354112277,729.4766082763672,147.7474880218506,560.5970726013184,7722,2013,5709,5709,0,22,2073000.0
2073,2073999,21.166540973496456,37.67793145024956,0.08438105528471562,729.7937476634979,147.81478357315063,560.9856758117676,7738,2015,5723,5723,0,22,2074000.0
2074,2074999,21.16744551705391,37.677861539887886,0.08439196147672468,730.1395225524902,147.8824872970581,561.0437965393066,7739,2016,5723,5723,0,22,2075000.0
2075,2075999,21.17031879342934,37.68196741607773,0.08443374625414823,730.5619506835938,147.9516944885254,560.7080879211426,7744,2019,5725,5725,0,22,2076000.0
2076,2076999,21.173937219393864,37.688634475880285,0.08448478993370778,730.9471845626831,148.0214340686798,560.8735008239746,7744,2019,5725,5725,0,22,2077000.0
2077,2077999,21.177063423365013,37.691783004538706,0.0845251433782106,731.3498978614807,148.09208297729492,560.8606910705566,7746,2020,5726,5726,0,22,2078000.0
2078,2078999,21.18019101804567,37.69447505980407,0.08459769431000086,731.645406961441,148.1610894203186,561.2900810241699,7746,2020,5726,5726,0,22,2079000.0
2079,2079999,21.184184678641856,37.702763409637704,0.08457169815740995,732.088098526001,148.22984433174133,561.091121673584,7746,2020,5726,5726,0,22,2080000.0
2080,2080999,21.18674077216987,37.70431126828867,0.0845890733817225,732.5262620449066,148.29930782318115,561.0133399963379,7746,2020,5726,5726,0,22,2081000.0
2081,2081999,21.18999666770367,37.70676008935308,0.08462075925275192,732.920282125473,148.367760181427,560.9127235412598,7766,2022,5744,5744,0,22,2082000.0
2082,2082999,21.19295727541772,37.71405511337656,0.08461125814065462,733.2089333534241,148.4386875629425,561.8523292541504,7768,2023,5745,5745,0,22,2083000.0
2083,2083999,21.195266315447764,37.71520298833614,0.08464264556027712,733.4217410087585,148.50773930549622,562.7047309875488,7768,2023,5745,5745,0,22,2084000.0
2084,2084999,21.19778273638013,37.71593282421816,0.08465809893527154,733.7944946289062,148.57760953903198,562.8955345153809,7769,2023,5746,5746,0,22,2085000.0
2085,2085999,21.199377625850264,37.72043016749308,0.08465567377904193,734.1316623687744,148.64623618125916,563.2500267028809,7769,2023,5746,5746,0,22,2086000.0
2086,2086999,21.197858253356642,37.71803621514887,0.0846173780944397,734.3323631286621,148.71320176124573,564.9892311096191,7793,2023,5770,5770,0,22,2087000.0
2087,2087999,21.193365163786034,37.71257542886844,0.08463699263450397,734.5190558433533,148.77903127670288,566.2079200744629,7796,2024,5772,5772,0,22,2088000.0
2088,2088999,21.189353616614195,37.7058610358323,0.08466333905617018,734.783203125,148.8437740802765,566.659854888916,7802,2027,5775,5775,0,22,2089000.0
2089,2089999,21.185973401849573,37.70179533940725,0.08466742604274491,735.0440211296082,148.91124272346497,567.407054901123,7805,2028,5777,5777,0,22,2090000.0
2090,2090999,21.181988935970892,37.69628821974731,0.08467744429186808,735.319619178772,148.97615265846252,567.9946479797363,7805,2028,5777,5777,0,22,2091000.0
2091,2091999,21.177654724866827,37.68970431388889,0.08469478237381955,735.7501790523529,149.04159712791443,567.7616004943848,7809,2030,5779,5779,0,22,2092000.0
2092,2092999,21.17425210628208,37.68424349948989,0.08469613883039506,736.0613396167755,149.1095097064972,568.1714744567871,7813,2032,5781,5781,0,22,2093000.0
2093,2093999,21.17059042052531,37.67838500383955,0.0847091833553939,736.3177359104156,149.17509126663208,568.8236274719238,7813,2032,5781,5781,0,22,2094000.0
2094,2094999,21.16775435518711,37.673431935011536,0.08471616450020614,736.7873458862305,149.24183082580566,568.3385810852051,7819,2035,5784,5784,0,22,2095000.0
2095,2095999,21.16483347324509,37.66832592911323,0.0847264765050787,737.1130821704865,149.31074714660645,568.6008415222168,7823,2037,5786,5786,0,22,2096000.0
2096,2096999,21.16315013903938,37.66520409108966,0.08473824736848579,737.3312270641327,149.38277792930603,569.3547172546387,7825,2038,5787,5787,0,22,2097000.0
2097,2097999,21.16174435867753,37.66228826270919,0.08474954665969037,737.7403523921967,149.44931769371033,569.3793830871582,7837,2040,5797,5797,0,22,2098000.0
2098,2098999,21.16109355985386,37.66107077284346,0.08474447936897056,737.9449641704559,149.51507234573364,570.0971641540527,7839,2041,5798,5798,0,22,2099000.0
2099,2099999,21.160924712384123,37.660195826054505,0.084746690633001,738.4046587944031,149.58257603645325,569.7833213806152,7841,2042,5799,5799,0,22,2100000.0
2100,2100999,21.160650733186323,37.65899717920991,0.08476999172607336,738.6887018680573,149.6499366760254,570.3310356140137,7843,2043,5800,5800,0,22,2101000.0
2101,2101999,21.16179110181337,37.66030301418459,0.08480078921224798,739.0530691146851,149.7174060344696,570.3020057678223,7845,2044,5801,5801,0,22,2102000.0
2102,2102999,21.16471396346302,37.66436332999615,0.08481090570669136,739.6343560218811,149.78525686264038,569.5329475402832,7851,2047,5804,5804,0,22,2103000.0
2103,2103999,21.16754147500252,37.66809899931047,0.08485565097957681,740.0622889995575,149.85509300231934,569.5492973327637,7855,2048,5807,5807,0,22,2104000.0
2104,2104999,21.169506494164356,37.670705601402595,0.08489567532267428,740.416074514389,149.9246973991394,569.612735748291,7863,2051,5812,5812,0,22,2105000.0
2105,2105999,21.170665437223338,37.671341729947365,0.08491039380186349,740.7495143413544,149.99141573905945,570.0996742248535,7863,2051,5812,5812,0,22,2106000.0
2106,2106999,21.16911345408188,37.6673646353756,0.08490108347587,741.0396139621735,150.05801653862,570.9959907531738,7873,2052,5821,5821,0,22,2107000.0
2107,2107999,21.1650628620075,37.66250146948503,0.08491486145123062,741.3197596073151,150.12449836730957,571.6815757751465,7876,2053,5823,5823,0,22,2108000.0
2108,2108999,21.161883337455585,37.65811277216769,0.0849140844652535,741.6021037101746,150.19074988365173,572.5791358947754,7895,2055,5840,5840,0,22,2109000.0
2109,2109999,21.160093979493592,37.659341952726095,0.08488788896662969,741.7867259979248,150.2575933933258,573.7911186218262,7896,2055,5841,5841,0,22,2110000.0
2110,2110999,21.156562778239795,37.65337516848674,0.08488794196144156,742.0786683559418,150.3248646259308,574.2976112365723,7900,2057,5843,5843,0,22,2111000.0
2111,2111999,21.154122171485735,37.65111691878752,0.08487226298050288,742.3618836402893,150.39300775527954,574.8198356628418,7905,2059,5846,5846,0,22,2112000.0
2112,2112999,21.150825750659433,37.64529674101177,0.08486947461941252,742.7639944553375,150.4596049785614,574.8120460510254,7905,2059,5846,5846,0,22,2113000.0
2113,2113999,21.148093153271027,37.640568647555455,0.0848536888746364,743.1001007556915,150.52747797966003,575.1531562805176,7906,2059,5847,5847,0,22,2114000.0
2114,2114999,21.14525681733909,37.63550567728129,0.08484422676185654,743.4317240715027,150.5944094657898,575.4271965026855,7906,2059,5847,5847,0,22,2115000.0
2115,2115999,21.14328712123486,37.63135513565389,0.08482336016713055,743.7974593639374,150.66368961334229,575.6458930969238,7906,2059,5847,5847,0,22,2116000.0
2116,2116999,21.141198499594108,37.62692964119908,0.08479904406421035,744.1756322383881,150.7312982082367,575.6508750915527,7908,2060,5848,5848,0,22,2117000.0
2117,2117999,21.139484548303532,37.62339890831728,0.0847729273015767,744.5758357048035,150.80072498321533,575.687442779541,7939,2061,5878,5878,0,22,2118000.0
2118,2118999,21.138428278349572,37.62177991537015,0.08474411119232261,744.9115376472473,150.86933398246765,575.9521675109863,7939,2061,5878,5878,0,22,2119000.0
2119,2119999,21.13723919379986,37.61896306542563,0.08471778261267082,745.4265310764313,153.81634664535522,575.3080177307129,7952,2065,5887,5887,0,22,2120000.0
2120,2120999,21.136104439288964,37.615888011563904,0.08470530868148307,745.6265046596527,153.88531136512756,576.149730682373,7952,2065,5887,5887,0,22,2121000.0
2121,2121999,21.1357063165077,37.61479693788579,0.08467498028974851,745.8694875240326,153.9530544281006,576.7133827209473,7952,2065,5887,5887,0,22,2122000.0
2122,2122999,21.13529967701667,37.61227977506429,0.08466602989347305,746.1189377307892,154.01947832107544,577.2775230407715,7952,2065,5887,5887,0,22,2123000.0
2123,2123999,21.135192035318127,37.61062132635338,0.08465890618577088,746.7702677249908,154.09104013442993,575.984447479248,7958,2068,5890,5890,0,22,2124000.0
2124,2124999,21.13534504846582,37.60979497061136,0.08466890422964934,747.0880033969879,154.1595630645752,576.242000579834,7962,2070,5892,5892,0,22,2125000.0
2125,2125999,21.135381539334013,37.608251016389076,0.08466939028574849,747.5646245479584,154.2290985584259,575.9256019592285,7964,2071,5893,5893,0,22,2126000.0
2126,2126999,21.134038974922504,37.604795282031816,0.08465923838411837,747.9018874168396,154.29740524291992,576.257022857666,7966,2072,5894,5894,0,22,2127000.0
2127,2127999,21.129866528915326,37.597808534590996,0.08469888540525672,748.135505437851,154.36667275428772,577.4170875549316,7978,2073,5905,5905,0,22,2128000.0
2128,2128999,21.12503190929249,37.590813233788325,0.08473846457214995,748.4795188903809,154.43404936790466,577.6198081970215,7999,2076,5923,5923,0,22,2129000.0
2129,2129999,21.121010258143087,37.58516950712401,0.08476303489595005,748.714471578598,154.5030300617218,578.8137092590332,8000,2076,5924,5924,0,22,2130000.0
2130,2130999,21.117639892392653,37.581027375312736,0.08477365444739127,748.9250528812408,154.57061457633972,579.7296562194824,8002,2076,5926,5926,0,22,2131000.0
2131,2131999,21.11397083850715,37.57574618851876,0.08478895328137404,749.248833656311,154.64112901687622,579.9927406311035,8020,2079,5941,5941,0,22,2132000.0
2132,2132999,21.110000403803557,37.56959756066144,0.0848109738409144,749.5258495807648,154.70951533317566,580.7367210388184,8022,2080,5942,5942,0,22,2133000.0
2133,2133999,21.106234493645385,37.564466183033105,0.08481659702159527,749.7663226127625,154.77925729751587,581.4861793518066,8024,2081,5943,5943,0,22,2134000.0
2134,2134999,21.101866017172316,37.557895698456775,0.08483750218519714,750.0937950611115,154.85042309761047,581.881519317627,8027,2082,5945,5945,0,22,2135000.0
2135,2135999,21.098122933878866,37.55215029603563,0.08484921295281778,750.5386617183685,154.92158007621765,581.853328704834,8029,2083,5946,5946,0,22,2136000.0
2136,2136999,21.094291308634233,37.546005154615955,0.08486298975727247,750.7452747821808,154.99147820472717,582.7369651794434,8029,2083,5946,5946,0,22,2137000.0
2137,2137999,21.090509903965515,37.539742085240654,0.0848712039005971,751.0456914901733,155.05980563163757,583.0517692565918,8029,2083,5946,5946,0,22,2138000.0
2138,2138999,21.08668304374118,37.533810738544396,0.08487481341508152,751.3555099964142,155.13127160072327,583.4482383728027,8031,2084,5947,5947,0,22,2139000.0
2139,2139999,21.083697884226105,37.529272488892076,0.08487269451308077,751.6186549663544,155.2006058692932,583.8875617980957,8033,2085,5948,5948,0,22,2140000.0
2140,2140999,21.080626776426982,37.524015009523346,0.08486286115712105,752.0539374351501,155.2700493335724,583.6381874084473,8035,2086,5949,5949,0,22,2141000.0
2141,2141999,21.078282851836658,37.51981331171607,0.08484970604001385,752.4526460170746,155.34127759933472,583.6443367004395,8037,2087,5950,5950,0,22,2142000.0
2142,2142999,21.075949252769597,37.51528043289793,0.0848392107186059,752.8575482368469,155.4108440876007,583.6174430847168,8039,2088,5951,5951,0,22,2143000.0
2143,2143999,21.074306257058634,37.51158336699295,0.08482603851259873,753.2045876979828,155.48064351081848,583.8472862243652,8041,2089,5952,5952,0,22,2144000.0
2144,2144999,21.072106167359014,37.50685357001467,0.08481997838940392,753.50146651268,155.55136680603027,584.2335090637207,8045,2090,5955,5955,0,22,2145000.0
2145,2145999,21.07071144175838,37.50373015280118,0.08480246936308988,753.867495059967,155.6221263408661,584.1773490905762,8049,2092,5957,5957,0,22,2146000.0
2146,2146999,21.06895151312826,37.49971020478052,0.08478888457541356,754.1738302707672,155.6935737133026,584.671688079834,8049,2092,5957,5957,0,22,2147000.0
2147,2147999,21.065782505351315,37.49428938650972,0.08478636742814993,754.5781795978546,155.76351499557495,584.8099479675293,8049,2092,5957,5957,0,22,2148000.0
2148,2148999,21.060812207057804,37.487275003514746,0.08483269545538497,754.9080595970154,155.82935047149658,585.6119422912598,8074,2093,5981,5981,0,22,2149000.0
2149,2149999,21.055871800478943,37.48051440023709,0.08486853670973526,755.1611502170563,155.89573526382446,586.4340476989746,8085,2094,5991,5991,0,22,2150000.0
2150,2150999,21.051323106256078,37.47448575522127,0.08490524007793099,755.4347987174988,155.96188616752625,587.3324241638184,8090,2095,5995,5995,0,22,2151000.0
2151,2151999,21.047175607896502,37.47013733686434,0.08492712507612443,755.6647679805756,156.02706599235535,588.2785987854004,8096,2096,6000,6000,0,22,2152000.0
2152,2152999,21.04305642269129,37.46734699400704,0.08493458305275559,755.9595813751221,156.09292125701904,588.940601348877,8099,2097,6002,6002,0,22,2153000.0
2153,2153999,21.039441524350988,37.462902041448366,0.08493913607652848,756.2494394779205,156.1596884727478,589.5687522888184,8101,2098,6003,6003,0,22,2154000.0
2154,2154999,21.035295734685374,37.45718253437401,0.08495692113388575,756.5682196617126,156.22586917877197,590.0298957824707,8105,2100,6005,6005,0,22,2155000.0
2155,2155999,21.03177712242572,37.45318363989196,0.08495941196051549,756.814373254776,156.2922170162201,590.8190879821777,8107,2101,6006,6006,0,22,2156000.0
2156,2156999,21.028250171151715,37.44782321777443,0.0849673887520338,757.0206832885742,156.35837173461914,591.7020606994629,8107,2101,6006,6006,0,22,2157000.0
2157,2157999,21.024881208160895,37.44201380434402,0.08497341340429843,757.3830201625824,156.42619252204895,591.7294807434082,8113,2104,6009,6009,0,22,2158000.0
2158,2158999,21.021211984268554,37.435909754558836,0.08498106774738423,757.7122981548309,156.4927282333374,591.9575538635254,8119,2107,6012,6012,0,22,2159000.0
2159,2159999,21.01828481356337,37.4314060756506,0.08497697097896117,758.0106570720673,156.55894804000854,592.535572052002,8119,2107,6012,6012,0,22,2160000.0
2160,2160999,21.015656918896333,37.42713259841816,0.08496683579324038,758.5028932094574,156.62912774085999,592.1119346618652,8122,2108,6014,6014,0,22,2161000.0
2161,2161999,21.013340627126773,37.4234774295881,0.08495376095577034,758.7053880691528,156.6956923007965,593.0412254333496,8122,2108,6014,6014,0,22,2162000.0
2162,2162999,21.011661107386374,37.43061988909019,0.08489684934766184,758.9652752876282,156.76218152046204,593.5974540710449,8124,2109,6015,6015,0,22,2163000.0
2163,2163999,21.009941611174956,37.42754309201051,0.08488848303914998,759.3064641952515,156.82934141159058,593.781925201416,8124,2109,6015,6015,0,22,2164000.0
2164,2164999,21.007941495671535,37.4231443180249,0.08488247725334575,759.8032743930817,156.89625692367554,593.2594413757324,8130,2111,6019,6019,0,22,2165000.0
2165,2165999,21.005784636941176,37.41946251105999,0.08488106247640981,760.2080471515656,156.96526265144348,593.2317161560059,8132,2112,6020,6020,0,22,2166000.0
2166,2166999,21.003839313962892,37.41513550960805,0.08488545912560563,760.4968800544739,157.0316264629364,593.6064643859863,8136,2114,6022,6022,0,22,2167000.0
2167,2167999,21.001863517623516,37.41068023899763,0.08487956054403722,760.9236745834351,157.10084891319275,593.5727806091309,8138,2115,6023,6023,0,22,2168000.0
2168,2168999,20.999031769406805,37.40525416541443,0.08487995513807634,761.4351649284363,157.1679871082306,593.3552742004395,8140,2116,6024,6024,0,22,2169000.0
2169,2169999,20.995265051309456,37.40054077964988,0.08490276782075423,761.7111003398895,157.2369101047516,594.3902397155762,8153,2117,6036,6036,0,22,2170000.0
2170,2170999,20.99112356739068,37.39464862741885,0.08494902043328845,761.9607751369476,157.3041868209839,595.2654151916504,8154,2117,6037,6037,0,22,2171000.0
2171,2171999,20.987019815257057,37.38853555402003,0.0850113007711949,762.2163701057434,157.3699860572815,595.9682121276855,8154,2117,6037,6037,0,22,2172000.0
2172,2172999,20.98382934992839,37.38479345507954,0.08503325917423077,762.5466709136963,157.43749403953552,596.290958404541,8163,2118,6045,6045,0,22,2173000.0
2173,2173999,20.981051200603158,37.381092035016614,0.08504342970502987,763.0013825893402,157.5065052509308,595.9570274353027,8170,2121,6049,6049,0,22,2174000.0
2174,2174999,20.977720868072026,37.376516698652196,0.08510807909225582,763.3797280788422,157.57495379447937,596.1162605285645,8174,2123,6051,6051,0,22,2175000.0
2175,2175999,20.974473307788223,37.37257420009071,0.08513593620070858,763.7333815097809,157.6423408985138,596.4642066955566,8174,2123,6051,6051,0,22,2176000.0
2176,2176999,20.971266035431256,37.36764423714275,0.08517253753735166,764.1179840564728,157.71111011505127,596.4451026916504,8179,2126,6053,6053,0,22,2177000.0
2177,2177999,20.968427662427224,37.36310190591875,0.08518993856234347,764.4078760147095,157.77940368652344,596.9309272766113,8179,2126,6053,6053,0,22,2178000.0
2178,2178999,20.965586001457698,37.35862887304248,0.08519227499598359,764.7594168186188,157.84834599494934,597.1028175354004,8181,2127,6054,6054,0,22,2179000.0
2179,2179999,20.96338610405929,37.354611744718035,0.08519842658437493,765.1149797439575,157.91808128356934,597.3084144592285,8184,2128,6056,6056,0,22,2180000.0
2180,2180999,20.960801180582557,37.35005198735101,0.08520124472817947,765.6105678081512,157.98798394203186,596.995922088623,8186,2129,6057,6057,0,22,2181000.0
2181,2181999,20.958492177100798,37.34530317973568,0.08521725546620995,765.870466709137,158.05991506576538,597.5543556213379,8187,2130,6057,6057,0,22,2182000.0
2182,2182999,20.955831058913887,37.34016815285589,0.08523594999172923,766.342844247818,158.13060808181763,597.2878913879395,8193,2132,6061,6061,0,22,2183000.0
2183,2183999,20.95400221197316,37.33578047978885,0.08525383019314459,766.6449701786041,158.19979906082153,597.6871299743652,8193,2132,6061,6061,0,22,2184000.0
2184,2184999,20.952044113498204,37.33132487659024,0.08525951045536428,767.2136595249176,158.27290725708008,597.0136680603027,8196,2134,6062,6062,0,22,2185000.0
2185,2185999,20.94925086592912,37.32597899099206,0.08527775926419046,767.5564687252045,158.34362030029297,597.3418846130371,8196,2134,6062,6062,0,22,2186000.0
2186,2186999,20.94697640676507,37.321290288077535,0.08526012062163923,767.8230395317078,158.41310596466064,598.2710075378418,8203,2134,6069,6069,0,22,2187000.0
2187,2187999,20.943588877318305,37.31875420219276,0.0852699321651651,768.089143037796,158.47892308235168,599.1013145446777,8216,2137,6079,6079,0,22,2188000.0
2188,2188999,20.939903719018098,37.31679314749694,0.08527807918931318,768.3594696521759,158.54510688781738,599.9048194885254,8219,2137,6082,6082,0,22,2189000.0
2189,2189999,20.936157616176587,37.31261324286888,0.08530646020477384,768.625846862793,158.61067056655884,600.5405158996582,8219,2137,6082,6082,0,22,2190000.0
2190,2190999,20.932193609298068,37.307148760189875,0.08533370962298503,768.8599202632904,158.67775988578796,601.4010124206543,8234,2138,6096,6096,0,22,2191000.0
2191,2191999,20.928051968674197,37.30103626027303,0.08536561902241924,769.2152774333954,158.74469447135925,601.8645286560059,8237,2139,6098,6098,0,22,2192000.0
2192,2192999,20.924604359951545,37.29849451462634,0.08536238144968267,769.4653832912445,158.81805300712585,602.6031150817871,8239,2140,6099,6099,0,22,2193000.0
2193,2193999,20.920829987580767,37.29239373280331,0.08537402119147719,769.8061335086823,158.88649463653564,602.8763160705566,8244,2142,6102,6102,0,22,2194000.0
2194,2194999,20.917691602810574,37.28758534006761,0.08537200978500192,770.0910818576813,158.9530827999115,603.3797492980957,8247,2143,6104,6104,0,22,2195000.0
2195,2195999,20.914409280846396,37.28209108651404,0.08537407530426244,770.4312856197357,159.01955437660217,603.5196647644043,8249,2144,6105,6105,0,22,2196000.0
2196,2196999,20.911707286589998,37.277658661168395,0.08535594706405314,770.8026213645935,159.08713841438293,603.4804878234863,8253,2145,6108,6108,0,22,2197000.0
2197,2197999,20.91017001016365,37.279814318278596,0.08530593887253424,771.2620859146118,159.15550446510315,603.2426109313965,8255,2146,6109,6109,0,22,2198000.0
2198,2198999,20.908129745784453,37.276075605841136,0.08528176024189704,771.5961339473724,159.2220389842987,603.5616493225098,8257,2147,6110,6110,0,22,2199000.0
2199,2199999,20.90666503202362,37.27362410219722,0.08526725891503606,771.9144012928009,159.28950333595276,603.8584861755371,8259,2148,6111,6111,0,22,2200000.0
2200,2200999,20.905118228881502,37.27141038010946,0.08524333456225275,772.2355859279633,159.35619378089905,604.1823310852051,8261,2149,6112,6112,0,22,2201000.0
2201,2201999,20.903926177512783,37.273217646639544,0.08520105774110276,772.4404559135437,159.424950838089,605.0032844543457,8261,2149,6112,6112,0,22,2202000.0
2202,2202999,20.903681416563987,37.27333522591243,0.08516803160945896,772.8224325180054,159.49239468574524,604.8533821105957,8265,2151,6114,6114,0,22,2203000.0
2203,2203999,20.902642572927952,37.27088357771775,0.08513022048751795,773.2308962345123,159.56171798706055,604.6623954772949,8268,2153,6115,6115,0,22,2204000.0
2204,2204999,20.901798931239945,37.27206856504918,0.08508391890943212,773.6228518486023,159.63156700134277,604.6222190856934,8271,2155,6116,6116,0,22,2205000.0
2205,2205999,20.900764967046854,37.26855529122404,0.08505416210127448,773.8798758983612,159.70041489601135,605.317211151123,8271,2155,6116,6116,0,22,2206000.0
2206,2206999,20.899139976572968,37.26479446287483,0.08503291611726904,774.270809173584,159.77013540267944,605.7320213317871,8279,2155,6124,6124,0,22,2207000.0
2207,2207999,20.89450932291837,37.26134301144886,0.08505927286179626,774.5960185527802,159.83712649345398,606.2842063903809,8283,2156,6127,6127,0,22,2208000.0
2208,2208999,20.889818113560054,37.25611241339852,0.08508946376742099,774.8851523399353,159.90364837646484,606.7918586730957,8284,2156,6128,6128,0,22,2209000.0
2209,2209999,20.885239829119705,37.250224662636434,0.08512509575391158,775.2148566246033,159.9709312915802,607.210865020752,8284,2156,6128,6128,0,22,2210000.0
2210,2210999,20.881193978640155,37.24743295961631,0.0851355887930193,775.5931866168976,160.03764700889587,607.3130149841309,8284,2156,6128,6128,0,22,2211000.0
2211,2211999,20.876686502119334,37.240953568054394,0.08517167416264249,776.0307831764221,160.1043300628662,607.1872367858887,8288,2158,6130,6130,0,22,2212000.0
2212,2212999,20.87222396298836,37.23512228152458,0.08519361893324806,776.391074180603,160.1705527305603,607.2593193054199,8290,2159,6131,6131,0,22,2213000.0
2213,2213999,20.867810892635593,37.22854736425154,0.0852213057294412,776.7389104366302,160.23702764511108,607.6931648254395,8290,2159,6131,6131,0,22,2214000.0
2214,2214999,20.86374655655116,37.222833443680834,0.08524363206410013,777.0330557823181,160.30475568771362,607.9575386047363,8293,2161,6132,6132,0,22,2215000.0
2215,2215999,20.85961091690654,37.21685220379348,0.08526468135512633,777.5182228088379,160.3729226589203,607.4245719909668,8296,2163,6133,6133,0,22,2216000.0
2216,2216999,20.856028459205778,37.21121378270444,0.08527797298720952,777.8971545696259,160.44104862213135,607.6247978210449,8296,2163,6133,6133,0,22,2217000.0
2217,2217999,20.852611586105414,37.20579082722613,0.08528222625377213,778.3926243782043,160.50899171829224,607.082332611084,8302,2165,6137,6137,0,22,2218000.0
2218,2218999,20.849373035199196,37.20129948867766,0.08528324065405435,778.6553266048431,160.57674098014832,607.8519859313965,8302,2165,6137,6137,0,22,2219000.0
2219,2219999,20.846379105303743,37.19779596784765,0.0852760060401272,779.008796453476,160.64612698554993,608.0590476989746,8302,2165,6137,6137,0,22,2220000.0
2220,2220999,20.843583675304952,37.193161575243856,0.08527619285243782,779.3665318489075,160.71395778656006,608.2850151062012,8302,2165,6137,6137,0,22,2221000.0
2221,2221999,20.841111748637598,37.1899780433408,0.08527120159302737,779.6721475124359,160.78452324867249,608.8554954528809,8320,2167,6153,6153,0,22,2222000.0
2222,2222999,20.83870506508543,37.18575143157331,0.0852731554586531,779.9491910934448,160.85509848594666,609.6679420471191,8320,2167,6153,6153,0,22,2223000.0
2223,2223999,20.835809652837803,37.18055315048539,0.08528383614104684,780.2955634593964,160.92480659484863,609.8681831359863,8322,2168,6154,6154,0,22,2224000.0
2224,2224999,20.83408641632417,37.18171598228106,0.0852552163393554,780.636974811554,160.9934344291687,610.0811653137207,8322,2168,6154,6154,0,22,2225000.0
2225,2225999,20.831643857006526,37.17770161589066,0.0852567374690758,781.0561819076538,161.0624716281891,610.0088920593262,8322,2168,6154,6154,0,22,2226000.0
2226,2226999,20.82864447005869,37.172401684504734,0.08526614996593562,781.3990218639374,161.13131141662598,610.3221626281738,8323,2168,6155,6155,0,22,2227000.0
2227,2227999,20.825346165820783,37.167065363068865,0.0852774709757651,781.7363839149475,161.2004373073578,611.201099395752,8346,2168,6178,6178,0,22,2228000.0
2228,2228999,20.821207461070575,37.16326121479208,0.08529590830542522,781.9193189144135,161.267160654068,612.6834602355957,8348,2168,6180,6180,0,22,2229000.0
2229,2229999,20.817265076689907,37.15876564826906,0.08532170185818921,782.1224176883698,161.33115983009338,613.6172065734863,8349,2168,6181,6181,0,22,2230000.0
2230,2230999,20.813064422793047,37.15293500999886,0.08535317330209213,782.4275805950165,161.3972725868225,614.1150016784668,8355,2171,6184,6184,0,22,2231000.0
2231,2231999,20.809586673579744,37.14961330228164,0.0853596477672055,782.6637110710144,161.46309852600098,614.7467460632324,8359,2173,6186,6186,0,22,2232000.0
2232,2232999,20.80514606532339,37.14325783552357,0.08539214260476125,783.067866563797,161.53006148338318,614.7606163024902,8367,2176,6191,6191,0,22,2233000.0
2233,2233999,20.80092188350938,37.13708298255007,0.08542113329444223,783.4584600925446,161.5990219116211,614.8455543518066,8371,2178,6193,6193,0,22,2234000.0
2234,2234999,20.79757272065077,37.132134728442985,0.08544369781579297,783.7590887546539,161.66680240631104,615.3150749206543,8377,2181,6196,6196,0,22,2235000.0
2235,2235999,20.794230128679054,37.12655251121739,0.08545515067684584,784.1429901123047,161.73402285575867,615.4416542053223,8379,2182,6197,6197,0,22,2236000.0
2236,2236999,20.79142057077464,37.12176650188404,0.08546051459097959,784.5308921337128,161.8016529083252,615.4581489562988,8383,2184,6199,6199,0,22,2237000.0
2237,2237999,20.789597754284554,37.11869496617664,0.08545834589019508,784.862984418869,161.86757946014404,615.8606071472168,8383,2184,6199,6199,0,22,2238000.0
2238,2238999,20.78858827726367,37.117713988373566,0.0854523030323554,785.1611571311951,161.93412733078003,616.3400764465332,8385,2185,6200,6200,0,22,2239000.0
2239,2239999,20.78894699230904,37.126411365961665,0.08539796626511897,785.4671778678894,162.0014853477478,616.7043037414551,8387,2186,6201,6201,0,22,2240000.0
2240,2240999,20.789160538067385,37.13762829588014,0.08537207601257013,785.7639017105103,162.06958675384521,617.2186393737793,8389,2187,6202,6202,0,22,2241000.0
2241,2241999,20.78959390741004,37.150315093656026,0.0853677807501928,786.2427549362183,162.13870453834534,616.9459800720215,8395,2189,6206,6206,0,22,2242000.0
2242,2242999,20.7917089882335,37.16630951252675,0.08531596752981851,786.7105767726898,162.2074315547943,616.5838050842285,8399,2191,6208,6208,0,22,2243000.0
2243,2243999,20.793444363082273,37.17154089453556,0.08525609281390834,787.0943002700806,162.2774202823639,616.7024192810059,8401,2192,6209,6209,0,22,2244000.0
2244,2244999,20.79399574737149,37.17590832211179,0.08528304283015731,787.5058560371399,162.3466739654541,616.8475074768066,8403,2193,6210,6210,0,22,2245000.0
2245,2245999,20.794266351736002,37.17660752981782,0.0852524226728173,787.7661828994751,162.4133312702179,617.5093879699707,8405,2194,6211,6211,0,22,2246000.0
2246,2246999,20.793895062994523,37.17639386601294,0.08523088898216835,788.1069056987762,162.48174667358398,617.7018089294434,8407,2195,6212,6212,0,22,2247000.0
2247,2247999,20.793511704504294,37.17498497440527,0.08521430998009027,788.3013670444489,162.54974102973938,619.1415672302246,8421,2196,6225,6225,0,22,2248000.0
2248,2248999,20.79209651613124,37.17532540845714,0.08522723312649039,788.5650594234467,162.61677885055542,619.951976776123,8423,2196,6227,6227,0,22,2249000.0
2249,2249999,20.791915620847114,37.17740406022611,0.08521199967039594,788.7865180969238,162.68207955360413,620.7372245788574,8423,2196,6227,6227,0,22,2250000.0
2250,2250999,20.791383139632927,37.17698945152069,0.08520768450446337,789.1145997047424,162.74933862686157,620.8208808898926,8430,2199,6231,6231,0,22,2251000.0
2251,2251999,20.79214751246132,37.17945535210141,0.08522928110993311,789.4768614768982,162.81611919403076,620.9561424255371,8434,2201,6233,6233,0,22,2252000.0
2252,2252999,20.79356954943567,37.18194038906003,0.08530962762948702,789.8745493888855,165.9806079864502,621.1672554016113,8436,2202,6234,6234,0,22,2253000.0
2253,2253999,20.794616576141,37.18332189003303,0.08542378230483083,790.2785987854004,166.0491406917572,621.2390937805176,8436,2202,6234,6234,0,22,2254000.0
2254,2254999,20.796992441298993,37.188537777582994,0.08557827259609074,790.6246683597565,166.11801743507385,621.4580116271973,8438,2203,6235,6235,0,22,2255000.0
2255,2255999,20.798552744018785,37.18959568656295,0.08572064700159532,790.915025472641,166.18552327156067,621.913875579834,8438,2203,6235,6235,0,22,2256000.0
2256,2256999,20.80151218056069,37.195997225578516,0.08590455272240627,791.3054220676422,166.25466871261597,621.8783226013184,8440,2204,6236,6236,0,22,2257000.0
2257,2257999,20.805012114283993,37.20232300353756,0.08615977990487689,791.7706933021545,166.323007106781,621.5120658874512,8443,2206,6237,6237,0,22,2258000.0
2258,2258999,20.807560429968202,37.20559352644899,0.086392518729834,791.974725484848,166.39128470420837,622.3868980407715,8443,2206,6237,6237,0,22,2259000.0
2259,2259999,20.80990709544132,37.2081363155221,0.08655940854342314,792.4323046207428,166.46085214614868,622.1342658996582,8447,2208,6239,6239,0,22,2260000.0
2260,2260999,20.812686436999027,37.21279004163743,0.08662751456815743,792.7840442657471,166.5308825969696,622.3286399841309,8448,2209,6239,6239,0,22,2261000.0
2261,2261999,20.81572795614685,37.2171519850743,0.08672279550952533,793.086245059967,166.59988284111023,622.6852073669434,8448,2209,6239,6239,0,22,2262000.0
2262,2262999,20.818734207397963,37.22073679087737,0.08683949780704525,793.460951089859,166.66985869407654,622.6978797912598,8454,2211,6243,6243,0,22,2263000.0
2263,2263999,20.82183313882106,37.22317587174753,0.08686374390046081,793.9704279899597,166.74053573608398,622.1061515808105,8462,2214,6248,6248,0,22,2264000.0
2264,2264999,20.824453246102983,37.22462284158977,0.08684667895770126,794.2826318740845,166.81389570236206,622.547679901123,8462,2214,6248,6248,0,22,2265000.0
2265,2265999,20.827057363223815,37.22588272894085,0.08683080923236686,794.6739082336426,166.88781762123108,622.6683311462402,8462,2214,6248,6248,0,22,2266000.0
2266,2266999,20.828007246015215,37.2238965161404,0.08679293742852179,795.0800626277924,166.95734572410583,622.592830657959,8464,2215,6249,6249,0,22,2267000.0
2267,2267999,20.82574570349098,37.22229773566519,0.08674739097042616,795.3724343776703,167.02717447280884,623.5772819519043,8477,2216,6261,6261,0,22,2268000.0
2268,2268999,20.822415507276986,37.217585816455696,0.08675331803198827,795.7217898368835,167.09480118751526,623.9394340515137,8479,2217,6262,6262,0,22,2269000.0
2269,2269999,20.819607341185407,37.21318346672154,0.08674833029265183,796.0053915977478,167.1619770526886,624.4830436706543,8488,2218,6270,6270,0,22,2270000.0
2270,2270999,20.81724761140257,37.20984105632153,0.08674054882317983,796.2599062919617,167.22961711883545,625.0998573303223,8489,2218,6271,6271,0,22,2271000.0
2271,2271999,20.81437792821572,37.20515921743067,0.08674105382595776,796.6875514984131,167.2972424030304,624.8619651794434,8495,2221,6274,6274,0,22,2272000.0
2272,2272999,20.812033165910353,37.20111666486456,0.0867430842191711,797.0802490711212,167.36717319488525,624.8253364562988,8501,2224,6277,6277,0,22,2273000.0
2273,2273999,20.809696530086033,37.197526270510615,0.08676011912649217,797.4226877689362,167.4355504512787,625.2318458557129,8501,2224,6277,6277,0,22,2274000.0
2274,2274999,20.80846571630852,37.19637474035492,0.08678076554827618,797.7339198589325,167.50431180000305,625.7223625183105,8501,2224,6277,6277,0,22,2275000.0
2275,2275999,20.80781748937171,37.203240267562315,0.08675893168136883,798.0783970355988,167.57341933250427,625.8658714294434,8502,2225,6277,6277,0,22,2276000.0
2276,2276999,20.80753571780366,37.20454002404995,0.08681042909238346,798.5661404132843,167.64531588554382,625.5402641296387,8506,2227,6279,6279,0,22,2277000.0
2277,2277999,20.80857490271259,37.208260848645985,0.08686748327352944,798.8735067844391,167.71407985687256,626.0656089782715,8506,2227,6279,6279,0,22,2278000.0
2278,2278999,20.81073028378143,37.21576519533932,0.08693716266158558,799.2719008922577,167.7846667766571,626.1222038269043,8506,2227,6279,6279,0,22,2279000.0
2279,2279999,20.812187652620718,37.220786800270176,0.08702845957732719,799.6311504840851,167.85447192192078,626.2763557434082,8508,2228,6280,6280,0,22,2280000.0
2280,2280999,20.814179294602727,37.22392559219627,0.08714210712826431,799.930627822876,167.9246346950531,626.6107368469238,8509,2229,6280,6280,0,22,2281000.0
2281,2281999,20.817116017563855,37.23325733998283,0.08720255428039214,800.415286064148,167.99540162086487,626.2632484436035,8511,2230,6281,6281,0,22,2282000.0
2282,2282999,20.82036488280378,37.23891353331673,0.08732736805503183,800.7559163570404,168.06675362586975,626.593578338623,8513,2231,6282,6282,0,22,2283000.0
2283,2283999,20.822501236339964,37.24062441331044,0.08742644426208945,801.116265296936,168.1371624469757,626.6288108825684,8516,2233,6283,6283,0,22,2284000.0
2284,2284999,20.826846626846333,37.246366937367455,0.08753067747949206,801.4524993896484,168.20916366577148,626.946231842041,8516,2233,6283,6283,0,22,2285000.0
2285,2285999,20.83058980665097,37.25128799944503,0.08754967486827836,801.9025938510895,168.2823350429535,626.7539482116699,8516,2233,6283,6283,0,22,2286000.0
2286,2286999,20.83314118306287,37.25251948814885,0.08754048641689971,802.2872982025146,168.35533261299133,626.9822273254395,8516,2233,6283,6283,0,22,2287000.0
2287,2287999,20.832840753022186,37.25027552960057,0.08750711448800064,802.696394443512,168.42427587509155,627.309497833252,8534,2234,6300,6300,0,22,2288000.0
2288,2288999,20.829325303588092,37.24473437447378,0.08751536071501909,802.9313859939575,168.49028396606445,628.4770698547363,8546,2234,6312,6312,0,22,2289000.0
2289,2289999,20.82693896653227,37.240435640484286,0.08751540075020647,803.2109684944153,168.55479955673218,629.1438407897949,8553,2235,6318,6318,0,22,2290000.0
2290,2290999,20.826074014801975,37.2383743717884,0.08749429784517815,803.4567687511444,168.61914205551147,630.1366691589355,8553,2235,6318,6318,0,22,2291000.0
2291,2291999,20.82531799095867,37.237992358654076,0.0874880209680936,803.6562700271606,168.68419480323792,631.3110694885254,8557,2235,6322,6322,0,22,2292000.0
2292,2292999,20.825037325030827,37.237439194698155,0.08749426035856578,803.9992532730103,168.7517213821411,631.7513771057129,8564,2238,6326,6326,0,22,2293000.0
2293,2293999,20.823622649368858,37.23387300801441,0.08751995434017945,804.2893018722534,168.81851816177368,632.3993721008301,8566,2239,6327,6327,0,22,2294000.0
2294,2294999,20.8233657106821,37.23219596420417,0.08752999832925457,804.6781969070435,168.88560128211975,632.427433013916,8580,2244,6336,6336,0,22,2295000.0
2295,2295999,20.823471681392622,37.23156341187751,0.08756738970144007,804.953323841095,168.95191144943237,633.0608787536621,8584,2246,6338,6338,0,22,2296000.0
2296,2296999,20.823710964055106,37.23142617891684,0.08758456362596323,805.1981439590454,169.0176703929901,633.7833824157715,8584,2246,6338,6338,0,22,2297000.0
2297,2297999,20.82384078229726,37.231005619621726,0.08762943912054655,805.6112847328186,169.08377408981323,633.6155281066895,8590,2249,6341,6341,0,22,2298000.0
2298,2298999,20.823690772117786,37.22932415667567,0.08769518797306364,805.8218533992767,169.1515371799469,634.4874610900879,8590,2249,6341,6341,0,22,2299000.0
2299,2299999,20.824405316491035,37.2288418468053,0.0877287801219615,806.2562379837036,169.21846961975098,634.0811500549316,8598,2253,6345,6345,0,22,2300000.0
2300,2300999,20.825591946830837,37.230747037486054,0.08779067916584671,806.5922191143036,169.28497648239136,634.4053840637207,8601,2254,6347,6347,0,22,2301000.0
2301,2301999,20.826482228163307,37.23068948757203,0.087862537125594,807.0195379257202,169.35519576072693,634.3496055603027,8603,2255,6348,6348,0,22,2302000.0
2302,2302999,20.82792360898697,37.232642428943095,0.08796155090226498,807.2870008945465,169.4238305091858,635.0934104919434,8603,2255,6348,6348,0,22,2303000.0
2303,2303999,20.829463483310267,37.23379170715699,0.0880281719830388,807.6243798732758,169.49230337142944,635.3493766784668,8603,2255,6348,6348,0,22,2304000.0
2304,2304999,20.83136724593399,37.241444989525334,0.08809395851164281,807.9711215496063,169.55920028686523,635.4846839904785,8605,2256,6349,6349,0,22,2305000.0
2305,2305999,20.833150732486914,37.24283554460524,0.08813551910939055,808.3405663967133,169.62720608711243,635.4986000061035,8607,2257,6350,6350,0,22,2306000.0
2306,2306999,20.835555067574983,37.24764356926883,0.08816050704188672,808.7765009403229,169.69433760643005,635.5127372741699,8607,2257,6350,6350,0,22,2307000.0
2307,2307999,20.836150889283097,37.245881533185866,0.08820199126323935,809.0813105106354,169.76056814193726,635.9044609069824,8609,2258,6351,6351,0,22,2308000.0
2308,2308999,20.834675761590606,37.24260538605186,0.08825329552285877,809.3708863258362,169.82825183868408,636.8476371765137,8621,2259,6362,6362,0,22,2309000.0
2309,2309999,20.831864504356734,37.24087211369669,0.08826197959203363,809.7049243450165,169.8946669101715,637.1716499328613,8628,2261,6367,6367,0,22,2310000.0
2310,2310999,20.828776474407327,37.23570962461659,0.08829423157465965,809.9415760040283,169.96106123924255,637.9930992126465,8628,2261,6367,6367,0,22,2311000.0
2311,2311999,20.82550190671053,37.23040545055328,0.0883282795973297,810.3194744586945,170.02984976768494,638.005428314209,8634,2263,6371,6371,0,22,2312000.0
2312,2312999,20.82233216702213,37.225067637509966,0.08835929567300793,810.6109788417816,170.09912753105164,638.4503898620605,8637,2264,6373,6373,0,22,2313000.0
2313,2313999,20.818955291358396,37.21945268873865,0.0883935584777088,811.0225765705109,170.16671204566956,638.4405250549316,8652,2266,6386,6386,0,22,2314000.0
2314,2314999,20.815395025054507,37.21357575078137,0.08843139647343456,811.3200144767761,170.23445796966553,638.8445320129395,8652,2266,6386,6386,0,22,2315000.0
2315,2315999,20.81223559481665,37.20814243123165,0.08846427958267389,811.75772356987,170.30308985710144,638.6571235656738,8656,2268,6388,6388,0,22,2316000.0
2316,2316999,20.809099991049624,37.20258248434123,0.08849637621354156,812.0080020427704,170.3705198764801,639.3286094665527,8656,2268,6388,6388,0,22,2317000.0
2317,2317999,20.80561039131979,37.196805239002906,0.08853471899735033,812.3546760082245,170.43850779533386,639.4579048156738,8658,2269,6389,6389,0,22,2318000.0
2318,2318999,20.802400918223626,37.1916380307959,0.08856590896085825,812.8305251598358,170.50617837905884,639.165958404541,8658,2269,6389,6389,0,22,2319000.0
2319,2319999,20.799982191600144,37.18755930490561,0.08857407889175184,813.2099697589874,170.575834274292,639.2322273254395,8660,2270,6390,6390,0,22,2320000.0
2320,2320999,20.798087251852994,37.18351481630552,0.08858872940500329,813.5554406642914,170.6432991027832,639.3677101135254,8661,2271,6390,6390,0,22,2321000.0
2321,2321999,20.79577500777518,37.17980966270901,0.08860703660229796,813.8057429790497,170.71081376075745,639.9634056091309,8662,2272,6390,6390,0,22,2322000.0
2322,2322999,20.79377703873603,37.17543366855606,0.08862769398298864,814.3116872310638,170.78047728538513,639.2736701965332,8692,2276,6416,6416,0,22,2323000.0
2323,2323999,20.79162272669335,37.17083443065522,0.08864687892505452,814.7376627922058,170.85176801681519,639.5812873840332,8694,2277,6417,6417,0,22,2324000.0
2324,2324999,20.789116716037363,37.165690253938585,0.08868676438074574,814.9829165935516,170.92093467712402,640.555477142334,8694,2277,6417,6417,0,22,2325000.0
2325,2325999,20.786285032341357,37.16077235041797,0.08871236743860766,815.2979583740234,170.9884283542633,641.0429801940918,8694,2277,6417,6417,0,22,2326000.0
2326,2326999,20.783045499368416,37.15971240286269,0.08872178221259952,815.532956123352,171.05501174926758,642.1879615783691,8713,2279,6434,6434,0,22,2327000.0
2327,2327999,20.77991271384897,37.15809676377294,0.08874511572765076,815.8096034526825,171.12167286872864,642.8788719177246,8717,2280,6437,6437,0,22,2328000.0
2328,2328999,20.77604726165155,37.15242117635257,0.08880254558599832,816.1327788829803,171.18762254714966,643.2804527282715,8721,2282,6439,6439,0,22,2329000.0
2329,2329999,20.772684692849023,37.14716396316885,0.0888380423013504,816.420027256012,171.25410199165344,643.815242767334,8721,2282,6439,6439,0,22,2330000.0
2330,2330999,20.768930157003762,37.14156957501088,0.08888242111056366,816.7874040603638,171.32094144821167,644.0188407897949,8721,2282,6439,6439,0,22,2331000.0
2331,2331999,20.765188280764253,37.13643398969711,0.08890648590667005,817.0300476551056,171.38698506355286,644.6966285705566,8722,2282,6440,6440,0,22,2332000.0
2332,2332999,20.761431602603945,37.1314660713202,0.08893269059061581,817.4750354290009,171.45534825325012,644.4650993347168,8726,2284,6442,6442,0,22,2333000.0
2333,2333999,20.757936721959375,37.12621811330032,0.08895698615043202,817.7938139438629,171.521466255188,644.7907752990723,8728,2285,6443,6443,0,22,2334000.0
2334,2334999,20.75502676734258,37.12416490328936,0.08895233397532676,818.1487996578217,171.58780789375305,645.0008354187012,8728,2285,6443,6443,0,22,2335000.0
2335,2335999,20.752378453769822,37.12106649717027,0.08894577675426274,818.5334804058075,171.6576030254364,645.0079536437988,8730,2286,6444,6444,0,22,2336000.0
2336,2336999,20.749865105317575,37.11715037571904,0.08894285571590044,818.9160058498383,171.72460985183716,645.0025749206543,8732,2287,6445,6445,0,22,2337000.0
2337,2337999,20.748237755170518,37.12113344739376,0.08889544585362119,819.3202195167542,171.7952675819397,644.8714866638184,8734,2289,6445,6445,0,22,2338000.0
2338,2338999,20.74653230453125,37.11783423319637,0.0888807106740942,819.6918923854828,171.86312747001648,645.000316619873,8738,2291,6447,6447,0,22,2339000.0
2339,2339999,20.744295124972215,37.11332071583822,0.08888011113962457,820.0338230133057,171.9319772720337,645.2860374450684,8738,2291,6447,6447,0,22,2340000.0
2340,2340999,20.743127343367444,37.110953365990866,0.08885263974574287,820.4104399681091,171.99993872642517,645.3563499450684,8738,2291,6447,6447,0,22,2341000.0
2341,2341999,20.741487061019352,37.10678290660678,0.08883993195515438,820.7965316772461,172.0684108734131,645.3813209533691,8738,2291,6447,6447,0,22,2342000.0
2342,2342999,20.740120041504785,37.108517937728124,0.08881199487214775,821.2010111808777,172.13763093948364,645.4024238586426,8738,2291,6447,6447,0,22,2343000.0
2343,2343999,20.738712480366917,37.1048289534377,0.08879062436819207,821.4905967712402,172.20502948760986,645.6445426940918,8739,2292,6447,6447,0,22,2344000.0
2344,2344999,20.736962722333807,37.10132163543942,0.08876682360831689,821.8776044845581,172.27241253852844,645.7830924987793,8739,2292,6447,6447,0,22,2345000.0
2345,2345999,20.734482812820026,37.09606925151825,0.0887526458333453,822.1745307445526,172.33969831466675,646.1797370910645,8740,2293,6447,6447,0,22,2346000.0
2346,2346999,20.73106150798718,37.09668037079969,0.08875071860447659,822.4953694343567,172.40828776359558,646.9571952819824,8750,2294,6456,6456,0,22,2347000.0
2347,2347999,20.72694564339165,37.09134795362595,0.08878185973088049,822.7151582241058,172.47523617744446,647.8571281433105,8752,2294,6458,6458,0,22,2348000.0
2348,2348999,20.72244982830774,37.08486601156884,0.08882359977625476,823.0435318946838,172.54101610183716,648.1725273132324,8754,2295,6459,6459,0,22,2349000.0
2349,2349999,20.718713691495406,37.08000272157313,0.08885167458517085,823.3335249423981,172.60649633407593,648.610179901123,8756,2296,6460,6460,0,22,2350000.0
2350,2350999,20.71470715535688,37.07408818427018,0.0888804870061436,823.6669793128967,172.67265462875366,648.7138404846191,8760,2298,6462,6462,0,22,2351000.0
2351,2351999,20.710938584101086,37.06883862206335,0.08890340726507007,824.074401140213,172.7406735420227,648.8019065856934,8762,2299,6463,6463,0,22,2352000.0
2352,2352999,20.706982820257316,37.0627577351332,0.08892669870705228,824.3662614822388,172.80918788909912,649.2369499206543,8762,2299,6463,6463,0,22,2353000.0
2353,2353999,20.70319028182475,37.05760937123236,0.08894568650219004,824.7144997119904,172.87586522102356,649.4807014465332,8762,2299,6463,6463,0,22,2354000.0
2354,2354999,20.70001927075901,37.05299040277467,0.08896237861589484,825.0635595321655,172.9457347393036,649.6115913391113,8764,2300,6464,6464,0,22,2355000.0
2355,2355999,20.696975279708752,37.04804823139989,0.08896859665627443,825.492041349411,173.0128936767578,649.5068702697754,8764,2300,6464,6464,0,22,2356000.0
2356,2356999,20.694723275044364,37.04405253974838,0.08896036356394277,825.8445296287537,173.08389520645142,649.7789497375488,8764,2300,6464,6464,0,22,2357000.0
2357,2357999,20.69295888532006,37.04055921268815,0.08894855871722884,826.2752583026886,173.15100693702698,649.4419593811035,8766,2302,6464,6464,0,22,2358000.0
2358,2358999,20.69194230120766,37.03852407973,0.08892403954959349,826.5904874801636,173.2182960510254,649.8437461853027,8766,2302,6464,6464,0,22,2359000.0
2359,2359999,20.690604662554755,37.03558691697985,0.08890915541466538,826.9289019107819,173.28716707229614,650.0875968933105,8766,2302,6464,6464,0,22,2360000.0
2360,2360999,20.690199082849972,37.03400158195511,0.08889323504553726,827.278418302536,173.35473322868347,650.1322364807129,8768,2303,6465,6465,0,22,2361000.0
2361,2361999,20.690474642811655,37.03309807995053,0.08887106550629453,827.5974724292755,173.4216558933258,650.4884834289551,8768,2303,6465,6465,0,22,2362000.0
2362,2362999,20.6904911505554,37.03143101246249,0.08886272428151554,827.8932030200958,173.4907624721527,650.7375297546387,8770,2304,6466,6466,0,22,2363000.0
2363,2363999,20.69154439559233,37.031408352105856,0.08884121744301987,828.2402052879333,173.5583291053772,650.8083686828613,8772,2305,6467,6467,0,22,2364000.0
2364,2364999,20.691754905290534,37.03050582731647,0.08881265036041197,828.6638028621674,173.62658786773682,650.5852241516113,8788,2306,6482,6482,0,22,2365000.0
2365,2365999,20.690836009532596,37.02676238365241,0.08880936927125083,829.0969994068146,173.6965823173523,650.7487983703613,8789,2307,6482,6482,0,22,2366000.0
2366,2366999,20.689678948807952,37.02412848252451,0.08878048863132426,829.3878839015961,173.76555109024048,651.8262825012207,8809,2307,6502,6502,0,22,2367000.0
2367,2367999,20.686024633918603,37.018750528519156,0.08880589141847761,829.549676656723,173.82934665679932,653.5735359191895,8815,2307,6508,6508,0,22,2368000.0
2368,2368999,20.68305440640176,37.01682962340297,0.08880155029691128,829.7497096061707,173.89372372627258,654.5512504577637,8816,2307,6509,6509,0,22,2369000.0
2369,2369999,20.67926717624799,37.01067493479279,0.08882885122209505,830.0463230609894,173.95805430412292,655.1162986755371,8823,2309,6514,6514,0,22,2370000.0
2370,2370999,20.676135526787423,37.0056883307686,0.08883637064664629,830.2746720314026,174.02274918556213,655.8442115783691,8825,2310,6515,6515,0,22,2371000.0
2371,2371999,20.67299597677869,37.000861011423915,0.08884557100030621,830.629490852356,174.08795428276062,655.9449806213379,8833,2314,6519,6519,0,22,2372000.0
2372,2372999,20.66992633525848,36.997959972119894,0.08885089993231055,830.9734888076782,174.15272450447083,656.2182807922363,8835,2315,6520,6520,0,22,2373000.0
2373,2373999,20.666767182140024,36.99247350143686,0.08886544298393917,831.3223016262054,174.21920561790466,656.5438041687012,8837,2316,6521,6521,0,22,2374000.0
2374,2374999,20.66388492620772,36.987280535516035,0.08887612908146902,831.4801752567291,174.28308296203613,657.4632759094238,8838,2316,6522,6522,0,22,2375000.0
2375,2375999,20.66121777843174,36.98225685044101,0.0888776536616599,831.9780311584473,174.35102605819702,656.9171180725098,8842,2318,6524,6524,0,22,2376000.0
2376,2376999,20.658675740322177,36.97750313354741,0.08887300550357735,832.3370456695557,174.4161729812622,656.961109161377,8850,2322,6528,6528,0,22,2377000.0
2377,2377999,20.656952457542026,36.974014413071856,0.08884715912590735,832.7196178436279,174.48187398910522,656.9487800598145,8856,2325,6531,6531,0,22,2378000.0
2378,2378999,20.65487222084451,36.97024507998904,0.08882852324295121,832.9626603126526,174.54836010932922,657.5767707824707,8857,2325,6532,6532,0,22,2379000.0
2379,2379999,20.654082064093398,36.96921428448221,0.08878030283020355,833.3096539974213,174.61551189422607,657.8666572570801,8857,2325,6532,6532,0,22,2380000.0
2380,2380999,20.65520654635648,36.97729074847242,0.08869496850265923,833.6888101100922,174.68141961097717,657.8186988830566,8862,2327,6535,6535,0,22,2381000.0
2381,2381999,20.65688753112415,36.98053094643497,0.08861601044849587,834.0626013278961,174.74727368354797,657.8889961242676,8866,2329,6537,6537,0,22,2382000.0
2382,2382999,20.65884714525788,36.983511068333165,0.08854091591043523,834.5816600322723,174.815776348114,657.4695701599121,8868,2330,6538,6538,0,22,2383000.0
2383,2383999,20.661081078024637,36.98850781615953,0.08846921647432626,834.9186074733734,174.881774187088,657.7662696838379,8872,2332,6540,6540,0,22,2384000.0
2384,2384999,20.663500700925642,36.99113720395657,0.08841059937435547,835.2934732437134,174.94888639450073,657.7612724304199,8874,2333,6541,6541,0,22,2385000.0
2385,2385999,20.665331832082387,36.993296151866524,0.08835923104156229,835.624077796936,175.015882730484,658.1177558898926,8876,2334,6542,6542,0,22,2386000.0
2386,2386999,20.666488206841482,36.99419836079708,0.08830766030331771,835.9552264213562,175.08195972442627,658.5869178771973,8876,2334,6542,6542,0,22,2387000.0
2387,2387999,20.66305830970171,36.98910769520488,0.08831941159571255,836.226809501648,175.15042662620544,659.5750541687012,8886,2334,6552,6552,0,22,2388000.0
2388,2388999,20.659554976335798,36.984538258122335,0.08833184088422152,836.5078999996185,175.2168254852295,660.1429557800293,8892,2336,6556,6556,0,22,2389000.0
2389,2389999,20.65686030085737,36.98212073056757,0.08833070398236953,836.8309226036072,175.28362894058228,660.5863990783691,8892,2336,6556,6556,0,22,2390000.0
2390,2390999,20.65391901277197,36.97795858929868,0.08833504369091083,837.1289281845093,175.35141682624817,660.9654350280762,8893,2336,6557,6557,0,22,2391000.0
2391,2391999,20.650913211631515,36.973095350908416,0.08833630620073929,837.5476570129395,175.4192337989807,660.7929801940918,8899,2339,6560,6560,0,22,2392000.0
2392,2392999,20.647937567200447,36.96793233371198,0.0883507070358801,837.9096097946167,175.4863133430481,661.0907936096191,8901,2340,6561,6561,0,22,2393000.0
2393,2393999,20.645463881678197,36.96314403850664,0.08834928966391142,838.2505490779877,175.55285787582397,661.3531303405762,8901,2340,6561,6561,0,22,2394000.0
2394,2394999,20.642743150642648,36.95793032929418,0.0883601239858568,838.580991268158,175.6195707321167,661.6044883728027,8903,2341,6562,6562,0,22,2395000.0
2395,2395999,20.640227993362426,36.953817032598494,0.08835991192168835,839.0340778827667,175.687415599823,661.3774604797363,8905,2342,6563,6563,0,22,2396000.0
2396,2396999,20.637754727400008,36.950580396609496,0.08835346521264986,839.3380382061005,175.75596499443054,661.6782875061035,8906,2343,6563,6563,0,22,2397000.0
2397,2397999,20.635664096810473,36.94631625909034,0.08834609901623347,839.7703659534454,175.82454419136047,661.5925712585449,8906,2343,6563,6563,0,22,2398000.0
2398,2398999,20.634072097584465,36.9430878656095,0.08833070304945867,840.1932015419006,175.8939266204834,661.3551139831543,8909,2345,6564,6564,0,22,2399000.0
2399,2399999,20.633175633386458,36.94124793085132,0.08830715093288144,840.4471335411072,175.96178340911865,662.0726051330566,8909,2345,6564,6564,0,22,2400000.0
2400,2400999,20.633742361787665,36.941438267831565,0.08827094945910552,840.7376699447632,176.02935934066772,662.5125999450684,8909,2345,6564,6564,0,22,2401000.0
2401,2401999,20.63389824624786,36.94014160806999,0.0882426729821415,841.1354773044586,176.09929585456848,662.4490165710449,8909,2345,6564,6564,0,22,2402000.0
2402,2402999,20.63460636758646,36.93977575318218,0.08820902975005862,841.5537841320038,176.16765308380127,662.4263725280762,8911,2346,6565,6565,0,22,2403000.0
2403,2403999,20.638115079929495,36.94635677566458,0.08815351207100774,841.9265205860138,176.23567724227905,662.4289970397949,8913,2347,6566,6566,0,22,2404000.0
2404,2404999,20.64141616465485,36.95352118851122,0.08809770521040516,842.3411712646484,176.30589532852173,662.3610038757324,8913,2347,6566,6566,0,22,2405000.0
2405,2405999,20.644973483027066,36.959138840361526,0.08804477265843769,842.8396708965302,176.37621307373047,662.0080223083496,8913,2347,6566,6566,0,22,2406000.0
2406,2406999,20.64766735793236,36.96161648618404,0.08800645950222374,843.1804432868958,179.72243666648865,661.9937324523926,8918,2350,6568,6568,0,22,2407000.0
2407,2407999,20.646666416982757,36.96183932338597,0.08797677983402019,843.4782609939575,179.7926971912384,662.7220191955566,8932,2352,6580,6580,0,22,2408000.0
2408,2408999,20.644122680325967,36.97105910872054,0.08791406086653197,843.7602393627167,179.86143565177917,663.5436973571777,8934,2352,6582,6582,0,22,2409000.0
2409,2409999,20.64130544300794,36.967479528836904,0.08791687063447118,844.0058476924896,179.93445420265198,664.2896003723145,8934,2352,6582,6582,0,22,2410000.0
2410,2410999,20.63891776081544,36.96380166092088,0.0879117172375865,844.3341062068939,180.00185012817383,664.476749420166,8937,2353,6584,6584,0,22,2411000.0
2411,2411999,20.63615557872305,36.959686125385716,0.08791084172165897,844.6169610023499,180.0693163871765,664.8765068054199,8939,2354,6585,6585,0,22,2412000.0
2412,2412999,20.63385623469614,36.956118000808786,0.08790474950391092,844.9883532524109,180.1369915008545,664.8359031677246,8945,2357,6588,6588,0,22,2413000.0
2413,2413999,20.630857164971403,36.951077049307706,0.08791485789558162,845.4031269550323,180.2073268890381,664.8645973205566,8968,2360,6608,6608,0,22,2414000.0
2414,2414999,20.62891976241651,36.947227965302716,0.08790838825466674,845.7290668487549,180.27620673179626,665.6156806945801,8970,2360,6610,6610,0,22,2415000.0
2415,2415999,20.626477096110268,36.94344237227161,0.0879095438837525,845.9269561767578,180.34495520591736,666.6130180358887,8970,2360,6610,6610,0,22,2416000.0
2416,2416999,20.624015617228523,36.93899718360478,0.08791439184048988,846.3105411529541,180.4138422012329,666.7628974914551,8972,2361,6611,6611,0,22,2417000.0
2417,2417999,20.62209405528929,36.93574512071184,0.08791169126630083,846.610387802124,180.48182153701782,667.1694221496582,8972,2361,6611,6611,0,22,2418000.0
2418,2418999,20.61981277255675,36.931674987936994,0.08789857322191152,846.9595320224762,180.55133438110352,667.4040946960449,8972,2361,6611,6611,0,22,2419000.0
2419,2419999,20.61866303150301,36.9304150181247,0.08787227131136077,847.212776184082,180.62041211128235,668.0196647644043,8972,2361,6611,6611,0,22,2420000.0
2420,2420999,20.617606697978857,36.92839966466424,0.08789350623109049,847.6973147392273,180.6916422843933,667.5793800354004,8974,2362,6612,6612,0,22,2421000.0
2421,2421999,20.617691934164878,36.92877041480982,0.08795921090007419,848.1133692264557,180.76105546951294,667.433048248291,8977,2364,6613,6613,0,22,2422000.0
2422,2422999,20.617780569585435,36.92995542674305,0.08800318938669915,848.4369249343872,180.83248496055603,667.7876777648926,8978,2364,6614,6614,0,22,2423000.0
2423,2423999,20.620041284336352,36.93377458562639,0.08800477125099637,848.821346282959,180.90151715278625,667.8514060974121,8978,2364,6614,6614,0,22,2424000.0
2424,2424999,20.622138514123726,36.938221448932204,0.08800480395309795,849.1059441566467,180.97285199165344,668.2605323791504,8981,2365,6616,6616,0,22,2425000.0
2425,2425999,20.625030542460788,36.94414529809345,0.0879754573690762,849.49862241745,181.0429286956787,668.1595039367676,8984,2367,6617,6617,0,22,2426000.0
2426,2426999,20.62598755822024,36.945019631657736,0.08797398809577506,849.9641661643982,181.11458730697632,667.9270362854004,8985,2367,6618,6618,0,22,2427000.0
2427,2427999,20.62760564257417,36.94961817771294,0.08793787736850178,850.2118530273438,181.1839759349823,668.6087608337402,8985,2367,6618,6618,0,22,2428000.0
2428,2428999,20.626519788672578,36.947932935614375,0.08791617222088777,850.5541763305664,181.25296139717102,669.4265174865723,9004,2367,6637,6637,0,22,2429000.0
2429,2429999,20.624143678546094,36.94738023519475,0.08788819162737205,850.8364818096161,181.31776475906372,670.2405052185059,9017,2368,6649,6649,0,22,2430000.0
2430,2430999,20.622034185066823,36.94500775951505,0.08787801343766066,851.0668761730194,181.38298344612122,671.1329154968262,9022,2369,6653,6653,0,22,2431000.0
2431,2431999,20.61943489169483,36.94117992903437,0.08786842188434796,851.3438675403595,181.44700455665588,671.9166603088379,9024,2369,6655,6655,0,22,2432000.0
2432,2432999,20.617125683902277,36.937538277116424,0.08785446431337884,851.6010203361511,181.51340508460999,672.8265266418457,9027,2369,6658,6658,0,22,2433000.0
2433,2433999,20.6156584801796,36.936283728012,0.08782933988289876,851.9128761291504,181.57968091964722,673.3743171691895,9032,2371,6661,6661,0,22,2434000.0
2434,2434999,20.61359479474269,36.93404220897579,0.08781885108621346,852.1923115253448,181.64480876922607,673.979923248291,9036,2373,6663,6663,0,22,2435000.0
2435,2435999,20.61155213118676,36.93013038138869,0.08780459744525326,852.5255694389343,181.71143102645874,674.353214263916,9042,2376,6666,6666,0,22,2436000.0
2436,2436999,20.609633480017973,36.9258251783898,0.08779595005033647,852.7594933509827,181.77688646316528,675.1414756774902,9044,2377,6667,6667,0,22,2437000.0
2437,2437999,20.60786701802483,36.921676290957095,0.0877871045710108,853.1374158859253,181.84466433525085,675.3252143859863,9046,2378,6668,6668,0,22,2438000.0
2438,2438999,20.60610364311705,36.917839735859914,0.08777456302696096,853.3770229816437,181.9103262424469,676.1063346862793,9046,2378,6668,6668,0,22,2439000.0
2439,2439999,20.60444238346459,36.9141779913608,0.08775948935340172,853.7309808731079,181.97641849517822,676.3010597229004,9048,2379,6669,6669,0,22,2440000.0
2440,2440999,20.60314262421014,36.91147440617823,0.08773577192142334,854.2467217445374,182.04293036460876,675.6329612731934,9052,2381,6671,6671,0,22,2441000.0
2441,2441999,20.602247326927664,36.90929366439603,0.08771240250769574,854.5185241699219,182.11119842529297,676.3255424499512,9055,2382,6673,6673,0,22,2442000.0
2442,2442999,20.600990955391843,36.90557185007903,0.08768992936386633,854.7283959388733,182.17707133293152,677.2326316833496,9055,2382,6673,6673,0,22,2443000.0
2443,2443999,20.60028458235771,36.90334796297872,0.08766281250285035,855.0296859741211,182.2434365749359,677.4434089660645,9059,2384,6675,6675,0,22,2444000.0
2444,2444999,20.599593961434994,36.90025163885499,0.08764461440583338,855.3868319988251,182.31177711486816,677.6551856994629,9073,2385,6688,6688,0,22,2445000.0
2445,2445999,20.599091708968842,36.89772169433841,0.08762458023516417,855.8177707195282,182.37976670265198,677.438648223877,9075,2386,6689,6689,0,22,2446000.0
2446,2446999,20.59828802034405,36.894990201563374,0.08760522596751386,856.1764636039734,182.4483678340912,677.5849571228027,9079,2388,6691,6691,0,22,2447000.0
2447,2447999,20.597952202527843,36.89208427709691,0.08758537783937259,856.5995676517487,182.51789093017578,677.6756782531738,9079,2388,6691,6691,0,22,2448000.0
2448,2448999,20.597299906756735,36.89198883136457,0.08755759806396124,856.9243340492249,182.58409976959229,678.1134147644043,9079,2388,6691,6691,0,22,2449000.0
2449,2449999,20.59604834168058,36.89285221622245,0.08751952507608252,857.2778573036194,182.65262651443481,678.7307777404785,9093,2390,6703,6703,0,22,2450000.0
2450,2450999,20.593844364940356,36.889165428837224,0.08751601039040424,857.5767273902893,182.7204041481018,679.4266471862793,9097,2390,6707,6707,0,22,2451000.0
2451,2451999,20.591908974448344,36.885492878872554,0.08752256137044756,857.9775111675262,182.78749012947083,679.564395904541,9097,2390,6707,6707,0,22,2452000.0
2452,2452999,20.589799135375586,36.881850610841234,0.08752713800407108,858.2863609790802,182.8541169166565,679.986629486084,9099,2391,6708,6708,0,22,2453000.0
2453,2453999,20.587978736107637,36.87950570854296,0.087524475175209,858.5898089408875,182.92180633544922,680.5465965270996,9100,2391,6709,6709,0,22,2454000.0
2454,2454999,20.586782236818042,36.87852156613266,0.08751699647170608,859.0346686840057,182.98972249031067,680.3550300598145,9106,2394,6712,6712,0,22,2455000.0
2455,2455999,20.584940960858784,36.874901816351816,0.08752207652193345,859.3635723590851,183.0577301979065,680.8320579528809,9106,2394,6712,6712,0,22,2456000.0
2456,2456999,20.583864475613897,36.87350716599408,0.08750700996284211,859.8603093624115,183.12589144706726,680.2100257873535,9113,2398,6715,6715,0,22,2457000.0
2457,2457999,20.582530774788292,36.87061688853527,0.08750889146921959,860.1665034294128,183.193941116333,680.763500213623,9114,2399,6715,6715,0,22,2458000.0
2458,2458999,20.580884251618507,36.86685348431093,0.08750233541596264,860.5651125907898,183.26327538490295,680.8223991394043,9118,2401,6717,6717,0,22,2459000.0
2459,2459999,20.579886594724123,36.86448689595967,0.0874970942108314,860.8417658805847,183.33445286750793,681.4984931945801,9118,2401,6717,6717,0,22,2460000.0
2460,2460999,20.579133878936275,36.86651878931374,0.08746041368552115,861.3363173007965,183.40349531173706,681.143741607666,9118,2401,6717,6717,0,22,2461000.0
2461,2461999,20.578729720525192,36.86474261222314,0.08745838668109618,861.6081829071045,183.47251749038696,681.8294486999512,9118,2401,6717,6717,0,22,2462000.0
2462,2462999,20.5779140503238,36.86138587188145,0.08745562383497996,862.0151128768921,183.54114985466003,681.7789268493652,9121,2402,6719,6719,0,22,2463000.0
2463,2463999,20.577031092960475,36.858147811604546,0.08745761304508881,862.461662530899,183.61060667037964,681.419490814209,9124,2404,6720,6720,0,22,2464000.0
2464,2464999,20.576672154711563,36.855557346665016,0.08744822661572305,862.7534365653992,183.68003392219543,682.0419425964355,9138,2406,6732,6732,0,22,2465000.0
2465,2465999,20.575061925439808,36.85132836261648,0.08745399172724644,863.0978171825409,183.75166654586792,682.6517372131348,9141,2407,6734,6734,0,22,2466000.0
2466,2466999,20.573650521850187,36.84742737583558,0.08744575549776412,863.3945598602295,183.8219439983368,683.3494758605957,9142,2407,6735,6735,0,22,2467000.0
2467,2467999,20.572207986047005,36.847437001635285,0.08741788137250728,863.6787090301514,183.88886618614197,684.431095123291,9157,2408,6749,6749,0,22,2468000.0
2468,2468999,20.570825695857415,36.846060882778566,0.08740420790156056,863.9513604640961,183.95373797416687,685.1657218933105,9159,2408,6751,6751,0,22,2469000.0
2469,2469999,20.56923654241778,36.84425222145813,0.08739520759995711,864.2793095111847,184.02000379562378,685.5298004150391,9162,2409,6753,6753,0,22,2470000.0
2470,2470999,20.567857503555572,36.84174453012633,0.0873850865101834,864.5125141143799,184.08473563194275,686.2059478759766,9162,2409,6753,6753,0,22,2471000.0
2471,2471999,20.566813995604793,36.839497936224376,0.08736703135803914,864.9840383529663,184.15293836593628,686.1629409790039,9180,2412,6768,6768,0,22,2472000.0
2472,2472999,20.565020226169622,36.835784411984164,0.0873473461367742,865.2136323451996,184.21960949897766,687.2729187011719,9181,2412,6769,6769,0,22,2473000.0
2473,2473999,20.564699474839973,36.83515479592058,0.08732426276796779,865.4540865421295,184.28730273246765,688.0276565551758,9185,2413,6772,6772,0,22,2474000.0
2474,2474999,20.56346537928266,36.832303449213555,0.08730734360630965,865.706545829773,184.35438132286072,688.6879348754883,9185,2413,6772,6772,0,22,2475000.0
2475,2475999,20.562989711591904,36.838140129022506,0.08724749850098956,866.0330538749695,184.4201364517212,688.8310928344727,9189,2415,6774,6774,0,22,2476000.0
2476,2476999,20.562085031196577,36.83593150869407,0.0872302255102152,866.4081673622131,184.48627424240112,688.7289199829102,9195,2417,6778,6778,0,22,2477000.0
2477,2477999,20.562308116976304,36.83849236816371,0.08719235737474151,866.8202393054962,184.55291771888733,688.6614227294922,9199,2419,6780,6780,0,22,2478000.0
2478,2478999,20.562403879832228,36.83693958764065,0.08718119664637469,867.1562185287476,184.61916375160217,688.8702392578125,9214,2421,6793,6793,0,22,2479000.0
2479,2479999,20.563798718942046,36.837472808782024,0.08714665899249896,867.4384937286377,184.68556880950928,689.387092590332,9214,2421,6793,6793,0,22,2480000.0
2480,2480999,20.564688408829443,36.83711886899256,0.0871325116050502,867.7248930931091,184.75323271751404,689.6860961914062,9216,2422,6794,6794,0,22,2481000.0
2481,2481999,20.5668533889638,36.83893518477703,0.0871127860606149,868.1957285404205,184.82467484474182,689.3960037231445,9218,2423,6795,6795,0,22,2482000.0
2482,2482999,20.569110339129534,36.84662890960928,0.08706560200276825,868.611983537674,184.8916199207306,689.3823928833008,9218,2423,6795,6795,0,22,2483000.0
2483,2483999,20.571269704068687,36.849433630970616,0.08704201030763115,869.0560219287872,184.9610240459442,689.2893905639648,9223,2424,6799,6799,0,22,2484000.0
2484,2484999,20.57288232052937,36.849311509458204,0.0870214814155984,869.4056792259216,185.0300316810608,689.5096206665039,9224,2424,6800,6800,0,22,2485000.0
2485,2485999,20.575045351361013,36.85241744941877,0.08698949697820035,869.7995176315308,185.10036373138428,689.4589996337891,9225,2425,6800,6800,0,22,2486000.0
2486,2486999,20.57491129858961,36.849724240177544,0.08698254075870238,870.1362309455872,185.16806650161743,689.8316192626953,9226,2425,6801,6801,0,22,2487000.0
2487,2487999,20.57280637592129,36.847565118404475,0.0869728467266454,870.3655061721802,185.23511576652527,691.0016250610352,9236,2426,6810,6810,0,22,2488000.0
2488,2488999,20.57089704345084,36.84606028877431,0.08696187760357488,870.6956896781921,185.30172061920166,691.3752212524414,9238,2426,6812,6812,0,22,2489000.0
2489,2489999,20.569347725021284,36.844268003711925,0.08695136009362492,870.9653115272522,185.3678867816925,691.9526748657227,9240,2427,6813,6813,0,22,2490000.0
2490,2490999,20.56816948474893,36.8431226254499,0.08693385926981012,871.2907574176788,185.43335461616516,692.2557983398438,9240,2427,6813,6813,0,22,2491000.0
2491,2491999,20.56619830158903,36.841690762107284,0.0869277754538691,871.6915843486786,185.49921107292175,692.2759857177734,9240,2427,6813,6813,0,22,2492000.0
2492,2492999,20.564489106052246,36.83893984687533,0.0869181097039552,872.0293478965759,185.56470394134521,692.5011291503906,9240,2427,6813,6813,0,22,2493000.0
2493,2493999,20.562889531440742,36.83640825888183,0.08689851300432305,872.4460709095001,185.6307816505432,692.3591079711914,9244,2428,6816,6816,0,22,2494000.0
2494,2494999,20.561058709170315,36.832822977320156,0.08688782449968069,872.7431490421295,185.69845247268677,692.7915267944336,9244,2428,6816,6816,0,22,2495000.0
2495,2495999,20.559856633301646,36.832232808067545,0.0868624871300393,873.1449298858643,185.76562213897705,692.5668487548828,9248,2430,6818,6818,0,22,2496000.0
2496,2496999,20.557874822389124,36.82744131681277,0.08685743699039783,873.5298707485199,185.83415246009827,692.4780044555664,9254,2434,6820,6820,0,22,2497000.0
2497,2497999,20.556513373785997,36.82852927097958,0.08682411530586653,873.9132342338562,185.90203261375427,692.6438674926758,9256,2435,6821,6821,0,22,2498000.0
2498,2498999,20.555417451108774,36.82546419132268,0.08681242326252947,874.1592211723328,185.97051572799683,693.7535018920898,9271,2436,6835,6835,0,22,2499000.0
2499,2499999,20.55428662513253,36.821847465381175,0.08680012270264448,874.3995146751404,186.0383563041687,694.6272430419922,9271,2436,6835,6835,0,22,2500000.0
2500,2500999,20.553579009860183,36.820473673255535,0.08678105829639571,874.6511933803558,186.10720324516296,695.295524597168,9271,2436,6835,6835,0,22,2501000.0
2501,2501999,20.55248242783825,36.816596533978164,0.08677662257656937,875.0579431056976,186.17519664764404,695.307861328125,9283,2437,6846,6846,0,22,2502000.0
2502,2502999,20.551437621015925,36.81301298058253,0.08676558078337782,875.4689791202545,186.24438619613647,695.1962890625,9284,2437,6847,6847,0,22,2503000.0
2503,2503999,20.550736805312894,36.809608339640356,0.08675891426503923,875.8435831069946,186.3127281665802,695.3270950317383,9284,2437,6847,6847,0,22,2504000.0
2504,2504999,20.549380552990236,36.80531740023005,0.08676466960686391,876.1769692897797,186.38115572929382,695.5572204589844,9297,2439,6858,6858,0,22,2505000.0
2505,2505999,20.548096278402102,36.8014713639724,0.08676212459231059,876.5648255348206,186.44978713989258,695.5295333862305,9299,2440,6859,6859,0,22,2506000.0
2506,2506999,20.546994419621623,36.79741530716938,0.086764155193786,876.8973331451416,186.51930475234985,695.6523208618164,9303,2442,6861,6861,0,22,2507000.0
2507,2507999,20.544829224822955,36.79338585741125,0.08674965570732784,877.3551933765411,186.58981204032898,695.8228149414062,9320,2443,6877,6877,0,22,2508000.0
2508,2508999,20.540975946713562,36.78719778060384,0.08679024319041995,877.5671279430389,186.65586137771606,697.2577590942383,9326,2443,6883,6883,0,22,2509000.0
2509,2509999,20.538058238226732,36.783362760527304,0.08681417941344416,877.7611780166626,186.72074246406555,698.2239761352539,9329,2444,6885,6885,0,22,2510000.0
2510,2510999,20.53494063850451,36.77909419105363,0.08684832698571543,878.1143484115601,186.7865662574768,698.5437393188477,9333,2445,6888,6888,0,22,2511000.0
2511,2511999,20.53224497634048,36.77845843621186,0.08686052227834795,878.3517415523529,186.8523247241974,699.2259979248047,9333,2445,6888,6888,0,22,2512000.0
2512,2512999,20.528805162967164,36.77318361157079,0.08689202426735321,878.7159399986267,186.9200291633606,699.1979064941406,9340,2448,6892,6892,0,22,2513000.0
2513,2513999,20.525731670185777,36.769036956323475,0.08692319865794018,879.1206574440002,186.98677039146423,699.1493301391602,9347,2451,6896,6896,0,22,2514000.0
2514,2514999,20.52229688075273,36.76352950093251,0.08694736337874631,879.4584805965424,187.0540566444397,699.5118179321289,9351,2453,6898,6898,0,22,2515000.0
2515,2515999,20.51879525582175,36.759700509476914,0.0869722840361491,879.7525291442871,187.1193573474884,699.9478912353516,9353,2454,6899,6899,0,22,2516000.0
2516,2516999,20.515595213189492,36.75428325775053,0.08699630949171533,880.0934295654297,187.18525552749634,700.2576141357422,9355,2455,6900,6900,0,22,2517000.0
2517,2517999,20.513040118404508,36.74979207161543,0.08701384310039029,880.3017401695251,187.25125432014465,700.9900054931641,9357,2456,6901,6901,0,22,2518000.0
2518,2518999,20.510379999744934,36.74567211946417,0.087025401765361,880.844268321991,187.3174123764038,700.4561920166016,9359,2457,6902,6902,0,22,2519000.0
2519,2519999,20.507595465084258,36.74050953766715,0.0870452396854905,881.0970804691315,187.3826162815094,701.0373764038086,9359,2457,6902,6902,0,22,2520000.0
2520,2520999,20.504651003455987,36.73519231281726,0.08706292143429051,881.444375038147,187.4479637145996,701.1787643432617,9361,2458,6903,6903,0,22,2521000.0
2521,2521999,20.501869460602887,36.73059850701199,0.08707793216916071,881.7813587188721,187.51483392715454,701.3767852783203,9363,2459,6904,6904,0,22,2522000.0
2522,2522999,20.499312977958674,36.726264737124595,0.08709250016926606,882.1652359962463,187.58099246025085,701.3075866699219,9367,2461,6906,6906,0,22,2523000.0
2523,2523999,20.497281296390067,36.72266764725034,0.08710540030472103,882.6160290241241,187.6483404636383,701.1627502441406,9367,2461,6906,6906,0,22,2524000.0
2524,2524999,20.495321398146356,36.71837272630844,0.08712107986825679,883.0290846824646,187.71557354927063,701.1627502441406,9369,2462,6907,6907,0,22,2525000.0
2525,2525999,20.49344018050662,36.71431315649038,0.08712562414166847,883.2882027626038,187.78332591056824,701.7226257324219,9369,2462,6907,6907,0,22,2526000.0
2526,2526999,20.491120755882292,36.709787818154666,0.0871388740697443,883.720253944397,187.84926104545593,701.5774536132812,9369,2462,6907,6907,0,22,2527000.0
2527,2527999,20.488665374885077,36.70538785852403,0.08715656806926786,883.9666719436646,187.91606903076172,702.2129364013672,9369,2462,6907,6907,0,22,2528000.0
2528,2528999,20.485533929341376,36.700591059368286,0.08718311922835897,884.3882124423981,187.98444843292236,702.675910949707,9381,2462,6919,6919,0,22,2529000.0
2529,2529999,20.482070989763574,36.697046305485486,0.0872023701024649,884.7132630348206,188.05135774612427,702.9990615844727,9389,2464,6925,6925,0,22,2530000.0
2530,2530999,20.478858983594026,36.69251540678979,0.08722056296063363,884.9930610656738,188.1184630393982,703.5530471801758,9395,2466,6929,6929,0,22,2531000.0
2531,2531999,20.476418704867193,36.69195392135489,0.08721137899148956,885.2329390048981,188.18525886535645,704.5926513671875,9411,2468,6943,6943,0,22,2532000.0
2532,2532999,20.47332731740008,36.68737604226337,0.08722941381951577,885.4943561553955,188.25259852409363,705.4120635986328,9421,2470,6951,6951,0,22,2533000.0
2533,2533999,20.471169112005356,36.683787880717404,0.08724104461347404,885.8391282558441,188.32216620445251,705.8883361816406,9425,2472,6953,6953,0,22,2534000.0
2534,2534999,20.468400838630195,36.67882723619892,0.0872618089859486,886.1240088939667,188.390207529068,706.3438186645508,9425,2472,6953,6953,0,22,2535000.0
2535,2535999,20.465538430486426,36.67390973126215,0.0872752130657598,886.3632135391235,188.4581699371338,707.0396347045898,9425,2472,6953,6953,0,22,2536000.0
2536,2536999,20.46330046586048,36.67012147847392,0.08728468263426847,886.8321959972382,188.52560448646545,706.6465682983398,9428,2473,6955,6955,0,22,2537000.0
2537,2537999,20.460590361387748,36.66497064215602,0.08730118284440536,887.1673862934113,188.59351778030396,706.949089050293,9430,2474,6956,6956,0,22,2538000.0
2538,2538999,20.458074829469023,36.66080958042508,0.08731088933766595,887.520457983017,188.66228485107422,707.2110137939453,9430,2474,6956,6956,0,22,2539000.0
2539,2539999,20.45570414544151,36.65611876798289,0.08731457234757434,887.9071674346924,188.73098039627075,707.1809463500977,9434,2476,6958,6958,0,22,2540000.0
2540,2540999,20.453655906765444,36.65205564850585,0.08731580768129898,888.2800168991089,188.80110454559326,707.2971115112305,9438,2478,6960,6960,0,22,2541000.0
2541,2541999,20.452122956218496,36.64900846321659,0.08730382737045816,888.4886457920074,188.86901926994324,708.1985015869141,9438,2478,6960,6960,0,22,2542000.0
2542,2542999,20.452312355738034,36.652365759967644,0.08726521784784602,888.9015259742737,188.93749046325684,708.1463241577148,9438,2478,6960,6960,0,22,2543000.0
2543,2543999,20.453240095166546,36.65342986252922,0.08723538447664603,889.2968471050262,189.0066418647766,708.1011810302734,9440,2479,6961,6961,0,22,2544000.0
2544,2544999,20.453901976337967,36.65427963732837,0.08721924787486146,889.6328310966492,189.07554149627686,708.2214584350586,9446,2482,6964,6964,0,22,2545000.0
2545,2545999,20.45516908752402,36.658326128099745,0.08720230344242652,889.9681985378265,189.14655232429504,708.4752578735352,9448,2483,6965,6965,0,22,2546000.0
2546,2546999,20.456362891044236,36.65896091447672,0.0872148670270616,890.3613209724426,189.21583247184753,708.5221786499023,9450,2484,6966,6966,0,22,2547000.0
2547,2547999,20.455977496085097,36.65638231080549,0.08721615534624816,890.6711826324463,189.28495836257935,708.9424209594727,9453,2485,6968,6968,0,22,2548000.0
2548,2548999,20.4549205746492,36.65342083037871,0.08722675011010583,891.1150426864624,189.3548641204834,708.8504180908203,9462,2487,6975,6975,0,22,2549000.0
2549,2549999,20.452119877584302,36.650619764141865,0.0872328823341979,891.4587392807007,189.42309737205505,709.6289443969727,9473,2488,6985,6985,0,22,2550000.0
2550,2550999,20.44993634045584,36.647898584622304,0.08724076784118961,891.7055134773254,189.49028611183167,710.4129333496094,9473,2488,6985,6985,0,22,2551000.0
2551,2551999,20.447203482084586,36.64314682717757,0.08726399053777789,892.0069601535797,189.55855059623718,710.8535995483398,9476,2489,6987,6987,0,22,2552000.0
2552,2552999,20.44447401590811,36.638319347791864,0.08728525386069352,892.2511031627655,189.62679314613342,711.5469589233398,9476,2489,6987,6987,0,22,2553000.0
2553,2553999,20.443212410980124,36.63688195383502,0.08725970654469617,892.7059042453766,189.69555068016052,711.3395309448242,9480,2491,6989,6989,0,22,2554000.0
2554,2554999,20.44158216771431,36.633754605885265,0.08725053300769259,893.030326128006,189.76496982574463,711.7769775390625,9480,2491,6989,6989,0,22,2555000.0
2555,2555999,20.440330895811705,36.633201328954065,0.08723292724275933,893.4216310977936,189.83401131629944,711.8299713134766,9482,2492,6990,6990,0,22,2556000.0
2556,2556999,20.439611351964043,36.63917000863421,0.08719096469927556,893.7851548194885,189.90460348129272,711.8903961181641,9485,2494,6991,6991,0,22,2557000.0
2557,2557999,20.439039662836503,36.638218756269865,0.08718059783888388,894.173928976059,189.97483348846436,711.8909225463867,9489,2496,6993,6993,0,22,2558000.0
2558,2558999,20.438228516529463,36.63583362591036,0.08718156294770574,894.4798533916473,190.04587030410767,712.2994232177734,9490,2497,6993,6993,0,22,2559000.0
2559,2559999,20.438750866660335,36.63657691614639,0.08717391187875356,894.8750140666962,190.11687779426575,712.3943099975586,9492,2498,6994,6994,0,22,2560000.0
2560,2560999,20.438933877393996,36.635516879739725,0.08718649789377164,895.2314167022705,190.18705344200134,712.6752090454102,9492,2498,6994,6994,0,22,2561000.0
2561,2561999,20.440360931954867,36.63764833862765,0.08718887404575404,895.5951228141785,190.2585346698761,712.8086166381836,9494,2499,6995,6995,0,22,2562000.0
2562,2562999,20.442587725426193,36.64150565663166,0.08725288507585272,899.487952709198,190.32964158058167,713.0780639648438,9494,2499,6995,6995,0,22,2563000.0
2563,2563999,20.444841441836072,36.64366798239829,0.08727436344145878,899.9066228866577,190.4012098312378,713.1033401489258,9498,2500,6998,6998,0,22,2564000.0
2564,2564999,20.448141017161333,36.648308295399055,0.08731869683238336,900.4925293922424,190.47517609596252,712.2590255737305,9526,2504,7022,7022,0,22,2565000.0
2565,2565999,20.452438425835492,36.65413774274615,0.08734064276035225,900.9015140533447,190.54607224464417,712.2465438842773,9528,2505,7023,7023,0,22,2566000.0
2566,2566999,20.458272300252098,36.66290279969556,0.08739841653819214,901.3055226802826,190.61766362190247,712.2753524780273,9529,2506,7023,7023,0,22,2567000.0
2567,2567999,20.462852968647752,36.670961306429376,0.08741054394082859,901.6139364242554,190.68948221206665,712.7389602661133,9529,2506,7023,7023,0,22,2568000.0
2568,2568999,20.468992418466243,36.680049218132744,0.08743240681482767,902.0128111839294,190.7616832256317,712.7055282592773,9531,2507,7024,7024,0,22,2569000.0
2569,2569999,20.47165226911445,36.686039476500135,0.0873955025524048,902.3649079799652,190.83261942863464,713.4555511474609,9547,2507,7040,7040,0,22,2570000.0
2570,2570999,20.469122367326147,36.68278849062308,0.08738623613505925,902.6432480812073,190.8980610370636,714.3846740722656,9561,2508,7053,7053,0,22,2571000.0
2571,2571999,20.466651964189605,36.68026664663853,0.08737631155730241,902.8850317001343,190.96278715133667,715.2885284423828,9567,2508,7059,7059,0,22,2572000.0
2572,2572999,20.46526527206227,36.68087072900401,0.08734677134168134,903.1605198383331,191.0278615951538,716.0636749267578,9568,2508,7060,7060,0,22,2573000.0
2573,2573999,20.463533773370013,36.67761567112798,0.08734141337186796,903.4059326648712,191.09300661087036,716.9526138305664,9572,2508,7064,7064,0,22,2574000.0
2574,2574999,20.461879899145455,36.67474577153062,0.08733503373835194,903.725917339325,191.1586365699768,717.5502166748047,9579,2511,7068,7068,0,22,2575000.0
2575,2575999,20.460088041274084,36.67146233644515,0.08733505682086729,904.0684704780579,191.2246150970459,717.8645095825195,9583,2513,7070,7070,0,22,2576000.0
2576,2576999,20.458427220046033,36.66783272259654,0.08733452093664218,904.4171440601349,191.29223823547363,718.207893371582,9591,2517,7074,7074,0,22,2577000.0
2577,2577999,20.45704579509245,36.664738399148185,0.087340975192291,904.5776453018188,191.35721826553345,719.3528823852539,9592,2517,7075,7075,0,22,2578000.0
2578,2578999,20.456288196441367,36.6633200074208,0.08733374541358774,904.8973734378815,191.42408061027527,719.6190872192383,9598,2520,7078,7078,0,22,2579000.0
2579,2579999,20.454628563216527,36.6597650202865,0.08734466347259662,905.1435596942902,191.49172449111938,720.3338012695312,9598,2520,7078,7078,0,22,2580000.0
2580,2580999,20.453997834540818,36.65767435997588,0.08737149039223602,905.6279337406158,191.55892372131348,719.8783721923828,9604,2523,7081,7081,0,22,2581000.0
2581,2581999,20.453438966548013,36.656028587983286,0.08738908231552156,906.0082039833069,191.62676644325256,719.9730224609375,9608,2525,7083,7083,0,22,2582000.0
2582,2582999,20.45346168064629,36.655646337318714,0.08737153255064212,906.3240015506744,191.69318628311157,720.4845275878906,9610,2526,7084,7084,0,22,2583000.0
2583,2583999,20.453755120085926,36.65555098631437,0.0873927471187752,906.5241022109985,191.76090383529663,721.3476867675781,9611,2526,7085,7085,0,22,2584000.0
2584,2584999,20.453932400819927,36.655206171057934,0.08743644300233722,906.8971168994904,191.8274631500244,721.4611358642578,9611,2526,7085,7085,0,22,2585000.0
2585,2585999,20.454690544687722,36.65471356838095,0.0874571877917375,907.2316992282867,191.89589047431946,721.7119674682617,9613,2527,7086,7086,0,22,2586000.0
2586,2586999,20.4561456892957,36.65573814805843,0.08745305334341913,907.5760278701782,191.96251106262207,721.9171371459961,9615,2528,7087,7087,0,22,2587000.0
2587,2587999,20.457515556524452,36.656640891749774,0.0874354318238747,908.1181633472443,192.03315424919128,721.4089889526367,9630,2530,7100,7100,0,22,2588000.0
2588,2588999,20.459467911484104,36.65857681188571,0.08744016170341085,908.4188737869263,192.10205149650574,721.9445190429688,9630,2530,7100,7100,0,22,2589000.0
2589,2589999,20.462081734780742,36.66351180937458,0.08742677462992843,908.5905869007111,192.16842126846313,722.9814453125,9630,2530,7100,7100,0,22,2590000.0
2590,2590999,20.461050738842616,36.660972101250586,0.0874482641173735,908.9505770206451,192.24204683303833,723.5346069335938,9646,2533,7113,7113,0,22,2591000.0
2591,2591999,20.458220793530707,36.658381083499734,0.08745920478087177,909.232479095459,192.30990409851074,724.4443359375,9652,2533,7119,7119,0,22,2592000.0
2592,2592999,20.45558458927358,36.65536601784912,0.08747684956154078,909.5857954025269,192.37654304504395,724.7359848022461,9652,2533,7119,7119,0,22,2593000.0
2593,2593999,20.452709401727535,36.65080650669989,0.08749778705866895,909.9467959403992,192.44364428520203,724.8037185668945,9656,2535,7121,7121,0,22,2594000.0
2594,2594999,20.449743324890616,36.645897052460334,0.08752045517572637,910.2236461639404,192.5105414390564,725.5186767578125,9657,2535,7122,7122,0,22,2595000.0
2595,2595999,20.446899533300385,36.64125411276283,0.08754440712241462,910.6226544380188,192.57812094688416,725.6174468994141,9659,2536,7123,7123,0,22,2596000.0
2596,2596999,20.443888894239212,36.63633164159356,0.08755841600937975,910.9311563968658,192.64628911018372,726.0893478393555,9661,2537,7124,7124,0,22,2597000.0
2597,2597999,20.440972736602877,36.631935649333634,0.0875784884304438,911.3045246601105,192.71472668647766,726.0851593017578,9664,2539,7125,7125,0,22,2598000.0
2598,2598999,20.438647879701655,36.628228704721224,0.08758469470898977,911.6499950885773,192.78414964675903,726.4429473876953,9664,2539,7125,7125,0,22,2599000.0
2599,2599999,20.43605577078774,36.62368862558552,0.08759742702692452,912.0423262119293,192.85267281532288,726.5872116088867,9666,2540,7126,7126,0,22,2600000.0
2600,2600999,20.434303501992478,36.62072400441615,0.08758690858539098,912.351877450943,192.9216001033783,727.0234985351562,9666,2540,7126,7126,0,22,2601000.0
2601,2601999,20.432817951165404,36.61758607864673,0.087584386765438,912.7307443618774,192.99492645263672,727.1551284790039,9667,2541,7126,7126,0,22,2602000.0
2602,2602999,20.431993162608666,36.615796693116074,0.08755969240745276,913.1352696418762,193.06549382209778,727.1989059448242,9667,2541,7126,7126,0,22,2603000.0
2603,2603999,20.43129540707599,36.613474287446316,0.08754741637071728,913.5426249504089,193.13650631904602,727.2643203735352,9667,2541,7126,7126,0,22,2604000.0
2604,2604999,20.43122652362987,36.61233218078641,0.08752427017030862,914.0139400959015,193.20563626289368,726.8033981323242,9670,2543,7127,7127,0,22,2605000.0
2605,2605999,20.431986775193383,36.61211712556145,0.08749962535307698,914.4169781208038,193.27683186531067,726.9126358032227,9672,2544,7128,7128,0,22,2606000.0
2606,2606999,20.432133372146957,36.611406975474836,0.08747970447681452,914.8187055587769,193.3465051651001,727.0557327270508,9672,2544,7128,7128,0,22,2607000.0
2607,2607999,20.432851791024124,36.61044060831363,0.08746164926482958,915.1376368999481,193.41650390625,727.4486770629883,9672,2544,7128,7128,0,22,2608000.0
2608,2608999,20.430299503214247,36.606594149554894,0.08747653394656507,915.3338098526001,193.48453903198242,728.7856216430664,9689,2545,7144,7144,0,22,2609000.0
2609,2609999,20.42671118638964,36.601766467111496,0.08751102074506256,915.5649297237396,193.54943418502808,729.8353500366211,9696,2546,7150,7150,0,22,2610000.0
2610,2610999,20.42338747195089,36.59777020613373,0.0875402215369554,915.7908797264099,193.6155252456665,730.8981857299805,9711,2547,7164,7164,0,22,2611000.0
2611,2611999,20.419590835596914,36.59216945876681,0.08758261837582548,916.0609760284424,193.6829628944397,731.7261581420898,9711,2547,7164,7164,0,22,2612000.0
2612,2612999,20.416025508609625,36.5873717927739,0.0876228427111686,916.3211560249329,193.74860072135925,732.3479537963867,9713,2548,7165,7165,0,22,2613000.0
2613,2613999,20.412323749954716,36.58190497069736,0.08766177775901407,916.5835583209991,193.81491470336914,733.1080932617188,9714,2548,7166,7166,0,22,2614000.0
2614,2614999,20.408781341089455,36.57738361880911,0.08768658419022313,916.827974319458,193.88072872161865,733.6601409912109,9716,2549,7167,7167,0,22,2615000.0
2615,2615999,20.405224938602753,36.5723993560157,0.08771474288309478,917.2505302429199,193.94870233535767,733.5490341186523,9719,2550,7169,7169,0,22,2616000.0
2616,2616999,20.401809734335657,36.566973160492175,0.08774107344476711,917.6185171604156,194.01630663871765,733.6410598754883,9723,2552,7171,7171,0,22,2617000.0
2617,2617999,20.398834246019423,36.562632522488435,0.08775210733773031,917.9002368450165,194.08403611183167,734.1897048950195,9723,2552,7171,7171,0,22,2618000.0
2618,2618999,20.395747524140646,36.55806337262091,0.08776044675075434,918.2857627868652,194.15229630470276,734.1315307617188,9727,2554,7173,7173,0,22,2619000.0
2619,2619999,20.393535355326136,36.555250740899254,0.08776316941429418,918.6491234302521,194.22108149528503,734.2688751220703,9730,2555,7175,7175,0,22,2620000.0
2620,2620999,20.391767675121653,36.55321084824877,0.08775882848337346,919.0336108207703,194.28778505325317,734.4002914428711,9730,2555,7175,7175,0,22,2621000.0
2621,2621999,20.390629254869303,36.55172269666146,0.08774803547995313,919.4022493362427,194.35760116577148,734.5291366577148,9730,2555,7175,7175,0,22,2622000.0
2622,2622999,20.391351028723523,36.55755938552201,0.08769684430168467,919.8013627529144,194.42516207695007,734.4519424438477,9732,2556,7176,7176,0,22,2623000.0
2623,2623999,20.391584201912107,36.55759042837392,0.08767154258048382,920.1608953475952,194.4923379421234,734.6021423339844,9734,2557,7177,7177,0,22,2624000.0
2624,2624999,20.3922928685664,36.55807842705062,0.0876490518505636,920.5916934013367,194.561909198761,734.3444747924805,9737,2559,7178,7178,0,22,2625000.0
2625,2625999,20.392590620524103,36.557926029572336,0.08762914105290442,920.9441299438477,194.6298213005066,734.5383987426758,9742,2562,7180,7180,0,22,2626000.0
2626,2626999,20.39253736054049,36.5559396082274,0.08761124320551916,921.3271186351776,194.69746899604797,734.6502685546875,9747,2564,7183,7183,0,22,2627000.0
2627,2627999,20.391214409861018,36.5524733294391,0.08760612403557566,921.6096124649048,194.76675534248352,735.2701950073242,9747,2564,7183,7183,0,22,2628000.0
2628,2628999,20.38781388538401,36.54713971033063,0.08762177309118035,921.9780809879303,194.84097456932068,736.0237655639648,9761,2565,7196,7196,0,22,2629000.0
2629,2629999,20.384317462701055,36.544056325543224,0.08762153918629156,922.2250792980194,194.9060821533203,736.916877746582,9764,2565,7199,7199,0,22,2630000.0
2630,2630999,20.380759604017165,36.53893352605228,0.08763490593861745,922.6076719760895,194.9720494747162,736.9732360839844,9767,2566,7201,7201,0,22,2631000.0
2631,2631999,20.377823016005472,36.5345183897554,0.087645155282704,922.8887274265289,195.03744316101074,737.5981521606445,9767,2566,7201,7201,0,22,2632000.0
2632,2632999,20.374523387148155,36.52958088565576,0.08765807508970624,923.3154726028442,195.10315918922424,737.4376831054688,9769,2567,7202,7202,0,22,2633000.0
2633,2633999,20.37143156230429,36.525474821278564,0.08766783170360881,923.6514129638672,195.16995072364807,737.8119659423828,9769,2567,7202,7202,0,22,2634000.0
2634,2634999,20.368017121954377,36.52080594595842,0.08768046949268082,924.0090439319611,195.23714971542358,737.8506088256836,9770,2568,7202,7202,0,22,2635000.0
2635,2635999,20.364806667167347,36.51566339595387,0.08769101111584132,924.3240671157837,195.30463361740112,738.2708206176758,9770,2568,7202,7202,0,22,2636000.0
2636,2636999,20.36193950576486,36.51339051044856,0.0876853117446883,924.7679119110107,195.37152814865112,737.8826217651367,9775,2571,7204,7204,0,22,2637000.0
2637,2637999,20.359366145951736,36.5092170482039,0.0876860742451383,925.1608226299286,195.4400999546051,738.0653839111328,9775,2571,7204,7204,0,22,2638000.0
2638,2638999,20.356470551897306,36.504591644708654,0.08768632060925563,925.5713367462158,195.50780510902405,738.0874786376953,9777,2572,7205,7205,0,22,2639000.0
2639,2639999,20.354002959173588,36.50165898073622,0.08767827052030752,925.8832201957703,195.57661962509155,738.5732803344727,9779,2573,7206,7206,0,22,2640000.0
2640,2640999,20.351881245305783,36.49760833410142,0.08767322155306678,926.2538313865662,195.64481282234192,738.8023529052734,9779,2573,7206,7206,0,22,2641000.0
2641,2641999,20.350313000554294,36.49460137054462,0.08765421074856461,926.703587770462,195.71311974525452,738.4198760986328,9782,2575,7207,7207,0,22,2642000.0
2642,2642999,20.349407338159164,36.49250388948879,0.08762699021791376,927.0085549354553,195.78233647346497,738.9515380859375,9782,2575,7207,7207,0,22,2643000.0
2643,2643999,20.348847145172446,36.49003152853782,0.08760702679299304,927.3554904460907,195.85116815567017,739.1444396972656,9783,2576,7207,7207,0,22,2644000.0
2644,2644999,20.34869700017265,36.48820682975523,0.0875880766636733,927.7765219211578,195.9220678806305,739.1660614013672,9783,2576,7207,7207,0,22,2645000.0
2645,2645999,20.35071755733982,36.48944887105084,0.08755693561981348,928.2805912494659,195.9914891719818,738.7877731323242,9783,2576,7207,7207,0,22,2646000.0
2646,2646999,20.35213381089637,36.488792058903364,0.08753574381988716,928.6404201984406,196.06155705451965,739.142333984375,9783,2576,7207,7207,0,22,2647000.0
2647,2647999,20.354136529470033,36.490276104825405,0.08751642422959938,929.0433745384216,196.13148093223572,739.1845321655273,9783,2576,7207,7207,0,22,2648000.0
2648,2648999,20.354815207213406,36.49029251476201,0.0874953962213122,929.2956833839417,196.20194578170776,739.6731567382812,9784,2577,7207,7207,0,22,2649000.0
2649,2649999,20.35213804962842,36.48663999573433,0.08749160316813986,929.5333743095398,196.26844096183777,741.4047698974609,9812,2577,7235,7235,0,22,2650000.0
2650,2650999,20.348904058896863,36.482431594801916,0.08748992847176063,929.6977736949921,196.33304405212402,742.7283554077148,9812,2577,7235,7235,0,22,2651000.0
2651,2651999,20.34591595134402,36.47795475770785,0.08748565834531918,929.9791057109833,196.39770603179932,743.1639938354492,9819,2580,7239,7239,0,22,2652000.0
2652,2652999,20.34339112703367,36.47429744083864,0.08747824125952319,930.26420545578,196.4625949859619,743.7509307861328,9823,2582,7241,7241,0,22,2653000.0
2653,2653999,20.340885948014844,36.47091309955237,0.0874770696416598,930.550350189209,196.52763319015503,744.1484680175781,9827,2584,7243,7243,0,22,2654000.0
2654,2654999,20.33874376172419,36.46802027176684,0.0874693376193173,931.0249817371368,196.5953118801117,743.8771743774414,9845,2588,7257,7257,0,22,2655000.0
2655,2655999,20.336637731155705,36.46449759323694,0.0874647848022454,931.2532215118408,196.66070342063904,744.7033843994141,9847,2589,7258,7258,0,22,2656000.0
2656,2656999,20.334650811123968,36.46064706948418,0.08746750777886225,931.5010361671448,196.72699570655823,745.3300857543945,9847,2589,7258,7258,0,22,2657000.0
2657,2657999,20.333149805085355,36.45803455759494,0.08746683028409208,931.8718168735504,196.79295992851257,745.4099273681641,9849,2590,7259,7259,0,22,2658000.0
2658,2658999,20.33244221095979,36.4567560108881,0.08745256062528428,932.2169678211212,196.86019587516785,745.6682205200195,9853,2592,7261,7261,0,22,2659000.0
2659,2659999,20.33367026318203,36.45907860702475,0.0874330833943352,932.5988352298737,196.92634630203247,745.6406478881836,9855,2593,7262,7262,0,22,2660000.0
2660,2660999,20.336075230916986,36.46322820263877,0.08739374584534532,932.8952326774597,196.99207878112793,746.2008972167969,9855,2593,7262,7262,0,22,2661000.0
2661,2661999,20.338780114300327,36.46845262326506,0.08736095829802382,933.2336709499359,197.058735370636,746.4415054321289,9857,2594,7263,7263,0,22,2662000.0
2662,2662999,20.343065626453672,36.481007353071355,0.08731175422225335,933.6534733772278,197.1262698173523,746.3402404785156,9875,2597,7278,7278,0,22,2663000.0
2663,2663999,20.348336237971875,36.49681128971895,0.08728354667983929,934.0164601802826,197.19299173355103,746.5122909545898,9881,2599,7282,7282,0,22,2664000.0
2664,2664999,20.353627582829485,36.50997820381582,0.08724466894974858,934.4226450920105,197.25933289527893,746.5871047973633,9883,2600,7283,7283,0,22,2665000.0
2665,2665999,20.358378132411303,36.51631734791339,0.08722780161566657,934.9391801357269,197.32808995246887,746.0460433959961,9887,2602,7285,7285,0,22,2666000.0
2666,2666999,20.36480766426585,36.52799456113016,0.08725645148726324,935.2277915477753,197.3948962688446,746.7099838256836,9887,2602,7285,7285,0,22,2667000.0
2667,2667999,20.369119199157154,36.53322533383631,0.08724201508680285,935.676185131073,197.4637689590454,746.54736328125,9891,2604,7287,7287,0,22,2668000.0
2668,2668999,20.372666541822962,36.53879735017739,0.08722440347897098,935.9527971744537,197.53166365623474,747.1736297607422,9891,2604,7287,7287,0,22,2669000.0
2669,2669999,20.370932033381994,36.53861462263854,0.087195565102404,936.1474106311798,197.59926629066467,748.6107177734375,9904,2604,7300,7300,0,22,2670000.0
2670,2670999,20.369642164608596,36.53934241328338,0.08714631161637743,936.4678280353546,197.664808511734,749.06005859375,9910,2606,7304,7304,0,22,2671000.0
2671,2671999,20.367158869143193,36.53567208305797,0.08714231986998988,936.7352576255798,197.7315227985382,749.6543884277344,9914,2607,7307,7307,0,22,2672000.0
2672,2672999,20.364739644372097,36.532520423232604,0.08713330331393576,937.1128394603729,197.7990894317627,749.7483749389648,9916,2608,7308,7308,0,22,2673000.0
2673,2673999,20.362196603349258,36.5290851382402,0.08713502239874005,937.4378125667572,197.86493945121765,749.9264907836914,9920,2610,7310,7310,0,22,2674000.0
2674,2674999,20.359721367463987,36.52498106253863,0.08713039762523622,937.8505899906158,197.93173956871033,750.0753707885742,9920,2610,7310,7310,0,22,2675000.0
2675,2675999,20.35700948300284,36.5203565558133,0.08713269737433926,938.1382279396057,197.99803948402405,750.5170288085938,9920,2610,7310,7310,0,22,2676000.0
2676,2676999,20.355126820939894,36.51760319681489,0.08714849254002,938.4272971153259,198.06536293029785,750.8951034545898,9920,2610,7310,7310,0,22,2677000.0
2677,2677999,20.352992063102167,36.51455262135399,0.08715667440858021,938.7159547805786,198.131334066391,751.2834701538086,9920,2610,7310,7310,0,22,2678000.0
2678,2678999,20.351497220834084,36.513944903821226,0.08716240724890545,939.1800096035004,198.1989290714264,750.9811172485352,9920,2610,7310,7310,0,22,2679000.0
2679,2679999,20.35197821321735,36.51974111972846,0.08717671946108685,939.5174272060394,198.26626634597778,751.058235168457,9923,2612,7311,7311,0,22,2680000.0
2680,2680999,20.35410865705101,36.52766483850441,0.08722266390567557,939.9508209228516,198.3357994556427,750.8886337280273,9939,2615,7324,7324,0,22,2681000.0
2681,2681999,20.357064092508246,36.53576837375029,0.08723148087202581,940.2643032073975,198.41140294075012,751.2687835693359,9941,2616,7325,7325,0,22,2682000.0
2682,2682999,20.3620935380976,36.551006580879395,0.08736040234599474,940.7371084690094,198.48147559165955,750.9951553344727,9941,2616,7325,7325,0,22,2683000.0
2683,2683999,20.367038504840327,36.56392538661113,0.08741783729456265,941.0601983070374,198.549391746521,751.3391265869141,9953,2617,7336,7336,0,22,2684000.0
2684,2684999,20.373077161889537,36.57780431975778,0.08750375878273031,941.4898450374603,198.61892533302307,751.2554702758789,9953,2617,7336,7336,0,22,2685000.0
2685,2685999,20.38052152774097,36.59460931121045,0.08755859673422917,941.841582775116,198.68931436538696,751.2907333374023,9957,2619,7338,7338,0,22,2686000.0
2686,2686999,20.38848655535772,36.610793393644975,0.08764907008817846,942.2835552692413,198.7582926750183,751.1728744506836,9957,2619,7338,7338,0,22,2687000.0
2687,2687999,20.395264061666285,36.625594728095365,0.08769870404866531,942.7306482791901,198.82671666145325,750.8740539550781,9961,2621,7340,7340,0,22,2688000.0
2688,2688999,20.40171750477613,36.637798235044514,0.08774542533277885,942.982369184494,198.89469528198242,751.6103134155273,9963,2622,7341,7341,0,22,2689000.0
2689,2689999,20.402710860799612,36.63824896400637,0.0877252295566816,943.3087630271912,198.9639823436737,752.346061706543,9977,2623,7354,7354,0,22,2690000.0
2690,2690999,20.400504475577428,36.63926883842362,0.0877018757018897,943.6270656585693,199.03136324882507,752.9543762207031,9982,2624,7358,7358,0,22,2691000.0
2691,2691999,20.397855442107577,36.635172687849035,0.08770719970162455,943.8712911605835,199.09980487823486,753.7733383178711,9984,2624,7360,7360,0,22,2692000.0
2692,2692999,20.39556667768734,36.63229214083403,0.0876966205156311,944.1176056861877,199.16732382774353,754.435417175293,9984,2624,7360,7360,0,22,2693000.0
2693,2693999,20.39286638458166,36.628488549328715,0.08769431176117803,944.4919285774231,199.2355387210846,754.6311721801758,9998,2625,7373,7373,0,22,2694000.0
2694,2694999,20.39019791863794,36.624496076714784,0.08769024890185939,944.7826166152954,199.30391359329224,755.5401611328125,10002,2627,7375,7375,0,22,2695000.0
2695,2695999,20.388308622432632,36.62269830448276,0.08767204179849142,944.9840013980865,199.37331986427307,756.6450424194336,10002,2627,7375,7375,0,22,2696000.0
2696,2696999,20.385897683242842,36.61885074513832,0.08766578553273585,945.2243518829346,199.44260787963867,757.3899688720703,10003,2627,7376,7376,0,22,2697000.0
2697,2697999,20.383022843741127,36.61409110205667,0.08767735112856878,945.4773268699646,199.51205396652222,757.8953018188477,10006,2628,7378,7378,0,22,2698000.0
2698,2698999,20.380440337277836,36.6098053743732,0.0876752605272858,945.8989260196686,199.58331608772278,757.694709777832,10010,2630,7380,7380,0,22,2699000.0
2699,2699999,20.37831060273453,36.60751620019841,0.08766195391513976,946.3434510231018,199.65313577651978,757.5953521728516,10012,2631,7381,7381,0,22,2700000.0
2700,2700999,20.37652918323549,36.60437033464777,0.08764400735989109,946.6998362541199,199.7218611240387,757.9594497680664,10024,2632,7392,7392,0,22,2701000.0
2701,2701999,20.374402952651607,36.600702843956356,0.08764309591101371,946.9449775218964,199.792405128479,758.5768814086914,10024,2632,7392,7392,0,22,2702000.0
2702,2702999,20.372617576801723,36.59742731247399,0.08763049177982796,947.369411945343,199.86311554908752,758.4626617431641,10026,2633,7393,7393,0,22,2703000.0
2703,2703999,20.37172837440011,36.59971954323461,0.08759209370063181,947.6229076385498,199.93211841583252,758.9735946655273,10028,2634,7394,7394,0,22,2704000.0
2704,2704999,20.37058160515179,36.59718738956742,0.08758142694520343,948.0283493995667,200.00955414772034,758.9893341064453,10028,2634,7394,7394,0,22,2705000.0
2705,2705999,20.369030995918653,36.59380162288137,0.08757409790451687,948.4136090278625,200.08070373535156,758.9895858764648,10030,2635,7395,7395,0,22,2706000.0
2706,2706999,20.368081979385156,36.591146616328224,0.08756283469507131,948.8761956691742,200.15229177474976,758.6225204467773,10034,2637,7397,7397,0,22,2707000.0
2707,2707999,20.367471053583508,36.58955931547782,0.0875444062519094,949.3180334568024,200.22337007522583,758.5131301879883,10036,2638,7398,7398,0,22,2708000.0
2708,2708999,20.366287409823723,36.58633198074823,0.08753693900604964,949.6176512241364,200.29288625717163,758.8055877685547,10038,2639,7399,7399,0,22,2709000.0
2709,2709999,20.36459572618485,36.582831225253045,0.0875250716363537,949.9272556304932,200.36242532730103,759.218864440918,10039,2639,7400,7400,0,22,2710000.0
2710,2710999,20.36214566116012,36.57842308374703,0.08752168165362861,950.2215740680695,200.4309642314911,760.1919479370117,10054,2639,7415,7415,0,22,2711000.0
2711,2711999,20.35893264914438,36.57394992556886,0.08753329538013466,950.5571913719177,200.49616599082947,760.7436141967773,10074,2641,7433,7433,0,22,2712000.0
2712,2712999,20.35592362415577,36.5689366356986,0.0875326762877845,950.7946755886078,200.56092143058777,761.7168807983398,10079,2641,7438,7438,0,22,2713000.0
2713,2713999,20.35353302822031,36.56469062084662,0.08752842375235981,951.0278785228729,200.62472772598267,762.6590576171875,10082,2642,7440,7440,0,22,2714000.0
2714,2714999,20.351404184917026,36.56106266107724,0.08751816555569725,951.2875549793243,200.68980932235718,763.5696868896484,10096,2643,7453,7453,0,22,2715000.0
2715,2715999,20.348622399899167,36.55645457928764,0.08752281662873529,951.5831091403961,200.75582194328308,764.1187286376953,10103,2646,7457,7457,0,22,2716000.0
2716,2716999,20.346400069247597,36.554214875301895,0.08751470073315593,951.9429566860199,200.82301425933838,764.3022689819336,10112,2649,7463,7463,0,22,2717000.0
2717,2717999,20.344489943708783,36.550685666838234,0.08751242581839891,952.279388666153,200.88901901245117,764.6818008422852,10118,2652,7466,7466,0,22,2718000.0
2718,2718999,20.342749428621712,36.547571152890534,0.08751175460500615,952.4989297389984,200.96337699890137,765.7859878540039,10119,2652,7467,7467,0,22,2719000.0
2719,2719999,20.34075398882872,36.54411466822668,0.08750961476862917,952.8849685192108,201.0297191143036,765.8265914916992,10123,2654,7469,7469,0,22,2720000.0
2720,2720999,20.339116412417585,36.54066465816551,0.08750474297375588,953.1317455768585,201.09608602523804,766.576301574707,10123,2654,7469,7469,0,22,2721000.0
2721,2721999,20.338348430317414,36.53838499264384,0.08750573427077435,953.5200619697571,201.16462993621826,766.595329284668,10127,2656,7471,7471,0,22,2722000.0
2722,2722999,20.337943455058657,36.53762551888151,0.0874991931407435,953.83829164505,201.23117852210999,766.9880828857422,10129,2657,7472,7472,0,22,2723000.0
2723,2723999,20.33791469318678,36.536511165946216,0.08749128378174376,954.1780543327332,201.29870867729187,767.2521286010742,10132,2658,7474,7474,0,22,2724000.0
2724,2724999,20.33786362679325,36.535467022308815,0.08750141405322431,954.528603553772,201.36579823493958,767.5699157714844,10135,2659,7476,7476,0,22,2725000.0
2725,2725999,20.33777950423285,36.53420238978088,0.08752919711050766,954.8553931713104,201.43265104293823,767.9050216674805,10149,2661,7488,7488,0,22,2726000.0
2726,2726999,20.33790966195436,36.5336221557349,0.08754845493322438,955.2088618278503,201.49942684173584,768.0429534912109,10154,2662,7492,7492,0,22,2727000.0
2727,2727999,20.33824408176738,36.5332945920617,0.08756286280349757,955.5784227848053,201.56654834747314,768.1812286376953,10158,2664,7494,7494,0,22,2728000.0
2728,2728999,20.339151250056503,36.53386511342675,0.08758897954849432,955.9773774147034,201.63418889045715,768.0742111206055,10162,2666,7496,7496,0,22,2729000.0
2729,2729999,20.339893904571024,36.53356552023687,0.08760372809698791,956.4535155296326,201.7016580104828,767.8142242431641,10164,2667,7497,7497,0,22,2730000.0
2730,2730999,20.339651047215323,36.53217439198039,0.0876229638354894,956.667804479599,201.77053809165955,768.633659362793,10166,2668,7498,7498,0,22,2731000.0
2731,2731999,20.338374976216908,36.52983124410714,0.08761859132708472,957.0438363552094,201.83922219276428,769.1633529663086,10177,2669,7508,7508,0,22,2732000.0
2732,2732999,20.335092004942876,36.52598325344877,0.0876425819442862,957.3675093650818,201.90732836723328,769.8261260986328,10185,2670,7515,7515,0,22,2733000.0
2733,2733999,20.33263267236563,36.52440028053882,0.08764823592867743,957.6621959209442,205.75484800338745,770.4515609741211,10188,2671,7517,7517,0,22,2734000.0
2734,2734999,20.32946238260866,36.51954364192733,0.08767704788031505,958.0776083469391,205.82096195220947,770.3313903808594,10194,2673,7521,7521,0,22,2735000.0
2735,2735999,20.326694005447248,36.515488628754945,0.08769240876065842,958.4347612857819,205.8886797428131,770.7291793823242,10195,2673,7522,7522,0,22,2736000.0
2736,2736999,20.32410473593467,36.512098904817535,0.08770620115075467,958.8532545566559,205.955708026886,770.7997131347656,10195,2673,7522,7522,0,22,2737000.0
2737,2737999,20.321836981574307,36.50881165054119,0.08771866658693239,959.1590905189514,206.02447390556335,771.1815719604492,10197,2674,7523,7523,0,22,2738000.0
2738,2738999,20.319050319986065,36.50494115716609,0.08774680175996019,959.5616841316223,206.09229731559753,771.1619110107422,10200,2676,7524,7524,0,22,2739000.0
2739,2739999,20.316901229720063,36.50166730812862,0.08775966062450014,959.9182868003845,206.16050028800964,771.5384521484375,10200,2676,7524,7524,0,22,2740000.0
2740,2740999,20.314735431799345,36.49784060812694,0.0877772065276391,960.425822019577,206.2294580936432,771.0976409912109,10202,2677,7525,7525,0,22,2741000.0
2741,2741999,20.31297450999479,36.494560219312724,0.08778005589090698,960.7433776855469,206.29797315597534,771.6189498901367,10202,2677,7525,7525,0,22,2742000.0
2742,2742999,20.31108221808125,36.49194262287371,0.08778561614018787,961.2557442188263,206.3688771724701,771.2905349731445,10213,2678,7535,7535,0,22,2743000.0
2743,2743999,20.30993754574738,36.49035681022356,0.08777558671410157,961.5643632411957,206.4380807876587,771.7987670898438,10213,2678,7535,7535,0,22,2744000.0
2744,2744999,20.308308785049118,36.48700301301132,0.0877870260015462,961.9263021945953,206.50680589675903,771.9318008422852,10214,2679,7535,7535,0,22,2745000.0
2745,2745999,20.30748465597284,36.48549170715288,0.0877774893295784,962.3226008415222,206.5761890411377,771.9047393798828,10215,2680,7535,7535,0,22,2746000.0
2746,2746999,20.305666484688885,36.48170066003108,0.08780123258045003,962.7277321815491,206.64722514152527,772.0076293945312,10215,2680,7535,7535,0,22,2747000.0
2747,2747999,20.303957273560403,36.478059283434575,0.0878121762437023,963.0909707546234,206.71783709526062,772.102897644043,10219,2682,7537,7537,0,22,2748000.0
2748,2748999,20.301992264316283,36.47429523387144,0.08782952670555755,963.536548614502,206.78842687606812,772.0582122802734,10221,2683,7538,7538,0,22,2749000.0
2749,2749999,20.299227869919196,36.47042014977494,0.08784495289825356,963.7982034683228,206.8577845096588,773.2318496704102,10232,2683,7549,7549,0,22,2750000.0
2750,2750999,20.29549362041836,36.465691228842765,0.0878811813014373,964.0608253479004,206.92345428466797,774.1617202758789,10236,2683,7553,7553,0,22,2751000.0
2751,2751999,20.29185378265805,36.46032494541912,0.08792272991919059,964.3504786491394,206.9894962310791,774.6296691894531,10243,2685,7558,7558,0,22,2752000.0
2752,2752999,20.288601800456604,36.4559004053409,0.08794941457931182,964.6261067390442,207.05552554130554,775.2204437255859,10243,2685,7558,7558,0,22,2753000.0
2753,2753999,20.285562933374514,36.45168856532854,0.08797855101283891,964.857684135437,207.12147617340088,775.9677810668945,10256,2686,7570,7570,0,22,2754000.0
2754,2754999,20.28248608078503,36.447341533155715,0.08799935908046119,965.2210621833801,207.19071245193481,776.3597106933594,10263,2689,7574,7574,0,22,2755000.0
2755,2755999,20.279657791477742,36.44369657350585,0.08800572107745597,965.4699814319611,207.261638879776,777.1779861450195,10265,2690,7575,7575,0,22,2756000.0
2756,2756999,20.277002844004848,36.440041791890856,0.08800788984653685,965.7093901634216,207.32896327972412,777.91015625,10268,2691,7577,7577,0,22,2757000.0
2757,2757999,20.274604917843302,36.43636318605806,0.08801091810722328,966.0324618816376,207.3951804637909,778.2056045532227,10270,2692,7578,7578,0,22,2758000.0
2758,2758999,20.272244919213826,36.43264012153279,0.08801060415041773,966.3520381450653,207.461731672287,778.5563354492188,10271,2692,7579,7579,0,22,2759000.0
2759,2759999,20.271105381506587,36.43751674844241,0.08795869509396359,966.7802896499634,207.52941250801086,778.3050842285156,10273,2693,7580,7580,0,22,2760000.0
2760,2760999,20.26940514378566,36.43451640591809,0.08794765024645335,967.2039139270782,207.5982220172882,778.1735153198242,10277,2695,7582,7582,0,22,2761000.0
2761,2761999,20.268199344115956,36.43215958310885,0.08792349340393169,967.5024173259735,207.66603755950928,778.5910949707031,10277,2695,7582,7582,0,22,2762000.0
2762,2762999,20.267124459581435,36.429887946955105,0.08790464354219096,967.7875735759735,207.7339026927948,779.085823059082,10279,2696,7583,7583,0,22,2763000.0
2763,2763999,20.267417247446986,36.429781617085325,0.08788832213351927,968.1063182353973,207.8007047176361,779.4491882324219,10279,2696,7583,7583,0,22,2764000.0
2764,2764999,20.26688763848648,36.42833754643473,0.0878711332986849,968.4932346343994,207.86834239959717,779.4070739746094,10283,2698,7585,7585,0,22,2765000.0
2765,2765999,20.26680899296771,36.4275006255949,0.08785082017388557,968.9583830833435,207.93598747253418,779.0993118286133,10285,2699,7586,7586,0,22,2766000.0
2766,2766999,20.266682304533706,36.42660139026045,0.08782063715938138,969.3896865844727,208.00354075431824,778.9189834594727,10289,2701,7588,7588,0,22,2767000.0
2767,2767999,20.26624130059531,36.424508004562085,0.0878021297699414,969.741274356842,208.07237648963928,779.195556640625,10290,2701,7589,7589,0,22,2768000.0
2768,2768999,20.26536298056768,36.421828229707664,0.0877890620394145,970.021087884903,208.1405327320099,779.6406707763672,10291,2702,7589,7589,0,22,2769000.0
2769,2769999,20.263067291766845,36.41871288412422,0.0877794888394362,970.3156628608704,208.20931339263916,780.6080703735352,10302,2703,7599,7599,0,22,2770000.0
2770,2770999,20.25944315219063,36.41365171835384,0.08780312973354587,970.5540466308594,208.2751591205597,781.5037536621094,10307,2704,7603,7603,0,22,2771000.0
2771,2771999,20.256177385654652,36.40932530498648,0.08781658792637326,970.9500744342804,208.34219193458557,781.6058578491211,10309,2704,7605,7605,0,22,2772000.0
2772,2772999,20.2528587327628,36.405442155214395,0.08782969274155705,971.2415697574615,208.40895628929138,782.1504287719727,10311,2705,7606,7606,0,22,2773000.0
2773,2773999,20.24999240610237,36.40200376350031,0.08783457952882923,971.633394241333,208.47626423835754,782.2019348144531,10313,2706,7607,7607,0,22,2774000.0
2774,2774999,20.246704128796384,36.39767474798926,0.08784583065134921,972.1105291843414,208.54579830169678,782.0003890991211,10333,2710,7623,7623,0,22,2775000.0
2775,2775999,20.24390219328652,36.393027869555965,0.0878510942885854,972.2930700778961,208.61501955986023,783.4325256347656,10333,2710,7623,7623,0,22,2776000.0
2776,2776999,20.24075900676713,36.38807196062429,0.08786277989725422,972.4636313915253,208.68271660804749,784.572135925293,10334,2710,7624,7624,0,22,2777000.0
2777,2777999,20.238104988295277,36.38381979060741,0.08786383145917076,972.8067526817322,208.75153136253357,784.7490081787109,10339,2712,7627,7627,0,22,2778000.0
2778,2778999,20.235249380338352,36.37909444779062,0.08787857600481719,973.1328699588776,208.82046175003052,785.1662902832031,10339,2712,7627,7627,0,22,2779000.0
2779,2779999,20.23259212843176,36.37451835284124,0.08788089345505556,973.5689694881439,208.88825702667236,785.0445556640625,10341,2713,7628,7628,0,22,2780000.0
2780,2780999,20.230718903454036,36.37174418895259,0.08786355492487463,973.9593262672424,208.95622515678406,785.2354125976562,10343,2714,7629,7629,0,22,2781000.0
2781,2781999,20.228535946635297,36.36782564155561,0.08786272979391674,974.165607213974,209.02482676506042,786.0331954956055,10343,2714,7629,7629,0,22,2782000.0
2782,2782999,20.22681989235293,36.364779174600166,0.08784789068649901,974.5554659366608,209.09323930740356,786.0141830444336,10345,2715,7630,7630,0,22,2783000.0
2783,2783999,20.22487367003181,36.36116395644233,0.0878395464021211,974.9889485836029,209.1628167629242,785.8957138061523,10345,2715,7630,7630,0,22,2784000.0
2784,2784999,20.22306826236318,36.35768056909202,0.08783015534466743,975.3317818641663,209.23077082633972,786.075813293457,10345,2715,7630,7630,0,22,2785000.0
2785,2785999,20.221554196475232,36.35486484121614,0.08782303208723408,975.696222782135,209.29957127571106,786.2373962402344,10345,2715,7630,7630,0,22,2786000.0
2786,2786999,20.219801079911118,36.35118326702279,0.08782422829048553,976.0586106777191,209.36771750450134,786.3152465820312,10349,2717,7632,7632,0,22,2787000.0
2787,2787999,20.21829044994094,36.34982544391154,0.0878068241351837,976.4020707607269,209.43685102462769,786.4926910400391,10349,2717,7632,7632,0,22,2788000.0
2788,2788999,20.216499032728386,36.346477258540254,0.08779957076989686,976.8666832447052,209.5048656463623,786.2229537963867,10351,2718,7633,7633,0,22,2789000.0
2789,2789999,20.214067608993723,36.342262734267734,0.08780420956387847,977.170832157135,209.5733208656311,786.6686248779297,10352,2718,7634,7634,0,22,2790000.0
2790,2790999,20.213516487637346,36.34602813366988,0.08778381903078714,977.5307946205139,209.64396381378174,787.672966003418,10376,2718,7658,7658,0,22,2791000.0
2791,2791999,20.213444997000046,36.34721050807887,0.08775913710346173,977.6750240325928,209.70819473266602,789.284553527832,10378,2718,7660,7660,0,22,2792000.0
2792,2792999,20.21186743309822,36.34614396359939,0.08775209916230176,977.8287692070007,209.77313947677612,790.4389266967773,10380,2718,7662,7662,0,22,2793000.0
2793,2793999,20.210545355240782,36.34578259127744,0.08775103905753046,978.1522219181061,209.83780455589294,790.8196868896484,10386,2721,7665,7665,0,22,2794000.0
2794,2794999,20.209366397241105,36.344811343004814,0.08774010019905254,978.4033856391907,209.90371203422546,791.3492736816406,10390,2723,7667,7667,0,22,2795000.0
2795,2795999,20.2089280026029,36.34695338169048,0.0877279454349208,978.8428030014038,209.97114157676697,791.0085144042969,10402,2729,7673,7673,0,22,2796000.0
2796,2796999,20.20721307020179,36.344922591494466,0.08772781780330297,979.1928358078003,210.03836154937744,791.4869384765625,10404,2730,7674,7674,0,22,2797000.0
2797,2797999,20.206104599415053,36.34427709994366,0.08776004952257899,979.4345681667328,210.10498428344727,792.2398529052734,10404,2730,7674,7674,0,22,2798000.0
2798,2798999,20.205491805741108,36.34373454139812,0.08778270718425762,979.8210370540619,210.17277598381042,792.2828826904297,10408,2732,7676,7676,0,22,2799000.0
2799,2799999,20.20502138954057,36.34917152446858,0.08774312439988086,980.1519770622253,210.24069786071777,792.5940475463867,10408,2732,7676,7676,0,22,2800000.0
2800,2800999,20.20428619977395,36.34750670098326,0.08777544831129735,980.4619286060333,210.3065323829651,793.0075759887695,10408,2732,7676,7676,0,22,2801000.0
2801,2801999,20.203840894006085,36.346393244603604,0.08775659663387614,980.7721223831177,210.37404322624207,793.4240493774414,10410,2733,7677,7677,0,22,2802000.0
2802,2802999,20.203547753153206,36.346105849785694,0.08775204912789203,981.2092678546906,210.44007468223572,793.1570892333984,10412,2734,7678,7678,0,22,2803000.0
2803,2803999,20.20312300508165,36.34534507462011,0.08774281710590404,981.555704832077,210.5076847076416,793.4252777099609,10412,2734,7678,7678,0,22,2804000.0
2804,2804999,20.202501727807302,36.3439418127728,0.08771632649788608,981.8893194198608,210.57517194747925,793.7716293334961,10414,2735,7679,7679,0,22,2805000.0
2805,2805999,20.202255678512522,36.34222080255324,0.08771458724508685,982.192526102066,210.6414613723755,794.0021743774414,10416,2736,7680,7680,0,22,2806000.0
2806,2806999,20.20231366140358,36.34081129909012,0.08772034478475599,982.6795756816864,210.70952081680298,793.6664505004883,10418,2737,7681,7681,0,22,2807000.0
2807,2807999,20.203192947171864,36.347626730837526,0.08767334290798301,983.0783212184906,210.77929306030273,793.6983795166016,10418,2737,7681,7681,0,22,2808000.0
2808,2808999,20.202978917480177,36.34584335256064,0.08767101336730565,983.405547618866,210.84595274925232,794.0563201904297,10418,2737,7681,7681,0,22,2809000.0
2809,2809999,20.202408115028668,36.34357555351066,0.08767017242953223,983.7536964416504,210.91496777534485,794.2773742675781,10418,2737,7681,7681,0,22,2810000.0
2810,2810999,20.200761887602074,36.339731835188026,0.08766315909241085,984.1118466854095,210.98375296592712,794.4915084838867,10426,2738,7688,7688,0,22,2811000.0
2811,2811999,20.19703772601808,36.33509366562139,0.08769138468048143,984.3567364215851,211.0493607521057,795.6073684692383,10431,2738,7693,7693,0,22,2812000.0
2812,2812999,20.193593831247526,36.3307107860126,0.08771255956475166,984.6018500328064,211.11468625068665,796.2868118286133,10436,2739,7697,7697,0,22,2813000.0
2813,2813999,20.190354986945245,36.326591848808214,0.08772946812898164,984.9194688796997,211.18124794960022,796.5946884155273,10439,2740,7699,7699,0,22,2814000.0
2814,2814999,20.187181480908965,36.32193829595909,0.0877473553257917,985.1884455680847,211.24753761291504,797.0796508789062,10439,2740,7699,7699,0,22,2815000.0
2815,2815999,20.18418179443812,36.31740710196092,0.08776255719782522,985.5627961158752,211.31464314460754,797.1720275878906,10441,2741,7700,7700,0,22,2816000.0
2816,2816999,20.18160641282023,36.314198738579684,0.08776526026093168,985.8800342082977,211.38122272491455,797.5233612060547,10443,2742,7701,7701,0,22,2817000.0
2817,2817999,20.17913271653307,36.3107231096494,0.0877606226657579,986.2847239971161,211.45146250724792,797.5173721313477,10459,2744,7715,7715,0,22,2818000.0
2818,2818999,20.17651770274777,36.3067213042794,0.08776193332433624,986.529509305954,211.5194742679596,798.4771957397461,10460,2744,7716,7716,0,22,2819000.0
2819,2819999,20.173948981687726,36.302275047326816,0.08775915336400653,986.9332294464111,211.588280916214,798.5448760986328,10464,2746,7718,7718,0,22,2820000.0
2820,2820999,20.17171397510004,36.29809940278676,0.08775488667533204,987.2256367206573,211.65549302101135,799.1450500488281,10466,2747,7719,7719,0,22,2821000.0
2821,2821999,20.17003441770175,36.29523654172998,0.0877350699163999,987.4403021335602,211.72346997261047,799.9783477783203,10467,2747,7720,7720,0,22,2822000.0
2822,2822999,20.16969750136785,36.30245520847278,0.08766823522501344,987.72789311409,211.79109930992126,800.256217956543,10469,2748,7721,7721,0,22,2823000.0
2823,2823999,20.169687271685078,36.30286787374224,0.08763292948713586,988.09375166893,211.85833191871643,800.4569625854492,10469,2748,7721,7721,0,22,2824000.0
2824,2824999,20.169922972600112,36.303250830277506,0.08759936439479721,988.6228206157684,211.92625832557678,799.8472442626953,10475,2751,7724,7724,0,22,2825000.0
2825,2825999,20.17090380680079,36.30563262596139,0.08756113502138296,988.8239479064941,211.9932279586792,800.7178115844727,10475,2751,7724,7724,0,22,2826000.0
2826,2826999,20.171694890651036,36.30650372244501,0.08752918609216076,989.1547381877899,212.0603952407837,800.9733810424805,10475,2751,7724,7724,0,22,2827000.0
2827,2827999,20.171896279064182,36.30538684330774,0.08750495861453944,989.5883460044861,212.1288845539093,800.7285995483398,10477,2752,7725,7725,0,22,2828000.0
2828,2828999,20.173625383573725,36.30726801094089,0.08748761170812702,989.9306643009186,212.1973419189453,800.9284286499023,10477,2752,7725,7725,0,22,2829000.0
2829,2829999,20.174572866318158,36.307416183755606,0.08747044480614707,990.3133878707886,212.27008700370789,801.0378494262695,10479,2753,7726,7726,0,22,2830000.0
2830,2830999,20.17455909399691,36.305650573631155,0.08746632402878718,990.696789264679,212.33826160430908,801.1351776123047,10485,2754,7731,7731,0,22,2831000.0
2831,2831999,20.173624602624397,36.30295898785175,0.08745671779275777,991.0732910633087,212.40854740142822,801.7021560668945,10494,2754,7740,7740,0,22,2832000.0
2832,2832999,20.171104172217593,36.30012720577231,0.08745136593014102,991.3107752799988,212.4769971370697,802.72119140625,10503,2755,7748,7748,0,22,2833000.0
2833,2833999,20.168307613319225,36.297047880442975,0.0874579044233007,991.6067838668823,212.544193983078,803.2735977172852,10503,2755,7748,7748,0,22,2834000.0
2834,2834999,20.165403449722593,36.292279993914576,0.0874668215090042,991.8932762145996,212.61131882667542,803.8534469604492,10506,2756,7750,7750,0,22,2835000.0
2835,2835999,20.163513651696515,36.28888184575189,0.0874578628561179,992.2505300045013,212.67954897880554,803.9748611450195,10508,2757,7751,7751,0,22,2836000.0
2836,2836999,20.16190290330688,36.286937548947236,0.08744158215640485,992.6401040554047,212.74715065956116,804.1226119995117,10512,2759,7753,7753,0,22,2837000.0
2837,2837999,20.160827953267226,36.28573515520694,0.08742936693479297,993.0144300460815,212.81728863716125,804.2582092285156,10515,2760,7755,7755,0,22,2838000.0
2838,2838999,20.160341902742363,36.28544081242563,0.08741991818096762,993.4230799674988,212.88494849205017,804.250373840332,10517,2761,7756,7756,0,22,2839000.0
2839,2839999,20.16053692183276,36.28753025851081,0.08740010685641042,993.7719712257385,212.95524859428406,804.3840637207031,10520,2763,7757,7757,0,22,2840000.0
2840,2840999,20.16125752739461,36.28958173712235,0.08740473399321147,994.1708633899689,213.02462220191956,804.4131927490234,10522,2764,7758,7758,0,22,2841000.0
2841,2841999,20.162587948554968,36.29261192839005,0.08741468913668582,994.6532714366913,213.10035228729248,804.2870178222656,10524,2765,7759,7759,0,22,2842000.0
2842,2842999,20.164945914731867,36.298683846567926,0.0874419963411307,994.9645504951477,213.1702663898468,804.6925964355469,10526,2766,7760,7760,0,22,2843000.0
2843,2843999,20.16900735939317,36.31310971239707,0.08750245299403592,995.3688607215881,213.2421567440033,804.8123245239258,10527,2766,7761,7761,0,22,2844000.0
2844,2844999,20.172117853283318,36.32039264976221,0.08756567565571782,995.6773166656494,213.31265926361084,805.1573181152344,10529,2767,7762,7762,0,22,2845000.0
2845,2845999,20.17644681410233,36.33209201075505,0.0876925940854133,996.0555522441864,213.3845510482788,805.4033813476562,10531,2768,7763,7763,0,22,2846000.0
2846,2846999,20.181275431165453,36.34203718919866,0.08781124667150009,996.3687205314636,213.45488357543945,805.8182144165039,10535,2769,7766,7766,0,22,2847000.0
2847,2847999,20.186638015263043,36.35477842286796,0.0879164643754744,996.7713351249695,213.52626585960388,805.6879730224609,10538,2771,7767,7767,0,22,2848000.0
2848,2848999,20.192079431477268,36.36451998948575,0.08809865986633236,997.1784830093384,213.59918928146362,805.6516265869141,10540,2772,7768,7768,0,22,2849000.0
2849,2849999,20.19676557978418,36.37168862188176,0.08817704441936491,997.5669522285461,213.6705346107483,805.7487335205078,10540,2772,7768,7768,0,22,2850000.0
2850,2850999,20.20220722100948,36.380446438102624,0.08831259484379939,997.9623079299927,213.74217295646667,805.9070587158203,10540,2772,7768,7768,0,22,2851000.0
2851,2851999,20.20599932162187,36.38442244076502,0.08835583003214709,998.4424231052399,213.81431198120117,805.6055068969727,10540,2772,7768,7768,0,22,2852000.0
2852,2852999,20.20542487713931,36.3823390662603,0.0883331430306602,998.6390113830566,213.88158059120178,807.0997161865234,10564,2773,7791,7791,0,22,2853000.0
2853,2853999,20.20348585464872,36.37989810373231,0.08830245803319081,998.9729409217834,213.94800543785095,807.8321151733398,10576,2773,7803,7803,0,22,2854000.0
2854,2854999,20.20129107989008,36.37576575200891,0.08829642177675079,999.2561457157135,214.01314425468445,808.568229675293,10583,2774,7809,7809,0,22,2855000.0
2855,2855999,20.200663198667886,36.37917495346423,0.0882512212044464,999.4482338428497,214.07713055610657,809.7350158691406,10585,2774,7811,7811,0,22,2856000.0
2856,2856999,20.199021230860335,36.375953352860165,0.08824096642483148,999.600419998169,214.142995595932,811.0230026245117,10587,2774,7813,7813,0,22,2857000.0
2857,2857999,20.197765596591896,36.373232887514696,0.08822925260162862,999.9622766971588,214.20910573005676,811.4557800292969,10592,2776,7816,7816,0,22,2858000.0
2858,2858999,20.19603657675779,36.369480415854774,0.08822029351763205,1000.2549815177917,214.27564072608948,812.0589752197266,10596,2778,7818,7818,0,22,2859000.0
2859,2859999,20.19479699517297,36.367384343904824,0.0882153103727471,1000.539891242981,214.341943025589,812.6507339477539,10600,2780,7820,7820,0,22,2860000.0
2860,2860999,20.194205153648824,36.36641518634566,0.08819503146098051,1000.7382736206055,214.40919947624207,813.5782623291016,10601,2780,7821,7821,0,22,2861000.0
2861,2861999,20.193408841821515,36.36417795473799,0.08818606956398889,1001.0683352947235,214.47478437423706,813.7726745605469,10607,2783,7824,7824,0,22,2862000.0
2862,2862999,20.19252466313954,36.36215105066087,0.0881709967015264,1001.3767642974854,214.5411298274994,814.2514419555664,10609,2784,7825,7825,0,22,2863000.0
2863,2863999,20.192234508161782,36.361529873794524,0.08815881732740838,1001.6667237281799,214.60790586471558,814.7347793579102,10611,2785,7826,7826,0,22,2864000.0
2864,2864999,20.191879118234468,36.35963499025936,0.08815560575489079,1002.0573139190674,214.67410445213318,814.6023330688477,10616,2787,7829,7829,0,22,2865000.0
2865,2865999,20.191843754214844,36.358932249892135,0.08814933278059733,1002.3454434871674,214.7416660785675,815.0609130859375,10616,2787,7829,7829,0,22,2866000.0
2866,2866999,20.192210897151224,36.35811821792262,0.0881370123766384,1002.8297300338745,214.80851364135742,814.6421966552734,10620,2789,7831,7831,0,22,2867000.0
2867,2867999,20.192382777548893,36.35837024945034,0.08812532397410977,1003.1708912849426,214.87644147872925,814.8965377807617,10622,2790,7832,7832,0,22,2868000.0
2868,2868999,20.192511939838642,36.357244419867584,0.0881258475326715,1003.4966554641724,214.94316387176514,815.295280456543,10624,2791,7833,7833,0,22,2869000.0
2869,2869999,20.193008287060625,36.35664256856649,0.08812048444658849,1003.8388502597809,215.0098056793213,815.5022048950195,10626,2792,7834,7834,0,22,2870000.0
2870,2870999,20.192881736831904,36.35472308864023,0.08812761479155318,1004.3538494110107,215.07873702049255,815.0686798095703,10635,2796,7839,7839,0,22,2871000.0
2871,2871999,20.192680700791136,36.352743911454645,0.08813485801019205,1004.6460001468658,215.1456115245819,815.6686630249023,10635,2796,7839,7839,0,22,2872000.0
2872,2872999,20.19176847498081,36.34966094749134,0.08814252764340658,1004.9197452068329,215.21337819099426,816.1108627319336,10637,2797,7840,7840,0,22,2873000.0
2873,2873999,20.18934059005291,36.34538045386198,0.08814923549906228,1005.3714144229889,215.28083848953247,816.3530502319336,10649,2798,7851,7851,0,22,2874000.0
2874,2874999,20.18618371470544,36.341090789461205,0.08816673487548732,1005.6585490703583,215.34899854660034,817.2378082275391,10654,2798,7856,7856,0,22,2875000.0
2875,2875999,20.183565336686133,36.33878235925623,0.08816968563878624,1005.9516015052795,215.41640710830688,817.7868728637695,10667,2799,7868,7868,0,22,2876000.0
2876,2876999,20.18099666743761,36.335136114432544,0.08817998230937452,1006.2939705848694,215.48310589790344,818.1664657592773,10681,2800,7881,7881,0,22,2877000.0
2877,2877999,20.17830407374972,36.330704541781955,0.08819416145733372,1006.7616369724274,215.55081701278687,818.07421875,10694,2801,7893,7893,0,22,2878000.0
2878,2878999,20.17591564858086,36.32734381662077,0.08819583432536093,1007.1300778388977,215.61875534057617,818.4240570068359,10694,2801,7893,7893,0,22,2879000.0
2879,2879999,20.173634877643938,36.3234961181455,0.08819850972283194,1007.4811730384827,215.68535041809082,818.6193695068359,10696,2802,7894,7894,0,22,2880000.0
2880,2880999,20.171713968589845,36.320429822402645,0.08819421304056885,1007.9554188251495,215.75376439094543,818.2184219360352,10701,2805,7896,7896,0,22,2881000.0
2881,2881999,20.170344907544155,36.317673822404004,0.08818430399274813,1008.2687292098999,215.82217812538147,818.7269439697266,10702,2806,7896,7896,0,22,2882000.0
2882,2882999,20.16971524346515,36.31622270259392,0.08816818820388528,1008.6824793815613,215.89057636260986,818.7991180419922,10702,2806,7896,7896,0,22,2883000.0
2883,2883999,20.16972704951853,36.31495939241538,0.08814445154257122,1009.0365159511566,215.95838117599487,818.9883728027344,10704,2807,7897,7897,0,22,2884000.0
2884,2884999,20.17018807947382,36.315248259920025,0.08812981600725622,1009.4987211227417,216.0280327796936,818.6156463623047,10708,2809,7899,7899,0,22,2885000.0
2885,2885999,20.17048578457239,36.314119839782826,0.08814393541466126,1009.9140484333038,216.09822750091553,818.8563690185547,10708,2809,7899,7899,0,22,2886000.0
2886,2886999,20.171333561973228,36.31420314518697,0.08816541964443192,1010.2162809371948,216.16680693626404,819.338737487793,10708,2809,7899,7899,0,22,2887000.0
2887,2887999,20.1722828094161,36.31393469222366,0.08819337987391707,1010.5944929122925,216.2369623184204,819.404296875,10712,2811,7901,7901,0,22,2888000.0
2888,2888999,20.173111349684152,36.31292456134384,0.08821417344271199,1010.9981677532196,216.30652809143066,819.4298553466797,10713,2812,7901,7901,0,22,2889000.0
2889,2889999,20.17345452750039,36.31137009270279,0.08821684466560009,1011.4796979427338,216.37850332260132,819.1955451965332,10727,2813,7914,7914,0,22,2890000.0
2890,2890999,20.17353074253463,36.30906628523993,0.0882004616043992,1011.7863311767578,216.44949293136597,819.7165794372559,10727,2813,7914,7914,0,22,2891000.0
2891,2891999,20.171713024805552,36.31027760869543,0.08818932419480041,1012.0375127792358,216.51572608947754,820.9081916809082,10742,2814,7928,7928,0,22,2892000.0
2892,2892999,20.169066863485984,36.3072858680826,0.0882102831691074,1012.2721264362335,216.5806863307953,821.8662376403809,10746,2815,7931,7931,0,22,2893000.0
2893,2893999,20.166452238173953,36.30295865296461,0.088237643081846,1012.6047224998474,216.64600133895874,822.2876396179199,10747,2815,7932,7932,0,22,2894000.0
2894,2894999,20.16496789156747,36.30141317155026,0.08824232256785958,1012.8991785049438,216.71156454086304,822.7319374084473,10748,2815,7933,7933,0,22,2895000.0
2895,2895999,20.162962814792095,36.29844148134164,0.08824960227509815,1013.3299376964569,216.77725982666016,822.4974479675293,10756,2818,7938,7938,0,22,2896000.0
2896,2896999,20.160801876604907,36.29513073190734,0.08826366805739927,1013.7086482048035,216.8434865474701,822.5843925476074,10760,2820,7940,7940,0,22,2897000.0
2897,2897999,20.158376473914924,36.291158173702655,0.0882810301678113,1014.0408456325531,216.91113805770874,823.0306358337402,10762,2821,7941,7941,0,22,2898000.0
2898,2898999,20.156219126472966,36.287723362466416,0.08829413973194566,1014.2877883911133,216.97793674468994,823.6643486022949,10762,2821,7941,7941,0,22,2899000.0
2899,2899999,20.154406355539408,36.28515827301195,0.0882946455148872,1014.7270483970642,217.04482102394104,823.461727142334,10766,2823,7943,7943,0,22,2900000.0
2900,2900999,20.152977552647403,36.283150088783806,0.08829340954931175,1015.271214723587,217.11253547668457,822.9348411560059,10768,2824,7944,7944,0,22,2901000.0
2901,2901999,20.15137784678449,36.2805537074193,0.088287860702704,1015.5684802532196,217.1797103881836,823.4703407287598,10768,2824,7944,7944,0,22,2902000.0
2902,2902999,20.150478643556262,36.278739023897664,0.08828070350032236,1015.8667938709259,217.2471649646759,823.8266868591309,10769,2825,7944,7944,0,22,2903000.0
2903,2903999,20.149702711489823,36.28023521390288,0.08826455776581188,1016.2116935253143,217.31531715393066,824.1264457702637,10769,2825,7944,7944,0,22,2904000.0
2904,2904999,20.1491407988139,36.278504519760546,0.08825841244994281,1016.4997456073761,217.38213562965393,824.6008796691895,10769,2825,7944,7944,0,22,2905000.0
2905,2905999,20.14913379159209,36.277698678487695,0.08823793838389704,1016.9556105136871,217.45124459266663,824.3348121643066,10773,2827,7946,7946,0,22,2906000.0
2906,2906999,20.14920053412153,36.27755958201126,0.08821063278020369,1017.3578670024872,217.51832389831543,824.212100982666,10778,2828,7950,7950,0,22,2907000.0
2907,2907999,20.14836658884546,36.27763705734882,0.08818157018473394,1017.7195932865143,217.58550357818604,824.303165435791,10781,2830,7951,7951,0,22,2908000.0
2908,2908999,20.145239260250097,36.27294185387891,0.08821467064293065,1018.0261731147766,217.65291452407837,825.2208366394043,10794,2831,7963,7963,0,22,2909000.0
2909,2909999,20.142391525310114,36.27042422739606,0.08823695759699623,1018.3256442546844,217.7197015285492,825.9079856872559,10796,2831,7965,7965,0,22,2910000.0
2910,2910999,20.139619516667448,36.26726098121102,0.08827098270452027,1018.7161514759064,217.78520679473877,826.059268951416,10797,2831,7966,7966,0,22,2911000.0
2911,2911999,20.13691679209182,36.264338844078196,0.08829939485223148,1019.0781211853027,217.85178971290588,826.299976348877,10802,2833,7969,7969,0,22,2912000.0
2912,2912999,20.1337337729564,36.26015993189236,0.08834264134920533,1019.4857230186462,217.91877150535583,826.4498405456543,10804,2834,7970,7970,0,22,2913000.0
2913,2913999,20.130849609621258,36.25636515838636,0.08836638319179135,1019.8419976234436,217.98546648025513,826.7874794006348,10804,2834,7970,7970,0,22,2914000.0
2914,2914999,20.12811780900495,36.252792833881074,0.0883852615566737,1020.1495354175568,218.05243110656738,827.0734519958496,10805,2835,7970,7970,0,22,2915000.0
2915,2915999,20.12672537634432,36.25291551723551,0.08836571042464436,1020.5546555519104,218.11997365951538,826.9801368713379,10810,2838,7972,7972,0,22,2916000.0
2916,2916999,20.12598099659249,36.25342727714663,0.08835016962527198,1021.0644364356995,218.18947768211365,826.6424140930176,10812,2839,7973,7973,0,22,2917000.0
2917,2917999,20.125435931169694,36.25424994241654,0.0883361891558263,1021.3279867172241,218.2580487728119,827.2691535949707,10814,2840,7974,7974,0,22,2918000.0
2918,2918999,20.125407322017523,36.25497873221878,0.08835407297806475,1021.7760429382324,218.3272247314453,827.2057075500488,10816,2841,7975,7975,0,22,2919000.0
2919,2919999,20.124674404775785,36.25443881169531,0.08836151306020912,1022.1372044086456,218.397700548172,827.4796943664551,10816,2841,7975,7975,0,22,2920000.0
2920,2920999,20.124532533109864,36.2548562972622,0.08835145775081721,1022.4461123943329,218.46678614616394,827.8781700134277,10816,2841,7975,7975,0,22,2921000.0
2921,2921999,20.12433846321175,36.25414827055453,0.08834678295343446,1022.844621181488,218.53790402412415,827.8617210388184,10822,2843,7979,7979,0,22,2922000.0
2922,2922999,20.124611459708138,36.25386492403385,0.08832859462485887,1023.155279636383,222.7053346633911,828.3168144226074,10822,2843,7979,7979,0,22,2923000.0
2923,2923999,20.12493459855682,36.25621755861342,0.08830488757984023,1023.5557994842529,222.77529883384705,828.342845916748,10822,2843,7979,7979,0,22,2924000.0
2924,2924999,20.125848777366237,36.25641997856398,0.08827291438009577,1023.8559801578522,222.84623456001282,828.7336235046387,10823,2844,7979,7979,0,22,2925000.0
2925,2925999,20.125368146220808,36.253924744224435,0.0882559350637806,1024.3530700206757,222.91960859298706,828.6860237121582,10838,2845,7993,7993,0,22,2926000.0
2926,2926999,20.12482501203067,36.25175632512539,0.08824612163323475,1024.6045789718628,222.99371123313904,829.6230201721191,10839,2845,7994,7994,0,22,2927000.0
2927,2927999,20.123066240767063,36.248429155852016,0.0882362261978803,1025.044248342514,223.06527137756348,829.8188056945801,10844,2845,7999,7999,0,22,2928000.0
2928,2928999,20.120321444807242,36.244493452195776,0.08824507438598705,1025.1899480819702,223.13101029396057,831.8160209655762,10863,2845,8018,8018,0,22,2929000.0
2929,2929999,20.11695865990478,36.24030847302981,0.08826202364758773,1025.432278394699,223.19629955291748,832.6655006408691,10864,2845,8019,8019,0,22,2930000.0
2930,2930999,20.11362153753842,36.235478668208316,0.08828247050024207,1025.7603232860565,223.26105451583862,832.9984169006348,10871,2848,8023,8023,0,22,2931000.0
2931,2931999,20.11053036716563,36.231521699700146,0.08830216244167732,1026.044287443161,223.32619071006775,833.6123161315918,10888,2851,8037,8037,0,22,2932000.0
2932,2932999,20.107857492399862,36.22725076252677,0.08831037951054721,1026.43940615654,223.39188885688782,833.5954704284668,10894,2854,8040,8040,0,22,2933000.0
2933,2933999,20.10534031120711,36.223020639372514,0.08832168290987397,1026.7967236042023,223.45796275138855,833.7709007263184,10902,2858,8044,8044,0,22,2934000.0
2934,2934999,20.10309733290078,36.219610210147124,0.08832015673745286,1027.147290468216,223.52604126930237,834.1147727966309,10908,2861,8047,8047,0,22,2935000.0
2935,2935999,20.10066743556963,36.21553541740406,0.0883245104332614,1027.415539741516,223.59158563613892,834.782787322998,10908,2861,8047,8047,0,22,2936000.0
2936,2936999,20.09866039631182,36.212835718956484,0.08831792123882387,1027.7245664596558,223.65901374816895,835.1000785827637,10912,2863,8049,8049,0,22,2937000.0
2937,2937999,20.097421638873353,36.21258085804451,0.08829749908491824,1028.123960018158,223.72609782218933,835.102352142334,10914,2864,8050,8050,0,22,2938000.0
2938,2938999,20.09757969872412,36.21528479828971,0.08825204876380943,1028.4590196609497,223.79436230659485,835.3085899353027,10916,2865,8051,8051,0,22,2939000.0
2939,2939999,20.09792721263686,36.225098687471394,0.08820270568413224,1028.8173751831055,223.8606081008911,835.6231575012207,10916,2865,8051,8051,0,22,2940000.0
2940,2940999,20.099069548265852,36.23123381987216,0.08816780100769583,1029.1110363006592,223.9279203414917,836.0749702453613,10918,2866,8052,8052,0,22,2941000.0
2941,2941999,20.099901528836604,36.234369266068,0.0881850633697211,1029.5033769607544,223.9943709373474,836.0611686706543,10918,2866,8052,8052,0,22,2942000.0
2942,2942999,20.099910955381354,36.23485436328128,0.08819779803953043,1029.832891702652,224.06158471107483,836.3406105041504,10920,2867,8053,8053,0,22,2943000.0
2943,2943999,20.100828542735773,36.236883957004636,0.08819931196715991,1030.3485877513885,224.12806367874146,835.8413581848145,10924,2869,8055,8055,0,22,2944000.0
2944,2944999,20.101180742649078,36.23755504874202,0.08818838247858207,1030.730064868927,224.19608783721924,835.953197479248,10928,2871,8057,8057,0,22,2945000.0
2945,2945999,20.102168293546967,36.23994707318573,0.08822061229712275,1031.0274772644043,224.26264786720276,836.448787689209,10930,2872,8058,8058,0,22,2946000.0
2946,2946999,20.101793136302522,36.23918198908818,0.08822752196020978,1031.2759776115417,224.33152437210083,837.061595916748,10930,2872,8058,8058,0,22,2947000.0
2947,2947999,20.101456212953337,36.238430067245886,0.08822339700023918,1031.602004289627,224.3993513584137,837.3316917419434,10930,2872,8058,8058,0,22,2948000.0
2948,2948999,20.10075452603897,36.24085693256535,0.08820142535261977,1031.9393091201782,224.4691822528839,838.019229888916,10938,2872,8066,8066,0,22,2949000.0
2949,2949999,20.098133263816305,36.23985341427198,0.08820377727849604,1032.2949607372284,224.5352725982666,838.4668846130371,10945,2873,8072,8072,0,22,2950000.0
2950,2950999,20.095941098722946,36.23875075866853,0.08819658161378796,1032.526124238968,224.60182547569275,839.194034576416,10946,2873,8073,8073,0,22,2951000.0
2951,2951999,20.09451727232072,36.2382822708603,0.08818120798300633,1032.8570897579193,224.67085599899292,839.7914619445801,10965,2876,8089,8089,0,22,2952000.0
2952,2952999,20.094093248452545,36.24005678924574,0.08816216208755878,1033.0915987491608,224.73897528648376,840.6812553405762,10967,2877,8090,8090,0,22,2953000.0
2953,2953999,20.095003445894186,36.242778475188324,0.08818204102178018,1033.3694522380829,224.80630803108215,841.3780937194824,10969,2878,8091,8091,0,22,2954000.0
2954,2954999,20.095122327545834,36.243070130117665,0.08820695118615074,1033.6166787147522,224.8734254837036,842.0334587097168,10971,2879,8092,8092,0,22,2955000.0
2955,2955999,20.094981275746022,36.243224287497604,0.08822636695139063,1034.022531747818,224.94808530807495,841.9910697937012,10973,2880,8093,8093,0,22,2956000.0
2956,2956999,20.095238763856297,36.249542398071846,0.08820621805011042,1034.35675740242,225.017343044281,842.2310218811035,10978,2882,8096,8096,0,22,2957000.0
2957,2957999,20.094534154081728,36.248141252931,0.08826597784168755,1034.7445831298828,225.08613538742065,842.2021369934082,10982,2884,8098,8098,0,22,2958000.0
2958,2958999,20.094122856763644,36.24709109962791,0.08830915461265121,1035.069018125534,225.15383291244507,842.609691619873,10985,2885,8100,8100,0,22,2959000.0
2959,2959999,20.0936210262825,36.2455589915847,0.08830640148945401,1035.496220111847,225.22289776802063,842.585033416748,10987,2886,8101,8101,0,22,2960000.0
2960,2960999,20.093851304883138,36.24542727870569,0.08832606411534139,1035.819982290268,225.29318618774414,843.0113410949707,10989,2887,8102,8102,0,22,2961000.0
2961,2961999,20.094540120397465,36.249087431942016,0.08833848338612638,1036.0492062568665,225.3613474369049,843.790225982666,10989,2887,8102,8102,0,22,2962000.0
2962,2962999,20.095184438357208,36.249029042618695,0.08835658714839567,1036.3552997112274,225.4288227558136,844.0444221496582,10991,2888,8103,8103,0,22,2963000.0
2963,2963999,20.096643391814787,36.250382319073,0.08839665749384507,1036.7016327381134,225.49784326553345,844.2243309020996,10993,2889,8104,8104,0,22,2964000.0
2964,2964999,20.097860163958188,36.251277414288985,0.08843463639704219,1037.0349164009094,225.56771397590637,844.443790435791,10995,2890,8105,8105,0,22,2965000.0
2965,2965999,20.0995927691978,36.25274591585818,0.08848171366139079,1037.433441877365,225.6393280029297,844.4160346984863,10999,2892,8107,8107,0,22,2966000.0
2966,2966999,20.100749978375084,36.253001882300296,0.08851033125819796,1037.9428386688232,225.7094054222107,843.8646812438965,11003,2894,8109,8109,0,22,2967000.0
2967,2967999,20.1012060436111,36.25168566876031,0.0885380115528479,1038.29074716568,225.77784895896912,844.1211891174316,11004,2894,8110,8110,0,22,2968000.0
2968,2968999,20.100996905437285,36.24991500263709,0.08853564292294558,1038.780869960785,225.8470697402954,843.7250938415527,11008,2896,8112,8112,0,22,2969000.0
2969,2969999,20.098320998093968,36.24555895283343,0.08855024762236552,1039.0228781700134,225.91778802871704,844.9660453796387,11021,2896,8125,8125,0,22,2970000.0
2970,2970999,20.095672847182698,36.242763968728134,0.08855189459765778,1039.2659919261932,225.984375,845.7873115539551,11024,2897,8127,8127,0,22,2971000.0
2971,2971999,20.093039091250525,36.2394998186072,0.08856097147270525,1039.5392067432404,226.0522541999817,846.4419212341309,11039,2898,8141,8141,0,22,2972000.0
2972,2972999,20.09083423648041,36.238728487643144,0.08855419904107398,1039.8159387111664,226.11927032470703,846.9988441467285,11053,2899,8154,8154,0,22,2973000.0
2973,2973999,20.0883799237005,36.235629598230766,0.08855793787754895,1040.2371737957,226.18781924247742,846.9052619934082,11057,2901,8156,8156,0,22,2974000.0
2974,2974999,20.08617972099398,36.238467006270405,0.08853288170239959,1040.5200667381287,226.25542545318604,847.5523338317871,11071,2902,8169,8169,0,22,2975000.0
2975,2975999,20.083781937292294,36.23478405257438,0.08853358216664842,1040.8361945152283,226.32329416275024,848.0883522033691,11073,2903,8170,8170,0,22,2976000.0
2976,2976999,20.08135566377815,36.23080096052895,0.08853887893187473,1041.1991682052612,226.39590764045715,848.4650001525879,11074,2903,8171,8171,0,22,2977000.0
2977,2977999,20.0792785692453,36.227146036883745,0.08853830260094131,1041.4981451034546,226.46372509002686,848.9372596740723,11076,2904,8172,8172,0,22,2978000.0
2978,2978999,20.077689556242884,36.22478947673065,0.08852397171938864,1041.9118452072144,226.5330593585968,848.8786201477051,11080,2906,8174,8174,0,22,2979000.0
2979,2979999,20.076361655729894,36.222600973319395,0.08851742857944556,1042.2218492031097,226.60411953926086,849.3419914245605,11082,2907,8175,8175,0,22,2980000.0
2980,2980999,20.075826764816632,36.22175997444141,0.0884983122152262,1042.5172531604767,226.67366313934326,849.766040802002,11082,2907,8175,8175,0,22,2981000.0
2981,2981999,20.075864114406365,36.221872262775726,0.08846600873772936,1042.9700815677643,226.7447714805603,849.3856773376465,11084,2909,8175,8175,0,22,2982000.0
2982,2982999,20.07661874268105,36.222131403401576,0.0884588332290912,1043.309318780899,226.81586408615112,849.6696357727051,11086,2910,8176,8176,0,22,2983000.0
2983,2983999,20.07762115333303,36.222349318355974,0.08843149481145163,1043.6818842887878,226.8879039287567,849.916561126709,11086,2910,8176,8176,0,22,2984000.0
2984,2984999,20.07922704359533,36.2237882107529,0.08839970847982759,1044.1137630939484,226.95902633666992,849.876049041748,11090,2912,8178,8178,0,22,2985000.0
2985,2985999,20.08181364448807,36.22739024737217,0.08834784652121253,1044.466801404953,227.02825617790222,850.1348075866699,11090,2912,8178,8178,0,22,2986000.0
2986,2986999,20.0833487631715,36.22841168725947,0.08835786809514068,1044.9434261322021,227.09819173812866,849.8438835144043,11090,2912,8178,8178,0,22,2987000.0
2987,2987999,20.085716374623892,36.2309854858248,0.08835858273670494,1045.231151342392,227.16812181472778,850.3913307189941,11090,2912,8178,8178,0,22,2988000.0
2988,2988999,20.088775032970215,36.23625591241399,0.08838343690961326,1045.5897707939148,227.23798656463623,850.5697364807129,11092,2913,8179,8179,0,22,2989000.0
2989,2989999,20.090196369011313,36.23906699464548,0.08838746317438695,1045.940546989441,227.30776572227478,850.8675346374512,11094,2914,8180,8180,0,22,2990000.0
2990,2990999,20.08865406708308,36.23881181911626,0.08836606452218776,1046.2186727523804,227.37443685531616,852.0510749816895,11120,2915,8205,8205,0,22,2991000.0
2991,2991999,20.08679062536395,36.23832983927354,0.08835454397717357,1046.497395515442,227.43994450569153,852.9174842834473,11131,2915,8216,8216,0,22,2992000.0
2992,2992999,20.084299337662873,36.234166186243826,0.08836024222422167,1046.7160556316376,227.50470638275146,853.9558906555176,11136,2915,8221,8221,0,22,2993000.0
2993,2993999,20.082355268004548,36.23152291730231,0.08835254673121873,1046.9067611694336,227.5698676109314,855.054370880127,11140,2915,8225,8225,0,22,2994000.0
2994,2994999,20.080521069194564,36.22931548829652,0.08833908904143806,1047.1923689842224,227.63633847236633,855.8152351379395,11145,2916,8229,8229,0,22,2995000.0
2995,2995999,20.07852482946382,36.22549575305247,0.0883400649507804,1047.4849665164948,227.70375895500183,856.5395469665527,11147,2917,8230,8230,0,22,2996000.0
2996,2996999,20.07700989927611,36.2227931737296,0.0883335504979974,1047.8177373409271,227.7700879573822,857.0242805480957,11152,2919,8233,8233,0,22,2997000.0
2997,2997999,20.075410504071385,36.21957837958776,0.08832706007127111,1048.0612978935242,227.83678436279297,857.7771644592285,11156,2920,8236,8236,0,22,2998000.0
2998,2998999,20.073814726306225,36.216481665271814,0.0883199375123761,1048.3021426200867,227.90230703353882,858.3756141662598,11158,2921,8237,8237,0,22,2999000.0
2999,2999999,20.07297782151199,36.214341996936746,0.08830194175954009,1048.7852566242218,227.97089672088623,858.0438652038574,11164,2924,8240,8240,0,22,3000000.0
3000,3000999,20.072483267370465,36.21274553556186,0.08828747272742365,1049.1208546161652,228.03873419761658,858.4669075012207,11167,2925,8242,8242,0,22,3001000.0
3001,3001999,20.071809999480095,36.21037468307951,0.08827529471191609,1049.4181916713715,228.10470485687256,858.978343963623,11167,2925,8242,8242,0,22,3002000.0
3002,3002999,20.07174101698105,36.2103634103542,0.08824732852954498,1049.8177313804626,228.17149996757507,858.9224815368652,11172,2927,8245,8245,0,22,3003000.0
3003,3003999,20.073060572938026,36.213408774024,0.08820700633249257,1050.1080753803253,228.2375042438507,859.4159202575684,11172,2927,8245,8245,0,22,3004000.0
3004,3004999,20.075798665875382,36.219761536193815,0.0881744096571736,1050.44327044487,228.30389165878296,859.626537322998,11174,2928,8246,8246,0,22,3005000.0
3005,3005999,20.07991742962033,36.230545591784534,0.08814296206440009,1050.7364344596863,228.36991500854492,860.0930290222168,11174,2928,8246,8246,0,22,3006000.0
3006,3006999,20.08499112560673,36.240449420334116,0.08812963160204423,1051.1213657855988,228.4365439414978,860.1085014343262,11178,2930,8248,8248,0,22,3007000.0
3007,3007999,20.09129401879354,36.253449875895186,0.08815546142508535,1051.5121393203735,228.50391340255737,860.0771903991699,11182,2932,8250,8250,0,22,3008000.0
3008,3008999,20.098032442150142,36.26896390958676,0.08823831516667957,1051.9357447624207,228.57148909568787,860.1789512634277,11184,2933,8251,8251,0,22,3009000.0
3009,3009999,20.104620814762164,36.279448741601485,0.08832714856609769,1052.2894957065582,228.63897824287415,860.4318199157715,11190,2935,8255,8255,0,22,3010000.0
3010,3010999,20.10797604257367,36.283816131856646,0.0883804964785232,1052.6493117809296,228.70709109306335,860.900074005127,11208,2937,8271,8271,0,22,3011000.0
3011,3011999,20.107379384681007,36.28693981485957,0.08832218228810973,1052.948885679245,228.77414846420288,861.8228340148926,11225,2938,8287,8287,0,22,3012000.0
3012,3012999,20.105927426099257,36.28609483061593,0.08831000123956301,1053.2345201969147,228.84113264083862,862.4735450744629,11226,2938,8288,8288,0,22,3013000.0
3013,3013999,20.104652030308788,36.28399031496539,0.08830518113070107,1053.6019937992096,228.9075527191162,862.7497978210449,11226,2938,8288,8288,0,22,3014000.0
3014,3014999,20.102976126024142,36.28197438573082,0.08829778057889548,1053.8958811759949,228.97376537322998,863.4154167175293,11228,2938,8290,8290,0,22,3015000.0
3015,3015999,20.101859873294956,36.28113353133258,0.08827886157466436,1054.316679239273,229.04072904586792,863.3657569885254,11232,2940,8292,8292,0,22,3016000.0
3016,3016999,20.100078908266696,36.27847940297315,0.08827351916065218,1054.6813168525696,229.10734486579895,863.5473518371582,11234,2941,8293,8293,0,22,3017000.0
3017,3017999,20.09865100748482,36.27559901464579,0.08826656664769772,1055.127034664154,229.17630434036255,863.2725868225098,11237,2943,8294,8294,0,22,3018000.0
3018,3018999,20.097165609408496,36.27277925192767,0.08826456168188401,1055.4752089977264,229.2452871799469,863.5838203430176,11242,2946,8296,8296,0,22,3019000.0
3019,3019999,20.095559481043782,36.26954742049472,0.08826406995986757,1055.7864034175873,229.31443786621094,864.0360069274902,11242,2946,8296,8296,0,22,3020000.0
3020,3020999,20.09462058344592,36.267032658629745,0.08824536763506752,1056.3376023769379,229.3831901550293,863.4217338562012,11244,2947,8297,8297,0,22,3021000.0
3021,3021999,20.094069152282415,36.26527099167957,0.08823001860400548,1056.7168288230896,229.4530303478241,863.6592597961426,11244,2947,8297,8297,0,22,3022000.0
3022,3022999,20.094463582246682,36.26556424987208,0.08819746429958253,1057.1327545642853,229.52455687522888,863.6401481628418,11246,2948,8298,8298,0,22,3023000.0
3023,3023999,20.095788954860854,36.26675150142077,0.08816142464798704,1057.4891312122345,229.59371089935303,863.9132499694824,11246,2948,8298,8298,0,22,3024000.0
3024,3024999,20.09645363078527,36.26593766225742,0.08814792249440273,1057.8883554935455,229.66412615776062,863.9696922302246,11247,2949,8298,8298,0,22,3025000.0
3025,3025999,20.097761672172982,36.26922252016309,0.08811002568313564,1058.2433137893677,229.73417782783508,864.2818641662598,11247,2949,8298,8298,0,22,3026000.0
3026,3026999,20.098638193090974,36.268736721241524,0.08809759828442487,1058.638997554779,229.80377674102783,864.4073143005371,11247,2949,8298,8298,0,22,3027000.0
3027,3027999,20.098596938105906,36.26641261847025,0.08808312023210596,1058.9593052864075,229.87278699874878,864.781078338623,11247,2949,8298,8298,0,22,3028000.0
3028,3028999,20.097722428060695,36.263294582031925,0.08807091931188071,1059.2605690956116,229.94281721115112,865.5016822814941,11257,2949,8308,8308,0,22,3029000.0
3029,3029999,20.09677105895071,36.26523283311577,0.08804935995080887,1059.5484399795532,230.00943160057068,866.3664894104004,11264,2951,8313,8313,0,22,3030000.0
3030,3030999,20.095544882440265,36.26360129586649,0.08804832791805906,1059.7866625785828,230.07449197769165,867.2523078918457,11268,2951,8317,8317,0,22,3031000.0
3031,3031999,20.095557909641787,36.264298660343464,0.08802863945160566,1060.1060376167297,230.13967490196228,867.5628242492676,11270,2952,8318,8318,0,22,3032000.0
3032,3032999,20.095774724045484,36.26436119400106,0.08803049109306005,1060.3079273700714,230.20672369003296,868.6700706481934,11284,2953,8331,8331,0,22,3033000.0
3033,3033999,20.09576458716966,36.26388120203298,0.08804141166498625,1060.6913595199585,230.27457737922668,869.0130500793457,11287,2954,8333,8333,0,22,3034000.0
3034,3034999,20.09551803307,36.263579864195776,0.0880370613832876,1060.933210849762,230.34157848358154,869.8936195373535,11289,2955,8334,8334,0,22,3035000.0
3035,3035999,20.095880920754393,36.26338684333706,0.08806934980595504,1061.26380610466,230.40903735160828,870.1800727844238,11290,2955,8335,8335,0,22,3036000.0
3036,3036999,20.096335375148673,36.262867196897524,0.08807708629005129,1061.556645154953,230.47658967971802,870.5741081237793,11294,2957,8337,8337,0,22,3037000.0
3037,3037999,20.097407366042855,36.26463470438454,0.08809578583355093,1061.930263519287,230.54449772834778,870.6881065368652,11310,2959,8351,8351,0,22,3038000.0
3038,3038999,20.098966224111734,36.26983995314891,0.08815615949271127,1062.2924137115479,230.61212372779846,870.8513145446777,11319,2962,8357,8357,0,22,3039000.0
3039,3039999,20.100767731804094,36.27254713206333,0.08824932781411243,1062.6447939872742,230.6809275150299,871.1495933532715,11325,2965,8360,8360,0,22,3040000.0
3040,3040999,20.102607713198243,36.27440285634318,0.08830318999980913,1062.9302916526794,230.7505795955658,871.7266120910645,11327,2966,8361,8361,0,22,3041000.0
3041,3041999,20.105746918914946,36.28059117021797,0.08836457811447884,1063.2155463695526,230.81796860694885,872.3484687805176,11329,2967,8362,8362,0,22,3042000.0
3042,3042999,20.10978776604512,36.29412169049301,0.08845727988502528,1063.5917701721191,230.88596439361572,872.4967460632324,11331,2968,8363,8363,0,22,3043000.0
3043,3043999,20.113598780485475,36.30140599918085,0.08856607873498612,1063.7991008758545,230.9528248310089,873.3458213806152,11332,2968,8364,8364,0,22,3044000.0
3044,3044999,20.117190449492764,36.30528747215768,0.08870145495407988,1064.2217025756836,231.02121591567993,873.2705421447754,11334,2969,8365,8365,0,22,3045000.0
3045,3045999,20.121447136524676,36.30976590460851,0.08877764337713967,1064.5534672737122,231.08917093276978,873.6052665710449,11334,2969,8365,8365,0,22,3046000.0
3046,3046999,20.125897893489054,36.31515265393722,0.08886202852730563,1064.8457579612732,231.15817999839783,874.040225982666,11334,2969,8365,8365,0,22,3047000.0
3047,3047999,20.129641939943276,36.321421409547035,0.08893715813677949,1065.2389137744904,231.22797679901123,874.1060523986816,11337,2970,8367,8367,0,22,3048000.0
3048,3048999,20.129491737651655,36.32012485330916,0.08894488541718237,1065.4923956394196,231.2966811656952,875.0573539733887,11348,2971,8377,8377,0,22,3049000.0
3049,3049999,20.12759775048486,36.31912235592634,0.08892956724241619,1065.7755081653595,231.36287236213684,875.8407096862793,11351,2971,8380,8380,0,22,3050000.0
3050,3050999,20.126086780223524,36.31849407934538,0.08890894783680048,1066.0775790214539,231.42920088768005,876.3322486877441,11352,2971,8381,8381,0,22,3051000.0
3051,3051999,20.12479637260739,36.31624040427033,0.08889972967956994,1066.413497686386,231.49502635002136,876.6019859313965,11356,2972,8384,8384,0,22,3052000.0
3052,3052999,20.123645684070432,36.31502094648614,0.08888099254662551,1066.846659898758,231.56566905975342,876.8063926696777,11358,2973,8385,8385,0,22,3053000.0
3053,3053999,20.122397821327663,36.312400830078055,0.08887152514167607,1067.2994530200958,231.63217949867249,876.7262840270996,11364,2976,8388,8388,0,22,3054000.0
3054,3054999,20.12181763749987,36.3108371292812,0.088851706935128,1067.6649332046509,231.69912958145142,876.9493293762207,11364,2976,8388,8388,0,22,3055000.0
3055,3055999,20.121539900728315,36.30890906120069,0.08883734575070801,1068.0171184539795,231.76610255241394,876.9766426086426,11366,2978,8388,8388,0,22,3056000.0
3056,3056999,20.12168155052874,36.30741913322213,0.08882922829943407,1068.3571243286133,231.83517837524414,877.3311195373535,11366,2978,8388,8388,0,22,3057000.0
3057,3057999,20.12239885307097,36.30692837865364,0.08881591197177174,1068.8156201839447,231.9031240940094,877.133975982666,11368,2979,8389,8389,0,22,3058000.0
3058,3058999,20.123721000676564,36.30708029550521,0.08882471013567717,1069.25843167305,231.97346949577332,877.0052833557129,11372,2981,8391,8391,0,22,3059000.0
3059,3059999,20.126349992933072,36.31087531762624,0.08890283767737428,1069.6907198429108,232.0424656867981,877.0194358825684,11374,2982,8392,8392,0,22,3060000.0
3060,3060999,20.128772605289853,36.31383353703757,0.08897126095254204,1069.9548916816711,232.11140942573547,877.660572052002,11374,2982,8392,8392,0,22,3061000.0
3061,3061999,20.131691637418342,36.317397165150695,0.08904123316758683,1070.3287613391876,232.18022847175598,877.6600532531738,11375,2983,8392,8392,0,22,3062000.0
3062,3062999,20.135842721788947,36.32603325398421,0.08910297549002899,1070.6626236438751,232.2501676082611,877.9462699890137,11375,2983,8392,8392,0,22,3063000.0
3063,3063999,20.141633881545378,36.33661315160047,0.08920163984017027,1071.2194337844849,232.32066440582275,877.244571685791,11379,2985,8394,8394,0,22,3064000.0
3064,3064999,20.146291418834696,36.3432759928273,0.08932334970273992,1071.5786859989166,232.39009547233582,877.4598731994629,11379,2985,8394,8394,0,22,3065000.0
3065,3065999,20.15080061451719,36.34815475890708,0.0894204387878752,1072.0458748340607,232.45997714996338,877.1180992126465,11384,2988,8396,8396,0,22,3066000.0
3066,3066999,20.155423920730527,36.353531120539884,0.08948444986413684,1072.4033296108246,232.5319468975067,877.4780616760254,11399,2989,8410,8410,0,22,3067000.0
3067,3067999,20.159059020224483,36.35659588800521,0.08957143159754388,1072.6479020118713,232.603506565094,878.562084197998,11401,2989,8412,8412,0,22,3068000.0
3068,3068999,20.160772745278923,36.35677694568214,0.08958597406592206,1072.8861796855927,232.67457270622253,879.5766258239746,11403,2989,8414,8414,0,22,3069000.0
3069,3069999,20.15964798110026,36.35725121793279,0.08955189685337461,1073.098129749298,232.7413992881775,881.3396110534668,11432,2990,8442,8442,0,22,3070000.0
3070,3070999,20.15782309918643,36.35563539766537,0.08954705793251949,1073.250429391861,232.80550718307495,882.6223793029785,11433,2990,8443,8443,0,22,3071000.0
3071,3071999,20.156120042713834,36.35339680266725,0.08954449507547069,1073.5739297866821,232.869788646698,882.9788246154785,11440,2993,8447,8447,0,22,3072000.0
3072,3072999,20.154727787467746,36.35305693356809,0.08951956689598273,1073.7744147777557,232.93368411064148,883.8588981628418,11442,2994,8448,8448,0,22,3073000.0
3073,3073999,20.152954546989886,36.3495892661412,0.08951496949836457,1074.1986508369446,232.99994897842407,883.7796821594238,11448,2997,8451,8451,0,22,3074000.0
3074,3074999,20.15164558673332,36.34890713078186,0.08949598743829923,1074.5400528907776,233.06466269493103,883.9335136413574,11452,2999,8453,8453,0,22,3075000.0
3075,3075999,20.150402569711783,36.34683215001477,0.08948236174298407,1075.0106799602509,233.1306369304657,883.8139533996582,11458,3002,8456,8456,0,22,3076000.0
3076,3076999,20.149279115376196,36.34467428613533,0.08947395783749057,1075.167799949646,233.19631171226501,884.9064140319824,11458,3002,8456,8456,0,22,3077000.0
3077,3077999,20.148227897372667,36.34242633576438,0.0894681497318418,1075.5177533626556,233.26199746131897,885.0259132385254,11462,3004,8458,8458,0,22,3078000.0
3078,3078999,20.147925271434193,36.34217021012399,0.08944576209302457,1076.0339260101318,233.32974123954773,884.5648460388184,11478,3006,8472,8472,0,22,3079000.0
3079,3079999,20.147707722981163,36.341221578369755,0.08944047222488072,1076.4391994476318,233.3958215713501,884.5285530090332,11480,3007,8473,8473,0,22,3080000.0
3080,3080999,20.147775477313402,36.340949876867775,0.08943606615699351,1076.6902871131897,233.4613721370697,885.2048149108887,11482,3008,8474,8474,0,22,3081000.0
3081,3081999,20.147717223327373,36.33987369608289,0.0894145995090384,1077.0233142375946,233.52939867973328,885.5092735290527,11482,3008,8474,8474,0,22,3082000.0
3082,3082999,20.14845999969459,36.34061476946938,0.0894041291746156,1077.3112416267395,233.59641861915588,886.0442543029785,11482,3008,8474,8474,0,22,3083000.0
3083,3083999,20.148836732741007,36.34056082257827,0.08939616253625271,1077.712159395218,233.66362738609314,885.9013328552246,11488,3011,8477,8477,0,22,3084000.0
3084,3084999,20.149134978519104,36.33949883497566,0.0893982895842983,1078.354784488678,233.73003244400024,884.9982643127441,11502,3012,8490,8490,0,22,3085000.0
3085,3085999,20.150000098093514,36.339462741762716,0.08939555666464583,1078.6130323410034,233.79877996444702,885.7822074890137,11502,3012,8490,8490,0,22,3086000.0
3086,3086999,20.150278739893846,36.33852610269596,0.08939983216378533,1078.9460220336914,233.86593341827393,886.0740623474121,11502,3012,8490,8490,0,22,3087000.0
3087,3087999,20.150059600031053,36.33653943564633,0.08939830044453567,1079.2273647785187,233.93253874778748,886.5121269226074,11502,3012,8490,8490,0,22,3088000.0
3088,3088999,20.149773628986864,36.3344172557375,0.08938920038319287,1079.5782845020294,233.99893927574158,886.7150764465332,11502,3012,8490,8490,0,22,3089000.0
3089,3089999,20.148452346006195,36.33102250633071,0.08938568497031651,1079.9483942985535,234.06750106811523,887.2722053527832,11514,3013,8501,8501,0,22,3090000.0
3090,3090999,20.1458210425945,36.32758951647647,0.08939500995469829,1080.2633168697357,234.1342031955719,887.909252166748,11520,3014,8506,8506,0,22,3091000.0
3091,3091999,20.143227831372972,36.32402195510713,0.08940375614351936,1080.5155682563782,234.20150876045227,888.8009910583496,11539,3016,8523,8523,0,22,3092000.0
3092,3092999,20.14123648072903,36.32268283417017,0.08939750930784818,1080.7104370594025,234.26794409751892,890.0146522521973,11542,3017,8525,8525,0,22,3093000.0
3093,3093999,20.13899906301454,36.31926383484822,0.08939895071853465,1080.9429516792297,234.33505606651306,890.8586235046387,11542,3017,8525,8525,0,22,3094000.0
3094,3094999,20.136704980779314,36.31614745658853,0.08940033076103471,1081.3601624965668,234.40258407592773,890.8376502990723,11546,3019,8527,8527,0,22,3095000.0
3095,3095999,20.134280758100903,36.31223629172486,0.0894041576999246,1081.6001658439636,234.469633102417,891.5092887878418,11546,3019,8527,8527,0,22,3096000.0
3096,3096999,20.132682749540365,36.311429292762924,0.08938428221168826,1081.9214787483215,234.5368275642395,891.8378944396973,11546,3019,8527,8527,0,22,3097000.0
3097,3097999,20.131293585395607,36.31055891498452,0.0893619965889847,1082.1698191165924,234.60371232032776,892.4083595275879,11547,3019,8528,8528,0,22,3098000.0
3098,3098999,20.130067776970858,36.30839541270036,0.08934907779415113,1082.6595075130463,234.6719400882721,891.9084510803223,11555,3023,8532,8532,0,22,3099000.0
3099,3099999,20.128730153975717,36.30633076186493,0.08933243132351698,1082.977225780487,234.73911929130554,892.3658714294434,11555,3023,8532,8532,0,22,3100000.0
3100,3100999,20.12849991912569,36.30619896029026,0.0893028886324787,1083.4093911647797,234.80739402770996,892.1685447692871,11559,3025,8534,8534,0,22,3101000.0
3101,3101999,20.128722160487456,36.30783701199968,0.08926847523829784,1083.7283532619476,234.87639570236206,892.6076698303223,11559,3025,8534,8534,0,22,3102000.0
3102,3102999,20.129287724619914,36.30857112192406,0.08924016714085192,1084.2125318050385,234.94653415679932,892.2363548278809,11561,3026,8535,8535,0,22,3103000.0
3103,3103999,20.129665523910333,36.30938680769936,0.08921080359018518,1084.5515897274017,235.0156226158142,892.5197868347168,11563,3027,8536,8536,0,22,3104000.0
3104,3104999,20.12961519513909,36.308713252625274,0.08918977422956953,1084.7666037082672,235.08462834358215,893.1807975769043,11563,3027,8536,8536,0,22,3105000.0
3105,3105999,20.130583025860208,36.30979751945639,0.08916226112058878,1085.180240869522,235.15305089950562,893.077564239502,11563,3027,8536,8536,0,22,3106000.0
3106,3106999,20.131163796977063,36.31046566195275,0.0891375497338669,1085.5198554992676,235.22138214111328,893.3726005554199,11596,3029,8567,8567,0,22,3107000.0
3107,3107999,20.132614624977393,36.312591250707754,0.0891127588821291,1085.9038202762604,235.29043531417847,893.4733695983887,11596,3029,8567,8567,0,22,3108000.0
3108,3108999,20.13368268514789,36.31314831900287,0.08909197117488055,1086.2943184375763,235.35819959640503,893.4833564758301,11598,3030,8568,8568,0,22,3109000.0
3109,3109999,20.13408381226376,36.31244793800263,0.08908290693030296,1086.7764093875885,235.4281029701233,893.2298164367676,11600,3031,8569,8569,0,22,3110000.0
3110,3110999,20.13254862379716,36.3103477348641,0.08907392396248381,1087.0540187358856,235.49730944633484,894.3021354675293,11617,3032,8585,8585,0,22,3111000.0
3111,3111999,20.13005572055621,36.306810044778274,0.08907924922386767,1087.4284899234772,235.56673192977905,894.626407623291,11634,3033,8601,8601,0,22,3112000.0
3112,3112999,20.127969320828498,36.30438318669001,0.08907357232559365,1087.6313772201538,235.63585138320923,895.9067115783691,11638,3034,8604,8604,0,22,3113000.0
3113,3113999,20.125706286578968,36.30104809864771,0.08907872279095008,1087.825355052948,240.12350630760193,896.9818840026855,11639,3034,8605,8605,0,22,3114000.0
3114,3114999,20.12351957136258,36.297368570438636,0.0890837702798909,1088.121907234192,240.1915054321289,897.4878883361816,11643,3036,8607,8607,0,22,3115000.0
3115,3115999,20.121729208652347,36.29576747887267,0.0890776503587708,1088.5226030349731,240.26108503341675,897.6093101501465,11649,3039,8610,8610,0,22,3116000.0
3116,3116999,20.120427393952653,36.29420270927344,0.08906197509784641,1088.7724602222443,240.3313286304474,898.375057220459,11652,3040,8612,8612,0,22,3117000.0
3117,3117999,20.119208197653816,36.29205243991239,0.08905736446339041,1089.10298371315,240.40020608901978,898.7508430480957,11671,3042,8629,8629,0,22,3118000.0
3118,3118999,20.118169696236905,36.290463875283535,0.0890450856675592,1089.4460954666138,240.472247838974,899.0544929504395,11675,3044,8631,8631,0,22,3119000.0
3119,3119999,20.117751603302533,36.28970443316083,0.08903108051175024,1089.7877094745636,240.54109072685242,899.3707313537598,11675,3044,8631,8631,0,22,3120000.0
3120,3120999,20.117949027222974,36.29074201937459,0.08902594610303771,1090.1854774951935,240.612863779068,899.4848594665527,11679,3046,8633,8633,0,22,3121000.0
3121,3121999,20.117938078143485,36.29034924800777,0.08902740566647382,1090.5268609523773,240.68182563781738,899.6706657409668,11681,3047,8634,8634,0,22,3122000.0
3122,3122999,20.11835926110243,36.29129266887184,0.08903383427781553,1090.9430718421936,240.7518539428711,899.9000282287598,11687,3048,8639,8639,0,22,3123000.0
3123,3123999,20.119203477113068,36.292874983635095,0.08903663022668795,1091.1948730945587,240.82096028327942,900.5456886291504,11687,3048,8639,8639,0,22,3124000.0
3124,3124999,20.11981737090092,36.29352276967988,0.08905538630914611,1091.5866916179657,240.89190888404846,900.5231056213379,11693,3051,8642,8642,0,22,3125000.0
3125,3125999,20.120996270155448,36.29516593692636,0.08906528230733746,1091.945719718933,240.9620180130005,900.7204170227051,11694,3052,8642,8642,0,22,3126000.0
3126,3126999,20.121510398731004,36.29485739817525,0.08907527866784404,1092.3677797317505,241.03179025650024,900.6012687683105,11696,3053,8643,8643,0,22,3127000.0
3127,3127999,20.122096040380498,36.294255445049856,0.08908244845476809,1092.6114785671234,241.1027548313141,901.3094673156738,11696,3053,8643,8643,0,22,3128000.0
3128,3128999,20.123064929778586,36.294305833592105,0.08907081548239826,1092.9953546524048,241.1743860244751,901.3037147521973,11696,3053,8643,8643,0,22,3129000.0
3129,3129999,20.12328140662374,36.293206001056284,0.08906142987169385,1093.393345117569,241.24458122253418,901.3304481506348,11700,3055,8645,8645,0,22,3130000.0
3130,3130999,20.12296934160624,36.291035184159725,0.089058794701939,1093.8754785060883,241.31556034088135,901.176586151123,11700,3055,8645,8645,0,22,3131000.0
3131,3131999,20.122084378392625,36.29326616380063,0.08901825967421328,1094.1220371723175,241.38181948661804,902.4241218566895,11722,3056,8666,8666,0,22,3132000.0
3132,3132999,20.11976111807844,36.289841331058184,0.08901598879490191,1094.3570227622986,241.4467852115631,903.552921295166,11735,3056,8679,8679,0,22,3133000.0
3133,3133999,20.117622466573494,36.28675074398431,0.08901144494612923,1094.6393008232117,241.51192569732666,904.2221336364746,11740,3057,8683,8683,0,22,3134000.0
3134,3134999,20.116097841009154,36.28599227061618,0.08898675630880415,1094.8348186016083,241.57653665542603,905.4157905578613,11741,3057,8684,8684,0,22,3135000.0
3135,3135999,20.11524451662477,36.28495592690451,0.08897101906996696,1095.0783424377441,241.6427698135376,906.3767433166504,11748,3058,8690,8690,0,22,3136000.0
3136,3136999,20.11465192279595,36.28387212260857,0.08894965412948785,1095.3380072116852,241.7076072692871,907.146167755127,11752,3060,8692,8692,0,22,3137000.0
3137,3137999,20.113982009397233,36.28245533008473,0.088937154923582,1095.6804842948914,241.77388334274292,907.5158348083496,11757,3062,8695,8695,0,22,3138000.0
3138,3138999,20.113645301462036,36.282244597465,0.08891510016432635,1095.9864027500153,241.84059762954712,908.0108833312988,11764,3065,8699,8699,0,22,3139000.0
3139,3139999,20.114216091145206,36.28237852295915,0.08890121061943967,1096.3401441574097,241.90625762939453,908.2304267883301,11766,3066,8700,8700,0,22,3140000.0
3140,3140999,20.11612098793314,36.29041751120333,0.08886536270515444,1096.7583949565887,241.97407031059265,908.2869453430176,11768,3067,8701,8701,0,22,3141000.0
3141,3141999,20.120342197398486,36.299135857715356,0.0888523422599975,1097.095213651657,242.04045152664185,908.6879386901855,11770,3068,8702,8702,0,22,3142000.0
3142,3142999,20.126905981794607,36.31415190277913,0.08887837058931247,1097.5677843093872,242.10758066177368,908.497257232666,11770,3068,8702,8702,0,22,3143000.0
3143,3143999,20.134922948167834,36.34448206650773,0.0888554106242927,1097.9094133377075,242.17377138137817,908.8842277526855,11772,3069,8703,8703,0,22,3144000.0
3144,3144999,20.143643067230013,36.37037161191236,0.08892146095420106,1098.214123249054,242.24127888679504,909.3400688171387,11775,3070,8705,8705,0,22,3145000.0
3145,3145999,20.15427083230284,36.40473013905521,0.08900868096234915,1098.5290467739105,242.30981636047363,909.7262840270996,11779,3072,8707,8707,0,22,3146000.0
3146,3146999,20.166702670054566,36.44304268821725,0.08919388910861381,1098.8649089336395,242.3763108253479,910.1895179748535,11779,3072,8707,8707,0,22,3147000.0
3147,3147999,20.1783951881613,36.47817978491929,0.0893788743246261,1099.1504628658295,242.44362807273865,910.7813377380371,11781,3073,8708,8708,0,22,3148000.0
3148,3148999,20.188282527595312,36.50070580291462,0.08964153727475277,1099.635976076126,242.51229596138,910.4961357116699,11783,3074,8709,8709,0,22,3149000.0
3149,3149999,20.199017870722148,36.52611990613871,0.08992743823987637,1099.938635110855,242.57851791381836,910.891170501709,11785,3075,8710,8710,0,22,3150000.0
3150,3150999,20.20935703014626,36.54958693114698,0.09025181414019467,1100.2551729679108,242.64599919319153,911.3002738952637,11806,3077,8729,8729,0,22,3151000.0
3151,3151999,20.216675219603875,36.5651140054752,0.090300941802968,1100.7641723155975,242.71382522583008,911.2821388244629,11823,3079,8744,8744,0,22,3152000.0
3152,3152999,20.216665101213195,36.57023382756649,0.09024183533991781,1101.0614666938782,242.7833104133606,912.0815238952637,11832,3080,8752,8752,0,22,3153000.0
3153,3153999,20.215697356710336,36.56917199152724,0.09022891726137172,1101.3572030067444,242.8505859375,912.7731895446777,11835,3081,8754,8754,0,22,3154000.0
3154,3154999,20.215179817212622,36.56874322403126,0.09021126947084912,1101.6691584587097,242.9165391921997,913.1984367370605,11837,3082,8755,8755,0,22,3155000.0
3155,3155999,20.21449369617417,36.56792718416723,0.09018447718780664,1101.9896721839905,242.9844400882721,913.7120552062988,11838,3082,8756,8756,0,22,3156000.0
3156,3156999,20.213832187090965,36.56665378075862,0.090168038948501,1102.4479911327362,243.05134320259094,913.478687286377,11842,3084,8758,8758,0,22,3157000.0
3157,3157999,20.21272461623596,36.564123525385725,0.09015963529106907,1102.811970949173,243.11820363998413,913.8644599914551,11842,3084,8758,8758,0,22,3158000.0
3158,3158999,20.212689746654124,36.568778905654625,0.09010658071908917,1103.1676876544952,243.18614506721497,914.0049324035645,11843,3085,8758,8758,0,22,3159000.0
3159,3159999,20.211906330300994,36.56677397108695,0.09008837772641698,1103.521222114563,243.25501370429993,914.6341972351074,11858,3086,8772,8772,0,22,3160000.0
3160,3160999,20.211475673711817,36.565187155053785,0.09007497433204403,1103.7899696826935,243.32389974594116,915.4070091247559,11863,3088,8775,8775,0,22,3161000.0
3161,3161999,20.21088817548503,36.56354632743141,0.09006276494389465,1104.155809879303,243.39257168769836,915.7603340148926,11865,3089,8776,8776,0,22,3162000.0
3162,3162999,20.210982002948843,36.56363069970543,0.09003939588130971,1104.4093461036682,243.46221613883972,916.4988136291504,11865,3089,8776,8776,0,22,3163000.0
3163,3163999,20.21100829725241,36.56319900982106,0.09002896891297474,1104.711791753769,243.5306670665741,916.897388458252,11867,3090,8777,8777,0,22,3164000.0
3164,3164999,20.21138056771824,36.56297078273434,0.09000503240310342,1105.1858100891113,243.59951853752136,916.5998573303223,11869,3091,8778,8778,0,22,3165000.0
3165,3165999,20.21162648317122,36.56166091400571,0.08999220997580892,1105.581711769104,243.6683473587036,916.635555267334,11873,3093,8780,8780,0,22,3166000.0
3166,3166999,20.211612106600327,36.559764889202405,0.0899850318836255,1105.981059551239,243.7369463443756,916.6897010803223,11875,3094,8781,8781,0,22,3167000.0
3167,3167999,20.211894950774386,36.558770577576176,0.08997240222710345,1106.279592037201,243.80527520179749,917.1162986755371,11877,3095,8782,8782,0,22,3168000.0
3168,3168999,20.212104114649577,36.55713965875855,0.08997073820319446,1106.675627708435,243.87726354599,917.1809577941895,11877,3095,8782,8782,0,22,3169000.0
3169,3169999,20.211556426678055,36.55609727478842,0.08995444378491813,1107.0863208770752,243.94782328605652,917.2768669128418,11880,3096,8784,8784,0,22,3170000.0
3170,3170999,20.20980971433601,36.55314276752122,0.08995876183088425,1107.3357255458832,244.01533722877502,918.5306587219238,11897,3097,8800,8800,0,22,3171000.0
3171,3171999,20.207382640208618,36.549816364420934,0.08996985412819525,1107.5580611228943,244.08239102363586,919.6507987976074,11902,3097,8805,8805,0,22,3172000.0
3172,3172999,20.20524271715044,36.54666974723906,0.08997446096161033,1107.8090949058533,244.14814972877502,920.6270484924316,11919,3099,8820,8820,0,22,3173000.0
3173,3173999,20.202621700639995,36.542289158932356,0.08998907938605039,1108.051420211792,244.21610760688782,921.5320701599121,11921,3100,8821,8821,0,22,3174000.0
3174,3174999,20.200443691294865,36.538632378413205,0.08999289443010083,1108.366529226303,244.28201055526733,921.9822196960449,11923,3101,8822,8822,0,22,3175000.0
3175,3175999,20.198187962085807,36.535866370772574,0.08999964693912033,1108.7531414031982,244.35030913352966,922.0631675720215,11926,3102,8824,8824,0,22,3176000.0
3176,3176999,20.195782530581386,36.531957593097914,0.0900059065002421,1108.9789888858795,244.41773867607117,922.919750213623,11926,3102,8824,8824,0,22,3177000.0
3177,3177999,20.193620827853206,36.52817227174744,0.09000899286367459,1109.3368690013885,244.48511457443237,923.0418663024902,11929,3103,8826,8826,0,22,3178000.0
3178,3178999,20.191713912487888,36.526060357900334,0.0900005071864145,1109.7142629623413,244.5518696308136,923.204158782959,11931,3104,8827,8827,0,22,3179000.0
3179,3179999,20.19008893313164,36.52345965984769,0.08999039919602314,1110.0632057189941,244.61955285072327,923.3336143493652,11934,3105,8829,8829,0,22,3180000.0
3180,3180999,20.188308518280333,36.52025480371303,0.08998608972988031,1110.4924521446228,244.68736791610718,923.1942176818848,11936,3106,8830,8830,0,22,3181000.0
3181,3181999,20.186770805661617,36.51728676469006,0.08997438262529145,1110.783365726471,244.75531196594238,923.7049827575684,11936,3106,8830,8830,0,22,3182000.0
3182,3182999,20.185388383178072,36.51420797422631,0.08996626516929151,1111.1128222942352,244.8243703842163,923.9689064025879,11936,3106,8830,8830,0,22,3183000.0
3183,3183999,20.184761927444036,36.512762483669576,0.08994550378758315,1111.4523429870605,244.8918273448944,924.2168083190918,11938,3107,8831,8831,0,22,3184000.0
3184,3184999,20.18487708591705,36.51513903552199,0.08990474549859784,1111.7371549606323,244.95844674110413,924.6393547058105,11938,3107,8831,8831,0,22,3185000.0
3185,3185999,20.18529792248833,36.51576391616859,0.08988142869921179,1112.1746034622192,245.02613496780396,924.4971809387207,11940,3108,8832,8832,0,22,3186000.0
3186,3186999,20.185503974676937,36.51544467829974,0.08986372901434336,1112.5674526691437,245.09341597557068,924.3968772888184,11944,3110,8834,8834,0,22,3187000.0
3187,3187999,20.186283869571227,36.51597328732381,0.0898548178662153,1112.9808461666107,245.16119647026062,924.3130989074707,11947,3112,8835,8835,0,22,3188000.0
3188,3188999,20.187059885475865,36.516760770102785,0.08983750431337922,1113.3741822242737,245.22995495796204,924.352367401123,11951,3114,8837,8837,0,22,3189000.0
3189,3189999,20.187351050709893,36.51583334281559,0.08982841281603049,1113.686372756958,245.30015420913696,924.7049674987793,11954,3116,8838,8838,0,22,3190000.0
3190,3190999,20.18719459957011,36.51571928423657,0.08980159507024743,1113.9186096191406,245.36897897720337,925.9080085754395,11963,3116,8847,8847,0,22,3191000.0
3191,3191999,20.184326413682307,36.511303010477256,0.08981674590549737,1114.2083578109741,245.4346477985382,926.7149696350098,11969,3117,8852,8852,0,22,3192000.0
3192,3192999,20.181950342925496,36.50858580895278,0.089817775262792,1114.5015697479248,245.50059366226196,927.2477531433105,11970,3117,8853,8853,0,22,3193000.0
3193,3193999,20.180035091810428,36.50605436396765,0.08981503850334571,1114.8562440872192,245.5674331188202,927.5681114196777,11972,3118,8854,8854,0,22,3194000.0
3194,3194999,20.178051245613158,36.50395512665117,0.08980453450181713,1115.160816669464,245.63296127319336,928.0457878112793,11974,3119,8855,8855,0,22,3195000.0
3195,3195999,20.17583425873598,36.50210617175022,0.08979804080405107,1115.6037275791168,245.7001781463623,927.9947624206543,11976,3120,8856,8856,0,22,3196000.0
3196,3196999,20.17360425865766,36.49841399700031,0.08979592831600591,1115.9593002796173,245.76712799072266,928.3038673400879,11976,3120,8856,8856,0,22,3197000.0
3197,3197999,20.171487492783786,36.49497136537316,0.08979378969176766,1116.274132490158,245.83383989334106,928.5580787658691,11977,3121,8856,8856,0,22,3198000.0
3198,3198999,20.16996105212655,36.493724951325866,0.08977985228663199,1116.7076210975647,245.9027454853058,928.4472770690918,11978,3122,8856,8856,0,22,3199000.0
3199,3199999,20.16831814044964,36.49049393447141,0.08977812432464372,1117.1538405418396,245.9713408946991,928.2699699401855,11984,3125,8859,8859,0,22,3200000.0
3200,3200999,20.16734334981357,36.489085557194905,0.08976311020557581,1117.6212666034698,246.04108381271362,928.1613578796387,11986,3126,8860,8860,0,22,3201000.0
3201,3201999,20.16710479960389,36.48930805531044,0.08973384546200314,1117.931714296341,246.10904788970947,928.6951484680176,11986,3126,8860,8860,0,22,3202000.0
3202,3202999,20.166809073929265,36.489033027168574,0.08971156016409199,1118.2994935512543,246.17732644081116,928.9244422912598,11986,3126,8860,8860,0,22,3203000.0
3203,3203999,20.168610263428324,36.494109411258975,0.0896714958849757,1118.6722629070282,246.24574637413025,928.9874076843262,11988,3127,8861,8861,0,22,3204000.0
3204,3204999,20.172313326632608,36.5014756103472,0.0896437764349508,1119.1316757202148,246.31784176826477,928.7320442199707,11991,3129,8862,8862,0,22,3205000.0
3205,3205999,20.176619779751636,36.5126799600812,0.08960663260849722,1119.43887758255,246.38835215568542,929.2727165222168,11991,3129,8862,8862,0,22,3206000.0
3206,3206999,20.181003609184113,36.520750571148355,0.08960753287642165,1119.7559530735016,246.4599051475525,930.016040802002,12008,3131,8877,8877,0,22,3207000.0
3207,3207999,20.185729529250906,36.528397439559,0.08966325464487857,1120.0583600997925,246.53223657608032,930.6903877258301,12008,3131,8877,8877,0,22,3208000.0
3208,3208999,20.190291461680538,36.53614847109483,0.08973097852576473,1120.391981601715,246.6032748222351,931.0060691833496,12010,3132,8878,8878,0,22,3209000.0
3209,3209999,20.194233028231366,36.54361286900666,0.08978473265739906,1120.6945176124573,246.67348217964172,931.575984954834,12010,3132,8878,8878,0,22,3210000.0
3210,3210999,20.19904617141647,36.55070493073922,0.08988843884015418,1121.0465891361237,246.7465443611145,931.6790809631348,12013,3133,8880,8880,0,22,3211000.0
3211,3211999,20.20274105300546,36.56254975894417,0.0898974970337173,1121.3940160274506,246.81866431236267,932.3922920227051,12035,3134,8901,8901,0,22,3212000.0
3212,3212999,20.200406097509997,36.56005227653053,0.08989759435148359,1121.584181547165,246.88386917114258,933.9247627258301,12043,3134,8909,8909,0,22,3213000.0
3213,3213999,20.198399118805785,36.556854822246194,0.08989402692447301,1121.7756478786469,246.94884419441223,935.0201606750488,12044,3134,8910,8910,0,22,3214000.0
3214,3214999,20.196390851827,36.553460810983765,0.08989803327608226,1122.1263411045074,247.01493620872498,935.2799339294434,12053,3138,8915,8915,0,22,3215000.0
3215,3215999,20.194470463410653,36.55026166322642,0.08990389039719715,1122.431843996048,247.08131957054138,935.8108863830566,12055,3139,8916,8916,0,22,3216000.0
3216,3216999,20.192709851034248,36.548167325102895,0.08989774508856307,1122.7942180633545,247.14660716056824,935.9615898132324,12061,3142,8919,8919,0,22,3217000.0
3217,3217999,20.191185270119774,36.546578704327914,0.08988816030579705,1123.2078416347504,247.21222972869873,935.9979209899902,12065,3144,8921,8921,0,22,3218000.0
3218,3218999,20.189825360272206,36.54528836899775,0.0898747122436826,1123.58367562294,247.27832174301147,936.2151985168457,12070,3146,8924,8924,0,22,3219000.0
3219,3219999,20.18919861357355,36.545660506305744,0.0898562663100253,1123.7875332832336,247.34366655349731,937.1402244567871,12070,3146,8924,8924,0,22,3220000.0
3220,3220999,20.18916719921673,36.54978241444547,0.08983926995206681,1124.1174757480621,247.40901279449463,937.4449348449707,12072,3147,8925,8925,0,22,3221000.0
3221,3221999,20.190272463120454,36.5547226930442,0.08981817585148832,1124.4876692295074,247.47754859924316,937.6049537658691,12072,3147,8925,8925,0,22,3222000.0
3222,3222999,20.19391174784252,36.5659626154305,0.08979883772236086,1124.793508529663,247.54475831985474,938.0503044128418,12074,3148,8926,8926,0,22,3223000.0
3223,3223999,20.19778120629992,36.58049752204246,0.08976626345312533,1125.2756600379944,247.61266565322876,937.8164405822754,12078,3150,8928,8928,0,22,3224000.0
3224,3224999,20.20360956782256,36.59792157459479,0.08976531890280837,1125.627762556076,247.6804141998291,938.0631370544434,12080,3151,8929,8929,0,22,3225000.0
3225,3225999,20.2107492702594,36.61857189213963,0.08975773479748461,1125.9150881767273,247.74641036987305,938.6939811706543,12082,3152,8930,8930,0,22,3226000.0
3226,3226999,20.21660697742281,36.63532355814537,0.08976863328791174,1126.185161113739,247.81226587295532,939.1953163146973,12084,3153,8931,8931,0,22,3227000.0
3227,3227999,20.224223384592225,36.65730468193743,0.0898145562360062,1126.6847949028015,247.88055849075317,938.8536796569824,12090,3156,8934,8934,0,22,3228000.0
3228,3228999,20.231289225506277,36.678158524001134,0.08986191269742272,1126.9960758686066,247.94865703582764,939.2271842956543,12094,3158,8936,8936,0,22,3229000.0
3229,3229999,20.239156360857667,36.69839426860797,0.08987514804193175,1127.5281229019165,248.01779079437256,938.9111518859863,12096,3159,8937,8937,0,22,3230000.0
3230,3230999,20.248702503054968,36.725448809924195,0.08997771441169533,1127.8867151737213,248.08568120002747,939.1541633605957,12098,3160,8938,8938,0,22,3231000.0
3231,3231999,20.254272685594064,36.73660972429936,0.09003513202343383,1128.1797864437103,248.15337872505188,939.7860145568848,12114,3161,8953,8953,0,22,3232000.0
3232,3232999,20.25462130936326,36.73703462746478,0.09007532479876101,1128.4780821800232,248.22184085845947,940.7761650085449,12127,3161,8966,8966,0,22,3233000.0
3233,3233999,20.25296312285475,36.73501867021019,0.09007570743481152,1128.7043187618256,248.28845071792603,942.097599029541,12146,3162,8984,8984,0,22,3234000.0
3234,3234999,20.251755634766493,36.73769492320932,0.0900436997337919,1128.9898586273193,248.356680393219,942.8756828308105,12153,3163,8990,8990,0,22,3235000.0
3235,3235999,20.250742309863917,36.73625858063537,0.09004395670107435,1129.194875717163,248.42261385917664,943.8332405090332,12155,3164,8991,8991,0,22,3236000.0
3236,3236999,20.249587402317374,36.734526853967694,0.09002802733080495,1129.4899833202362,248.489173412323,944.2618064880371,12159,3166,8993,8993,0,22,3237000.0
3237,3237999,20.248461436896825,36.73257893445171,0.09001577138124695,1129.837763786316,248.55760431289673,944.5457725524902,12165,3169,8996,8996,0,22,3238000.0
3238,3238999,20.24679136351794,36.72926444387577,0.09001016427003883,1130.1546580791473,248.62456464767456,944.9215507507324,12165,3169,8996,8996,0,22,3239000.0
3239,3239999,20.245466855147512,36.726486600858856,0.09000346220896605,1130.6151299476624,248.69217920303345,944.6716575622559,12166,3169,8997,8997,0,22,3240000.0
3240,3240999,20.244428972975065,36.724310733488934,0.08999510753959794,1130.876310825348,248.76132559776306,945.3267707824707,12170,3171,8999,8999,0,22,3241000.0
3241,3241999,20.24383478091022,36.722530044110286,0.08998941907691937,1131.2493822574615,248.82871413230896,945.5732765197754,12170,3171,8999,8999,0,22,3242000.0
3242,3242999,20.243268539068456,36.72054746054546,0.08997563836378686,1131.5349736213684,248.8950080871582,946.026294708252,12170,3171,8999,8999,0,22,3243000.0
3243,3243999,20.24427057520351,36.722737916300346,0.08995354674422473,1132.0086691379547,248.9636743068695,945.7244148254395,12172,3172,9000,9000,0,22,3244000.0
3244,3244999,20.245468817946836,36.724445968023566,0.08994884193604202,1132.308827638626,249.03041887283325,946.0850715637207,12172,3172,9000,9000,0,22,3245000.0
3245,3245999,20.248208138818523,36.731112890755774,0.08992153948693415,1132.7268824577332,249.098637342453,946.1132469177246,12172,3172,9000,9000,0,22,3246000.0
3246,3246999,20.252007818729975,36.74438608869268,0.08986609457083217,1132.9662263393402,249.16529035568237,946.8048133850098,12172,3172,9000,9000,0,22,3247000.0
3247,3247999,20.256670652838913,36.75434222499443,0.08983441273368564,1133.2676265239716,249.23339366912842,947.1851768493652,12174,3173,9001,9001,0,22,3248000.0
3248,3248999,20.261921709141866,36.76575250000177,0.08984243296859762,1133.55238199234,249.3014838695526,947.6870613098145,12174,3173,9001,9001,0,22,3249000.0
3249,3249999,20.266517761263948,36.77576742782726,0.08984169568969247,1134.113748550415,249.37060499191284,947.0107460021973,12176,3174,9002,9002,0,22,3250000.0
3250,3250999,20.27101144834074,36.783204065237506,0.08987716744298968,1134.413883447647,249.43848419189453,947.6321449279785,12176,3174,9002,9002,0,22,3251000.0
3251,3251999,20.276372552821087,36.79160099708026,0.08995062230209316,1134.7204356193542,249.5063512325287,948.0739402770996,12176,3174,9002,9002,0,22,3252000.0
3252,3252999,20.279325414178054,36.79752122069696,0.08995507599457986,1135.0003209114075,249.57431173324585,948.7041969299316,12176,3174,9002,9002,0,22,3253000.0
3253,3253999,20.27745447292609,36.79479700603118,0.08995592588875645,1135.2951641082764,249.64439964294434,949.6899147033691,12194,3175,9019,9019,0,22,3254000.0
3254,3254999,20.275168236019134,36.79153587088038,0.08995808661742566,1135.587741136551,249.7127547264099,950.3001289367676,12197,3175,9022,9022,0,22,3255000.0
3255,3255999,20.273632318956682,36.79307021204692,0.0899319411101771,1135.9641127586365,249.7805302143097,950.5576438903809,12203,3176,9027,9027,0,22,3256000.0
3256,3256999,20.27193997912794,36.78996285342357,0.08993628005603826,1136.2638626098633,249.8482985496521,951.0321617126465,12203,3176,9027,9027,0,22,3257000.0
3257,3257999,20.270505260824184,36.788925563732434,0.08992101309937728,1136.6898546218872,249.91671633720398,950.9445304870605,12205,3177,9028,9028,0,22,3258000.0
3258,3258999,20.26938989862315,36.787395811494136,0.08990812025772654,1137.0316843986511,249.98534989356995,951.3616065979004,12205,3177,9028,9028,0,22,3259000.0
3259,3259999,20.2680584428457,36.78661815830198,0.08988800523561913,1137.349060535431,250.05256271362305,951.7440910339355,12205,3177,9028,9028,0,22,3260000.0
3260,3260999,20.26661751143027,36.78394330655398,0.08988179466044033,1137.7787337303162,250.12330389022827,951.4930610656738,12213,3182,9031,9031,0,22,3261000.0
3261,3261999,20.26542470965241,36.7813344989456,0.089872525560736,1138.1297721862793,250.19324278831482,951.855770111084,12215,3183,9032,9032,0,22,3262000.0
3262,3262999,20.264615874511552,36.77978956027425,0.08986214771520074,1138.4819858074188,250.26249313354492,952.1395530700684,12215,3183,9032,9032,0,22,3263000.0
3263,3263999,20.263869376456334,36.77908479388781,0.08984849428398423,1138.8434329032898,250.33197402954102,952.3962821960449,12215,3183,9032,9032,0,22,3264000.0
3264,3264999,20.264058720442648,36.778057698853246,0.08985068754854175,1139.2943334579468,250.40300130844116,952.1799354553223,12217,3184,9033,9033,0,22,3265000.0
3265,3265999,20.26441491647847,36.777493105369345,0.08984134312163539,1139.7174484729767,250.47373747825623,952.1635856628418,12224,3186,9038,9038,0,22,3266000.0
3266,3266999,20.265618531688414,36.778090721110345,0.08984672488310341,1140.088573217392,250.54336047172546,952.3539924621582,12226,3187,9039,9039,0,22,3267000.0
3267,3267999,20.268226709275357,36.781279541732275,0.08984558340808246,1140.4033787250519,250.61465716362,952.663990020752,12230,3189,9041,9041,0,22,3268000.0
3268,3268999,20.271127592975308,36.784036353296486,0.08987912522029917,1140.7990238666534,250.68484234809875,952.678409576416,12232,3190,9042,9042,0,22,3269000.0
3269,3269999,20.274380413467703,36.78756090028044,0.08992922692529537,1141.1633644104004,250.7550687789917,952.8219337463379,12235,3192,9043,9043,0,22,3270000.0
3270,3270999,20.27796707301287,36.79124697047558,0.08998348938960199,1141.6649491786957,250.8263669013977,952.5664253234863,12235,3192,9043,9043,0,22,3271000.0
3271,3271999,20.281124588807398,36.793011770775585,0.09003291116793366,1142.0504324436188,250.8970308303833,952.7454261779785,12235,3192,9043,9043,0,22,3272000.0
3272,3272999,20.284055567953853,36.79466076832757,0.09006731443331373,1142.4460997581482,250.96890330314636,952.9036521911621,12235,3192,9043,9043,0,22,3273000.0
3273,3273999,20.286772942700072,36.795768583071315,0.09008595979091738,1142.7141726016998,251.03889775276184,953.565502166748,12235,3192,9043,9043,0,22,3274000.0
3274,3274999,20.286161279971893,36.793337524275984,0.09008113939854834,1142.969963312149,251.10647773742676,954.7426719665527,12264,3194,9070,9070,0,22,3275000.0
3275,3275999,20.283983684995228,36.79011325389755,0.09008009148380813,1143.248248577118,251.171555519104,955.7130546569824,12278,3194,9084,9084,0,22,3276000.0
3276,3276999,20.28189481627623,36.787175033764264,0.0900756061969824,1143.4816780090332,251.23659491539001,956.6472206115723,12282,3194,9088,9088,0,22,3277000.0
3277,3277999,20.280387299520697,36.78439558537562,0.09006353446155513,1143.7174015045166,251.30098938941956,957.5759239196777,12284,3194,9090,9090,0,22,3278000.0
3278,3278999,20.278458802147483,36.78073764430097,0.09006121646639775,1143.911655664444,251.36698126792908,958.7173118591309,12295,3195,9100,9100,0,22,3279000.0
3279,3279999,20.27746613010811,36.78198001033398,0.09002668756657162,1144.3659331798553,251.43420386314392,958.8105964660645,12300,3197,9103,9103,0,22,3280000.0
3280,3280999,20.275685843232687,36.778998260678236,0.09001834765531402,1144.6774423122406,251.50017976760864,959.418628692627,12305,3199,9106,9106,0,22,3281000.0
3281,3281999,20.274082771728104,36.77574435687576,0.09000689606127577,1144.9723432064056,251.56662678718567,960.0242958068848,12308,3200,9108,9108,0,22,3282000.0
3282,3282999,20.27251294151757,36.77263647433384,0.08999353732974502,1145.1882762908936,251.63305068016052,960.7838554382324,12310,3201,9109,9109,0,22,3283000.0
3283,3283999,20.271485606030353,36.76988632349139,0.08997126075141615,1145.638650894165,251.7010636329651,960.5296592712402,12318,3205,9113,9113,0,22,3284000.0
3284,3284999,20.27092731064681,36.76884382145706,0.08994852022896915,1146.0022180080414,251.76818585395813,960.9055824279785,12322,3207,9115,9115,0,22,3285000.0
3285,3285999,20.27072592824722,36.767661288374555,0.08992266942870375,1146.3140544891357,251.83727836608887,961.3380241394043,12326,3209,9117,9117,0,22,3286000.0
3286,3286999,20.271084228328665,36.76674080450978,0.08990613815437942,1146.77663230896,251.90441966056824,961.2118110656738,12333,3212,9121,9121,0,22,3287000.0
3287,3287999,20.271677041122434,36.766433355393524,0.08989057806776724,1147.0549881458282,251.9712519645691,961.9517631530762,12348,3213,9135,9135,0,22,3288000.0
3288,3288999,20.272728018038674,36.766801766976045,0.08986935236445104,1147.2822363376617,252.03800797462463,962.7610893249512,12350,3214,9136,9136,0,22,3289000.0
3289,3289999,20.27368660073513,36.76682182640754,0.08985023509949042,1147.5525662899017,252.10451340675354,963.2516899108887,12352,3215,9137,9137,0,22,3290000.0
3290,3290999,20.274453294378258,36.7660858557032,0.08984036347792634,1147.9910378456116,252.17213940620422,963.1222343444824,12356,3217,9139,9139,0,22,3291000.0
3291,3291999,20.275310283932267,36.76511860001215,0.08984074146378374,1148.4646484851837,252.2416069507599,963.0185966491699,12360,3219,9141,9141,0,22,3292000.0
3292,3292999,20.276729042006398,36.76780673160239,0.08980727906522068,1148.7487092018127,252.30935049057007,963.7261085510254,12366,3220,9146,9146,0,22,3293000.0
3293,3293999,20.278084020330773,36.77391704635941,0.08975493276711999,1149.0039076805115,252.37619137763977,964.3330574035645,12366,3220,9146,9146,0,22,3294000.0
3294,3294999,20.278482245802227,36.772547560821806,0.0897379522294578,1149.431137084961,252.44304156303406,964.2156181335449,12366,3220,9146,9146,0,22,3295000.0
3295,3295999,20.277906488168483,36.771657092455314,0.08970554027310285,1149.8166377544403,252.51171326637268,964.817195892334,12381,3221,9160,9160,0,22,3296000.0
3296,3296999,20.277346600656283,36.77144107944788,0.0896800903524505,1150.0657346248627,252.57966089248657,965.8473243713379,12390,3222,9168,9168,0,22,3297000.0
3297,3297999,20.27661652908851,36.769355414044774,0.08969282986395655,1150.3627378940582,252.6471402645111,966.4794120788574,12393,3223,9170,9170,0,22,3298000.0
3298,3298999,20.27610015324429,36.76772817474116,0.08968638218291014,1150.7842772006989,252.71441102027893,966.4399070739746,12393,3223,9170,9170,0,22,3299000.0
3299,3299999,20.2757003233664,36.76664065089999,0.08969022394084647,1151.1441309452057,252.78233647346497,966.7966575622559,12411,3225,9186,9186,0,22,3300000.0
3300,3300999,20.275316321978202,36.76528239221115,0.08968762621310189,1151.543181180954,252.84994411468506,967.0037422180176,12415,3227,9188,9188,0,22,3301000.0
3301,3301999,20.27532528081955,36.76469349940388,0.08968147840904284,1151.8461484909058,252.9185938835144,967.7028160095215,12415,3227,9188,9188,0,22,3302000.0
3302,3302999,20.275078452991735,36.7629816215049,0.08969941751759347,1152.103091955185,252.9866807460785,968.447322845459,12417,3228,9189,9189,0,22,3303000.0
3303,3303999,20.2759076835469,36.76477840178084,0.08972815341388096,1152.5047509670258,253.05577611923218,968.7132911682129,12419,3229,9190,9190,0,22,3304000.0
3304,3304999,20.276528279198264,36.76640429766283,0.08973725032498503,1152.7735810279846,253.12358784675598,969.255428314209,12420,3230,9190,9190,0,22,3305000.0
3305,3305999,20.27868934988861,36.77683429232171,0.08974354591720834,1153.1718580722809,253.19329476356506,969.4245872497559,12422,3231,9191,9191,0,22,3306000.0
3306,3306999,20.282787309788148,36.78763390129022,0.08980101382806804,1153.490960597992,253.26345682144165,969.7826309204102,12426,3233,9193,9193,0,22,3307000.0
3307,3307999,20.285892323713608,36.792902888436174,0.08998491078320381,1153.8337955474854,253.33405137062073,970.1144485473633,12426,3233,9193,9193,0,22,3308000.0
3308,3308999,20.28973054166413,36.80056566573129,0.09006930052350004,1154.1452729701996,253.4035999774933,970.5670166015625,12426,3233,9193,9193,0,22,3309000.0
3309,3309999,20.293510068246274,36.806684218885366,0.09015907225568065,1154.547485113144,253.47356128692627,970.6458206176758,12429,3234,9195,9195,0,22,3310000.0
3310,3310999,20.296558324795903,36.810884261282276,0.09023366449566295,1155.0587344169617,253.5428659915924,970.2796249389648,12434,3236,9198,9198,0,22,3311000.0
3311,3311999,20.30075849549434,36.818175150218806,0.09029382823405352,1155.4150876998901,253.61310362815857,970.6541442871094,12434,3236,9198,9198,0,22,3312000.0
3312,3312999,20.303983361865622,36.82182843323054,0.09034695169231277,1155.8258748054504,253.68436813354492,970.6133193969727,12438,3238,9200,9200,0,22,3313000.0
3313,3313999,20.306922597001478,36.82423437221235,0.09034113755456874,1156.1283349990845,253.75396251678467,971.1105499267578,12439,3239,9200,9200,0,22,3314000.0
3314,3314999,20.30754329921232,36.82521148161584,0.0903051305838416,1156.401248216629,253.82289052009583,972.1415100097656,12454,3240,9214,9214,0,22,3315000.0
3315,3315999,20.306403587550207,36.82460084119342,0.09029097067437519,1156.6732804775238,253.8882327079773,973.0753631591797,12461,3241,9220,9220,0,22,3316000.0
3316,3316999,20.30513441875486,36.82287005941306,0.09029865539632087,1156.965180158615,253.95424938201904,973.574836730957,12464,3242,9222,9222,0,22,3317000.0
3317,3317999,20.30448008319362,36.82387768106088,0.09027787657968445,1162.0712337493896,254.01973176002502,973.9948883056641,12467,3243,9224,9224,0,22,3318000.0
3318,3318999,20.304557927122925,36.824479042746574,0.09026413980225145,1162.2769184112549,254.08605647087097,975.0285110473633,12481,3244,9237,9237,0,22,3319000.0
3319,3319999,20.304791140120606,36.82655700261921,0.09024083111542691,1162.6228342056274,254.15375232696533,975.4244537353516,12484,3245,9239,9239,0,22,3320000.0
3320,3320999,20.305096351467824,36.82823034735477,0.09023511553193331,1162.966418504715,254.22075867652893,975.8181762695312,12488,3247,9241,9241,0,22,3321000.0
3321,3321999,20.306415331232905,36.83087025574022,0.09022475114592376,1163.166165113449,254.28811407089233,976.7174987792969,12489,3247,9242,9242,0,22,3322000.0
3322,3322999,20.307315076538952,36.83146895825762,0.09023533159509611,1163.571696281433,254.3547613620758,976.8372192382812,12491,3248,9243,9243,0,22,3323000.0
3323,3323999,20.30878309256075,36.83404100947481,0.09025851656549422,1163.932392835617,254.42194604873657,976.9994888305664,12495,3250,9245,9245,0,22,3324000.0
3324,3324999,20.31032469655278,36.83647525348802,0.09029716560870482,1164.3099930286407,254.4893729686737,977.1824722290039,12497,3251,9246,9246,0,22,3325000.0
3325,3325999,20.31216465481065,36.8387069020355,0.09034201302983302,1164.6527571678162,254.55712699890137,977.5160293579102,12513,3253,9260,9260,0,22,3326000.0
3326,3326999,20.314678380825516,36.84750590555948,0.09037483132128443,1164.9790074825287,254.62583374977112,977.8943862915039,12514,3253,9261,9261,0,22,3327000.0
3327,3327999,20.316596371131507,36.85228443707676,0.09044291297330231,1165.297165632248,254.69281601905823,978.3260040283203,12514,3253,9261,9261,0,22,3328000.0
3328,3328999,20.3189794874472,36.859104561893986,0.0905013190863786,1165.756816625595,254.7674901485443,978.1518249511719,12516,3254,9262,9262,0,22,3329000.0
3329,3329999,20.321153089894537,36.86165409529043,0.09054871170090761,1166.1770091056824,254.8396122455597,978.2338104248047,12524,3256,9268,9268,0,22,3330000.0
3330,3330999,20.32354787692383,36.86652759680268,0.09062444136095105,1166.6043202877045,254.90888786315918,978.1829681396484,12528,3258,9270,9270,0,22,3331000.0
3331,3331999,20.325551247960263,36.86881471448717,0.0906778110548645,1166.8086717128754,254.97583603858948,979.0912017822266,12528,3258,9270,9270,0,22,3332000.0
3332,3332999,20.327762193685682,36.873996725633106,0.09071844472072654,1167.1322495937347,255.04462265968323,979.2930450439453,12531,3260,9271,9271,0,22,3333000.0
3333,3333999,20.329665451685383,36.87539789040947,0.0907645704460519,1167.407418012619,255.1137933731079,979.8433265686035,12533,3260,9273,9273,0,22,3334000.0
3334,3334999,20.330486118225913,36.879321131412,0.09076621578391109,1167.8180906772614,255.1848702430725,980.2394981384277,12542,3260,9282,9282,0,22,3335000.0
3335,3335999,20.3285846463495,36.87773346068819,0.09075729102301311,1168.1092672348022,255.25101113319397,981.0382652282715,12549,3261,9288,9288,0,22,3336000.0
3336,3336999,20.32647566317323,36.87465684131733,0.09075301873750574,1168.4073889255524,255.31766629219055,981.6148872375488,12550,3261,9289,9289,0,22,3337000.0
3337,3337999,20.32445255008237,36.8712767214267,0.09075248701325989,1168.7473437786102,255.38376569747925,982.0074424743652,12550,3261,9289,9289,0,22,3338000.0
3338,3338999,20.32322961301856,36.86981315232428,0.09073430716643338,1169.042290687561,255.45002269744873,982.4808921813965,12551,3261,9290,9290,0,22,3339000.0
3339,3339999,20.321351348436753,36.866552789069786,0.09072638197907479,1169.515594959259,255.5161702632904,982.2612800598145,12555,3263,9292,9292,0,22,3340000.0
3340,3340999,20.32007101873158,36.86538193783997,0.09070910860531756,1169.9399502277374,255.58315992355347,982.2627983093262,12557,3264,9293,9293,0,22,3341000.0
3341,3341999,20.31884249529248,36.86301901614686,0.09069557680320606,1170.3673145771027,255.64993572235107,981.9966697692871,12562,3267,9295,9295,0,22,3342000.0
3342,3342999,20.318002292234883,36.86087062373364,0.09067822110816648,1170.626981496811,255.718603849411,982.7183952331543,12563,3268,9295,9295,0,22,3343000.0
3343,3343999,20.31803222647756,36.861017183365675,0.0906545563396901,1171.0850749015808,255.78681302070618,982.5541572570801,12565,3269,9296,9296,0,22,3344000.0
3344,3344999,20.318140072061148,36.86050104132366,0.09063479091824234,1171.440022945404,255.8560824394226,982.8685340881348,12565,3269,9296,9296,0,22,3345000.0
3345,3345999,20.3196956486689,36.86406298080844,0.09060044472689222,1171.8110370635986,255.92533946037292,983.0792427062988,12565,3269,9296,9296,0,22,3346000.0
3346,3346999,20.322077764999463,36.86927247289111,0.09059681108577788,1172.2534716129303,255.99474954605103,982.8562889099121,12573,3271,9302,9302,0,22,3347000.0
3347,3347999,20.32465770802497,36.87332123415249,0.09060797876612892,1172.613092660904,256.0655379295349,983.0934944152832,12573,3271,9302,9302,0,22,3348000.0
3348,3348999,20.327531275109816,36.87702970810399,0.09069960649891085,1173.0417232513428,256.13547348976135,982.981273651123,12574,3272,9302,9302,0,22,3349000.0
3349,3349999,20.331589142633334,36.88436369821354,0.09077652614272957,1173.495011806488,256.2066903114319,982.850513458252,12576,3273,9303,9303,0,22,3350000.0
3350,3350999,20.336390333194938,36.89174477891912,0.09087612086062524,1173.858943939209,256.27789545059204,983.1639289855957,12578,3274,9304,9304,0,22,3351000.0
3351,3351999,20.34149378137307,36.90712786576943,0.09090792735882058,1174.1622836589813,256.34847497940063,983.722339630127,12578,3274,9304,9304,0,22,3352000.0
3352,3352999,20.345585295882817,36.913618430503966,0.09095113117199516,1174.73863530159,256.41901087760925,982.969165802002,12582,3276,9306,9306,0,22,3353000.0
3353,3353999,20.349933963114868,36.92056301081694,0.09099957643738654,1175.1849932670593,256.490519285202,982.9157295227051,12600,3278,9322,9322,0,22,3354000.0
3354,3354999,20.353125026365156,36.9225713063777,0.09103946542854457,1175.5302708148956,256.56301045417786,983.2409324645996,12600,3278,9322,9322,0,22,3355000.0
3355,3355999,20.35487935543457,36.923904603911,0.09102164212544739,1175.8372151851654,256.63495087623596,984.1180458068848,12618,3279,9339,9339,0,22,3356000.0
3356,3356999,20.35404303483182,36.92292446743334,0.09097656982111113,1175.9773743152618,256.6991469860077,986.0244255065918,12630,3279,9351,9351,0,22,3357000.0
3357,3357999,20.35296022137273,36.92348212754868,0.09096961474440302,1176.1231603622437,256.7630777359009,987.3178367614746,12633,3279,9354,9354,0,22,3358000.0
3358,3358999,20.351910134917652,36.922152862774276,0.09096316053205067,1176.4555397033691,256.82955598831177,987.7554740905762,12640,3282,9358,9358,0,22,3359000.0
3359,3359999,20.350545318842197,36.919092446683585,0.09096041501801488,1176.662056684494,256.8943750858307,988.6637077331543,12643,3283,9360,9360,0,22,3360000.0
3360,3360999,20.34955474652704,36.91641507519251,0.09095444417496679,1177.0346307754517,256.9605939388275,988.7208824157715,12647,3285,9362,9362,0,22,3361000.0
3361,3361999,20.34914685828579,36.914725143024015,0.0909457509875099,1177.6119320392609,257.0293107032776,987.9455451965332,12659,3291,9368,9368,0,22,3362000.0
3362,3362999,20.348406161205244,36.91253937466937,0.0909389826453314,1177.8581087589264,257.0966169834137,988.8417015075684,12662,3292,9370,9370,0,22,3363000.0
3363,3363999,20.347904480795005,36.91244207687452,0.09092084607043893,1178.1003773212433,257.1623728275299,989.5452766418457,12662,3292,9370,9370,0,22,3364000.0
3364,3364999,20.347293762436646,36.9109738518169,0.09090481457421073,1178.4452211856842,257.22826647758484,989.7255516052246,12666,3294,9372,9372,0,22,3365000.0
3365,3365999,20.34719654515422,36.90973806884976,0.09089627673403267,1178.9053061008453,257.29677724838257,989.5734672546387,12672,3295,9377,9377,0,22,3366000.0
3366,3366999,20.34846162224171,36.916517027733434,0.09085258841665989,1179.2503836154938,257.3625786304474,989.8392524719238,12672,3295,9377,9377,0,22,3367000.0
3367,3367999,20.35115650537872,36.92632295426033,0.09079596326897688,1179.5379297733307,257.4298360347748,990.3114585876465,12672,3295,9377,9377,0,22,3368000.0
3368,3368999,20.355338835175665,36.93508015851998,0.09075372406499926,1179.7819774150848,257.49728083610535,990.937313079834,12672,3295,9377,9377,0,22,3369000.0
3369,3369999,20.359738047997055,36.94713667822591,0.09072917717987239,1180.1983704566956,257.5641074180603,990.8490409851074,12676,3297,9379,9379,0,22,3370000.0
3370,3370999,20.366761238107067,36.96809743312231,0.09071479856989362,1180.6204152107239,257.63206338882446,990.7314643859863,12678,3298,9380,9380,0,22,3371000.0
3371,3371999,20.376127322428776,36.994848259841326,0.09072565429289736,1180.9826283454895,257.698260307312,990.9056968688965,12680,3299,9381,9381,0,22,3372000.0
3372,3372999,20.38510189144303,37.02056740029891,0.09084159737706587,1181.4275538921356,257.76496720314026,990.7754402160645,12690,3303,9387,9387,0,22,3373000.0
3373,3373999,20.393834283165692,37.041798835636946,0.090955755397507,1181.7258982658386,257.83124685287476,991.3432121276855,12692,3304,9388,9388,0,22,3374000.0
3374,3374999,20.402065177599443,37.05879145002619,0.09112209251758774,1182.0907528400421,257.9002046585083,991.4161109924316,12694,3305,9389,9389,0,22,3375000.0
3375,3375999,20.409534233079324,37.0732889586437,0.09129034245405132,1182.5161607265472,257.9670944213867,991.5366249084473,12694,3305,9389,9389,0,22,3376000.0
3376,3376999,20.412996477913143,37.07952524090185,0.091358386919285,1182.8090014457703,258.03434467315674,992.6440925598145,12723,3307,9416,9416,0,22,3377000.0
3377,3377999,20.412838309147936,37.079885454739696,0.09133893014361594,1183.0816657543182,258.101913690567,993.4209327697754,12728,3308,9420,9420,0,22,3378000.0
3378,3378999,20.412861412122968,37.08101660461593,0.09131487436888797,1183.365267276764,258.16737389564514,993.9372520446777,12734,3309,9425,9425,0,22,3379000.0
3379,3379999,20.414432367017888,37.08587652203634,0.09128541288079906,1183.6690142154694,258.2342007160187,994.4217491149902,12736,3310,9426,9426,0,22,3380000.0
3380,3380999,20.415682204495454,37.09300722414158,0.09124975070861963,1184.0013365745544,258.30120062828064,994.7433967590332,12739,3311,9428,9428,0,22,3381000.0
3381,3381999,20.416133297636545,37.09297782282169,0.09126559062580863,1184.5122895240784,258.36948704719543,994.4131889343262,12757,3314,9443,9443,0,22,3382000.0
3382,3382999,20.417244956714047,37.09448625341118,0.09130230175531184,1184.7961735725403,258.4359712600708,995.0904960632324,12759,3315,9444,9444,0,22,3383000.0
3383,3383999,20.418357624922127,37.095259129496206,0.09131536147688502,1185.0969417095184,258.5035026073456,995.529712677002,12761,3316,9445,9445,0,22,3384000.0
3384,3384999,20.419197737365028,37.09573314867102,0.09133210306816542,1185.3350007534027,258.5717933177948,996.2416038513184,12761,3316,9445,9445,0,22,3385000.0
3385,3385999,20.41946825131413,37.09527106753256,0.09136134971328203,1185.8226222991943,258.6414370536804,995.8162651062012,12765,3318,9447,9447,0,22,3386000.0
3386,3386999,20.420628812127525,37.09586143897879,0.0914022509444341,1186.2525584697723,258.70908761024475,995.7462730407715,12765,3318,9447,9447,0,22,3387000.0
3387,3387999,20.421141142327343,37.094719596381196,0.09143615890964019,1186.5968971252441,258.77791595458984,995.993579864502,12766,3319,9447,9447,0,22,3388000.0
3388,3388999,20.422455592571747,37.09607167135161,0.09145919827160931,1186.9515891075134,258.84640765190125,996.2228584289551,12766,3319,9447,9447,0,22,3389000.0
3389,3389999,20.42367397760922,37.09715996821561,0.0914870137390793,1187.2936890125275,258.9148037433624,996.4543876647949,12766,3319,9447,9447,0,22,3390000.0
3390,3390999,20.42482902582147,37.09717685143976,0.09150407644443281,1187.6199951171875,258.98367261886597,996.6786231994629,12766,3319,9447,9447,0,22,3391000.0
3391,3391999,20.426514347248,37.10064870996536,0.09152415350880061,1187.9777574539185,259.0547311306,996.9413414001465,12766,3319,9447,9447,0,22,3392000.0
3392,3392999,20.42800750044613,37.10131729933303,0.09154430978275718,1188.464770078659,259.1248822212219,996.602725982666,12785,3321,9464,9464,0,22,3393000.0
3393,3393999,20.42933981870148,37.10198224816206,0.09155971096678095,1188.8038334846497,259.19307374954224,996.9245872497559,12785,3321,9464,9464,0,22,3394000.0
3394,3394999,20.4305063880976,37.10165790327443,0.09156876021162097,1189.1543953418732,259.26154947280884,997.029354095459,12785,3321,9464,9464,0,22,3395000.0
3395,3395999,20.43157130049781,37.10061379524992,0.09159740636022096,1189.6723322868347,259.3307545185089,996.4713478088379,12786,3322,9464,9464,0,22,3396000.0
3396,3396999,20.43263003518909,37.10211589643461,0.0915779818195781,1190.0077016353607,259.40567564964294,996.8491096496582,12786,3322,9464,9464,0,22,3397000.0
3397,3397999,20.43251974300169,37.10496792304549,0.09154762416637019,1190.2504811286926,259.47444224357605,997.9077110290527,12800,3323,9477,9477,0,22,3398000.0
3398,3398999,20.430597829973927,37.10466268549538,0.09153494999084644,1190.4886515140533,259.54273223876953,998.9229316711426,12805,3323,9482,9482,0,22,3399000.0
3399,3399999,20.428173227688568,37.101147616958386,0.09154244504403186,1190.779093503952,259.61020135879517,999.6203193664551,12838,3324,9514,9514,0,22,3400000.0
3400,3400999,20.42588720789429,37.09857062138966,0.09154237089722583,1191.1477615833282,259.6787874698639,999.8332939147949,12839,3324,9515,9515,0,22,3401000.0
3401,3401999,20.42365184056067,37.09527933051334,0.0915439050161041,1191.4797141551971,259.7458755970001,1000.2119941711426,12840,3324,9516,9516,0,22,3402000.0
3402,3402999,20.421628676841905,37.093432484456834,0.0915343915006318,1191.9296550750732,259.8152368068695,1000.0796775817871,12844,3326,9518,9518,0,22,3403000.0
3403,3403999,20.419438250239544,37.08987940094572,0.0915359362321081,1192.2795038223267,259.88381481170654,1000.4237174987793,12844,3326,9518,9518,0,22,3404000.0
3404,3404999,20.417318037192373,37.08627904573518,0.09153720090760797,1192.6513171195984,259.9523956775665,1000.394229888916,12847,3328,9519,9519,0,22,3405000.0
3405,3405999,20.41506988378663,37.08233403394363,0.09153907344308454,1193.0030462741852,260.02237200737,1000.652645111084,12850,3330,9520,9520,0,22,3406000.0
3406,3406999,20.41397881129996,37.081207515488785,0.09152431665631333,1193.4140450954437,260.09433794021606,1000.7260856628418,12856,3331,9525,9525,0,22,3407000.0
3407,3407999,20.412983249067963,37.07879865422202,0.09151031256684727,1193.9512305259705,260.1654679775238,1000.1507682800293,12858,3332,9526,9526,0,22,3408000.0
3408,3408999,20.411936973232816,37.07647382246427,0.09149724025142136,1194.2746229171753,260.23561334609985,1000.6015129089355,12858,3332,9526,9526,0,22,3409000.0
3409,3409999,20.411924299082383,37.07738176655548,0.09146499808399,1194.745764017105,260.3065721988678,1000.373836517334,12862,3334,9528,9528,0,22,3410000.0
3410,3410999,20.411279464433424,37.07588614131548,0.09144567391670666,1195.0111992359161,260.3781909942627,1000.9940452575684,12862,3334,9528,9528,0,22,3411000.0
3411,3411999,20.41170077659182,37.075854860520465,0.09142511569588907,1195.4042613506317,260.44964241981506,1001.5337791442871,12878,3335,9543,9543,0,22,3412000.0
3412,3412999,20.412780172948562,37.08137932666349,0.0914105274192566,1195.6164240837097,260.5204303264618,1002.5165901184082,12878,3335,9543,9543,0,22,3413000.0
3413,3413999,20.414916101076,37.08705958760935,0.09139140770823873,1196.0511474609375,260.59324288368225,1002.4071922302246,12878,3335,9543,9543,0,22,3414000.0
3414,3414999,20.418016207075055,37.09799685160667,0.09140236316033012,1196.258388519287,260.6630759239197,1003.3263740539551,12878,3335,9543,9543,0,22,3415000.0
3415,3415999,20.421232172780222,37.1047306913414,0.09144584648854392,1196.711689710617,260.736314535141,1003.194637298584,12899,3338,9561,9561,0,22,3416000.0
3416,3416999,20.424672344663232,37.11333180822418,0.09146282388754257,1197.132496356964,260.80755376815796,1003.1684150695801,12899,3338,9561,9561,0,22,3417000.0
3417,3417999,20.428588996258462,37.121825082865435,0.09144828348091238,1197.4592468738556,260.87973499298096,1003.5627861022949,12900,3338,9562,9562,0,22,3418000.0
3418,3418999,20.43021057857186,37.1244456742989,0.09142924084226378,1197.8108015060425,260.95022463798523,1004.1998558044434,12911,3338,9573,9573,0,22,3419000.0
3419,3419999,20.428573560605102,37.12364353535186,0.09140913930225458,1198.0979046821594,261.01526379585266,1005.1852378845215,12932,3339,9593,9593,0,22,3420000.0
3420,3420999,20.426613490013455,37.12293118892634,0.09139474507328571,1198.3354420661926,261.080543756485,1006.1720237731934,12938,3339,9599,9599,0,22,3421000.0
3421,3421999,20.42516423159431,37.12211054392998,0.09136936471197521,1198.6345767974854,261.1462154388428,1006.9285316467285,12942,3340,9602,9602,0,22,3422000.0
3422,3422999,20.42330206694582,37.11938765538773,0.0913625868281066,1198.9007103443146,261.21648383140564,1007.8987007141113,12948,3340,9608,9608,0,22,3423000.0
3423,3423999,20.421559286085763,37.11654647223449,0.09135178989420656,1199.2019939422607,261.28237891197205,1008.4853324890137,12953,3342,9611,9611,0,22,3424000.0
3424,3424999,20.419775541198856,37.11347044265074,0.09134789133632992,1199.5481235980988,261.3481333255768,1008.8994407653809,12957,3344,9613,9613,0,22,3425000.0
3425,3425999,20.417863136470203,37.11049031191442,0.09134493123442633,1199.8363018035889,261.41562604904175,1009.6102867126465,12961,3346,9615,9615,0,22,3426000.0
3426,3426999,20.416413450863438,37.108847556413025,0.09132757155223992,1200.1239686012268,261.4812979698181,1010.3008232116699,12962,3346,9616,9616,0,22,3427000.0
3427,3427999,20.41504693812373,37.106208513178416,0.0913196551205151,1200.4220173358917,261.5481925010681,1010.7580757141113,12966,3348,9618,9618,0,22,3428000.0
3428,3428999,20.414032829358224,37.108065595405975,0.09129565931589845,1200.7783269882202,261.6166491508484,1011.0731086730957,12970,3350,9620,9620,0,22,3429000.0
3429,3429999,20.41330443340708,37.10668118014541,0.0912832809810602,1201.1135902404785,261.6836140155792,1011.5043830871582,12972,3351,9621,9621,0,22,3430000.0
3430,3430999,20.41244946350417,37.10490594324623,0.09126772446237597,1201.46457695961,261.7523338794708,1011.7046394348145,12974,3352,9622,9622,0,22,3431000.0
3431,3431999,20.412573809946895,37.104804210321966,0.09124875905265428,1201.8018012046814,261.8193669319153,1012.0831031799316,12977,3353,9624,9624,0,22,3432000.0
3432,3432999,20.413647975511502,37.10846179374692,0.09121104897820032,1202.1490972042084,261.8883149623871,1012.3761863708496,12977,3353,9624,9624,0,22,3433000.0
3433,3433999,20.414846176273784,37.11137287005423,0.09118551743833603,1202.5438113212585,261.9548876285553,1012.3836479187012,12979,3354,9625,9625,0,22,3434000.0
3434,3434999,20.416145307334993,37.11272769110174,0.09117201432254651,1202.8767869472504,262.0212278366089,1012.639476776123,12979,3354,9625,9625,0,22,3435000.0
3435,3435999,20.417539082802445,37.11363783602895,0.09116429046909336,1203.2496404647827,262.08810901641846,1012.9318428039551,12979,3354,9625,9625,0,22,3436000.0
3436,3436999,20.419370172050588,37.115472013236534,0.09116208091059519,1203.7761297225952,262.15768551826477,1012.4685020446777,12981,3355,9626,9626,0,22,3437000.0
3437,3437999,20.421274909930226,37.11965792475246,0.09115542491430328,1204.0532586574554,262.22660183906555,1013.2396965026855,12981,3355,9626,9626,0,22,3438000.0
3438,3438999,20.422542050755055,37.11978014299563,0.09117465614207743,1204.223804950714,262.2945351600647,1014.2184028625488,12981,3355,9626,9626,0,22,3439000.0
3439,3439999,20.42280996325758,37.118444420851745,0.09116963450569182,1204.7076888084412,262.36274933815,1013.9141426086426,12985,3357,9628,9628,0,22,3440000.0
3440,3440999,20.4210294226497,37.115663036891256,0.0911668532680312,1204.998836517334,262.4302477836609,1014.8276557922363,12998,3358,9640,9640,0,22,3441000.0
3441,3441999,20.418636301746794,37.112063876738155,0.0911772775413936,1205.3091337680817,262.4968526363373,1015.4892234802246,13004,3358,9646,9646,0,22,3442000.0
3442,3442999,20.416311690096837,37.108520784302655,0.09118748508396046,1205.671707391739,262.5646116733551,1015.8561668395996,13021,3359,9662,9662,0,22,3443000.0
3443,3443999,20.414045056970235,37.10503226828735,0.09119231280152162,1206.081820011139,262.63402915000916,1015.9905204772949,13026,3360,9666,9666,0,22,3444000.0
3444,3444999,20.4119588177383,37.10248721120869,0.09119158883655454,1206.4171166419983,262.70092487335205,1016.4033164978027,13026,3360,9666,9666,0,22,3445000.0
3445,3445999,20.410075394466002,37.10068357562434,0.0911842407736475,1206.8494279384613,262.76892614364624,1016.5252799987793,13030,3362,9668,9668,0,22,3446000.0
3446,3446999,20.40802764291905,37.09766469914229,0.0911856823339442,1207.2315680980682,262.83583211898804,1016.5797080993652,13031,3363,9668,9668,0,22,3447000.0
3447,3447999,20.406130072638444,37.09700453695209,0.0911745379517882,1207.5820841789246,262.90535497665405,1016.8967323303223,13034,3365,9669,9669,0,22,3448000.0
3448,3448999,20.40469722331645,37.098893000577434,0.09114897241021369,1207.9814920425415,262.9736933708191,1017.0523490905762,13036,3366,9670,9670,0,22,3449000.0
3449,3449999,20.40328083504749,37.09773395491384,0.09113434127300835,1208.4249608516693,263.0425269603729,1016.9424324035645,13040,3368,9672,9672,0,22,3450000.0
3450,3450999,20.40225183943185,37.10108642568064,0.0910985190001753,1208.7497301101685,263.1115550994873,1017.4517631530762,13057,3369,9688,9688,0,22,3451000.0
3451,3451999,20.40107443038778,37.09864936746416,0.09108905426423897,1209.2651357650757,263.18179392814636,1017.1045036315918,13057,3369,9688,9688,0,22,3452000.0
3452,3452999,20.39995707854453,37.09651729954098,0.0910807936989021,1209.6288828849792,263.2518231868744,1017.5424003601074,13073,3370,9703,9703,0,22,3453000.0
3453,3453999,20.399118573449822,37.09440964931954,0.09107315456884779,1209.8822438716888,263.32090044021606,1018.5555458068848,13073,3370,9703,9703,0,22,3454000.0
3454,3454999,20.397925736425783,37.09155881645159,0.09107326632011781,1210.1297488212585,263.38952136039734,1019.2975578308105,13073,3370,9703,9703,0,22,3455000.0
3455,3455999,20.396659562903558,37.08842697788605,0.09107463860808018,1210.4906363487244,263.46535086631775,1019.6827583312988,13073,3370,9703,9703,0,22,3456000.0
3456,3456999,20.395453972941908,37.085735627936714,0.09107353907152538,1210.7912395000458,263.53590273857117,1020.1125221252441,13073,3370,9703,9703,0,22,3457000.0
3457,3457999,20.39447640575226,37.08280792671322,0.09107226994847606,1211.1897616386414,263.604941368103,1020.1045951843262,13076,3371,9705,9705,0,22,3458000.0
3458,3458999,20.393180042137697,37.08001317663148,0.09106552457819561,1211.57666182518,263.67554473876953,1020.4760246276855,13084,3371,9713,9713,0,22,3459000.0
3459,3459999,20.390923376940997,37.07753479586689,0.09107553517780764,1211.8257231712341,263.7420129776001,1021.6706428527832,13095,3373,9722,9722,0,22,3460000.0
3460,3460999,20.388992567793732,37.07827684426675,0.09106727472598275,1212.0697982311249,263.8088674545288,1022.6144065856934,13099,3373,9726,9726,0,22,3461000.0
3461,3461999,20.38670042330436,37.07523171498173,0.09108422158345986,1212.3790736198425,263.87569189071655,1023.298770904541,13113,3374,9739,9739,0,22,3462000.0
3462,3462999,20.384311028695354,37.07154289487964,0.09109679954525485,1212.6057453155518,263.94230484962463,1024.19234085083,13114,3374,9740,9740,0,22,3463000.0
3463,3463999,20.382481384299744,37.07049697229678,0.09109263443272997,1212.939198732376,264.0096275806427,1024.5072059631348,13118,3376,9742,9742,0,22,3464000.0
3464,3464999,20.380320442348076,37.067884813977635,0.09109289000842236,1213.2557101249695,264.07719111442566,1024.931354522705,13121,3377,9744,9744,0,22,3465000.0
3465,3465999,20.37832811804937,37.06536024163037,0.09109027236389311,1213.5363767147064,264.14823269844055,1025.5065574645996,13122,3377,9745,9745,0,22,3466000.0
3466,3466999,20.376621021441064,37.062849413515266,0.09108248451774192,1213.9317891597748,264.2144305706024,1025.5254249572754,13128,3380,9748,9748,0,22,3467000.0
3467,3467999,20.375188057539905,37.060298189440125,0.09107480596639872,1214.2063689231873,264.28178787231445,1026.0855751037598,13128,3380,9748,9748,0,22,3468000.0
3468,3468999,20.373641037990854,37.05776713872702,0.09106624967730947,1214.4493024349213,264.34882164001465,1026.714511871338,13128,3380,9748,9748,0,22,3469000.0
3469,3469999,20.372841299004065,37.060202357724364,0.09103205490368893,1214.7672607898712,264.4176321029663,1026.9969596862793,13130,3381,9749,9749,0,22,3470000.0
3470,3470999,20.372224568218627,37.06019812176543,0.09100506173050216,1215.1583888530731,264.48540449142456,1026.913990020752,13134,3383,9751,9751,0,22,3471000.0
3471,3471999,20.371550243675664,37.05888002573233,0.0909807246626263,1215.5346503257751,264.5521273612976,1026.9001197814941,13134,3383,9751,9751,0,22,3472000.0
3472,3472999,20.37105315474472,37.05706249995192,0.09096086731948683,1215.9550943374634,264.61959958076477,1026.7692070007324,13136,3384,9752,9752,0,22,3473000.0
3473,3473999,20.37047294452363,37.05561324716167,0.0909398634352041,1216.416383266449,264.6869592666626,1026.5440788269043,13140,3386,9754,9754,0,22,3474000.0
3474,3474999,20.37036827500051,37.05483983681685,0.09091419556789415,1216.79265999794,264.7539827823639,1026.6486930847168,13155,3387,9768,9768,0,22,3475000.0
3475,3475999,20.37062197100131,37.05471474708023,0.0908912104663947,1217.0359213352203,264.8223834037781,1027.5762901306152,13156,3387,9769,9769,0,22,3476000.0
3476,3476999,20.370686989584552,37.053710166474914,0.09087181425887525,1217.3320367336273,264.89455556869507,1028.2000617980957,13156,3387,9769,9769,0,22,3477000.0
3477,3477999,20.370848965758736,37.052848317731076,0.090849005732764,1217.6557347774506,264.96161937713623,1028.5519676208496,13157,3387,9770,9770,0,22,3478000.0
3478,3478999,20.3703899724215,37.05086978844439,0.0908342279698039,1218.013964176178,265.03062987327576,1028.996410369873,13172,3388,9784,9784,0,22,3479000.0
3479,3479999,20.36892410405358,37.0483123988548,0.09082539969349135,1218.3639419078827,265.1004593372345,1029.7951622009277,13186,3389,9797,9797,0,22,3480000.0
3480,3480999,20.36635229206398,37.04459104537149,0.0908316128306188,1218.7058897018433,265.16745233535767,1030.3747596740723,13195,3390,9805,9805,0,22,3481000.0
3481,3481999,20.364304169052375,37.04171862280797,0.09082642570198796,1219.0079817771912,265.2334690093994,1030.9012565612793,13199,3391,9808,9808,0,22,3482000.0
3482,3482999,20.36295592525918,37.04005686398874,0.09081291663827251,1219.3694310188293,265.2992784976959,1031.1810188293457,13201,3392,9809,9809,0,22,3483000.0
3483,3483999,20.361252799372075,37.039241206284075,0.0907936366949591,1219.6797370910645,265.36644077301025,1031.6324577331543,13203,3392,9811,9811,0,22,3484000.0
3484,3484999,20.360045086346826,37.03828182106791,0.09077445033025588,1220.215175628662,265.4331228733063,1031.222942352295,13207,3394,9813,9813,0,22,3485000.0
3485,3485999,20.359189851981267,37.03634363911541,0.09075695732626388,1220.5309307575226,265.50082445144653,1031.6729545593262,13207,3394,9813,9813,0,22,3486000.0
3486,3486999,20.35949694663532,37.036943112456726,0.09072378562364902,1220.9344019889832,265.5696630477905,1031.5671730041504,13211,3397,9814,9814,0,22,3487000.0
3487,3487999,20.3607121940335,37.03809791136673,0.09070235926037262,1221.293675661087,265.63759088516235,1031.9085807800293,13213,3398,9815,9815,0,22,3488000.0
3488,3488999,20.362955989190713,37.04197327480673,0.09067800513528035,1221.6155037879944,265.7052729129791,1032.273349761963,13215,3399,9816,9816,0,22,3489000.0
3489,3489999,20.36613036352067,37.048921438598654,0.09065425001998006,1222.16689991951,265.7745044231415,1031.7684593200684,13223,3401,9822,9822,0,22,3490000.0
3490,3490999,20.369781893431753,37.05604861062472,0.09064635329548598,1222.5624754428864,265.844530582428,1031.9139289855957,13223,3401,9822,9822,0,22,3491000.0
3491,3491999,20.374671848180647,37.06484010347587,0.09067463876810411,1222.9257805347443,265.9144518375397,1032.1650428771973,13225,3402,9823,9823,0,22,3492000.0
3492,3492999,20.380267132829367,37.07395219638877,0.09073628330371297,1223.1971983909607,265.9830250740051,1032.8587837219238,13225,3402,9823,9823,0,22,3493000.0
3493,3493999,20.386093314503775,37.08186204090146,0.09082756300812711,1223.5873034000397,266.05391335487366,1032.8571434020996,13226,3403,9823,9823,0,22,3494000.0
3494,3494999,20.393157393957527,37.09359488437214,0.09102146530122923,1224.0526831150055,266.12539625167847,1032.6822547912598,13230,3405,9825,9825,0,22,3495000.0
3495,3495999,20.400616677541727,37.106222756912764,0.09125229028070114,1224.4283392429352,266.1955268383026,1032.9028663635254,13232,3406,9826,9826,0,22,3496000.0
3496,3496999,20.407191175918374,37.116907084099736,0.09149229247563662,1224.8871755599976,266.26648449897766,1032.7597312927246,13234,3407,9827,9827,0,22,3497000.0
3497,3497999,20.41305741301953,37.1262566517034,0.09163015346453185,1225.2623410224915,266.33835673332214,1032.9518241882324,13235,3408,9827,9827,0,22,3498000.0
3498,3498999,20.42020500298827,37.13632846959958,0.09178654963314536,1225.6133949756622,266.40887904167175,1033.2075157165527,13235,3408,9827,9827,0,22,3499000.0
3499,3499999,20.42643696560604,37.14598105756346,0.09188784545190232,1226.020878314972,266.486652135849,1033.4314079284668,13239,3409,9830,9830,0,22,3500000.0
3500,3500999,20.425470476073947,37.144653689417545,0.09185001420005523,1226.217422246933,266.5535671710968,1035.3466606140137,13266,3409,9857,9857,0,22,3501000.0
3501,3501999,20.42386763360836,37.1429353318846,0.09184252198604481,1226.366369009018,266.61794543266296,1036.6685218811035,13269,3409,9860,9860,0,22,3502000.0
3502,3502999,20.42306907656978,37.142225112498664,0.0918331766687912,1226.7227871418,266.6828062534332,1036.978588104248,13272,3410,9862,9862,0,22,3503000.0
3503,3503999,20.422306572336183,37.141166894217776,0.09182108555917678,1227.0199978351593,266.7485864162445,1037.4705924987793,13276,3412,9864,9864,0,22,3504000.0
3504,3504999,20.421130493172864,37.139634686229925,0.09180917782431874,1227.4308140277863,266.8152129650116,1037.4610404968262,13303,3417,9886,9886,0,22,3505000.0
3505,3505999,20.420291633944647,37.137831824897084,0.09179929844586254,1227.8482427597046,266.8814582824707,1037.7585105895996,13307,3419,9888,9888,0,22,3506000.0
3506,3506999,20.4197757403934,37.13937281628395,0.09176361747945683,1228.2205080986023,266.9487030506134,1038.0593605041504,13313,3422,9891,9891,0,22,3507000.0
3507,3507999,20.419353458767635,37.139155858634844,0.09175236481375237,1228.5370235443115,267.014536857605,1038.5096168518066,13315,3423,9892,9892,0,22,3508000.0
3508,3508999,20.418907801503334,37.13843339033134,0.09174487322044522,1228.883552312851,267.0809621810913,1038.8861961364746,13317,3424,9893,9893,0,22,3509000.0
3509,3509999,20.420959007673208,37.146117741477234,0.09172100079824386,1229.1495270729065,267.14746356010437,1039.6397514343262,13323,3425,9898,9898,0,22,3510000.0
3510,3510999,20.42459238481749,37.15814584051196,0.09169205383688406,1229.558022260666,267.2144865989685,1039.633632659912,13325,3426,9899,9899,0,22,3511000.0
3511,3511999,20.430572643928045,37.17847511058247,0.0917286288428919,1229.8840272426605,267.2819986343384,1039.9541130065918,13327,3427,9900,9900,0,22,3512000.0
3512,3512999,20.435586318088127,37.19127549899667,0.09177912814945743,1230.2226736545563,267.3483831882477,1040.2634925842285,13327,3427,9900,9900,0,22,3513000.0
3513,3513999,20.44134673855738,37.2070984172836,0.09184393800757074,1230.7808709144592,267.4163398742676,1039.5843696594238,13329,3428,9901,9901,0,22,3514000.0
3514,3514999,20.446935800036776,37.227003067263794,0.091878225877295,1231.0849776268005,267.48247933387756,1040.0002250671387,13331,3429,9902,9902,0,22,3515000.0
3515,3515999,20.45175679842897,37.236723268356975,0.09193031812124597,1231.460690021515,267.5506548881531,1040.1803550720215,13333,3430,9903,9903,0,22,3516000.0
3516,3516999,20.45721939473326,37.248443570532054,0.09199914250990904,1231.802973985672,267.6187207698822,1040.521816253662,13335,3431,9904,9904,0,22,3517000.0
3517,3517999,20.46240832951559,37.25905960665972,0.09205806263116101,1232.2313742637634,267.6876595020294,1040.5184059143066,13337,3432,9905,9905,0,22,3518000.0
3518,3518999,20.46696348945324,37.266198757568475,0.0921221233958126,1232.6061086654663,267.75788855552673,1040.7845497131348,13358,3434,9924,9924,0,22,3519000.0
3519,3519999,20.470147475728375,37.27007664703256,0.09214809660562462,1233.1400310993195,267.8277726173401,1040.576847076416,13358,3434,9924,9924,0,22,3520000.0
3520,3520999,20.469864110750724,37.26952293797705,0.09213444434907114,1233.4625754356384,267.8966794013977,1041.4560203552246,13374,3436,9938,9938,0,22,3521000.0
3521,3521999,20.468678602377423,37.2686730159148,0.09212549962381611,1233.7552168369293,267.96455693244934,1042.25638961792,13380,3437,9943,9943,0,22,3522000.0
3522,3522999,20.467944208977737,37.26917614438319,0.09210040063476865,1234.0562155246735,268.0305685997009,1042.7193717956543,13384,3438,9946,9946,0,22,3523000.0
3523,3523999,20.46781524802299,37.271990987680574,0.0920795558625952,1234.3443896770477,268.09824895858765,1043.2684898376465,13386,3439,9947,9947,0,22,3524000.0
3524,3524999,20.46720065750524,37.27067287384753,0.09206228423617435,1234.6873309612274,268.1657991409302,1043.4584007263184,13390,3440,9950,9950,0,22,3525000.0
3525,3525999,20.466718114636187,37.269945815881336,0.09205977247824404,1235.3722727298737,268.24074149131775,1042.4315605163574,13396,3443,9953,9953,0,22,3526000.0
3526,3526999,20.465857624333143,37.26791221308475,0.09205572766543002,1235.6676812171936,268.30916380882263,1042.9523277282715,13396,3443,9953,9953,0,22,3527000.0
3527,3527999,20.46538448249549,37.26676084750635,0.09205485817111947,1235.954481124878,268.37799882888794,1043.4810676574707,13396,3443,9953,9953,0,22,3528000.0
3528,3528999,20.465852914204575,37.26874390375489,0.092042466235698,1236.3244948387146,268.44706559181213,1043.6570777893066,13405,3445,9960,9960,0,22,3529000.0
3529,3529999,20.46849690423375,37.27823747096192,0.09200634083608106,1236.7590248584747,268.51655197143555,1043.537052154541,13406,3446,9960,9960,0,22,3530000.0
3530,3530999,20.47194788267914,37.286352333585526,0.0920154644718536,1237.175954580307,268.5866103172302,1043.5862007141113,13408,3447,9961,9961,0,22,3531000.0
3531,3531999,20.477577854456424,37.302632059877794,0.0920222174899481,1237.5632688999176,268.6555335521698,1043.7905616760254,13408,3447,9961,9961,0,22,3532000.0
3532,3532999,20.484681426635472,37.320804196194395,0.0920456461183422,1237.9230179786682,268.7260811328888,1044.0656471252441,13408,3447,9961,9961,0,22,3533000.0
3533,3533999,20.49286948175608,37.344715821125455,0.09211862224860501,1238.269991159439,268.79600048065186,1044.3235130310059,13408,3447,9961,9961,0,22,3534000.0
3534,3534999,20.502687963593186,37.37493491065452,0.09228989526340758,1238.6396305561066,268.8665874004364,1044.4893074035645,13409,3448,9961,9961,0,22,3535000.0
3535,3535999,20.514897286113907,37.414517183151084,0.0924909845446229,1239.0988824367523,268.93605041503906,1044.3748817443848,13409,3448,9961,9961,0,22,3536000.0
3536,3536999,20.527100189926287,37.45079204754394,0.09269854435765668,1239.609468460083,269.0049018859863,1044.0881004333496,13411,3449,9962,9962,0,22,3537000.0
3537,3537999,20.539682495497164,37.48300418620955,0.09299605647650666,1239.8264791965485,269.075252532959,1044.9131813049316,13411,3449,9962,9962,0,22,3538000.0
3538,3538999,20.552912466636997,37.51544125223703,0.09334765698946867,1240.2291550636292,269.1441957950592,1045.05912399292,13413,3450,9963,9963,0,22,3539000.0
3539,3539999,20.560229326889477,37.527902695622494,0.0934540699248968,1240.4924385547638,269.21431016921997,1045.958194732666,13424,3450,9974,9974,0,22,3540000.0
3540,3540999,20.559610561774516,37.52776596719923,0.09342834104500941,1240.7398962974548,269.282776594162,1047.0726509094238,13434,3451,9983,9983,0,22,3541000.0
3541,3541999,20.55949303746926,37.53153060167161,0.09340027249349492,1241.010251045227,269.3515131473541,1047.8150825500488,13435,3451,9984,9984,0,22,3542000.0
3542,3542999,20.560119575395397,37.53443735121248,0.09336604004158733,1241.3092303276062,269.4204330444336,1048.3048973083496,13436,3451,9985,9985,0,22,3543000.0
3543,3543999,20.56078175228677,37.536518231447126,0.09333354060734433,1241.689148426056,269.48977875709534,1048.4497871398926,13441,3452,9989,9989,0,22,3544000.0
3544,3544999,20.561724655553405,37.53956958023698,0.0933066130534318,1242.069014787674,269.557480096817,1048.5837898254395,13443,3453,9990,9990,0,22,3545000.0
3545,3545999,20.56191252884745,37.538751670978804,0.0932936342601649,1242.5351901054382,269.62610936164856,1048.4453392028809,13447,3455,9992,9992,0,22,3546000.0
3546,3546999,20.562561380333957,37.54018386258992,0.09328375324789395,1242.837780714035,269.6941578388214,1049.0213661193848,13447,3455,9992,9992,0,22,3547000.0
3547,3547999,20.563453635861872,37.54156425935847,0.09325884774861137,1243.1523699760437,269.7631139755249,1049.4284400939941,13447,3455,9992,9992,0,22,3548000.0
3548,3548999,20.56541056639168,37.544807538449945,0.09325314591521072,1243.6304004192352,269.8326425552368,1048.9948997497559,13453,3459,9994,9994,0,22,3549000.0
3549,3549999,20.56780123482156,37.54750772413868,0.09326479422281708,1244.037918329239,269.9027154445648,1049.0719108581543,13455,3460,9995,9995,0,22,3550000.0
3550,3550999,20.570819817867065,37.55486681970498,0.09327015699674213,1244.4379765987396,269.974262714386,1049.1987571716309,13455,3460,9995,9995,0,22,3551000.0
3551,3551999,20.575116456057614,37.563513167368846,0.09331521150241551,1250.0550446510315,270.0459394454956,1048.9347343444824,13455,3460,9995,9995,0,22,3552000.0
3552,3552999,20.579824005739404,37.571685417097,0.09336412043643105,1250.4250853061676,270.1153905391693,1049.0301322937012,13470,3461,10009,10009,0,22,3553000.0
3553,3553999,20.58424280650415,37.58018162551212,0.09348633465836798,1250.6287775039673,270.1852114200592,1050.299991607666,13470,3461,10009,10009,0,22,3554000.0
3554,3554999,20.589648834010397,37.59550860311314,0.09361176125822224,1250.9362962245941,270.2563741207123,1050.8233222961426,13470,3461,10009,10009,0,22,3555000.0
3555,3555999,20.597041139836556,37.611560157538015,0.09378102518629994,1251.454294681549,270.3286373615265,1050.5676765441895,13490,3462,10028,10028,0,22,3556000.0
3556,3556999,20.60401385650993,37.63010461809894,0.0939536318944334,1251.7036921977997,270.39904284477234,1051.2793312072754,13490,3462,10028,10028,0,22,3557000.0
3557,3557999,20.610108101139986,37.64313763446284,0.0941286843069239,1252.060122013092,270.47031474113464,1051.5083808898926,13490,3462,10028,10028,0,22,3558000.0
3558,3558999,20.619355809226793,37.66613291709711,0.0944325011743492,1252.4668653011322,270.5425646305084,1051.5350608825684,13493,3463,10030,10030,0,22,3559000.0
3559,3559999,20.626276655796456,37.67846506643356,0.09464683518098238,1252.901419878006,270.61424446105957,1051.6633338928223,13511,3464,10047,10047,0,22,3560000.0
3560,3560999,20.62623308667794,37.67939961505256,0.09461072990951147,1253.3214468955994,270.68064045906067,1052.13472366333,13534,3466,10068,10068,0,22,3561000.0
3561,3561999,20.625278163168122,37.68043577178034,0.09455887310011124,1253.6104700565338,270.7479646205902,1053.0283470153809,13548,3466,10082,10082,0,22,3562000.0
3562,3562999,20.62475214553482,37.680856864963424,0.094529211451991,1253.836371421814,270.8131561279297,1054.033275604248,13551,3466,10085,10085,0,22,3563000.0
3563,3563999,20.624871912424414,37.68811349870669,0.09447266158555512,1254.076227426529,270.87924671173096,1054.9798469543457,13556,3466,10090,10090,0,22,3564000.0
3564,3564999,20.624149368643547,37.6868041008047,0.09445084505579726,1254.376038312912,270.94622683525085,1055.6880989074707,13559,3467,10092,10092,0,22,3565000.0
3565,3565999,20.623826868283764,37.68561159020357,0.0944271690681594,1254.716280221939,271.0153777599335,1056.1611518859863,13566,3470,10096,10096,0,22,3566000.0
3566,3566999,20.622947743464895,37.6852872054208,0.09440047705227905,1255.0144464969635,271.0820035934448,1056.876636505127,13570,3472,10098,10098,0,22,3567000.0
3567,3567999,20.62264604707729,37.68374913524884,0.09437156889921028,1255.250188589096,271.1481201648712,1057.7625541687012,13571,3472,10099,10099,0,22,3568000.0
3568,3568999,20.622179122650508,37.682161464473516,0.09434748827352957,1255.5399572849274,271.21566700935364,1058.2860221862793,13573,3473,10100,10100,0,22,3569000.0
3569,3569999,20.622696441756524,37.68450144881168,0.09431562773375035,1256.0100502967834,271.2843906879425,1058.0707893371582,13579,3476,10103,10103,0,22,3570000.0
3570,3570999,20.622927303976105,37.683617314428886,0.09430284714095905,1256.375232219696,271.350704908371,1058.2701454162598,13583,3478,10105,10105,0,22,3571000.0
3571,3571999,20.623124638592788,37.68276693403665,0.09429207111798854,1256.8065812587738,271.4186818599701,1058.3577308654785,13603,3479,10124,10124,0,22,3572000.0
3572,3572999,20.624621326295653,37.68663477001628,0.09427616199260958,1257.1707427501678,271.48689818382263,1058.634708404541,13608,3481,10127,10127,0,22,3573000.0
3573,3573999,20.626665119877554,37.691549722766375,0.09427899369846982,1257.5157282352448,271.5542469024658,1058.970058441162,13610,3482,10128,10128,0,22,3574000.0
3574,3574999,20.62884475377745,37.6946509472405,0.09430164712455713,1257.873271226883,271.62161207199097,1059.2266731262207,13610,3482,10128,10128,0,22,3575000.0
3575,3575999,20.631356388437958,37.69645896028874,0.09435510564514593,1258.176828622818,271.68837428092957,1059.6503257751465,13610,3482,10128,10128,0,22,3576000.0
3576,3576999,20.63480557634149,37.70433360576011,0.0943882728290264,1258.6559734344482,271.75685596466064,1059.3330879211426,13612,3483,10129,10129,0,22,3577000.0
3577,3577999,20.638351955665282,37.709023497191446,0.09447833880535872,1259.1525874137878,271.82684874534607,1059.1947975158691,13614,3484,10130,10130,0,22,3578000.0
3578,3578999,20.641123540669057,37.71196527788733,0.09453231738326051,1259.4716079235077,271.893750667572,1059.6794319152832,13616,3485,10131,10131,0,22,3579000.0
3579,3579999,20.644984521540557,37.71667319683286,0.09462699100986904,1259.7761886119843,271.9625747203827,1060.1059379577637,13618,3486,10132,10132,0,22,3580000.0
3580,3580999,20.64743866713849,37.7218355514178,0.0946640515113546,1260.129133939743,272.0308382511139,1060.6191291809082,13618,3486,10132,10132,0,22,3581000.0
3581,3581999,20.646583347638597,37.71966835738174,0.09465098403228689,1260.3810150623322,272.0990719795227,1061.8682136535645,13648,3488,10160,10160,0,22,3582000.0
3582,3582999,20.644766874056348,37.71711699140874,0.09464604413192601,1260.7556703090668,272.1658124923706,1062.2936210632324,13656,3488,10168,10168,0,22,3583000.0
3583,3583999,20.643247254146825,37.71536575549005,0.0946368507557327,1261.022293329239,272.2334408760071,1062.9775276184082,13659,3489,10170,10170,0,22,3584000.0
3584,3584999,20.641767090722873,37.712631853185314,0.09463064050576953,1261.3267166614532,272.3003067970276,1063.5007514953613,13663,3490,10173,10173,0,22,3585000.0
3585,3585999,20.64059796448969,37.712092663931934,0.09460962716294197,1261.6344747543335,272.36706280708313,1063.925624847412,13665,3491,10174,10174,0,22,3586000.0
3586,3586999,20.63970194532091,37.71040823013409,0.09459775192286868,1262.084275007248,272.43775177001953,1064.188274383545,13679,3492,10187,10187,0,22,3587000.0
3587,3587999,20.638444925386306,37.70819163247439,0.09459015572538243,1262.3405621051788,272.5062689781189,1065.154598236084,13682,3493,10189,10189,0,22,3588000.0
3588,3588999,20.6378374829181,37.70776275560369,0.09457244647567442,1262.6237607002258,272.5743143558502,1065.837215423584,13683,3493,10190,10190,0,22,3589000.0
3589,3589999,20.63742206118865,37.70624273081075,0.09455879261802547,1262.8768420219421,272.6440405845642,1066.558162689209,13683,3493,10190,10190,0,22,3590000.0
3590,3590999,20.637627984467343,37.7098765858778,0.09453030650167404,1263.1628983020782,272.71351861953735,1066.991054534912,13687,3495,10192,10192,0,22,3591000.0
3591,3591999,20.6384407384999,37.71040399054857,0.09451640246937754,1263.5374748706818,272.783273935318,1067.1218452453613,13689,3496,10193,10193,0,22,3592000.0
3592,3592999,20.63931866942656,37.7107206133503,0.09451593807833703,1263.8840475082397,272.85257148742676,1067.5130729675293,13691,3497,10194,10194,0,22,3593000.0
3593,3593999,20.640849040804927,37.71169690360819,0.09452872312768357,1264.3393688201904,272.9227113723755,1067.350788116455,13691,3497,10194,10194,0,22,3594000.0
3594,3594999,20.641854386888458,37.71463691423914,0.09452370278551947,1264.5965394973755,272.9914450645447,1067.920612335205,13693,3498,10195,10195,0,22,3595000.0
3595,3595999,20.643809491787234,37.721353312314314,0.09453391076386186,1264.9747202396393,273.06114768981934,1068.0245475769043,13693,3498,10195,10195,0,22,3596000.0
3596,3596999,20.645402569574955,37.724857764587625,0.09455957662403824,1265.4611110687256,273.1309702396393,1067.8522605895996,13695,3499,10196,10196,0,22,3597000.0
3597,3597999,20.646502603460096,37.72563960137448,0.09457547963350332,1265.9029626846313,273.199604511261,1067.8011894226074,13697,3500,10197,10197,0,22,3598000.0
3598,3598999,20.647854869503483,37.72691007373097,0.09460048967695045,1266.1606345176697,273.26885199546814,1068.527500152588,13698,3500,10198,10198,0,22,3599000.0
3599,3599999,20.650552762837762,37.730167301956286,0.09460485525081253,1266.509439945221,273.33721828460693,1068.945369720459,13699,3500,10199,10199,0,22,3600000.0
3600,3600999,20.650145663789953,37.72870250937483,0.09458635423253925,1266.8567237854004,273.4050967693329,1069.48482131958,13703,3501,10202,10202,0,22,3601000.0
3601,3601999,20.648935200298162,37.72766936985339,0.09456925352973256,1267.2257044315338,273.4743149280548,1069.7398948669434,13710,3504,10206,10206,0,22,3602000.0
3602,3602999,20.647853301632715,37.72504403179519,0.0945587087072467,1267.6250305175781,273.54403853416443,1069.868251800537,13715,3506,10209,10209,0,22,3603000.0
3603,3603999,20.646576297830794,37.72326916151241,0.09454762791649196,1268.0616223812103,273.61363887786865,1069.7920036315918,13719,3507,10212,10212,0,22,3604000.0
3604,3604999,20.64567002554558,37.721530543475836,0.09453655509267367,1268.3438427448273,273.68151569366455,1070.4011573791504,13720,3507,10213,10213,0,22,3605000.0
3605,3605999,20.64485367561218,37.7204171707587,0.09451838671398183,1268.6568052768707,273.74907207489014,1070.8281135559082,13720,3507,10213,10213,0,22,3606000.0
3606,3606999,20.644051247871932,37.72013151639502,0.09449968897937511,1268.9413323402405,273.81648111343384,1071.2488059997559,13722,3507,10215,10215,0,22,3607000.0
3607,3607999,20.64394978644873,37.7201675651536,0.09448059778348039,1269.404007434845,273.8867325782776,1071.0135917663574,13724,3508,10216,10216,0,22,3608000.0
3608,3608999,20.64461721396827,37.72125169793997,0.09445881076155616,1269.7305753231049,273.9554147720337,1071.3828468322754,13724,3508,10216,10216,0,22,3609000.0
3609,3609999,20.645637955612063,37.72376035972288,0.09444198760166966,1270.1306564807892,274.02338004112244,1071.406650543213,13728,3510,10218,10218,0,22,3610000.0
3610,3610999,20.64791985210698,37.72861880632066,0.09442317598040295,1270.597678899765,274.0926823616028,1071.0513038635254,13735,3512,10223,10223,0,22,3611000.0
3611,3611999,20.650997508864275,37.73909613802156,0.09440341706114452,1271.1584854125977,274.16331601142883,1070.4006462097168,13739,3514,10225,10225,0,22,3612000.0
3612,3612999,20.654899856797595,37.74896449387537,0.09442122248912654,1271.5054306983948,274.23193883895874,1070.6668968200684,13740,3514,10226,10226,0,22,3613000.0
3613,3613999,20.658323929682325,37.75873750272461,0.09440912068896812,1271.878201007843,274.3019919395447,1070.8303413391113,13742,3514,10228,10228,0,22,3614000.0
3614,3614999,20.663422396428505,37.77806478483867,0.09441960909670033,1272.135660648346,274.37294816970825,1071.4326515197754,13742,3514,10228,10228,0,22,3615000.0
3615,3615999,20.668423947351528,37.78921585164543,0.09445596927582134,1272.6634018421173,274.44504737854004,1070.8818626403809,13748,3517,10231,10231,0,22,3616000.0
3616,3616999,20.673392742515585,37.80245702819908,0.09448503398687413,1272.9792771339417,274.51446080207825,1071.2886085510254,13750,3518,10232,10232,0,22,3617000.0
3617,3617999,20.677945156081332,37.812225643270445,0.09447983903970425,1273.4374494552612,274.5866858959198,1070.9548301696777,13753,3520,10233,10233,0,22,3618000.0
3618,3618999,20.68187162876985,37.81757587004177,0.09450587433561786,1273.8467855453491,274.6571023464203,1070.879566192627,13779,3523,10256,10256,0,22,3619000.0
3619,3619999,20.685783483262576,37.82412928945667,0.09454877291951691,1274.2109410762787,274.7263824939728,1071.2127723693848,13779,3523,10256,10256,0,22,3620000.0
3620,3620999,20.685164007731416,37.822550669497105,0.09452521847080253,1274.664288520813,274.7943458557129,1071.2862281799316,13781,3524,10257,10257,0,22,3621000.0
3621,3621999,20.68464683271969,37.82232765448998,0.09448537192615936,1274.9233965873718,274.8635199069977,1072.0147590637207,13782,3524,10258,10258,0,22,3622000.0
3622,3622999,20.684110873250905,37.822388678654164,0.09446367397636524,1275.2521722316742,274.9315273761749,1072.9114112854004,13843,3525,10318,10318,0,22,3623000.0
3623,3623999,20.683704807194047,37.821496240111,0.09444050256122083,1275.7371563911438,274.9992923736572,1072.7460746765137,13847,3527,10320,10320,0,22,3624000.0
3624,3624999,20.68298991697355,37.819853453082224,0.09442155510070815,1276.064380645752,275.06752157211304,1073.3019523620605,13849,3528,10321,10321,0,22,3625000.0
3625,3625999,20.682343277643806,37.81847191585155,0.09440722109244393,1276.4610452651978,275.137966632843,1073.4767799377441,13851,3529,10322,10322,0,22,3626000.0
3626,3626999,20.68187034412892,37.81731060714052,0.09438558865343438,1276.913031578064,275.2081570625305,1073.439785003662,13853,3530,10323,10323,0,22,3627000.0
3627,3627999,20.681660138838918,37.81697136829811,0.09436756469130392,1277.3048872947693,275.2779302597046,1073.483959197998,13861,3534,10327,10327,0,22,3628000.0
3628,3628999,20.682516535715482,37.819488768029444,0.0943409456022124,1277.7308826446533,275.34874057769775,1073.6108360290527,13865,3536,10329,10329,0,22,3629000.0
3629,3629999,20.683504359293508,37.825374844702154,0.09430485865208715,1277.973087310791,275.4198246002197,1074.5215950012207,13865,3536,10329,10329,0,22,3630000.0
3630,3630999,20.6847706730601,37.828183753916456,0.09429787617680296,1278.2933485507965,275.4887008666992,1074.9184303283691,13865,3536,10329,10329,0,22,3631000.0
3631,3631999,20.68645371564293,37.830899877114426,0.094293846428393,1278.7039468288422,275.55945348739624,1075.0381927490234,13879,3537,10342,10342,0,22,3632000.0
3632,3632999,20.687957061998336,37.83298686080016,0.09428395577211168,1279.106137752533,275.6303594112396,1075.1911926269531,13879,3537,10342,10342,0,22,3633000.0
3633,3633999,20.689962554081347,37.83622088809586,0.09428096935512809,1279.4148244857788,275.699337720871,1075.7476119995117,13879,3537,10342,10342,0,22,3634000.0
3634,3634999,20.692284332809354,37.843497969624124,0.09426815290281965,1279.8407797813416,275.7710237503052,1075.689552307129,13883,3539,10344,10344,0,22,3635000.0
3635,3635999,20.6942299077646,37.845371194473024,0.09429222280861893,1280.2441003322601,275.84178614616394,1075.8287506103516,13883,3539,10344,10344,0,22,3636000.0
3636,3636999,20.69628590909051,37.8481042566785,0.09430836110564478,1280.552550792694,275.91253638267517,1076.4339447021484,13883,3539,10344,10344,0,22,3637000.0
3637,3637999,20.697574012029946,37.85054383657766,0.0943061448523107,1280.970484495163,275.98175835609436,1076.414665222168,13902,3541,10361,10361,0,22,3638000.0
3638,3638999,20.699442885677154,37.85360613127309,0.09431093041422567,1281.3330481052399,276.0510971546173,1076.7739715576172,13904,3542,10362,10362,0,22,3639000.0
3639,3639999,20.700261323411887,37.8589483416162,0.09429454772417944,1281.794270992279,276.1249039173126,1076.709732055664,13904,3542,10362,10362,0,22,3640000.0
3640,3640999,20.700971899393192,37.85790611861077,0.09421991247967876,1282.0547189712524,276.1914772987366,1077.7650604248047,13906,3542,10364,10364,0,22,3641000.0
3641,3641999,20.70078875974231,37.856116699481944,0.09417067677231372,1282.2515029907227,276.2570061683655,1078.8655700683594,13906,3542,10364,10364,0,22,3642000.0
3642,3642999,20.700524472218337,37.8542406030519,0.09412386444210008,1282.6643295288086,276.3235378265381,1079.0117950439453,13910,3544,10366,10366,0,22,3643000.0
3643,3643999,20.700367350914245,37.85200221726351,0.09408452402462031,1283.1133408546448,276.3915433883667,1078.8483810424805,13916,3547,10369,10369,0,22,3644000.0
3644,3644999,20.699752256906667,37.84969963837127,0.09405879645294468,1283.512306213379,276.45962023735046,1079.024429321289,13916,3547,10369,10369,0,22,3645000.0
3645,3645999,20.69953750397989,37.84804815796706,0.09402047671050862,1283.8304026126862,276.5275151729584,1079.4194259643555,13918,3548,10370,10370,0,22,3646000.0
3646,3646999,20.69861775121124,37.845252712277,0.09399870928280707,1284.4318096637726,276.59805607795715,1078.5585098266602,13928,3553,10375,10375,0,22,3647000.0
3647,3647999,20.697655697696828,37.84422699655679,0.09397045905471058,1284.747356891632,276.66499304771423,1079.0881729125977,13932,3555,10377,10377,0,22,3648000.0
3648,3648999,20.696411620657777,37.841220551329116,0.09396481296140935,1285.1417150497437,276.7318789958954,1079.2357177734375,13932,3555,10377,10377,0,22,3649000.0
3649,3649999,20.695823199759733,37.83933438298413,0.09394035806879908,1285.4588923454285,276.8004035949707,1079.5374755859375,13934,3556,10378,10378,0,22,3650000.0
3650,3650999,20.69472868514475,37.83651965734978,0.09391700968763006,1285.7764267921448,276.86720275878906,1079.9097366333008,13936,3557,10379,10379,0,22,3651000.0
3651,3651999,20.69409725976222,37.8345073132246,0.09389942391869255,1286.1007299423218,276.93568325042725,1080.1641235351562,13938,3558,10380,10380,0,22,3652000.0
3652,3652999,20.69395100623599,37.83337777747321,0.09387667508763953,1286.5541977882385,277.00304317474365,1079.9381256103516,13938,3558,10380,10380,0,22,3653000.0
3653,3653999,20.694792628214763,37.83456573081329,0.09386029871789658,1287.057900428772,277.07082962989807,1079.605239868164,13940,3559,10381,10381,0,22,3654000.0
3654,3654999,20.69524949926064,37.834206374119844,0.09384599525569948,1287.3629460334778,277.13813042640686,1080.0303802490234,13940,3559,10381,10381,0,22,3655000.0
3655,3655999,20.696254002396838,37.8349299342757,0.0938408742322806,1287.804265499115,277.2069728374481,1079.9586715698242,13944,3561,10383,10383,0,22,3656000.0
3656,3656999,20.697395331964962,37.837067891231655,0.0938309906243866,1288.0692298412323,277.27452874183655,1080.6449813842773,13944,3561,10383,10383,0,22,3657000.0
3657,3657999,20.697963034102433,37.83764838769002,0.09382258319901504,1288.4193046092987,277.34328293800354,1080.842155456543,13946,3562,10384,10384,0,22,3658000.0
3658,3658999,20.69860695777748,37.83896512051395,0.09381592415961137,1288.9026880264282,277.410897731781,1080.5218811035156,13946,3562,10384,10384,0,22,3659000.0
3659,3659999,20.698318126851163,37.837208464572186,0.09382356042719786,1289.1773715019226,277.47759342193604,1081.1367263793945,13946,3562,10384,10384,0,22,3660000.0
3660,3660999,20.699381094398746,37.837537519043515,0.09373552517113237,1289.4703679084778,277.5455729961395,1082.0537643432617,13947,3562,10385,10385,0,22,3661000.0
3661,3661999,20.699733370772535,37.83654442504153,0.09368433937765996,1290.071474313736,277.6152250766754,1081.263916015625,13955,3566,10389,10389,0,22,3662000.0
3662,3662999,20.700161440588246,37.8360931317768,0.09362395030747861,1290.3300507068634,277.68263959884644,1082.0851135253906,13955,3566,10389,10389,0,22,3663000.0
3663,3663999,20.700225477210488,37.83387140154701,0.09358899924198427,1290.7712428569794,277.75336170196533,1081.938705444336,13959,3568,10391,10391,0,22,3664000.0
3664,3664999,20.70012795218217,37.83187499616983,0.09355104258575297,1291.0152807235718,277.82291650772095,1082.734992980957,13961,3569,10392,10392,0,22,3665000.0
3665,3665999,20.699988220812912,37.830302319839745,0.09349659510634556,1291.6263542175293,277.8921751976013,1081.8029022216797,13969,3573,10396,10396,0,22,3666000.0
3666,3666999,20.699426270956696,37.828318381081424,0.09345517133312997,1291.9249529838562,277.96134757995605,1082.4437255859375,13971,3574,10397,10397,0,22,3667000.0
3667,3667999,20.699020035693923,37.826656775315016,0.09341469933195334,1292.312980413437,278.02949357032776,1082.411521911621,13981,3577,10404,10404,0,22,3668000.0
3668,3668999,20.698515539102274,37.83014055590095,0.09335954988744888,1292.6151714324951,278.09873604774475,1082.8547134399414,13981,3577,10404,10404,0,22,3669000.0
3669,3669999,20.69799759180494,37.82842628841863,0.09331534878074654,1293.0903220176697,278.16808581352234,1082.442153930664,13985,3579,10406,10406,0,22,3670000.0
3670,3670999,20.697723695125575,37.826787728355974,0.09326853188608464,1293.6398313045502,278.23819732666016,1082.0281829833984,13989,3581,10408,10408,0,22,3671000.0
3671,3671999,20.696655766398887,37.82438941948092,0.09324998518857675,1293.8967871665955,278.30850768089294,1082.7099227905273,13989,3581,10408,10408,0,22,3672000.0
3672,3672999,20.696447800522478,37.82505975091237,0.09321424484340379,1294.233324289322,278.3792896270752,1083.0239181518555,13989,3581,10408,10408,0,22,3673000.0
3673,3673999,20.696519049223497,37.82373718670852,0.09316829599482468,1294.677169084549,278.4490668773651,1082.660385131836,13993,3583,10410,10410,0,22,3674000.0
3674,3674999,20.69623819014775,37.82152114132037,0.09315507090909503,1295.0614354610443,278.52015447616577,1082.8403701782227,13995,3584,10411,10411,0,22,3675000.0
3675,3675999,20.695835033662682,37.81961625386223,0.09314526962154468,1295.5009515285492,278.59057807922363,1082.7577896118164,13995,3584,10411,10411,0,22,3676000.0
3676,3676999,20.695733496777816,37.82104237065137,0.09310869947534717,1295.7674491405487,278.6606562137604,1083.3644180297852,13995,3584,10411,10411,0,22,3677000.0
3677,3677999,20.695625519186127,37.81886435101352,0.09305375622390744,1296.2288026809692,278.7297041416168,1083.4009094238281,13998,3585,10413,10413,0,22,3678000.0
3678,3678999,20.695391065665746,37.81642804986935,0.09301433924411573,1296.535727262497,278.80266761779785,1084.1577758789062,13998,3585,10413,10413,0,22,3679000.0
3679,3679999,20.6945213926867,37.813518776870794,0.09299290408146754,1296.8475785255432,278.8745927810669,1084.6604309082031,13998,3585,10413,10413,0,22,3680000.0
3680,3680999,20.69373416361427,37.810733113810436,0.09297065984777841,1297.2350180149078,278.94596242904663,1084.8093719482422,14000,3586,10414,10414,0,22,3681000.0
3681,3681999,20.69253362811765,37.80761873305874,0.09295921622695269,1297.6175804138184,279.0194127559662,1085.0522155761719,14020,3588,10432,10432,0,22,3682000.0
3682,3682999,20.691114354704034,37.80590267888927,0.0929465574667061,1298.0804619789124,279.09217953681946,1084.867042541504,14022,3589,10433,10433,0,22,3683000.0
3683,3683999,20.689354417408182,37.80235017720021,0.09294907625077198,1298.5024309158325,279.1664378643036,1084.9132232666016,14022,3589,10433,10433,0,22,3684000.0
3684,3684999,20.688192734104707,37.80001044317549,0.09294087828678155,1298.8741834163666,279.23859763145447,1085.0691528320312,14024,3590,10434,10434,0,22,3685000.0
3685,3685999,20.687096781764005,37.797621352183135,0.09292749594807226,1299.2953460216522,279.3115921020508,1085.1188583374023,14028,3592,10436,10436,0,22,3686000.0
3686,3686999,20.686158301827437,37.796308228586916,0.09290864907043894,1299.701159477234,279.3876359462738,1085.105598449707,14031,3594,10437,10437,0,22,3687000.0
3687,3687999,20.685528141972757,37.79446354670837,0.0928884312719318,1300.1912746429443,279.46119713783264,1084.768898010254,14031,3594,10437,10437,0,22,3688000.0
3688,3688999,20.685389706754247,37.79370303780772,0.09286339792453224,1300.5197830200195,279.5348205566406,1085.1980361938477,14031,3594,10437,10437,0,22,3689000.0
3689,3689999,20.685800661482045,37.79564927451354,0.09282744331340875,1301.003336429596,279.6093056201935,1085.0059967041016,14035,3596,10439,10439,0,22,3690000.0
3690,3690999,20.686015065931073,37.79525226366948,0.09280545956338981,1301.4724826812744,279.68498277664185,1084.754524230957,14038,3598,10440,10440,0,22,3691000.0
3691,3691999,20.68656310029236,37.795435575294476,0.09278504399956411,1301.7742261886597,279.7605366706848,1085.2922973632812,14038,3598,10440,10440,0,22,3692000.0
3692,3692999,20.687491315719186,37.79538322051898,0.09276942801523302,1302.147697687149,279.8347852230072,1085.4544372558594,14038,3598,10440,10440,0,22,3693000.0
3693,3693999,20.688744845880837,37.798195787907815,0.09273068251836747,1302.5983016490936,279.90984177589417,1085.392219543457,14038,3598,10440,10440,0,22,3694000.0
3694,3694999,20.689389457479503,37.79744820257558,0.09272406290190682,1302.980808019638,279.98494601249695,1085.4942779541016,14041,3600,10441,10441,0,22,3695000.0
3695,3695999,20.690223916007646,37.79640771220953,0.09271628016299238,1303.3331215381622,280.0611698627472,1085.763900756836,14041,3600,10441,10441,0,22,3696000.0
3696,3696999,20.69072601211976,37.79549848850349,0.0927029899140176,1303.6467778682709,280.1352548599243,1086.092544555664,14041,3600,10441,10441,0,22,3697000.0
3697,3697999,20.689986279948286,37.79356301349706,0.09268681599826478,1304.0250098705292,280.20313453674316,1086.4648818969727,14042,3600,10442,10442,0,22,3698000.0
3698,3698999,20.68800761684379,37.78988522733504,0.09268044905560602,1304.3604717254639,280.2705702781677,1086.9326934814453,14044,3601,10443,10443,0,22,3699000.0
3699,3699999,20.686405335910646,37.78732794309645,0.09267466746082786,1304.6759915351868,280.33625888824463,1087.3122100830078,14047,3602,10445,10445,0,22,3700000.0
3700,3700999,20.684915502786637,37.78411964683043,0.09266697560001613,1305.0848653316498,280.40541338920593,1087.3199768066406,14049,3603,10446,10446,0,22,3701000.0
3701,3701999,20.683800982756452,37.78227618626854,0.09263995440226325,1305.3479549884796,280.47191739082336,1088.105827331543,14049,3603,10446,10446,0,22,3702000.0
3702,3702999,20.68278073648667,37.77929738605733,0.09261817662482275,1305.7498807907104,280.53949308395386,1088.2394180297852,14051,3604,10447,10447,0,22,3703000.0
3703,3703999,20.68217589122326,37.77674278246569,0.09258116272556294,1306.1362013816833,280.60862159729004,1088.4457473754883,14053,3605,10448,10448,0,22,3704000.0
3704,3704999,20.682045779801797,37.77597183310368,0.09254011652170069,1306.4734468460083,280.6759214401245,1088.7632141113281,14061,3607,10454,10454,0,22,3705000.0
3705,3705999,20.682391645318454,37.778588233540205,0.09248361554757834,1306.7550776004791,280.7421293258667,1089.180061340332,14063,3608,10455,10455,0,22,3706000.0
3706,3706999,20.682290941875177,37.77771670638804,0.09245711967481363,1307.2351984977722,280.8114743232727,1088.7466354370117,14065,3609,10456,10456,0,22,3707000.0
3707,3707999,20.682936104832123,37.77817367341744,0.09245832205754911,1307.849207162857,280.8798472881317,1087.8739852905273,14077,3615,10462,10462,0,22,3708000.0
3708,3708999,20.68363476504912,37.77926592848106,0.092454747070845,1308.3304302692413,280.9504065513611,1087.817008972168,14079,3616,10463,10463,0,22,3709000.0
3709,3709999,20.684790226025754,37.78567638212277,0.09242746315715744,1308.596830368042,281.01990270614624,1088.532585144043,14079,3616,10463,10463,0,22,3710000.0
3710,3710999,20.68537040178847,37.78588810582119,0.09244053613041436,1308.946713924408,281.0880591869354,1088.8943252563477,14079,3616,10463,10463,0,22,3711000.0
3711,3711999,20.686336364572274,37.78745902931148,0.09243004961892831,1309.2417533397675,281.1557397842407,1089.3496704101562,14079,3616,10463,10463,0,22,3712000.0
3712,3712999,20.687277392027315,37.78777381784311,0.09241005058027651,1309.5078279972076,281.22285866737366,1089.988754272461,14099,3617,10482,10482,0,22,3713000.0
3713,3713999,20.688989597248053,37.791351888452056,0.09238540965004749,1309.8427033424377,281.29076385498047,1090.2515106201172,14099,3617,10482,10482,0,22,3714000.0
3714,3714999,20.69032576640888,37.79250165877752,0.0923726151948151,1310.2505342960358,281.3600244522095,1090.2767181396484,14101,3618,10483,10483,0,22,3715000.0
3715,3715999,20.691253045824404,37.79255445039449,0.09237455501137015,1310.6664969921112,281.42870807647705,1090.3656005859375,14101,3618,10483,10483,0,22,3716000.0
3716,3716999,20.69200504172711,37.7924592476527,0.0923551250322977,1311.0213618278503,281.49805974960327,1090.4740676879883,14101,3618,10483,10483,0,22,3717000.0
3717,3717999,20.69174099237028,37.790784922185445,0.09234409320639836,1311.4343464374542,281.56749510765076,1090.5882873535156,14103,3619,10484,10484,0,22,3718000.0
3718,3718999,20.690407112334242,37.789933123857885,0.09233480519903103,1311.6908087730408,281.6365945339203,1091.5447158813477,14105,3619,10486,10486,0,22,3719000.0
3719,3719999,20.68864105973857,37.78702916453144,0.09234148925846897,1312.0505094528198,281.70633363723755,1091.9526901245117,14105,3619,10486,10486,0,22,3720000.0
3720,3720999,20.68671144758418,37.78372751950655,0.09235285446772556,1312.3291537761688,281.77495288848877,1092.609390258789,14105,3619,10486,10486,0,22,3721000.0
3721,3721999,20.685207835231836,37.78087897721941,0.09235884808622974,1312.6917841434479,281.8456857204437,1092.8385620117188,14105,3619,10486,10486,0,22,3722000.0
3722,3722999,20.68335561526573,37.777612775343826,0.09236498074837363,1313.1350584030151,281.9157440662384,1092.568702697754,14109,3621,10488,10488,0,22,3723000.0
3723,3723999,20.681993167016252,37.77532613792425,0.0923608152784483,1313.441278219223,281.9882433414459,1093.0254821777344,14109,3621,10488,10488,0,22,3724000.0
3724,3724999,20.68035946600895,37.77238982664442,0.09236210133679801,1313.8538801670074,282.059255361557,1092.9754104614258,14111,3622,10489,10489,0,22,3725000.0
3725,3725999,20.67881574486965,37.77007253010476,0.09235849843410693,1314.3847818374634,282.1322898864746,1092.4456481933594,14115,3624,10491,10491,0,22,3726000.0
3726,3726999,20.678012676775136,37.76895355434931,0.09234395788264882,1314.7402787208557,282.2042691707611,1092.5921478271484,14116,3625,10491,10491,0,22,3727000.0
3727,3727999,20.676921708534564,37.76663214928151,0.09233315902163064,1315.222007036209,282.27753949165344,1092.3221702575684,14117,3625,10492,10492,0,22,3728000.0
3728,3728999,20.675883878930556,37.76436258608984,0.09232439298896045,1315.6310670375824,282.34911274909973,1092.3847999572754,14117,3625,10492,10492,0,22,3729000.0
3729,3729999,20.675399216830588,37.763245360674595,0.09230884779710913,1316.0217723846436,282.4215009212494,1092.5033912658691,14117,3625,10492,10492,0,22,3730000.0
3730,3730999,20.674629303224666,37.76095312177635,0.09230288274580023,1316.4260416030884,282.49377155303955,1092.6951484680176,14151,3627,10524,10524,0,22,3731000.0
3731,3731999,20.67403015476746,37.75972689067976,0.09229318491322247,1316.627447128296,282.56486463546753,1093.9082984924316,14151,3627,10524,10524,0,22,3732000.0
3732,3732999,20.673130960582355,37.75743959726002,0.09228830798537013,1316.9524199962616,282.63775634765625,1094.4564933776855,14151,3627,10524,10524,0,22,3733000.0
3733,3733999,20.673047967587074,37.75855667699043,0.0922639495674964,1317.166650056839,282.7089533805847,1095.2348518371582,14151,3627,10524,10524,0,22,3734000.0
3734,3734999,20.672426094119096,37.756383018008044,0.09225896975840897,1317.5353231430054,282.78265357017517,1095.4328422546387,14151,3627,10524,10524,0,22,3735000.0
3735,3735999,20.671844056688318,37.753937548857586,0.09225604774841167,1317.7489035129547,282.85326766967773,1096.2430610656738,14151,3627,10524,10524,0,22,3736000.0
3736,3736999,20.670814467859916,37.75283470958372,0.09223984627107173,1318.1547739505768,282.92452025413513,1096.2546730041504,14151,3627,10524,10524,0,22,3737000.0
3737,3737999,20.66911529308439,37.750010238280176,0.09224015332275182,1318.5179636478424,282.993364572525,1096.7031364440918,14154,3628,10526,10526,0,22,3738000.0
3738,3738999,20.667170587593056,37.747487134678,0.09224215235817335,1318.9155530929565,283.0607964992523,1096.918758392334,14154,3628,10526,10526,0,22,3739000.0
3739,3739999,20.665284543098164,37.74393497976326,0.09225584980991186,1319.3294644355774,283.12958002090454,1097.0589866638184,14156,3629,10527,10527,0,22,3740000.0
3740,3740999,20.663767511862513,37.741537793744776,0.0922562311547066,1319.7374470233917,283.1987838745117,1097.0574378967285,14156,3629,10527,10527,0,22,3741000.0
3741,3741999,20.662634742799046,37.741494434028155,0.09224061518769777,1320.1539895534515,283.2673738002777,1097.0745658874512,14160,3631,10529,10529,0,22,3742000.0
3742,3742999,20.66135287906567,37.739282213191835,0.09222942667675926,1320.5211896896362,283.33891439437866,1097.2767143249512,14162,3632,10530,10530,0,22,3743000.0
3743,3743999,20.66010947068724,37.737755147383794,0.09221443329645063,1320.9210062026978,283.4069917201996,1097.248119354248,14164,3633,10531,10531,0,22,3744000.0
3744,3744999,20.65960315038545,37.73702690324692,0.09219226475352627,1321.331558227539,283.47544407844543,1097.227138519287,14168,3635,10533,10533,0,22,3745000.0
3745,3745999,20.65922199447156,37.741004701593155,0.09214778683145242,1321.6419594287872,283.5452456474304,1097.5719184875488,14170,3636,10534,10534,0,22,3746000.0
3746,3746999,20.659755600278313,37.74152185809613,0.09211599513584867,1322.0521113872528,283.6138095855713,1097.5861320495605,14174,3638,10536,10536,0,22,3747000.0
3747,3747999,20.660352921845,37.74326917731808,0.0920883461967349,1322.46280503273,283.6835677623749,1097.5251731872559,14174,3638,10536,10536,0,22,3748000.0
3748,3748999,20.661304152225703,37.7441044844924,0.09206118711534361,1322.8375706672668,283.752925157547,1097.7878150939941,14174,3638,10536,10536,0,22,3749000.0
3749,3749999,20.66321774817377,37.74870403831564,0.09200942658145883,1323.1716012954712,283.8256084918976,1098.1547737121582,14176,3639,10537,10537,0,22,3750000.0
3750,3750999,20.66548599876648,37.75653064699313,0.09195233625940191,1323.5093784332275,283.89453864097595,1098.3898658752441,14176,3639,10537,10537,0,22,3751000.0
3751,3751999,20.667971503675748,37.76339394009581,0.09190945491239155,1323.871253490448,283.96409726142883,1098.5550346374512,14178,3640,10538,10538,0,22,3752000.0
3752,3752999,20.669675531480163,37.76724526727757,0.09188448701894869,1324.2959420681,284.0346255302429,1098.3667030334473,14184,3643,10541,10541,0,22,3753000.0
3753,3753999,20.672322392718737,37.77471120456094,0.09185535298410463,1324.5542359352112,284.1055829524994,1099.0034217834473,14184,3643,10541,10541,0,22,3754000.0
3754,3754999,20.67484545347852,37.77701453179641,0.09184230884351818,1324.9641997814178,284.1748332977295,1098.9521293640137,14189,3646,10543,10543,0,22,3755000.0
3755,3755999,20.677135032052448,37.78169961679117,0.09181519539994532,1325.2313935756683,284.2436172962189,1099.5348472595215,14191,3647,10544,10544,0,22,3756000.0
3756,3756999,20.678271072234732,37.78127183810383,0.09181153855484081,1325.613587141037,284.3126075267792,1099.53023147583,14191,3647,10544,10544,0,22,3757000.0
3757,3757999,20.67730841400008,37.77852380208743,0.09180679872187714,1326.1939375400543,284.38146710395813,1099.1408500671387,14200,3648,10552,10552,0,22,3758000.0
3758,3758999,20.675370615660697,37.77606208656602,0.0918092659279699,1326.5122101306915,284.4531307220459,1099.7593040466309,14200,3648,10552,10552,0,22,3759000.0
3759,3759999,20.673532556679152,37.773285630067164,0.09180733994645751,1326.7737233638763,284.5209424495697,1100.376522064209,14200,3648,10552,10552,0,22,3760000.0
3760,3760999,20.672016723844912,37.77145521826262,0.09179995828173337,1327.219422340393,284.58880615234375,1100.136806488037,14200,3648,10552,10552,0,22,3761000.0
3761,3761999,20.671272545728076,37.77340203870532,0.0917678407061544,1327.7576158046722,284.6586401462555,1099.5111961364746,14204,3650,10554,10554,0,22,3762000.0
3762,3762999,20.67022119119038,37.771385780571386,0.0917571266452617,1328.2016060352325,284.72679114341736,1099.3724098205566,14206,3651,10555,10555,0,22,3763000.0
3763,3763999,20.6694778932605,37.77153482777698,0.09172906139194703,1328.516128063202,284.79488492012024,1099.776454925537,14208,3652,10556,10556,0,22,3764000.0
3764,3764999,20.66866037007524,37.77003555916646,0.0917124171565834,1328.9113099575043,284.863648891449,1099.9906883239746,14210,3653,10557,10557,0,22,3765000.0
3765,3765999,20.667960065241353,37.76850718254024,0.09169421496360652,1329.1932566165924,284.93292355537415,1100.415241241455,14212,3654,10558,10558,0,22,3766000.0
3766,3766999,20.667754394700612,37.76822248130352,0.09166853453168,1329.5194900035858,285.0017547607422,1100.709758758545,14214,3655,10559,10559,0,22,3767000.0
3767,3767999,20.66755623603937,37.76763676556631,0.09165286540282624,1330.0303704738617,285.0725095272064,1100.3502082824707,14218,3657,10561,10561,0,22,3768000.0
3768,3768999,20.668413880671118,37.76917121741296,0.09163030231475655,1330.406097650528,285.1413779258728,1100.4685859680176,14222,3659,10563,10563,0,22,3769000.0
3769,3769999,20.670937646996475,37.77693718645082,0.09158480040719819,1330.7607610225677,285.21013951301575,1100.7592964172363,14224,3660,10564,10564,0,22,3770000.0
3770,3770999,20.674097395163106,37.78548476495431,0.09153583712251367,1331.0383894443512,285.2814335823059,1101.3386268615723,14226,3661,10565,10565,0,22,3771000.0
3771,3771999,20.67862650044321,37.79962148050189,0.09147622658261234,1331.4328513145447,285.3507056236267,1101.4184684753418,14226,3661,10565,10565,0,22,3772000.0
3772,3772999,20.682508654534423,37.808395559675404,0.0914514236400904,1331.87313580513,285.4211013317108,1101.3485069274902,14228,3662,10566,10566,0,22,3773000.0
3773,3773999,20.687904638260264,37.82232034464361,0.09140117699778239,1332.300094127655,285.4903461933136,1101.2348518371582,14232,3664,10568,10568,0,22,3774000.0
3774,3774999,20.692873611530416,37.834989295569194,0.09138217381667613,1332.6373436450958,285.55895233154297,1101.6780967712402,14232,3664,10568,10568,0,22,3775000.0
3775,3775999,20.697062286612088,37.8417154092868,0.09137389839822008,1332.9952976703644,285.6295871734619,1101.7984809875488,14232,3664,10568,10568,0,22,3776000.0
3776,3776999,20.701636353823933,37.84926166047219,0.0913787492301057,1333.3839013576508,285.698543548584,1101.8624229431152,14234,3665,10569,10569,0,22,3777000.0
3777,3777999,20.704521137600977,37.85234752995797,0.09138116432295262,1333.731487751007,285.76883125305176,1102.1750679016113,14234,3665,10569,10569,0,22,3778000.0
3778,3778999,20.704665164251125,37.851470716590995,0.09138269183715775,1334.0033311843872,285.83773136138916,1103.0990180969238,14238,3665,10573,10573,0,22,3779000.0
3779,3779999,20.70321806779564,37.853080924731756,0.09134954240336368,1334.332117319107,285.90479946136475,1103.6159172058105,14238,3665,10573,10573,0,22,3780000.0
3780,3780999,20.702030392427943,37.85216042265906,0.09133061429445044,1334.7274677753448,285.9709367752075,1103.8437614440918,14239,3665,10574,10574,0,22,3781000.0
3781,3781999,20.700892987930402,37.85062309748189,0.09131351059410753,1334.984616279602,286.0387873649597,1104.4745063781738,14239,3665,10574,10574,0,22,3782000.0
3782,3782999,20.699930386999732,37.84945104983716,0.09129370450850172,1335.2746307849884,286.1063756942749,1104.8953971862793,14239,3665,10574,10574,0,22,3783000.0
3783,3783999,20.699028268491464,37.84728924854717,0.09127581084571768,1335.8994517326355,286.1749384403229,1103.8962440490723,14247,3669,10578,10578,0,22,3784000.0
3784,3784999,20.69824036479466,37.846595859519596,0.0912500269949853,1336.2931866645813,286.2427091598511,1104.087978363037,14249,3670,10579,10579,0,22,3785000.0
3785,3785999,20.69759868462816,37.8454083880759,0.09122819482836353,1336.8460521697998,286.31157088279724,1103.4437294006348,14259,3673,10586,10586,0,22,3786000.0
3786,3786999,20.696840308230374,37.8437671894457,0.09120656868035693,1337.109305858612,286.378235578537,1104.1156959533691,14261,3674,10587,10587,0,22,3787000.0
3787,3787999,20.69710126362463,37.84656142794227,0.0911712366676043,1337.380470752716,286.44675493240356,1104.5974235534668,14261,3674,10587,10587,0,22,3788000.0
3788,3788999,20.699456621135546,37.854000971550896,0.09111122627519685,1337.8289649486542,286.51387429237366,1104.452236175537,14263,3675,10588,10588,0,22,3789000.0
3789,3789999,20.70438702129115,37.86920231061971,0.09103157762757241,1343.7206497192383,286.58401679992676,1104.4392127990723,14269,3676,10593,10593,0,22,3790000.0
3790,3790999,20.709916907974023,37.88934892459982,0.09096572497896349,1344.1732206344604,286.65292096138,1104.2718620300293,14271,3677,10594,10594,0,22,3791000.0
3791,3791999,20.716719322870564,37.90897030037062,0.09093079319595032,1344.599873304367,286.7202453613281,1104.2447319030762,14277,3680,10597,10597,0,22,3792000.0
3792,3792999,20.724312169550373,37.92611511772958,0.09094048098285801,1345.1077721118927,286.78974986076355,1103.888111114502,14281,3682,10599,10599,0,22,3793000.0
3793,3793999,20.73238608677535,37.94552397844083,0.091026960526577,1345.3551964759827,286.8568594455719,1104.7253227233887,14281,3682,10599,10599,0,22,3794000.0
3794,3794999,20.74034390509441,37.96322264444378,0.09116835346256003,1345.6658027172089,286.9241645336151,1105.210033416748,14283,3683,10600,10600,0,22,3795000.0
3795,3795999,20.748783653419636,37.981700923789056,0.09128428865111904,1345.9202227592468,286.9907052516937,1105.807689666748,14283,3683,10600,10600,0,22,3796000.0
3796,3796999,20.756337593425357,37.995740520372486,0.0914290850313888,1346.3878240585327,287.06015181541443,1105.543056488037,14289,3686,10603,10603,0,22,3797000.0
3797,3797999,20.76454102532628,38.01057635653497,0.09160600592160151,1346.8991703987122,287.1311650276184,1105.2347831726074,14293,3688,10605,10605,0,22,3798000.0
3798,3798999,20.76968087341757,38.01794912614274,0.0916913053617544,1347.1172981262207,287.1979684829712,1106.224063873291,14293,3688,10605,10605,0,22,3799000.0
3799,3799999,20.77271434311907,38.02181987972143,0.09149334566234735,1347.4279253482819,287.26560735702515,1106.9748191833496,14295,3688,10607,10607,0,22,3800000.0
3800,3800999,20.774211233257688,38.023107152800996,0.09131358325172378,1347.8406999111176,287.3352837562561,1107.1115837097168,14295,3688,10607,10607,0,22,3801000.0
3801,3801999,20.7757581256876,38.02434962616779,0.09118193646905992,1348.2556567192078,287.4053473472595,1107.127597808838,14299,3690,10609,10609,0,22,3802000.0
3802,3802999,20.777948625796967,38.028273849030704,0.09106793845204741,1348.7850754261017,287.47535586357117,1106.726161956787,14303,3692,10611,10611,0,22,3803000.0
3803,3803999,20.778727724229462,38.02841747824214,0.0909879182608826,1349.340737104416,287.54779267311096,1106.1250114440918,14314,3696,10618,10618,0,22,3804000.0
3804,3804999,20.779442606774822,38.02828088231155,0.09089975150844598,1349.840919494629,287.6184012889862,1105.9198875427246,14320,3699,10621,10621,0,22,3805000.0
3805,3805999,20.779801465369527,38.028609865234834,0.09084272063021959,1350.186823606491,287.68718791007996,1106.2769813537598,14320,3699,10621,10621,0,22,3806000.0
3806,3806999,20.780686694556135,38.02864653784614,0.09078792760602716,1350.4841313362122,287.75661873817444,1106.8213920593262,14320,3699,10621,10621,0,22,3807000.0
3807,3807999,20.781635967482277,38.033597231134735,0.09072889006185281,1350.817682981491,287.82803320884705,1107.1445121765137,14322,3700,10622,10622,0,22,3808000.0
3808,3808999,20.78303095684233,38.03476658043188,0.09070793582520986,1351.109384059906,287.8985080718994,1107.6175727844238,14322,3700,10622,10622,0,22,3809000.0
3809,3809999,20.784158918918198,38.03633067791631,0.09067287197324769,1351.405568599701,287.9677188396454,1108.1193962097168,14322,3700,10622,10622,0,22,3810000.0
3810,3810999,20.787132242552826,38.04540118231446,0.09061621262114805,1351.8191871643066,288.03834414482117,1108.0019645690918,14324,3701,10623,10623,0,22,3811000.0
3811,3811999,20.790133549850527,38.05040426137832,0.09060467723721788,1352.225594997406,288.1108822822571,1108.0480308532715,14331,3702,10629,10629,0,22,3812000.0
3812,3812999,20.793334251247146,38.054468970323896,0.09058650683097214,1352.6074771881104,288.1805307865143,1108.1030921936035,14335,3704,10631,10631,0,22,3813000.0
3813,3813999,20.797759898293585,38.061809228379786,0.09056526841364121,1352.9578065872192,288.2498869895935,1108.36869430542,14335,3704,10631,10631,0,22,3814000.0
3814,3814999,20.802498199364514,38.07242143436516,0.09057644451552416,1353.4345407485962,288.31991624832153,1108.2831840515137,14354,3707,10647,10647,0,22,3815000.0
3815,3815999,20.80769773082293,38.08238195635311,0.09058139928277709,1353.889318227768,288.39414715766907,1108.3034782409668,14360,3710,10650,10650,0,22,3816000.0
3816,3816999,20.81166689310683,38.08851364210183,0.0906189803034565,1354.2723515033722,288.4653990268707,1108.5317192077637,14364,3712,10652,10652,0,22,3817000.0
3817,3817999,20.81598436686945,38.09533064846694,0.09064848975238404,1354.5780835151672,288.5374915599823,1109.1059532165527,14364,3712,10652,10652,0,22,3818000.0
3818,3818999,20.81963641333787,38.099291839135496,0.09069432637582786,1354.9035568237305,288.6065671443939,1109.5728797912598,14364,3712,10652,10652,0,22,3819000.0
3819,3819999,20.821328683733935,38.0995784091402,0.0906910576300205,1355.2080059051514,288.676260471344,1110.2952308654785,14365,3712,10653,10653,0,22,3820000.0
3820,3820999,20.822705668478168,38.101043188351525,0.09052713883595698,1355.5672736167908,288.74676275253296,1110.7220726013184,14368,3713,10655,10655,0,22,3821000.0
3821,3821999,20.8237261964228,38.10131071143496,0.09040014013377384,1355.8816916942596,288.8168215751648,1111.3097190856934,14388,3715,10673,10673,0,22,3822000.0
3822,3822999,20.824706926409167,38.101438844264926,0.09031635616773848,1356.337244272232,288.8887519836426,1110.998134613037,14392,3717,10675,10675,0,22,3823000.0
3823,3823999,20.824616825366352,38.0997539460173,0.0902621988228981,1356.7907948493958,288.9591438770294,1110.9232597351074,14398,3720,10678,10678,0,22,3824000.0
3824,3824999,20.824294931277826,38.09779818101299,0.09021065281139662,1357.1153967380524,289.03259325027466,1111.3456077575684,14418,3722,10696,10696,0,22,3825000.0
3825,3825999,20.823554198557016,38.09550283421194,0.09015644550618918,1357.6360883712769,289.1038520336151,1110.9036674499512,14442,3726,10716,10716,0,22,3826000.0
3826,3826999,20.823158749710394,38.09362474024733,0.09010531449347414,1358.0054399967194,289.17464447021484,1111.069911956787,14444,3727,10717,10717,0,22,3827000.0
3827,3827999,20.82265701368351,38.092258240377575,0.0900599669458434,1358.589588880539,289.2472629547119,1110.3056526184082,14446,3728,10718,10718,0,22,3828000.0
3828,3828999,20.82200719407848,38.09014901348286,0.09001348357001127,1358.9268989562988,289.32029008865356,1110.7132377624512,14450,3730,10720,10720,0,22,3829000.0
3829,3829999,20.822035808964014,38.08972321507343,0.08994262605068282,1359.2280435562134,289.3926913738251,1111.212329864502,14452,3731,10721,10721,0,22,3830000.0
3830,3830999,20.82190951878156,38.088739724833545,0.089885777748554,1359.5592844486237,289.46365451812744,1111.5248222351074,14461,3733,10728,10728,0,22,3831000.0
3831,3831999,20.82191178115261,38.08807047380248,0.0898400292966468,1360.2571544647217,289.53657579421997,1110.3433570861816,14463,3734,10729,10729,0,22,3832000.0
3832,3832999,20.821717322762275,38.087001790050934,0.08980840398089118,1360.5262439250946,289.61297392845154,1111.1525764465332,14463,3734,10729,10729,0,22,3833000.0
3833,3833999,20.821700496597405,38.085459821447834,0.0897695947500533,1360.8048465251923,289.6852910518646,1111.6386375427246,14470,3735,10735,10735,0,22,3834000.0
3834,3834999,20.821808843026208,38.08435921653397,0.08973639602211692,1361.1771080493927,289.75738406181335,1111.8201484680176,14470,3735,10735,10735,0,22,3835000.0
3835,3835999,20.822462354713824,38.08379140363517,0.0896885992196339,1361.6766004562378,289.82982206344604,1111.468936920166,14472,3736,10736,10736,0,22,3836000.0
3836,3836999,20.82322264966909,38.08357187651616,0.08964829385285444,1362.0227754116058,289.9014801979065,1111.8463706970215,14476,3738,10738,10738,0,22,3837000.0
3837,3837999,20.823914065419448,38.08313723843121,0.08961586049530412,1362.3848972320557,289.973002910614,1112.1843299865723,14478,3739,10739,10739,0,22,3838000.0
3838,3838999,20.824428145039224,38.08219161783143,0.08958391619475348,1362.7188513278961,290.04484128952026,1112.4295387268066,14480,3740,10740,10740,0,22,3839000.0
3839,3839999,20.825377786593656,38.08155362364864,0.08955065246603555,1363.213065624237,290.119788646698,1112.2640800476074,14480,3740,10740,10740,0,22,3840000.0
3840,3840999,20.825272936048588,38.079774485622295,0.08952385173312738,1363.5298964977264,290.1903030872345,1112.7275047302246,14482,3741,10741,10741,0,22,3841000.0
3841,3841999,20.824218584956608,38.077719360490875,0.08950280718611947,1363.971190214157,290.25350427627563,1112.6837577819824,14488,3742,10746,10746,0,22,3842000.0
3842,3842999,20.822962341172467,38.07647773268898,0.08948467574006735,1364.4350607395172,290.31836700439453,1112.4370307922363,14492,3744,10748,10748,0,22,3843000.0
3843,3843999,20.82158341856096,38.074140184419676,0.08947394258545538,1364.8252897262573,290.3824725151062,1112.6529960632324,14498,3746,10752,10752,0,22,3844000.0
3844,3844999,20.820630563154637,38.071714763217614,0.08945478001126272,1365.1542570590973,290.4460291862488,1113.1345252990723,14498,3746,10752,10752,0,22,3845000.0
3845,3845999,20.819859666825224,38.06886285394424,0.08942598020376968,1365.434571504593,290.5103213787079,1113.7580070495605,14498,3746,10752,10752,0,22,3846000.0
3846,3846999,20.819416507307288,38.06660524177612,0.08940769597265408,1365.7631497383118,290.5774371623993,1114.1764335632324,14502,3748,10754,10754,0,22,3847000.0
3847,3847999,20.818721617100344,38.06400458235795,0.08939331310679022,1366.1670725345612,290.641432762146,1114.1108665466309,14506,3750,10756,10756,0,22,3848000.0
3848,3848999,20.81795435055139,38.06124599542707,0.08937499135335913,1366.4376199245453,290.70674180984497,1114.6767311096191,14508,3751,10757,10757,0,22,3849000.0
3849,3849999,20.81709052592753,38.05847445630922,0.0893725548591181,1366.753814458847,290.7724771499634,1114.990665435791,14510,3752,10758,10758,0,22,3850000.0
3850,3850999,20.81643186101758,38.056364187569926,0.08936218452239408,1367.0564255714417,290.8409101963043,1115.402919769287,14512,3753,10759,10759,0,22,3851000.0
3851,3851999,20.8158768116734,38.054495083959544,0.0893563458132306,1367.412017583847,290.90831232070923,1115.5053215026855,14516,3755,10761,10761,0,22,3852000.0
3852,3852999,20.815534491653953,38.05431490907859,0.08933874288025045,1367.7953078746796,290.9740025997162,1115.5158805847168,14518,3756,10762,10762,0,22,3853000.0
3853,3853999,20.815166772153518,38.05297463260767,0.08933787054155073,1368.2144193649292,291.0407874584198,1115.3411445617676,14522,3758,10764,10764,0,22,3854000.0
3854,3854999,20.815032989842994,38.0573533397144,0.0893146069526144,1368.6617572307587,291.1076822280884,1115.1791877746582,14526,3760,10766,10766,0,22,3855000.0
3855,3855999,20.814443993271812,38.05521393342721,0.08929909650232415,1369.1598439216614,291.17690110206604,1114.6325340270996,14530,3762,10768,10768,0,22,3856000.0
3856,3856999,20.81455481708029,38.054054444993696,0.08927696011102038,1369.6241245269775,291.24262046813965,1114.3087043762207,14530,3762,10768,10768,0,22,3857000.0
3857,3857999,20.814448148239254,38.05316274014756,0.08926365581043738,1369.927904844284,291.307874917984,1114.814640045166,14532,3763,10769,10769,0,22,3858000.0
3858,3858999,20.81504463575884,38.05328926703131,0.08924204680388459,1370.1732995510101,291.373765707016,1115.4664421081543,14532,3763,10769,10769,0,22,3859000.0
3859,3859999,20.81526624033019,38.05206177837047,0.08921932293029888,1370.6068978309631,291.44080662727356,1115.360179901123,14534,3764,10770,10770,0,22,3860000.0
3860,3860999,20.815486462965804,38.050998831552036,0.08920005160164879,1370.9427218437195,291.5099251270294,1115.6905555725098,14536,3765,10771,10771,0,22,3861000.0
3861,3861999,20.815312890308594,38.049134429920315,0.089189172347658,1371.261130809784,291.5766091346741,1116.026668548584,14538,3766,10772,10772,0,22,3862000.0
3862,3862999,20.81481221500775,38.04843167477801,0.08917406331535727,1371.7214465141296,291.64583945274353,1115.9751167297363,14540,3766,10774,10774,0,22,3863000.0
3863,3863999,20.81344723093943,38.045858926020955,0.0891640859748446,1372.0328433513641,291.7136187553406,1116.5258293151855,14543,3767,10776,10776,0,22,3864000.0
3864,3864999,20.811735302210728,38.04337988270966,0.08917276836940813,1372.2793061733246,291.7804787158966,1117.2744407653809,14544,3767,10777,10777,0,22,3865000.0
3865,3865999,20.810594263720468,38.0423868960996,0.08916212951516878,1372.8027594089508,291.8487823009491,1116.749942779541,14546,3768,10778,10778,0,22,3866000.0
3866,3866999,20.809318463517233,38.04018042766707,0.08915254954335183,1373.206064939499,291.9173233509064,1117.11665725708,14581,3771,10810,10810,0,22,3867000.0
3867,3867999,20.808024219047475,38.03828820783747,0.08914439856808776,1373.4834270477295,291.99143147468567,1118.008945465088,14583,3772,10811,10811,0,22,3868000.0
3868,3868999,20.806404328777806,38.034892967725796,0.08914200310668241,1373.7070367336273,292.06099677085876,1118.8978233337402,14583,3772,10811,10811,0,22,3869000.0
3869,3869999,20.80578414990259,38.03501880749601,0.08912293061613241,1374.2004206180573,292.13135385513306,1118.5427436828613,14586,3773,10813,10813,0,22,3870000.0
3870,3870999,20.805608609140656,38.03434351992398,0.08910212450786237,1374.4455034732819,292.1998519897461,1119.3034934997559,14586,3773,10813,10813,0,22,3871000.0
3871,3871999,20.805761892064258,38.0353207821064,0.08907342577366928,1374.8301973342896,292.2716820240021,1119.407398223877,14586,3773,10813,10813,0,22,3872000.0
3872,3872999,20.80607024000482,38.03528965677082,0.0890558459866474,1375.2196757793427,292.34060859680176,1119.4025382995605,14590,3775,10815,10815,0,22,3873000.0
3873,3873999,20.806260487434148,38.0346442147094,0.08903629276509206,1375.5171797275543,292.4087030887604,1119.954288482666,14590,3775,10815,10815,0,22,3874000.0
3874,3874999,20.807106263264835,38.03507526304571,0.08901627681609214,1375.8029570579529,292.4800043106079,1120.4632606506348,14598,3777,10821,10821,0,22,3875000.0
3875,3875999,20.807561826568705,38.03449372803339,0.08899989640465644,1376.2922072410583,292.55474615097046,1120.0274848937988,14600,3778,10822,10822,0,22,3876000.0
3876,3876999,20.80776735595259,38.033533834943086,0.08898771897884872,1376.9189927577972,292.6251835823059,1119.1164817810059,14606,3781,10825,10825,0,22,3877000.0
3877,3877999,20.808246309835514,38.03264741954022,0.0889726244107607,1377.2711429595947,292.6954162120819,1119.4856605529785,14608,3782,10826,10826,0,22,3878000.0
3878,3878999,20.80870177554173,38.031875676354105,0.08896172670895053,1377.6054322719574,292.7654447555542,1119.870273590088,14608,3782,10826,10826,0,22,3879000.0
3879,3879999,20.809075321369864,38.031287501602414,0.08894790119418561,1377.9870302677155,292.8352792263031,1119.8814659118652,14610,3783,10827,10827,0,22,3880000.0
3880,3880999,20.809367442707313,38.02982184408942,0.08893641626785387,1378.3304462432861,292.90544867515564,1120.2088508605957,14610,3783,10827,10827,0,22,3881000.0
3881,3881999,20.808683630563003,38.027041006767654,0.08892329906935037,1378.5563790798187,292.9785919189453,1121.3156929016113,14615,3783,10832,10832,0,22,3882000.0
3882,3882999,20.80876577775522,38.02525870248205,0.08885280875669432,1378.8641269207,293.045521736145,1121.9629249572754,14617,3784,10833,10833,0,22,3883000.0
3883,3883999,20.80880760790371,38.02370049140789,0.08879378765517842,1379.240290403366,293.11005115509033,1122.0537757873535,14620,3785,10835,10835,0,22,3884000.0
3884,3884999,20.808468675510866,38.02183444114372,0.08875449929226586,1379.830527305603,293.1791617870331,1121.7132530212402,14685,3788,10897,10897,0,22,3885000.0
3885,3885999,20.808222956863457,38.020310918143146,0.08871525806870706,1380.1347937583923,293.24417996406555,1122.3861503601074,14687,3789,10898,10898,0,22,3886000.0
3886,3886999,20.807872651796448,38.019290655020676,0.08868216095442727,1380.765768289566,293.3120045661926,1121.7098579406738,14702,3796,10906,10906,0,22,3887000.0
3887,3887999,20.80768256219918,38.01755585464121,0.08863554068864576,1380.9717695713043,293.3784234523773,1122.8696556091309,14702,3796,10906,10906,0,22,3888000.0
3888,3888999,20.807338581310553,38.01557185766588,0.08860276990235061,1381.1779301166534,293.4470090866089,1123.9277839660645,14703,3796,10907,10907,0,22,3889000.0
3889,3889999,20.80747345898097,38.014602215533344,0.08857307488876576,1381.4734966754913,293.51474046707153,1124.438564300537,14703,3796,10907,10907,0,22,3890000.0
3890,3890999,20.807628769806566,38.0145892857424,0.08853260339654934,1381.878606081009,293.5821511745453,1124.491626739502,14712,3798,10914,10914,0,22,3891000.0
3891,3891999,20.807763704726547,38.01459260532258,0.08850635202668367,1382.386907339096,293.6483335494995,1124.2985877990723,14729,3800,10929,10929,0,22,3892000.0
3892,3892999,20.80828975568919,38.0151589820395,0.08848207621445303,1382.6691386699677,293.7169134616852,1124.9244575500488,14733,3802,10931,10931,0,22,3893000.0
3893,3893999,20.808920431478104,38.018421074993235,0.0884542130752195,1383.0110321044922,293.78387689590454,1125.269718170166,14735,3803,10932,10932,0,22,3894000.0
3894,3894999,20.80976750896406,38.01865422882924,0.08844059154305117,1383.258082151413,293.85155987739563,1125.952449798584,14735,3803,10932,10932,0,22,3895000.0
3895,3895999,20.81109980371369,38.0199326781496,0.08842854785682408,1383.701852798462,293.91891384124756,1125.734661102295,14737,3804,10933,10933,0,22,3896000.0
3896,3896999,20.812907386991032,38.02306018846691,0.08841053732126114,1384.1145198345184,293.98950576782227,1125.7914924621582,14737,3804,10933,10933,0,22,3897000.0
3897,3897999,20.8146468906376,38.02585339412656,0.08839703010050526,1384.4733242988586,294.06241178512573,1126.1237602233887,14737,3804,10933,10933,0,22,3898000.0
3898,3898999,20.81628640750682,38.02886273094103,0.0883840198255138,1384.7245726585388,294.12800645828247,1126.889072418213,14737,3804,10933,10933,0,22,3899000.0
3899,3899999,20.818020662131826,38.03292590224239,0.08835660817046798,1385.106060743332,294.1939277648926,1126.9572944641113,14737,3804,10933,10933,0,22,3900000.0
3900,3900999,20.81968738873882,38.03369238246189,0.08834731115941186,1385.4203169345856,294.2603096961975,1127.3783531188965,14771,3807,10964,10964,0,22,3901000.0
3901,3901999,20.820343393372237,38.03268247439013,0.08832568754761316,1385.6676499843597,294.32764410972595,1128.081699371338,14771,3807,10964,10964,0,22,3902000.0
3902,3902999,20.821124161146777,38.03475545168259,0.08825592301520468,1385.8740317821503,294.39452266693115,1129.147792816162,14775,3807,10968,10968,0,22,3903000.0
3903,3903999,20.821102870725756,38.03306464385956,0.08818394018898168,1386.3221309185028,294.4610483646393,1128.9331321716309,14782,3809,10973,10973,0,22,3904000.0
3904,3904999,20.82079922560731,38.03111815398347,0.08813317064750958,1386.7434675693512,294.52817273139954,1128.787784576416,14784,3810,10974,10974,0,22,3905000.0
3905,3905999,20.82022622012403,38.03014363963229,0.08809765207054976,1387.1747725009918,294.5963490009308,1128.6589546203613,14784,3810,10974,10974,0,22,3906000.0
3906,3906999,20.819509124537728,38.02812509564649,0.088060506043811,1387.5047268867493,294.6639893054962,1128.9207038879395,14787,3811,10976,10976,0,22,3907000.0
3907,3907999,20.81871554237084,38.02602181044128,0.0880318530359242,1387.8578524589539,294.73310375213623,1129.1219062805176,14789,3812,10977,10977,0,22,3908000.0
3908,3908999,20.818165095143215,38.02659149874229,0.08799106775057819,1388.2908463478088,294.8004593849182,1128.961727142334,14809,3816,10993,10993,0,22,3909000.0
3909,3909999,20.817417887814308,38.024232064618374,0.08796121755974995,1388.675279378891,294.87037897109985,1129.1889152526855,14811,3817,10994,10994,0,22,3910000.0
3910,3910999,20.81730884880593,38.02338247402424,0.08792707616877427,1389.0126059055328,294.93938517570496,1129.635799407959,14813,3818,10995,10995,0,22,3911000.0
3911,3911999,20.817053581341835,38.02216158092759,0.08789320541779633,1389.3362736701965,295.00712513923645,1130.1209831237793,14814,3818,10996,10996,0,22,3912000.0
3912,3912999,20.817031347139146,38.02077136733962,0.08785740419769972,1389.6608033180237,295.0764973163605,1130.5860328674316,14816,3819,10997,10997,0,22,3913000.0
3913,3913999,20.81814562880426,38.028268850602906,0.08778421881222342,1389.9776883125305,295.14187574386597,1130.8829917907715,14816,3819,10997,10997,0,22,3914000.0
3914,3914999,20.81867944937125,38.02806980037553,0.08775351424381073,1390.3103578090668,295.2083168029785,1131.1268043518066,14816,3819,10997,10997,0,22,3915000.0
3915,3915999,20.819496558170115,38.028030356091016,0.08771145767101607,1390.6958408355713,295.2765734195709,1131.2357063293457,14818,3820,10998,10998,0,22,3916000.0
3916,3916999,20.820515475309655,38.02831283825932,0.08768632334109439,1390.8568425178528,295.34164094924927,1132.1940574645996,14818,3820,10998,10998,0,22,3917000.0
3917,3917999,20.821543902621855,38.02902985072987,0.08764922610615367,1391.3751256465912,295.40926003456116,1131.68696975708,14818,3820,10998,10998,0,22,3918000.0
3918,3918999,20.822993319257606,38.03019737899076,0.08762291826577906,1391.5540421009064,295.48189973831177,1132.6474800109863,14818,3820,10998,10998,0,22,3919000.0
3919,3919999,20.824305154424735,38.03097932676751,0.08761203410425833,1392.0271980762482,295.55595898628235,1132.301555633545,14820,3821,10999,10999,0,22,3920000.0
3920,3920999,20.825145670274914,38.03115720662991,0.0875928182640604,1392.4190638065338,295.6278190612793,1132.4518852233887,14822,3822,11000,11000,0,22,3921000.0
3921,3921999,20.827173887326865,38.035509770764605,0.0875640277413271,1392.7683749198914,295.69765424728394,1132.7163429260254,14822,3822,11000,11000,0,22,3922000.0
3922,3922999,20.82830027476027,38.03600292854411,0.08754217111037055,1392.9750671386719,295.7631299495697,1133.424747467041,14822,3822,11000,11000,0,22,3923000.0
3923,3923999,20.828427336020138,38.03503902817463,0.08751383092004184,1393.332291841507,295.8305401802063,1133.8239707946777,14827,3823,11004,11004,0,22,3924000.0
3924,3924999,20.82715747678511,38.03258269173298,0.0874800617582695,1393.5323083400726,295.8948001861572,1134.8609886169434,14828,3823,11005,11005,0,22,3925000.0
3925,3925999,20.826161243725025,38.03078753891324,0.08744582766581299,1393.8937108516693,295.9576380252838,1134.9719276428223,14831,3824,11007,11007,0,22,3926000.0
3926,3926999,20.825347308400648,38.029516041106085,0.08742154024742543,1394.2492578029633,296.02369117736816,1135.2006797790527,14835,3826,11009,11009,0,22,3927000.0
3927,3927999,20.824439257028864,38.027610519250736,0.08740118881833137,1394.6019840240479,296.08903527259827,1135.424015045166,14840,3828,11012,11012,0,22,3928000.0
3928,3928999,20.823510232601247,38.02618760737137,0.08737527417556734,1394.9549922943115,296.1533052921295,1135.6657981872559,14842,3829,11013,11013,0,22,3929000.0
3929,3929999,20.822773497216875,38.024009945746805,0.08734997216709972,1395.2383077144623,296.2176568508148,1136.1148567199707,14842,3829,11013,11013,0,22,3930000.0
3930,3930999,20.82223271946901,38.02195130488058,0.08732607361048073,1395.6237950325012,296.28493571281433,1136.099536895752,14846,3831,11015,11015,0,22,3931000.0
3931,3931999,20.821417054461737,38.01944613132859,0.08730580533661769,1395.9638109207153,296.3513011932373,1136.3065071105957,14848,3832,11016,11016,0,22,3932000.0
3932,3932999,20.820722898961183,38.017441115593435,0.08728625879153329,1396.4332604408264,296.4176366329193,1135.8840217590332,14852,3834,11018,11018,0,22,3933000.0
3933,3933999,20.820689597296347,38.02044549223958,0.08724728437391038,1396.9381663799286,296.4812092781067,1135.3969841003418,14860,3836,11024,11024,0,22,3934000.0
3934,3934999,20.82027345376481,38.01894803138281,0.08722416590441151,1397.2856934070587,296.54846453666687,1135.7852516174316,14860,3836,11024,11024,0,22,3935000.0
3935,3935999,20.82032609927383,38.018650335401205,0.08720274732896671,1397.6478803157806,296.6127920150757,1135.8611793518066,14862,3837,11025,11025,0,22,3936000.0
3936,3936999,20.821091116484673,38.01892174811722,0.0871731015741456,1398.133483171463,296.6839051246643,1135.506191253662,14864,3838,11026,11026,0,22,3937000.0
3937,3937999,20.822298431964946,38.02007738940487,0.08715708092279872,1398.4559557437897,296.74854493141174,1135.8900032043457,14868,3840,11028,11028,0,22,3938000.0
3938,3938999,20.823179713617463,38.020182077383296,0.08713606602616952,1398.9329767227173,296.81700134277344,1135.6297035217285,14881,3844,11037,11037,0,22,3939000.0
3939,3939999,20.82505841072444,38.02181577563465,0.08711298870266337,1399.3385441303253,296.88780093193054,1135.712070465088,14887,3847,11040,11040,0,22,3940000.0
3940,3940999,20.826825761152687,38.02319546950026,0.0871048515452314,1399.5935714244843,296.9540023803711,1136.3651008605957,14887,3847,11040,11040,0,22,3941000.0
3941,3941999,20.828839710672437,38.024610024442936,0.08709228211390307,1399.9867069721222,297.0209503173828,1136.4202690124512,14887,3847,11040,11040,0,22,3942000.0
3942,3942999,20.829766472726362,38.024259196124845,0.08708222850189007,1400.242047071457,297.0866708755493,1136.9519004821777,14887,3847,11040,11040,0,22,3943000.0
3943,3943999,20.83079646702737,38.024023408034964,0.0870717394002627,1400.7625057697296,297.15684723854065,1136.3727836608887,14891,3849,11042,11042,0,22,3944000.0
3944,3944999,20.83072239666885,38.022367325570826,0.0870609584954809,1401.0571451187134,297.2228946685791,1137.071865081787,14894,3849,11045,11045,0,22,3945000.0
3945,3945999,20.82987254919568,38.021975127137104,0.0870437299672806,1401.408285856247,297.2907602787018,1137.7051048278809,14957,3850,11107,11107,0,22,3946000.0
3946,3946999,20.829125498671118,38.02182809784579,0.08702930205337267,1401.8316459655762,297.35802125930786,1138.0574073791504,14961,3852,11109,11109,0,22,3947000.0
3947,3947999,20.828917155618896,38.02423651393108,0.08700876127110069,1402.2486708164215,297.42404770851135,1138.2456855773926,14965,3854,11111,11111,0,22,3948000.0
3948,3948999,20.82967066162789,38.02809032124571,0.08698294880649493,1402.6023738384247,297.4919366836548,1138.6538352966309,14968,3855,11113,11113,0,22,3949000.0
3949,3949999,20.830572248791984,38.03359245809512,0.08696743664537965,1402.956111907959,297.5586738586426,1139.0201835632324,14979,3858,11121,11121,0,22,3950000.0
3950,3950999,20.830794379056623,38.03536455213921,0.08696679304121557,1403.2083356380463,297.62669563293457,1139.8720817565918,14979,3858,11121,11121,0,22,3951000.0
3951,3951999,20.83138434039888,38.03836112699724,0.08696012145088083,1403.6079199314117,297.69309544563293,1139.7689476013184,14981,3859,11122,11122,0,22,3952000.0
3952,3952999,20.83243010840744,38.04116243376755,0.08696006733364203,1403.9500997066498,297.75975584983826,1140.095027923584,14983,3860,11123,11123,0,22,3953000.0
3953,3953999,20.83371671145202,38.0464382664437,0.0869526651515401,1404.2751383781433,297.82641100883484,1140.5290870666504,14983,3860,11123,11123,0,22,3954000.0
3954,3954999,20.834993188524958,38.049754053679706,0.08695863690240202,1404.6810252666473,297.8996615409851,1140.6665840148926,14985,3861,11124,11124,0,22,3955000.0
3955,3955999,20.83691932084869,38.05451510853173,0.08696150977979189,1404.9702303409576,297.9698414802551,1141.299388885498,14985,3861,11124,11124,0,22,3956000.0
3956,3956999,20.83817569807626,38.05777506549733,0.08696894811532074,1405.2915704250336,298.03516125679016,1141.673915863037,14985,3861,11124,11124,0,22,3957000.0
3957,3957999,20.839823273684253,38.06007852318796,0.08697956634606552,1405.5120458602905,298.10181975364685,1142.4241981506348,14992,3862,11130,11130,0,22,3958000.0
3958,3958999,20.841847047316307,38.063482693725696,0.08698540716681791,1405.9405915737152,298.16948771476746,1142.3143730163574,14994,3863,11131,11131,0,22,3959000.0
3959,3959999,20.84408035054967,38.06657681431321,0.08700441763412581,1406.350303888321,298.23654532432556,1142.3403205871582,14994,3863,11131,11131,0,22,3960000.0
3960,3960999,20.84707916760686,38.07110495174213,0.08702834165437234,1406.7290153503418,298.30358123779297,1142.5806159973145,14996,3864,11132,11132,0,22,3961000.0
3961,3961999,20.85177656990793,38.08950375070564,0.08701397589942605,1407.0376913547516,298.37008810043335,1142.9939460754395,14998,3865,11133,11133,0,22,3962000.0
3962,3962999,20.855658132151444,38.097666088882136,0.08702986147044978,1407.2843701839447,298.43651962280273,1143.6720085144043,14998,3865,11133,11133,0,22,3963000.0
3963,3963999,20.859943171709308,38.10702674199908,0.08702984067580144,1407.618979692459,298.50594210624695,1144.0248908996582,14998,3865,11133,11133,0,22,3964000.0
3964,3964999,20.863143085407195,38.11174111633224,0.08704553413095273,1408.0118744373322,298.5715835094452,1143.96635055542,14998,3865,11133,11133,0,22,3965000.0
3965,3965999,20.86394186242137,38.11540867410734,0.08703008949532376,1408.4326920509338,298.6403081417084,1144.2201347351074,14999,3865,11134,11134,0,22,3966000.0
3966,3966999,20.862836569270144,38.11589394637,0.08700462715938995,1408.6379671096802,298.7103159427643,1145.400691986084,15000,3865,11135,11135,0,22,3967000.0
3967,3967999,20.862353800864536,38.11657995114517,0.08697794953775917,1409.0436096191406,298.7777030467987,1145.445613861084,15007,3868,11139,11139,0,22,3968000.0
3968,3968999,20.862512402462738,38.11854178964255,0.08694973998585276,1409.3518636226654,298.8451957702637,1145.9431343078613,15027,3870,11157,11157,0,22,3969000.0
3969,3969999,20.86283223701142,38.11933893534777,0.08693260483040532,1409.8304407596588,298.9123854637146,1145.6287956237793,15032,3872,11160,11160,0,22,3970000.0
3970,3970999,20.863701312381554,38.120489745748614,0.08693218585535001,1410.2274904251099,298.9814431667328,1145.7136039733887,15036,3874,11162,11162,0,22,3971000.0
3971,3971999,20.86456388444985,38.12176136202936,0.08692448414398801,1410.5359644889832,299.0483229160309,1146.0087776184082,15038,3875,11163,11163,0,22,3972000.0
3972,3972999,20.866434403083456,38.12541744634014,0.08693094026961667,1410.921748638153,299.1171762943268,1146.0529289245605,15040,3876,11164,11164,0,22,3973000.0
3973,3973999,20.868607782014312,38.129392359315716,0.08694108784650734,1411.314177274704,299.1859269142151,1146.0438957214355,15044,3878,11166,11166,0,22,3974000.0
3974,3974999,20.871080492777278,38.13362790189977,0.08695462371386442,1411.751880645752,299.25623536109924,1145.898151397705,15046,3879,11167,11167,0,22,3975000.0
3975,3975999,20.875477698397066,38.14235850291474,0.08700020714989964,1412.091450214386,299.32365322113037,1146.2633476257324,15046,3879,11167,11167,0,22,3976000.0
3976,3976999,20.880999813946897,38.159123723176116,0.08702503666594985,1412.450726032257,299.39042496681213,1146.4416160583496,15048,3880,11168,11168,0,22,3977000.0
3977,3977999,20.886865202600116,38.169671806363255,0.08709266811212624,1412.9301402568817,299.45895504951477,1146.189022064209,15050,3881,11169,11169,0,22,3978000.0
3978,3978999,20.893297565741115,38.18132724715128,0.08717433549224218,1413.1846208572388,299.5303997993469,1146.9759101867676,15050,3881,11169,11169,0,22,3979000.0
3979,3979999,20.899439322518987,38.193972438247506,0.08724673259768057,1413.4050540924072,299.6000728607178,1147.6952476501465,15050,3881,11169,11169,0,22,3980000.0
3980,3980999,20.907369281820124,38.21306422134745,0.08734582350907416,1413.7714264392853,299.66855812072754,1147.8586311340332,15050,3881,11169,11169,0,22,3981000.0
3981,3981999,20.914332636030963,38.22725258015585,0.08741891512679689,1414.2611303329468,299.73841381073,1147.532527923584,15050,3881,11169,11169,0,22,3982000.0
3982,3982999,20.921474181523635,38.240889212640695,0.08755081354546967,1414.5841462612152,299.8082356452942,1147.8459434509277,15052,3882,11170,11170,0,22,3983000.0
3983,3983999,20.92776435767261,38.25025720771352,0.0876894047574962,1414.9807918071747,299.8774664402008,1147.7884101867676,15054,3883,11171,11171,0,22,3984000.0
3984,3984999,20.93451115649802,38.262485165641145,0.08781762975614826,1415.4914360046387,299.94570112228394,1147.4240074157715,15062,3885,11177,11177,0,22,3985000.0
3985,3985999,20.939741036296866,38.27251374777581,0.0879066899982115,1415.8132555484772,300.0137927532196,1148.0555839538574,15065,3886,11179,11179,0,22,3986000.0
3986,3986999,20.93859747479671,38.27158815080532,0.0878879210948802,1416.1653270721436,300.07673931121826,1148.4124717712402,15069,3888,11181,11181,0,22,3987000.0
3987,3987999,20.937510200237316,38.26984685269433,0.08787817409263354,1416.4014132022858,300.1398277282715,1149.2099723815918,15070,3888,11182,11182,0,22,3988000.0
3988,3988999,20.93697738737407,38.26879653046302,0.08785790716329189,1416.7457847595215,300.20378017425537,1149.5092124938965,15070,3888,11182,11182,0,22,3989000.0
3989,3989999,20.936569312782133,38.26906265036444,0.08783196822078354,1417.0953123569489,300.2689778804779,1149.7486534118652,15073,3889,11184,11184,0,22,3990000.0
3990,3990999,20.935759779631987,38.26725502774114,0.08781051848768018,1417.6629605293274,300.33499217033386,1149.1142234802246,15077,3891,11186,11186,0,22,3991000.0
3991,3991999,20.93493751791794,38.26512718865851,0.08779972814757897,1417.8202245235443,300.39763355255127,1150.256435394287,15077,3891,11186,11186,0,22,3992000.0
3992,3992999,20.934489568808146,38.26396469157686,0.08778253846624484,1418.144326210022,300.4612739086151,1150.4853782653809,15085,3893,11192,11192,0,22,3993000.0
3993,3993999,20.93435993069957,38.2632437847698,0.08775894745077906,1418.5867657661438,300.5275297164917,1150.2349433898926,15085,3893,11192,11192,0,22,3994000.0
3994,3994999,20.934110948628714,38.262200525256084,0.08773859892135838,1418.834676027298,300.5929117202759,1150.8933372497559,15085,3893,11192,11192,0,22,3995000.0
3995,3995999,20.933986936367596,38.26145572438928,0.08771293351421217,1419.1854047775269,300.65557193756104,1150.9002876281738,15094,3895,11199,11199,0,22,3996000.0
3996,3996999,20.93460262127139,38.26181252122961,0.08768621357818451,1419.6869797706604,300.71996331214905,1150.387783050537,15118,3898,11220,11220,0,22,3997000.0
3997,3997999,20.935471812349945,38.26194495319434,0.08766481430924122,1420.1618101596832,300.7830185890198,1150.0072898864746,15122,3900,11222,11222,0,22,3998000.0
3998,3998999,20.93714055623974,38.264144083999994,0.08765742898746565,1420.5761151313782,300.84754371643066,1149.920467376709,15128,3903,11225,11225,0,22,3999000.0
3999,3999999,20.93836159491959,38.26480849247061,0.08766160165997927,1420.8714532852173,300.9124517440796,1150.4494132995605,15135,3904,11231,11231,0,22,4000000.0
4000,4000999,20.939773260010643,38.26599012580635,0.08767092643511998,1421.3320291042328,300.979140996933,1150.1348762512207,15135,3904,11231,11231,0,22,4001000.0
4001,4001999,20.94136807990086,38.266922455228766,0.0876722692141867,1421.6285030841827,301.0434355735779,1150.553783416748,15137,3905,11232,11232,0,22,4002000.0
4002,4002999,20.942109278892445,38.26618402578286,0.08769411756813483,1421.9533393383026,301.10923075675964,1150.84224319458,15139,3906,11233,11233,0,22,4003000.0
4003,4003999,20.943274365593172,38.266169048695815,0.08772418820003425,1422.2613697052002,301.1762297153473,1151.2236289978027,15139,3906,11233,11233,0,22,4004000.0
4004,4004999,20.944359948539006,38.266092232840485,0.08773019733102017,1422.687094449997,301.2437403202057,1151.1359062194824,15143,3908,11235,11235,0,22,4005000.0
4005,4005999,20.945426112531173,38.2655340544057,0.08776578799867596,1423.00111246109,301.31376338005066,1151.5993690490723,15150,3909,11241,11241,0,22,4006000.0
4006,4006999,20.9454713065459,38.26388577596738,0.0877917115735144,1423.4629595279694,301.3814494609833,1151.3712425231934,15152,3910,11242,11242,0,22,4007000.0
4007,4007999,20.943925505227938,38.260960921105,0.08778762826045272,1423.8619451522827,301.44996404647827,1151.632610321045,15153,3910,11243,11243,0,22,4008000.0
4008,4008999,20.94225023040901,38.25901298195678,0.08778541912043747,1424.2641212940216,301.5204927921295,1151.8493614196777,15169,3911,11258,11258,0,22,4009000.0
4009,4009999,20.940920780602166,38.259572279172914,0.08776628798622021,1424.6322622299194,301.588876247406,1152.1450004577637,15171,3912,11259,11259,0,22,4010000.0
4010,4010999,20.939374260770723,38.25687746789154,0.08776816063974335,1424.8778545856476,301.6561450958252,1152.981533050537,15172,3912,11260,11260,0,22,4011000.0
4011,4011999,20.93781402911215,38.25406013609908,0.0877667205570456,1425.3112111091614,301.7257413864136,1152.9549293518066,15174,3913,11261,11261,0,22,4012000.0
4012,4012999,20.936432765148634,38.25135586889718,0.0877623585843691,1425.726492881775,301.79476857185364,1153.0220909118652,15176,3914,11262,11262,0,22,4013000.0
4013,4013999,20.935067401382796,38.248801007380735,0.08775539016858536,1426.0859112739563,301.86378741264343,1153.2306785583496,15176,3914,11262,11262,0,22,4014000.0
4014,4014999,20.93396904990775,38.247107496969456,0.08774515231181812,1426.4769070148468,301.9337556362152,1153.2578163146973,15177,3915,11262,11262,0,22,4015000.0
4015,4015999,20.932681401281023,38.24441557636931,0.08774261539221007,1426.8236861228943,302.00339102745056,1153.5873069763184,15177,3915,11262,11262,0,22,4016000.0
4016,4016999,20.931648728815077,38.243748262778595,0.08772851835643503,1427.2421696186066,302.0752372741699,1153.5650901794434,15183,3917,11266,11266,0,22,4017000.0
4017,4017999,20.930723629061188,38.24154169016577,0.08771915213291481,1427.6492311954498,302.1489441394806,1153.5743141174316,15184,3918,11266,11266,0,22,4018000.0
4018,4018999,20.929853196623657,38.239376215093834,0.08770841204740876,1428.0283753871918,302.22130131721497,1153.71390914917,15184,3918,11266,11266,0,22,4019000.0
4019,4019999,20.930004754425163,38.24486677443909,0.08766203969476616,1428.391034603119,302.2909302711487,1153.9016227722168,15186,3919,11267,11267,0,22,4020000.0
4020,4020999,20.929852622356783,38.2444683321673,0.0876449796963289,1428.6903386116028,302.3610496520996,1154.2896842956543,15186,3919,11267,11267,0,22,4021000.0
4021,4021999,20.930447823944007,38.246412191828206,0.08761402258784767,1429.0817830562592,302.43407130241394,1154.397762298584,15188,3920,11268,11268,0,22,4022000.0
4022,4022999,20.931013942768512,38.245457523844316,0.08759912153173932,1429.5220324993134,302.5045120716095,1154.1412086486816,15198,3923,11275,11275,0,22,4023000.0
4023,4023999,20.931845040383834,38.24666445701102,0.08757453789731928,1430.0752575397491,302.57601046562195,1153.5374870300293,15202,3925,11277,11277,0,22,4024000.0
4024,4024999,20.93242013314346,38.245777817946504,0.08756386733632515,1430.3868939876556,302.6478531360626,1154.1773796081543,15220,3926,11294,11294,0,22,4025000.0
4025,4025999,20.9319459534028,38.244024472254026,0.08754796683054766,1430.7941088676453,302.7185320854187,1154.1762428283691,15221,3927,11294,11294,0,22,4026000.0
4026,4026999,20.930665263237323,38.24166595520719,0.08754469219646355,1431.0711195468903,302.78123688697815,1154.9314994812012,15223,3927,11296,11296,0,22,4027000.0
4027,4027999,20.92941039250327,38.240781804300795,0.08753459215839576,1431.5102338790894,302.8474106788635,1154.7436256408691,15227,3929,11298,11298,0,22,4028000.0
4028,4028999,20.92789386119991,38.23781864752974,0.08753786893823468,1432.0082049369812,302.9127175807953,1154.436107635498,15229,3930,11299,11299,0,22,4029000.0
4029,4029999,20.92633284278658,38.23529857220798,0.08753562264077641,1432.3743238449097,302.9781222343445,1154.5736503601074,15234,3932,11302,11302,0,22,4030000.0
4030,4030999,20.924914855919162,38.23378835017987,0.08752867412118581,1432.7079622745514,303.0431880950928,1154.9129524230957,15234,3932,11302,11302,0,22,4031000.0
4031,4031999,20.923298632367008,38.23059774953961,0.08752609934238353,1433.106990814209,303.1095061302185,1154.949634552002,15238,3934,11304,11304,0,22,4032000.0
4032,4032999,20.922081848077042,38.229099570105426,0.0875094996666127,1433.4031145572662,303.17479062080383,1155.305965423584,15238,3934,11304,11304,0,22,4033000.0
4033,4033999,20.921158017072553,38.23281103931384,0.08747211730741533,1433.793205022812,303.24130487442017,1155.2292823791504,15240,3935,11305,11305,0,22,4034000.0
4034,4034999,20.920090967026297,38.23113229112701,0.08746490892598957,1434.2162120342255,303.30678820610046,1155.1097373962402,15247,3936,11311,11311,0,22,4035000.0
4035,4035999,20.919312413877613,38.22989274413484,0.08744366315201824,1434.4556894302368,303.37258648872375,1155.74849319458,15247,3936,11311,11311,0,22,4036000.0
4036,4036999,20.918722027483252,38.23096791014279,0.087411267141564,1434.9992010593414,303.4438691139221,1155.1408805847168,15247,3936,11311,11311,0,22,4037000.0
4037,4037999,20.91829874117928,38.22949943135257,0.08739329496266035,1435.3720905780792,303.51049757003784,1155.193515777588,15261,3938,11323,11323,0,22,4038000.0
4038,4038999,20.917937846178667,38.22897933487053,0.0873711511631432,1441.4551746845245,303.5771961212158,1155.2650260925293,15261,3938,11323,11323,0,22,4039000.0
4039,4039999,20.91813148496646,38.23064581843932,0.0873291757259248,1441.9219641685486,303.6446352005005,1154.92134475708,15268,3939,11329,11329,0,22,4040000.0
4040,4040999,20.917885377989514,38.22937792374592,0.08731116205450717,1442.301724910736,303.7118020057678,1155.0470161437988,15268,3939,11329,11329,0,22,4041000.0
4041,4041999,20.91877752285566,38.229534036753456,0.08728229856725456,1442.646065711975,303.7780740261078,1155.257724761963,15270,3940,11330,11330,0,22,4042000.0
4042,4042999,20.919030531544532,38.228663814491156,0.08726213514081205,1442.9858417510986,303.844491481781,1155.3375511169434,15271,3941,11330,11330,0,22,4043000.0
4043,4043999,20.919859866682618,38.22868571802443,0.08723375843708181,1443.31250166893,303.91327595710754,1155.6373252868652,15271,3941,11330,11330,0,22,4044000.0
4044,4044999,20.920878962603393,38.22861364420432,0.08720798492748172,1443.6961901187897,303.97913575172424,1155.655101776123,15272,3942,11330,11330,0,22,4045000.0
4045,4045999,20.92140272558978,38.22755822535208,0.08718943245447741,1443.9525032043457,304.0468888282776,1156.211826324463,15274,3943,11331,11331,0,22,4046000.0
4046,4046999,20.920887021160777,38.22643581425914,0.08717312675448152,1444.2463128566742,304.1123321056366,1156.8100624084473,15275,3943,11332,11332,0,22,4047000.0
4047,4047999,20.918972346641745,38.22532138649952,0.08717216937895267,1444.4903047084808,304.1784174442291,1157.6135368347168,15275,3943,11332,11332,0,22,4048000.0
4048,4048999,20.9171881071328,38.22250975729194,0.08717362691880637,1445.0032749176025,304.24636054039,1157.02290725708,15275,3943,11332,11332,0,22,4049000.0
4049,4049999,20.915720626899667,38.22036388400316,0.08716837151727008,1445.4604315757751,304.31478691101074,1156.7773475646973,15277,3944,11333,11333,0,22,4050000.0
4050,4050999,20.91429782294286,38.217543233216055,0.08716467831640495,1445.8267986774445,304.38868045806885,1157.1808815002441,15281,3945,11336,11336,0,22,4051000.0
4051,4051999,20.913206475698285,38.215162759836275,0.08715420626613612,1446.3032977581024,304.45500588417053,1156.7605323791504,15290,3947,11343,11343,0,22,4052000.0
4052,4052999,20.912565488256618,38.213742928292824,0.0871436535991098,1446.6418516635895,304.52341532707214,1157.0063972473145,15290,3947,11343,11343,0,22,4053000.0
4053,4053999,20.912175388117777,38.2125107947808,0.08712953853396455,1446.837275505066,304.58887362480164,1157.775676727295,15290,3947,11343,11343,0,22,4054000.0
4054,4054999,20.91188350475097,38.21146283208131,0.08712038976739256,1447.3617565631866,304.6569941043854,1157.1288108825684,15312,3949,11363,11363,0,22,4055000.0
4055,4055999,20.91199204999824,38.21154086540203,0.08710054275159085,1447.8737936019897,304.7237138748169,1156.8414192199707,15318,3952,11366,11366,0,22,4056000.0
4056,4056999,20.912377548699556,38.21222179637254,0.08711087361137004,1448.2637906074524,304.7924506664276,1156.9589729309082,15320,3953,11367,11367,0,22,4057000.0
4057,4057999,20.913059842914144,38.21332110147013,0.08711420073592258,1448.7599754333496,304.8609993457794,1156.4665565490723,15329,3955,11374,11374,0,22,4058000.0
4058,4058999,20.913909687165678,38.2154951315117,0.08710818735137993,1449.0850658416748,304.9276075363159,1156.7652168273926,15333,3957,11376,11376,0,22,4059000.0
4059,4059999,20.915067204628016,38.21734234563846,0.0870971595349398,1449.689959526062,304.9958727359772,1155.7737159729004,15339,3960,11379,11379,0,22,4060000.0
4060,4060999,20.91632011937327,38.21875196404509,0.08707447846694516,1450.03453707695,305.0634231567383,1156.2738761901855,15339,3960,11379,11379,0,22,4061000.0
4061,4061999,20.917941214438745,38.221201167631456,0.0870748219128179,1450.283378124237,305.1316566467285,1156.9839515686035,15341,3961,11380,11380,0,22,4062000.0
4062,4062999,20.919915765624527,38.22376103278091,0.08707564932151668,1450.5377976894379,305.2010681629181,1157.518268585205,15341,3961,11380,11380,0,22,4063000.0
4063,4063999,20.921990184691385,38.22577706406949,0.08706283951022264,1450.8100357055664,305.26983165740967,1157.9486274719238,15343,3962,11381,11381,0,22,4064000.0
4064,4064999,20.923560898658657,38.2271460299433,0.08704996420985123,1451.1451828479767,305.33837723731995,1158.1304740905762,15345,3963,11382,11382,0,22,4065000.0
4065,4065999,20.925608724989257,38.22876846555344,0.08703599164797993,1451.6858794689178,305.40693736076355,1157.504810333252,15347,3964,11383,11383,0,22,4066000.0
4066,4066999,20.926884497212914,38.22870921207555,0.08703539354955003,1452.0766832828522,305.47549390792847,1157.559284210205,15347,3964,11383,11383,0,22,4067000.0
4067,4067999,20.928314655161458,38.23144526979009,0.08701628526443561,1452.5313832759857,305.54373359680176,1157.6624183654785,15350,3964,11386,11386,0,22,4068000.0
4068,4068999,20.926880474684918,38.22860719599084,0.08700362387002158,1452.8699178695679,305.60677003860474,1158.2314186096191,15351,3964,11387,11387,0,22,4069000.0
4069,4069999,20.92552160744332,38.2265000093569,0.0869960031696082,1453.0809500217438,305.6709785461426,1159.170093536377,15351,3964,11387,11387,0,22,4070000.0
4070,4070999,20.9245265476286,38.22679254944868,0.08697548050894999,1453.4289150238037,305.7362039089203,1159.3642921447754,15354,3965,11389,11389,0,22,4071000.0
4071,4071999,20.923253094838174,38.22409545993894,0.08696581655005475,1453.7421915531158,305.79940032958984,1159.8499946594238,15357,3966,11391,11391,0,22,4072000.0
4072,4072999,20.921869214851274,38.221768646183826,0.08696066919055012,1454.238189458847,305.86477732658386,1159.2572135925293,15361,3968,11393,11393,0,22,4073000.0
4073,4073999,20.920685023109634,38.22002275193345,0.08695859949838947,1454.6355409622192,305.9289367198944,1159.2653007507324,15363,3969,11394,11394,0,22,4074000.0
4074,4074999,20.9193987735845,38.21722909074348,0.08694832877677128,1455.0693821907043,305.9962511062622,1159.1202812194824,15367,3971,11396,11396,0,22,4075000.0
4075,4075999,20.918451372698815,38.21554792726859,0.08692302855895129,1455.3383960723877,306.0596601963043,1159.6802711486816,15367,3971,11396,11396,0,22,4076000.0
4076,4076999,20.917131658261237,38.21269247699416,0.08691384298747529,1455.8216905593872,306.12745666503906,1159.2626457214355,15369,3972,11397,11397,0,22,4077000.0
4077,4077999,20.916116105821803,38.21060101694368,0.08690210917499097,1456.2160949707031,306.19178223609924,1159.3085289001465,15371,3973,11398,11398,0,22,4078000.0
4078,4078999,20.91491197937854,38.2081907879762,0.08689204312006671,1456.4878599643707,306.2568054199219,1159.9048194885254,15371,3973,11398,11398,0,22,4079000.0
4079,4079999,20.913910727680904,38.20607875076624,0.08687661864243068,1456.7763249874115,306.32478880882263,1160.3399620056152,15371,3973,11398,11398,0,22,4080000.0
4080,4080999,20.91326388766478,38.204526777203085,0.08685977269239842,1457.2221565246582,306.3910322189331,1160.046054840088,15373,3974,11399,11399,0,22,4081000.0
4081,4081999,20.912394212691705,38.20218483789947,0.08684500725101485,1457.5281419754028,306.4551522731781,1160.3568382263184,15373,3974,11399,11399,0,22,4082000.0
4082,4082999,20.911794013286073,38.2039592308487,0.08681546037587962,1457.9742741584778,306.5221154689789,1160.100269317627,15375,3975,11400,11400,0,22,4083000.0
4083,4083999,20.91153023136191,38.20283907808187,0.08680022546017019,1458.3244001865387,306.5907459259033,1160.4467430114746,15375,3975,11400,11400,0,22,4084000.0
4084,4084999,20.911101394694498,38.20129715738151,0.08678747302167755,1458.6801385879517,306.65528178215027,1160.5765342712402,15377,3976,11401,11401,0,22,4085000.0
4085,4085999,20.91037123649809,38.199196625375045,0.08677917918726952,1459.0880031585693,306.7200894355774,1160.470890045166,15385,3978,11407,11407,0,22,4086000.0
4086,4086999,20.909868620033613,38.19714515150495,0.08676595060048664,1459.5816323757172,306.78458285331726,1159.979549407959,15385,3978,11407,11407,0,22,4087000.0
4087,4087999,20.909435839802683,38.19502125298808,0.08675324795869777,1459.8538336753845,306.850332736969,1160.5035667419434,15387,3979,11408,11408,0,22,4088000.0
4088,4088999,20.908490506874838,38.1926261948774,0.08674586390288197,1460.2773368358612,306.91624903678894,1160.401782989502,15387,3979,11408,11408,0,22,4089000.0
4089,4089999,20.909747149312356,38.19368333851156,0.08653838679268666,1460.5423481464386,306.981915473938,1161.2221336364746,15392,3980,11412,11412,0,22,4090000.0
4090,4090999,20.90968454492123,38.192523111248306,0.08643160094012625,1460.8900866508484,307.04866552352905,1161.392002105713,15395,3981,11414,11414,0,22,4091000.0
4091,4091999,20.908905480652038,38.1909769931828,0.08635558849287484,1461.3507318496704,307.11754870414734,1161.1042518615723,15400,3983,11417,11417,0,22,4092000.0
4092,4092999,20.90811041836478,38.18905940676793,0.08630721755007309,1461.800462961197,307.18694162368774,1161.137752532959,15402,3984,11418,11418,0,22,4093000.0
4093,4093999,20.907452036803544,38.18759326026143,0.08625594184134977,1462.107760667801,307.253319978714,1161.5409889221191,15403,3984,11419,11419,0,22,4094000.0
4094,4094999,20.906868375443164,38.18615355727878,0.08620293621180697,1462.4753704071045,307.3196725845337,1161.6793098449707,15403,3984,11419,11419,0,22,4095000.0
4095,4095999,20.905932786348178,38.18395760009495,0.08615963256904358,1462.7973728179932,307.3873429298401,1161.9215507507324,15407,3986,11421,11421,0,22,4096000.0
4096,4096999,20.905055813420475,38.181809375484235,0.08613363006096375,1463.213764667511,307.4550271034241,1161.7468605041504,15411,3988,11423,11423,0,22,4097000.0
4097,4097999,20.904068985947326,38.1802741714085,0.0861134234030716,1463.6215591430664,307.5223503112793,1161.7186698913574,15415,3990,11425,11425,0,22,4098000.0
4098,4098999,20.903155725145986,38.1788143704819,0.08609407793323998,1463.9571068286896,307.5900490283966,1162.0434913635254,15417,3991,11426,11426,0,22,4099000.0
4099,4099999,20.902283861136446,38.17730662192103,0.08607235256425994,1464.408590555191,307.65857887268066,1161.879825592041,15420,3993,11427,11427,0,22,4100000.0
4100,4100999,20.901998178374996,38.17621874024306,0.08603874881292617,1464.7857542037964,307.7253837585449,1162.0668983459473,15422,3994,11428,11428,0,22,4101000.0
4101,4101999,20.902332925409596,38.18061576704927,0.08598922274788245,1465.0725228786469,307.79465341567993,1162.5387382507324,15422,3994,11428,11428,0,22,4102000.0
4102,4102999,20.90243408879052,38.17952921597263,0.08596023046764067,1465.4456803798676,307.86546421051025,1162.7048149108887,15424,3995,11429,11429,0,22,4103000.0
4103,4103999,20.902871119237002,38.17913712758855,0.08593416657330522,1465.8354623317719,307.93699860572815,1162.737705230713,15424,3995,11429,11429,0,22,4104000.0
4104,4104999,20.903213132768002,38.178970232914196,0.08590642136608773,1466.2207236289978,308.00649547576904,1162.7963218688965,15424,3995,11429,11429,0,22,4105000.0
4105,4105999,20.903630281552978,38.17852874076803,0.08587927653623584,1466.624323606491,308.0762825012207,1163.0673027038574,15442,3997,11445,11445,0,22,4106000.0
4106,4106999,20.90430734437134,38.17817101435871,0.08585928467867987,1466.8213200569153,308.14597964286804,1164.22310256958,15442,3997,11445,11445,0,22,4107000.0
4107,4107999,20.90478481836167,38.17756180028988,0.08584894904277995,1467.0234332084656,308.2150762081146,1165.138240814209,15442,3997,11445,11445,0,22,4108000.0
4108,4108999,20.905735441078352,38.177126115564505,0.08583990215234727,1467.3168740272522,308.2831394672394,1165.573398590088,15442,3997,11445,11445,0,22,4109000.0
4109,4109999,20.906051292173,38.17562502103942,0.08583369497231386,1467.6459600925446,308.35106682777405,1165.7492713928223,15442,3997,11445,11445,0,22,4110000.0
4110,4110999,20.90618757952155,38.174369320080615,0.08581282533463241,1468.2091014385223,308.42091512680054,1165.2139778137207,15445,3998,11447,11447,0,22,4111000.0
4111,4111999,20.905552888472826,38.17210963517086,0.0858036633624446,1468.5752189159393,308.4911165237427,1165.5999717712402,15451,4000,11451,11451,0,22,4112000.0
4112,4112999,20.904698196290564,38.170059785566195,0.08583673762728516,1468.9039607048035,308.56345105171204,1166.058879852295,15451,4000,11451,11451,0,22,4113000.0
4113,4113999,20.904483222611578,38.169506702625384,0.08587831887142594,1469.3485956192017,308.63639211654663,1165.993579864502,15451,4000,11451,11451,0,22,4114000.0
4114,4114999,20.90421418466772,38.16912443915382,0.08590520610204089,1469.6959064006805,308.70311880111694,1166.1790885925293,15454,4001,11453,11453,0,22,4115000.0
4115,4115999,20.903686028183298,38.16746270013309,0.08595700091340652,1470.2626893520355,308.772989988327,1165.5849952697754,15465,4004,11461,11461,0,22,4116000.0
4116,4116999,20.903436251098285,38.16607462390108,0.08601052603498671,1470.6280477046967,308.8453209400177,1165.7873497009277,15472,4005,11467,11467,0,22,4117000.0
4117,4117999,20.90317302578487,38.16574861916313,0.08604214922120834,1470.9705102443695,308.9141790866852,1166.0732383728027,15472,4005,11467,11467,0,22,4118000.0
4118,4118999,20.903173364902116,38.1688553060726,0.08603925561116976,1471.283531665802,308.98363971710205,1166.4698524475098,15472,4005,11467,11467,0,22,4119000.0
4119,4119999,20.903407305686386,38.168655512595414,0.08606493640965152,1471.5555217266083,309.0536205768585,1166.8985023498535,15473,4006,11467,11467,0,22,4120000.0
4120,4120999,20.903797553828177,38.168620922192474,0.08608690286184184,1471.975668668747,309.1240670681,1166.798252105713,15473,4006,11467,11467,0,22,4121000.0
4121,4121999,20.90504462662921,38.170169291221086,0.08606236650086796,1472.3765363693237,309.19463658332825,1166.8232460021973,15473,4006,11467,11467,0,22,4122000.0
4122,4122999,20.906651226956903,38.171693579619834,0.0860611078677106,1472.8333406448364,309.2667737007141,1166.463436126709,15474,4007,11467,11467,0,22,4123000.0
4123,4123999,20.908366544008878,38.173447479491955,0.08607050341835931,1473.10054063797,309.3379259109497,1167.187572479248,15476,4008,11468,11468,0,22,4124000.0
4124,4124999,20.910584276413232,38.17762586370789,0.08607590035213075,1473.3962144851685,309.40797328948975,1167.6430549621582,15476,4008,11468,11468,0,22,4125000.0
4125,4125999,20.912591139222286,38.179566402780196,0.08608095687668949,1473.7750272750854,309.4825096130371,1167.7552070617676,15480,4010,11470,11470,0,22,4126000.0
4126,4126999,20.915239937245584,38.18264356212742,0.08611136990483736,1474.1379628181458,309.5541093349457,1167.941722869873,15480,4010,11470,11470,0,22,4127000.0
4127,4127999,20.917614746339183,38.184894818561325,0.08612108249579642,1474.6886868476868,309.6280975341797,1167.5339469909668,15489,4012,11477,11477,0,22,4128000.0
4128,4128999,20.921176435660655,38.19307352964872,0.08615633081483731,1475.0328876972198,309.6990475654602,1167.78364944458,15490,4013,11477,11477,0,22,4129000.0
4129,4129999,20.924164088568382,38.195709416077925,0.08616593087890745,1475.506584405899,309.7734155654907,1167.5242195129395,15542,4014,11528,11528,0,22,4130000.0
4130,4130999,20.926340568201887,38.19674315927782,0.08619005478399178,1475.883231163025,309.8453176021576,1167.7652626037598,15549,4015,11534,11534,0,22,4131000.0
4131,4131999,20.927186691250714,38.19853104754584,0.08617440991041003,1476.2561135292053,309.91400957107544,1168.18599319458,15552,4015,11537,11537,0,22,4132000.0
4132,4132999,20.926896795583183,38.19920265663101,0.0861205072514496,1476.5379076004028,309.976594209671,1168.7293968200684,15552,4015,11537,11537,0,22,4133000.0
4133,4133999,20.92625898815861,38.1984643226021,0.08608293639745268,1477.0434334278107,310.04022240638733,1168.2538795471191,15552,4015,11537,11537,0,22,4134000.0
4134,4134999,20.925783690896363,38.197885348476376,0.08605005375039687,1477.384194135666,310.1060540676117,1168.6309700012207,15552,4015,11537,11537,0,22,4135000.0
4135,4135999,20.92598025521042,38.198744408209585,0.08598351032200424,1477.739828824997,310.17240834236145,1168.8653678894043,15555,4016,11539,11539,0,22,4136000.0
4136,4136999,20.92577375602364,38.19744389078405,0.08594160996340983,1478.1695067882538,310.23699474334717,1168.7625923156738,15557,4017,11540,11540,0,22,4137000.0
4137,4137999,20.92554650236956,38.19574813779613,0.0859054747902086,1478.4768126010895,310.30253887176514,1169.2887153625488,15570,4018,11552,11552,0,22,4138000.0
4138,4138999,20.92531878015735,38.194317404555875,0.08586145138968959,1478.7735307216644,310.36788725852966,1169.6359901428223,15574,4020,11554,11554,0,22,4139000.0
4139,4139999,20.924990731770823,38.19329556130633,0.08582691043535184,1479.2155301570892,310.43586683273315,1169.4082145690918,15582,4024,11558,11558,0,22,4140000.0
4140,4140999,20.924537202850228,38.19133582347982,0.08581177678831287,1479.5961301326752,310.5007219314575,1169.5720863342285,15584,4025,11559,11559,0,22,4141000.0
4141,4141999,20.924286763981772,38.190893638137375,0.08580040466621719,1479.9068903923035,310.5654265880585,1170.0020866394043,15586,4026,11560,11560,0,22,4142000.0
4142,4142999,20.92453046549499,38.190707156806205,0.0857863552963225,1480.1728301048279,310.6301202774048,1170.5449028015137,15586,4026,11560,11560,0,22,4143000.0
4143,4143999,20.925440360240156,38.19667361048976,0.08575893998742978,1480.5747244358063,310.6950521469116,1170.3713569641113,15588,4027,11561,11561,0,22,4144000.0
4144,4144999,20.92695326586316,38.19933492688261,0.08574560068877901,1480.8607604503632,310.76065945625305,1170.7524299621582,15588,4027,11561,11561,0,22,4145000.0
4145,4145999,20.929312538571892,38.20773087951338,0.08573247591379307,1481.4025509357452,310.82848262786865,1170.0210151672363,15592,4029,11563,11563,0,22,4146000.0
4146,4146999,20.932682453126926,38.21833680679693,0.08572269109351971,1481.694712638855,310.8935432434082,1170.3755683898926,15592,4029,11563,11563,0,22,4147000.0
4147,4147999,20.939009759848897,38.23489982734478,0.08573848944704254,1482.0923190116882,310.96049070358276,1170.428554534912,15594,4030,11564,11564,0,22,4148000.0
4148,4148999,20.944977961331073,38.250703963961584,0.08577810332294322,1482.4007861614227,311.02597308158875,1170.8279838562012,15596,4031,11565,11565,0,22,4149000.0
4149,4149999,20.950279658577873,38.26089101735681,0.08583287204016443,1482.7290754318237,311.09190607070923,1171.077480316162,15598,4032,11566,11566,0,22,4150000.0
4150,4150999,20.956646425540928,38.275198072771055,0.0858739849025284,1483.1514294147491,311.158572435379,1170.9591331481934,15600,4033,11567,11567,0,22,4151000.0
4151,4151999,20.962684628061478,38.286216709932305,0.08595004382683247,1483.8228409290314,311.22540068626404,1169.768497467041,15606,4036,11570,11570,0,22,4152000.0
4152,4152999,20.96520067349101,38.29000438630312,0.08595592710268096,1484.3199598789215,311.29173827171326,1169.8713417053223,15618,4038,11580,11580,0,22,4153000.0
4153,4153999,20.963512485994194,38.28804911397079,0.08594943409317146,1484.5218136310577,311.3598527908325,1171.0379905700684,15619,4038,11581,11581,0,22,4154000.0
4154,4154999,20.96210013363761,38.28654068316384,0.08593790208432095,1484.77720785141,311.4251308441162,1171.7690086364746,15619,4038,11581,11581,0,22,4155000.0
4155,4155999,20.961268596537266,38.28741085047324,0.08591482207679613,1485.1610143184662,311.4901261329651,1171.9768257141113,15637,4039,11598,11598,0,22,4156000.0
4156,4156999,20.96064922838616,38.28638273100061,0.08589560149320119,1485.5814034938812,311.5564284324646,1171.9158744812012,15642,4041,11601,11601,0,22,4157000.0
4157,4157999,20.95944840211271,38.28383576179521,0.08588815577948405,1485.9206817150116,311.62227845191956,1172.1940803527832,15644,4042,11602,11602,0,22,4158000.0
4158,4158999,20.95841451772286,38.282045960831056,0.08587240602286594,1486.2132847309113,311.6905872821808,1172.68257522583,15644,4042,11602,11602,0,22,4159000.0
4159,4159999,20.95765894155932,38.28029305994876,0.08585689228109972,1486.644021987915,311.7572181224823,1172.5894660949707,15645,4042,11603,11603,0,22,4160000.0
4160,4160999,20.956915767826473,38.27932851150597,0.08583830296878614,1487.0268743038177,311.8241443634033,1172.648380279541,15652,4044,11608,11608,0,22,4161000.0
4161,4161999,20.95650434691456,38.278386894022645,0.08581561600987764,1487.3108649253845,311.8927855491638,1173.1212348937988,15652,4044,11608,11608,0,22,4162000.0
4162,4162999,20.956529067736806,38.278121882001564,0.08579085949864007,1487.8412580490112,311.9633457660675,1172.6842460632324,15652,4044,11608,11608,0,22,4163000.0
4163,4163999,20.956892236360517,38.278086128023965,0.08576216143576376,1488.253237247467,312.03078508377075,1172.6743049621582,15654,4045,11609,11609,0,22,4164000.0
4164,4164999,20.958017017812818,38.2797345018495,0.08572209301109224,1488.587455034256,312.09767985343933,1173.025707244873,15654,4045,11609,11609,0,22,4165000.0
4165,4165999,20.958813488603536,38.28029473382132,0.08569311120664846,1489.0472316741943,312.1688151359558,1172.6986274719238,15657,4047,11610,11610,0,22,4166000.0
4166,4166999,20.960764209068262,38.28672873506092,0.08564401217718665,1489.43634724617,312.23849725723267,1172.8177680969238,15657,4047,11610,11610,0,22,4167000.0
4167,4167999,20.961529570714106,38.286981158229686,0.08561792526714063,1489.8666317462921,312.3061566352844,1172.6799125671387,15657,4047,11610,11610,0,22,4168000.0
4168,4168999,20.962405820451508,38.2870137700151,0.08559672999409385,1490.2162442207336,312.37424778938293,1172.898723602295,15658,4048,11610,11610,0,22,4169000.0
4169,4169999,20.963330253951153,38.28728023481736,0.08557474376007945,1490.467449426651,312.4430122375488,1173.5012092590332,15658,4048,11610,11610,0,22,4170000.0
4170,4170999,20.96375458830587,38.28679935887529,0.085558177840385,1490.8637161254883,312.511643409729,1173.5207710266113,15660,4049,11611,11611,0,22,4171000.0
4171,4171999,20.96263450743587,38.28407206075079,0.08555437475471361,1491.2215473651886,312.57793283462524,1174.0006523132324,15662,4050,11612,11612,0,22,4172000.0
4172,4172999,20.960879788908706,38.28105709705122,0.08555957337442133,1491.4829361438751,312.6451258659363,1174.6434211730957,15662,4050,11612,11612,0,22,4173000.0
4173,4173999,20.959383563875125,38.27969534560184,0.0855549746567188,1491.8526248931885,312.71073055267334,1174.769458770752,15666,4052,11614,11614,0,22,4174000.0
4174,4174999,20.95815095892287,38.27781628516154,0.08554980775397292,1492.312218427658,312.7765817642212,1174.4943656921387,15667,4052,11615,11615,0,22,4175000.0
4175,4175999,20.957223304933283,38.27601843042372,0.08554008641020205,1492.616426229477,312.8433964252472,1174.8792533874512,15667,4052,11615,11615,0,22,4176000.0
4176,4176999,20.956302190078432,38.27433012341698,0.08552887538420573,1493.065337896347,312.9109995365143,1174.5827369689941,15669,4053,11616,11616,0,22,4177000.0
4177,4177999,20.95535569496918,38.27339123697241,0.08551229082894674,1493.4436733722687,312.9763283729553,1174.5784873962402,15669,4053,11616,11616,0,22,4178000.0
4178,4178999,20.95595412097422,38.27748497008378,0.08546890610455193,1493.8537735939026,313.0419647693634,1174.5928764343262,15671,4054,11617,11617,0,22,4179000.0
4179,4179999,20.959440716083993,38.29056068781977,0.08539943160957619,1494.4466545581818,313.110413312912,1173.631420135498,15681,4057,11624,11624,0,22,4180000.0
4180,4180999,20.963294252036604,38.30298481214585,0.08537073507897919,1494.876892566681,313.17912459373474,1173.661563873291,15683,4058,11625,11625,0,22,4181000.0
4181,4181999,20.969878203827776,38.32637516980638,0.08537105557392133,1495.2912833690643,313.245502948761,1173.6911735534668,15687,4060,11627,11627,0,22,4182000.0
4182,4182999,20.97721999645651,38.34534486536123,0.08548982292145613,1495.5931630134583,313.3120744228363,1174.200252532959,15688,4061,11627,11627,0,22,4183000.0
4183,4183999,20.986061385293663,38.36845963653857,0.08557118783286288,1495.9655656814575,313.3799841403961,1174.2417640686035,15688,4061,11627,11627,0,22,4184000.0
4184,4184999,20.99401658505764,38.38759149293164,0.08565051829008452,1496.2720549106598,313.44812417030334,1174.503833770752,15690,4062,11628,11628,0,22,4185000.0
4185,4185999,21.002845836730117,38.40704913784166,0.0857875203013323,1496.6322298049927,313.5168967247009,1174.7330360412598,15692,4063,11629,11629,0,22,4186000.0
4186,4186999,21.01314363162937,38.434154270957784,0.0859235274201865,1496.934939622879,313.5836606025696,1175.1422157287598,15694,4064,11630,11630,0,22,4187000.0
4187,4187999,21.021108759856386,38.44859847594587,0.08604888214908113,1497.38108420372,313.65240836143494,1174.9530067443848,15700,4065,11635,11635,0,22,4188000.0
4188,4188999,21.030578396881758,38.470474200938604,0.08616944472343224,1497.7106685638428,313.72060656547546,1175.2072639465332,15700,4065,11635,11635,0,22,4189000.0
4189,4189999,21.039427680662225,38.485438501344625,0.08631611590635291,1498.1766135692596,313.7904396057129,1174.9783515930176,15735,4068,11667,11667,0,22,4190000.0
4190,4190999,21.044112077240595,38.49335728465294,0.08632696173581245,1498.4659609794617,313.85788202285767,1175.6364402770996,15735,4068,11667,11667,0,22,4191000.0
4191,4191999,21.044201751047247,38.49553103428307,0.08628693322855407,1498.717456817627,313.92426347732544,1176.4725074768066,15735,4068,11667,11667,0,22,4192000.0
4192,4192999,21.044497127672503,38.4989130850752,0.08624795207058544,1498.9893262386322,313.99223923683167,1177.1352424621582,15735,4068,11667,11667,0,22,4193000.0
4193,4193999,21.044865267291847,38.500288245821594,0.08621624631998726,1499.3718616962433,314.0570936203003,1177.1079216003418,15735,4068,11667,11667,0,22,4194000.0
4194,4194999,21.04511937746573,38.5009127023609,0.08619872888073299,1499.8612568378448,314.1229102611542,1176.6717948913574,15742,4069,11673,11673,0,22,4195000.0
4195,4195999,21.044979266996318,38.50024229362346,0.08618455326858687,1500.1440858840942,314.188982963562,1177.1849174499512,15742,4069,11673,11673,0,22,4196000.0
4196,4196999,21.044684805566515,38.499471722197995,0.08617087949156266,1500.6077377796173,314.2571532726288,1176.830883026123,15746,4071,11675,11675,0,22,4197000.0
4197,4197999,21.04492537003926,38.499040662620835,0.0861582785734003,1501.0216648578644,314.32263827323914,1176.9095268249512,15756,4073,11683,11683,0,22,4198000.0
4198,4198999,21.045484099520866,38.49981504678298,0.08614102602618012,1501.4798266887665,314.39066433906555,1176.5811882019043,15761,4075,11686,11686,0,22,4199000.0
4199,4199999,21.046040967508663,38.50056031724566,0.08613590185814035,1501.791002035141,314.4565167427063,1177.0292778015137,15761,4075,11686,11686,0,22,4200000.0
4200,4200999,21.047247094508617,38.50263784587736,0.08613631869356397,1502.0755920410156,314.52223229408264,1177.4574089050293,15761,4075,11686,11686,0,22,4201000.0
4201,4201999,21.048633026326282,38.50503104491877,0.0861346423966105,1502.4502515792847,314.5918266773224,1177.4639472961426,15765,4077,11688,11688,0,22,4202000.0
4202,4202999,21.050751061342304,38.50806635152802,0.08614846802647047,1502.868681192398,314.659380197525,1177.3146324157715,15771,4080,11691,11691,0,22,4203000.0
4203,4203999,21.052837726004107,38.511375633593126,0.08616938016257614,1503.2603089809418,314.72850823402405,1177.3213386535645,15773,4081,11692,11692,0,22,4204000.0
4204,4204999,21.055387409979314,38.51416932854276,0.08618209121224552,1503.5935492515564,314.7972195148468,1177.6267280578613,15773,4081,11692,11692,0,22,4205000.0
4205,4205999,21.05862724090561,38.51949758707647,0.08620311559077476,1503.9750440120697,314.86685514450073,1177.6425437927246,15773,4081,11692,11692,0,22,4206000.0
4206,4206999,21.06162390112747,38.52331246191867,0.08622535139506715,1504.3902547359467,314.93553161621094,1177.5730628967285,15775,4082,11693,11693,0,22,4207000.0
4207,4207999,21.064969289308454,38.528398714304394,0.08625925293282066,1504.7693548202515,315.0045130252838,1177.6482887268066,15775,4082,11693,11693,0,22,4208000.0
4208,4208999,21.067834887349928,38.53141069477797,0.08627412471910145,1505.2002825737,315.07339000701904,1177.430492401123,15775,4082,11693,11693,0,22,4209000.0
4209,4209999,21.071166320671956,38.535235174709555,0.08630577787174376,1505.5220427513123,315.1394901275635,1177.731647491455,15775,4082,11693,11693,0,22,4210000.0
4210,4210999,21.073230031090173,38.53606601198528,0.08632205273212012,1505.747367143631,315.20589447021484,1178.3455390930176,15776,4083,11693,11693,0,22,4211000.0
4211,4211999,21.074309861604757,38.53682612661007,0.08629209884885236,1505.9773740768433,315.2733759880066,1179.6868934631348,15799,4083,11716,11716,0,22,4212000.0
4212,4212999,21.072832764202218,38.5354720262081,0.08628504960396954,1506.1620032787323,315.3353109359741,1181.1874198913574,15807,4083,11724,11724,0,22,4213000.0
4213,4213999,21.07120622865154,38.532920520094876,0.08628637370710979,1506.3609039783478,315.39967679977417,1182.2392311096191,15809,4083,11726,11726,0,22,4214000.0
4214,4214999,21.06997770932175,38.53064026101525,0.08628425847658427,1506.6624071598053,315.4618284702301,1182.78413772583,15812,4084,11728,11728,0,22,4215000.0
4215,4215999,21.068629316512503,38.52810473941551,0.08628308563763398,1506.9530642032623,315.52473068237305,1183.2849769592285,15817,4086,11731,11731,0,22,4216000.0
4216,4216999,21.067398492585895,38.52630531341513,0.08627722210378919,1507.376084804535,315.5870077610016,1183.1525993347168,15826,4090,11736,11736,0,22,4217000.0
4217,4217999,21.06609168279377,38.52379826201285,0.0862764001163504,1507.7727046012878,315.64923310279846,1183.3123512268066,15832,4093,11739,11739,0,22,4218000.0
4218,4218999,21.06471752105558,38.521135613054355,0.08627296188561207,1508.1319570541382,315.713351726532,1183.7514152526855,15838,4096,11742,11742,0,22,4219000.0
4219,4219999,21.063966629473036,38.52010778818505,0.08626080382568657,1508.384497642517,315.7791893482208,1184.3824729919434,15841,4097,11744,11744,0,22,4220000.0
4220,4220999,21.06322252161146,38.51883336991282,0.08625220288978441,1508.8746490478516,315.84293127059937,1183.9264869689941,15847,4100,11747,11747,0,22,4221000.0
4221,4221999,21.06237213636457,38.51683235642337,0.08624268463470919,1509.2338435649872,315.907333612442,1184.2427101135254,15847,4100,11747,11747,0,22,4222000.0
4222,4222999,21.062022164060963,38.51569129165644,0.08623518934311902,1509.5738191604614,315.97416615486145,1184.5724449157715,15847,4100,11747,11747,0,22,4223000.0
4223,4223999,21.063136994406687,38.51788671027045,0.08622620608110021,1509.8399593830109,316.036940574646,1185.142421722412,15851,4102,11749,11749,0,22,4224000.0
4224,4224999,21.064250510553403,38.519884427644655,0.08622078289093826,1510.2094717025757,316.10112857818604,1185.1529655456543,15851,4102,11749,11749,0,22,4225000.0
4225,4225999,21.06603589860232,38.522276590476906,0.08622390162335392,1510.6678380966187,316.1685390472412,1184.9741172790527,15851,4102,11749,11749,0,22,4226000.0
4226,4226999,21.067457670617234,38.524815551150546,0.08623494803358167,1510.9366841316223,316.2314190864563,1185.5443229675293,15855,4104,11751,11751,0,22,4227000.0
4227,4227999,21.06963050232745,38.53174585198294,0.08622510585081378,1511.3884501457214,316.2941439151764,1185.3982582092285,15875,4106,11769,11769,0,22,4228000.0
4228,4228999,21.071972056769926,38.53584684663177,0.08624071505470787,1511.7742702960968,316.3591809272766,1185.4641609191895,15895,4108,11787,11787,0,22,4229000.0
4229,4229999,21.07359016810755,38.538658273466496,0.08626243066538364,1512.1383538246155,316.4249336719513,1185.5700492858887,15895,4108,11787,11787,0,22,4230000.0
4230,4230999,21.075060405142064,38.53936952234777,0.08627683972856826,1512.6199615001678,316.488849401474,1185.233310699463,15895,4108,11787,11787,0,22,4231000.0
4231,4231999,21.076570520931842,38.540070823277134,0.08628230552930916,1512.9308516979218,316.5545437335968,1185.7057075500488,15897,4109,11788,11788,0,22,4232000.0
4232,4232999,21.07658124042459,38.538626941294055,0.08628400760544574,1513.2644958496094,316.6198935508728,1186.398494720459,15907,4109,11798,11798,0,22,4233000.0
4233,4233999,21.07456518178472,38.535892930011606,0.08629076872377905,1513.504348039627,316.6833472251892,1187.4437828063965,15916,4110,11806,11806,0,22,4234000.0
4234,4234999,21.07256103325309,38.53364672612448,0.0862954734560335,1513.7927997112274,316.7463595867157,1188.0490760803223,15922,4111,11811,11811,0,22,4235000.0
4235,4235999,21.0704825626708,38.530542280480624,0.08630145834839609,1514.108838558197,316.81642723083496,1188.5995597839355,15927,4111,11816,11816,0,22,4236000.0
4236,4236999,21.068793349566658,38.527921240480694,0.08630098032904954,1514.4078397750854,316.87922954559326,1189.0164909362793,15931,4112,11819,11819,0,22,4237000.0
4237,4237999,21.06774411629598,38.526796157172924,0.08628473319124697,1514.8902912139893,316.9435420036316,1188.7432823181152,15940,4115,11825,11825,0,22,4238000.0
4238,4238999,21.066557930742338,38.52441348247473,0.08627653725994877,1515.2455253601074,317.00729298591614,1189.0052299499512,15943,4116,11827,11827,0,22,4239000.0
4239,4239999,21.065567682634054,38.52268469788465,0.0862629909756979,1515.4933993816376,317.0717341899872,1189.6302375793457,15943,4116,11827,11827,0,22,4240000.0
4240,4240999,21.06476598741873,38.521078044374555,0.08625087220323313,1515.8767874240875,317.13644528388977,1189.664722442627,15948,4117,11831,11831,0,22,4241000.0
4241,4241999,21.06462711684636,38.52134844688528,0.08622892462741427,1516.3188135623932,317.20053005218506,1189.3564720153809,15952,4119,11833,11833,0,22,4242000.0
4242,4242999,21.064385032030206,38.52067128343094,0.08622634200878532,1516.8421409130096,317.26853585243225,1188.9567832946777,15957,4122,11835,11835,0,22,4243000.0
4243,4243999,21.064316836814076,38.51967601360697,0.08622212418024522,1517.0910584926605,317.3342592716217,1189.6363716125488,15957,4122,11835,11835,0,22,4244000.0
4244,4244999,21.06535660419296,38.52037020554814,0.08620926579046972,1517.431532382965,317.40202021598816,1189.9185981750488,15957,4122,11835,11835,0,22,4245000.0
4245,4245999,21.06695815581353,38.52448359158094,0.08619552980620071,1517.859852552414,317.4690775871277,1189.816493988037,15958,4122,11836,11836,0,22,4246000.0
4246,4246999,21.068919005833322,38.52655947195733,0.08622662490635324,1518.164136648178,317.5365164279938,1190.1653327941895,15960,4123,11837,11837,0,22,4247000.0
4247,4247999,21.07054646161115,38.52779613697326,0.08624968190371074,1518.526794910431,317.60535645484924,1190.3132591247559,15963,4124,11839,11839,0,22,4248000.0
4248,4248999,21.07309940887826,38.53088934368214,0.08629657453052497,1518.852062702179,317.671231508255,1190.602222442627,15963,4124,11839,11839,0,22,4249000.0
4249,4249999,21.07557134778044,38.53311959258054,0.08632315044415417,1519.1991152763367,317.73986291885376,1190.8296394348145,15965,4125,11840,11840,0,22,4250000.0
4250,4250999,21.077893213846572,38.535446647107904,0.08635986037323962,1519.5756747722626,317.80639910697937,1190.9505882263184,15965,4125,11840,11840,0,22,4251000.0
4251,4251999,21.080284664883713,38.53743168152667,0.08636288375614454,1519.8856663703918,317.87567043304443,1191.1839027404785,15966,4126,11840,11840,0,22,4252000.0
4252,4252999,21.082571604447168,38.53895421125248,0.08636853748456541,1520.4131197929382,317.9421925544739,1190.5663871765137,15968,4127,11841,11841,0,22,4253000.0
4253,4253999,21.083950274310904,38.54051174495073,0.08637095223617319,1520.7152404785156,318.0084459781647,1191.0340614318848,15968,4127,11841,11841,0,22,4254000.0
4254,4254999,21.082455900926796,38.53774356014463,0.08636874804903394,1521.0058255195618,318.0759720802307,1192.022548675537,15986,4128,11858,11858,0,22,4255000.0
4255,4255999,21.080375622351532,38.535258474397416,0.0863738867870697,1521.3061952590942,318.14165592193604,1192.74320602417,15999,4129,11870,11870,0,22,4256000.0
4256,4256999,21.078502785831795,38.53288218161722,0.08637885518082311,1521.614410161972,318.20718002319336,1193.2118339538574,16008,4130,11878,11878,0,22,4257000.0
4257,4257999,21.077105186168946,38.53118599059758,0.08637873136158813,1521.930010318756,318.26972126960754,1193.5131950378418,16009,4130,11879,11879,0,22,4258000.0
4258,4258999,21.07601489113838,38.53056128184381,0.08636681051993922,1522.3273451328278,318.33704662323,1194.0967140197754,16034,4133,11901,11901,0,22,4259000.0
4259,4259999,21.07470501359446,38.529439127485155,0.08636115476011363,1522.6566996574402,318.40566873550415,1194.6961708068848,16036,4134,11902,11902,0,22,4260000.0
4260,4260999,21.07331517956591,38.526921919284575,0.08635601201453225,1522.957498550415,318.47195625305176,1195.0264472961426,16042,4135,11907,11907,0,22,4261000.0
4261,4261999,21.07207197134055,38.52454424143891,0.08635095881869104,1523.2286658287048,318.53912258148193,1195.6300926208496,16043,4135,11908,11908,0,22,4262000.0
4262,4262999,21.07084453723087,38.522240403160204,0.08634932129657336,1523.6028089523315,318.6055853366852,1195.7120933532715,16043,4135,11908,11908,0,22,4263000.0
4263,4263999,21.070346920504615,38.521640099521726,0.08633561175010118,1524.0018315315247,318.6717154979706,1195.8568992614746,16047,4137,11910,11910,0,22,4264000.0
4264,4264999,21.06957592024795,38.5195193144394,0.08632675992000982,1524.429724931717,318.73928570747375,1195.7173042297363,16049,4138,11911,11911,0,22,4265000.0
4265,4265999,21.068781377462695,38.51785994951033,0.08631840333142038,1524.6706283092499,318.80645537376404,1196.348690032959,16049,4138,11911,11911,0,22,4266000.0
4266,4266999,21.069022175736684,38.51914400826849,0.08629507462193964,1525.0304505825043,318.8736879825592,1196.472354888916,16049,4138,11911,11911,0,22,4267000.0
4267,4267999,21.0685493259622,38.51721142989033,0.08629179620056837,1525.4737706184387,318.9399924278259,1196.1486320495605,16053,4140,11913,11913,0,22,4268000.0
4268,4268999,21.068555417451357,38.516646589840256,0.0862809192091969,1525.6737999916077,319.0063099861145,1197.0093269348145,16053,4140,11913,11913,0,22,4269000.0
4269,4269999,21.068563623631018,38.516964215012536,0.08627522753920636,1526.040108680725,319.0749990940094,1197.0788688659668,16053,4140,11913,11913,0,22,4270000.0
4270,4270999,21.06851622310374,38.516263863914254,0.08627058176158886,1526.4177129268646,319.1426696777344,1197.1620292663574,16055,4141,11914,11914,0,22,4271000.0
4271,4271999,21.068928023349603,38.51856578810563,0.0862635138016199,1526.9439444541931,319.2112329006195,1196.6443519592285,16057,4142,11915,11915,0,22,4272000.0
4272,4272999,21.06860577767308,38.51656055849671,0.08626025579973406,1527.2905173301697,319.27966690063477,1196.9041633605957,16057,4142,11915,11915,0,22,4273000.0
4273,4273999,21.068604462483453,38.51510433996248,0.08625928026158969,1527.618854045868,319.3504602909088,1197.1725425720215,16057,4142,11915,11915,0,22,4274000.0
4274,4274999,21.067902211300353,38.51285428423685,0.08625973253462249,1527.9356143474579,319.4151358604431,1197.431812286377,16064,4143,11921,11921,0,22,4275000.0
4275,4275999,21.06654923786589,38.51074373874726,0.0862573464081745,1528.2596538066864,319.4829487800598,1198.2859153747559,16083,4143,11940,11940,0,22,4276000.0
4276,4276999,21.06442982759377,38.50844387520228,0.08626514907889782,1528.5066606998444,319.5444746017456,1199.266933441162,16099,4144,11955,11955,0,22,4277000.0
4277,4277999,21.062140893470012,38.50500671483989,0.0862736991231231,1528.7281260490417,319.6064178943634,1200.2835807800293,16106,4144,11962,11962,0,22,4278000.0
4278,4278999,21.06027068587929,38.50243257769755,0.08627804972900177,1528.9678678512573,319.66918110847473,1201.288242340088,16111,4145,11966,11966,0,22,4279000.0
4279,4279999,21.05915588884774,38.50176849233022,0.08626867758852041,1529.161060810089,319.7356503009796,1202.510585784912,16117,4145,11972,11972,0,22,4280000.0
4280,4280999,21.057420753803935,38.49875245348935,0.086270555261456,1529.4127204418182,319.79927110671997,1203.383144378662,16118,4145,11973,11973,0,22,4281000.0
4281,4281999,21.055752222830925,38.49618840101268,0.08627129733976158,1529.8987565040588,319.86449813842773,1203.091365814209,16133,4150,11983,11983,0,22,4282000.0
4282,4282999,21.0543334875513,38.49370134338905,0.08626877086755924,1530.2569913864136,319.927152633667,1203.4251976013184,16140,4153,11987,11987,0,22,4283000.0
4283,4283999,21.05300664331551,38.4920856671763,0.08626593446253283,1530.5037314891815,319.99180579185486,1204.217601776123,16142,4154,11988,11988,0,22,4284000.0
4284,4284999,21.05151549992073,38.4893743042578,0.08626588496607956,1530.7936866283417,320.056613445282,1204.684268951416,16144,4155,11989,11989,0,22,4285000.0
4285,4285999,21.050566309696492,38.48765509876387,0.08625742782062173,1531.2661168575287,320.1211817264557,1204.3381996154785,16152,4159,11993,11993,0,22,4286000.0
4286,4286999,21.050455811223063,38.4888239533121,0.08623457700186177,1531.5912022590637,320.18504786491394,1204.8107261657715,16154,4160,11994,11994,0,22,4287000.0
4287,4287999,21.050162491773147,38.48807439320061,0.08621671930368446,1531.9131212234497,320.2484300136566,1205.1319313049316,16154,4160,11994,11994,0,22,4288000.0
4288,4288999,21.04994572158731,38.48708866964429,0.08620440176730926,1532.335307598114,320.3120517730713,1205.049488067627,16159,4162,11997,11997,0,22,4289000.0
4289,4289999,21.05095485673013,38.489971516593734,0.08617969131417369,1532.5357069969177,320.376118183136,1205.9190711975098,16159,4162,11997,11997,0,22,4290000.0
4290,4290999,21.05232213309171,38.49200383076883,0.08615507041518855,1532.8226132392883,320.4394705295563,1206.348331451416,16159,4162,11997,11997,0,22,4291000.0
4291,4291999,21.05386124936986,38.49443703926479,0.08614055338974402,1533.240775346756,320.5058708190918,1206.3126487731934,16166,4163,12003,12003,0,22,4292000.0
4292,4292999,21.05581915393691,38.49809295975158,0.0861228347095282,1533.6407406330109,320.57055592536926,1206.307949066162,16166,4163,12003,12003,0,22,4293000.0
4293,4293999,21.058558887694037,38.505448366519865,0.08610960785382182,1533.979932308197,320.6371126174927,1206.557689666748,16170,4165,12005,12005,0,22,4294000.0
4294,4294999,21.061947516635627,38.51615275744995,0.08609739971786312,1534.4005093574524,320.701208114624,1206.4368629455566,16176,4168,12008,12008,0,22,4295000.0
4295,4295999,21.06416723142969,38.519717455399615,0.08611897993280893,1534.8980617523193,320.7667453289032,1206.0660209655762,16185,4170,12015,12015,0,22,4296000.0
4296,4296999,21.06515340093412,38.52136743284061,0.08614169533126592,1535.4008388519287,320.83265948295593,1206.145839691162,16206,4173,12033,12033,0,22,4297000.0
4297,4297999,21.063539925281372,38.51992556533884,0.08613444707134754,1535.698399066925,320.8980486392975,1207.0332984924316,16221,4174,12047,12047,0,22,4298000.0
4298,4298999,21.06184504639517,38.51841624670201,0.0861327417661859,1535.998573064804,320.9679789543152,1207.680576324463,16223,4174,12049,12049,0,22,4299000.0
4299,4299999,21.060698326881067,38.51761618341766,0.08612677270880453,1536.3043370246887,321.0313313007355,1208.2639656066895,16233,4175,12058,12058,0,22,4300000.0
4300,4300999,21.059195957611095,38.515583799993486,0.08612505098291545,1536.654527425766,321.10461473464966,1209.0133094787598,16250,4177,12073,12073,0,22,4301000.0
4301,4301999,21.057735803414964,38.51315592072112,0.08612493416882594,1536.997508764267,321.1718075275421,1209.5428047180176,16254,4179,12075,12075,0,22,4302000.0
4302,4302999,21.056268109133583,38.51104292206105,0.08612183232481718,1537.251147031784,321.23766255378723,1210.311321258545,16256,4180,12076,12076,0,22,4303000.0
4303,4303999,21.055213739077423,38.5093342436076,0.086119369446792,1537.5344231128693,321.30295062065125,1210.9059257507324,16257,4180,12077,12077,0,22,4304000.0
4304,4304999,21.05401381672834,38.50714196987732,0.08611400870946728,1537.8447885513306,321.3669693470001,1211.2998085021973,16257,4180,12077,12077,0,22,4305000.0
4305,4305999,21.05321141303923,38.50552473055665,0.08610442982783673,1538.27494430542,321.4324383735657,1211.1281776428223,16264,4181,12083,12083,0,22,4306000.0
4306,4306999,21.052551675415593,38.503985007843454,0.08609390835340403,1538.7343065738678,321.49723196029663,1210.9583930969238,16266,4182,12084,12084,0,22,4307000.0
4307,4307999,21.052094799934768,38.503154470442496,0.08607916610212352,1538.9817049503326,321.5636100769043,1211.700481414795,16266,4182,12084,12084,0,22,4308000.0
4308,4308999,21.051194715404165,38.50107275586024,0.08606897618867715,1539.3434975147247,321.62870931625366,1211.775547027588,16273,4183,12090,12090,0,22,4309000.0
4309,4309999,21.05070809552596,38.499606899648725,0.08605703168668533,1545.630351781845,321.69261360168457,1212.211711883545,16273,4183,12090,12090,0,22,4310000.0
4310,4310999,21.050879335460827,38.50575058717689,0.0860133149260518,1545.9327211380005,321.75816798210144,1212.4606742858887,16275,4184,12091,12091,0,22,4311000.0
4311,4311999,21.05067950078686,38.50468603701745,0.08599982868501599,1546.4312717914581,321.8249719142914,1212.0731468200684,16282,4185,12097,12097,0,22,4312000.0
4312,4312999,21.050424679907184,38.503175271507,0.08598905552876468,1546.8519382476807,321.8915219306946,1212.038486480713,16286,4187,12099,12099,0,22,4313000.0
4313,4313999,21.05015933196213,38.50176453433264,0.0859793944594105,1547.2555899620056,321.9589755535126,1212.1824378967285,16304,4190,12114,12114,0,22,4314000.0
4314,4314999,21.049618807683174,38.50002105274057,0.08597628635316945,1547.7248623371124,322.0241813659668,1211.9368019104004,16304,4190,12114,12114,0,22,4315000.0
4315,4315999,21.048477822776423,38.497722919801134,0.0859741701564748,1548.0967819690704,322.0974426269531,1212.8178825378418,16318,4190,12128,12128,0,22,4316000.0
4316,4316999,21.047298698731748,38.49616494279966,0.08597518151206485,1548.4144432544708,322.1600909233093,1213.558521270752,16322,4191,12131,12131,0,22,4317000.0
4317,4317999,21.046944823032867,38.49644282585768,0.08596519578631423,1548.711130619049,322.2221579551697,1214.0301475524902,16327,4192,12135,12135,0,22,4318000.0
4318,4318999,21.046414097573564,38.49595362846419,0.08596583249165068,1548.9837591648102,322.2866315841675,1214.7281761169434,16331,4194,12137,12137,0,22,4319000.0
4319,4319999,21.04587703804754,38.49444499411225,0.08597067158445904,1549.252518415451,322.3490777015686,1215.2343559265137,16331,4194,12137,12137,0,22,4320000.0
4320,4320999,21.045727700555204,38.49394309203483,0.08598202664700727,1549.6597962379456,322.41259241104126,1215.2919425964355,16336,4196,12140,12140,0,22,4321000.0
4321,4321999,21.045587026950418,38.492912757145284,0.08598565072905917,1550.06347322464,322.4762980937958,1215.325397491455,16340,4198,12142,12142,0,22,4322000.0
4322,4322999,21.045244266260553,38.49177988989025,0.08599543979825797,1550.4232351779938,322.5478525161743,1215.5858345031738,16342,4199,12143,12143,0,22,4323000.0
4323,4323999,21.04507753910975,38.49079038667879,0.08599109007117378,1550.9871969223022,322.6138298511505,1214.9248847961426,16344,4200,12144,12144,0,22,4324000.0
4324,4324999,21.04500245564923,38.489916003830885,0.08599477873821693,1551.267230272293,322.6773843765259,1215.4403343200684,16344,4200,12144,12144,0,22,4325000.0
4325,4325999,21.045274588180455,38.489429551286634,0.08598988720878165,1551.6398310661316,322.74111437797546,1215.5689659118652,16344,4200,12144,12144,0,22,4326000.0
4326,4326999,21.04587801952001,38.490986479835016,0.08598511722511448,1552.091542005539,322.8073241710663,1215.1989707946777,16351,4204,12147,12147,0,22,4327000.0
4327,4327999,21.046356057770613,38.49097315998966,0.0859788917472949,1552.377048254013,322.873015165329,1215.7281913757324,16351,4204,12147,12147,0,22,4328000.0
4328,4328999,21.04712188216396,38.49098529762941,0.08597402052737291,1552.6082472801208,322.9366178512573,1216.4554710388184,16351,4204,12147,12147,0,22,4329000.0
4329,4329999,21.04843164623264,38.494264160784674,0.08599741881752954,1552.971877336502,323.0023236274719,1216.520923614502,16352,4205,12147,12147,0,22,4330000.0
4330,4330999,21.050132510186142,38.495596781619504,0.08601308765118132,1553.3442327976227,323.06833577156067,1216.654941558838,16352,4205,12147,12147,0,22,4331000.0
4331,4331999,21.05281644970613,38.498963474136154,0.08605666381275756,1553.769763469696,323.1345591545105,1216.4691276550293,16352,4205,12147,12147,0,22,4332000.0
4332,4332999,21.05523655620153,38.50200223607122,0.08610153183587033,1554.311991930008,323.1988501548767,1215.8715553283691,16370,4206,12164,12164,0,22,4333000.0
4333,4333999,21.057860018419802,38.504703450965955,0.08614244838477503,1554.6095023155212,323.26376581192017,1216.3806800842285,16377,4207,12170,12170,0,22,4334000.0
4334,4334999,21.060173757436544,38.50668963007454,0.0862054166229933,1554.988841533661,323.3315155506134,1216.6561393737793,16391,4208,12183,12183,0,22,4335000.0
4335,4335999,21.061382940699108,38.50710781948652,0.08621318274234047,1555.2352261543274,323.3972644805908,1217.6522331237793,16399,4208,12191,12191,0,22,4336000.0
4336,4336999,21.059940524681572,38.50589527263487,0.08620050021863512,1555.5669836997986,323.4608771800995,1218.2646522521973,16402,4208,12194,12194,0,22,4337000.0
4337,4337999,21.05882856979592,38.50785133725406,0.08618093096582546,1555.8629672527313,323.5233705043793,1218.8892250061035,16409,4209,12200,12200,0,22,4338000.0
4338,4338999,21.0574947280508,38.5057668914973,0.08617786380325221,1556.2034277915955,323.5879662036896,1219.2640571594238,16412,4210,12202,12202,0,22,4339000.0
4339,4339999,21.056582027106046,38.504425602801945,0.08616860988267339,1556.5068106651306,323.6511836051941,1219.7382469177246,16415,4211,12204,12204,0,22,4340000.0
4340,4340999,21.055345239095093,38.50224606025825,0.08615980508619048,1556.9285147190094,323.71441626548767,1219.6201667785645,16422,4214,12208,12208,0,22,4341000.0
4341,4341999,21.054294440082245,38.501724489357045,0.0861460805669505,1557.3409600257874,323.7786202430725,1219.7167854309082,16422,4214,12208,12208,0,22,4342000.0
4342,4342999,21.053836533373318,38.50166327283159,0.08612784307802501,1557.6989161968231,323.84255051612854,1219.8228187561035,16423,4215,12208,12208,0,22,4343000.0
4343,4343999,21.05328662360588,38.50027916378072,0.0861166428952932,1557.9938390254974,323.9074580669403,1220.299030303955,16423,4215,12208,12208,0,22,4344000.0
4344,4344999,21.052933197013175,38.49860312018441,0.08610918499146558,1558.4800860881805,323.9721329212189,1219.8534507751465,16426,4217,12209,12209,0,22,4345000.0
4345,4345999,21.053618394450737,38.49952260594615,0.08609780230490871,1558.8416719436646,324.0379858016968,1220.1580848693848,16433,4218,12215,12215,0,22,4346000.0
4346,4346999,21.05428778912344,38.50016874535842,0.08609321029453265,1559.322586297989,324.1035327911377,1219.7909660339355,16433,4218,12215,12215,0,22,4347000.0
4347,4347999,21.055075533867413,38.50087791875468,0.08608825484062221,1559.6053352355957,324.16772079467773,1220.2935752868652,16433,4218,12215,12215,0,22,4348000.0
4348,4348999,21.05622411682971,38.502294767113916,0.08608073134937422,1559.9649279117584,324.23250818252563,1220.4605827331543,16433,4218,12215,12215,0,22,4349000.0
4349,4349999,21.0583150360405,38.5071496238783,0.08606386465586502,1560.2290937900543,324.299040555954,1220.8717002868652,16434,4219,12215,12215,0,22,4350000.0
4350,4350999,21.06061798549666,38.51477237227323,0.08604370912411441,1560.6224207878113,324.3662407398224,1220.8052558898926,16435,4220,12215,12215,0,22,4351000.0
4351,4351999,21.063464760822104,38.517909204684706,0.08606532439732528,1561.1137573719025,324.43235063552856,1220.48881149292,16437,4221,12216,12216,0,22,4352000.0
4352,4352999,21.066259639489616,38.52074454242926,0.0860764989807008,1561.4143660068512,324.49824261665344,1220.87007522583,16437,4221,12216,12216,0,22,4353000.0
4353,4353999,21.06931081774657,38.523729514904744,0.08609164505764066,1562.0039093494415,324.5651638507843,1220.1249504089355,16446,4223,12223,12223,0,22,4354000.0
4354,4354999,21.072168674239254,38.52587096925166,0.08610645746053791,1562.4140350818634,324.637020111084,1220.2757530212402,16446,4223,12223,12223,0,22,4355000.0
4355,4355999,21.075527840335866,38.5291092080085,0.08612657782501132,1562.7402067184448,324.702538728714,1220.5471153259277,16447,4224,12223,12223,0,22,4356000.0
4356,4356999,21.07716019380234,38.5288225974576,0.08611708204407409,1563.199666261673,324.77306270599365,1220.3870658874512,16454,4226,12228,12228,0,22,4357000.0
4357,4357999,21.076287971668794,38.52717119050389,0.08609430758334125,1563.4392306804657,324.8380239009857,1222.0554695129395,16483,4226,12257,12257,0,22,4358000.0
4358,4358999,21.075088305418937,38.527342640298656,0.08607976850547494,1563.631945848465,324.90043115615845,1223.3444709777832,16489,4227,12262,12262,0,22,4359000.0
4359,4359999,21.07440673990955,38.526839358940876,0.08607486812296872,1564.0708153247833,324.9647305011749,1223.3299980163574,16497,4230,12267,12267,0,22,4360000.0
4360,4360999,21.07408324729879,38.52628170947862,0.086068842287783,1564.256875038147,325.0261437892914,1224.4158821105957,16498,4230,12268,12268,0,22,4361000.0
4361,4361999,21.074474885821278,38.5283097072472,0.0860429439937831,1564.5264348983765,325.0900239944458,1224.9816627502441,16500,4230,12270,12270,0,22,4362000.0
4362,4362999,21.074693378463063,38.52870051768462,0.0860316741302164,1565.0284488201141,325.1552777290344,1224.6788597106934,16513,4234,12279,12279,0,22,4363000.0
4363,4363999,21.0743311668354,38.5274221484502,0.08602718057151171,1565.475303888321,325.21963000297546,1224.64262008667,16519,4237,12282,12282,0,22,4364000.0
4364,4364999,21.074470217816113,38.52689595165576,0.08602000190806258,1565.8318812847137,325.2839231491089,1224.9664878845215,16528,4239,12289,12289,0,22,4365000.0
4365,4365999,21.07405842129027,38.525378628850824,0.08601832385091313,1566.1268315315247,325.34839606285095,1225.5223808288574,16530,4240,12290,12290,0,22,4366000.0
4366,4366999,21.074212656177288,38.52487612886871,0.08602371400416942,1566.545503616333,325.4118230342865,1225.4224967956543,16536,4243,12293,12293,0,22,4367000.0
4367,4367999,21.074037528346373,38.52402446230025,0.08602020602105209,1566.9398674964905,325.47892236709595,1225.567684173584,16542,4246,12296,12296,0,22,4368000.0
4368,4368999,21.074304729560634,38.52380444522527,0.08602064189966574,1567.256632566452,325.54298734664917,1225.982723236084,16542,4246,12296,12296,0,22,4369000.0
4369,4369999,21.07475678533671,38.52448186957759,0.0860087800451701,1567.4089481830597,325.60578060150146,1226.9580345153809,16542,4246,12296,12296,0,22,4370000.0
4370,4370999,21.07522766356476,38.524419655838294,0.08600186780425356,1567.761343240738,325.66892671585083,1227.110523223877,16542,4246,12296,12296,0,22,4371000.0
4371,4371999,21.07563066095015,38.52406540299528,0.08599034049818155,1568.138792514801,325.7342793941498,1227.1602973937988,16544,4247,12297,12297,0,22,4372000.0
4372,4372999,21.076578651729914,38.52494843794447,0.08598807392861563,1568.4776737689972,325.79624938964844,1227.3532371520996,16565,4249,12316,12316,0,22,4373000.0
4373,4373999,21.077419442291916,38.525351077562306,0.08598207408129133,1568.9542028903961,325.8618860244751,1226.9393424987793,16565,4249,12316,12316,0,22,4374000.0
4374,4374999,21.078189480491528,38.526384567657786,0.08596525352413542,1569.3276093006134,325.9266195297241,1227.253589630127,16572,4250,12322,12322,0,22,4375000.0
4375,4375999,21.078963472439412,38.52705710733324,0.08595786673621397,1569.8028597831726,325.9902067184448,1227.056339263916,16585,4254,12331,12331,0,22,4376000.0
4376,4376999,21.079576387410206,38.52655143347398,0.08595609267394255,1570.1978516578674,326.05657410621643,1227.1078758239746,16585,4254,12331,12331,0,22,4377000.0
4377,4377999,21.07988429705898,38.52651929169992,0.08594098965580621,1570.5272617340088,326.1194884777069,1227.4638557434082,16585,4254,12331,12331,0,22,4378000.0
4378,4378999,21.079853738634288,38.526614663876686,0.0859261232870615,1570.7731227874756,326.1828992366791,1228.657901763916,16598,4255,12343,12343,0,22,4379000.0
4379,4379999,21.079318357754634,38.52750963142191,0.08591009625555679,1571.1264417171478,326.2471168041229,1229.2220039367676,16618,4257,12361,12361,0,22,4380000.0
4380,4380999,21.07885258936225,38.52637730431192,0.08591092848712822,1571.3214292526245,326.31200551986694,1230.5048713684082,16623,4258,12365,12365,0,22,4381000.0
4381,4381999,21.078535785838536,38.525939176766755,0.08591609602154338,1571.5852272510529,326.3770868778229,1231.312343597412,16623,4258,12365,12365,0,22,4382000.0
4382,4382999,21.078576781072897,38.52570553566365,0.08591439862892336,1571.8419091701508,326.44054555892944,1231.9112663269043,16626,4259,12367,12367,0,22,4383000.0
4383,4383999,21.079153244760057,38.535917357933975,0.08588422921339245,1572.2106039524078,326.5075194835663,1232.0903129577637,16628,4260,12368,12368,0,22,4384000.0
4384,4384999,21.078754733664102,38.53524265958793,0.08588936884192122,1572.5291347503662,326.57316160202026,1232.35152053833,16630,4261,12369,12369,0,22,4385000.0
4385,4385999,21.078984109248992,38.53520309431274,0.08589572006746449,1572.910210609436,326.63866424560547,1232.4374809265137,16633,4262,12371,12371,0,22,4386000.0
4386,4386999,21.078993460949963,38.53507408782845,0.08588829285443378,1573.217366695404,326.70423340797424,1232.78023147583,16637,4264,12373,12373,0,22,4387000.0
4387,4387999,21.07901693928793,38.53509429172459,0.08588562127607269,1573.5960738658905,326.770304441452,1232.7463264465332,16639,4265,12374,12374,0,22,4388000.0
4388,4388999,21.07946838374234,38.535594803238325,0.08588758777525662,1574.0886735916138,326.83565068244934,1232.383602142334,16641,4266,12375,12375,0,22,4389000.0
4389,4389999,21.07973613142458,38.53524720229196,0.08590075764807048,1574.3178236484528,326.899929523468,1233.1323585510254,16641,4266,12375,12375,0,22,4390000.0
4390,4390999,21.080261027394204,38.536510127070656,0.08590934438068909,1574.697901725769,326.9662215709686,1233.1905326843262,16643,4267,12376,12376,0,22,4391000.0
4391,4391999,21.080984683081944,38.537072490671505,0.08590947901382717,1574.9869878292084,327.0309875011444,1233.6813163757324,16645,4268,12377,12377,0,22,4392000.0
4392,4392999,21.0819507947103,38.53794866379553,0.08589894963851974,1575.3161697387695,327.0975921154022,1233.9858283996582,16647,4269,12378,12378,0,22,4393000.0
4393,4393999,21.08318419734105,38.53881656313986,0.08589447727173238,1575.8227360248566,327.1635420322418,1233.4213829040527,16649,4270,12379,12379,0,22,4394000.0
4394,4394999,21.08505783987784,38.5454303385301,0.08587247514401697,1576.0753972530365,327.2277739048004,1233.9339027404785,16651,4271,12380,12380,0,22,4395000.0
4395,4395999,21.08640113896772,38.54767223993137,0.08586314771557124,1576.4274909496307,327.29274916648865,1234.05863571167,16651,4271,12380,12380,0,22,4396000.0
4396,4396999,21.087686781485655,38.5493705851839,0.08585718602136228,1576.9042983055115,327.36176800727844,1233.618595123291,16653,4272,12381,12381,0,22,4397000.0
4397,4397999,21.089055496634003,38.551942965201555,0.08584424290171078,1577.2635881900787,327.4282433986664,1233.885097503662,16657,4274,12383,12383,0,22,4398000.0
4398,4398999,21.08979397133382,38.5515163487193,0.08582883572094313,1577.685779094696,327.4943654537201,1233.7953910827637,16659,4275,12384,12384,0,22,4399000.0
4399,4399999,21.08909503468239,38.54965529340404,0.08581804041457963,1578.116527080536,327.5643608570099,1234.3381233215332,16683,4277,12406,12406,0,22,4400000.0
4400,4400999,21.087195468703108,38.54925555921664,0.08581472939527424,1578.4122490882874,327.631041765213,1235.2697792053223,16713,4279,12434,12434,0,22,4401000.0
4401,4401999,21.08538063801981,38.54733241362086,0.08581583261111081,1578.6578624248505,327.69605803489685,1236.5457649230957,16731,4280,12451,12451,0,22,4402000.0
4402,4402999,21.083671908451855,38.54552781155995,0.08581729287300155,1578.9293324947357,327.7626042366028,1237.2616539001465,16732,4280,12452,12452,0,22,4403000.0
4403,4403999,21.082062633275424,38.54289598923222,0.08581924579846567,1579.159007549286,327.82914566993713,1238.1601219177246,16736,4281,12455,12455,0,22,4404000.0
4404,4404999,21.080760147379056,38.54097251030093,0.08581599135633122,1579.6530561447144,327.89994382858276,1237.9952507019043,16740,4283,12457,12457,0,22,4405000.0
4405,4405999,21.0794052045271,38.538254953573414,0.08581792722768777,1579.906639099121,327.9667172431946,1238.6551551818848,16742,4284,12458,12458,0,22,4406000.0
4406,4406999,21.078536978077413,38.53689591429275,0.08581275056945903,1580.143419265747,328.032368183136,1239.3276329040527,16742,4284,12458,12458,0,22,4407000.0
4407,4407999,21.07787787511037,38.53598998037363,0.08583512498363477,1580.5883820056915,328.09925413131714,1239.077953338623,16747,4286,12461,12461,0,22,4408000.0
4408,4408999,21.0782693864247,38.53849833079071,0.08582051653339784,1581.0189464092255,328.16801476478577,1238.9744682312012,16751,4288,12463,12463,0,22,4409000.0
4409,4409999,21.080115615670938,38.54489612173163,0.08585089856680972,1581.4393191337585,328.2344853878021,1239.0528526306152,16753,4289,12464,12464,0,22,4410000.0
4410,4410999,21.08316215133936,38.5552774757971,0.0858697974940481,1581.8006410598755,328.3021049499512,1239.4150352478027,16757,4291,12466,12466,0,22,4411000.0
4411,4411999,21.08714699153716,38.57251530808641,0.08587705495970721,1582.1486237049103,328.3730411529541,1239.7992057800293,16759,4292,12467,12467,0,22,4412000.0
4412,4412999,21.09095852269144,38.58328711927508,0.0859788591239381,1582.3958711624146,328.4386975765228,1240.4572792053223,16759,4292,12467,12467,0,22,4413000.0
4413,4413999,21.0952569111227,38.59756481330262,0.08607335983751452,1582.7990999221802,328.50574016571045,1240.46382522583,16763,4294,12469,12469,0,22,4414000.0
4414,4414999,21.100487439410987,38.61494318174945,0.0861409827879851,1583.1166427135468,328.573219537735,1240.8132057189941,16763,4294,12469,12469,0,22,4415000.0
4415,4415999,21.10603609556013,38.63373980707729,0.08629931287800896,1583.6240932941437,328.6404616832733,1240.5529747009277,16779,4297,12482,12482,0,22,4416000.0
4416,4416999,21.1119212997976,38.64831097704118,0.08639771815475572,1584.0364124774933,328.7079679965973,1240.5843315124512,16787,4299,12488,12488,0,22,4417000.0
4417,4417999,21.11759415442248,38.6638656071507,0.08650712073457778,1584.2967593669891,328.77785873413086,1241.2504920959473,16789,4300,12489,12489,0,22,4418000.0
4418,4418999,21.124752859481468,38.681225313272705,0.08664852304053994,1584.9247241020203,328.84666752815247,1240.6538047790527,16794,4303,12491,12491,0,22,4419000.0
4419,4419999,21.130306557874018,38.692774818162285,0.08679862010971451,1585.2080504894257,328.91549134254456,1241.267017364502,16794,4303,12491,12491,0,22,4420000.0
4420,4420999,21.130173811906797,38.693269812335025,0.0867867880587071,1585.3897910118103,328.9792106151581,1242.8863945007324,16822,4303,12519,12519,0,22,4421000.0
4421,4421999,21.128499273272798,38.69093819360328,0.08678411288287435,1585.6718482971191,329.04047751426697,1243.8221397399902,16836,4304,12532,12532,0,22,4422000.0
4422,4422999,21.12709055573648,38.688686949951766,0.08677961093760156,1585.9521217346191,329.10275506973267,1244.5411109924316,16841,4305,12536,12536,0,22,4423000.0
4423,4423999,21.126672101601205,38.69288795824163,0.08675073896710028,1586.1364343166351,329.1642997264862,1245.8031425476074,16846,4305,12541,12541,0,22,4424000.0
4424,4424999,21.126297194354393,38.69263987803647,0.08673825639661703,1586.3923544883728,329.2309150695801,1246.6959190368652,16854,4306,12548,12548,0,22,4425000.0
4425,4425999,21.125686946617257,38.691499623340874,0.08672624490614012,1586.7300658226013,329.2969150543213,1247.1628150939941,16859,4308,12551,12551,0,22,4426000.0
4426,4426999,21.124879992992692,38.689414254341926,0.0867214249072461,1587.0957148075104,329.36057686805725,1247.591152191162,16865,4311,12554,12554,0,22,4427000.0
4427,4427999,21.12438865177303,38.687622838231995,0.08672055745495255,1587.4192879199982,329.42560863494873,1248.2563591003418,16878,4314,12564,12564,0,22,4428000.0
4428,4428999,21.124045328711123,38.68627453097661,0.08671510089213053,1587.6869957447052,329.4890103340149,1248.863842010498,16882,4316,12566,12566,0,22,4429000.0
4429,4429999,21.124265429967636,38.689872288834756,0.08669728319217873,1588.0163214206696,329.5525562763214,1249.1887474060059,16884,4317,12567,12567,0,22,4430000.0
4430,4430999,21.125000186887334,38.69078411292958,0.08670270918810152,1588.4568889141083,329.6180911064148,1249.218074798584,16888,4319,12569,12569,0,22,4431000.0
4431,4431999,21.125816529624736,38.69160868412456,0.0867272221926575,1588.7801377773285,329.6840467453003,1249.8114051818848,16890,4320,12570,12570,0,22,4432000.0
4432,4432999,21.126651553774373,38.69255224097669,0.08675266596339948,1589.0886874198914,329.7483608722687,1250.2137870788574,16891,4320,12571,12571,0,22,4433000.0
4433,4433999,21.127867526331418,38.69413729911077,0.0867677139638332,1589.3856890201569,329.8149917125702,1250.675579071045,16893,4321,12572,12572,0,22,4434000.0
4434,4434999,21.129431631096864,38.69714625362219,0.0867957234746759,1589.6209225654602,329.8789732456207,1251.2976341247559,16893,4321,12572,12572,0,22,4435000.0
4435,4435999,21.131770073270737,38.70088207237343,0.08684486805118286,1590.068046092987,329.944052696228,1251.0565452575684,16893,4321,12572,12572,0,22,4436000.0
4436,4436999,21.13354161604893,38.707127233960605,0.08687235895809331,1590.4423112869263,330.00944089889526,1251.2175636291504,16893,4321,12572,12572,0,22,4437000.0
4437,4437999,21.135365681255035,38.7092917662893,0.08692121199858427,1590.9112911224365,330.07471776008606,1250.832332611084,16904,4324,12580,12580,0,22,4438000.0
4438,4438999,21.137502061396216,38.71323790243378,0.08695861498206725,1591.3884987831116,330.1392574310303,1250.7389106750488,16912,4328,12584,12584,0,22,4439000.0
4439,4439999,21.13992067147851,38.717650802280545,0.08701282107819985,1591.5852677822113,330.2036986351013,1251.6318244934082,16912,4328,12584,12584,0,22,4440000.0
4440,4440999,21.14155202603876,38.71889078487759,0.08705134046553564,1592.0193605422974,330.26768732070923,1251.4732093811035,16916,4330,12586,12586,0,22,4441000.0
4441,4441999,21.1415519491665,38.718180060348516,0.08703800243067628,1592.4596281051636,330.3370599746704,1251.9270820617676,16938,4332,12606,12606,0,22,4442000.0
4442,4442999,21.13974710401328,38.71602531260899,0.08704479704612533,1592.7820456027985,330.40209579467773,1252.7408485412598,16957,4333,12624,12624,0,22,4443000.0
4443,4443999,21.13811150503301,38.71473186197032,0.08704626385514969,1593.0911989212036,330.468665599823,1253.3205223083496,16958,4333,12625,12625,0,22,4444000.0
4444,4444999,21.136268736857705,38.71245687692537,0.08705240585060958,1593.4212243556976,330.5331699848175,1253.7480354309082,16959,4333,12626,12626,0,22,4445000.0
4445,4445999,21.134753984314163,38.7100269842661,0.08705356256713037,1593.6578106880188,330.59803104400635,1254.8445625305176,16975,4334,12641,12641,0,22,4446000.0
4446,4446999,21.133165232653187,38.70754328078613,0.08705738311260314,1593.9877557754517,330.66341519355774,1255.451229095459,16981,4337,12644,12644,0,22,4447000.0
4447,4447999,21.131686837211895,38.70534828871617,0.08705597222347716,1594.2530872821808,330.7291934490204,1256.1701011657715,16983,4338,12645,12645,0,22,4448000.0
4448,4448999,21.130316021537766,38.70278322721997,0.08706114817750588,1594.6421222686768,330.797101020813,1256.3151664733887,16986,4339,12647,12647,0,22,4449000.0
4449,4449999,21.128989869375914,38.70033973457818,0.08706404700138726,1594.8962950706482,330.86326479911804,1256.9595222473145,16988,4340,12648,12648,0,22,4450000.0
4450,4450999,21.12778227319316,38.698519941423996,0.0870607850951729,1595.215036869049,330.9284031391144,1257.2096061706543,16988,4340,12648,12648,0,22,4451000.0
4451,4451999,21.126823393871813,38.696320394579544,0.087058965312516,1595.6867580413818,330.99520778656006,1256.9843559265137,16990,4341,12649,12649,0,22,4452000.0
4452,4452999,21.12597025457638,38.69501345121835,0.08705394431618974,1595.9318943023682,331.0617616176605,1257.6539421081543,16990,4341,12649,12649,0,22,4453000.0
4453,4453999,21.12480125535636,38.692535346135905,0.0870568058799126,1596.2637221813202,331.12692189216614,1257.8658561706543,16990,4341,12649,12649,0,22,4454000.0
4454,4454999,21.12392097278154,38.690537022397,0.0870552533872404,1596.6372368335724,331.1928884983063,1257.8664283752441,16990,4341,12649,12649,0,22,4455000.0
4455,4455999,21.123027230396502,38.68828249731284,0.08705866112765648,1597.0850760936737,331.2586359977722,1257.6534385681152,17000,4343,12657,12657,0,22,4456000.0
4456,4456999,21.122267552183164,38.68648365859682,0.08705620459996899,1597.475677728653,331.32371282577515,1257.5950889587402,17002,4344,12658,12658,0,22,4457000.0
4457,4457999,21.121454801212018,38.68446828350035,0.08705705937335295,1597.9191691875458,331.3915505409241,1257.477367401123,17004,4345,12659,12659,0,22,4458000.0
4458,4458999,21.12063919391951,38.682367052945665,0.08705616712873332,1598.335117340088,331.45996594429016,1257.7274436950684,17013,4347,12666,12666,0,22,4459000.0
4459,4459999,21.119828013858168,38.68067314394957,0.08705270595711911,1598.7134664058685,331.528439283371,1258.0085945129395,17021,4348,12673,12673,0,22,4460000.0
4460,4460999,21.118669492644766,38.67928537101291,0.08704915575704841,1599.062126159668,331.59685730934143,1258.9409523010254,17042,4351,12691,12691,0,22,4461000.0
4461,4461999,21.116872249600885,38.67659650342016,0.08705819630401812,1599.387414932251,331.6701567173004,1259.964298248291,17067,4353,12714,12714,0,22,4462000.0
4462,4462999,21.11537364500231,38.67501754145135,0.08706258151036617,1599.5899584293365,331.7344365119934,1261.222095489502,17071,4354,12717,12717,0,22,4463000.0
4463,4463999,21.113589366261333,38.67239614197861,0.08707465263040726,1599.8849546909332,331.79768800735474,1261.9445915222168,17079,4356,12723,12723,0,22,4464000.0
4464,4464999,21.112076327385324,38.670409534219736,0.08707982892190524,1600.0676085948944,331.86125898361206,1262.8771476745605,17079,4356,12723,12723,0,22,4465000.0
4465,4465999,21.110781350877904,38.66878139706686,0.08708410776507203,1600.3235063552856,331.9246897697449,1263.4766960144043,17082,4357,12725,12725,0,22,4466000.0
4466,4466999,21.109579679317335,38.67040695914765,0.08706604464682477,1600.75692486763,331.9907863140106,1263.4124946594238,17089,4360,12729,12729,0,22,4467000.0
4467,4467999,21.108012225270027,38.6676584073123,0.08706820821900474,1601.0181057453156,332.05368399620056,1263.9695625305176,17090,4360,12730,12730,0,22,4468000.0
4468,4468999,21.106683217155847,38.665220945031095,0.08706676293235549,1601.4613635540009,332.1199972629547,1263.8187294006348,17094,4362,12732,12732,0,22,4469000.0
4469,4469999,21.105316903792986,38.66279071699632,0.08707006426109354,1601.7841029167175,332.18507170677185,1264.0670433044434,17094,4362,12732,12732,0,22,4470000.0
4470,4470999,21.10433635098247,38.66089654692903,0.08706676289615045,1602.0119247436523,332.2483079433441,1264.6875038146973,17094,4362,12732,12732,0,22,4471000.0
4471,4471999,21.103641779327738,38.659351060298086,0.08705971279295333,1602.430596113205,332.31536197662354,1264.5767250061035,17096,4363,12733,12733,0,22,4472000.0
4472,4472999,21.10296461762714,38.65832231594339,0.08705081702315709,1602.8664555549622,332.3818688392639,1264.3907051086426,17100,4365,12735,12735,0,22,4473000.0
4473,4473999,21.10247899832974,38.657085845281834,0.087040436553671,1603.2110130786896,332.44718384742737,1264.546215057373,17102,4366,12736,12736,0,22,4474000.0
4474,4474999,21.102089101579057,38.6557816668669,0.08702799688664287,1603.6003668308258,332.51127767562866,1264.5512809753418,17125,4368,12757,12757,0,22,4475000.0
4475,4475999,21.10187431119527,38.65432529293826,0.08701837477952568,1604.1004467010498,332.5770139694214,1264.072826385498,17140,4369,12771,12771,0,22,4476000.0
4476,4476999,21.101374594392244,38.65251383360291,0.08701546031346474,1604.3978428840637,332.643581867218,1264.8248176574707,17142,4370,12772,12772,0,22,4477000.0
4477,4477999,21.101708247932482,38.652148410080166,0.08699225336051386,1604.762230873108,332.7088658809662,1265.0029258728027,17142,4370,12772,12772,0,22,4478000.0
4478,4478999,21.101737240809737,38.65095038133307,0.08698205631373546,1605.1260316371918,332.7763469219208,1265.283878326416,17146,4372,12774,12774,0,22,4479000.0
4479,4479999,21.101558879041,38.649691832944605,0.08696950833904726,1605.3900418281555,332.8432252407074,1265.8129615783691,17148,4373,12775,12775,0,22,4480000.0
4480,4480999,21.101012280428982,38.64855540394748,0.08696080404629258,1605.6022028923035,332.91144704818726,1266.8686637878418,17154,4373,12781,12781,0,22,4481000.0
4481,4481999,21.098979179761,38.64644081665683,0.08696843570183344,1605.8500936031342,332.97762179374695,1267.9845008850098,17162,4374,12788,12788,0,22,4482000.0
4482,4482999,21.097453326549804,38.64729715321615,0.08695190891011972,1606.1430084705353,333.0439908504486,1268.6406288146973,17168,4374,12794,12794,0,22,4483000.0
4483,4483999,21.095709799660856,38.64501623266501,0.08695348339942632,1606.4571642875671,333.107075214386,1269.0033378601074,17169,4374,12795,12795,0,22,4484000.0
4484,4484999,21.094538852705593,38.644386544329706,0.08694538265215379,1606.7690093517303,333.17056012153625,1269.4066734313965,17170,4374,12796,12796,0,22,4485000.0
4485,4485999,21.092981336679923,38.6419051170084,0.0869453760692519,1607.2532992362976,333.2342298030853,1269.449375152588,17192,4378,12814,12814,0,22,4486000.0
4486,4486999,21.091471458048584,38.63938868601827,0.08694804083014773,1607.42236661911,333.3103654384613,1270.8660163879395,17192,4378,12814,12814,0,22,4487000.0
4487,4487999,21.089759334992202,38.63665660482375,0.08695032776205436,1607.6503250598907,333.3737449645996,1271.5807609558105,17193,4378,12815,12815,0,22,4488000.0
4488,4488999,21.088549476198096,38.63463897622316,0.08695063158678495,1607.963665008545,333.4389228820801,1271.956615447998,17201,4380,12821,12821,0,22,4489000.0
4489,4489999,21.08724421163965,38.631940535502714,0.08694942423490659,1608.3229794502258,333.50274538993835,1272.0168952941895,17208,4381,12827,12827,0,22,4490000.0
4490,4490999,21.085830267324354,38.62938206988965,0.08695108747049562,1608.8144342899323,333.5706946849823,1271.6875190734863,17208,4381,12827,12827,0,22,4491000.0
4491,4491999,21.084934943861516,38.627567921398175,0.08694884053118701,1609.200344800949,333.6348547935486,1271.7298011779785,17210,4382,12828,12828,0,22,4492000.0
4492,4492999,21.08431115567409,38.62683636479651,0.08694005922477654,1609.4446620941162,333.70050406455994,1272.38920211792,17210,4382,12828,12828,0,22,4493000.0
4493,4493999,21.08387445755931,38.62583391581165,0.0869320890416947,1609.7283535003662,333.76584911346436,1272.7450675964355,17210,4382,12828,12828,0,22,4494000.0
4494,4494999,21.083315874615366,38.62470015769434,0.08692535256680434,1610.0819280147552,333.83142852783203,1272.7261848449707,17210,4382,12828,12828,0,22,4495000.0
4495,4495999,21.083231860358275,38.62406211684024,0.0869114504800017,1610.4652438163757,333.8980007171631,1272.713306427002,17210,4382,12828,12828,0,22,4496000.0
4496,4496999,21.082863931175893,38.62237874890779,0.0869050455372482,1610.7783586978912,333.96387577056885,1273.0828666687012,17210,4382,12828,12828,0,22,4497000.0
4497,4497999,21.082321144841554,38.62073325410089,0.08690401742698994,1611.1485817432404,334.0293564796448,1273.1469230651855,17212,4383,12829,12829,0,22,4498000.0
4498,4498999,21.082267151173635,38.61962908237349,0.08689602105265826,1611.4660317897797,334.0940372943878,1273.392749786377,17214,4384,12830,12830,0,22,4499000.0
4499,4499999,21.081893498633647,38.61787653358686,0.08688726393255253,1611.9501707553864,334.15950655937195,1272.929889678955,17216,4385,12831,12831,0,22,4500000.0
4500,4500999,21.081794423526933,38.6181628962034,0.08687801167497655,1612.2506890296936,334.2251570224762,1273.310214996338,17216,4385,12831,12831,0,22,4501000.0
4501,4501999,21.081361587420055,38.616388958946345,0.08687383470424204,1612.7022507190704,334.2919433116913,1273.0436058044434,17216,4385,12831,12831,0,22,4502000.0
4502,4502999,21.080815919352382,38.615827685048345,0.08685906687496114,1612.9379336833954,334.360454082489,1274.623218536377,17243,4385,12858,12858,0,22,4503000.0
4503,4503999,21.079509084950875,38.61564508391402,0.08685195282915037,1613.1168987751007,334.42240810394287,1275.963436126709,17250,4385,12865,12865,0,22,4504000.0
4504,4504999,21.078346460499326,38.61329159912528,0.08685068862542433,1613.3521735668182,334.4838581085205,1276.7681999206543,17256,4386,12870,12870,0,22,4505000.0
4505,4505999,21.077331030028304,38.611368336231386,0.08684854345021309,1613.6430163383484,334.54567694664,1277.4081687927246,17261,4388,12873,12873,0,22,4506000.0
4506,4506999,21.07602268012552,38.608600197452986,0.08685173991593897,1614.0193152427673,334.60895824432373,1277.5063514709473,17274,4391,12883,12883,0,22,4507000.0
4507,4507999,21.075257390282466,38.6072384370127,0.08685173677470259,1614.4053359031677,334.67175030708313,1277.6899375915527,17276,4392,12884,12884,0,22,4508000.0
4508,4508999,21.07479724740139,38.605508281935606,0.08685101824209629,1614.8363864421844,334.73635149002075,1277.7985801696777,17288,4395,12893,12893,0,22,4509000.0
4509,4509999,21.074212876892005,38.60374469636291,0.08685343666095013,1615.0988891124725,334.8015787601471,1278.5039710998535,17290,4396,12894,12894,0,22,4510000.0
4510,4510999,21.07339382160415,38.60164044905232,0.08685479781995742,1615.4989559650421,334.8656611442566,1278.526668548584,17296,4399,12897,12897,0,22,4511000.0
4511,4511999,21.072792021411747,38.60025154643217,0.0868550261827159,1615.913423538208,334.92953538894653,1278.5263328552246,17308,4402,12906,12906,0,22,4512000.0
4512,4512999,21.072297047677772,38.5983045164436,0.0868619144442373,1616.2869274616241,334.9927625656128,1278.7801780700684,17308,4402,12906,12906,0,22,4513000.0
4513,4513999,21.071985717772947,38.59709211148957,0.0868676003889115,1616.5325527191162,335.0552809238434,1279.5150718688965,17308,4402,12906,12906,0,22,4514000.0
4514,4514999,21.071728875739392,38.59595990890416,0.08686461199938278,1616.8367011547089,335.1178879737854,1279.9314994812012,17312,4404,12908,12908,0,22,4515000.0
4515,4515999,21.071621512954295,38.59489432586853,0.08686006840971872,1617.2175731658936,335.183429479599,1280.0147743225098,17312,4404,12908,12908,0,22,4516000.0
4516,4516999,21.07145096452208,38.59326337839064,0.08685353495310777,1617.5595712661743,335.24945044517517,1280.272548675537,17314,4405,12909,12909,0,22,4517000.0
4517,4517999,21.07141359870663,38.5920146702017,0.08684737096134332,1617.9640769958496,335.3148398399353,1280.2015571594238,17316,4406,12910,12910,0,22,4518000.0
4518,4518999,21.071259339204765,38.590423816174614,0.086844802850922,1618.413681268692,335.38154101371765,1280.1858177185059,17320,4408,12912,12912,0,22,4519000.0
4519,4519999,21.071508960899408,38.58969976962081,0.08683452839644268,1618.7861378192902,335.4458429813385,1280.3586311340332,17322,4409,12913,12913,0,22,4520000.0
4520,4520999,21.071753786761526,38.588726640332446,0.08682692871974551,1619.1023378372192,335.5098466873169,1280.749439239502,17324,4410,12914,12914,0,22,4521000.0
4521,4521999,21.071710171162135,38.587210205918,0.0868211891039985,1619.5178644657135,335.57506346702576,1280.7068214416504,17324,4410,12914,12914,0,22,4522000.0
4522,4522999,21.071776884708765,38.58602192825252,0.08681254624832124,1619.9368472099304,335.64058089256287,1280.535213470459,17324,4410,12914,12914,0,22,4523000.0
4523,4523999,21.070905017360158,38.58424198726246,0.08680270868657813,1620.1563637256622,335.706298828125,1281.8431587219238,17339,4411,12928,12928,0,22,4524000.0
4524,4524999,21.06888082737929,38.582338985925226,0.08681191334914984,1620.4260475635529,335.76950883865356,1282.6799049377441,17346,4412,12934,12934,0,22,4525000.0
4525,4525999,21.067059356637316,38.57989753319496,0.08681606942629472,1620.653439283371,335.83196806907654,1283.3984336853027,17349,4412,12937,12937,0,22,4526000.0
4526,4526999,21.065026554608657,38.57716832903343,0.08682470474535642,1621.06423330307,335.89546751976013,1283.4156074523926,17351,4413,12938,12938,0,22,4527000.0
4527,4527999,21.063612643579013,38.576388079575395,0.08681771353926582,1621.401818037033,335.9586110115051,1283.6995735168457,17355,4414,12941,12941,0,22,4528000.0
4528,4528999,21.062043939034748,38.574123600393385,0.08681695112806342,1621.8649413585663,336.0218641757965,1283.4397468566895,17361,4417,12944,12944,0,22,4529000.0
4529,4529999,21.060382115823096,38.571189594866325,0.0868197628865196,1622.190680027008,336.086288690567,1283.7816352844238,17363,4418,12945,12945,0,22,4530000.0
4530,4530999,21.058805715582015,38.56852742385945,0.08681605904831802,1622.430370092392,336.1512758731842,1284.4360313415527,17363,4418,12945,12945,0,22,4531000.0
4531,4531999,21.057356969781303,38.566451424744464,0.08681076941926136,1622.8747515678406,336.2156047821045,1284.1680335998535,17365,4419,12946,12946,0,22,4532000.0
4532,4532999,21.05595735768196,38.56412641381095,0.08680465030646778,1623.221540927887,336.2801744937897,1284.2731819152832,17366,4420,12946,12946,0,22,4533000.0
4533,4533999,21.0547427696952,38.56184430882729,0.08680010520980685,1623.547470331192,336.34491634368896,1284.9106483459473,17380,4421,12959,12959,0,22,4534000.0
4534,4534999,21.053810266659493,38.560117293134695,0.08678635723131034,1623.8883979320526,336.4102885723114,1285.3969078063965,17383,4422,12961,12961,0,22,4535000.0
4535,4535999,21.053542647740336,38.560152729593064,0.08676638140313297,1624.1126050949097,336.4741859436035,1286.2386512756348,17384,4422,12962,12962,0,22,4536000.0
4536,4536999,21.052858735546103,38.55874242394052,0.08675347841202596,1624.3049919605255,336.54112815856934,1287.0329551696777,17384,4422,12962,12962,0,22,4537000.0
4537,4537999,21.05230504590259,38.55717863941123,0.08673974326676148,1624.6643855571747,336.60609316825867,1287.0842781066895,17386,4423,12963,12963,0,22,4538000.0
4538,4538999,21.05189641940909,38.55571978778103,0.08672943003491873,1625.001750946045,336.6710877418518,1287.186695098877,17388,4424,12964,12964,0,22,4539000.0
4539,4539999,21.051926327165937,38.554872342239555,0.08671022227983827,1625.4205436706543,336.7407727241516,1287.2071495056152,17392,4426,12966,12966,0,22,4540000.0
4540,4540999,21.052013853698494,38.55444199273682,0.0866910541489414,1625.941335439682,336.809045791626,1286.7473793029785,17398,4429,12969,12969,0,22,4541000.0
4541,4541999,21.05252978786494,38.55425111520046,0.08667530058104134,1626.2270686626434,336.87465238571167,1287.230525970459,17398,4429,12969,12969,0,22,4542000.0
4542,4542999,21.0532531067744,38.554576518425606,0.08664909216166128,1626.6407928466797,336.9421889781952,1287.258701324463,17405,4430,12975,12975,0,22,4543000.0
4543,4543999,21.05416524787994,38.55479707827941,0.08662406046253723,1626.9486014842987,337.0099284648895,1287.6084938049316,17409,4432,12977,12977,0,22,4544000.0
4544,4544999,21.053900273278554,38.55315984413198,0.08661291380943914,1627.4913051128387,337.07679319381714,1287.2721519470215,17409,4432,12977,12977,0,22,4545000.0
4545,4545999,21.05170725035983,38.54990798762792,0.0866263982569242,1627.739409685135,337.14440965652466,1288.5745277404785,17431,4433,12998,12998,0,22,4546000.0
4546,4546999,21.04982749709754,38.54819291760074,0.08662994999759177,1628.0190644264221,337.2100727558136,1289.3386497497559,17438,4433,13005,13005,0,22,4547000.0
4547,4547999,21.048192694355258,38.54771941023511,0.08661961985040145,1628.312106847763,337.27712416648865,1289.8711585998535,17439,4433,13006,13006,0,22,4548000.0
4548,4548999,21.04701937880394,38.54609010763609,0.08661445926549283,1628.6217279434204,337.3413507938385,1290.2876167297363,17443,4434,13009,13009,0,22,4549000.0
4549,4549999,21.04637969445426,38.5458549681739,0.0866043219546343,1629.0045437812805,337.40821981430054,1290.9097633361816,17467,4437,13030,13030,0,22,4550000.0
4550,4550999,21.045786397620322,38.54474700439256,0.08660394624593226,1629.31889462471,337.4746115207672,1291.6220893859863,17471,4439,13032,13032,0,22,4551000.0
4551,4551999,21.04516671757578,38.54444197438512,0.08659265776287284,1629.5007634162903,337.54111409187317,1292.6441459655762,17472,4439,13033,13033,0,22,4552000.0
4552,4552999,21.045145338698877,38.54525709896877,0.08657863458253623,1629.8802716732025,337.6082339286804,1292.719066619873,17474,4440,13034,13034,0,22,4553000.0
4553,4553999,21.04542254904132,38.54601753270968,0.08658093238551201,1630.2325253486633,337.6760425567627,1292.9412879943848,17478,4442,13036,13036,0,22,4554000.0
4554,4554999,21.04580038725918,38.54699587905196,0.08658368912950609,1630.5643513202667,337.74222111701965,1293.2651023864746,17480,4443,13037,13037,0,22,4555000.0
4555,4555999,21.046278420742844,38.548292686656374,0.08659695490428543,1631.0390856266022,337.80937790870667,1292.9906120300293,17482,4444,13038,13038,0,22,4556000.0
4556,4556999,21.04699211818853,38.54943507192178,0.08660419345364667,1631.338440656662,337.8754279613495,1293.4907341003418,17484,4445,13039,13039,0,22,4557000.0
4557,4557999,21.048278360801962,38.551923973974034,0.08659210237930992,1631.7024867534637,337.9437234401703,1293.6733283996582,17487,4446,13041,13041,0,22,4558000.0
4558,4558999,21.050430981334404,38.55614051075421,0.08657401721503244,1632.103901386261,338.01417231559753,1293.6642265319824,17494,4447,13047,13047,0,22,4559000.0
4559,4559999,21.052695121793374,38.55953432643778,0.08656881202912714,1632.4715163707733,338.0817902088165,1293.7916374206543,17494,4447,13047,13047,0,22,4560000.0
4560,4560999,21.054770545369635,38.56217547375371,0.08658928184489023,1632.6740572452545,338.1497495174408,1294.610149383545,17494,4447,13047,13047,0,22,4561000.0
4561,4561999,21.05738645575581,38.56547113953295,0.08661407239429275,1633.295164346695,338.2218568325043,1293.8667488098145,17496,4448,13048,13048,0,22,4562000.0
4562,4562999,21.060005898141156,38.56956505592156,0.08663180054629682,1633.7461895942688,338.2909138202667,1293.7538871765137,17498,4449,13049,13049,0,22,4563000.0
4563,4563999,21.063097105194394,38.573961951776134,0.08666749468496582,1633.9890286922455,338.36091780662537,1294.6017799377441,17505,4450,13055,13055,0,22,4564000.0
4564,4564999,21.06615874968575,38.578026266029575,0.08670171573770702,1634.3204188346863,338.4283866882324,1294.8157386779785,17505,4450,13055,13055,0,22,4565000.0
4565,4565999,21.06859545099858,38.58058728401336,0.08671686325192507,1634.8087708950043,338.4961841106415,1294.464412689209,17507,4451,13056,13056,0,22,4566000.0
4566,4566999,21.0673168830586,38.578145858085655,0.08671019031816252,1635.0501656532288,338.5602226257324,1295.7778358459473,17534,4452,13082,13082,0,22,4567000.0
4567,4567999,21.065631399974333,38.576489132299315,0.0867095550793715,1635.3365359306335,338.6232919692993,1296.64351272583,17556,4453,13103,13103,0,22,4568000.0
4568,4568999,21.064153941991623,38.5753152191201,0.08670312142106928,1635.6271002292633,338.68571734428406,1297.37748336792,17561,4453,13108,13108,0,22,4569000.0
4569,4569999,21.062467160841315,38.57246074761676,0.08670810070663304,1635.8146286010742,338.7487361431122,1298.6009407043457,17569,4453,13116,13116,0,22,4570000.0
4570,4570999,21.060800600072504,38.56973759201908,0.08670745392107726,1636.0694372653961,338.8117878437042,1299.3740425109863,17570,4453,13117,13117,0,22,4571000.0
4571,4571999,21.059388016065416,38.56755939043371,0.0867059404291276,1636.470505475998,338.87698698043823,1299.6833229064941,17576,4456,13120,13120,0,22,4572000.0
4572,4572999,21.05803871370744,38.56586827024663,0.08670054840103314,1636.7451612949371,338.9397852420807,1300.3922309875488,17580,4458,13122,13122,0,22,4573000.0
4573,4573999,21.056816694010575,38.564228502207925,0.08669495552573869,1636.991753578186,339.0034718513489,1301.2171821594238,17583,4459,13124,13124,0,22,4574000.0
4574,4574999,21.05565963594182,38.56269636793645,0.08668433001390252,1637.3803589344025,339.0674741268158,1301.2927589416504,17587,4461,13126,13126,0,22,4575000.0
4575,4575999,21.054806774521943,38.561710135028044,0.08667559204191977,1637.7657778263092,339.1310865879059,1301.539005279541,17598,4464,13134,13134,0,22,4576000.0
4576,4576999,21.054448719476397,38.56612272637802,0.0866418991325103,1638.218369960785,339.1961359977722,1301.478084564209,17606,4468,13138,13138,0,22,4577000.0
4577,4577999,21.055292451932736,38.569385169167255,0.08661561176311117,1638.5200779438019,339.26095390319824,1302.0720100402832,17608,4469,13139,13139,0,22,4578000.0
4578,4578999,21.057719133193096,38.57694272851728,0.08658200130881577,1638.874965429306,339.32538294792175,1302.4661293029785,17609,4469,13140,13140,0,22,4579000.0
4579,4579999,21.060435573195768,38.5840488359298,0.08657905318543202,1639.132465839386,339.38960123062134,1303.114055633545,17614,4470,13144,13144,0,22,4580000.0
4580,4580999,21.063626142095238,38.59341581143582,0.08657125147435651,1639.3252391815186,339.45331168174744,1304.002025604248,17614,4470,13144,13144,0,22,4581000.0
4581,4581999,21.068059545070813,38.605174661263845,0.08663615886616616,1639.6440827846527,339.51788353919983,1304.2679710388184,17616,4471,13145,13145,0,22,4582000.0
4582,4582999,21.07259658812071,38.615886293513725,0.08669141260415925,1640.2285249233246,346.0066454410553,1303.6999778747559,17624,4474,13150,13150,0,22,4583000.0
4583,4583999,21.07758706525992,38.62889162252184,0.08677010554944098,1640.5819885730743,346.07198190689087,1304.0140419006348,17626,4475,13151,13151,0,22,4584000.0
4584,4584999,21.081453757880865,38.63613514371988,0.08684285607973952,1641.1187255382538,346.1383309364319,1303.5504341125488,17630,4477,13153,13153,0,22,4585000.0
4585,4585999,21.08624207101717,38.64402243929386,0.08695370792961332,1641.427790403366,346.20227241516113,1304.0579795837402,17632,4478,13154,13154,0,22,4586000.0
4586,4586999,21.088600008305974,38.64700534111961,0.08697778094411568,1641.786446094513,346.2695655822754,1304.7675743103027,17649,4479,13170,13170,0,22,4587000.0
4587,4587999,21.087648105432248,38.647417781337744,0.08691175146995733,1642.0302298069,346.3339705467224,1305.9669075012207,17665,4480,13185,13185,0,22,4588000.0
4588,4588999,21.08657305175295,38.646908702234235,0.08690304691034778,1642.3176400661469,346.3980522155762,1306.658748626709,17669,4481,13188,13188,0,22,4589000.0
4589,4589999,21.085435247730285,38.64515847664576,0.08689927497181593,1642.5440254211426,346.46244525909424,1307.4094429016113,17670,4481,13189,13189,0,22,4590000.0
4590,4590999,21.084207306812015,38.642965089642956,0.08689701414672646,1642.856109380722,346.52702951431274,1308.1747398376465,17689,4483,13206,13206,0,22,4591000.0
4591,4591999,21.083193199178616,38.64178364392204,0.08688836767526542,1643.2722177505493,346.5913643836975,1308.3469276428223,17695,4486,13209,13209,0,22,4592000.0
4592,4592999,21.082097152198333,38.640725954570414,0.0868771519555257,1643.490516424179,346.65607237815857,1309.3246879577637,17695,4486,13209,13209,0,22,4593000.0
4593,4593999,21.080873990262695,38.63842154668613,0.086874568860143,1643.7083895206451,346.7204473018646,1310.1185417175293,17696,4486,13210,13210,0,22,4594000.0
4594,4594999,21.07988490049286,38.63636631136264,0.08686740605959842,1644.0190539360046,346.7851867675781,1310.5661506652832,17696,4486,13210,13210,0,22,4595000.0
4595,4595999,21.079239510868337,38.63477112232229,0.08685815005572572,1644.317327260971,346.84911704063416,1310.8895378112793,17698,4487,13211,13211,0,22,4596000.0
4596,4596999,21.078946447698176,38.633863433348914,0.086844105230795,1644.7983510494232,346.91410398483276,1310.6057319641113,17704,4490,13214,13214,0,22,4597000.0
4597,4597999,21.078777729478976,38.63375866012406,0.08683063935436919,1645.233627319336,346.97914958000183,1310.452220916748,17712,4491,13221,13221,0,22,4598000.0
4598,4598999,21.078691669911144,38.632802741119114,0.08681525595368778,1645.5499048233032,347.04704999923706,1310.8623161315918,17714,4492,13222,13222,0,22,4599000.0
4599,4599999,21.078911304645715,38.63247524468172,0.08680092608005441,1645.8829815387726,347.11284494400024,1311.2087135314941,17730,4493,13237,13237,0,22,4600000.0
4600,4600999,21.07962346476294,38.63610188533567,0.08677256270782141,1646.124211549759,347.17746567726135,1312.131908416748,17730,4493,13237,13237,0,22,4601000.0
4601,4601999,21.080005445654304,38.6370226645497,0.08675929585320408,1646.510909318924,347.24328684806824,1312.3101234436035,17732,4494,13238,13238,0,22,4602000.0
4602,4602999,21.08085216340293,38.63844209829644,0.08674512012891455,1646.7913565635681,347.310555934906,1312.844150543213,17732,4494,13238,13238,0,22,4603000.0
4603,4603999,21.081376291478872,38.6393644118221,0.08674950675993798,1647.2092485427856,347.37776255607605,1312.9405097961426,17736,4496,13240,13240,0,22,4604000.0
4604,4604999,21.081800743963896,38.638650929761816,0.08674114221615292,1647.7871005535126,347.4463646411896,1312.3694038391113,17738,4497,13241,13241,0,22,4605000.0
4605,4605999,21.08155492625051,38.637744803609245,0.08672685838890604,1647.9857449531555,347.51330971717834,1313.8062705993652,17752,4497,13255,13255,0,22,4606000.0
4606,4606999,21.080680975783125,38.63743946991603,0.08673157032615209,1648.3203856945038,347.5765368938446,1314.4951362609863,17760,4499,13261,13261,0,22,4607000.0
4607,4607999,21.079532436193958,38.635911458142424,0.08672780779444755,1648.5889525413513,347.64009404182434,1315.1774940490723,17764,4499,13265,13265,0,22,4608000.0
4608,4608999,21.07841445378054,38.6340043601183,0.08673212983361311,1648.8101255893707,347.7040822505951,1315.9786643981934,17766,4499,13267,13267,0,22,4609000.0
4609,4609999,21.07837099740698,38.635548633629995,0.08671383489030626,1649.0992953777313,347.7678875923157,1316.648998260498,17779,4500,13279,13279,0,22,4610000.0
4610,4610999,21.079204077800554,38.6370043146723,0.08669712283786546,1649.448352098465,347.83151268959045,1317.1871376037598,17784,4502,13282,13282,0,22,4611000.0
4611,4611999,21.080036890757924,38.63785563552747,0.08669756348597324,1649.7656149864197,347.89576292037964,1317.71431350708,17789,4504,13285,13285,0,22,4612000.0
4612,4612999,21.08102158424172,38.64052524269644,0.08669431591346999,1650.02317070961,347.9597098827362,1318.345142364502,17791,4504,13287,13287,0,22,4613000.0
4613,4613999,21.081693092956954,38.64068085975179,0.08669528429604856,1650.394763469696,348.02417516708374,1318.5577659606934,17797,4507,13290,13290,0,22,4614000.0
4614,4614999,21.08309019563816,38.642618360611465,0.08668851349015694,1650.7430222034454,348.0882887840271,1318.777774810791,17801,4509,13292,13292,0,22,4615000.0
4615,4615999,21.085118408049077,38.64628320937252,0.08668736150906065,1651.140864610672,348.1521952152252,1318.7235984802246,17803,4510,13293,13293,0,22,4616000.0
4616,4616999,21.087040710484494,38.64898265399991,0.08671596918759095,1651.4155759811401,348.21848464012146,1319.3244590759277,17803,4510,13293,13293,0,22,4617000.0
4617,4617999,21.088401077784358,38.65058845913768,0.08672905541669029,1651.783098936081,348.28479981422424,1319.5166664123535,17810,4511,13299,13299,0,22,4618000.0
4618,4618999,21.0902136823675,38.65336238136037,0.08674855016530825,1652.1251003742218,348.3502311706543,1319.7469520568848,17812,4512,13300,13300,0,22,4619000.0
4619,4619999,21.092562616890973,38.65807847462566,0.08677364989005587,1652.418667793274,348.4167277812958,1320.1581077575684,17814,4513,13301,13301,0,22,4620000.0
4620,4620999,21.094308508831766,38.66020933690734,0.08685733511426463,1652.7809176445007,348.4822127819061,1320.239315032959,17818,4515,13303,13303,0,22,4621000.0
4621,4621999,21.096433113840646,38.66447942819799,0.08692293315810073,1653.2625889778137,348.5487811565399,1320.0439186096191,17822,4517,13305,13305,0,22,4622000.0
4622,4622999,21.09905357791506,38.66857255838214,0.08696746642003739,1653.6805863380432,348.6174166202545,1320.000072479248,17830,4518,13312,13312,0,22,4623000.0
4623,4623999,21.101011070502874,38.67075400929152,0.08701395789109334,1654.0031967163086,348.682204246521,1320.3896598815918,17830,4518,13312,13312,0,22,4624000.0
4624,4624999,21.102978526620056,38.67402200184516,0.08703272025284059,1654.3860528469086,348.7483341693878,1320.3786888122559,17831,4519,13312,13312,0,22,4625000.0
4625,4625999,21.104013306943138,38.67420884381295,0.08702754907564003,1654.6738920211792,348.81729102134705,1321.2607383728027,17842,4519,13323,13323,0,22,4626000.0
4626,4626999,21.10285861217725,38.67306140688029,0.08702203036444423,1654.9479887485504,348.88072180747986,1321.9927711486816,17845,4519,13326,13326,0,22,4627000.0
4627,4627999,21.10201188568959,38.671509023528046,0.08702129993323171,1655.3023929595947,348.94421124458313,1322.3502311706543,17854,4521,13333,13333,0,22,4628000.0
4628,4628999,21.101437205591527,38.669941994523946,0.08701745332295574,1655.6013987064362,349.00864696502686,1322.9235343933105,17856,4522,13334,13334,0,22,4629000.0
4629,4629999,21.10123546791282,38.66915628659016,0.08700953893363517,1655.9547197818756,349.07217288017273,1323.1323356628418,17861,4523,13338,13338,0,22,4630000.0
4630,4630999,21.10149855988488,38.66978987320876,0.08699994001846123,1656.5532612800598,349.1378951072693,1322.5899467468262,17874,4528,13346,13346,0,22,4631000.0
4631,4631999,21.10175082019008,38.66975901674746,0.0869906558499739,1656.8670761585236,349.20409965515137,1323.1149635314941,17874,4528,13346,13346,0,22,4632000.0
4632,4632999,21.101811909933293,38.66870506921751,0.08698844545765905,1657.2008383274078,349.2712116241455,1323.4921760559082,17878,4530,13348,13348,0,22,4633000.0
4633,4633999,21.102005505990117,38.66789425185965,0.08699643016583924,1657.557156085968,349.33681082725525,1323.760944366455,17880,4531,13349,13349,0,22,4634000.0
4634,4634999,21.10276754133316,38.6706047930059,0.08700555818666533,1657.9527699947357,349.4016010761261,1323.8270378112793,17881,4532,13349,13349,0,22,4635000.0
4635,4635999,21.103539622852384,38.670959970646166,0.08700292799880283,1658.2938520908356,349.4678797721863,1324.1115684509277,17881,4532,13349,13349,0,22,4636000.0
4636,4636999,21.105531321437397,38.67448509474638,0.08700815625831171,1658.6910648345947,349.53422832489014,1324.1769523620605,17881,4532,13349,13349,0,22,4637000.0
4637,4637999,21.10802808891847,38.678547218495616,0.08702051988553472,1658.951801776886,349.60084652900696,1324.8111457824707,17881,4532,13349,13349,0,22,4638000.0
4638,4638999,21.10990144373476,38.680604692304165,0.08703576266948476,1659.4893743991852,349.66654443740845,1324.355541229248,17901,4535,13366,13366,0,22,4639000.0
4639,4639999,21.11259255841232,38.68426072863843,0.08704859290324651,1659.8154418468475,349.7324788570404,1325.035831451416,17918,4537,13381,13381,0,22,4640000.0
4640,4640999,21.115602382640045,38.68807671710948,0.08707625813654729,1660.148854970932,349.8000614643097,1325.612606048584,17922,4539,13383,13383,0,22,4641000.0
4641,4641999,21.11860155904675,38.69177851479722,0.08711927601387681,1660.3806829452515,349.8665635585785,1326.4409141540527,17922,4539,13383,13383,0,22,4642000.0
4642,4642999,21.122081174682272,38.69845186955436,0.08714378004933732,1660.6584277153015,349.9324052333832,1326.9691886901855,17922,4539,13383,13383,0,22,4643000.0
4643,4643999,21.125874585635593,38.706655983565526,0.08717863595641329,1661.125837802887,349.99926805496216,1326.7349281311035,17926,4541,13385,13385,0,22,4644000.0
4644,4644999,21.128825964209803,38.71080653428856,0.08720465394720611,1661.540277004242,350.0680961608887,1326.8329887390137,17933,4543,13390,13390,0,22,4645000.0
4645,4645999,21.131436686905545,38.71328068946478,0.08721871864097241,1661.9952654838562,350.13582038879395,1326.5678596496582,17933,4543,13390,13390,0,22,4646000.0
4646,4646999,21.13219673572989,38.7142872178824,0.08717536520703884,1662.1919922828674,350.2034924030304,1328.2651863098145,17960,4543,13417,13417,0,22,4647000.0
4647,4647999,21.131082418208482,38.71374903807851,0.08716640218101535,1662.3306431770325,350.26595401763916,1329.911708831787,17968,4543,13425,13425,0,22,4648000.0
4648,4648999,21.130166522804657,38.712350147348246,0.08716175838589624,1662.6294181346893,350.32944679260254,1330.4251823425293,17971,4543,13428,13428,0,22,4649000.0
4649,4649999,21.12956972167022,38.71113592590638,0.08715699975335867,1662.9884836673737,350.39181661605835,1330.894214630127,17985,4546,13439,13439,0,22,4650000.0
4650,4650999,21.129121144745323,38.71082640080679,0.08714663823349433,1663.290361881256,350.4547243118286,1331.4476509094238,17990,4548,13442,13442,0,22,4651000.0
4651,4651999,21.128932510287846,38.709791194944835,0.08714252218188989,1663.7549481391907,350.52087354660034,1331.360912322998,17996,4551,13445,13445,0,22,4652000.0
4652,4652999,21.128617059324142,38.70901969127331,0.08713188036544561,1664.030634880066,350.5850758552551,1331.947078704834,17996,4551,13445,13445,0,22,4653000.0
4653,4653999,21.128113129532874,38.707397776499846,0.08713300255953937,1664.4277431964874,350.6492908000946,1331.951976776123,18002,4554,13448,13448,0,22,4654000.0
4654,4654999,21.128256435211565,38.70772202583981,0.08712851845445257,1664.8276047706604,350.71217703819275,1332.0890312194824,18008,4557,13451,13451,0,22,4655000.0
4655,4655999,21.128640490501127,38.70863029221071,0.08712543215881174,1665.1076192855835,350.77710700035095,1332.608814239502,18008,4557,13451,13451,0,22,4656000.0
4656,4656999,21.129218077374556,38.70917754111177,0.08713998604549078,1665.462564945221,350.84382677078247,1332.7857398986816,18010,4558,13452,13452,0,22,4657000.0
4657,4657999,21.130404174989273,38.713097023608526,0.08716169257384598,1665.7699608802795,350.9067327976227,1333.1823616027832,18012,4559,13453,13453,0,22,4658000.0
4658,4658999,21.131209910875157,38.71476657296537,0.0871678453362772,1666.1407551765442,350.97145915031433,1333.3337364196777,18017,4560,13457,13457,0,22,4659000.0
4659,4659999,21.132027466037652,38.71530822258274,0.08716942221439072,1666.4471752643585,351.03472232818604,1333.768123626709,18019,4561,13458,13458,0,22,4660000.0
4660,4660999,21.132929242776314,38.71618110074438,0.08717317186899032,1666.793221950531,351.099894285202,1333.9381675720215,18021,4562,13459,13459,0,22,4661000.0
4661,4661999,21.134942011269413,38.71891369215819,0.08719379233205804,1667.1761124134064,351.1643822193146,1334.0470085144043,18023,4563,13460,13460,0,22,4662000.0
4662,4662999,21.136945588214285,38.72281752403475,0.08719416475139752,1667.584097623825,351.2283260822296,1334.0540199279785,18025,4564,13461,13461,0,22,4663000.0
4663,4663999,21.138518476317433,38.724320723416255,0.08720959760501323,1667.8304932117462,351.2925531864166,1334.6796607971191,18025,4564,13461,13461,0,22,4664000.0
4664,4664999,21.140045041898208,38.724998238415964,0.08721654788230604,1668.475527048111,351.3568139076233,1333.641674041748,18036,4567,13469,13469,0,22,4665000.0
4665,4665999,21.14160696991352,38.726338388195195,0.08722153518472708,1668.864429473877,351.4238920211792,1333.8132438659668,18036,4567,13469,13469,0,22,4666000.0
4666,4666999,21.142270730598614,38.72584715031808,0.0872194505949434,1669.1702077388763,351.4946777820587,1334.6495094299316,18046,4567,13479,13479,0,22,4667000.0
4667,4667999,21.140991133045787,38.72416689361897,0.08721525431886368,1669.3722076416016,351.55943751335144,1335.9546165466309,18056,4568,13488,13488,0,22,4668000.0
4668,4668999,21.13943954671795,38.722065952764,0.08721584486359857,1669.7577514648438,351.62562131881714,1336.190029144287,18064,4570,13494,13494,0,22,4669000.0
4669,4669999,21.137950125482398,38.71960954326388,0.08721907463801315,1670.1370754241943,351.692218542099,1336.3857612609863,18066,4571,13495,13495,0,22,4670000.0
4670,4670999,21.136891041318957,38.71864905445466,0.08720677416578126,1670.4030086994171,351.7567629814148,1337.0208168029785,18083,4573,13510,13510,0,22,4671000.0
4671,4671999,21.135431523219612,38.71611658359448,0.08720868319404895,1670.78542137146,351.82232093811035,1337.458797454834,18088,4575,13513,13513,0,22,4672000.0
4672,4672999,21.134029970674963,38.71332147166085,0.08721134004132103,1671.1121368408203,351.8862226009369,1337.988597869873,18090,4576,13514,13514,0,22,4673000.0
4673,4673999,21.13324343923021,38.712555690087974,0.08720667616750277,1671.3647496700287,351.95007848739624,1338.6469078063965,18097,4577,13520,13520,0,22,4674000.0
4674,4674999,21.132148626600486,38.71025806491148,0.08721033062970696,1671.6524498462677,352.01426553726196,1339.3618278503418,18110,4578,13532,13532,0,22,4675000.0
4675,4675999,21.131394449109,38.70856214663098,0.08720781576406367,1671.9431002140045,352.0781292915344,1339.9174766540527,18112,4579,13533,13533,0,22,4676000.0
4676,4676999,21.130754347597524,38.707215773919536,0.08720931120980158,1672.4185223579407,352.1454439163208,1339.7233390808105,18122,4581,13541,13541,0,22,4677000.0
4677,4677999,21.13040664598633,38.70621617638934,0.08720887950535094,1672.7375996112823,352.2115697860718,1340.0234489440918,18122,4581,13541,13541,0,22,4678000.0
4678,4678999,21.130555711485894,38.70856266600589,0.08719830746545254,1673.1121017932892,352.2773947715759,1340.2125205993652,18129,4583,13546,13546,0,22,4679000.0
4679,4679999,21.130343046554135,38.70779324481538,0.08719004301254174,1673.3489010334015,352.3443970680237,1340.81693649292,18129,4583,13546,13546,0,22,4680000.0
4680,4680999,21.13073757416539,38.70786608286445,0.08718533728406552,1673.6699795722961,352.41169595718384,1341.1657600402832,18129,4583,13546,13546,0,22,4681000.0
4681,4681999,21.131470356492258,38.708620931088745,0.08718191242271012,1673.9516561031342,352.4766480922699,1341.6088218688965,18129,4583,13546,13546,0,22,4682000.0
4682,4682999,21.132360228721527,38.708978019079694,0.08718824658722546,1674.3794827461243,352.54197549819946,1341.5315055847168,18131,4584,13547,13547,0,22,4683000.0
4683,4683999,21.134576508775037,38.721331319036395,0.08715278034903284,1674.8081049919128,352.608500957489,1341.453929901123,18133,4585,13548,13548,0,22,4684000.0
4684,4684999,21.135768345454874,38.72283759427444,0.08714558369495007,1675.1274201869965,352.67470049858093,1341.8166542053223,18133,4585,13548,13548,0,22,4685000.0
4685,4685999,21.136945698868455,38.72587597744268,0.0871573003447208,1675.3817954063416,352.7394988536835,1342.2914543151855,18133,4585,13548,13548,0,22,4686000.0
4686,4686999,21.138255404024576,38.727287023553764,0.08715711555981087,1675.885998249054,352.80656361579895,1341.9079780578613,18137,4587,13550,13550,0,22,4687000.0
4687,4687999,21.13808637145988,38.72643518502974,0.08714971916536796,1676.1640491485596,352.8729431629181,1342.8657188415527,18149,4587,13562,13562,0,22,4688000.0
4688,4688999,21.13692748347374,38.725525778475095,0.08714515106171628,1676.455314397812,352.93734788894653,1343.703914642334,18161,4588,13573,13573,0,22,4689000.0
4689,4689999,21.136015811071545,38.726358071551914,0.08713935452323751,1676.7518615722656,353.0017774105072,1344.3611030578613,18171,4589,13582,13582,0,22,4690000.0
4690,4690999,21.135299050697157,38.7254319465399,0.08712936791644543,1677.107850074768,353.06733202934265,1344.5854530334473,18178,4590,13588,13588,0,22,4691000.0
4691,4691999,21.134150475302697,38.723133906101644,0.08713075594361686,1677.4408128261566,353.13440132141113,1345.10306930542,18199,4592,13607,13607,0,22,4692000.0
4692,4692999,21.133332570306187,38.72156458948449,0.08712665292978405,1677.789695739746,353.2012765407562,1345.9093284606934,18205,4595,13610,13610,0,22,4693000.0
4693,4693999,21.1329433048916,38.72123302877582,0.08711263743638276,1678.023324728012,353.26878905296326,1346.9217948913574,18207,4596,13611,13611,0,22,4694000.0
4694,4694999,21.132250184894914,38.71933126941984,0.08711210521145307,1678.3311896324158,353.3368921279907,1347.4395866394043,18210,4597,13613,13613,0,22,4695000.0
4695,4695999,21.131874972908196,38.71899190997863,0.08710022945836626,1678.7126421928406,353.40670228004456,1347.541835784912,18210,4597,13613,13613,0,22,4696000.0
4696,4696999,21.13220432277126,38.71990071824752,0.0870838340556267,1679.0688245296478,353.47438955307007,1347.822811126709,18220,4599,13621,13621,0,22,4697000.0
4697,4697999,21.132612626156668,38.721996667724824,0.08707596182713961,1679.4329907894135,353.54234504699707,1348.020420074463,18220,4599,13621,13621,0,22,4698000.0
4698,4698999,21.133455948662057,38.72377519450637,0.08708305237614933,1679.7587008476257,353.6087040901184,1348.2355842590332,18220,4599,13621,13621,0,22,4699000.0
4699,4699999,21.13513082169206,38.729274929541106,0.08708142407496766,1680.1263456344604,353.67576789855957,1348.3159980773926,18224,4601,13623,13623,0,22,4700000.0
4700,4700999,21.136984689072197,38.733984759041626,0.08707321066872908,1680.4716062545776,353.74357056617737,1348.6556129455566,18226,4602,13624,13624,0,22,4701000.0
4701,4701999,21.139446333277277,38.741725269778925,0.08704177455058859,1680.9404108524323,353.8111643791199,1348.5159034729004,18240,4604,13636,13636,0,22,4702000.0
4702,4702999,21.142438386765395,38.75034306862824,0.08703547816501656,1681.1891152858734,353.87920093536377,1349.0556373596191,18240,4604,13636,13636,0,22,4703000.0
4703,4703999,21.146030930047054,38.76156631402431,0.08702016368144105,1681.6761271953583,353.9478073120117,1348.8500709533691,18246,4607,13639,13639,0,22,4704000.0
4704,4704999,21.14984480143175,38.77109294035681,0.0870744180535028,1682.11980676651,354.01846647262573,1348.8831977844238,18253,4608,13645,13645,0,22,4705000.0
4705,4705999,21.153440635199864,38.78151550706031,0.0870681374986424,1682.4391522407532,354.08941316604614,1349.3201789855957,18255,4609,13646,13646,0,22,4706000.0
4706,4706999,21.15799748403187,38.792690859407834,0.08706787078426359,1682.8434686660767,354.1607892513275,1349.398494720459,18257,4610,13647,13647,0,22,4707000.0
4707,4707999,21.160800449020915,38.798100024547516,0.08705126355731696,1683.2812445163727,354.2314524650574,1349.88724899292,18276,4610,13666,13666,0,22,4708000.0
4708,4708999,21.159039806731858,38.79529589808464,0.08705262912006351,1683.631620168686,354.2990005016327,1350.686595916748,18294,4611,13683,13683,0,22,4709000.0
4709,4709999,21.158294536237708,38.79524506809969,0.08703437872791331,1683.9033632278442,354.36436676979065,1351.5228309631348,18300,4611,13689,13689,0,22,4710000.0
4710,4710999,21.15759890660311,38.79474990556231,0.08701939509740675,1684.1419496536255,354.4269323348999,1352.5373268127441,18305,4612,13693,13693,0,22,4711000.0
4711,4711999,21.15685406041464,38.79342512622481,0.08700803526286649,1684.332203388214,354.4895443916321,1353.71236038208,18311,4612,13699,13699,0,22,4712000.0
4712,4712999,21.156321815873333,38.79211083722402,0.0869991445846705,1684.5488271713257,354.5529637336731,1354.7301216125488,18312,4612,13700,13700,0,22,4713000.0
4713,4713999,21.15568365621553,38.78992365283171,0.08699440255130442,1685.0466783046722,354.6166133880615,1354.5825462341309,18322,4617,13705,13705,0,22,4714000.0
4714,4714999,21.15507309394151,38.78796010919597,0.08699391491032615,1685.388079881668,354.67965817451477,1355.123462677002,18329,4620,13709,13709,0,22,4715000.0
4715,4715999,21.15445480396376,38.78637923360008,0.0869930282130581,1685.6667187213898,354.74353098869324,1355.81343460083,18333,4622,13711,13711,0,22,4716000.0
4716,4716999,21.15398513720765,38.786513041140545,0.08698200310659676,1685.9191617965698,354.80761528015137,1356.5307960510254,18335,4623,13712,13712,0,22,4717000.0
4717,4717999,21.153909731747916,38.78597290351646,0.08697591278351391,1686.3200223445892,354.87129950523376,1356.6252403259277,18339,4625,13714,13714,0,22,4718000.0
4718,4718999,21.154177736585762,38.786087462367156,0.08696388400119626,1686.6735639572144,354.9373643398285,1356.9270515441895,18341,4626,13715,13715,0,22,4719000.0
4719,4719999,21.154537225924702,38.78671140316077,0.08696048797426648,1687.1676905155182,355.0048522949219,1356.6646614074707,18344,4627,13717,13717,0,22,4720000.0
4720,4720999,21.155555014167202,38.788395643204005,0.08694638386429898,1687.3870933055878,355.0690915584564,1357.592357635498,18344,4627,13717,13717,0,22,4721000.0
4721,4721999,21.157520956599804,38.79212842940587,0.0869296779023857,1687.7081987857819,355.13329005241394,1357.9972953796387,18344,4627,13717,13717,0,22,4722000.0
4722,4722999,21.160481553017174,38.79859545527148,0.08691929582323354,1687.9883968830109,355.1968150138855,1358.5033073425293,18344,4627,13717,13717,0,22,4723000.0
4723,4723999,21.16450392683688,38.80651724503976,0.08693608025844746,1688.315550327301,355.2623784542084,1358.792148590088,18346,4628,13718,13718,0,22,4724000.0
4724,4724999,21.16797594277168,38.8118606120179,0.08696228375036685,1688.796050310135,355.32774090766907,1358.5675010681152,18352,4631,13721,13721,0,22,4725000.0
4725,4725999,21.171943575544958,38.8188854488006,0.08699047234745605,1689.155225276947,355.39323902130127,1358.953182220459,18352,4631,13721,13721,0,22,4726000.0
4726,4726999,21.176630272197055,38.829751688707205,0.08702167076857314,1689.3645331859589,355.4575934410095,1359.778392791748,18352,4631,13721,13721,0,22,4727000.0
4727,4727999,21.18016328608246,38.836604744933865,0.08707749737330928,1689.7638647556305,355.5224058628082,1359.7353477478027,18354,4632,13722,13722,0,22,4728000.0
4728,4728999,21.18107856164762,38.837185048810646,0.08709363486096589,1690.2172076702118,355.5879352092743,1360.1486320495605,18378,4635,13743,13743,0,22,4729000.0
4729,4729999,21.180791958343402,38.837921219877586,0.08707910257948659,1690.4935522079468,355.65296840667725,1361.1531028747559,18391,4635,13756,13756,0,22,4730000.0
4730,4730999,21.180667944721744,38.8381096862573,0.08706128937483282,1690.8706228733063,355.7191550731659,1361.5180854797363,18403,4637,13766,13766,0,22,4731000.0
4731,4731999,21.18085863924344,38.8384166431479,0.08706057095154562,1691.3091390132904,355.7856149673462,1361.64262008667,18421,4639,13782,13782,0,22,4732000.0
4732,4732999,21.181019814848465,38.8390485650577,0.08705620818563231,1691.5035798549652,355.8519570827484,1363.164882659912,18427,4640,13787,13787,0,22,4733000.0
4733,4733999,21.180720926015923,38.838046256028086,0.08705285353245729,1691.7179698944092,355.91647148132324,1364.1435508728027,18427,4640,13787,13787,0,22,4734000.0
4734,4734999,21.180380100416137,38.837301098998246,0.08706342574589476,1692.1491236686707,355.98332476615906,1364.2772254943848,18434,4643,13791,13791,0,22,4735000.0
4735,4735999,21.179960506335654,38.83621683617414,0.08706954444581017,1692.465561389923,356.04724407196045,1364.8082160949707,18439,4645,13794,13794,0,22,4736000.0
4736,4736999,21.18006134810227,38.83605406024934,0.08706400525559144,1692.766987323761,356.11304092407227,1365.3137016296387,18441,4646,13795,13795,0,22,4737000.0
4737,4737999,21.180392258638467,38.8360634147148,0.0870696948702595,1693.3156323432922,356.1790089607239,1364.8225593566895,18469,4649,13820,13820,0,22,4738000.0
4738,4738999,21.18051755093566,38.835329719813885,0.08707298873776137,1693.6835489273071,356.24575877189636,1365.0814399719238,18469,4649,13820,13820,0,22,4739000.0
4739,4739999,21.18075912263191,38.83495233402065,0.08708158363302665,1693.8861937522888,356.31035447120667,1365.9057426452637,18469,4649,13820,13820,0,22,4740000.0
4740,4740999,21.180953811295538,38.83453415841371,0.08709515884011532,1694.2161469459534,356.3761417865753,1366.176082611084,18469,4649,13820,13820,0,22,4741000.0
4741,4741999,21.181882861260796,38.835697423267554,0.08711173850141118,1694.505199432373,356.4407274723053,1366.5858192443848,18469,4649,13820,13820,0,22,4742000.0
4742,4742999,21.18333425078449,38.83837948205373,0.08713841242569542,1694.9512495994568,356.50720024108887,1366.4239387512207,18473,4651,13822,13822,0,22,4743000.0
4743,4743999,21.184515535350222,38.83924561522824,0.08717220509565926,1695.3524222373962,356.5736463069916,1366.544101715088,18475,4652,13823,13823,0,22,4744000.0
4744,4744999,21.185650877917748,38.84073829484502,0.08718239854627563,1695.8254396915436,356.6396954059601,1366.408893585205,18480,4654,13826,13826,0,22,4745000.0
4745,4745999,21.18714394615721,38.84365391371948,0.08717657934443157,1696.1301629543304,356.7056622505188,1366.945110321045,18480,4654,13826,13826,0,22,4746000.0
4746,4746999,21.187449491621393,38.84602574492671,0.08716200528758333,1696.4875667095184,356.77306151390076,1367.8478050231934,18501,4655,13846,13846,0,22,4747000.0
4747,4747999,21.186037113658582,38.84484521733774,0.0871638656903514,1696.8358309268951,356.8359875679016,1368.6042594909668,18511,4657,13854,13854,0,22,4748000.0
4748,4748999,21.184253457980375,38.84203314023498,0.08718244351958548,1697.0954325199127,356.89930415153503,1369.4657020568848,18526,4658,13868,13868,0,22,4749000.0
4749,4749999,21.18268987967058,38.84039551447182,0.0871904122173095,1697.3031022548676,356.9623963832855,1370.701816558838,18527,4658,13869,13869,0,22,4750000.0
4750,4750999,21.181022535490076,38.83797647339439,0.0872015637782706,1697.5242466926575,357.0297839641571,1371.60054397583,18527,4658,13869,13869,0,22,4751000.0
4751,4751999,21.179640949891773,38.83614308579873,0.08720459800489255,1697.851000070572,357.0953149795532,1372.0249214172363,18531,4659,13872,13872,0,22,4752000.0
4752,4752999,21.178040916471417,38.83333843890567,0.08721305185620809,1698.0602350234985,357.1580021381378,1372.9228782653809,18534,4660,13874,13874,0,22,4753000.0
4753,4753999,21.17649414296247,38.830973587749554,0.08721745176930318,1698.4322640895844,357.2214298248291,1373.1410865783691,18538,4662,13876,13876,0,22,4754000.0
4754,4754999,21.175197977715634,38.82875544035774,0.0872173040474753,1698.7551620006561,357.286208152771,1373.5594749450684,18540,4663,13877,13877,0,22,4755000.0
4755,4755999,21.173879667391994,38.82632906525947,0.08721766789204755,1699.0785701274872,357.35102343559265,1373.8326377868652,18542,4664,13878,13878,0,22,4756000.0
4756,4756999,21.17321722732696,38.82510709944033,0.08720455505950853,1699.3381683826447,357.41286063194275,1374.3082389831543,18542,4664,13878,13878,0,22,4757000.0
4757,4757999,21.172658156198512,38.823857920878446,0.08719990691685564,1699.9836485385895,357.4785387516022,1373.2345008850098,18553,4668,13885,13885,0,22,4758000.0
4758,4758999,21.171924171304727,38.82217812501482,0.08719703033232251,1700.2949707508087,357.5421566963196,1373.679141998291,18555,4669,13886,13886,0,22,4759000.0
4759,4759999,21.172347064555126,38.822440346636775,0.08718703551965845,1700.6156258583069,357.6081030368805,1374.0909309387207,18555,4669,13886,13886,0,22,4760000.0
4760,4760999,21.172954714436756,38.824203084092055,0.08717599059424253,1700.964846611023,357.67395639419556,1374.2511711120605,18563,4670,13893,13893,0,22,4761000.0
4761,4761999,21.17368646001585,38.824428236722405,0.08717138954937487,1701.4718322753906,357.738751411438,1373.8474082946777,18569,4673,13896,13896,0,22,4762000.0
4762,4762999,21.174796846988457,38.82730002587818,0.08715783904669905,1701.8362684249878,357.80374026298523,1374.070713043213,18573,4675,13898,13898,0,22,4763000.0
4763,4763999,21.175486036170067,38.82776575148222,0.08715757726925688,1702.288414478302,357.8711431026459,1374.0224571228027,18577,4677,13900,13900,0,22,4764000.0
4764,4764999,21.175749644900772,38.826814244062135,0.08715864268722284,1702.6496975421906,357.93795228004456,1374.2449836730957,18578,4677,13901,13901,0,22,4765000.0
4765,4765999,21.175876063877432,38.82571774855075,0.08715695961897407,1702.914564371109,358.00154542922974,1374.837230682373,18578,4677,13901,13901,0,22,4766000.0
4766,4766999,21.175906102800234,38.82839173610324,0.08714559910076491,1703.1509268283844,358.06912112236023,1375.9262962341309,18589,4677,13912,13912,0,22,4767000.0
4767,4767999,21.173933229997488,38.82573587274995,0.08715832096413045,1703.4413998126984,358.1316874027252,1376.7074012756348,18595,4678,13917,13917,0,22,4768000.0
4768,4768999,21.172117532711706,38.82307611774498,0.08717011422966436,1703.7077445983887,358.1952154636383,1377.3532447814941,18596,4678,13918,13918,0,22,4769000.0
4769,4769999,21.170513566320807,38.82059248056871,0.08717822917996898,1704.0605916976929,358.2592704296112,1377.7007331848145,18598,4679,13919,13919,0,22,4770000.0
4770,4770999,21.169023503773012,38.81838329457469,0.0871828258235442,1704.384522676468,358.32250332832336,1378.2555046081543,18616,4681,13935,13935,0,22,4771000.0
4771,4771999,21.167750200364296,38.815828976592194,0.08718867120973428,1704.7553899288177,358.38671255111694,1378.798984527588,18624,4684,13940,13940,0,22,4772000.0
4772,4772999,21.16639842738155,38.813618045505336,0.08719409821813717,1704.943844795227,358.4512231349945,1379.7464485168457,18624,4684,13940,13940,0,22,4773000.0
4773,4773999,21.165249877129707,38.811260123632785,0.08719677606600773,1705.3560602664948,358.51699590682983,1379.7578620910645,18626,4685,13941,13941,0,22,4774000.0
4774,4774999,21.16445055500644,38.80968195364307,0.08719583506751438,1705.5917854309082,358.5817563533783,1380.5829887390137,18634,4686,13948,13948,0,22,4775000.0
4775,4775999,21.163242156196347,38.807562822583485,0.0871979319184325,1705.9475507736206,358.64701795578003,1380.6915016174316,18634,4686,13948,13948,0,22,4776000.0
4776,4776999,21.162068704665412,38.805045107405974,0.08719925132962703,1706.3367228507996,358.7126979827881,1380.6450691223145,18634,4686,13948,13948,0,22,4777000.0
4777,4777999,21.16119081302952,38.803206498708,0.08719974585386137,1706.7185754776,358.78072690963745,1380.7236671447754,18634,4686,13948,13948,0,22,4778000.0
4778,4778999,21.160046255577573,38.80070150053571,0.08720336611428903,1707.0930898189545,358.8468737602234,1380.809268951416,18634,4686,13948,13948,0,22,4779000.0
4779,4779999,21.159329795554484,38.799276787097796,0.08719917353022721,1707.415817975998,358.9113094806671,1380.969882965088,18634,4686,13948,13948,0,22,4780000.0
4780,4780999,21.1587976297329,38.79772652099047,0.08719346472874023,1707.791740655899,358.97922563552856,1381.1242713928223,18636,4687,13949,13949,0,22,4781000.0
4781,4781999,21.158189948672582,38.79636443431525,0.0871897406175266,1708.0941643714905,359.04323720932007,1381.4111137390137,18636,4687,13949,13949,0,22,4782000.0
4782,4782999,21.15795733391953,38.79523481080947,0.08718841732788674,1708.3794965744019,359.10746669769287,1381.8833198547363,18657,4688,13969,13969,0,22,4783000.0
4783,4783999,21.157745465343165,38.79447634911697,0.08717857063602807,1709.0014152526855,359.17346358299255,1380.9003105163574,18659,4689,13970,13970,0,22,4784000.0
4784,4784999,21.15793568801805,38.79426151431426,0.0871651969016185,1709.3482468128204,359.23790550231934,1381.1095008850098,18661,4690,13971,13971,0,22,4785000.0
4785,4785999,21.157626152557786,38.79303045318851,0.08715980854689398,1709.6913316249847,359.30371141433716,1381.38334274292,18663,4691,13972,13972,0,22,4786000.0
4786,4786999,21.157197908739853,38.79134332549754,0.0871618608264817,1710.0406980514526,359.3681859970093,1381.6106071472168,18665,4692,13973,13973,0,22,4787000.0
4787,4787999,21.156409359919596,38.79298165346027,0.08714324736974322,1710.5774545669556,359.4373891353607,1381.1601448059082,18677,4693,13984,13984,0,22,4788000.0
4788,4788999,21.15475698906908,38.79182257600897,0.08714313453555889,1710.7161276340485,359.50184988975525,1383.3150215148926,18705,4693,14012,14012,0,22,4789000.0
4789,4789999,21.152678934933522,38.78859249090704,0.0871638794931352,1710.8774876594543,359.57356691360474,1384.6792640686035,18710,4693,14017,14017,0,22,4790000.0
4790,4790999,21.150929519187024,38.786711003243276,0.08717498986016603,1711.180674791336,359.6354639530182,1385.2797813415527,18714,4695,14019,14019,0,22,4791000.0
4791,4791999,21.14918938464756,38.783799115568044,0.08719509525317692,1711.516804933548,359.70130443573,1385.7690391540527,18728,4698,14030,14030,0,22,4792000.0
4792,4792999,21.14730275930828,38.78128815077588,0.08721027607736864,1711.8702516555786,359.7637276649475,1386.018383026123,18733,4700,14033,14033,0,22,4793000.0
4793,4793999,21.14556454136258,38.77885521654706,0.08722692049346237,1712.2778553962708,359.82616567611694,1386.1857109069824,18741,4704,14037,14037,0,22,4794000.0
4794,4794999,21.14373767676361,38.776012178078815,0.08724164670470358,1712.6259989738464,359.8891487121582,1386.643726348877,18746,4706,14040,14040,0,22,4795000.0
4795,4795999,21.141740230578698,38.773001220787535,0.0872599567614113,1712.8565564155579,359.9541528224945,1387.4119911193848,18746,4706,14040,14040,0,22,4796000.0
4796,4796999,21.14004504460414,38.77028747501604,0.08727067258089538,1713.3958599567413,360.0199155807495,1386.9537620544434,18754,4710,14044,14044,0,22,4797000.0
4797,4797999,21.13842598251241,38.767893471746646,0.08728160785737893,1713.5976293087006,360.08335041999817,1387.8248329162598,18754,4710,14044,14044,0,22,4798000.0
4798,4798999,21.137002966485714,38.765328706138305,0.0872900361643224,1714.0962398052216,360.14949893951416,1387.4895973205566,18778,4711,14067,14067,0,22,4799000.0
4799,4799999,21.135475133833886,38.7627327792172,0.08730031663737048,1714.4639999866486,360.2127606868744,1387.572582244873,18783,4712,14071,14071,0,22,4800000.0
4800,4800999,21.13409220294217,38.76060783332617,0.08730554845263594,1714.7759306430817,360.2785425186157,1387.9216270446777,18785,4713,14072,14072,0,22,4801000.0
4801,4801999,21.13285993654838,38.75872407115092,0.08730926444278941,1715.1439399719238,360.3435733318329,1388.0055046081543,18787,4714,14073,14073,0,22,4802000.0
4802,4802999,21.13202664871296,38.75720156099484,0.0873051944764478,1715.6100199222565,360.41039204597473,1387.8440132141113,18797,4716,14081,14081,0,22,4803000.0
4803,4803999,21.131158935334124,38.75518956344449,0.08731246531773496,1716.0850932598114,360.47477889060974,1387.6977500915527,18803,4719,14084,14084,0,22,4804000.0
4804,4804999,21.1302346308916,38.75312325681099,0.08731827327862418,1716.4367263317108,360.5398473739624,1388.0531883239746,18805,4720,14085,14085,0,22,4805000.0
4805,4805999,21.12976384931097,38.75308679555615,0.08730926077688927,1716.707375049591,360.6041450500488,1388.5747108459473,18807,4721,14086,14086,0,22,4806000.0
4806,4806999,21.12876822051662,38.75077009465912,0.08731439552549858,1717.200856924057,360.66884875297546,1388.0359916687012,18807,4721,14086,14086,0,22,4807000.0
4807,4807999,21.127537576681494,38.748268081291364,0.08732265340833967,1717.5928995609283,360.73366355895996,1388.1510047912598,18807,4721,14086,14086,0,22,4808000.0
4808,4808999,21.126311670011436,38.74783473849797,0.08732472544962078,1717.8751084804535,360.79913902282715,1389.0896644592285,18817,4721,14096,14096,0,22,4809000.0
4809,4809999,21.124180055797247,38.74546474551389,0.0873426734873246,1718.2291314601898,360.86348938941956,1389.5794258117676,18824,4722,14102,14102,0,22,4810000.0
4810,4810999,21.122190614070426,38.74251581668713,0.08735988152342578,1718.4341592788696,360.9282088279724,1390.839672088623,18841,4723,14118,14118,0,22,4811000.0
4811,4811999,21.12059665000727,38.74162455460194,0.08736536262574235,1718.7391963005066,360.99334836006165,1391.571361541748,18849,4725,14124,14124,0,22,4812000.0
4812,4812999,21.11886602612556,38.739002653417735,0.08737846655016268,1719.08571767807,361.0608274936676,1391.9729194641113,18862,4728,14134,14134,0,22,4813000.0
4813,4813999,21.11712184041194,38.736600462544665,0.08738955649964719,1719.365877866745,361.12580943107605,1392.6872596740723,18864,4729,14135,14135,0,22,4814000.0
4814,4814999,21.115394152326434,38.734538427752675,0.0873971325280265,1719.5904488563538,361.1923017501831,1393.3452339172363,18864,4729,14135,14135,0,22,4815000.0
4815,4815999,21.113793884657415,38.73192664991124,0.08740818726826394,1719.9254839420319,361.25651240348816,1393.4766273498535,18865,4729,14136,14136,0,22,4816000.0
4816,4816999,21.11209914780907,38.7293139557253,0.08741721594562324,1720.4363627433777,361.323130607605,1393.2000465393066,18876,4732,14144,14144,0,22,4817000.0
4817,4817999,21.11050154540742,38.72700885086763,0.0874239938564274,1720.644767999649,361.3877272605896,1393.9416007995605,18876,4732,14144,14144,0,22,4818000.0
4818,4818999,21.1093943063056,38.725217522384014,0.08741901452786627,1721.1043021678925,361.4532868862152,1393.8378791809082,18880,4734,14146,14146,0,22,4819000.0
4819,4819999,21.108561238753275,38.72402650163378,0.08740588968964458,1721.6074569225311,361.5195834636688,1393.6071968078613,18886,4737,14149,14149,0,22,4820000.0
4820,4820999,21.109602164845608,38.72625017789485,0.08737225535042659,1722.038789510727,361.5888569355011,1393.6832466125488,18888,4738,14150,14150,0,22,4821000.0
4821,4821999,21.111220430577905,38.728989954832,0.0873339513267628,1722.3703100681305,361.6556251049042,1394.006435394287,18896,4740,14156,14156,0,22,4822000.0
4822,4822999,21.11356951393189,38.732976568824895,0.08730083936573829,1722.6621129512787,361.72418236732483,1394.4836463928223,18898,4741,14157,14157,0,22,4823000.0
4823,4823999,21.115517700686453,38.73585260532069,0.08728751008419355,1723.0201485157013,361.7899971008301,1394.5175132751465,18900,4742,14158,14158,0,22,4824000.0
4824,4824999,21.117654004635146,38.738694744581835,0.08729530611051439,1723.4748797416687,361.85816860198975,1394.342685699463,18907,4743,14164,14164,0,22,4825000.0
4825,4825999,21.11954171791387,38.740521547994796,0.08730035255497515,1723.790828704834,361.92504024505615,1394.6831016540527,18909,4744,14165,14165,0,22,4826000.0
4826,4826999,21.121559751231516,38.74265906582153,0.08731488699785395,1724.2461981773376,361.9974060058594,1394.620937347412,18913,4746,14167,14167,0,22,4827000.0
4827,4827999,21.12318840077185,38.74530885415146,0.08730802936814186,1724.6362044811249,362.0632770061493,1394.734172821045,18915,4747,14168,14168,0,22,4828000.0
4828,4828999,21.1243299419954,38.74543230793141,0.087323737608898,1725.0804295539856,362.13052582740784,1394.7085075378418,18919,4749,14170,14170,0,22,4829000.0
4829,4829999,21.123536928359183,38.74384574322581,0.08733424544650104,1725.5065624713898,362.19836950302124,1395.3113594055176,18941,4751,14190,14190,0,22,4830000.0
4830,4830999,21.12168541859775,38.741033860060014,0.08734459655947646,1725.7996644973755,362.2670683860779,1396.2073249816895,18949,4751,14198,14198,0,22,4831000.0
4831,4831999,21.119954337912123,38.73845017396088,0.08735105734296766,1726.1003658771515,362.3362259864807,1396.8808937072754,18954,4751,14203,14203,0,22,4832000.0
4832,4832999,21.118550769481374,38.73619056284337,0.0873527917249668,1726.3489151000977,362.40036129951477,1397.5938453674316,18955,4751,14204,14204,0,22,4833000.0
4833,4833999,21.117385113237184,38.73483345683397,0.08734890418262309,1726.6772940158844,362.4664800167084,1398.1289405822754,18974,4753,14221,14221,0,22,4834000.0
4834,4834999,21.11588431130989,38.732510023295234,0.08735232848969987,1726.9661417007446,362.53348422050476,1399.1036567687988,18976,4754,14222,14222,0,22,4835000.0
4835,4835999,21.114557366956163,38.73009319174523,0.08735576566562475,1727.2348446846008,362.60020327568054,1399.8178520202637,18978,4755,14223,14223,0,22,4836000.0
4836,4836999,21.11321169768024,38.72791168019957,0.08735641741471967,1727.6048924922943,362.6662051677704,1400.039852142334,18988,4757,14231,14231,0,22,4837000.0
4837,4837999,21.11199666690772,38.725685862151224,0.08736376690913494,1727.9221153259277,362.7336513996124,1400.3700675964355,18988,4757,14231,14231,0,22,4838000.0
4838,4838999,21.110729377565793,38.723045488690815,0.0873655483915764,1728.2281041145325,362.7995150089264,1400.7809410095215,18995,4758,14237,14237,0,22,4839000.0
4839,4839999,21.109699726012355,38.721343682585875,0.08737712694403155,1728.811274766922,362.86771512031555,1400.4111366271973,19059,4763,14296,14296,0,22,4840000.0
4840,4840999,21.10874705981013,38.7193470842043,0.08737664230838837,1729.2818377017975,362.93803572654724,1400.336727142334,19061,4764,14297,14297,0,22,4841000.0
4841,4841999,21.10876925652291,38.720873991449956,0.08736342555864596,1729.6571033000946,363.00470900535583,1400.3891410827637,19061,4764,14297,14297,0,22,4842000.0
4842,4842999,21.10968595310672,38.72324827679957,0.08735150216788379,1729.8523375988007,363.070410490036,1401.2196159362793,19061,4764,14297,14297,0,22,4843000.0
4843,4843999,21.111344619547797,38.72588105308283,0.08733436547534723,1730.2250363826752,363.1388487815857,1401.2872123718262,19061,4764,14297,14297,0,22,4844000.0
4844,4844999,21.11338778631047,38.729321779302715,0.08731882956770842,1730.6529903411865,363.207731962204,1401.1297340393066,19065,4766,14299,14299,0,22,4845000.0
4845,4845999,21.11656826432573,38.73891183975108,0.087316223631701,1731.1356375217438,363.2751030921936,1400.906192779541,19065,4766,14299,14299,0,22,4846000.0
4846,4846999,21.118987710398578,38.74230634102626,0.08732613458326399,1731.4941477775574,363.34186005592346,1401.2116737365723,19067,4767,14300,14300,0,22,4847000.0
4847,4847999,21.1209970856207,38.744771992404075,0.08733670051889086,1731.915694475174,363.4087059497833,1401.1488914489746,19071,4769,14302,14302,0,22,4848000.0
4848,4848999,21.123468969642968,38.747511329486606,0.08735651003698452,1732.2836937904358,363.48307037353516,1401.529010772705,19073,4770,14303,14303,0,22,4849000.0
4849,4849999,21.124800689569614,38.749488224256474,0.08737894508772304,1732.6997122764587,363.5501651763916,1401.4775352478027,19073,4770,14303,14303,0,22,4850000.0
4850,4850999,21.124787100147838,38.74940897483619,0.08737806246191682,1733.1475167274475,363.61507654190063,1401.8303337097168,19091,4771,14320,14320,0,22,4851000.0
4851,4851999,21.12310398408815,38.74712802623495,0.08738570440293925,1733.3742189407349,363.677677154541,1402.9855918884277,19106,4771,14335,14335,0,22,4852000.0
4852,4852999,21.12145343632763,38.74499194730419,0.08739466386528527,1733.6050870418549,363.73931217193604,1403.9565467834473,19112,4771,14341,14341,0,22,4853000.0
4853,4853999,21.120108277935202,38.7438466103598,0.08739435734501022,1733.824161529541,363.80114674568176,1404.9372215270996,19115,4771,14344,14344,0,22,4854000.0
4854,4854999,21.11861817624176,38.74187408535467,0.08739746909157153,1734.1408805847168,363.86487460136414,1405.4853630065918,19123,4772,14351,14351,0,22,4855000.0
4855,4855999,21.11725249705093,38.73988115601458,0.08739800995647962,1734.5646634101868,363.9295048713684,1405.816104888916,19137,4775,14362,14362,0,22,4856000.0
4856,4856999,21.115767784582864,38.737470675441884,0.08740287127413149,1734.9993360042572,363.9924809932709,1405.9957389831543,19143,4778,14365,14365,0,22,4857000.0
4857,4857999,21.114509967865946,38.736047418056366,0.08740215521460581,1735.303361415863,364.05692315101624,1406.6992454528809,19147,4779,14368,14368,0,22,4858000.0
4858,4858999,21.113198132476352,38.73431299140131,0.08740002322820051,1735.595377445221,364.1215023994446,1407.3325691223145,19151,4781,14370,14370,0,22,4859000.0
4859,4859999,21.11185817028534,38.7318108420407,0.08740290651736815,1735.8110110759735,364.185213804245,1408.2245826721191,19153,4782,14371,14371,0,22,4860000.0
4860,4860999,21.111134000175092,38.73064783698415,0.0874025953872195,1736.262955904007,364.2522325515747,1408.2319068908691,19157,4784,14373,14373,0,22,4861000.0
4861,4861999,21.110311883166226,38.72930811334221,0.087396983331818,1736.520591020584,364.3163437843323,1408.9012870788574,19159,4785,14374,14374,0,22,4862000.0
4862,4862999,21.11027694964759,38.72915424363915,0.08738779215083092,1737.0210783481598,364.3802409172058,1408.6067161560059,19163,4787,14376,14376,0,22,4863000.0
4863,4863999,21.11017337004236,38.7286551623742,0.08737869539896825,1737.4850690364838,364.44694924354553,1408.507266998291,19168,4789,14379,14379,0,22,4864000.0
4864,4864999,21.11046890071409,38.728251683306866,0.08737949933399669,1737.685557603836,371.47329449653625,1409.500202178955,19168,4789,14379,14379,0,22,4865000.0
4865,4865999,21.11142770780545,38.72931586727948,0.08738598898124905,1737.8901801109314,371.53689312934875,1410.3009300231934,19168,4789,14379,14379,0,22,4866000.0
4866,4866999,21.112653187436624,38.73032812900505,0.0873823876887968,1738.3311159610748,371.60090470314026,1410.169864654541,19189,4791,14398,14398,0,22,4867000.0
4867,4867999,21.114135147241367,38.73178905339191,0.08738084703165983,1738.7116124629974,371.6662540435791,1410.2912483215332,19191,4792,14399,14399,0,22,4868000.0
4868,4868999,21.115508264925694,38.73296241499763,0.08738412856257793,1739.2435505390167,371.7330815792084,1409.860538482666,19197,4795,14402,14402,0,22,4869000.0
4869,4869999,21.11667104779561,38.733666732414505,0.08739124615413918,1739.5743310451508,371.79714274406433,1410.3150215148926,19201,4797,14404,14404,0,22,4870000.0
4870,4870999,21.11762024642563,38.73364563303789,0.08740684244579433,1739.8975348472595,371.8646731376648,1410.7251243591309,19201,4797,14404,14404,0,22,4871000.0
4871,4871999,21.117631524696897,38.732645986650546,0.08741536557711738,1740.2347211837769,371.93264508247375,1411.544521331787,19215,4797,14418,14418,0,22,4872000.0
4872,4872999,21.116183106538145,38.73072901928638,0.08742224217072392,1740.539978981018,371.9990577697754,1412.4951286315918,19230,4798,14432,14432,0,22,4873000.0
4873,4873999,21.1148804464556,38.7315671595204,0.08742147115096666,1740.7971556186676,372.0635323524475,1413.3920249938965,19237,4798,14439,14439,0,22,4874000.0
4874,4874999,21.113923443380955,38.73225657138934,0.08741451358544505,1741.16917014122,372.1281027793884,1413.8830680847168,19269,4800,14469,14469,0,22,4875000.0
4875,4875999,21.11276155131134,38.73724312398981,0.08739137188893009,1741.4122636318207,372.19339323043823,1415.1363410949707,19286,4801,14485,14485,0,22,4876000.0
4876,4876999,21.111908202784274,38.7371760453893,0.08738508693673774,1741.6028492450714,372.25829434394836,1416.2586784362793,19288,4801,14487,14487,0,22,4877000.0
4877,4877999,21.11038377026439,38.73416961603625,0.08739292293801049,1742.005863904953,372.3236782550812,1416.4594917297363,19296,4803,14493,14493,0,22,4878000.0
4878,4878999,21.10895014790864,38.73178252526526,0.08738924770392331,1742.2503399848938,372.389860868454,1417.2144355773926,19298,4803,14495,14495,0,22,4879000.0
4879,4879999,21.107509521928563,38.72929317312707,0.08738481175460922,1742.8211178779602,372.456458568573,1416.5029411315918,19302,4805,14497,14497,0,22,4880000.0
4880,4880999,21.10619447512837,38.726974704385775,0.08738108056179994,1743.1612606048584,372.525758266449,1416.9484367370605,19303,4805,14498,14498,0,22,4881000.0
4881,4881999,21.10508211934653,38.727032404512734,0.08737630795314655,1743.5413472652435,372.5928041934967,1417.1859245300293,19307,4807,14500,14500,0,22,4882000.0
4882,4882999,21.104121794494677,38.72489200988329,0.08737364897402056,1743.9179413318634,372.6580626964569,1417.2290229797363,19307,4807,14500,14500,0,22,4883000.0
4883,4883999,21.103253169040155,38.723412114103795,0.08737337561720815,1744.1614582538605,372.7249803543091,1417.9880638122559,19308,4807,14501,14501,0,22,4884000.0
4884,4884999,21.102320243400214,38.72158064233076,0.08738055292604185,1744.5753650665283,372.794228553772,1417.8861274719238,19310,4808,14502,14502,0,22,4885000.0
4885,4885999,21.10154014704496,38.7195229479515,0.0873872553557139,1744.9884140491486,372.86057782173157,1417.845790863037,19310,4808,14502,14502,0,22,4886000.0
4886,4886999,21.100747174483164,38.717383447172466,0.08739989375091806,1745.2620022296906,372.9255301952362,1418.4694938659668,19311,4808,14503,14503,0,22,4887000.0
4887,4887999,21.099699869737343,38.7148037080378,0.08742088941577553,1745.5883331298828,372.9929735660553,1418.796215057373,19312,4808,14504,14504,0,22,4888000.0
4888,4888999,21.098811517049505,38.713579565247166,0.08742285574024111,1746.1095604896545,373.0647141933441,1418.8224449157715,19326,4808,14518,14518,0,22,4889000.0
4889,4889999,21.09758225453869,38.71410622620501,0.08742843318354454,1746.3823456764221,373.1309337615967,1419.918285369873,19333,4810,14523,14523,0,22,4890000.0
4890,4890999,21.09597831168197,38.71229146020574,0.08745916044804614,1746.6539828777313,373.19329285621643,1420.6880073547363,19334,4810,14524,14524,0,22,4891000.0
4891,4891999,21.094281550140675,38.71063446277822,0.08748454902322644,1746.889419078827,373.2571177482605,1421.3865547180176,19336,4810,14526,14526,0,22,4892000.0
4892,4892999,21.0923726715744,38.70764116316106,0.0875179266042021,1747.200133562088,373.3207905292511,1421.743709564209,19340,4810,14530,14530,0,22,4893000.0
4893,4893999,21.090211476108376,38.70433487579951,0.08755278421520318,1747.426931142807,373.38387966156006,1422.4029121398926,19341,4810,14531,14531,0,22,4894000.0
4894,4894999,21.08837832301229,38.70175703622383,0.0875761360057723,1747.8894593715668,373.4475688934326,1422.1636848449707,19347,4813,14534,14534,0,22,4895000.0
4895,4895999,21.086436430354038,38.699241464783384,0.08760227121818454,1748.234223127365,373.5116391181946,1422.4924125671387,19349,4814,14535,14535,0,22,4896000.0
4896,4896999,21.08467273363459,38.69676707066562,0.08762436055056932,1748.6526494026184,373.57764530181885,1422.4704399108887,19351,4815,14536,14536,0,22,4897000.0
4897,4897999,21.083004061978688,38.69458454454195,0.0876450606154573,1749.041268825531,373.6411099433899,1422.5356254577637,19353,4816,14537,14537,0,22,4898000.0
4898,4898999,21.08145329163466,38.69208179963667,0.0876649957879354,1749.4713451862335,373.7049036026001,1422.6832847595215,19368,4817,14551,14551,0,22,4899000.0
4899,4899999,21.079966213129396,38.68938997707109,0.087688240044828,1749.8507318496704,373.77241349220276,1423.0465812683105,19384,4818,14566,14566,0,22,4900000.0
4900,4900999,21.078573635197245,38.686935548899015,0.08771002019560525,1750.0018997192383,373.83556604385376,1424.4931144714355,19384,4818,14566,14566,0,22,4901000.0
4901,4901999,21.077348392301722,38.684628091404974,0.08774368976211044,1750.3535747528076,373.9006464481354,1424.903751373291,19386,4819,14567,14567,0,22,4902000.0
4902,4902999,21.076031661149656,38.68205094800277,0.08777035986473436,1750.5160458087921,373.96477913856506,1425.9424476623535,19386,4819,14567,14567,0,22,4903000.0
4903,4903999,21.07440118812081,38.679155519576426,0.08780153447013961,1750.9493947029114,374.03155851364136,1425.7796516418457,19386,4819,14567,14567,0,22,4904000.0
4904,4904999,21.073172748249654,38.67701714015914,0.08783019222893718,1751.4338982105255,374.0969114303589,1425.6645622253418,19390,4821,14569,14569,0,22,4905000.0
4905,4905999,21.07145658353956,38.67494513675131,0.08785254185042135,1751.6293895244598,374.16662335395813,1427.2068977355957,19403,4821,14582,14582,0,22,4906000.0
4906,4906999,21.069299797119026,38.672272579089984,0.0878803484158267,1751.9200236797333,374.2295775413513,1427.9205513000488,19406,4821,14585,14585,0,22,4907000.0
4907,4907999,21.067646792781225,38.67266145484127,0.08789314560641626,1752.1804320812225,374.29242968559265,1428.6471061706543,19409,4822,14587,14587,0,22,4908000.0
4908,4908999,21.066054882872194,38.670769645607336,0.08791458734725721,1752.546719789505,374.3585650920868,1428.8335914611816,19412,4822,14590,14590,0,22,4909000.0
4909,4909999,21.064078622560764,38.66783403125808,0.08794641780559376,1752.9819581508636,374.42300844192505,1428.8045234680176,19418,4824,14594,14594,0,22,4910000.0
4910,4910999,21.062143229136325,38.66517194579327,0.08797263136434164,1753.4068083763123,374.48674297332764,1428.758014678955,19422,4826,14596,14596,0,22,4911000.0
4911,4911999,21.06037889577753,38.66287731142148,0.08798923292273186,1753.8084645271301,374.55706214904785,1428.9922218322754,19426,4828,14598,14598,0,22,4912000.0
4912,4912999,21.058768656845928,38.661116612693384,0.08799670058807985,1754.184443950653,374.62176060676575,1429.1075172424316,19429,4830,14599,14599,0,22,4913000.0
4913,4913999,21.057268767341014,38.659806228491675,0.08800262476357101,1754.6491475105286,374.68744373321533,1428.9717597961426,19439,4832,14607,14607,0,22,4914000.0
4914,4914999,21.056386222106795,38.65902164399672,0.08799425809569095,1755.0471346378326,374.7524893283844,1428.9905815124512,19440,4833,14607,14607,0,22,4915000.0
4915,4915999,21.05544682221289,38.657662829964536,0.08799175901484824,1755.476561307907,374.819504737854,1428.8603858947754,19440,4833,14607,14607,0,22,4916000.0
4916,4916999,21.054963634446022,38.65696485836812,0.08798047523644592,1755.7263858318329,374.8847017288208,1429.5567665100098,19440,4833,14607,14607,0,22,4917000.0
4917,4917999,21.05440742841883,38.65614368603748,0.0879664125057017,1756.0689852237701,374.94927859306335,1429.7796058654785,19440,4833,14607,14607,0,22,4918000.0
4918,4918999,21.054410161950546,38.65612305501074,0.08795163968871889,1756.551440000534,375.0155830383301,1429.4000358581543,19443,4835,14608,14608,0,22,4919000.0
4919,4919999,21.054142223871455,38.654842233038124,0.08794361757933733,1756.9189291000366,375.0839695930481,1429.6895561218262,19445,4836,14609,14609,0,22,4920000.0
4920,4920999,21.054324443189344,38.65591207372535,0.08793110045070629,1757.2811868190765,375.1510772705078,1429.897388458252,19446,4837,14609,14609,0,22,4921000.0
4921,4921999,21.05427593140466,38.65522801756136,0.08792039778306604,1757.7236061096191,375.2200291156769,1429.72310256958,19446,4837,14609,14609,0,22,4922000.0
4922,4922999,21.05419988991793,38.65425771706695,0.08791106271110782,1758.087012052536,375.2899556159973,1429.9526557922363,19446,4837,14609,14609,0,22,4923000.0
4923,4923999,21.053783891514986,38.65260498483102,0.08790983385245155,1758.6173374652863,375.35724115371704,1429.3332786560059,19448,4838,14610,14610,0,22,4924000.0
4924,4924999,21.053753904006513,38.651732232362235,0.08790001962618965,1758.9942688941956,375.42371821403503,1429.390552520752,19449,4839,14610,14610,0,22,4925000.0
4925,4925999,21.052623328220253,38.6492923341912,0.08790308708461114,1759.2745711803436,375.49295115470886,1430.5521430969238,19476,4839,14637,14637,0,22,4926000.0
4926,4926999,21.05079230621571,38.647460899045655,0.08791183893795729,1759.4113080501556,375.55486130714417,1432.4497032165527,19488,4839,14649,14649,0,22,4927000.0
4927,4927999,21.048558210129123,38.64427210479785,0.08793108424322316,1759.5559844970703,375.61721205711365,1433.7608680725098,19491,4839,14652,14652,0,22,4928000.0
4928,4928999,21.046603918258047,38.64181323262975,0.08794317458297929,1759.9445631504059,375.67877292633057,1434.218822479248,19498,4842,14656,14656,0,22,4929000.0
4929,4929999,21.044838874453003,38.639004422649485,0.08795899755095282,1760.1524288654327,375.7421290874481,1435.0759925842285,19502,4843,14659,14659,0,22,4930000.0
4930,4930999,21.042943369241872,38.636005863217115,0.08797357578414444,1760.6556148529053,375.80623483657837,1434.8205833435059,19511,4847,14664,14664,0,22,4931000.0
4931,4931999,21.04139755005095,38.63367691236917,0.0879858086023868,1760.9845533370972,375.87209725379944,1435.3861503601074,19513,4848,14665,14665,0,22,4932000.0
4932,4932999,21.039853919389888,38.631042342612076,0.08799819403459741,1761.2608079910278,375.9350824356079,1435.9850578308105,19516,4849,14667,14667,0,22,4933000.0
4933,4933999,21.03819842282408,38.62866384821196,0.08800791712513667,1761.6796967983246,375.9996705055237,1435.8796577453613,19518,4850,14668,14668,0,22,4934000.0
4934,4934999,21.03679998963174,38.62648211447541,0.08801457839695048,1761.8924424648285,376.0625584125519,1436.6661109924316,19520,4851,14669,14669,0,22,4935000.0
4935,4935999,21.035503013924764,38.62425597352684,0.08802070423366448,1762.4568073749542,376.1273727416992,1435.901424407959,19532,4854,14678,14678,0,22,4936000.0
4936,4936999,21.034298942688626,38.62213674568646,0.08802230268932798,1762.8499743938446,376.1920680999756,1436.1524696350098,19534,4855,14679,14679,0,22,4937000.0
4937,4937999,21.033144450025013,38.61980925494593,0.0880330568737181,1763.1133375167847,376.2559154033661,1436.7450675964355,19536,4856,14680,14680,0,22,4938000.0
4938,4938999,21.032096846811793,38.61812299170218,0.08803099785688906,1763.4448029994965,376.31948137283325,1437.0256614685059,19538,4857,14681,14681,0,22,4939000.0
4939,4939999,21.031263274572485,38.61619647175293,0.08803769300075182,1763.8484826087952,376.3833122253418,1437.300220489502,19544,4860,14684,14684,0,22,4940000.0
4940,4940999,21.03036812949774,38.61438573593652,0.08803748963715519,1764.2526907920837,376.4462938308716,1437.2462196350098,19546,4861,14685,14685,0,22,4941000.0
4941,4941999,21.029574617582476,38.61252251708814,0.08804263200537699,1764.609650850296,376.51115918159485,1437.5463218688965,19548,4862,14686,14686,0,22,4942000.0
4942,4942999,21.028951264388713,38.61052609424669,0.08804313728762758,1764.9504928588867,376.57429695129395,1438.1131553649902,19552,4864,14688,14688,0,22,4943000.0
4943,4943999,21.028668875847675,38.609296047914505,0.0880402073390516,1765.2710189819336,376.6397490501404,1438.353214263916,19552,4864,14688,14688,0,22,4944000.0
4944,4944999,21.028150451274588,38.608180507528225,0.08803401881181006,1765.7672698497772,376.70368695259094,1437.906894683838,19552,4864,14688,14688,0,22,4945000.0
4945,4945999,21.02751143429706,38.60632846397234,0.08803058065139147,1766.0313732624054,376.7700080871582,1438.5262489318848,19552,4864,14688,14688,0,22,4946000.0
4946,4946999,21.02631167190695,38.60484172652248,0.08803178963430103,1766.4318101406097,376.8358464241028,1439.1191291809082,19571,4865,14706,14706,0,22,4947000.0
4947,4947999,21.025225440777774,38.60339326216883,0.08803236507161649,1766.7180542945862,376.8988356590271,1439.8699684143066,19578,4866,14712,14712,0,22,4948000.0
4948,4948999,21.023696005655378,38.60100303659609,0.08803855359747226,1766.9735186100006,376.9618818759918,1440.6000785827637,19580,4867,14713,14713,0,22,4949000.0
4949,4949999,21.02242374747414,38.59873985045152,0.08804429081681409,1767.3074219226837,377.02565813064575,1441.0266151428223,19583,4868,14715,14715,0,22,4950000.0
4950,4950999,21.021333847546856,38.59688293073479,0.08804200967528297,1767.6107213497162,377.08941555023193,1441.4273872375488,19587,4869,14718,14718,0,22,4951000.0
4951,4951999,21.020031578583225,38.59433424006821,0.0880449543714047,1768.072060585022,377.15384912490845,1441.3728370666504,19591,4871,14720,14720,0,22,4952000.0
4952,4952999,21.018948115340077,38.59231443552672,0.08804835691358393,1768.3477766513824,377.21701216697693,1441.923168182373,19591,4871,14720,14720,0,22,4953000.0
4953,4953999,21.017777598638233,38.59003441911053,0.08805050926158631,1768.7286040782928,377.28071331977844,1442.0872535705566,19593,4872,14721,14721,0,22,4954000.0
4954,4954999,21.0170611703601,38.5945417205897,0.0880179543200379,1769.125569820404,377.34395384788513,1442.0857048034668,19595,4873,14722,14722,0,22,4955000.0
4955,4955999,21.015819920011914,38.592237641316146,0.088020476517225,1769.5175988674164,377.4062240123749,1442.1331672668457,19603,4875,14728,14728,0,22,4956000.0
4956,4956999,21.01476290623325,38.59047864881363,0.0880214687239892,1770.0066003799438,377.4716866016388,1441.8026008605957,19615,4878,14737,14737,0,22,4957000.0
4957,4957999,21.01360692932438,38.588263454878486,0.08802193946615877,1770.4452424049377,377.5382091999054,1441.6667213439941,19616,4879,14737,14737,0,22,4958000.0
4958,4958999,21.01245094427199,38.585936415196095,0.0880230533896379,1770.7618496418,377.604373216629,1442.074550628662,19616,4879,14737,14737,0,22,4959000.0
4959,4959999,21.011431292789034,38.58393800659881,0.08802058109530364,1771.0139071941376,377.671471118927,1442.6678352355957,19616,4879,14737,14737,0,22,4960000.0
4960,4960999,21.010543356263334,38.58167445569303,0.08801805203711732,1771.4208238124847,377.737530708313,1442.5743675231934,19616,4879,14737,14737,0,22,4961000.0
4961,4961999,21.009882748155054,38.57958982118428,0.0880147432266799,1771.8098108768463,377.80698823928833,1442.6600303649902,19616,4879,14737,14737,0,22,4962000.0
4962,4962999,21.00939942074999,38.57774254042558,0.0880084184214679,1772.1896550655365,377.8725564479828,1442.688632965088,19616,4879,14737,14737,0,22,4963000.0
4963,4963999,21.009254921920867,38.57651931074838,0.08799894035713085,1772.4856050014496,377.9375171661377,1443.0610466003418,19616,4879,14737,14737,0,22,4964000.0
4964,4964999,21.00867379160689,38.57467450498221,0.08799488318070758,1772.8935825824738,378.0028245449066,1442.9922370910645,19618,4880,14738,14738,0,22,4965000.0
4965,4965999,21.00769274178303,38.572238396452256,0.08799845722863509,1773.2257668972015,378.0690233707428,1443.7249031066895,19636,4882,14754,14754,0,22,4966000.0
4966,4966999,21.00644813610534,38.569738924328526,0.08800308944848434,1773.633544921875,378.13697576522827,1443.88618850708,19638,4883,14755,14755,0,22,4967000.0
4967,4967999,21.004697446551493,38.56865639916234,0.08801419581644376,1773.8922548294067,378.207777261734,1445.2959938049316,19661,4884,14777,14777,0,22,4968000.0
4968,4968999,21.00284712034357,38.56696699457146,0.08802383272134784,1774.1634695529938,378.27338314056396,1446.7182273864746,19686,4886,14800,14800,0,22,4969000.0
4969,4969999,21.000858025382183,38.56398056554807,0.0880421979901036,1774.3088190555573,378.338828086853,1448.0702781677246,19687,4886,14801,14801,0,22,4970000.0
4970,4970999,20.998783690672923,38.56070506226231,0.08806981045873186,1774.5403180122375,378.40460109710693,1448.8282508850098,19689,4886,14803,14803,0,22,4971000.0
4971,4971999,20.996892310056495,38.55794405842854,0.08808684016042345,1774.8382987976074,378.4727523326874,1449.3455924987793,19692,4887,14805,14805,0,22,4972000.0
4972,4972999,20.995260196413106,38.55520288475126,0.0881028630111429,1775.2069437503815,378.53929233551025,1449.6742973327637,19695,4888,14807,14807,0,22,4973000.0
4973,4973999,20.993500982455295,38.55258786261854,0.08811625875693829,1775.4433648586273,378.60607051849365,1450.3041877746582,19695,4888,14807,14807,0,22,4974000.0
4974,4974999,20.991726286790893,38.54957954271817,0.08812851996549076,1775.8464789390564,378.6725609302521,1450.254970550537,19695,4888,14807,14807,0,22,4975000.0
4975,4975999,20.989985987422347,38.54684736140728,0.08814091996535889,1776.242957353592,378.73938822746277,1450.2973442077637,19701,4891,14810,14810,0,22,4976000.0
4976,4976999,20.988296585853185,38.54457517664597,0.08814959047095672,1776.596637248993,378.805171251297,1450.7089805603027,19705,4893,14812,14812,0,22,4977000.0
4977,4977999,20.986886002284503,38.54227991429745,0.08815234375423064,1777.1357200145721,378.87158274650574,1450.2546730041504,19719,4897,14822,14822,0,22,4978000.0
4978,4978999,20.98530435658057,38.53947332864504,0.08816225165225033,1777.4197027683258,378.93970108032227,1450.771068572998,19719,4897,14822,14822,0,22,4979000.0
4979,4979999,20.984023064696604,38.53727629230383,0.08816169254474437,1777.86794424057,379.0073847770691,1450.6320304870605,19723,4899,14824,14824,0,22,4980000.0
4980,4980999,20.982957165587116,38.53565561739994,0.0881586720409463,1778.3547179698944,379.0745725631714,1450.3017082214355,19731,4900,14831,14831,0,22,4981000.0
4981,4981999,20.98248336536138,38.5354389475141,0.08814529349343814,1778.7155039310455,379.142208814621,1450.5606956481934,19733,4901,14832,14832,0,22,4982000.0
4982,4982999,20.982146635869565,38.53469989469913,0.08813474065739746,1778.9166514873505,379.2097294330597,1451.3395347595215,19733,4901,14832,14832,0,22,4983000.0
4983,4983999,20.98255348221397,38.53518695904505,0.088115673622021,1779.3346524238586,379.281197309494,1451.3440132141113,19733,4901,14832,14832,0,22,4984000.0
4984,4984999,20.982916770688824,38.5354162663896,0.08810499357615575,1779.6419596672058,379.3472275733948,1451.7085990905762,19735,4902,14833,14833,0,22,4985000.0
4985,4985999,20.983007319159995,38.534840182858986,0.0881009635943314,1780.0490674972534,379.41643238067627,1451.657299041748,19735,4902,14833,14833,0,22,4986000.0
4986,4986999,20.983231927133847,38.534366935759955,0.08809405909039258,1780.4709067344666,379.4829890727997,1451.6120796203613,19735,4902,14833,14833,0,22,4987000.0
4987,4987999,20.98290975699178,38.534039160455386,0.08808440905097714,1780.745937347412,379.54922795295715,1452.2931938171387,19737,4903,14834,14834,0,22,4988000.0
4988,4988999,20.981473219546466,38.532109850917436,0.08808842521322957,1780.9927270412445,379.61362314224243,1453.7872581481934,19768,4904,14864,14864,0,22,4989000.0
4989,4989999,20.979438062440465,38.528885604360376,0.08810791324795642,1781.2213671207428,379.6766290664673,1454.8451881408691,19777,4904,14873,14873,0,22,4990000.0
4990,4990999,20.97782578047207,38.52718123188112,0.08811541327172012,1781.4801120758057,379.73953557014465,1455.7653846740723,19783,4904,14879,14879,0,22,4991000.0
4991,4991999,20.976453110495527,38.52454688007794,0.0881263190267757,1781.665159702301,379.8017144203186,1456.917194366455,19790,4904,14886,14886,0,22,4992000.0
4992,4992999,20.97517532510074,38.522440353353346,0.088130103427142,1781.9507567882538,379.86522102355957,1457.6575355529785,19796,4906,14890,14890,0,22,4993000.0
4993,4993999,20.974503238036014,38.52083224070023,0.0881295016760073,1782.4313580989838,379.92842531204224,1457.80668258667,19807,4911,14896,14896,0,22,4994000.0
4994,4994999,20.973838417146332,38.51914738050797,0.08813013744101095,1782.6822445392609,379.993230342865,1458.733959197998,19809,4912,14897,14897,0,22,4995000.0
4995,4995999,20.973063463189607,38.51755184973117,0.08813622234965346,1783.0037639141083,380.05712032318115,1459.2466850280762,19813,4914,14899,14899,0,22,4996000.0
4996,4996999,20.97258827380622,38.51616906439114,0.08814046251737917,1783.322342634201,380.1201505661011,1459.7162971496582,19818,4916,14902,14902,0,22,4997000.0
4997,4997999,20.97230862554894,38.5150807413872,0.08814530647282148,1783.7936482429504,380.1839325428009,1459.6367683410645,19824,4919,14905,14905,0,22,4998000.0
4998,4998999,20.972013035457504,38.514077743859964,0.08817355837744667,1784.131683588028,380.2471573352814,1460.0839653015137,19826,4920,14906,14906,0,22,4999000.0
4999,4999999,20.971767843618153,38.51330016570176,0.08819627355138815,1784.3573968410492,380.30995512008667,1460.8270072937012,19826,4920,14906,14906,0,22,5000000.0
5000,5000999,20.971459434712795,38.51218815282223,0.08822688650369814,1784.9281840324402,380.37500524520874,1460.2456550598145,19833,4923,14910,14910,0,22,5001000.0
5001,5001999,20.97138147269797,38.51148679644784,0.08826355196171365,1785.1274032592773,380.4392192363739,1461.2540168762207,19834,4923,14911,14911,0,22,5002000.0
5002,5002999,20.97168728049308,38.51162225880577,0.08827841614058973,1785.3592150211334,380.504022359848,1461.9307670593262,19834,4923,14911,14911,0,22,5003000.0
5003,5003999,20.971914114553183,38.51268033652552,0.08829160764867983,1785.6612749099731,380.5676336288452,1462.319149017334,19836,4924,14912,14912,0,22,5004000.0
5004,5004999,20.972071241427432,38.512396129178306,0.08831793879088634,1786.1300625801086,380.6329081058502,1462.0267601013184,19838,4925,14913,14913,0,22,5005000.0
5005,5005999,20.97228285341488,38.51156650369014,0.08833416774174241,1786.5515098571777,380.69696497917175,1461.9503746032715,19840,4926,14914,14914,0,22,5006000.0
5006,5006999,20.972260612367158,38.51058338896482,0.08834616169686416,1786.923657655716,380.762659072876,1462.3688011169434,19868,4928,14940,14940,0,22,5007000.0
5007,5007999,20.972099733557233,38.50915668718135,0.08835936861290294,1787.4519152641296,380.8277564048767,1461.9612159729004,19875,4931,14944,14944,0,22,5008000.0
5008,5008999,20.97148563071466,38.50745912687428,0.08836690571082029,1787.613421678543,380.8942539691925,1463.2514457702637,19883,4931,14952,14952,0,22,5009000.0
5009,5009999,20.96963509605756,38.504757020931756,0.0883886814821665,1787.8596527576447,380.96004343032837,1464.465488433838,19898,4932,14966,14966,0,22,5010000.0
5010,5010999,20.968020610560117,38.50305043255597,0.08840397284989154,1788.0908002853394,381.0242486000061,1465.355411529541,19902,4932,14970,14970,0,22,5011000.0
5011,5011999,20.966134971675878,38.5000166224162,0.08843126381110611,1788.3762707710266,381.08872961997986,1465.903522491455,19905,4932,14973,14973,0,22,5012000.0
5012,5012999,20.964819694081477,38.498936431880324,0.08843459463081305,1788.7268776893616,381.1526062488556,1466.146900177002,19907,4933,14974,14974,0,22,5013000.0
5013,5013999,20.96318681759254,38.49674546835645,0.08845125108135121,1789.1490156650543,381.2171950340271,1466.1443519592285,19911,4935,14976,14976,0,22,5014000.0
5014,5014999,20.96182571025813,38.49469616913753,0.08845883525241882,1789.525176525116,381.2806363105774,1466.3799018859863,19915,4937,14978,14978,0,22,5015000.0
5015,5015999,20.9604992101825,38.49243797152847,0.08846975102419752,1789.9966266155243,381.3448762893677,1466.057903289795,19915,4937,14978,14978,0,22,5016000.0
5016,5016999,20.95893871294665,38.48983575326272,0.08848382099623597,1790.4021463394165,381.4110403060913,1466.3259620666504,19919,4940,14979,14979,0,22,5017000.0
5017,5017999,20.957986831444536,38.49547439789287,0.08845524119465842,1790.6435496807098,381.47606134414673,1467.0158805847168,19919,4940,14979,14979,0,22,5018000.0
5018,5018999,20.95674298992053,38.49318792548755,0.08846178813649375,1791.0847902297974,381.54204392433167,1466.9650611877441,19923,4942,14981,14981,0,22,5019000.0
5019,5019999,20.955479082612857,38.49054362603926,0.08847463814771883,1791.514225244522,381.608359336853,1466.851161956787,19923,4942,14981,14981,0,22,5020000.0
5020,5020999,20.954518707123015,38.49112582860072,0.08846936531076621,1791.8997731208801,381.67570090293884,1466.986629486084,19923,4942,14981,14981,0,22,5021000.0
5021,5021999,20.95356509139377,38.48911067113601,0.08847629734800855,1792.3000602722168,381.74407410621643,1467.0823860168457,19923,4942,14981,14981,0,22,5022000.0
5022,5022999,20.952680869237817,38.48709812799895,0.08848412202625089,1792.6680064201355,381.81054878234863,1467.271541595459,19925,4943,14982,14982,0,22,5023000.0
5023,5023999,20.951759761603267,38.48497304978926,0.08849463511164568,1793.0458087921143,381.8769085407257,1467.377773284912,19926,4944,14982,14982,0,22,5024000.0
5024,5024999,20.950673303095016,38.48335500844651,0.08850627570408165,1793.460655450821,381.94447135925293,1467.5373344421387,19929,4946,14983,14983,0,22,5025000.0
5025,5025999,20.94944146676264,38.48094328218214,0.08852867859909608,1793.7777225971222,382.01340341567993,1468.1771659851074,19939,4947,14992,14992,0,22,5026000.0
5026,5026999,20.947844703902767,38.479112020992,0.08854347803181528,1794.0124940872192,382.0778000354767,1469.5499229431152,19954,4948,15006,15006,0,22,5027000.0
5027,5027999,20.946029896166213,38.47636424710403,0.08856366357338918,1794.2495622634888,382.1393618583679,1470.575252532959,19957,4948,15009,15009,0,22,5028000.0
5028,5028999,20.9443237851223,38.47407560215649,0.0885792781265925,1794.561199426651,382.2023482322693,1471.014102935791,19962,4950,15012,15012,0,22,5029000.0
5029,5029999,20.94294897709348,38.47270796762584,0.08858669369858585,1794.779202222824,382.2661120891571,1471.7778663635254,19963,4950,15013,15013,0,22,5030000.0
5030,5030999,20.94147854540617,38.470794849117894,0.08859447089550176,1795.219319820404,382.33062410354614,1471.682300567627,19970,4953,15017,15017,0,22,5031000.0
5031,5031999,20.940490720526768,38.469855770933805,0.08859046291102524,1795.5159125328064,382.3947927951813,1472.2440910339355,19982,4954,15028,15028,0,22,5032000.0
5032,5032999,20.93920487193132,38.46820280431883,0.08859446170762475,1795.882010936737,382.4596321582794,1472.4767723083496,19984,4954,15030,15030,0,22,5033000.0
5033,5033999,20.937984975790517,38.46626688172159,0.08859572209486588,1796.2568912506104,382.5225040912628,1472.701374053955,19990,4957,15033,15033,0,22,5034000.0
5034,5034999,20.937088842731814,38.46451989074129,0.08859123171101935,1796.5743420124054,382.5861430168152,1473.083179473877,19990,4957,15033,15033,0,22,5035000.0
5035,5035999,20.936711350192603,38.4643256047993,0.0885740891157446,1796.9019267559052,382.64954662323,1473.4692497253418,19992,4958,15034,15034,0,22,5036000.0
5036,5036999,20.93674709808265,38.4646354311582,0.08856613738758223,1797.3690927028656,382.7182834148407,1473.3351020812988,20002,4960,15042,15042,0,22,5037000.0
5037,5037999,20.936790384310267,38.46461010874402,0.0885551667733947,1797.7495222091675,382.7822985649109,1473.6464805603027,20004,4961,15043,15043,0,22,5038000.0
5038,5038999,20.937067099248083,38.46452590104055,0.08854880712212199,1798.0049908161163,382.84567880630493,1474.3773612976074,20006,4962,15044,15044,0,22,5039000.0
5039,5039999,20.937208045930955,38.46436082528435,0.08853897980102554,1798.3001260757446,382.9095618724823,1474.902904510498,20008,4963,15045,15045,0,22,5040000.0
5040,5040999,20.937568787656947,38.46577428598677,0.08852584134307295,1798.527967453003,382.9731295108795,1475.617115020752,20008,4963,15045,15045,0,22,5041000.0
5041,5041999,20.93761464512443,38.46523310464158,0.08852153513913996,1798.8680799007416,383.0417196750641,1475.8505210876465,20012,4965,15047,15047,0,22,5042000.0
5042,5042999,20.937898515706564,38.464833622751335,0.08851721942705482,1799.4188694953918,383.107430934906,1475.0251655578613,20014,4966,15048,15048,0,22,5043000.0
5043,5043999,20.937765838553737,38.46352145119347,0.08851016254270794,1799.7858352661133,383.17301869392395,1475.233341217041,20014,4966,15048,15048,0,22,5044000.0
5044,5044999,20.937603416978153,38.46209061089119,0.08850713997372339,1800.0967783927917,383.23823833465576,1475.6289710998535,20014,4966,15048,15048,0,22,5045000.0
5045,5045999,20.93702769921959,38.46076581822284,0.0885047102805192,1800.363543510437,383.30455470085144,1476.6551933288574,20028,4966,15062,15062,0,22,5046000.0
5046,5046999,20.93547344124947,38.45842451835766,0.08851578440420649,1800.701095342636,383.369188785553,1477.3149070739746,20035,4967,15068,15068,0,22,5047000.0
5047,5047999,20.93487321571811,38.45920512881641,0.08853960409204009,1800.9900152683258,383.4366521835327,1478.525234222412,20053,4969,15084,15084,0,22,5048000.0
5048,5048999,20.934434174347636,38.45848584315679,0.08858787542065705,1801.2032606601715,383.50089621543884,1479.736972808838,20056,4970,15086,15086,0,22,5049000.0
5049,5049999,20.9341997582854,38.45808374134543,0.0886175429045779,1801.4548399448395,383.56436133384705,1480.5306968688965,20061,4971,15090,15090,0,22,5050000.0
5050,5050999,20.934491075719055,38.465392968378126,0.0886685582026796,1802.0154175758362,383.6289236545563,1480.320156097412,20077,4976,15101,15101,0,22,5051000.0
5051,5051999,20.934195268430226,38.464985072573825,0.08872400478362741,1802.2076487541199,383.694452047348,1481.2857551574707,20078,4976,15102,15102,0,22,5052000.0
5052,5052999,20.93397007700843,38.465026630640324,0.08877501400376686,1802.6271641254425,383.7595715522766,1481.2809791564941,20082,4978,15104,15104,0,22,5053000.0
5053,5053999,20.934632335859444,38.46780661383054,0.08879715257359255,1802.8995316028595,383.8253564834595,1481.9296913146973,20082,4978,15104,15104,0,22,5054000.0
5054,5054999,20.93531963038527,38.474260218436314,0.08879002383338741,1803.168117761612,383.890909910202,1482.4771003723145,20084,4979,15105,15105,0,22,5055000.0
5055,5055999,20.93569390824664,38.474085072062714,0.08882940575206744,1803.72376704216,383.9563035964966,1482.0008964538574,20086,4980,15106,15106,0,22,5056000.0
5056,5056999,20.9362274034145,38.47431154929582,0.08885542155047066,1803.9439070224762,384.0219180583954,1482.8183784484863,20088,4981,15107,15107,0,22,5057000.0
5057,5057999,20.936966445971397,38.475102878610734,0.08888476895961539,1804.2924394607544,384.0885925292969,1483.0340995788574,20090,4982,15108,15108,0,22,5058000.0
5058,5058999,20.937241183457985,38.47459230874829,0.08890997578278126,1804.7066488265991,384.1545398235321,1483.0002479553223,20094,4984,15110,15110,0,22,5059000.0
5059,5059999,20.93776093667104,38.47461611361487,0.0889410289962278,1805.034295797348,384.22080636024475,1483.3692665100098,20094,4984,15110,15110,0,22,5060000.0
5060,5060999,20.93871080199637,38.475390509529774,0.08894756344893284,1805.5284225940704,384.2865746021271,1483.1090965270996,20100,4987,15113,15113,0,22,5061000.0
5061,5061999,20.939786238900066,38.4760663498862,0.08897450803419404,1806.02774643898,384.3521478176117,1482.7872352600098,20106,4990,15116,15116,0,22,5062000.0
5062,5062999,20.940790374445893,38.476401902739866,0.08901985804965384,1806.3829452991486,384.4214732646942,1483.228199005127,20108,4991,15117,15117,0,22,5063000.0
5063,5063999,20.94169492643054,38.476461460802994,0.08905405989968418,1806.7348153591156,384.48842430114746,1483.5609092712402,20110,4992,15118,15118,0,22,5064000.0
5064,5064999,20.942344987879512,38.47600009915464,0.08908296932797244,1806.9752752780914,384.5542941093445,1484.243938446045,20110,4992,15118,15118,0,22,5065000.0
5065,5065999,20.942532402861637,38.475191888183346,0.08908157618216217,1807.2230861186981,384.6214988231659,1485.2381629943848,20130,4992,15138,15138,0,22,5066000.0
5066,5066999,20.941490864379023,38.474636094091785,0.0890523004776067,1807.35329246521,384.68464827537537,1487.1602516174316,20140,4992,15148,15148,0,22,5067000.0
5067,5067999,20.93981318387819,38.47220385369986,0.08906030036933477,1807.5301790237427,384.7469570636749,1488.324878692627,20146,4992,15154,15154,0,22,5068000.0
5068,5068999,20.938297578918142,38.47086435583435,0.08906170167101957,1807.795737504959,384.8069293498993,1489.052333831787,20150,4993,15157,15157,0,22,5069000.0
5069,5069999,20.936756865326945,38.46831648269479,0.08906945440159808,1808.0461466312408,384.87001037597656,1489.7315254211426,20155,4994,15161,15161,0,22,5070000.0
5070,5070999,20.935613997158228,38.46611679799219,0.08906974563817993,1808.3716487884521,384.93324637413025,1490.1441612243652,20162,4996,15166,15166,0,22,5071000.0
5071,5071999,20.934556534127214,38.464101439743594,0.08907003752478804,1809.0498502254486,384.99858498573303,1489.4085273742676,20176,5003,15173,15173,0,22,5072000.0
5072,5072999,20.934048793219535,38.463636489545955,0.08906411575766782,1809.287929534912,385.0610394477844,1490.23286819458,20176,5003,15173,15173,0,22,5073000.0
5073,5073999,20.933864741920022,38.46364966913193,0.08905637336260319,1809.6843693256378,385.12591075897217,1490.4963035583496,20182,5006,15176,15176,0,22,5074000.0
5074,5074999,20.933942538863473,38.4636011961595,0.08905676907171067,1810.0177631378174,385.1876814365387,1490.7507514953613,20184,5007,15177,15177,0,22,5075000.0
5075,5075999,20.934126664856876,38.46368522664043,0.08906603854307438,1810.2695412635803,385.2494649887085,1491.3814888000488,20186,5008,15178,15178,0,22,5076000.0
5076,5076999,20.93459825356168,38.46450692031291,0.08906292308544306,1810.6901686191559,385.310866355896,1491.2645378112793,20188,5009,15179,15179,0,22,5077000.0
5077,5077999,20.935079498371355,38.46567700272675,0.0890598126268366,1811.0981984138489,385.37655091285706,1491.442211151123,20194,5012,15182,15182,0,22,5078000.0
5078,5078999,20.935654075150822,38.46642017438098,0.089060836159366,1811.440312385559,385.4412033557892,1491.8230934143066,20196,5013,15183,15183,0,22,5079000.0
5079,5079999,20.936129181314882,38.46679776305853,0.0890689659004027,1811.8181483745575,385.50870275497437,1492.0978660583496,20201,5015,15186,15186,0,22,5080000.0
5080,5080999,20.93697930152871,38.46732142681158,0.08909163611750937,1812.0902092456818,385.5714774131775,1492.6070976257324,20201,5015,15186,15186,0,22,5081000.0
5081,5081999,20.93752767317788,38.46712591996478,0.08909982226163715,1812.6284954547882,385.6356120109558,1492.1218910217285,20205,5017,15188,15188,0,22,5082000.0
5082,5082999,20.938111595088326,38.46698609421899,0.08910899238740255,1812.9368116855621,385.69920349121094,1492.5643882751465,20207,5018,15189,15189,0,22,5083000.0
5083,5083999,20.93819413448456,38.46610519210244,0.08911512019368806,1813.2099657058716,385.76424741744995,1493.0028190612793,20207,5018,15189,15189,0,22,5084000.0
5084,5084999,20.938711361768494,38.465513126711166,0.089104671289709,1813.7234983444214,385.83106660842896,1492.6889381408691,20210,5019,15191,15191,0,22,5085000.0
5085,5085999,20.938362260618806,38.46456532396781,0.08909542886925093,1813.9642009735107,385.89845037460327,1493.877529144287,20222,5019,15203,15203,0,22,5086000.0
5086,5086999,20.936997429767725,38.464613192732614,0.08909259130429636,1814.2729885578156,385.96164655685425,1494.7212562561035,20233,5021,15212,15212,0,22,5087000.0
5087,5087999,20.93509801798755,38.46156981834577,0.0891097426120867,1814.4544219970703,386.0253918170929,1495.768756866455,20233,5021,15212,15212,0,22,5088000.0
5088,5088999,20.93333708017766,38.45916933981455,0.08912373438010979,1814.7506725788116,386.088636636734,1496.2740516662598,20236,5022,15214,15214,0,22,5089000.0
5089,5089999,20.931477019804394,38.456566511324944,0.08913836880685722,1815.1144845485687,386.15219497680664,1496.4048118591309,20239,5023,15216,15216,0,22,5090000.0
5090,5090999,20.930032140841238,38.454169154721015,0.0891423592189502,1815.5733726024628,386.21633791923523,1496.2863807678223,20246,5026,15220,15220,0,22,5091000.0
5091,5091999,20.928438613195294,38.45174462039709,0.08914806381789264,1815.8446061611176,386.2797327041626,1496.840129852295,20246,5026,15220,15220,0,22,5092000.0
5092,5092999,20.926759753343152,38.44918682965918,0.08915858727743198,1816.1553666591644,386.34565782546997,1497.178524017334,20248,5027,15221,15221,0,22,5093000.0
5093,5093999,20.925440775658142,38.447321492961954,0.08915996237358148,1816.518827199936,386.412132024765,1497.279628753662,20248,5027,15221,15221,0,22,5094000.0
5094,5094999,20.92412693515471,38.44531538412855,0.08916464221166354,1817.0479950904846,386.4782202243805,1496.72993850708,20260,5030,15230,15230,0,22,5095000.0
5095,5095999,20.923044025851162,38.44345019371224,0.08916750696695774,1817.3549659252167,386.54253697395325,1497.1339302062988,20260,5030,15230,15230,0,22,5096000.0
5096,5096999,20.921709916368297,38.44104515289954,0.08917413191923496,1817.7255446910858,386.6096704006195,1497.2809028625488,20261,5031,15230,15230,0,22,5097000.0
5097,5097999,20.920528829249015,38.438987153634024,0.08918091365205516,1818.0470252037048,386.6752243041992,1497.5356941223145,20263,5032,15231,15231,0,22,5098000.0
5098,5098999,20.91939255280058,38.437337920232736,0.08918096839889034,1818.5044643878937,386.74367570877075,1497.3416328430176,20265,5033,15232,15232,0,22,5099000.0
5099,5099999,20.9183433374358,38.43510781260123,0.08918579798165716,1818.8234429359436,386.8084831237793,1497.5663948059082,20265,5033,15232,15232,0,22,5100000.0
5100,5100999,20.917436527290096,38.43341158401959,0.08918601732238429,1819.123942375183,386.8731806278229,1497.9699592590332,20265,5033,15232,15232,0,22,5101000.0
5101,5101999,20.91652687759919,38.431549082302126,0.08918283362198387,1819.4965453147888,386.93936562538147,1497.904239654541,20265,5033,15232,15232,0,22,5102000.0
5102,5102999,20.915813850445407,38.43020634818381,0.0891836798036596,1819.7992432117462,387.0035572052002,1498.276912689209,20265,5033,15232,15232,0,22,5103000.0
5103,5103999,20.91473342255376,38.42778437017849,0.0891838409010487,1820.1932649612427,387.0693597793579,1498.2980690002441,20278,5034,15244,15244,0,22,5104000.0
5104,5104999,20.91401031941081,38.42587077963808,0.08918419998817106,1820.5451123714447,387.1368188858032,1498.498134613037,20280,5035,15245,15245,0,22,5105000.0
5105,5105999,20.912963233873473,38.42415371372838,0.08918724821457147,1820.8944582939148,387.2023618221283,1498.751178741455,20283,5037,15246,15246,0,22,5106000.0
5106,5106999,20.91112311872854,38.421194545614625,0.08920676993922794,1821.1986892223358,387.27034282684326,1499.8169441223145,20306,5038,15268,15268,0,22,5107000.0
5107,5107999,20.90915873713094,38.41897217023119,0.08921940649715099,1821.4841418266296,387.3357343673706,1500.719928741455,20316,5039,15277,15277,0,22,5108000.0
5108,5108999,20.907232711062242,38.416157927929035,0.08923393997860307,1821.7805709838867,387.4027805328369,1501.2571449279785,20319,5039,15280,15280,0,22,5109000.0
5109,5109999,20.90531242504713,38.41337566152374,0.08925178214818208,1822.028312444687,387.4682743549347,1501.9447135925293,20321,5039,15282,15282,0,22,5110000.0
5110,5110999,20.90331882373357,38.41027612300861,0.08926755711275836,1822.3756637573242,387.5321378707886,1502.2118186950684,20324,5040,15284,15284,0,22,5111000.0
5111,5111999,20.90146515324828,38.40731635730623,0.08927891719944236,1822.9781687259674,387.59912037849426,1501.7489433288574,20362,5044,15318,15318,0,22,5112000.0
5112,5112999,20.89960677541756,38.404383580006524,0.0892902020827483,1823.2441246509552,387.66707277297974,1502.4372673034668,20362,5044,15318,15318,0,22,5113000.0
5113,5113999,20.897935010704078,38.40207129837533,0.08929723497106512,1823.7260973453522,387.73418521881104,1502.223934173584,20368,5048,15320,15320,0,22,5114000.0
5114,5114999,20.89653079918705,38.40012786468158,0.0892960969488632,1824.1258113384247,387.80081129074097,1502.663631439209,20391,5050,15341,15341,0,22,5115000.0
5115,5115999,20.894919909666047,38.39732669765606,0.08930958266416689,1824.4207780361176,387.8678877353668,1503.622226715088,20395,5051,15344,15344,0,22,5116000.0
5116,5116999,20.893710978455847,38.39529793268864,0.08931614925104037,1824.6723017692566,387.93271565437317,1504.355068206787,20397,5052,15345,15345,0,22,5117000.0
5117,5117999,20.89312694602087,38.39432393523223,0.08931939480255369,1825.0349819660187,388.00382232666016,1504.6390266418457,20397,5052,15345,15345,0,22,5118000.0
5118,5118999,20.892940316984987,38.39345682722851,0.08932624974800818,1825.3925504684448,388.07305884361267,1504.8198738098145,20397,5052,15345,15345,0,22,5119000.0
5119,5119999,20.893359509698723,38.396373985498755,0.0893318626932873,1825.6830277442932,388.139696598053,1505.1742210388184,20397,5052,15345,15345,0,22,5120000.0
5120,5120999,20.89346287725525,38.39659614962975,0.0893446783814732,1826.1069934368134,388.2096598148346,1505.1742210388184,20397,5052,15345,15345,0,22,5121000.0
5121,5121999,20.893587945545196,38.39658482830572,0.08936639356700904,1826.3744957447052,388.2774531841278,1505.704891204834,20399,5053,15346,15346,0,22,5122000.0
5122,5122999,20.89417588798265,38.397192263142585,0.08940094014593325,1826.6603274345398,388.3455023765564,1506.099552154541,20399,5053,15346,15346,0,22,5123000.0
5123,5123999,20.894207950841125,38.39687964635412,0.08943487918083626,1826.993361711502,388.412228345871,1506.432903289795,20401,5054,15347,15347,0,22,5124000.0
5124,5124999,20.89377173381885,38.39533226428386,0.08944654842057942,1827.2913115024567,388.47962522506714,1506.6453132629395,20401,5054,15347,15347,0,22,5125000.0
5125,5125999,20.893776829640252,38.3945555589946,0.0894641715913006,1827.6829106807709,388.5480623245239,1506.783992767334,20403,5055,15348,15348,0,22,5126000.0
5126,5126999,20.89377647279506,38.393704111663595,0.08949061159302818,1828.3095140457153,388.6184723377228,1506.1318626403809,20413,5060,15353,15353,0,22,5127000.0
5127,5127999,20.892268130342504,38.39150239443246,0.08950093585526908,1828.5621118545532,388.684157371521,1507.6345329284668,20442,5061,15381,15381,0,22,5128000.0
5128,5128999,20.890596449839645,38.38936847843236,0.08950605467674388,1828.7856712341309,388.7460505962372,1508.7079124450684,20454,5061,15393,15393,0,22,5129000.0
5129,5129999,20.889000023004666,38.386853589695214,0.08951752410195057,1829.078353881836,388.808057308197,1509.4532585144043,20460,5061,15399,15399,0,22,5130000.0
5130,5130999,20.887552223674515,38.38523745918645,0.08952118708368029,1829.2626993656158,388.8696753978729,1510.6313667297363,20468,5061,15407,15407,0,22,5131000.0
5131,5131999,20.88617910829298,38.38296067093315,0.08952026612791342,1829.4766838550568,388.93247079849243,1511.6402626037598,20473,5062,15411,15411,0,22,5132000.0
5132,5132999,20.88511650634121,38.38114103439071,0.08951984345080832,1829.9344222545624,388.99501848220825,1511.845531463623,20482,5066,15416,15416,0,22,5133000.0
5133,5133999,20.883930327246624,38.378985931309245,0.08952227021966608,1830.2401237487793,389.0609691143036,1512.5346412658691,20484,5067,15417,15417,0,22,5134000.0
5134,5134999,20.882802282984553,38.37684850241906,0.08952362716312401,1830.5848801136017,389.1247925758362,1513.0359153747559,20488,5069,15419,15419,0,22,5135000.0
5135,5135999,20.88169133643768,38.37704361543884,0.08951418085011087,1831.0625903606415,389.1882975101471,1512.9327507019043,20495,5072,15423,15423,0,22,5136000.0
5136,5136999,20.880842856400772,38.375684990020105,0.08951733912041882,1831.41676902771,389.2522518634796,1513.4680671691895,20501,5075,15426,15426,0,22,5137000.0
5137,5137999,20.88037798884638,38.37514593850896,0.08952281417088204,1831.6562798023224,389.318975687027,1514.2629737854004,20501,5075,15426,15426,0,22,5138000.0
5138,5138999,20.880256058730307,38.37745035592293,0.08952082441947418,1831.9472069740295,389.38631415367126,1514.830654144287,20501,5075,15426,15426,0,22,5139000.0
5139,5139999,20.88085372839406,38.38125955175923,0.0895250157827262,1832.220588684082,389.448086977005,1515.309856414795,20502,5075,15427,15427,0,22,5140000.0
5140,5140999,20.8815995196962,38.38241964004934,0.08956703682063372,1832.6342458724976,389.51127529144287,1515.2899894714355,20506,5077,15429,15429,0,22,5141000.0
5141,5141999,20.882846423999908,38.38468763534682,0.08960569787515726,1832.9781277179718,389.5776228904724,1515.641414642334,20508,5078,15430,15430,0,22,5142000.0
5142,5142999,20.883921011382654,38.38624675627375,0.08968449209615215,1833.2111368179321,389.64361691474915,1516.4562644958496,20510,5079,15431,15431,0,22,5143000.0
5143,5143999,20.885626052475093,38.389563001771,0.08976366985316375,1833.6545522212982,389.7066538333893,1516.3523750305176,20514,5081,15433,15433,0,22,5144000.0
5144,5144999,20.887209108920477,38.392254202414605,0.08981844652431681,1834.1420958042145,389.7699248790741,1516.2085075378418,20545,5084,15461,15461,0,22,5145000.0
5145,5145999,20.888226078669913,38.39292699029928,0.08986309154550687,1834.604023218155,389.83485674858093,1516.0140419006348,20545,5084,15461,15461,0,22,5146000.0
5146,5146999,20.889488258628162,38.39371762005186,0.08990818384046695,1834.9268848896027,389.89866733551025,1516.4610481262207,20555,5086,15469,15469,0,22,5147000.0
5147,5147999,20.891003908483498,38.39567010075557,0.08994605926953836,1835.2494666576385,389.9663655757904,1517.0016899108887,20562,5086,15476,15476,0,22,5148000.0
5148,5148999,20.889696023415265,38.39353383793023,0.08995435204687663,1835.4994201660156,390.0310652256012,1518.3417701721191,20582,5087,15495,15495,0,22,5149000.0
5149,5149999,20.888383188533954,38.39188803404661,0.08996293741461103,1835.7732832431793,390.0961093902588,1519.3217277526855,20598,5088,15510,15510,0,22,5150000.0
5150,5150999,20.88700775688524,38.38962807293822,0.0899733482984586,1835.916387796402,390.1601598262787,1520.6335334777832,20601,5088,15513,15513,0,22,5151000.0
5151,5151999,20.885892758377576,38.38967019525575,0.0899650746802233,1836.1444261074066,390.2242727279663,1521.4357643127441,20601,5088,15513,15513,0,22,5152000.0
5152,5152999,20.884572421870814,38.39089698884192,0.08995408139703764,1836.5158722400665,390.2886824607849,1521.607578277588,20603,5089,15514,15514,0,22,5153000.0
5153,5153999,20.883031507790022,38.388162072929134,0.08996456642610529,1836.8379316329956,390.3526725769043,1522.0551567077637,20605,5090,15515,15515,0,22,5154000.0
5154,5154999,20.88189258379456,38.38632332321724,0.08996623247808977,1837.2399661540985,390.4175510406494,1521.9856605529785,20605,5090,15515,15515,0,22,5155000.0
5155,5155999,20.88065026658398,38.384693846021705,0.08996722451610573,1837.639274597168,390.4818058013916,1521.9999046325684,20607,5091,15516,15516,0,22,5156000.0
5156,5156999,20.879283314550833,38.38268649596353,0.0899753367742927,1837.9891633987427,390.5441482067108,1522.1093559265137,20607,5091,15516,15516,0,22,5157000.0
5157,5157999,20.878244316437,38.3807658604134,0.08998008980263417,1838.2987701892853,390.60837388038635,1522.5201530456543,20609,5092,15517,15517,0,22,5158000.0
5158,5158999,20.877283561215055,38.38114525651585,0.08997544656750978,1838.6538887023926,390.6753878593445,1522.8132133483887,20622,5094,15528,15528,0,22,5159000.0
5159,5159999,20.876070214913693,38.37878355482235,0.0899858045560834,1839.1337463855743,390.740802526474,1522.6933631896973,20626,5096,15530,15530,0,22,5160000.0
5160,5160999,20.875053160179316,38.376982452111115,0.08999383071955425,1839.450216293335,390.80734729766846,1523.0958824157715,20626,5096,15530,15530,0,22,5161000.0
5161,5161999,20.87405295478083,38.37706916487356,0.08999629835529643,1839.7170062065125,390.87163376808167,1523.7425498962402,20628,5097,15531,15531,0,22,5162000.0
5162,5162999,20.872973526132107,38.374762992624504,0.09001065380248763,1840.0494756698608,390.9377508163452,1524.0597801208496,20628,5097,15531,15531,0,22,5163000.0
5163,5163999,20.871645052502025,38.37209893103302,0.09002870893960602,1840.4042165279388,391.00556230545044,1524.3453559875488,20628,5097,15531,15531,0,22,5164000.0
5164,5164999,20.87030296759484,38.37045974141393,0.09004170386068688,1840.8797636032104,391.0725529193878,1524.3300437927246,20643,5100,15543,15543,0,22,5165000.0
5165,5165999,20.86844055799565,38.367443550819296,0.09006157224130451,1841.161383152008,391.1400616168976,1525.582851409912,20663,5102,15561,15561,0,22,5166000.0
5166,5166999,20.86670228125982,38.36510101279591,0.09007655971452033,1841.42049908638,391.2032036781311,1526.565341949463,20682,5103,15579,15579,0,22,5167000.0
5167,5167999,20.865021886698774,38.363597349220754,0.09008779125440514,1841.7554504871368,391.2663896083832,1527.2735176086426,20685,5104,15581,15581,0,22,5168000.0
5168,5168999,20.863247110290796,38.360744012384544,0.09010365216593375,1841.9888503551483,391.3305869102478,1528.1470222473145,20686,5104,15582,15582,0,22,5169000.0
5169,5169999,20.86177374283914,38.35876169412672,0.09011251007245524,1842.2423160076141,391.3935685157776,1528.8361701965332,20689,5105,15584,15584,0,22,5170000.0
5170,5170999,20.86052335145315,38.35700334329537,0.09011559640901146,1842.5306046009064,391.4579510688782,1529.332103729248,20691,5106,15585,15585,0,22,5171000.0
5171,5171999,20.859219902495774,38.35601550331042,0.09011767173421614,1843.008605003357,391.52234148979187,1529.139820098877,20699,5109,15590,15590,0,22,5172000.0
5172,5172999,20.857845493094796,38.353978241713925,0.0901242397672749,1843.4527215957642,391.5904264450073,1529.2619667053223,20712,5112,15600,15600,0,22,5173000.0
5173,5173999,20.856744302051496,38.35262184981614,0.09012632392176712,1843.8093926906586,391.6569457054138,1529.641300201416,20716,5114,15602,15602,0,22,5174000.0
5174,5174999,20.855557743524493,38.35079371649653,0.09012217634172537,1844.1982879638672,391.72205424308777,1529.9058570861816,20748,5116,15632,15632,0,22,5175000.0
5175,5175999,20.85474056611003,38.34935581695658,0.09011590209576548,1844.544053554535,391.78845834732056,1530.199619293213,20750,5117,15633,15633,0,22,5176000.0
5176,5176999,20.854336643493024,38.34915334789326,0.090100845016862,1844.9278361797333,391.8537333011627,1530.2838859558105,20752,5118,15634,15634,0,22,5177000.0
5177,5177999,20.853869477095103,38.34826474508166,0.09009138411408202,1845.4065408706665,391.9193570613861,1530.2106971740723,20758,5121,15637,15637,0,22,5178000.0
5178,5178999,20.853037235348012,38.346544799617874,0.09008898455565306,1845.6410353183746,391.9835093021393,1530.8951606750488,20758,5121,15637,15637,0,22,5179000.0
5179,5179999,20.852820908579414,38.34608537288337,0.09007416246003586,1846.048909664154,392.0516505241394,1530.951847076416,20766,5122,15644,15644,0,22,5180000.0
5180,5180999,20.85212401933586,38.34445590344115,0.09007045645620937,1846.6540760993958,392.12043023109436,1530.361904144287,20772,5125,15647,15647,0,22,5181000.0
5181,5181999,20.851434596337082,38.34283102743633,0.09006165606303174,1846.9726305007935,399.72290301322937,1530.8132514953613,20775,5127,15648,15648,0,22,5182000.0
5182,5182999,20.850883693941245,38.34147206756251,0.09005173570184954,1847.3479452133179,399.78936529159546,1530.956226348877,20783,5129,15654,15654,0,22,5183000.0
5183,5183999,20.85068464516792,38.34384424127603,0.09002545345519031,1847.7413306236267,399.8548927307129,1531.0363807678223,20785,5130,15655,15655,0,22,5184000.0
5184,5184999,20.84999823330465,38.3444448489705,0.09000752691621494,1848.0208101272583,399.9227924346924,1531.8598670959473,20794,5130,15664,15664,0,22,5185000.0
5185,5185999,20.84828109956313,38.34252248459769,0.09001506922628932,1848.342556476593,399.9871416091919,1532.6390495300293,20805,5131,15674,15674,0,22,5186000.0
5186,5186999,20.84652497757775,38.341059273599875,0.09002000636904883,1848.5758876800537,400.05324840545654,1533.5098304748535,20807,5131,15676,15676,0,22,5187000.0
5187,5187999,20.845071379451678,38.34018507015984,0.09001694128771887,1848.8715541362762,400.12128829956055,1534.1695823669434,20817,5132,15685,15685,0,22,5188000.0
5188,5188999,20.84381574013937,38.33833805031101,0.09001833033682383,1849.1969501972198,400.18489837646484,1534.6406898498535,20823,5134,15689,15689,0,22,5189000.0
5189,5189999,20.842861100528076,38.337338436131176,0.09001625335349395,1849.6698367595673,400.25009274482727,1534.6622581481934,20832,5138,15694,15694,0,22,5190000.0
5190,5190999,20.841743867000268,38.33558778704273,0.09001695151938827,1849.9692883491516,400.31471037864685,1535.3351402282715,20834,5139,15695,15695,0,22,5191000.0
5191,5191999,20.84054831158083,38.33350545502236,0.09002167105696424,1850.2546577453613,400.37937688827515,1535.9069786071777,20835,5139,15696,15696,0,22,5192000.0
5192,5192999,20.83934743942741,38.33126432180885,0.09002435032191447,1850.561564207077,400.444712638855,1536.1870918273926,20835,5139,15696,15696,0,22,5193000.0
5193,5193999,20.838432266954598,38.329469977233586,0.09002125403193595,1851.0274775028229,400.519065618515,1536.1970710754395,20837,5140,15697,15697,0,22,5194000.0
5194,5194999,20.837843486711293,38.32888933016204,0.09002024938011255,1851.3400495052338,400.5836887359619,1536.610538482666,20839,5141,15698,15698,0,22,5195000.0
5195,5195999,20.837034820463085,38.32691394504249,0.09001849200177148,1851.7775144577026,400.6543347835541,1536.5324974060059,20848,5142,15706,15706,0,22,5196000.0
5196,5196999,20.836447965063964,38.325606418750425,0.09001703872306144,1852.0586643218994,400.7208294868469,1537.0494575500488,20848,5142,15706,15706,0,22,5197000.0
5197,5197999,20.835623436821646,38.323840948528414,0.09001800229556367,1852.5099167823792,400.7860424518585,1536.9397468566895,20862,5143,15719,15719,0,22,5198000.0
5198,5198999,20.835135348247654,38.32502180843659,0.09000577767311424,1852.8103189468384,400.85222864151,1537.6029777526855,20862,5143,15719,15719,0,22,5199000.0
5199,5199999,20.834296993773073,38.32294940509286,0.0900121875592872,1853.002783536911,400.9177486896515,1538.551914215088,20862,5143,15719,15719,0,22,5200000.0
5200,5200999,20.83340844864039,38.32084949454113,0.09001876262448238,1853.273537158966,400.98582339286804,1539.0546379089355,20864,5144,15720,15720,0,22,5201000.0
5201,5201999,20.83292237275874,38.31981350572434,0.09001659400434936,1853.7296504974365,401.0538864135742,1538.853572845459,20868,5146,15722,15722,0,22,5202000.0
5202,5202999,20.8322156699561,38.31792105833591,0.09002079473154556,1854.1026697158813,401.12103390693665,1538.92094039917,20868,5146,15722,15722,0,22,5203000.0
5203,5203999,20.831156421713782,38.31557476034101,0.09002440133377054,1854.4607088565826,401.1885998249054,1539.0659217834473,20868,5146,15722,15722,0,22,5204000.0
5204,5204999,20.829966590909127,38.313168264727665,0.0900275313079808,1854.8302285671234,401.25555515289307,1539.1798515319824,20868,5146,15722,15722,0,22,5205000.0
5205,5205999,20.8290047743625,38.3110183326055,0.09003179248381243,1855.1688754558563,401.3268313407898,1539.987102508545,20893,5146,15747,15747,0,22,5206000.0
5206,5206999,20.827083895140184,38.30823351389992,0.09005175338984572,1855.340297460556,401.389041185379,1541.59428024292,20903,5146,15757,15757,0,22,5207000.0
5207,5207999,20.825137585050157,38.30539626592543,0.09006841655578601,1855.562519788742,401.4528889656067,1542.540370941162,20906,5146,15760,15760,0,22,5208000.0
5208,5208999,20.82341304645587,38.30262836035372,0.09008358337262934,1855.8674125671387,401.51739740371704,1543.1562156677246,20910,5147,15763,15763,0,22,5209000.0
5209,5209999,20.82183785009436,38.3000713473768,0.0900954160406977,1856.128514289856,401.5813181400299,1543.7401161193848,20913,5147,15766,15766,0,22,5210000.0
5210,5210999,20.82043272647752,38.2988632036375,0.09010142949773337,1856.5004551410675,401.64414834976196,1543.8091163635254,20917,5149,15768,15768,0,22,5211000.0
5211,5211999,20.818795003903126,38.29623636729047,0.09011406063186966,1857.0865631103516,401.7102155685425,1543.6274604797363,20927,5154,15773,15773,0,22,5212000.0
5212,5212999,20.81717537172853,38.29366128705371,0.09012568361828488,1857.349731206894,401.77308917045593,1544.485996246338,20929,5155,15774,15774,0,22,5213000.0
5213,5213999,20.81580396331179,38.29126729691975,0.09013368002980382,1857.6741542816162,401.8357927799225,1544.992031097412,20933,5157,15776,15776,0,22,5214000.0
5214,5214999,20.814467356075166,38.289374276391854,0.09014734699379157,1858.0461990833282,401.8989429473877,1545.2373085021973,20937,5159,15778,15778,0,22,5215000.0
5215,5215999,20.81321429028874,38.28746088933762,0.090155277072555,1858.452070236206,401.96500062942505,1545.4133033752441,20943,5162,15781,15781,0,22,5216000.0
5216,5216999,20.81162439844921,38.28478166909194,0.09017100250839227,1858.8287003040314,402.03228855133057,1545.5388069152832,20943,5162,15781,15781,0,22,5217000.0
5217,5217999,20.81027303263937,38.282268899909965,0.09018048027827053,1859.1428501605988,402.09636211395264,1546.0396614074707,20945,5163,15782,15782,0,22,5218000.0
5218,5218999,20.809189276423464,38.28047314156495,0.09018531845810884,1859.510416507721,402.1598286628723,1546.168170928955,20945,5163,15782,15782,0,22,5219000.0
5219,5219999,20.808153140624636,38.27859819214285,0.09019256855657765,1859.8681831359863,402.22350215911865,1546.3628959655762,20945,5163,15782,15782,0,22,5220000.0
5220,5220999,20.8075365064697,38.27777587257707,0.09019307963682743,1860.0537221431732,402.28689193725586,1547.2037315368652,20945,5163,15782,15782,0,22,5221000.0
5221,5221999,20.806850223834953,38.27614324266347,0.09019631719076615,1860.5270853042603,402.3530480861664,1546.90620803833,20949,5165,15784,15784,0,22,5222000.0
5222,5222999,20.80620046089396,38.2749398522715,0.09019511602303454,1861.0206499099731,402.41701579093933,1546.6792488098145,20955,5168,15787,15787,0,22,5223000.0
5223,5223999,20.805480781088963,38.27445000605259,0.0901905297078357,1861.3894927501678,402.48336958885193,1546.7696800231934,20955,5168,15787,15787,0,22,5224000.0
5224,5224999,20.804384793292186,38.27328144540023,0.09018973781343342,1861.7524945735931,402.5471181869507,1546.925968170166,20955,5168,15787,15787,0,22,5225000.0
5225,5225999,20.803320854258487,38.27108302036446,0.09019429450835614,1862.0788929462433,402.6151201725006,1547.6873817443848,20967,5168,15799,15799,0,22,5226000.0
5226,5226999,20.80170225586408,38.26991707736952,0.09020535687762965,1862.4388036727905,402.6812815666199,1548.4677085876465,20997,5170,15827,15827,0,22,5227000.0
5227,5227999,20.799840214216072,38.267181349883714,0.09021888075005002,1862.6205332279205,402.74426341056824,1549.7806816101074,20999,5170,15829,15829,0,22,5228000.0
5228,5228999,20.797899549297835,38.26418559316118,0.09023605651092548,1862.8725800514221,402.8077201843262,1550.774974822998,21002,5171,15831,15831,0,22,5229000.0
5229,5229999,20.796259856064726,38.26157422327868,0.09024656476419568,1863.1478786468506,402.8712739944458,1551.4343452453613,21005,5172,15833,15833,0,22,5230000.0
5230,5230999,20.794980531380997,38.259779066111086,0.09024683857158988,1863.4978177547455,402.93581771850586,1551.7488899230957,21010,5174,15836,15836,0,22,5231000.0
5231,5231999,20.79327429684972,38.25703582857661,0.09025941973009044,1863.768593788147,402.99914622306824,1552.2697486877441,21010,5174,15836,15836,0,22,5232000.0
5232,5232999,20.79189411553374,38.25505128732229,0.09026403730340893,1864.092957019806,403.0610897541046,1552.5488243103027,21013,5175,15838,15838,0,22,5233000.0
5233,5233999,20.790564359388696,38.25321183726401,0.09026846154066803,1864.3143689632416,403.12460374832153,1553.1859855651855,21014,5175,15839,15839,0,22,5234000.0
5234,5234999,20.789159318117722,38.25071854561339,0.0902755068460126,1864.8300371170044,403.1905996799469,1552.7237739562988,21020,5178,15842,15842,0,22,5235000.0
5235,5235999,20.78771530113926,38.24821231256814,0.09028468802266043,1865.2725644111633,403.2562675476074,1552.7365760803223,21030,5180,15850,15850,0,22,5236000.0
5236,5236999,20.78647263908927,38.246305439883265,0.09028889971614262,1865.723032951355,403.32145643234253,1552.6880073547363,21034,5182,15852,15852,0,22,5237000.0
5237,5237999,20.78512957032196,38.24425247723517,0.09029402459802538,1866.0451939105988,403.3865292072296,1552.9542655944824,21034,5182,15852,15852,0,22,5238000.0
5238,5238999,20.783708898508664,38.241904863502455,0.0903020946404739,1866.3611342906952,403.45342230796814,1553.3240013122559,21034,5182,15852,15852,0,22,5239000.0
5239,5239999,20.78253869220561,38.239607748979374,0.09030590616604084,1866.5200984477997,403.5175971984863,1554.2588996887207,21034,5182,15852,15852,0,22,5240000.0
5240,5240999,20.781296757085446,38.23857175865572,0.09030592741377419,1866.7353563308716,403.5812039375305,1554.8828239440918,21034,5182,15852,15852,0,22,5241000.0
5241,5241999,20.780068689172072,38.236205653724085,0.09031223655065079,1867.176414489746,403.6450939178467,1554.5830116271973,21038,5184,15854,15854,0,22,5242000.0
5242,5242999,20.779034432553495,38.234160183144525,0.09031511105019485,1867.5485367774963,403.7103612422943,1554.6530723571777,21038,5184,15854,15854,0,22,5243000.0
5243,5243999,20.77781927409512,38.23174761599415,0.09031907625716118,1868.144725561142,403.7768635749817,1553.9751625061035,21044,5187,15857,15857,0,22,5244000.0
5244,5244999,20.77646425558441,38.229162824065696,0.0903242412531613,1868.4143657684326,403.84468054771423,1554.6647148132324,21044,5187,15857,15857,0,22,5245000.0
5245,5245999,20.775064859473193,38.22670957456316,0.09033063616601378,1868.620956659317,403.9095184803009,1555.3900337219238,21044,5187,15857,15857,0,22,5246000.0
5246,5246999,20.773351865630758,38.22391910231867,0.09034817931198191,1868.964771747589,403.9779460430145,1556.3035850524902,21066,5187,15879,15879,0,22,5247000.0
5247,5247999,20.771277860470654,38.22103640594563,0.09036382560543932,1869.2676281929016,404.04339599609375,1557.0653190612793,21076,5188,15888,15888,0,22,5248000.0
5248,5248999,20.769395047246036,38.21832352010327,0.09037779072917917,1869.5053873062134,404.1085994243622,1557.9296607971191,21080,5188,15892,15892,0,22,5249000.0
5249,5249999,20.767678192977755,38.215642577484516,0.09039343614850626,1869.7633719444275,404.1775963306427,1558.6294059753418,21082,5188,15894,15894,0,22,5250000.0
5250,5250999,20.766092918429337,38.21321784656963,0.09040014635969362,1870.1917419433594,404.24277782440186,1558.5944633483887,21087,5190,15897,15897,0,22,5251000.0
5251,5251999,20.764868002983317,38.211958208391366,0.09040285515824376,1870.6749274730682,404.30793809890747,1558.5356712341309,21093,5193,15900,15900,0,22,5252000.0
5252,5252999,20.763313291271327,38.210091474418206,0.09040827376739968,1870.9518003463745,404.3827381134033,1559.334758758545,21094,5193,15901,15901,0,22,5253000.0
5253,5253999,20.76205742243328,38.208367139420716,0.09041088005920128,1871.3759500980377,404.4485676288605,1559.3803672790527,21104,5195,15909,15909,0,22,5254000.0
5254,5254999,20.760779252513334,38.20636224021842,0.0904143970045519,1871.6901443004608,404.5153992176056,1559.9332389831543,21118,5196,15922,15922,0,22,5255000.0
5255,5255999,20.75957636198298,38.204256044319564,0.09041937561853686,1872.0505731105804,404.58359384536743,1560.575351715088,21121,5197,15924,15924,0,22,5256000.0
5256,5256999,20.758430532210735,38.202106246199506,0.09042600268125778,1872.2570555210114,404.65045523643494,1561.5909385681152,21121,5197,15924,15924,0,22,5257000.0
5257,5257999,20.75718557301452,38.20007406813921,0.0904317547354122,1872.6146318912506,404.71578764915466,1561.6975212097168,21121,5197,15924,15924,0,22,5258000.0
5258,5258999,20.756165093544332,38.19833492908107,0.09043404099871677,1872.8849432468414,404.78401279449463,1562.3162803649902,21122,5197,15925,15925,0,22,5259000.0
5259,5259999,20.755057709041758,38.19627001541015,0.09043573311534858,1873.0851345062256,404.851003408432,1563.0597953796387,21122,5197,15925,15925,0,22,5260000.0
5260,5260999,20.754450936563615,38.19702668273941,0.09042172493801937,1873.5639481544495,404.9182302951813,1562.6395378112793,21122,5197,15925,15925,0,22,5261000.0
5261,5261999,20.753785191269355,38.19641239279175,0.09041833897069351,1873.8422105312347,404.98517656326294,1563.204517364502,21124,5198,15926,15926,0,22,5262000.0
5262,5262999,20.75319632200498,38.196474091457425,0.09041855190901682,1874.2096626758575,405.05349802970886,1563.384334564209,21124,5198,15926,15926,0,22,5263000.0
5263,5263999,20.752828698102242,38.19549154537747,0.09042214159451034,1874.5129601955414,405.1178786754608,1563.8122901916504,21126,5199,15927,15927,0,22,5264000.0
5264,5264999,20.752461219653878,38.19526475789114,0.09042054622708018,1875.0347809791565,405.1941030025482,1563.3097877502441,21128,5200,15928,15928,0,22,5265000.0
5265,5265999,20.7515979835439,38.19336226655077,0.09042496428224045,1875.277874469757,405.26176404953003,1563.9936408996582,21128,5200,15928,15928,0,22,5266000.0
5266,5266999,20.750527691528767,38.19123528541564,0.09043338032200676,1875.7287561893463,405.3333489894867,1563.8553276062012,21130,5201,15929,15929,0,22,5267000.0
5267,5267999,20.74928463159671,38.19065129078627,0.09043016180121421,1876.132607460022,405.4011301994324,1564.6429405212402,21156,5202,15954,15954,0,22,5268000.0
5268,5268999,20.74761875784062,38.18827258932024,0.09043749339597185,1876.386106967926,405.4648187160492,1565.9160346984863,21184,5203,15981,15981,0,22,5269000.0
5269,5269999,20.746419402162452,38.187147321662,0.09043745163706451,1876.640899181366,405.5273644924164,1567.1667213439941,21194,5204,15990,15990,0,22,5270000.0
5270,5270999,20.745218953974202,38.18536887289677,0.09044341286932367,1876.7871339321136,405.5899090766907,1568.7136573791504,21202,5204,15998,15998,0,22,5271000.0
5271,5271999,20.744400245325874,38.183922956397744,0.09044053975670452,1876.9571042060852,405.65432810783386,1569.9380149841309,21205,5204,16001,16001,0,22,5272000.0
5272,5272999,20.743267981444117,38.181652138650605,0.09044502755621064,1877.4949433803558,405.7185559272766,1569.7442512512207,21214,5208,16006,16006,0,22,5273000.0
5273,5273999,20.742314453896263,38.180445199784806,0.09043646266614969,1877.7858309745789,405.78206181526184,1570.6279792785645,21219,5210,16009,16009,0,22,5274000.0
5274,5274999,20.74126167548892,38.17857683833925,0.09043447034100871,1878.0146462917328,405.84845757484436,1571.5850257873535,21219,5210,16009,16009,0,22,5275000.0
5275,5275999,20.740206903289685,38.17642522278468,0.09044131720409099,1878.3125598430634,405.91135001182556,1572.0777397155762,21222,5211,16011,16011,0,22,5276000.0
5276,5276999,20.739523335643856,38.177413010534366,0.09043419782687767,1878.7566645145416,405.9762284755707,1572.078914642334,21228,5214,16014,16014,0,22,5277000.0
5277,5277999,20.73853581676155,38.17524041023287,0.09043330910111003,1879.1376602649689,406.0411059856415,1572.3075981140137,21232,5216,16016,16016,0,22,5278000.0
5278,5278999,20.737956234157565,38.17397265696986,0.09043748924298745,1879.4655220508575,406.1054949760437,1572.7206916809082,21232,5216,16016,16016,0,22,5279000.0
5279,5279999,20.737371014221555,38.17245499545978,0.09043900543340067,1879.9276258945465,406.1707880496979,1572.5231437683105,21235,5217,16018,16018,0,22,5280000.0
5280,5280999,20.737271663572788,38.17383115818711,0.0904269326299253,1880.1955587863922,406.233815908432,1573.1545753479004,21235,5217,16018,16018,0,22,5281000.0
5281,5281999,20.737136307175646,38.17326114708777,0.09041866213124272,1880.3973915576935,406.30069398880005,1574.0243034362793,21235,5217,16018,16018,0,22,5282000.0
5282,5282999,20.73711773572691,38.17269817941603,0.09041064390734133,1880.780327796936,406.3653898239136,1574.1696128845215,21239,5219,16020,16020,0,22,5283000.0
5283,5283999,20.737141794935248,38.17337329783376,0.09040078849312283,1881.2564327716827,406.4314544200897,1573.8582191467285,21241,5220,16021,16021,0,22,5284000.0
5284,5284999,20.737236790055846,38.17258932009819,0.09039779051644581,1881.621098279953,406.4975609779358,1574.1157112121582,21243,5221,16022,16022,0,22,5285000.0
5285,5285999,20.737264287968337,38.171686142488085,0.09038644582812738,1882.0574431419373,406.5621781349182,1574.047420501709,21245,5222,16023,16023,0,22,5286000.0
5286,5286999,20.737221147736786,38.17040183214905,0.09037540470988492,1882.3815023899078,406.62714290618896,1574.4786949157715,21245,5222,16023,16023,0,22,5287000.0
5287,5287999,20.736908122617464,38.168845909801,0.090369089172195,1882.5764391422272,406.69166469573975,1575.506679534912,21245,5222,16023,16023,0,22,5288000.0
5288,5288999,20.735685631905447,38.16729511935896,0.09037281202339853,1882.8567113876343,406.75609064102173,1576.7190742492676,21268,5223,16045,16045,0,22,5289000.0
5289,5289999,20.734188170805854,38.16512045355747,0.09038317669423168,1883.0802597999573,406.8200008869171,1577.7824211120605,21277,5223,16054,16054,0,22,5290000.0
5290,5290999,20.73265105104799,38.16262372181042,0.09039950031445709,1883.313792705536,406.8825936317444,1578.5990943908691,21280,5223,16057,16057,0,22,5291000.0
5291,5291999,20.73139121218125,38.16066749956822,0.09040161651040013,1883.617864370346,406.94755244255066,1579.0714073181152,21283,5224,16059,16059,0,22,5292000.0
5292,5292999,20.730194829582953,38.15850745205916,0.09040772591018076,1884.1052467823029,407.01433658599854,1579.0129280090332,21289,5227,16062,16062,0,22,5293000.0
5293,5293999,20.728802300490866,38.15665098803069,0.09040871754370383,1884.4956574440002,407.08029794692993,1579.2064247131348,21292,5228,16064,16064,0,22,5294000.0
5294,5294999,20.727827323057543,38.1550075176408,0.09040894571248337,1884.8603992462158,407.14878702163696,1579.4283638000488,21294,5229,16065,16065,0,22,5295000.0
5295,5295999,20.72686390630939,38.15309475423215,0.09041267136604902,1885.2169914245605,407.21241760253906,1579.7741508483887,21296,5230,16066,16066,0,22,5296000.0
5296,5296999,20.72587934548947,38.15107809378535,0.0904139069177502,1885.5641832351685,407.28068256378174,1580.0451698303223,21296,5230,16066,16066,0,22,5297000.0
5297,5297999,20.725202435827146,38.14995809308391,0.09040873798703242,1885.9480299949646,407.34533524513245,1580.1895942687988,21300,5232,16068,16068,0,22,5298000.0
5298,5298999,20.724833477528097,38.148663633357586,0.09040532349350572,1886.3759758472443,407.4100639820099,1580.0863304138184,21303,5234,16069,16069,0,22,5299000.0
5299,5299999,20.724166219359063,38.146978250155264,0.09040897759640731,1886.7768194675446,407.47511768341064,1580.1670188903809,21304,5235,16069,16069,0,22,5300000.0
5300,5300999,20.72402874084133,38.14657891181381,0.09040191278470067,1887.1076517105103,407.54252314567566,1580.5401802062988,21304,5235,16069,16069,0,22,5301000.0
5301,5301999,20.723715306660104,38.14545344146581,0.09039917831481903,1887.3839673995972,407.60949182510376,1581.0397605895996,21304,5235,16069,16069,0,22,5302000.0
5302,5302999,20.723203456012158,38.14399218009825,0.09040435280122239,1887.8834397792816,407.68082451820374,1580.7771263122559,21306,5236,16070,16070,0,22,5303000.0
5303,5303999,20.722759399774805,38.14253108289193,0.09040765162903985,1888.1268224716187,407.7467963695526,1581.390209197998,21306,5236,16070,16070,0,22,5304000.0
5304,5304999,20.722017760311097,38.14030901311983,0.09041886455113068,1888.5288527011871,407.8198912143707,1581.4684104919434,21307,5237,16070,16070,0,22,5305000.0
5305,5305999,20.720670070281802,38.1398835529664,0.09042112029639193,1888.7389223575592,407.88663721084595,1582.9732398986816,21326,5237,16089,16089,0,22,5306000.0
5306,5306999,20.71914868209385,38.139219440356214,0.09042991181216564,1889.0409665107727,407.9492914676666,1583.7385749816895,21332,5238,16094,16094,0,22,5307000.0
5307,5307999,20.71753207680713,38.136608835247856,0.09045260655070597,1889.312279701233,408.01231145858765,1584.663875579834,21349,5239,16110,16110,0,22,5308000.0
5308,5308999,20.716089656391766,38.13510337118733,0.09046938513935998,1889.516952753067,408.0768368244171,1585.732006072998,21350,5239,16111,16111,0,22,5309000.0
5309,5309999,20.714506509442117,38.1325141549281,0.09049076467505068,1889.7681181430817,408.141893863678,1586.4560585021973,21352,5240,16112,16112,0,22,5310000.0
5310,5310999,20.712954465178353,38.130401436354404,0.09050281772576652,1890.0643887519836,408.20679688453674,1586.9534339904785,21356,5241,16115,16115,0,22,5311000.0
5311,5311999,20.711595525224443,38.12878136549863,0.09050657033634013,1890.3497834205627,408.26926827430725,1587.4699821472168,21359,5242,16117,16117,0,22,5312000.0
5312,5312999,20.710224507744528,38.12676768602939,0.09050988272054883,1890.796842098236,408.33269810676575,1587.3798637390137,21370,5245,16125,16125,0,22,5313000.0
5313,5313999,20.70903830627356,38.12488475895453,0.09051030820927186,1891.230629682541,408.39749336242676,1587.5139198303223,21372,5246,16126,16126,0,22,5314000.0
5314,5314999,20.708037956721903,38.12346529134496,0.0905046538649581,1891.583582162857,408.4655091762543,1587.81343460083,21374,5247,16127,16127,0,22,5315000.0
5315,5315999,20.707197199819074,38.12309932117937,0.09049446649797266,1891.8686499595642,408.5364580154419,1588.4345359802246,21376,5248,16128,16128,0,22,5316000.0
5316,5316999,20.706365711145608,38.12256771745119,0.09048622140618467,1892.3879742622375,408.60102343559265,1588.0660209655762,21388,5251,16137,16137,0,22,5317000.0
5317,5317999,20.705690216725664,38.1215308548187,0.0904738273077067,1892.7432169914246,408.6646547317505,1588.2957572937012,21390,5252,16138,16138,0,22,5318000.0
5318,5318999,20.704752352236866,38.11982603515817,0.09047254983719644,1893.119215965271,408.72883582115173,1588.3475379943848,21390,5252,16138,16138,0,22,5319000.0
5319,5319999,20.704022163657353,38.11829606545728,0.09046201960636735,1893.4655034542084,408.7948966026306,1588.6906623840332,21393,5253,16140,16140,0,22,5320000.0
5320,5320999,20.70372676897589,38.11761481750205,0.09044478481839491,1893.7955253124237,408.85965609550476,1588.9538612365723,21395,5254,16141,16141,0,22,5321000.0
5321,5321999,20.703274759011997,38.11659561466382,0.09043471497014033,1894.1293992996216,408.9255197048187,1589.2308311462402,21397,5255,16142,16142,0,22,5322000.0
5322,5322999,20.702555904221132,38.11483922708597,0.0904250829751021,1894.6001331806183,408.9894676208496,1588.9236640930176,21399,5256,16143,16143,0,22,5323000.0
5323,5323999,20.70183986926635,38.11330936819737,0.09041926106468112,1894.8006908893585,409.05292296409607,1589.6909446716309,21399,5256,16143,16143,0,22,5324000.0
5324,5324999,20.700856559607512,38.11170923771941,0.09041574734528479,1895.174194574356,409.118714094162,1589.9711570739746,21407,5256,16151,16151,0,22,5325000.0
5325,5325999,20.699398249931495,38.11082080286166,0.09041746520803318,1895.4268009662628,409.18185472488403,1591.0404624938965,21413,5257,16156,16156,0,22,5326000.0
5326,5326999,20.698155229824685,38.10915011236279,0.09041873123598887,1895.7395265102386,409.246541261673,1591.4542045593262,21417,5257,16160,16160,0,22,5327000.0
5327,5327999,20.69681792408668,38.10724791201279,0.09042264538834133,1896.0492959022522,409.3097405433655,1591.786220550537,21418,5257,16161,16161,0,22,5328000.0
5328,5328999,20.695614285724872,38.105438976444404,0.09042771431209062,1896.4197840690613,409.37336230278015,1591.8048057556152,21420,5257,16163,16163,0,22,5329000.0
5329,5329999,20.694404812889292,38.10368562673658,0.09042774155134536,1896.810076713562,409.4362442493439,1591.9464836120605,21423,5258,16165,16165,0,22,5330000.0
5330,5330999,20.693087460252404,38.10127386816973,0.09043519410371526,1897.2112636566162,409.5008897781372,1592.0954933166504,21425,5259,16166,16166,0,22,5331000.0
5331,5331999,20.691816778574672,38.099537450807546,0.09043524395954028,1897.6135437488556,409.56486225128174,1592.20658493042,21431,5260,16171,16171,0,22,5332000.0
5332,5332999,20.6905270563682,38.0972759231705,0.09043855812165169,1897.984201669693,409.6283736228943,1592.2469673156738,21432,5261,16171,16171,0,22,5333000.0
5333,5333999,20.689415058259755,38.0950534388492,0.09044114811616233,1898.512678861618,409.6941056251526,1591.8967628479004,21437,5264,16173,16173,0,22,5334000.0
5334,5334999,20.688511666839254,38.09339917352085,0.09043825025985164,1898.849191904068,409.76016664505005,1592.2707252502441,21437,5264,16173,16173,0,22,5335000.0
5335,5335999,20.687368407953873,38.091496482517364,0.09043925486024229,1899.3682475090027,409.8260989189148,1591.818660736084,21439,5265,16174,16174,0,22,5336000.0
5336,5336999,20.686586309939273,38.089672400749315,0.09043817991792602,1899.6748685836792,409.89419412612915,1592.379566192627,21439,5265,16174,16174,0,22,5337000.0
5337,5337999,20.685527114780935,38.0875208888119,0.09044042403512054,1899.9790935516357,409.9590473175049,1592.801959991455,21439,5265,16174,16174,0,22,5338000.0
5338,5338999,20.68485107824742,38.08632463073296,0.09043798899236821,1900.4685513973236,410.0243606567383,1592.7765312194824,21463,5267,16196,16196,0,22,5339000.0
5339,5339999,20.684040488895516,38.08460452794176,0.09043686859890632,1900.6283841133118,410.09342885017395,1594.0964393615723,21463,5267,16196,16196,0,22,5340000.0
5340,5340999,20.683469772023177,38.083277761762425,0.09043664869306389,1900.9129717350006,410.15733313560486,1594.548542022705,21463,5267,16196,16196,0,22,5341000.0
5341,5341999,20.6827989316471,38.08173848623412,0.09043725796469837,1901.4111242294312,410.22511434555054,1594.378589630127,21469,5270,16199,16199,0,22,5342000.0
5342,5342999,20.682626200918815,38.082360243255174,0.0904245882702499,1901.6774237155914,410.29229068756104,1594.9084739685059,21469,5270,16199,16199,0,22,5343000.0
5343,5343999,20.681979786386375,38.080630942381816,0.09042441184744576,1902.090898513794,410.3583858013153,1594.7777290344238,21469,5270,16199,16199,0,22,5344000.0
5344,5344999,20.68078229345823,38.07817005040492,0.0904334394138725,1902.518212556839,410.42722511291504,1594.7461585998535,21471,5271,16200,16200,0,22,5345000.0
5345,5345999,20.67982014783087,38.075968457587166,0.09043859178512004,1902.8104021549225,410.4951593875885,1595.7802543640137,21498,5271,16227,16227,0,22,5346000.0
5346,5346999,20.678079302612662,38.07388221180924,0.09044944853922776,1902.9847676753998,410.5595717430115,1597.425479888916,21509,5271,16238,16238,0,22,5347000.0
5347,5347999,20.676141149863327,38.07084478218349,0.09046317756672584,1903.1540942192078,410.6210980415344,1598.5495414733887,21512,5271,16241,16241,0,22,5348000.0
5348,5348999,20.674329194480862,38.06809496287066,0.09047701365593608,1903.5135235786438,410.68319869041443,1598.9809074401855,21517,5273,16244,16244,0,22,5349000.0
5349,5349999,20.672910368193165,38.06620437713962,0.09047948335231326,1903.694494485855,410.74602794647217,1599.9809303283691,21521,5273,16248,16248,0,22,5350000.0
5350,5350999,20.671445663071584,38.06424623567574,0.09048275429934671,1904.1028997898102,410.8087594509125,1599.9985466003418,21525,5275,16250,16250,0,22,5351000.0
5351,5351999,20.670168808338758,38.06199147255537,0.0904912679449984,1904.6767683029175,410.8720169067383,1599.6931419372559,21531,5278,16253,16253,0,22,5352000.0
5352,5352999,20.668836939280304,38.06020688792917,0.09049606110006925,1904.9756963253021,410.9360291957855,1600.3217887878418,21535,5280,16255,16255,0,22,5353000.0
5353,5353999,20.669275939088866,38.063424275063475,0.09045702055408844,1905.3507220745087,410.99950075149536,1600.5648765563965,21537,5281,16256,16256,0,22,5354000.0
5354,5354999,20.66955558970449,38.06447601446126,0.09043567856580015,1905.7314631938934,411.062114238739,1600.7646827697754,21541,5283,16258,16258,0,22,5355000.0
5355,5355999,20.670107462464063,38.06591838293956,0.09041122897383469,1906.0390493869781,411.1267867088318,1601.3058052062988,21543,5284,16259,16259,0,22,5356000.0
5356,5356999,20.671258748585306,38.068200948776465,0.09038240156639887,1906.3111772537231,411.18934631347656,1601.9755897521973,21545,5285,16260,16260,0,22,5357000.0
5357,5357999,20.6726413461655,38.070688715020275,0.09035769874125688,1906.7469770908356,411.2530541419983,1601.9245643615723,21549,5287,16262,16262,0,22,5358000.0
5358,5358999,20.674609967768745,38.074176428187336,0.09032339168810499,1907.1684050559998,411.31724429130554,1602.085048675537,21553,5289,16264,16264,0,22,5359000.0
5359,5359999,20.676726820428684,38.07794352619118,0.09028357361566997,1907.5092096328735,411.38145685195923,1602.494785308838,21555,5290,16265,16265,0,22,5360000.0
5360,5360999,20.678542244115576,38.08048503029574,0.09027092927211233,1907.9546508789062,411.4475531578064,1602.5622901916504,21559,5292,16267,16267,0,22,5361000.0
5361,5361999,20.680206317527336,38.083066837481624,0.09025239113020933,1908.4826362133026,411.51256489753723,1602.3554649353027,21565,5295,16270,16270,0,22,5362000.0
5362,5362999,20.68224435133587,38.085704117393945,0.0902369657272899,1908.801987171173,411.5776295661926,1602.8727989196777,21565,5295,16270,16270,0,22,5363000.0
5363,5363999,20.683568505903455,38.086946356171254,0.09022784406723738,1909.0784435272217,411.64391803741455,1603.4084510803223,21565,5295,16270,16270,0,22,5364000.0
5364,5364999,20.68427196761334,38.086590752851535,0.09022145438573059,1909.3639135360718,411.70767760276794,1603.8600425720215,21565,5295,16270,16270,0,22,5365000.0
5365,5365999,20.68371060454038,38.08498682152412,0.09021960672293616,1909.6824147701263,411.77624225616455,1604.823642730713,21579,5296,16283,16283,0,22,5366000.0
5366,5366999,20.68207350086865,38.08290006708454,0.0902265617981921,1909.916887998581,411.8399341106415,1605.8271980285645,21586,5297,16289,16289,0,22,5367000.0
5367,5367999,20.680612376080887,38.08064882047882,0.09022986516188247,1910.2351438999176,411.9033877849579,1606.2271537780762,21589,5298,16291,16291,0,22,5368000.0
5368,5368999,20.67929767275465,38.07863721663533,0.09023811743660204,1910.4576182365417,411.96624851226807,1606.9594612121582,21590,5298,16292,16292,0,22,5369000.0
5369,5369999,20.677986994085988,38.07697197712724,0.09023655635793226,1910.8816730976105,412.0296378135681,1607.0651054382324,21610,5301,16309,16309,0,22,5370000.0
5370,5370999,20.676704458725435,38.074773678894864,0.09023908541194292,1911.3593809604645,412.09643363952637,1607.198802947998,21616,5304,16312,16312,0,22,5371000.0
5371,5371999,20.675362789785517,38.072543370655794,0.09024466849677981,1911.5993440151215,412.16418623924255,1608.0830574035645,21618,5304,16314,16314,0,22,5372000.0
5372,5372999,20.674019700646237,38.07032447244795,0.09025029123714723,1911.9381217956543,412.22820711135864,1608.4439964294434,21619,5304,16315,16315,0,22,5373000.0
5373,5373999,20.672657408925634,38.06787717584301,0.09025692188594525,1912.1617226600647,412.2924060821533,1609.2353477478027,21619,5304,16315,16315,0,22,5374000.0
5374,5374999,20.67154135167624,38.06645369673212,0.0902555696674826,1912.6595182418823,412.3570177555084,1608.9848899841309,21631,5307,16324,16324,0,22,5375000.0
5375,5375999,20.670221854501094,38.064210550005804,0.09025755901258792,1912.9279215335846,412.42609000205994,1609.6113624572754,21633,5308,16325,16325,0,22,5376000.0
5376,5376999,20.66915116698903,38.06229635429643,0.09025822259179828,1913.1951458454132,412.4909529685974,1610.0841178894043,21633,5308,16325,16325,0,22,5377000.0
5377,5377999,20.66829228771164,38.06085436478045,0.09025378912293813,1913.5155878067017,412.55622029304504,1610.4198036193848,21633,5308,16325,16325,0,22,5378000.0
5378,5378999,20.66723805346472,38.05885069258409,0.09025228058649626,1913.8641991615295,412.63289070129395,1610.6887245178223,21633,5308,16325,16325,0,22,5379000.0
5379,5379999,20.66637895952482,38.0568945458949,0.09024795378210315,1914.1394510269165,412.698513507843,1611.17818069458,21633,5308,16325,16325,0,22,5380000.0
5380,5380999,20.665726653570633,38.05572327138476,0.09023892852910642,1914.4117391109467,412.7627069950104,1611.5656776428223,21633,5308,16325,16325,0,22,5381000.0
5381,5381999,20.66515995436925,38.05454105112015,0.09023303153195339,1914.774480342865,412.8289158344269,1611.685977935791,21633,5308,16325,16325,0,22,5382000.0
5382,5382999,20.664800092599563,38.05337867744234,0.09022606456705096,1915.1675357818604,412.8957962989807,1611.7680778503418,21636,5310,16326,16326,0,22,5383000.0
5383,5383999,20.664535118941707,38.05210422334531,0.09021781668657158,1915.598058462143,412.96091532707214,1611.5817756652832,21638,5311,16327,16327,0,22,5384000.0
5384,5384999,20.664305222380936,38.05102555481258,0.09021347860707296,1916.018387556076,413.02722549438477,1611.4835929870605,21640,5312,16328,16328,0,22,5385000.0
5385,5385999,20.663505605285412,38.04912512167419,0.09022142972995117,1916.4554691314697,413.09625697135925,1611.7351264953613,21662,5313,16349,16349,0,22,5386000.0
5386,5386999,20.662104389554063,38.04754249426123,0.09022764983840148,1916.7436473369598,413.1634509563446,1612.704303741455,21675,5314,16361,16361,0,22,5387000.0
5387,5387999,20.660564763042178,38.04574596689004,0.09023241162012319,1917.0216357707977,413.2287631034851,1613.405429840088,21679,5314,16365,16365,0,22,5388000.0
5388,5388999,20.659617266203703,38.04886929083158,0.09020928326768263,1917.285594701767,413.29262256622314,1613.9851112365723,21683,5315,16368,16368,0,22,5389000.0
5389,5389999,20.658234642265384,38.046596696107265,0.0902114853588688,1917.5507459640503,413.3575351238251,1614.5896263122559,21686,5315,16371,16371,0,22,5390000.0
5390,5390999,20.657158905106115,38.044572630512754,0.09020591773312947,1918.0045013427734,413.4270393848419,1614.688533782959,21716,5317,16399,16399,0,22,5391000.0
5391,5391999,20.65609853054497,38.042473251817476,0.09020068872727038,1918.4619140625,413.49316453933716,1614.621379852295,21720,5319,16401,16401,0,22,5392000.0
5392,5392999,20.65529154354289,38.04099615137991,0.09018556584805759,1918.8071920871735,413.5669946670532,1615.0936088562012,21722,5320,16402,16402,0,22,5393000.0
5393,5393999,20.654328562316266,38.039118021859615,0.09017844573221367,1919.1936256885529,413.63532638549805,1615.1811637878418,21725,5322,16403,16403,0,22,5394000.0
5394,5394999,20.653429745893245,38.03718013059338,0.09017160591116391,1919.616758108139,413.7018837928772,1615.2046546936035,21729,5324,16405,16405,0,22,5395000.0
5395,5395999,20.65294910464156,38.03594465992986,0.0901646073063126,1919.90363073349,413.7675745487213,1615.7628288269043,21729,5324,16405,16405,0,22,5396000.0
5396,5396999,20.652469351333792,38.03522916333784,0.09015254777697657,1920.347564458847,413.83564615249634,1615.6044807434082,21733,5326,16407,16407,0,22,5397000.0
5397,5397999,20.65229686914568,38.0342518428854,0.09014153000069969,1920.7340061664581,413.9111211299896,1615.824649810791,21734,5327,16407,16407,0,22,5398000.0
5398,5398999,20.652404719023217,38.03337123924319,0.09012642439668472,1921.1678791046143,413.97959995269775,1615.82759475708,21742,5328,16414,16414,0,22,5399000.0
5399,5399999,20.652821348777263,38.03375679094541,0.09012221746125626,1921.6032495498657,414.05444049835205,1615.7620658874512,21742,5328,16414,16414,0,22,5400000.0
5400,5400999,20.65369444813052,38.03744326733726,0.09011734162775265,1921.9015483856201,414.1222388744354,1616.2583122253418,21742,5328,16414,16414,0,22,5401000.0
5401,5401999,20.656143818674796,38.04884149198561,0.09006978485179273,1922.2840330600739,414.19945907592773,1616.5520210266113,21756,5330,16426,16426,0,22,5402000.0
5402,5402999,20.658040874927476,38.05251178839246,0.09007384527554296,1922.6552667617798,414.26878476142883,1616.7608757019043,21756,5330,16426,16426,0,22,5403000.0
5403,5403999,20.66044898253788,38.05690229229758,0.09008647271373382,1923.0336921215057,414.34063601493835,1617.0180015563965,21758,5331,16427,16427,0,22,5404000.0
5404,5404999,20.66214809437658,38.05874262423828,0.09011707256284618,1923.4751455783844,414.4137029647827,1617.0468559265137,21758,5331,16427,16427,0,22,5405000.0
5405,5405999,20.66408699570892,38.06085044928529,0.09012612101068396,1923.8188076019287,414.49020648002625,1617.463092803955,21760,5332,16428,16428,0,22,5406000.0
5406,5406999,20.66429465555606,38.061525170055305,0.09012604577774974,1924.0854992866516,414.5580599308014,1618.6565742492676,21782,5333,16449,16449,0,22,5407000.0
5407,5407999,20.662681439326207,38.065525005015424,0.09010308886168505,1924.2903263568878,414.62212467193604,1619.9720497131348,21798,5333,16465,16465,0,22,5408000.0
5408,5408999,20.661088689534523,38.064076341061764,0.09010543206586308,1924.561752796173,414.6849036216736,1620.8534049987793,21812,5334,16478,16478,0,22,5409000.0
5409,5409999,20.659561886601363,38.061794368633464,0.09010832782635625,1924.774096250534,414.7471024990082,1621.8667793273926,21817,5334,16483,16483,0,22,5410000.0
5410,5410999,20.658236261918685,38.059820779754304,0.09010667670641481,1924.952457666397,414.80937457084656,1623.100040435791,21823,5334,16489,16489,0,22,5411000.0
5411,5411999,20.656845408432964,38.057593023295276,0.09011083863670089,1925.4252705574036,414.8720266819,1623.1916007995605,21834,5338,16496,16496,0,22,5412000.0
5412,5412999,20.655280767008176,38.05498286562753,0.09011465439915545,1925.7217650413513,414.9375216960907,1624.0497856140137,21837,5339,16498,16498,0,22,5413000.0
5413,5413999,20.654018404029415,38.05342241551359,0.09011331477762718,1926.0652704238892,415.0048813819885,1624.6231575012207,21841,5341,16500,16500,0,22,5414000.0
5414,5414999,20.65288320945959,38.05176503729818,0.09010916476896857,1926.2160558700562,415.0683879852295,1625.683895111084,21842,5341,16501,16501,0,22,5415000.0
5415,5415999,20.65158013627122,38.04952268391176,0.09010959589453504,1926.7778136730194,415.1367275714874,1625.3338432312012,21848,5344,16504,16504,0,22,5416000.0
5416,5416999,20.650573795990883,38.04787676654583,0.09010495791893991,1927.0737564563751,415.20182180404663,1626.069019317627,21852,5346,16506,16506,0,22,5417000.0
5417,5417999,20.649508088246986,38.045709110978436,0.09010580119079337,1927.5970768928528,415.27537178993225,1625.789463043213,21856,5348,16508,16508,0,22,5418000.0
5418,5418999,20.648573355066716,38.04386646463701,0.09010458749304773,1927.8443989753723,415.3394949436188,1626.5664558410645,21858,5349,16509,16509,0,22,5419000.0
5419,5419999,20.64789893315459,38.04297369488988,0.09009762597915494,1928.23042678833,415.40323781967163,1626.730312347412,21861,5350,16511,16511,0,22,5420000.0
5420,5420999,20.647422362906784,38.04154326232342,0.09009194058345549,1928.5434911251068,415.4700040817261,1627.1632804870605,21863,5351,16512,16512,0,22,5421000.0
5421,5421999,20.647229261849823,38.04140280861981,0.09008474153421098,1928.8131761550903,415.53455424308777,1627.7786140441895,21872,5352,16520,16520,0,22,5422000.0
5422,5422999,20.647015531189595,38.040693239711246,0.09007896900919188,1929.252747297287,415.60348558425903,1627.671932220459,21874,5353,16521,16521,0,22,5423000.0
5423,5423999,20.64705760724364,38.040247507713126,0.09007620561825236,1929.7605488300323,415.67446875572205,1627.2259101867676,21874,5353,16521,16521,0,22,5424000.0
5424,5424999,20.647076159115965,38.03946165973608,0.0900697596656651,1930.279066324234,415.74383902549744,1627.0615730285645,21878,5355,16523,16523,0,22,5425000.0
5425,5425999,20.647437531642453,38.03917515841654,0.09007139768817563,1930.6045470237732,415.81005811691284,1627.5062980651855,21880,5356,16524,16524,0,22,5426000.0
5426,5426999,20.646999394781066,38.03772533049015,0.09006949874070691,1930.8746407032013,415.87327551841736,1628.102825164795,21882,5357,16525,16525,0,22,5427000.0
5427,5427999,20.646115515849306,38.03585205149886,0.09007204981668071,1931.1565251350403,415.9398753643036,1629.1573677062988,21899,5358,16541,16541,0,22,5428000.0
5428,5428999,20.644644256068993,38.034313863172294,0.09008076185619929,1931.4122273921967,416.00451040267944,1630.3046913146973,21915,5358,16557,16557,0,22,5429000.0
5429,5429999,20.643016003229555,38.03226592723228,0.09009495308349269,1931.6497783660889,416.0682165622711,1631.0935554504395,21917,5358,16559,16559,0,22,5430000.0
5430,5430999,20.641505900949028,38.030192683816296,0.09010535760253391,1931.9577865600586,416.1308994293213,1631.5519981384277,21920,5359,16561,16561,0,22,5431000.0
5431,5431999,20.640122221558304,38.0278803158259,0.09011133840270347,1932.2347400188446,416.1949849128723,1632.1028785705566,21920,5359,16561,16561,0,22,5432000.0
5432,5432999,20.638717769446636,38.02528138436081,0.09012096089652488,1932.628404378891,416.2651786804199,1632.3029823303223,21922,5360,16562,16562,0,22,5433000.0
5433,5433999,20.637470606564158,38.02381372301123,0.09012283713901037,1933.0413088798523,416.33528089523315,1632.5556526184082,21938,5361,16577,16577,0,22,5434000.0
5434,5434999,20.63618575240093,38.02155666741026,0.09012875283690569,1933.3395082950592,416.40039682388306,1633.4215812683105,21940,5362,16578,16578,0,22,5435000.0
5435,5435999,20.63521961620103,38.023544157779696,0.09011564206570821,1933.5724682807922,416.4662187099457,1634.2841682434082,21940,5362,16578,16578,0,22,5436000.0
5436,5436999,20.633980396331054,38.02136633276168,0.09012276179405099,1933.9513230323792,416.53158593177795,1634.5112342834473,21942,5363,16579,16579,0,22,5437000.0
5437,5437999,20.63294150286374,38.01938558231169,0.09012726540405414,1934.180305480957,416.5963740348816,1635.259593963623,21942,5363,16579,16579,0,22,5438000.0
5438,5438999,20.63169374313183,38.016937862267696,0.09013819430497183,1934.6778995990753,416.6614615917206,1634.8528785705566,21948,5366,16582,16582,0,22,5439000.0
5439,5439999,20.630655099984057,38.01476278091848,0.09014775869935421,1935.0365583896637,416.7270722389221,1635.1388359069824,21950,5367,16583,16583,0,22,5440000.0
5440,5440999,20.62962853698852,38.01265571018235,0.09015276078434808,1935.3502218723297,416.79323530197144,1635.4235038757324,21950,5367,16583,16583,0,22,5441000.0
5441,5441999,20.62850920488571,38.01032029526621,0.0901620009108447,1935.6737105846405,416.8588309288025,1635.8723793029785,21950,5367,16583,16583,0,22,5442000.0
5442,5442999,20.62726114831387,38.00781582404912,0.09017563106469517,1935.9651923179626,416.9238324165344,1636.2828102111816,21950,5367,16583,16583,0,22,5443000.0
5443,5443999,20.625987510912704,38.00534642387416,0.09019024924654628,1936.5863542556763,416.9911906719208,1635.5441780090332,21974,5369,16605,16605,0,22,5444000.0
5444,5444999,20.624824417248604,38.003600804880506,0.09019759606648159,1936.9506385326385,417.0592567920685,1636.360752105713,22001,5370,16631,16631,0,22,5445000.0
5445,5445999,20.62326253118923,38.00112860710216,0.09021062070235719,1937.2760515213013,417.1231379508972,1637.238094329834,22010,5372,16638,16638,0,22,5446000.0
5446,5446999,20.621795437433676,37.99930701826715,0.0902236457774438,1937.5255808830261,417.1866035461426,1638.3158149719238,22027,5373,16654,16654,0,22,5447000.0
5447,5447999,20.620744202059434,38.00320388342202,0.09021300817039224,1937.7477960586548,417.2537441253662,1639.3656120300293,22028,5373,16655,16655,0,22,5448000.0
5448,5448999,20.61965846142528,38.00269254932581,0.0902148611787209,1937.9647946357727,417.31667160987854,1640.1965217590332,22028,5373,16655,16655,0,22,5449000.0
5449,5449999,20.61815619146113,38.00004921666758,0.09022536892791844,1938.334790468216,417.38178515434265,1640.5037117004395,22034,5375,16659,16659,0,22,5450000.0
5450,5450999,20.616787359299938,37.99784188586343,0.09022975022427848,1938.5947525501251,417.44546723365784,1641.1833839416504,22038,5376,16662,16662,0,22,5451000.0
5451,5451999,20.61555972017635,37.9960812996468,0.09023421425209133,1939.0299770832062,417.5155773162842,1641.1110610961914,22041,5377,16664,16664,0,22,5452000.0
5452,5452999,20.614317586291627,37.99379907729496,0.09023686259850983,1939.3958265781403,417.57991647720337,1641.283676147461,22041,5377,16664,16664,0,22,5453000.0
5453,5453999,20.61312275662787,37.99190897175978,0.09023465561437505,1939.745882987976,417.64812445640564,1641.599739074707,22043,5378,16665,16665,0,22,5454000.0
5454,5454999,20.612289633274244,37.99044461213139,0.09023020465648357,1940.0576219558716,417.71254992485046,1641.9392166137695,22043,5378,16665,16665,0,22,5455000.0
5455,5455999,20.61161547372142,37.98885388144877,0.09022767788843611,1940.3986232280731,417.7774062156677,1642.2317428588867,22045,5379,16666,16666,0,22,5456000.0
5456,5456999,20.610983293686328,37.98738313270355,0.09021908351604757,1940.7438759803772,417.84186458587646,1642.475212097168,22047,5380,16667,16667,0,22,5457000.0
5457,5457999,20.61035874080345,37.98607345849788,0.09021006944929322,1940.9662091732025,417.90570187568665,1643.1102294921875,22047,5380,16667,16667,0,22,5458000.0
5458,5458999,20.610219766695664,37.986976945605285,0.09019415386767071,1941.4397003650665,417.96985840797424,1642.7989959716797,22064,5382,16682,16682,0,22,5459000.0
5459,5459999,20.609942878549816,37.987504137583734,0.09018259043517551,1941.8117880821228,418.03423595428467,1643.175552368164,22069,5384,16685,16685,0,22,5460000.0
5460,5460999,20.609807815692204,37.98722511610097,0.09017249043681075,1942.2282469272614,418.0994746685028,1643.2565612792969,22073,5386,16687,16687,0,22,5461000.0
5461,5461999,20.609782796708476,37.98654295027753,0.0901682229928763,1942.6243913173676,418.16522336006165,1643.367332458496,22076,5388,16688,16688,0,22,5462000.0
5462,5462999,20.609462216367305,37.9853641712215,0.09016014045921195,1942.9896221160889,418.23100066185,1643.7363052368164,22083,5389,16694,16694,0,22,5463000.0
5463,5463999,20.60899446249956,37.984046190312284,0.09015817211192967,1943.2918174266815,418.29539608955383,1644.182876586914,22083,5389,16694,16694,0,22,5464000.0
5464,5464999,20.608606391455886,37.985340674595946,0.09014820999741568,1943.5615856647491,418.3610112667084,1645.2527770996094,22097,5390,16707,16707,0,22,5465000.0
5465,5465999,20.607685431878902,37.98392300272469,0.09011651073439819,1943.8354985713959,418.42387986183167,1646.0399169921875,22102,5390,16712,16712,0,22,5466000.0
5466,5466999,20.60653269723762,37.98209693687864,0.09010701993748549,1944.0735342502594,418.48636174201965,1646.8061904907227,22107,5390,16717,16717,0,22,5467000.0
5467,5467999,20.605469522541462,37.980857270585666,0.09010335790735313,1944.399092912674,418.54964661598206,1647.2131271362305,22112,5390,16722,16722,0,22,5468000.0
5468,5468999,20.604091452913025,37.97836767419229,0.09010771383227645,1944.8270175457,418.6131639480591,1647.2342071533203,22121,5392,16729,16729,0,22,5469000.0
5469,5469999,20.60298118279127,37.97648151262691,0.09010134333160025,1945.2687935829163,418.6777181625366,1647.9316864013672,22148,5396,16752,16752,0,22,5470000.0
5470,5470999,20.601934343270113,37.974715755748605,0.0900949439012807,1945.493844985962,418.7429413795471,1649.0348815917969,22150,5396,16754,16754,0,22,5471000.0
5471,5471999,20.600866848117874,37.972696010332406,0.09008876717693848,1945.7233624458313,418.8060975074768,1649.8011856079102,22153,5396,16757,16757,0,22,5472000.0
5472,5472999,20.599794659921667,37.97075447976639,0.09008495929293625,1946.0059723854065,418.8720135688782,1650.338623046875,22154,5396,16758,16758,0,22,5473000.0
5473,5473999,20.59887920087134,37.969130762352215,0.0900813439942747,1946.3582503795624,418.93747448921204,1650.5432357788086,22156,5397,16759,16759,0,22,5474000.0
5474,5474999,20.59778544292774,37.9669674093548,0.09007670461873318,1946.7946257591248,419.0018379688263,1650.370849609375,22156,5397,16759,16759,0,22,5475000.0
5475,5475999,20.59717698851435,37.96532489472358,0.0900680440078071,1947.1816656589508,419.0682327747345,1650.5064086914062,22156,5397,16759,16759,0,22,5476000.0
5476,5476999,20.596207595831526,37.963365430603304,0.09006907883076021,1947.3783948421478,419.13126397132874,1651.3023986816406,22156,5397,16759,16759,0,22,5477000.0
5477,5477999,20.59538279741134,37.9624362986701,0.09006534408399625,1947.8228719234467,419.19722509384155,1651.0005187988281,22156,5397,16759,16759,0,22,5478000.0
5478,5478999,20.594627161629884,37.960556135178194,0.09006431529064818,1948.1830651760101,419.26250648498535,1651.0073776245117,22156,5397,16759,16759,0,22,5479000.0
5479,5479999,20.593733884104534,37.95885213374343,0.0900625717429756,1948.5035653114319,419.3274302482605,1651.3065872192383,22156,5397,16759,16759,0,22,5480000.0
5480,5480999,20.592967963624233,37.957066985517095,0.09006120927192529,1948.739370584488,419.39207553863525,1651.8834838867188,22156,5397,16759,16759,0,22,5481000.0
5481,5481999,20.59204885541927,37.95499795202774,0.09006412719375301,1949.2389917373657,419.4606373310089,1651.4570999145508,22158,5398,16760,16760,0,22,5482000.0
5482,5482999,20.591272568401344,37.953257259773586,0.09006343150578255,1949.708823442459,419.52492094039917,1651.1161880493164,22161,5399,16762,16762,0,22,5483000.0
5483,5483999,20.59010825003241,37.9509430868985,0.09006892944967082,1949.9532759189606,419.58974289894104,1651.6333236694336,22161,5399,16762,16762,0,22,5484000.0
5484,5484999,20.588787236425357,37.94838788123085,0.09007594252632722,1950.4579458236694,419.6580100059509,1651.2402572631836,22163,5400,16763,16763,0,22,5485000.0
5485,5485999,20.58809568826358,37.94666280543311,0.09007978954848739,1950.7769889831543,419.7236957550049,1652.3401412963867,22174,5400,16774,16774,0,22,5486000.0
5486,5486999,20.5869316399716,37.94422651173839,0.09007969087332268,1950.9164791107178,419.78604555130005,1653.9722518920898,22181,5400,16781,16781,0,22,5487000.0
5487,5487999,20.58601630611091,37.944815768223684,0.09006680717172377,1951.1797511577606,419.8477852344513,1654.56689453125,22182,5400,16782,16782,0,22,5488000.0
5488,5488999,20.58494206656339,37.942573620820035,0.09007233088201905,1951.369436264038,419.9128441810608,1655.5891799926758,22185,5400,16785,16785,0,22,5489000.0
5489,5489999,20.584188617639033,37.94100059126829,0.09006879645059351,1951.8076775074005,419.9754960536957,1655.5774230957031,22193,5403,16790,16790,0,22,5490000.0
5490,5490999,20.583757177790456,37.94018169337256,0.09006015808336276,1952.2908301353455,420.04019570350647,1655.364128112793,22193,5403,16790,16790,0,22,5491000.0
5491,5491999,20.582919859609596,37.938111617612556,0.09006043983678225,1952.5257120132446,420.10735154151917,1656.277473449707,22193,5403,16790,16790,0,22,5492000.0
5492,5492999,20.58237175592441,37.93676941764437,0.09005723975715074,1952.7138648033142,420.16946291923523,1657.1347198486328,22194,5403,16791,16791,0,22,5493000.0
5493,5493999,20.581733808007126,37.935030391420305,0.09005686315701644,1953.126662492752,420.2347192764282,1656.9226531982422,22194,5403,16791,16791,0,22,5494000.0
5494,5494999,20.581290205105145,37.933428256781006,0.09005638050078324,1953.4302237033844,420.2962906360626,1657.2980041503906,22196,5404,16792,16792,0,22,5495000.0
5495,5495999,20.58088027839915,37.932106920790446,0.09005445504512544,1954.228783607483,420.36787271499634,1655.8925476074219,22204,5408,16796,16796,0,22,5496000.0
5496,5496999,20.58071276018338,37.93118514061768,0.09005195069716188,1954.528434753418,420.4295847415924,1656.5060272216797,22213,5409,16804,16804,0,22,5497000.0
5497,5497999,20.580298010901313,37.92990780223283,0.09005151735499028,1954.897688627243,420.4962525367737,1656.8004684448242,22215,5410,16805,16805,0,22,5498000.0
5498,5498999,20.57987952754851,37.92858821564634,0.09005132667373061,1955.198524236679,420.5637650489807,1657.2508239746094,22215,5410,16805,16805,0,22,5499000.0
5499,5499999,20.579806741748317,37.93043664105461,0.09003984862459191,1955.4628205299377,420.6342759132385,1657.8029022216797,22215,5410,16805,16805,0,22,5500000.0
5500,5500999,20.57963273701046,37.93651202839674,0.09002022166394774,1955.9151101112366,420.6983335018158,1657.4571075439453,22215,5410,16805,16805,0,22,5501000.0
5501,5501999,20.57918459614181,37.93519363300902,0.09001949841116097,1956.3603880405426,420.7609474658966,1657.188720703125,22215,5410,16805,16805,0,22,5502000.0
5502,5502999,20.578881572779412,37.93373390975223,0.09001502328411803,1956.7167477607727,420.82640528678894,1657.2412414550781,22215,5410,16805,16805,0,22,5503000.0
5503,5503999,20.5782779613204,37.93193931978119,0.09000963706549447,1957.1479904651642,420.8890347480774,1657.176139831543,22217,5411,16806,16806,0,22,5504000.0
5504,5504999,20.577562395074864,37.92975340722506,0.09001178330834847,1957.3438227176666,420.9550256729126,1657.9703369140625,22217,5411,16806,16806,0,22,5505000.0
5505,5505999,20.57681575636721,37.92772481402835,0.09001350114121609,1957.704468011856,421.0216500759125,1658.5288848876953,22225,5411,16814,16814,0,22,5506000.0
5506,5506999,20.575627247383466,37.92587907396832,0.09000761820694292,1957.962986946106,421.08482933044434,1659.3848190307617,22228,5411,16817,16817,0,22,5507000.0
5507,5507999,20.57435677914851,37.92423573417621,0.090004130496536,1958.1962230205536,421.1470241546631,1660.1386184692383,22229,5411,16818,16818,0,22,5508000.0
5508,5508999,20.573143764757898,37.92221575782333,0.09000858474990647,1958.5069591999054,421.2103807926178,1660.5004501342773,22230,5411,16819,16819,0,22,5509000.0
5509,5509999,20.571834015023104,37.92003176266599,0.09001620734040905,1958.8604354858398,421.2730379104614,1660.5503311157227,22232,5411,16821,16821,0,22,5510000.0
5510,5510999,20.570388820487178,37.917442394534596,0.0900217097712227,1959.3778021335602,421.3362739086151,1660.080322265625,22236,5413,16823,16823,0,22,5511000.0
5511,5511999,20.568988858337814,37.91489283160312,0.09002722826907406,1959.7255327701569,421.40144324302673,1660.4115753173828,22238,5414,16824,16824,0,22,5512000.0
5512,5512999,20.567666790696045,37.912798962974954,0.09003041790438104,1960.1194169521332,421.4648594856262,1660.517936706543,22247,5415,16832,16832,0,22,5513000.0
5513,5513999,20.56619316821199,37.9102546349553,0.09003640209733388,1960.4317061901093,421.5278606414795,1660.8898468017578,22248,5416,16832,16832,0,22,5514000.0
5514,5514999,20.564792912908583,37.90763205309889,0.0900464611233035,1960.8950316905975,421.5926012992859,1660.6986236572266,22251,5418,16833,16833,0,22,5515000.0
5515,5515999,20.564189393554347,37.921981695775294,0.08997478323815022,1961.3032290935516,421.6595928668976,1660.9019470214844,22260,5419,16841,16841,0,22,5516000.0
5516,5516999,20.563008509165552,37.91964321102315,0.08998067961274692,1961.6378145217896,421.7247438430786,1661.0626525878906,22260,5419,16841,16841,0,22,5517000.0
5517,5517999,20.56197163416857,37.91752055442468,0.08998538855701,1962.0477344989777,421.79044342041016,1661.0811386108398,22262,5420,16842,16842,0,22,5518000.0
5518,5518999,20.560713704652603,37.91531336558326,0.08998836133147226,1962.3766033649445,421.8548641204834,1661.2758560180664,22262,5420,16842,16842,0,22,5519000.0
5519,5519999,20.559817178659774,37.91497154823797,0.08998131776524632,1962.702434539795,421.9200837612152,1661.5365295410156,22262,5420,16842,16842,0,22,5520000.0
5520,5520999,20.559048781931438,37.91364851948642,0.08998134567245597,1963.068425655365,421.9840590953827,1661.5325164794922,22262,5420,16842,16842,0,22,5521000.0
5521,5521999,20.558304264121404,37.912478311899086,0.08998417065561304,1963.3385920524597,422.04971075057983,1662.289566040039,22278,5421,16857,16857,0,22,5522000.0
5522,5522999,20.557471747033773,37.91072782918109,0.08998796557193789,1963.8226175308228,422.1139533519745,1662.3172988891602,22282,5423,16859,16859,0,22,5523000.0
5523,5523999,20.556795391453175,37.90923995906927,0.0899887297031674,1972.2722177505493,422.18019819259644,1662.687156677246,22284,5424,16860,16860,0,22,5524000.0
5524,5524999,20.555932856344327,37.90748849532825,0.08999162989918774,1972.5862212181091,422.244651556015,1663.015495300293,22285,5425,16860,16860,0,22,5525000.0
5525,5525999,20.554878774750946,37.905259627135365,0.08999701606432164,1973.0194156169891,422.30945014953613,1662.9468154907227,22287,5426,16861,16861,0,22,5526000.0
5526,5526999,20.55443762667464,37.90409502426488,0.08996443063767179,1973.2286086082458,422.38409399986267,1664.438591003418,22299,5426,16873,16873,0,22,5527000.0
5527,5527999,20.55410268193704,37.903205575076896,0.08990586276427182,1973.515697002411,422.451135635376,1665.3674240112305,22312,5426,16886,16886,0,22,5528000.0
5528,5528999,20.553325854635318,37.90177157353573,0.08988951257890032,1973.7884895801544,422.51551246643066,1666.1042251586914,22316,5426,16890,16890,0,22,5529000.0
5529,5529999,20.55289820711599,37.90031534583357,0.0898682257743566,1974.0309615135193,422.5787923336029,1666.865463256836,22318,5426,16892,16892,0,22,5530000.0
5530,5530999,20.552288812505246,37.90046509859311,0.08984615250299077,1974.4602267742157,422.6428768634796,1666.800682067871,22335,5427,16908,16908,0,22,5531000.0
5531,5531999,20.55139123142474,37.89852237939019,0.08984209989682623,1974.7353472709656,422.7078478336334,1667.830795288086,22336,5427,16909,16909,0,22,5532000.0
5532,5532999,20.550552820120615,37.89649831139917,0.0898330537042864,1974.9264171123505,422.7739613056183,1668.907485961914,22337,5427,16910,16910,0,22,5533000.0
5533,5533999,20.54964175978883,37.89463588132245,0.08983222844619121,1975.2483599185944,422.8402292728424,1669.1890258789062,22337,5427,16910,16910,0,22,5534000.0
5534,5534999,20.54875288207291,37.89255568386616,0.08982580949965535,1975.4902460575104,422.9055333137512,1669.794662475586,22337,5427,16910,16910,0,22,5535000.0
5535,5535999,20.54815596158055,37.89085303284821,0.08981915171841615,1975.8816816806793,422.97216176986694,1669.8546524047852,22339,5428,16911,16911,0,22,5536000.0
5536,5536999,20.547667429359493,37.88935725175019,0.08980755499529358,1976.3570737838745,423.03725934028625,1669.5019454956055,22339,5428,16911,16911,0,22,5537000.0
5537,5537999,20.546895134896182,37.88747335133661,0.08980504805623002,1976.6207036972046,423.1033310890198,1670.0825805664062,22339,5428,16911,16911,0,22,5538000.0
5538,5538999,20.54635251009962,37.88602310786412,0.08979831800470861,1976.9040055274963,423.17036175727844,1670.4145736694336,22339,5428,16911,16911,0,22,5539000.0
5539,5539999,20.54566547410771,37.88459337746641,0.08979488878694697,1977.2638719081879,423.23546290397644,1670.5102767944336,22339,5428,16911,16911,0,22,5540000.0
5540,5540999,20.545233668085146,37.88361883335436,0.08978775482221057,1977.6451501846313,423.3011360168457,1670.623031616211,22348,5429,16919,16919,0,22,5541000.0
5541,5541999,20.544676231155332,37.88211756720007,0.08978368129343772,1977.9661526679993,423.36873149871826,1670.758529663086,22348,5429,16919,16919,0,22,5542000.0
5542,5542999,20.544235336675797,37.880594359456964,0.08978000477483206,1978.4826850891113,423.4357964992523,1670.2100067138672,22348,5429,16919,16919,0,22,5543000.0
5543,5543999,20.54399065403724,37.87930393538237,0.08977904049338292,1978.7274141311646,423.5017960071564,1670.8740844726562,22348,5429,16919,16919,0,22,5544000.0
5544,5544999,20.543555210361045,37.877973831249385,0.08977363700646768,1979.0043365955353,423.56690764427185,1671.2819519042969,22348,5429,16919,16919,0,22,5545000.0
5545,5545999,20.543038948463163,37.876425399249925,0.08976631398266555,1979.3318874835968,423.6324620246887,1671.4201736450195,22348,5429,16919,16919,0,22,5546000.0
5546,5546999,20.542331782117053,37.87466343951883,0.08976092897377697,1979.6152527332306,423.69966340065,1671.7490921020508,22348,5429,16919,16919,0,22,5547000.0
5547,5547999,20.54162501053873,37.87278666424032,0.08975491170697814,1980.1057405471802,423.76397371292114,1671.8387985229492,22356,5430,16926,16926,0,22,5548000.0
5548,5548999,20.540839640417477,37.872132408218164,0.08973077320497735,1980.3888778686523,423.8275384902954,1672.761360168457,22362,5430,16932,16932,0,22,5549000.0
5549,5549999,20.54022470502488,37.870508884655756,0.08970432184135413,1980.6738047599792,423.891489982605,1673.5803298950195,22367,5430,16937,16937,0,22,5550000.0
5550,5550999,20.53982665257269,37.868787135224835,0.08968092500399072,1980.9057774543762,423.9530837535858,1674.6105651855469,22370,5430,16940,16940,0,22,5551000.0
5551,5551999,20.539890784960598,37.86755107872043,0.08964164819371867,1981.104425907135,424.0156099796295,1675.7638854980469,22371,5430,16941,16941,0,22,5552000.0
5552,5552999,20.539807273232885,37.86601507544664,0.08960515174578243,1981.4601097106934,424.07945704460144,1676.0648956298828,22372,5430,16942,16942,0,22,5553000.0
5553,5553999,20.540143922869984,37.86488217544349,0.08955773033475123,1981.746039390564,424.1428954601288,1676.6858367919922,22372,5430,16942,16942,0,22,5554000.0
5554,5554999,20.54010949252242,37.86353047339865,0.08952868635045697,1982.070806503296,424.20696568489075,1677.1574401855469,22374,5431,16943,16943,0,22,5555000.0
5555,5555999,20.540063940215955,37.86195241473351,0.08950165122970388,1982.3007788658142,424.27030849456787,1677.8311080932617,22375,5431,16944,16944,0,22,5556000.0
5556,5556999,20.540102074026123,37.86063578778025,0.08948224027209695,1982.6759271621704,424.3339960575104,1677.9142379760742,22375,5431,16944,16944,0,22,5557000.0
5557,5557999,20.540039051807202,37.85949758233726,0.08947355867026496,1983.1091556549072,424.39992022514343,1677.8883361816406,22379,5433,16946,16946,0,22,5558000.0
5558,5558999,20.54037114919642,37.85967575184986,0.08946072141166461,1983.437876701355,424.462952375412,1678.1739883422852,22379,5433,16946,16946,0,22,5559000.0
5559,5559999,20.54053538997523,37.85861821317059,0.08945328633419258,1983.8483567237854,424.52811574935913,1678.0749130249023,22379,5433,16946,16946,0,22,5560000.0
5560,5560999,20.540583957690156,37.857647871966456,0.08944774694529012,1984.1439845561981,424.5910313129425,1678.4919509887695,22379,5433,16946,16946,0,22,5561000.0
5561,5561999,20.541050035923437,37.857767306662446,0.08943371381702891,1984.4665894508362,424.6567554473877,1678.8519592285156,22379,5433,16946,16946,0,22,5562000.0
5562,5562999,20.541854594683613,37.85831033414083,0.0894265780075838,1984.6626677513123,424.71995282173157,1679.584701538086,22379,5433,16946,16946,0,22,5563000.0
5563,5563999,20.54243569084273,37.857994343266284,0.0894169698453744,1985.1142582893372,424.78503608703613,1679.196144104004,22379,5433,16946,16946,0,22,5564000.0
5564,5564999,20.543332020319273,37.85829012175267,0.08940324837509195,1985.523756980896,424.84817814826965,1679.2405242919922,22381,5434,16947,16947,0,22,5565000.0
5565,5565999,20.543811294584014,37.85769037039016,0.0894005633701922,1985.9679226875305,424.91211438179016,1679.1987838745117,22385,5436,16949,16949,0,22,5566000.0
5566,5566999,20.54427599864899,37.85699310304992,0.08939458858477534,1986.3352241516113,424.97538471221924,1679.3280487060547,22387,5437,16950,16950,0,22,5567000.0
5567,5567999,20.544512674761954,37.85579083609112,0.08939043477367847,1986.6897308826447,425.03949522972107,1679.5394287109375,22387,5437,16950,16950,0,22,5568000.0
5568,5568999,20.543937889733527,37.8540517030599,0.08938940437219034,1986.9510684013367,425.10191583633423,1680.7185897827148,22396,5437,16959,16959,0,22,5569000.0
5569,5569999,20.54307158177521,37.852530082173146,0.08938720081986606,1987.1854877471924,425.16499495506287,1681.826156616211,22406,5437,16969,16969,0,22,5570000.0
5570,5570999,20.542067092884285,37.850525855902795,0.08939121733148692,1987.518074274063,425.22906589508057,1682.3445281982422,22410,5437,16973,16973,0,22,5571000.0
5571,5571999,20.54143402516083,37.84913697213571,0.08938810114892026,1987.8616166114807,425.3010847568512,1682.8560791015625,22413,5438,16975,16975,0,22,5572000.0
5572,5572999,20.54063724440844,37.84743556865921,0.08938695335184699,1988.1660120487213,425.3667709827423,1683.3913345336914,22413,5438,16975,16975,0,22,5573000.0
5573,5573999,20.539758458684343,37.845778555111764,0.08938489531435667,1988.5688209533691,425.4301254749298,1683.4379959106445,22415,5439,16976,16976,0,22,5574000.0
5574,5574999,20.538798384677587,37.84395253704825,0.08938219269598824,1988.9112739562988,425.49402594566345,1683.8048706054688,22415,5439,16976,16976,0,22,5575000.0
5575,5575999,20.537907092866288,37.84204453160827,0.08938065082080382,1989.3702960014343,425.5632824897766,1683.7321472167969,22418,5441,16977,16977,0,22,5576000.0
5576,5576999,20.536953379358053,37.83992752717488,0.08938356199497255,1989.7364342212677,425.62768959999084,1684.0662841796875,22427,5442,16985,16985,0,22,5577000.0
5577,5577999,20.536051559746195,37.83810661172745,0.08938119395073352,1990.1902494430542,425.6943335533142,1683.8271179199219,22428,5443,16985,16985,0,22,5578000.0
5578,5578999,20.535463582644585,37.83857460554615,0.08936978031991383,1990.4769678115845,425.7596344947815,1684.3415756225586,22428,5443,16985,16985,0,22,5579000.0
5579,5579999,20.534413045720093,37.83624288033495,0.0893745554644747,1991.024482011795,425.8260169029236,1683.6786651611328,22428,5443,16985,16985,0,22,5580000.0
5580,5580999,20.53360363248267,37.834456477020815,0.08937672759844606,1991.3557314872742,425.8999843597412,1684.1301727294922,22428,5443,16985,16985,0,22,5581000.0
5581,5581999,20.532792008667027,37.832275890451434,0.08938509343187673,1991.7241084575653,425.965660572052,1684.2338562011719,22429,5444,16985,16985,0,22,5582000.0
5582,5582999,20.5322387852202,37.83104559965006,0.08939041486534849,1992.1136395931244,426.03118777275085,1684.2541580200195,22429,5444,16985,16985,0,22,5583000.0
5583,5583999,20.53123266199069,37.82871558208347,0.08940443443103208,1992.4072971343994,426.09665966033936,1684.7169799804688,22429,5444,16985,16985,0,22,5584000.0
5584,5584999,20.53013171961039,37.82638456703512,0.08941625552102106,1992.8479013442993,426.1625020503998,1684.636489868164,22432,5446,16986,16986,0,22,5585000.0
5585,5585999,20.52998654533932,37.82538862182641,0.08940030980532399,1993.2600462436676,426.22653102874756,1685.100845336914,22440,5447,16993,16993,0,22,5586000.0
5586,5586999,20.530095968211015,37.82480291854203,0.08938253825940623,1993.5224258899689,426.28916931152344,1685.9922409057617,22442,5447,16995,16995,0,22,5587000.0
5587,5587999,20.529901712170947,37.82327821239415,0.08937600503934984,1993.7976822853088,426.3508641719818,1686.6802062988281,22446,5447,16999,16999,0,22,5588000.0
5588,5588999,20.529488028460968,37.82149589221908,0.08937431956766462,1994.083420753479,426.4154679775238,1687.1310577392578,22447,5447,17000,17000,0,22,5589000.0
5589,5589999,20.528957213067315,37.820003406287654,0.08937574842381579,1994.489389181137,426.4815125465393,1687.2236709594727,22450,5449,17001,17001,0,22,5590000.0
5590,5590999,20.527843321936107,37.81831516313114,0.08937757917209344,1994.823790550232,426.54944825172424,1687.5360260009766,22450,5449,17001,17001,0,22,5591000.0
5591,5591999,20.526782736524787,37.81626985084765,0.08938241022120019,1995.153567790985,426.6165723800659,1687.818832397461,22450,5449,17001,17001,0,22,5592000.0
5592,5592999,20.52573122288113,37.81427093853219,0.0893830007191927,1995.5330085754395,426.6827518939972,1687.8670043945312,22450,5449,17001,17001,0,22,5593000.0
5593,5593999,20.52480356554859,37.812359471888946,0.08938244881830981,1995.9706633090973,426.74971103668213,1687.724998474121,22450,5449,17001,17001,0,22,5594000.0
5594,5594999,20.524159645517056,37.81144864492688,0.08937410235684118,1996.2948319911957,426.8157820701599,1688.0956802368164,22452,5450,17002,17002,0,22,5595000.0
5595,5595999,20.523449238451573,37.80966732634945,0.08936943497378091,1996.9527568817139,426.88212513923645,1686.998306274414,22455,5452,17003,17003,0,22,5596000.0
5596,5596999,20.52276561544002,37.808388637854506,0.08936148002901068,1997.3368847370148,426.9499213695526,1687.0806121826172,22455,5452,17003,17003,0,22,5597000.0
5597,5597999,20.522292118924533,37.80742246901324,0.08934991560734085,1997.7084262371063,427.0163457393646,1687.2437744140625,22456,5453,17003,17003,0,22,5598000.0
5598,5598999,20.52192314926625,37.806109615697146,0.08933835446425054,1998.0404069423676,427.08266496658325,1687.5393981933594,22456,5453,17003,17003,0,22,5599000.0
5599,5599999,20.521375198884627,37.80492640771492,0.0893288210205676,1998.4063091278076,427.1492087841034,1687.6547622680664,22457,5454,17003,17003,0,22,5600000.0
5600,5600999,20.521067478092537,37.80368698655699,0.08931671339795566,1998.7306485176086,427.2175991535187,1687.9491271972656,22457,5454,17003,17003,0,22,5601000.0
5601,5601999,20.52109784477563,37.80424551744077,0.08929698900406269,1999.1662292480469,427.2864809036255,1687.8240203857422,22457,5454,17003,17003,0,22,5602000.0
5602,5602999,20.520734919697222,37.8027612551823,0.08928646598187129,1999.6139152050018,427.3570945262909,1687.7061233520508,22458,5455,17003,17003,0,22,5603000.0
5603,5603999,20.52038818178299,37.801323207045506,0.08927617169652269,1999.8907051086426,427.4263322353363,1688.1541290283203,22458,5455,17003,17003,0,22,5604000.0
5604,5604999,20.52010395677761,37.80010271295371,0.08926362452496972,2000.270993232727,427.4947409629822,1688.245506286621,22458,5455,17003,17003,0,22,5605000.0
5605,5605999,20.51924299407954,37.799924702338316,0.08925205131799074,2000.572592496872,427.5645160675049,1689.0980529785156,22460,5455,17005,17005,0,22,5606000.0
5606,5606999,20.51819781667954,37.798406610697235,0.08924635207865872,2000.917833328247,427.6338541507721,1689.6124725341797,22465,5456,17009,17009,0,22,5607000.0
5607,5607999,20.51740786244207,37.796985998987616,0.08924366161573827,2001.3053205013275,427.7046341896057,1689.7247619628906,22466,5456,17010,17010,0,22,5608000.0
5608,5608999,20.51657716591733,37.79521231646169,0.08924318618682747,2001.670585155487,427.77683901786804,1689.9655456542969,22468,5456,17012,17012,0,22,5609000.0
5609,5609999,20.515925399658904,37.793640916300774,0.08923790078624749,2002.106350660324,427.8481652736664,1689.9194793701172,22470,5457,17013,17013,0,22,5610000.0
5610,5610999,20.515439362203875,37.79230935955613,0.08922985561388619,2002.5310616493225,427.91900062561035,1690.0091094970703,22472,5458,17014,17014,0,22,5611000.0
5611,5611999,20.514927050149144,37.790849363590866,0.08922206609438144,2002.8854966163635,427.9906258583069,1690.3215103149414,22472,5458,17014,17014,0,22,5612000.0
5612,5612999,20.51456987267128,37.7897049183508,0.08921498865612443,2003.2580409049988,428.0618920326233,1690.5474090576172,22472,5458,17014,17014,0,22,5613000.0
5613,5613999,20.514405688232657,37.78896785537376,0.08920415511892466,2003.825233221054,428.1350085735321,1689.88671875,22475,5460,17015,17015,0,22,5614000.0
5614,5614999,20.51443238194155,37.78815501896772,0.08919567668176231,2004.1858072280884,428.2077739238739,1690.2190704345703,22475,5460,17015,17015,0,22,5615000.0
5615,5615999,20.51430241593368,37.78704402401979,0.08918719946086595,2004.6622886657715,428.2814109325409,1689.9462051391602,22476,5461,17015,17015,0,22,5616000.0
5616,5616999,20.51431154930748,37.786836864121035,0.08917608799061627,2005.0536699295044,428.3564991950989,1690.176155090332,22476,5461,17015,17015,0,22,5617000.0
5617,5617999,20.51446048014324,37.78841914716628,0.08915417629931777,2005.3774981498718,428.43153285980225,1690.5922775268555,22476,5461,17015,17015,0,22,5618000.0
5618,5618999,20.51508605928266,37.78967273060524,0.08913708097043715,2005.9051623344421,428.5075373649597,1690.3906021118164,22478,5462,17016,17016,0,22,5619000.0
5619,5619999,20.515526754738527,37.78949269266138,0.08912435007910624,2006.2521123886108,428.58025312423706,1690.6382598876953,22479,5463,17016,17016,0,22,5620000.0
5620,5620999,20.516300580011986,37.78917686888713,0.08911321325231325,2006.6967182159424,428.6558361053467,1690.6008071899414,22479,5463,17016,17016,0,22,5621000.0
5621,5621999,20.517207768382256,37.789467013234635,0.08909957062571039,2007.076917886734,428.73121428489685,1690.7930908203125,22479,5463,17016,17016,0,22,5622000.0
5622,5622999,20.518147109287018,37.78966169358284,0.08908709562487327,2007.529343366623,428.80789947509766,1691.2211380004883,22544,5465,17079,17079,0,22,5623000.0
5623,5623999,20.51881792516133,37.7893447356884,0.08907687182759372,2007.8927915096283,428.8830785751343,1691.7564239501953,22544,5465,17079,17079,0,22,5624000.0
5624,5624999,20.51958683640646,37.78896010991906,0.08906534054614657,2008.2602801322937,428.9603476524353,1692.233543395996,22544,5465,17079,17079,0,22,5625000.0
5625,5625999,20.51949374477015,37.78727698994441,0.08905250845642454,2008.571375131607,429.0343382358551,1692.735939025879,22544,5465,17079,17079,0,22,5626000.0
5626,5626999,20.518713137230385,37.78662611083011,0.08903302744875818,2008.9499871730804,429.1012992858887,1693.634422302246,22554,5466,17088,17088,0,22,5627000.0
5627,5627999,20.51749171626681,37.784404671698155,0.08902761862059927,2009.2422604560852,429.16726779937744,1694.4064559936523,22560,5466,17094,17094,0,22,5628000.0
5628,5628999,20.516380880590944,37.78293781124831,0.08902722347749537,2009.5317573547363,429.2329833507538,1695.5342330932617,22626,5467,17159,17159,0,22,5629000.0
5629,5629999,20.515199785858375,37.78063199738037,0.08903166767166537,2009.9407901763916,429.30115580558777,1695.8509140014648,22630,5468,17162,17162,0,22,5630000.0
5630,5630999,20.514038116621787,37.77899541372306,0.0890294834851646,2010.2551128864288,429.36885714530945,1696.5626678466797,22631,5468,17163,17163,0,22,5631000.0
5631,5631999,20.5129374036281,37.776829488673826,0.08903011753429912,2010.7172849178314,429.4350538253784,1696.6225509643555,22635,5470,17165,17165,0,22,5632000.0
5632,5632999,20.511590843515425,37.774318822236054,0.08903377018673131,2011.062907218933,429.5041742324829,1697.242172241211,22635,5470,17165,17165,0,22,5633000.0
5633,5633999,20.510331674573695,37.77183877613879,0.08903762953057448,2011.3221719264984,429.5703947544098,1697.9522323608398,22635,5470,17165,17165,0,22,5634000.0
5634,5634999,20.509388489438596,37.770036527638375,0.08903781550112366,2011.6946833133698,429.64422035217285,1698.201644897461,22635,5470,17165,17165,0,22,5635000.0
5635,5635999,20.50907329640307,37.76951347289137,0.08902869434296201,2012.0699648857117,429.71349120140076,1698.4197845458984,22635,5470,17165,17165,0,22,5636000.0
5636,5636999,20.509285049270893,37.770607778919405,0.08901349914910872,2012.4521610736847,429.7810549736023,1698.6650085449219,22635,5470,17165,17165,0,22,5637000.0
5637,5637999,20.50953583604025,37.77121151018357,0.08900088814945262,2012.8279626369476,429.84719729423523,1699.0274353027344,22637,5471,17166,17166,0,22,5638000.0
5638,5638999,20.510610020371864,37.77619305984673,0.08896792217584149,2013.0857405662537,429.91414523124695,1699.7049255371094,22637,5471,17166,17166,0,22,5639000.0
5639,5639999,20.512564605855406,37.78352696999617,0.08891963005937997,2013.480322599411,429.9820659160614,1699.6966705322266,22637,5471,17166,17166,0,22,5640000.0
5640,5640999,20.514517028352472,37.79077369845145,0.08888459429813611,2013.8717095851898,430.0483407974243,1699.822151184082,22637,5471,17166,17166,0,22,5641000.0
5641,5641999,20.516358588399097,37.79621470571416,0.0888578666991271,2014.2187116146088,430.1145775318146,1700.1904830932617,22637,5471,17166,17166,0,22,5642000.0
5642,5642999,20.51949503827701,37.80649058328605,0.088811397808085,2014.5837969779968,430.18014311790466,1700.5371551513672,22639,5472,17167,17167,0,22,5643000.0
5643,5643999,20.52182369778189,37.813772964760744,0.08877909788410332,2014.892935037613,430.24775218963623,1701.023422241211,22639,5472,17167,17167,0,22,5644000.0
5644,5644999,20.523946299874662,37.818897525242704,0.08876340810365801,2015.4088218212128,430.3141713142395,1700.6930236816406,22641,5473,17168,17168,0,22,5645000.0
5645,5645999,20.525074233512687,37.821293457582485,0.08874640800669209,2015.9068121910095,430.38052344322205,1700.5182418823242,22641,5473,17168,17168,0,22,5646000.0
5646,5646999,20.524386802504583,37.82106734392973,0.08875283070075801,2016.328525543213,430.45013904571533,1701.0651626586914,22648,5473,17175,17175,0,22,5647000.0
5647,5647999,20.52310091098705,37.82000230724524,0.08875245752787264,2016.6471049785614,430.5190737247467,1701.6906967163086,22653,5474,17179,17179,0,22,5648000.0
5648,5648999,20.5217683371202,37.81835949343711,0.08875882661159096,2016.8941991329193,430.5875759124756,1702.4806365966797,22655,5474,17181,17181,0,22,5649000.0
5649,5649999,20.520492741637568,37.81624174491755,0.08876319110476738,2017.2098653316498,430.65454363822937,1702.905014038086,22658,5475,17183,17183,0,22,5650000.0
5650,5650999,20.5192177347324,37.814745177771606,0.08876556665752922,2017.5001811981201,430.72240471839905,1703.3317260742188,22659,5475,17184,17184,0,22,5651000.0
5651,5651999,20.51784463907104,37.812680673687666,0.08876997805611975,2017.9512786865234,430.79161071777344,1703.1557083129883,22661,5476,17185,17185,0,22,5652000.0
5652,5652999,20.516546317081417,37.81442567948624,0.08875782983251568,2018.2663991451263,430.8604018688202,1703.6226654052734,22663,5477,17186,17186,0,22,5653000.0
5653,5653999,20.51529509998313,37.81221987242258,0.08876301072546644,2018.5602009296417,430.93019342422485,1704.0700225830078,22664,5478,17186,17186,0,22,5654000.0
5654,5654999,20.514131991712294,37.810143815015216,0.08876794508684871,2019.1264526844025,431.0002329349518,1703.5601806640625,22668,5480,17188,17188,0,22,5655000.0
5655,5655999,20.513166743955868,37.80837986663194,0.08876953165610502,2019.506362438202,431.07113456726074,1703.6693649291992,22668,5480,17188,17188,0,22,5656000.0
5656,5656999,20.5124793141259,37.80738055855498,0.08876451516064521,2020.2672548294067,431.14013624191284,1702.3976593017578,22682,5483,17199,17199,0,22,5657000.0
5657,5657999,20.511684965657274,37.80570519220198,0.08876568696509124,2020.5009129047394,431.2105383872986,1703.1670684814453,22682,5483,17199,17199,0,22,5658000.0
5658,5658999,20.510873702928922,37.80396663194023,0.08876234471918742,2020.750295162201,431.28134989738464,1703.7916259765625,22682,5483,17199,17199,0,22,5659000.0
5659,5659999,20.51045031272705,37.80277237141074,0.08875769185367499,2021.2524936199188,431.3532683849335,1703.4475708007812,22684,5484,17200,17200,0,22,5660000.0
5660,5660999,20.510191050266997,37.801730565106574,0.08874813985535068,2021.6148207187653,431.4218063354492,1703.6885223388672,22693,5485,17208,17208,0,22,5661000.0
5661,5661999,20.50986428839999,37.80055439816118,0.08874638191018724,2022.0844407081604,431.49027943611145,1703.4554595947266,22695,5486,17209,17209,0,22,5662000.0
5662,5662999,20.5099547624995,37.80165954276015,0.08873199864465009,2022.5730786323547,431.5604667663574,1703.315818786621,22699,5488,17211,17211,0,22,5663000.0
5663,5663999,20.510136779340804,37.80146269575623,0.08872245349308738,2022.9467260837555,431.63027572631836,1703.516944885254,22701,5489,17212,17212,0,22,5664000.0
5664,5664999,20.509893594339985,37.80021074210436,0.08872641448310026,2023.3661110401154,431.70062613487244,1703.5324249267578,22703,5490,17213,17213,0,22,5665000.0
5665,5665999,20.509956715724524,37.799635946526045,0.08871466744536405,2023.6952066421509,431.7705066204071,1703.920555114746,22705,5491,17214,17214,0,22,5666000.0
5666,5666999,20.50929081617531,37.79806512020287,0.08870573656481162,2024.3751723766327,431.84095549583435,1703.5961532592773,22778,5494,17284,17284,0,22,5667000.0
5667,5667999,20.508745858966403,37.79670165662108,0.08867754716778276,2024.744146823883,431.91245222091675,1704.241096496582,22791,5494,17297,17297,0,22,5668000.0
5668,5668999,20.507665679374465,37.794379575485216,0.08866707846771338,2025.243735074997,431.98470997810364,1704.3439025878906,22799,5497,17302,17302,0,22,5669000.0
5669,5669999,20.50664803577789,37.792205469192915,0.08866290233896312,2025.5272469520569,432.0598363876343,1705.1606140136719,22801,5497,17304,17304,0,22,5670000.0
5670,5670999,20.505947315694456,37.79115847298992,0.08864755368059896,2025.8925397396088,432.12839913368225,1705.5752258300781,22808,5499,17309,17309,0,22,5671000.0
5671,5671999,20.504775991112044,37.788863093770416,0.08864330231057593,2026.2746965885162,432.1993250846863,1705.7764587402344,22816,5500,17316,17316,0,22,5672000.0
5672,5672999,20.50373739305195,37.78671359072689,0.08863562088107513,2026.8220160007477,432.26954674720764,1705.4348907470703,22820,5502,17318,17318,0,22,5673000.0
5673,5673999,20.50283371725714,37.785042777379196,0.08862955645817905,2027.2078104019165,432.3390312194824,1705.7013702392578,22822,5503,17319,17319,0,22,5674000.0
5674,5674999,20.502265803250637,37.78425184027123,0.08861465014771819,2027.4644474983215,432.4100558757782,1706.3222351074219,22822,5503,17319,17319,0,22,5675000.0
5675,5675999,20.501878527953586,37.78483706937218,0.08860147243118177,2027.907547712326,432.4803750514984,1706.436294555664,22855,5505,17350,17350,0,22,5676000.0
5676,5676999,20.502200380882847,37.787099456774484,0.0885828319284423,2028.262044429779,432.54979729652405,1706.6578216552734,22855,5505,17350,17350,0,22,5677000.0
5677,5677999,20.50288212427695,37.78956913543252,0.0885737437371229,2028.7507514953613,432.6214873790741,1706.3457794189453,22855,5505,17350,17350,0,22,5678000.0
5678,5678999,20.50344218555668,37.791338876197244,0.0885796369706735,2029.0879600048065,432.69352102279663,1706.7544403076172,22857,5506,17351,17351,0,22,5679000.0
5679,5679999,20.504163627389463,37.79381761990142,0.08855842547220927,2029.5317206382751,432.76334524154663,1706.619041442871,22859,5507,17352,17352,0,22,5680000.0
5680,5680999,20.505186823455844,37.797261728599786,0.08853532748218285,2029.9206712245941,432.8339545726776,1706.8172149658203,22861,5508,17353,17353,0,22,5681000.0
5681,5681999,20.50642558419598,37.80107235072189,0.08851813155817945,2030.3449711799622,432.90472173690796,1706.909782409668,22863,5509,17354,17354,0,22,5682000.0
5682,5682999,20.507302643070755,37.803342017844436,0.08851068173823262,2030.7362830638885,432.97711086273193,1706.9880294799805,22863,5509,17354,17354,0,22,5683000.0
5683,5683999,20.508791043393522,37.806820643696916,0.08849440338724701,2031.3175313472748,433.0477843284607,1706.5552139282227,22874,5512,17362,17362,0,22,5684000.0
5684,5684999,20.510166281089454,37.8099966322417,0.08849336826425369,2031.771960735321,433.1198720932007,1706.539794921875,22878,5514,17364,17364,0,22,5685000.0
5685,5685999,20.51160285596695,37.81527223741721,0.08846598911418013,2032.2347838878632,433.19162368774414,1706.4358367919922,22880,5515,17365,17365,0,22,5686000.0
5686,5686999,20.512539349212105,37.81660484449536,0.08845181237301081,2032.5676803588867,433.2624053955078,1706.9320220947266,22882,5516,17366,17366,0,22,5687000.0
5687,5687999,20.512522133569917,37.816897328966874,0.0884406193078785,2032.8666412830353,433.3312392234802,1707.8596572875977,22888,5516,17372,17372,0,22,5688000.0
5688,5688999,20.51155980304139,37.81510401561642,0.0884293966781835,2033.2500114440918,433.39813137054443,1708.3819885253906,22896,5516,17380,17380,0,22,5689000.0
5689,5689999,20.51055959700554,37.81359229309623,0.08841246211721399,2033.6013917922974,433.46369099617004,1708.9565658569336,22911,5518,17393,17393,0,22,5690000.0
5690,5690999,20.510177978511962,37.81268177443602,0.08837511370869733,2033.8914141654968,433.5318133831024,1709.6018676757812,22913,5518,17395,17395,0,22,5691000.0
5691,5691999,20.510364979086322,37.811950600554795,0.08832499985524822,2034.1500952243805,433.59737968444824,1710.5576400756836,22915,5518,17397,17397,0,22,5692000.0
5692,5692999,20.510484982386206,37.811243215138326,0.08827591744400265,2034.4105927944183,433.6665623188019,1711.352653503418,22915,5518,17397,17397,0,22,5693000.0
5693,5693999,20.510718373297106,37.81038927958102,0.08822812537934888,2034.719269990921,433.7333722114563,1711.8352279663086,22915,5518,17397,17397,0,22,5694000.0
5694,5694999,20.510971398491677,37.809791662689705,0.08819524311528193,2035.0911560058594,433.8019745349884,1712.267593383789,22919,5520,17399,17399,0,22,5695000.0
5695,5695999,20.511282643607696,37.80953108198417,0.08815040910579386,2035.3427994251251,433.8682653903961,1712.9063568115234,22920,5520,17400,17400,0,22,5696000.0
5696,5696999,20.511757189485515,37.80938354668649,0.08811994404750023,2035.8437914848328,433.9349105358124,1712.6761474609375,22932,5522,17410,17410,0,22,5697000.0
5697,5697999,20.512218972667238,37.80965969147427,0.08809085929016724,2036.2712202072144,434.0039539337158,1712.721794128418,22932,5522,17410,17410,0,22,5698000.0
5698,5698999,20.512493639534544,37.80916644900518,0.0880679822162137,2036.6286668777466,434.0711419582367,1713.0398483276367,22932,5522,17410,17410,0,22,5699000.0
5699,5699999,20.513167812229018,37.81214740925552,0.08803437061120811,2036.888655424118,434.13730454444885,1713.6659393310547,22932,5522,17410,17410,0,22,5700000.0
5700,5700999,20.51365576165563,37.81212818662764,0.08801371939838853,2037.2914590835571,434.2046639919281,1713.788673400879,22954,5523,17431,17431,0,22,5701000.0
5701,5701999,20.514516577849307,37.81262888075275,0.08798998324719487,2037.7256164550781,434.27610325813293,1713.7502746582031,22961,5524,17437,17437,0,22,5702000.0
5702,5702999,20.514944094821725,37.81220189829491,0.08797621506325981,2038.1082608699799,434.34316515922546,1713.8645401000977,22963,5525,17438,17438,0,22,5703000.0
5703,5703999,20.515441722063905,37.81214577123931,0.08796062789889769,2038.658403635025,434.41088223457336,1713.4927978515625,22994,5526,17468,17468,0,22,5704000.0
5704,5704999,20.516158444290056,37.81188591178289,0.0879470249089308,2039.0285375118256,434.47757720947266,1713.7194137573242,22994,5526,17468,17468,0,22,5705000.0
5705,5705999,20.516604375020126,37.812897078220075,0.08792844897602559,2039.4312090873718,434.5468394756317,1713.7816314697266,22994,5526,17468,17468,0,22,5706000.0
5706,5706999,20.51703849182074,37.812449907266455,0.08791964471039848,2039.6451189517975,434.6132822036743,1714.509162902832,22994,5526,17468,17468,0,22,5707000.0
5707,5707999,20.517376195244477,37.81168837733879,0.08790813665623443,2040.067880153656,434.6813793182373,1714.4763717651367,22994,5526,17468,17468,0,22,5708000.0
5708,5708999,20.516916822593515,37.810063515775944,0.08790501750972168,2040.4701871871948,434.7499797344208,1714.9914093017578,23001,5526,17475,17475,0,22,5709000.0
5709,5709999,20.516142465281543,37.808657994809785,0.08790286331450647,2040.888727903366,434.8430058956146,1715.8600845336914,23015,5526,17489,17489,0,22,5710000.0
5710,5710999,20.515121468738403,37.80795727464553,0.0879068815694396,2041.3150391578674,434.9119999408722,1716.2125930786133,23022,5528,17494,17494,0,22,5711000.0
5711,5711999,20.514207511839704,37.80667326900681,0.08790782832805477,2041.635106086731,434.9805488586426,1716.8316345214844,23032,5529,17503,17503,0,22,5712000.0
5712,5712999,20.513139133622435,37.80523014919638,0.08791206752915914,2042.0081684589386,435.04997205734253,1717.0534896850586,23033,5529,17504,17504,0,22,5713000.0
5713,5713999,20.511740835074747,37.80268677848258,0.08792312416574577,2042.2730224132538,435.12266778945923,1717.7261810302734,23033,5529,17504,17504,0,22,5714000.0
5714,5714999,20.510594928289933,37.8005942390939,0.08792995860387876,2042.669869184494,435.1940772533417,1717.9919738769531,23055,5530,17525,17525,0,22,5715000.0
5715,5715999,20.509610385358624,37.799126516674946,0.087932581577714,2043.1449012756348,435.2645523548126,1717.7832336425781,23057,5531,17526,17526,0,22,5716000.0
5716,5716999,20.508363326478683,37.797130857777525,0.08794297025024433,2043.7033340930939,435.33570408821106,1717.4352416992188,23083,5533,17550,17550,0,22,5717000.0
5717,5717999,20.50714935297694,37.794794352064095,0.08795507775290956,2044.1159343719482,435.4063742160797,1717.6117095947266,23087,5535,17552,17552,0,22,5718000.0
5718,5718999,20.505907708076382,37.79241169080942,0.08796457940746583,2044.487010717392,435.47595834732056,1718.061424255371,23089,5536,17553,17553,0,22,5719000.0
5719,5719999,20.504812167755773,37.79050589217873,0.0879745471615263,2044.9588763713837,435.5519781112671,1717.8302764892578,23091,5537,17554,17554,0,22,5720000.0
5720,5720999,20.503797575673605,37.788536297625555,0.08798548833555186,2045.4385120868683,435.6215922832489,1717.643669128418,23091,5537,17554,17554,0,22,5721000.0
5721,5721999,20.502968016574005,37.786752680539664,0.08799594354273144,2045.7060878276825,435.69040274620056,1718.218162536621,23091,5537,17554,17554,0,22,5722000.0
5722,5722999,20.502097699458744,37.78483037342392,0.08800775306096142,2046.136902809143,435.7593877315521,1718.1778106689453,23093,5538,17555,17555,0,22,5723000.0
5723,5723999,20.501345750400887,37.782941378701935,0.08802101753712266,2046.5239565372467,435.8279724121094,1718.3538665771484,23093,5538,17555,17555,0,22,5724000.0
5724,5724999,20.50012856703643,37.78043914307332,0.08804031282528013,2046.7915976047516,435.8976366519928,1718.9443588256836,23093,5538,17555,17555,0,22,5725000.0
5725,5725999,20.499753734629966,37.77967447243914,0.08803357071599605,2047.1561591625214,435.96623396873474,1719.4268417358398,23096,5538,17558,17558,0,22,5726000.0
5726,5726999,20.499998520153518,37.77859749500292,0.08799261384079904,2047.528641462326,436.0340085029602,1719.9921340942383,23105,5539,17566,17566,0,22,5727000.0
5727,5727999,20.50029157028972,37.77863335818562,0.08796175334806855,2047.8218083381653,436.10164618492126,1720.7475891113281,23107,5539,17568,17568,0,22,5728000.0
5728,5728999,20.50025159634874,37.778965195699186,0.08793369348697477,2048.6501109600067,436.16998767852783,1719.4936599731445,23125,5545,17580,17580,0,22,5729000.0
5729,5729999,20.500044620700642,37.777963551751874,0.08791900114423101,2049.0455038547516,436.2389769554138,1719.8487014770508,23129,5547,17582,17582,0,22,5730000.0
5730,5730999,20.500016029202676,37.777690074298256,0.08790217481698714,2049.29186296463,436.3086061477661,1720.5917663574219,23129,5547,17582,17582,0,22,5731000.0
5731,5731999,20.49986350048579,37.77655483845562,0.08789079857229087,2049.620505332947,436.37719106674194,1721.0296096801758,23131,5548,17583,17583,0,22,5732000.0
5732,5732999,20.499450394124306,37.77497945683332,0.08787688904762259,2050.031630039215,436.4476537704468,1721.0987854003906,23135,5550,17585,17585,0,22,5733000.0
5733,5733999,20.4989560121469,37.773257357988754,0.08787022080991136,2050.415718317032,436.51574540138245,1721.2964401245117,23137,5551,17586,17586,0,22,5734000.0
5734,5734999,20.498821333342747,37.77299518776345,0.08785893224568464,2050.7933621406555,436.5851683616638,1721.545310974121,23139,5552,17587,17587,0,22,5735000.0
5735,5735999,20.498531836900032,37.771762310152134,0.08785151584601392,2051.2225024700165,436.6564803123474,1721.5279998779297,23141,5553,17588,17588,0,22,5736000.0
5736,5736999,20.498146514565626,37.77052154746202,0.08784203797639589,2051.690262556076,436.7266845703125,1721.347526550293,23141,5553,17588,17588,0,22,5737000.0
5737,5737999,20.497831876696814,37.769287795547164,0.08782407775796608,2052.0573918819427,436.7965362071991,1721.6073455810547,23143,5554,17589,17589,0,22,5738000.0
5738,5738999,20.497906404824956,37.769233672896725,0.08780628193271867,2052.3025126457214,436.8639919757843,1722.2678909301758,23143,5554,17589,17589,0,22,5739000.0
5739,5739999,20.49797071650946,37.76940136368912,0.08778952546537455,2052.7669711112976,436.9325819015503,1722.1279220581055,23171,5555,17616,17616,0,22,5740000.0
5740,5740999,20.49774253050721,37.76802864577409,0.08777654164799076,2053.6310238838196,437.00246000289917,1720.6278915405273,23188,5560,17628,17628,0,22,5741000.0
5741,5741999,20.497869802121677,37.767298165424776,0.08776273734416273,2053.8817279338837,437.0722029209137,1721.3778762817383,23188,5560,17628,17628,0,22,5742000.0
5742,5742999,20.49820033667942,37.76697263238827,0.08774636987489859,2054.259234189987,437.142698764801,1721.5465621948242,23189,5561,17628,17628,0,22,5743000.0
5743,5743999,20.49858054463943,37.76642316457126,0.08773571238935751,2054.456057548523,437.21302247047424,1722.3955917358398,23189,5561,17628,17628,0,22,5744000.0
5744,5744999,20.49888881030407,37.76825448288725,0.08771389289613796,2054.827316761017,437.28173303604126,1722.5907592773438,23191,5562,17629,17629,0,22,5745000.0
5745,5745999,20.500308913812027,37.7687450753846,0.0875960443813888,2055.21985578537,437.35139656066895,1723.1241836547852,23196,5562,17634,17634,0,22,5746000.0
5746,5746999,20.502153105404105,37.770292662602024,0.08755305641259081,2055.575297832489,437.41915559768677,1723.7566223144531,23204,5563,17641,17641,0,22,5747000.0
5747,5747999,20.503821721560573,37.77245347034113,0.08751198856138032,2056.106957435608,437.48774814605713,1723.4420318603516,23211,5565,17646,17646,0,22,5748000.0
5748,5748999,20.5052403054622,37.77325286170331,0.0874754033092996,2056.406777858734,437.55509757995605,1724.316032409668,23223,5567,17656,17656,0,22,5749000.0
5749,5749999,20.506137425130653,37.77360904430347,0.08746789437866054,2056.8125145435333,437.6268410682678,1724.4853439331055,23228,5569,17659,17659,0,22,5750000.0
5750,5750999,20.50704315687468,37.77352794002907,0.0874319972534896,2057.2328157424927,437.6946244239807,1724.5068283081055,23230,5570,17660,17660,0,22,5751000.0
5751,5751999,20.507637709975846,37.773325118296555,0.08741607636577264,2057.604608297348,437.76615357398987,1724.7482223510742,23232,5571,17661,17661,0,22,5752000.0
5752,5752999,20.50843307514452,37.77387012856318,0.08742221716222143,2058.135319709778,437.83540749549866,1724.5620880126953,23243,5574,17669,17669,0,22,5753000.0
5753,5753999,20.509025243690093,37.77355640234569,0.08740882361554536,2058.474587202072,437.90723514556885,1724.9577560424805,23245,5575,17670,17670,0,22,5754000.0
5754,5754999,20.510111510908906,37.77411965674513,0.0874106669245499,2058.7796092033386,437.9755492210388,1725.4463577270508,23245,5575,17670,17670,0,22,5755000.0
5755,5755999,20.511066122647676,37.77555227001524,0.08738994206479678,2059.1691749095917,438.04394340515137,1725.5377731323242,23247,5576,17671,17671,0,22,5756000.0
5756,5756999,20.512407440054258,37.776715594983976,0.0873970376463774,2059.633156299591,438.11454010009766,1725.4798889160156,23253,5579,17674,17674,0,22,5757000.0
5757,5757999,20.5140362025773,37.77991207992934,0.08738983689386426,2060.403652191162,438.18801736831665,1724.714485168457,23323,5583,17740,17740,0,22,5758000.0
5758,5758999,20.515391003039184,37.782139004116566,0.08743005840157703,2060.6570534706116,438.2572240829468,1725.923583984375,23323,5583,17740,17740,0,22,5759000.0
5759,5759999,20.51761588530556,37.78741056271953,0.08742162764802908,2060.9915056228638,438.32710909843445,1726.640495300293,23330,5584,17746,17746,0,22,5760000.0
5760,5760999,20.51953374231933,37.7910132802775,0.08743195660266234,2061.350301027298,438.39602160453796,1726.952392578125,23330,5584,17746,17746,0,22,5761000.0
5761,5761999,20.521974336939213,37.7980685631146,0.08743485882447577,2061.706814289093,438.4651460647583,1727.3418731689453,23330,5584,17746,17746,0,22,5762000.0
5762,5762999,20.52422759270945,37.802030987984,0.08745707079861165,2062.1588838100433,438.5371689796448,1727.5337219238281,23341,5586,17755,17755,0,22,5763000.0
5763,5763999,20.525734820811408,37.80376237077088,0.08748520901011514,2062.5347707271576,438.60813426971436,1727.901969909668,23343,5587,17756,17756,0,22,5764000.0
5764,5764999,20.52659598681708,37.80382630417972,0.08749388080772291,2062.8239266872406,438.67760968208313,1728.5279006958008,23345,5588,17757,17757,0,22,5765000.0
5765,5765999,20.527490030954276,37.80435374409147,0.0874835298881601,2063.2193446159363,438.74786853790283,1728.9605712890625,23350,5588,17762,17762,0,22,5766000.0
5766,5766999,20.527673212154582,37.8046286243203,0.08744275528511802,2063.6200098991394,438.8155779838562,1729.4794387817383,23359,5588,17771,17771,0,22,5767000.0
5767,5767999,20.527361892994346,37.80341498111988,0.08743274791675837,2063.8610010147095,438.88347840309143,1730.556495666504,23361,5588,17773,17773,0,22,5768000.0
5768,5768999,20.526773247994885,37.801605279182134,0.08742974332714026,2064.153062582016,438.95021963119507,1731.1378555297852,23366,5589,17777,17777,0,22,5769000.0
5769,5769999,20.52632007675257,37.80022297099308,0.08742381044593317,2064.59095621109,439.0244529247284,1731.1309814453125,23369,5590,17779,17779,0,22,5770000.0
5770,5770999,20.525664487272415,37.79851825356881,0.08741837417819176,2064.903215408325,439.09076404571533,1731.5374374389648,23370,5590,17780,17780,0,22,5771000.0
5771,5771999,20.525084992873722,37.79683415787236,0.08741070923007299,2065.146695613861,439.1572685241699,1732.0980224609375,23370,5590,17780,17780,0,22,5772000.0
5772,5772999,20.524512564405534,37.79502555060527,0.08740432413721178,2065.638221502304,439.22343730926514,1731.8884582519531,23372,5591,17781,17781,0,22,5773000.0
5773,5773999,20.52394646623603,37.79313122036637,0.0873989850520015,2065.7995817661285,439.2886416912079,1732.8849258422852,23372,5591,17781,17781,0,22,5774000.0
5774,5774999,20.523336243097635,37.7913190454521,0.08739331930453953,2066.0995626449585,439.35515427589417,1733.11181640625,23372,5591,17781,17781,0,22,5775000.0
5775,5775999,20.522758344571287,37.78943670133582,0.08738590732917673,2066.4476675987244,439.42320370674133,1733.2779235839844,23372,5591,17781,17781,0,22,5776000.0
5776,5776999,20.52236362041437,37.78784431137536,0.08737800618951808,2066.8763325214386,439.49098348617554,1733.1076965332031,23374,5592,17782,17782,0,22,5777000.0
5777,5777999,20.52198446283452,37.78629973803866,0.08737004961871564,2067.5033309459686,439.5618579387665,1732.426498413086,23378,5594,17784,17784,0,22,5778000.0
5778,5778999,20.521598196049784,37.784925867184654,0.08736491409494718,2067.769825696945,439.6352891921997,1733.0288162231445,23378,5594,17784,17784,0,22,5779000.0
5779,5779999,20.52147440221977,37.78409648560713,0.08735396563642561,2068.201733827591,439.70188903808594,1732.8504638671875,23380,5595,17785,17785,0,22,5780000.0
5780,5780999,20.52111990142254,37.78265560510691,0.0873524212323673,2068.6244955062866,439.7696056365967,1732.9375915527344,23382,5596,17786,17786,0,22,5781000.0
5781,5781999,20.520953459201753,37.781381552273466,0.08734532125904204,2068.989067554474,439.83833360671997,1733.071922302246,23382,5596,17786,17786,0,22,5782000.0
5782,5782999,20.520854881483753,37.780187697499834,0.08734112274607475,2069.4561541080475,439.90498876571655,1732.8356857299805,23384,5597,17787,17787,0,22,5783000.0
5783,5783999,20.52050685654309,37.7786873174387,0.08733998528888554,2069.9154448509216,439.9719455242157,1732.7594985961914,23386,5598,17788,17788,0,22,5784000.0
5784,5784999,20.519974244424606,37.77688325262487,0.08734209782997926,2070.1676948070526,440.0383906364441,1733.4015197753906,23386,5598,17788,17788,0,22,5785000.0
5785,5785999,20.519503193132124,37.77568558416609,0.08733982788347883,2070.471745967865,440.1043162345886,1733.9749298095703,23387,5598,17789,17789,0,22,5786000.0
5786,5786999,20.518791742498117,37.77384973127113,0.0873146343646144,2070.8898873329163,440.1734461784363,1734.228775024414,23391,5598,17793,17793,0,22,5787000.0
5787,5787999,20.51811091489176,37.772619766742615,0.08727881715265107,2071.308846950531,440.24260687828064,1734.4165267944336,23402,5600,17802,17802,0,22,5788000.0
5788,5788999,20.517522129915022,37.77113925705483,0.08724316530912624,2071.611248254776,440.3121671676636,1735.0148468017578,23403,5600,17803,17803,0,22,5789000.0
5789,5789999,20.51681474450756,37.770424537571245,0.08721979683646164,2071.9855880737305,440.3835380077362,1735.2727966308594,23405,5601,17804,17804,0,22,5790000.0
5790,5790999,20.516136169012245,37.76947676581447,0.08719414970348804,2072.2852685451508,440.45321702957153,1735.7427825927734,23406,5601,17805,17805,0,22,5791000.0
5791,5791999,20.51540345225631,37.76792548434477,0.08717396378612163,2072.621682882309,440.52245569229126,1736.0465621948242,23406,5601,17805,17805,0,22,5792000.0
5792,5792999,20.51472312212914,37.766107176563565,0.087157674068298,2072.9710738658905,440.5930836200714,1736.3884353637695,23407,5601,17806,17806,0,22,5793000.0
5793,5793999,20.514153003417025,37.765040306001744,0.08713828362552145,2073.281491994858,440.6624286174774,1736.7597427368164,23407,5601,17806,17806,0,22,5794000.0
5794,5794999,20.513740083420753,37.76362631143003,0.08711952078756457,2073.7565305233,440.7335479259491,1736.5706634521484,23414,5602,17812,17812,0,22,5795000.0
5795,5795999,20.51342088708632,37.76295709490122,0.08709631822345199,2074.2028794288635,440.8052890300751,1736.493881225586,23415,5603,17812,17812,0,22,5796000.0
5796,5796999,20.512932800427674,37.76140092186146,0.08708516203410288,2074.711615085602,440.87571692466736,1736.5342178344727,23480,5605,17875,17875,0,22,5797000.0
5797,5797999,20.512950706422433,37.760972049184964,0.08707270337235384,2075.0502717494965,440.94647002220154,1737.239273071289,23481,5606,17875,17875,0,22,5798000.0
5798,5798999,20.512690095208754,37.760005190621335,0.08706153966637575,2075.402044773102,441.01802158355713,1737.8767623901367,23481,5606,17875,17875,0,22,5799000.0
5799,5799999,20.512868998773893,37.759448964170986,0.08704882027658001,2075.820323705673,441.0884037017822,1737.9799728393555,23483,5607,17876,17876,0,22,5800000.0
5800,5800999,20.51240341574475,37.757967330128594,0.08704474059274214,2076.0295028686523,441.1583547592163,1738.9556121826172,23483,5607,17876,17876,0,22,5801000.0
5801,5801999,20.512334048546947,37.757088624739026,0.08703567851436056,2076.3881964683533,441.23153138160706,1739.2636795043945,23483,5607,17876,17876,0,22,5802000.0
5802,5802999,20.512150443376797,37.755903903609166,0.0870293534363572,2076.956760406494,441.3022668361664,1738.853530883789,23492,5608,17884,17884,0,22,5803000.0
5803,5803999,20.512190692843717,37.75521560074527,0.0870160233833942,2077.247307777405,441.3738193511963,1739.5176010131836,23492,5608,17884,17884,0,22,5804000.0
5804,5804999,20.511853142183302,37.7537496470034,0.08701120035145105,2077.6502256393433,441.4458758831024,1739.6665573120117,23507,5609,17898,17898,0,22,5805000.0
5805,5805999,20.51133349604888,37.751848171704395,0.0870039123976889,2077.945352077484,441.5188889503479,1740.5525207519531,23507,5609,17898,17898,0,22,5806000.0
5806,5806999,20.51048352284591,37.74966559383329,0.08700200292567128,2078.3416690826416,441.5894694328308,1741.0520629882812,23515,5609,17906,17906,0,22,5807000.0
5807,5807999,20.509795167086143,37.74866881479032,0.08698350047075443,2078.70974111557,441.6595997810364,1741.6064987182617,23527,5610,17917,17917,0,22,5808000.0
5808,5808999,20.509541808409068,37.748122773880915,0.08695505849074547,2078.995005607605,441.72939896583557,1742.3372039794922,23529,5610,17919,17919,0,22,5809000.0
5809,5809999,20.509666488119404,37.74712238627864,0.08693214491668733,2079.5017986297607,441.80033922195435,1742.1897659301758,23535,5613,17922,17922,0,22,5810000.0
5810,5810999,20.50975089942737,37.74615620417256,0.08690407601170369,2079.9048342704773,441.873583316803,1742.526107788086,23539,5614,17925,17925,0,22,5811000.0
5811,5811999,20.509822617732166,37.74569861333768,0.08686623574699948,2080.34610915184,441.9438738822937,1742.6565399169922,23541,5615,17926,17926,0,22,5812000.0
5812,5812999,20.509917301214312,37.74510010466902,0.08684107867924573,2080.6795053482056,442.01391887664795,1743.1288299560547,23543,5616,17927,17927,0,22,5813000.0
5813,5813999,20.50980124513218,37.744001553810605,0.08682103720705092,2081.1114749908447,442.085453748703,1743.1972961425781,23547,5618,17929,17929,0,22,5814000.0
5814,5814999,20.50987548489057,37.743191702592156,0.08680178663622284,2081.528244972229,442.1564140319824,1743.443504333496,23551,5620,17931,17931,0,22,5815000.0
5815,5815999,20.509697565853656,37.74238314367155,0.0867869265736958,2081.908634662628,442.22751021385193,1743.6782836914062,23553,5621,17932,17932,0,22,5816000.0
5816,5816999,20.509803024717797,37.741707159441326,0.08679089806678375,2082.3791456222534,442.2979567050934,1743.6203155517578,23555,5622,17933,17933,0,22,5817000.0
5817,5817999,20.51006214035227,37.741872808915225,0.08681178519805155,2082.8110818862915,442.3705668449402,1743.6892547607422,23557,5623,17934,17934,0,22,5818000.0
5818,5818999,20.51026590017983,37.74156125481436,0.08684181360407917,2083.155072450638,442.4417312145233,1744.1405029296875,23559,5624,17935,17935,0,22,5819000.0
5819,5819999,20.510828781611156,37.74207297298999,0.08687595847409413,2083.493952035904,442.5135269165039,1744.3929748535156,23559,5624,17935,17935,0,22,5820000.0
5820,5820999,20.511607348858217,37.74342669647438,0.0869245986673205,2083.818822622299,442.5869493484497,1744.770362854004,23559,5624,17935,17935,0,22,5821000.0
5821,5821999,20.512839511962824,37.745555543322,0.0869631237275349,2084.0861060619354,442.6576101779938,1745.3017120361328,23559,5624,17935,17935,0,22,5822000.0
5822,5822999,20.514181790820814,37.74768269359857,0.08702765935504186,2084.636615037918,442.7308521270752,1744.9670639038086,23577,5627,17950,17950,0,22,5823000.0
5823,5823999,20.51660821720327,37.752479241197165,0.0870782898259066,2085.174507856369,442.80384731292725,1744.7608795166016,23581,5629,17952,17952,0,22,5824000.0
5824,5824999,20.519125640286134,37.75932581521514,0.08710638188710851,2085.6542410850525,442.87926149368286,1744.703842163086,23583,5630,17953,17953,0,22,5825000.0
5825,5825999,20.521562442160228,37.7653587968383,0.08715322293042471,2085.9153666496277,442.949666261673,1745.4070129394531,23583,5630,17953,17953,0,22,5826000.0
5826,5826999,20.52352320322025,37.76838481760577,0.08718535045414189,2086.224592447281,443.02108669281006,1745.9771194458008,23583,5630,17953,17953,0,22,5827000.0
5827,5827999,20.523344198882743,37.76765720872397,0.08717350550559999,2086.5150747299194,443.08853793144226,1747.0145645141602,23588,5630,17958,17958,0,22,5828000.0
5828,5828999,20.52245219254303,37.76657097394652,0.08716111273016047,2086.839990377426,443.1547815799713,1747.893798828125,23595,5631,17964,17964,0,22,5829000.0
5829,5829999,20.521747374483322,37.765913030488406,0.08714674286390778,2087.0354750156403,443.22021532058716,1749.0051651000977,23597,5631,17966,17966,0,22,5830000.0
5830,5830999,20.521194582513687,37.76449974386464,0.08713377182956794,2087.469750404358,443.2869613170624,1749.0702438354492,23600,5631,17969,17969,0,22,5831000.0
5831,5831999,20.52108283981988,37.76334381035849,0.08711306177102185,2087.803689956665,443.35371923446655,1749.7920150756836,23602,5632,17970,17970,0,22,5832000.0
5832,5832999,20.520701705279574,37.76213761563897,0.08710467140426248,2088.199295759201,443.42038679122925,1749.9812927246094,23602,5632,17970,17970,0,22,5833000.0
5833,5833999,20.520554861125376,37.760797085969685,0.08708952161416406,2088.523761987686,443.48688292503357,1750.4347534179688,23604,5633,17971,17971,0,22,5834000.0
5834,5834999,20.520422245426726,37.759909509937664,0.08708164400079332,2088.732676267624,443.5524904727936,1751.2597045898438,23604,5633,17971,17971,0,22,5835000.0
5835,5835999,20.520799053974674,37.762733826635895,0.08706751177584293,2089.177889585495,443.61983919143677,1751.0549240112305,23606,5633,17973,17973,0,22,5836000.0
5836,5836999,20.521453180940693,37.763547382280834,0.08706775152927204,2089.5545370578766,443.68652534484863,1751.300880432129,23608,5634,17974,17974,0,22,5837000.0
5837,5837999,20.522589865125063,37.76492379382001,0.08708339470271875,2089.9951837062836,443.75468826293945,1751.2269821166992,23608,5634,17974,17974,0,22,5838000.0
5838,5838999,20.524008425389077,37.767021300361066,0.08710550095924208,2090.467694044113,443.8221790790558,1751.18359375,23619,5636,17983,17983,0,22,5839000.0
5839,5839999,20.525243563291927,37.768295301730696,0.08712549079454346,2091.018671989441,443.8902196884155,1751.3517532348633,23684,5639,18045,18045,0,22,5840000.0
5840,5840999,20.526841346353635,37.76997873665592,0.0871447670112081,2091.2300424575806,443.95975399017334,1752.4761047363281,23685,5639,18046,18046,0,22,5841000.0
5841,5841999,20.528902476447957,37.774803677705535,0.08714982584149122,2091.5659472942352,444.0270884037018,1752.9894943237305,23687,5640,18047,18047,0,22,5842000.0
5842,5842999,20.531131329404,37.78015011716118,0.0871796860873022,2092.034505844116,444.0949807167053,1753.0495071411133,23696,5641,18055,18055,0,22,5843000.0
5843,5843999,20.53312911530425,37.782910355680656,0.08720366643224842,2092.432473182678,444.1637110710144,1753.3268814086914,23696,5641,18055,18055,0,22,5844000.0
5844,5844999,20.535896739839213,37.789344728470745,0.08722738398842855,2092.868063926697,444.2322371006012,1753.6424865722656,23702,5644,18058,18058,0,22,5845000.0
5845,5845999,20.538191019484522,37.79323847562554,0.0872534922442123,2093.314612865448,444.30231618881226,1753.7230911254883,23702,5644,18058,18058,0,22,5846000.0
5846,5846999,20.541184446194123,37.7982668348175,0.08728529153843834,2093.6496465206146,444.3695275783539,1754.2834777832031,23704,5645,18059,18059,0,22,5847000.0
5847,5847999,20.542646891138602,37.79966391862405,0.08728896182382806,2093.9524476528168,444.43765687942505,1755.0110549926758,23710,5645,18065,18065,0,22,5848000.0
5848,5848999,20.542003182188374,37.7999835821952,0.0872701152065185,2094.2214963436127,444.50980257987976,1756.1266860961914,23723,5645,18078,18078,0,22,5849000.0
5849,5849999,20.541139975187857,37.79885182257355,0.08727282055540342,2094.6195859909058,444.58155632019043,1756.456916809082,23726,5646,18080,18080,0,22,5850000.0
5850,5850999,20.540214537059118,37.797146510409824,0.08727431585580703,2095.0314905643463,444.65344738960266,1756.8913955688477,23741,5648,18093,18093,0,22,5851000.0
5851,5851999,20.539243801068203,37.79527881122607,0.0872760806976467,2095.396392583847,444.7253510951996,1757.1469955444336,23741,5648,18093,18093,0,22,5852000.0
5852,5852999,20.538296228814676,37.79691617989858,0.08726080339141862,2095.7566800117493,444.79582118988037,1757.4131088256836,23741,5648,18093,18093,0,22,5853000.0
5853,5853999,20.537213002001426,37.7948256086029,0.08726387089623633,2096.31884932518,444.8691394329071,1757.0662155151367,23752,5650,18102,18102,0,22,5854000.0
5854,5854999,20.53606462952505,37.792580068953164,0.08726944778554846,2096.801344871521,444.94110894203186,1756.937858581543,23752,5650,18102,18102,0,22,5855000.0
5855,5855999,20.534962833598843,37.79081822258176,0.08727082531120978,2097.1222760677338,445.01323223114014,1757.4188690185547,23752,5650,18102,18102,0,22,5856000.0
5856,5856999,20.53386719461859,37.788858361204,0.08727422396125573,2097.474932909012,445.0869081020355,1757.7908630371094,23753,5651,18102,18102,0,22,5857000.0
5857,5857999,20.53291982906019,37.78713949078489,0.08727628639175722,2097.813842535019,445.16001439094543,1758.1094436645508,23754,5652,18102,18102,0,22,5858000.0
5858,5858999,20.532032927900342,37.785520639349684,0.08727645680539597,2098.4223098754883,445.2355525493622,1757.3404693603516,23754,5652,18102,18102,0,22,5859000.0
5859,5859999,20.530957170572105,37.78341375711767,0.08728380848237538,2098.752979516983,445.308988571167,1757.8401641845703,23754,5652,18102,18102,0,22,5860000.0
5860,5860999,20.530120567236267,37.781704315061255,0.08728587944971256,2099.0962200164795,445.3831775188446,1758.3111419677734,23763,5653,18110,18110,0,22,5861000.0
5861,5861999,20.529304711334976,37.78029334172198,0.08728765361208257,2099.512907266617,445.45685172080994,1758.3573989868164,23763,5653,18110,18110,0,22,5862000.0
5862,5862999,20.528453803718286,37.77832021467453,0.08729539197894354,2099.9233317375183,445.530127286911,1758.3393173217773,23764,5654,18110,18110,0,22,5863000.0
5863,5863999,20.527635936406472,37.77655235882827,0.08729998582119369,2100.5137140750885,445.604944229126,1757.9288024902344,23778,5657,18121,18121,0,22,5864000.0
5864,5864999,20.526763635624736,37.77456599235713,0.0873033807339132,2101.0186626911163,445.6792676448822,1757.8147354125977,23781,5658,18123,18123,0,22,5865000.0
5865,5865999,20.529300220240835,37.77675866099168,0.08713149295862921,2101.4055054187775,445.74944972991943,1758.441505432129,23789,5659,18130,18130,0,22,5866000.0
5866,5866999,20.53046064742384,37.77772275972052,0.08705678527191507,2101.878846168518,445.82017636299133,1758.5695114135742,23798,5662,18136,18136,0,22,5867000.0
5867,5867999,20.530888200959556,37.77684048396758,0.08700201983274514,2102.331003189087,445.8907902240753,1758.676040649414,23802,5664,18138,18138,0,22,5868000.0
5868,5868999,20.531334792927094,37.77756578440954,0.08695324232147883,2102.9099814891815,445.9609885215759,1758.3944778442383,23810,5668,18142,18142,0,22,5869000.0
5869,5869999,20.53120613042773,37.7771956325235,0.08692775756120297,2103.452461719513,446.0298693180084,1758.183090209961,23816,5671,18145,18145,0,22,5870000.0
5870,5870999,20.530804325860473,37.77561158423466,0.08692094770673264,2103.8250980377197,446.1013414859772,1758.5234680175781,23828,5672,18156,18156,0,22,5871000.0
5871,5871999,20.53065646305093,37.77597852267485,0.0868973355711482,2104.201481819153,446.1691131591797,1758.7792739868164,23832,5674,18158,18158,0,22,5872000.0
5872,5872999,20.530307412853187,37.77483499279061,0.08687841871485491,2104.5297582149506,446.23875308036804,1759.2249374389648,23832,5674,18158,18158,0,22,5873000.0
5873,5873999,20.529985580169605,37.77378965591732,0.0868593463408669,2104.9727358818054,446.30909276008606,1759.3449325561523,23846,5677,18169,18169,0,22,5874000.0
5874,5874999,20.529877265966288,37.7731159476872,0.08683400193531188,2105.5226485729218,446.3793523311615,1758.994026184082,23852,5680,18172,18172,0,22,5875000.0
5875,5875999,20.529714115775324,37.772234410800145,0.08681351016617622,2106.0003006458282,446.4501750469208,1758.8642807006836,23854,5681,18173,18173,0,22,5876000.0
5876,5876999,20.529622995557453,37.77182847314612,0.08679359779980045,2106.2542378902435,446.52026438713074,1759.5404205322266,23854,5681,18173,18173,0,22,5877000.0
5877,5877999,20.5298308101321,37.77134486729126,0.08677724375046003,2106.721383333206,446.5902132987976,1759.4543685913086,23856,5682,18174,18174,0,22,5878000.0
5878,5878999,20.53003688500577,37.77126269701829,0.08676098586981806,2107.1159570217133,446.6638922691345,1759.5696258544922,23858,5683,18175,18175,0,22,5879000.0
5879,5879999,20.530220368956275,37.770789694561074,0.08674954221254727,2107.412321329117,446.7340438365936,1760.0565643310547,23858,5683,18175,18175,0,22,5880000.0
5880,5880999,20.530973625550708,37.77137263823668,0.08672713844332658,2107.932235956192,446.80474305152893,1759.6233520507812,23860,5684,18176,18176,0,22,5881000.0
5881,5881999,20.53148482984572,37.77110906456033,0.08670405659476188,2108.1890029907227,446.8739514350891,1760.2779846191406,23860,5684,18176,18176,0,22,5882000.0
5882,5882999,20.5318619515084,37.770641261143204,0.08668930238169059,2108.7880589962006,446.9439363479614,1759.7134704589844,23865,5687,18178,18178,0,22,5883000.0
5883,5883999,20.532333946300117,37.77113832758999,0.08667335660591824,2109.081140756607,447.0146324634552,1760.2686157226562,23865,5687,18178,18178,0,22,5884000.0
5884,5884999,20.53247004594784,37.771931329333164,0.08665196372576622,2109.3331384658813,447.0824661254883,1761.1313858032227,23869,5687,18182,18182,0,22,5885000.0
5885,5885999,20.531955535018522,37.76987291515492,0.08663550406482268,2109.6232364177704,447.14972448349,1761.8375778198242,23874,5687,18187,18187,0,22,5886000.0
5886,5886999,20.53140885008377,37.76814958408509,0.08662318265570601,2109.8879687786102,447.2218403816223,1762.4599533081055,23876,5687,18189,18189,0,22,5887000.0
5887,5887999,20.530837691034584,37.76642535868818,0.08661423086945097,2110.5047318935394,447.29177474975586,1761.8451614379883,23882,5690,18192,18192,0,22,5888000.0
5888,5888999,20.53046907096541,37.76524454198261,0.08660031312530359,2110.8537168502808,447.36329102516174,1762.1940536499023,23885,5691,18194,18194,0,22,5889000.0
5889,5889999,20.530279885812273,37.76427351464864,0.08658924631213771,2111.323704481125,447.43325996398926,1762.0925064086914,23890,5693,18197,18197,0,22,5890000.0
5890,5890999,20.530375445961113,37.76727921099893,0.08656455148811248,2111.793880224228,447.5037202835083,1762.0821685791016,23895,5695,18200,18200,0,22,5891000.0
5891,5891999,20.529939268481343,37.76599092955228,0.08655727531566826,2112.2628486156464,447.57447719573975,1762.066635131836,23899,5697,18202,18202,0,22,5892000.0
5892,5892999,20.52965253406108,37.76486414871721,0.08655251185389135,2112.514406442642,447.6437940597534,1762.7546081542969,23899,5697,18202,18202,0,22,5893000.0
5893,5893999,20.52942646996348,37.763729013573524,0.08655551246136894,2112.8978950977325,447.7122039794922,1762.8225555419922,23899,5697,18202,18202,0,22,5894000.0
5894,5894999,20.529273284565388,37.76251626006494,0.08655814178608168,2113.3384544849396,447.78122758865356,1762.7789001464844,23901,5698,18203,18203,0,22,5895000.0
5895,5895999,20.528898923259522,37.760922167097675,0.08655692112606983,2113.8912649154663,447.8518545627594,1762.2010650634766,23903,5699,18204,18204,0,22,5896000.0
5896,5896999,20.529111508408594,37.76061607205367,0.08655267866676353,2114.2566332817078,447.92260551452637,1762.6171417236328,23905,5700,18205,18205,0,22,5897000.0
5897,5897999,20.529388357838478,37.76302823845546,0.08654873332230362,2114.5604870319366,447.9935095310211,1763.0110626220703,23905,5700,18205,18205,0,22,5898000.0
5898,5898999,20.52960033801975,37.762682068256886,0.08655276093829478,2114.942256450653,448.064080953598,1763.0944213867188,23905,5700,18205,18205,0,22,5899000.0
5899,5899999,20.52978597118382,37.76197906434714,0.08655726075972703,2115.4434406757355,448.1335823535919,1762.9745559692383,23919,5702,18217,18217,0,22,5900000.0
5900,5900999,20.5311591954024,37.76349673724092,0.08657516844195445,2115.9609503746033,448.2053134441376,1762.5603408813477,23921,5703,18218,18218,0,22,5901000.0
5901,5901999,20.531966792479302,37.76383986665197,0.08658707673820842,2116.4642713069916,448.27439308166504,1762.4535369873047,23925,5705,18220,18220,0,22,5902000.0
5902,5902999,20.532530472592395,37.76321779973346,0.08661212369137217,2116.8129613399506,456.99435806274414,1762.8373184204102,23925,5705,18220,18220,0,22,5903000.0
5903,5903999,20.532969166056827,37.7629324567779,0.08661125914611145,2117.1188583374023,457.0641391277313,1763.2028579711914,23925,5705,18220,18220,0,22,5904000.0
5904,5904999,20.533520953700368,37.762647541479694,0.08661307308365318,2117.55069899559,457.1338131427765,1763.1198959350586,23927,5706,18221,18221,0,22,5905000.0
5905,5905999,20.532818728257496,37.76094684059094,0.08662116814123344,2117.8024888038635,457.20098209381104,1764.1196594238281,23934,5706,18228,18228,0,22,5906000.0
5906,5906999,20.531446060529884,37.75968799207672,0.08661741215828378,2118.346364736557,457.27121591567993,1764.0347900390625,23951,5707,18244,18244,0,22,5907000.0
5907,5907999,20.530228536654775,37.757985938993535,0.08661781780797384,2118.7001192569733,457.3374545574188,1764.3718795776367,23952,5707,18245,18245,0,22,5908000.0
5908,5908999,20.529320596068192,37.75707231939717,0.0866142949081139,2118.917227745056,457.40446734428406,1765.2523574829102,23955,5707,18248,18248,0,22,5909000.0
5909,5909999,20.528255702770654,37.75513830314772,0.08661211905976984,2119.43692278862,457.47061038017273,1764.9109573364258,23965,5708,18257,18257,0,22,5910000.0
5910,5910999,20.527242210937498,37.75308138397352,0.08661379284865756,2119.844956636429,457.5394957065582,1765.0132141113281,23969,5710,18259,18259,0,22,5911000.0
5911,5911999,20.526124729167854,37.75093612989213,0.0866175411640645,2120.1458377838135,457.60717821121216,1765.4187469482422,23969,5710,18259,18259,0,22,5912000.0
5912,5912999,20.525374426432606,37.74953029688333,0.0866124446711446,2120.5680754184723,457.6778018474579,1765.535270690918,23973,5712,18261,18261,0,22,5913000.0
5913,5913999,20.524477059008596,37.74782017227265,0.0866103849855191,2120.879239320755,457.7454721927643,1765.8572006225586,23973,5712,18261,18261,0,22,5914000.0
5914,5914999,20.523933719278485,37.74902129356252,0.08659350299850188,2121.3343455791473,457.8127453327179,1765.8410415649414,23977,5714,18263,18263,0,22,5915000.0
5915,5915999,20.52330607337173,37.747889555878835,0.08659234747294375,2121.6649148464203,457.88098073005676,1766.1945190429688,23977,5714,18263,18263,0,22,5916000.0
5916,5916999,20.52296773097342,37.7472908808712,0.08658589475693423,2122.009047269821,457.94899582862854,1766.4226608276367,23977,5714,18263,18263,0,22,5917000.0
5917,5917999,20.522655308593805,37.74627300038565,0.0865818775298034,2122.350120782852,458.0175726413727,1766.6577606201172,23977,5714,18263,18263,0,22,5918000.0
5918,5918999,20.522544842147045,37.74601758821743,0.08658545458782663,2122.6310896873474,458.0835802555084,1767.1383743286133,23979,5715,18264,18264,0,22,5919000.0
5919,5919999,20.522651432474202,37.74734520173718,0.08658008466390721,2123.1939446926117,458.15074944496155,1766.4552993774414,23981,5716,18265,18265,0,22,5920000.0
5920,5920999,20.523061437747476,37.74741826103689,0.08658318305825752,2123.4800956249237,458.22047662734985,1767.0474243164062,23985,5717,18268,18268,0,22,5921000.0
5921,5921999,20.523431512103112,37.74747901524177,0.08659507355578644,2123.735950231552,458.28846073150635,1767.6022872924805,23985,5717,18268,18268,0,22,5922000.0
5922,5922999,20.523711365396995,37.74709117796276,0.08661392928498823,2124.2368190288544,458.35543608665466,1767.2257537841797,23989,5719,18270,18270,0,22,5923000.0
5923,5923999,20.52382777162063,37.74680887256081,0.08662038474885758,2124.706434726715,458.4247167110443,1767.0779037475586,23991,5720,18271,18271,0,22,5924000.0
5924,5924999,20.52399440463746,37.74628737946175,0.08662237588179666,2125.019725561142,458.49412727355957,1767.419204711914,23991,5720,18271,18271,0,22,5925000.0
5925,5925999,20.523486400429363,37.744852204135,0.0866335561090954,2125.548120737076,458.56312441825867,1767.3091888427734,23996,5721,18275,18275,0,22,5926000.0
5926,5926999,20.52193787083998,37.74238893672557,0.08664095249032522,2126.2292392253876,458.66110825538635,1767.2442016601562,23999,5721,18278,18278,0,22,5927000.0
5927,5927999,20.520737939050182,37.74068269547888,0.08663926988250148,2126.531302690506,458.72853779792786,1767.729347229004,23999,5721,18278,18278,0,22,5928000.0
5928,5928999,20.51963386230928,37.73902961546031,0.08663724466952649,2126.785742521286,458.79679346084595,1768.3542251586914,23999,5721,18278,18278,0,22,5929000.0
5929,5929999,20.51871562188345,37.73836508173194,0.08663251872183109,2127.333850622177,458.86622190475464,1767.7793045043945,24006,5724,18282,18282,0,22,5930000.0
5930,5930999,20.517893199204497,37.73662004123473,0.08662732428136732,2127.622697353363,458.934885263443,1768.4540252685547,24008,5725,18283,18283,0,22,5931000.0
5931,5931999,20.516918861792718,37.734728513847514,0.08662568358360534,2128.05069065094,459.00458312034607,1768.3382186889648,24008,5725,18283,18283,0,22,5932000.0
5932,5932999,20.516171151606148,37.73334618780277,0.08661770852968609,2128.438446044922,459.0751647949219,1768.3838424682617,24008,5725,18283,18283,0,22,5933000.0
5933,5933999,20.515356794215812,37.731467622339785,0.08661494412461412,2128.7324690818787,459.14381217956543,1768.8235397338867,24008,5725,18283,18283,0,22,5934000.0
5934,5934999,20.51498990128413,37.7304102537487,0.08660521407460697,2129.0865516662598,459.21588134765625,1768.984230041504,24008,5725,18283,18283,0,22,5935000.0
5935,5935999,20.515120762216764,37.730179057575036,0.08658535110177012,2129.4704406261444,459.28647661209106,1769.0649871826172,24008,5725,18283,18283,0,22,5936000.0
5936,5936999,20.515611145115294,37.73106954487949,0.08655880451673503,2129.8417434692383,459.3557639122009,1769.1509475708008,24008,5725,18283,18283,0,22,5937000.0
5937,5937999,20.516368746651086,37.73190726821291,0.08653541709230439,2130.557886838913,459.4279956817627,1768.0556411743164,24018,5728,18290,18290,0,22,5938000.0
5938,5938999,20.51712068772034,37.73253387353971,0.08651820271137789,2130.891684770584,459.49935722351074,1768.4695281982422,24028,5729,18299,18299,0,22,5939000.0
5939,5939999,20.517874643415425,37.73317521501272,0.0865035760572902,2131.3017592430115,459.572717666626,1768.5773468017578,24030,5730,18300,18300,0,22,5940000.0
5940,5940999,20.518843165705697,37.73412605311062,0.08649260660900082,2131.61088013649,459.645601272583,1769.0080261230469,24030,5730,18300,18300,0,22,5941000.0
5941,5941999,20.520265047290252,37.735374261451085,0.08648859083393334,2131.9889278411865,459.7165367603302,1769.1220092773438,24031,5731,18300,18300,0,22,5942000.0
5942,5942999,20.521432524755724,37.736104659027276,0.0864807902714686,2132.486131668091,459.79050278663635,1768.860969543457,24034,5733,18301,18301,0,22,5943000.0
5943,5943999,20.522481350086018,37.736483432543785,0.08646969763249746,2132.9201912879944,459.861453294754,1768.8920364379883,24036,5734,18302,18302,0,22,5944000.0
5944,5944999,20.523347473726144,37.73659285444452,0.0864622950629681,2133.3835101127625,459.93418526649475,1768.6876602172852,24038,5735,18303,18303,0,22,5945000.0
5945,5945999,20.524013645275172,37.73624605346321,0.08645176379048147,2133.766582965851,460.0067849159241,1768.9128875732422,24040,5736,18304,18304,0,22,5946000.0
5946,5946999,20.523151897997945,37.73464579791458,0.08644773696984553,2133.9274282455444,460.07575488090515,1770.5350875854492,24052,5736,18316,18316,0,22,5947000.0
5947,5947999,20.522184794329796,37.73303446634875,0.08644406841901997,2134.3774864673615,460.14846658706665,1770.9357299804688,24066,5738,18328,18328,0,22,5948000.0
5948,5948999,20.52150619154974,37.73214172468069,0.08643798609250086,2134.7326426506042,460.21960401535034,1771.4318008422852,24076,5739,18337,18337,0,22,5949000.0
5949,5949999,20.52072418419609,37.730401847599694,0.0864404444550202,2135.116941213608,460.28890109062195,1771.7491607666016,24081,5741,18340,18340,0,22,5950000.0
5950,5950999,20.519954312832024,37.72858912234902,0.08644271924999292,2135.465974330902,460.359215259552,1772.1572036743164,24084,5742,18342,18342,0,22,5951000.0
5951,5951999,20.519457882606833,37.728180700180026,0.0864369218665193,2135.8598713874817,460.42991304397583,1772.3146286010742,24086,5743,18343,18343,0,22,5952000.0
5952,5952999,20.518495206061413,37.726441772794,0.08643661098709843,2136.3348689079285,460.50040197372437,1772.2021102905273,24090,5745,18345,18345,0,22,5953000.0
5953,5953999,20.51780287736466,37.724831892313574,0.08643595606018695,2136.7665770053864,460.5733504295349,1772.4313735961914,24092,5746,18346,18346,0,22,5954000.0
5954,5954999,20.5173565629536,37.72400991432608,0.08643727113744415,2137.022902727127,460.64305305480957,1773.0263595581055,24092,5746,18346,18346,0,22,5955000.0
5955,5955999,20.51695616608794,37.72275125298205,0.08643720537942068,2137.4998586177826,460.71641993522644,1772.9218292236328,24092,5746,18346,18346,0,22,5956000.0
5956,5956999,20.516486883088344,37.721791222216794,0.08643325794470724,2137.8169906139374,460.7865560054779,1773.3111724853516,24092,5746,18346,18346,0,22,5957000.0
5957,5957999,20.51620865744313,37.72075521487102,0.08643295363299686,2138.19132399559,460.85857105255127,1773.4223022460938,24094,5747,18347,18347,0,22,5958000.0
5958,5958999,20.51614753679336,37.7208627786971,0.08642702671394209,2138.7628116607666,460.9324436187744,1772.8885345458984,24096,5748,18348,18348,0,22,5959000.0
5959,5959999,20.51636058330695,37.72102847130211,0.08642721057786551,2139.1501638889313,461.0031769275665,1773.1211547851562,24098,5749,18349,18349,0,22,5960000.0
5960,5960999,20.516308716057416,37.7204279404274,0.08642346217896002,2139.44882106781,461.07587242126465,1773.6534271240234,24100,5750,18350,18350,0,22,5961000.0
5961,5961999,20.516768122063723,37.72112974283822,0.08641793642062401,2139.9208199977875,461.14797377586365,1773.5788192749023,24102,5751,18351,18351,0,22,5962000.0
5962,5962999,20.51693898486711,37.720725796865295,0.08641892184582789,2140.5311212539673,461.22077345848083,1773.0784530639648,24106,5753,18353,18353,0,22,5963000.0
5963,5963999,20.517087028075757,37.72021884279936,0.08641721472621022,2140.926290988922,461.29252910614014,1773.218360900879,24106,5753,18353,18353,0,22,5964000.0
5964,5964999,20.517232771958376,37.719897778071285,0.08641021519974668,2141.35116314888,461.36447644233704,1773.3835983276367,24115,5754,18361,18361,0,22,5965000.0
5965,5965999,20.51782870379088,37.719863503271256,0.08640096395180774,2141.7066617012024,461.4372034072876,1773.6422958374023,24115,5754,18361,18361,0,22,5966000.0
5966,5966999,20.51744980426024,37.7185428298757,0.08639600648071555,2141.9657418727875,461.5079712867737,1774.3231964111328,24115,5754,18361,18361,0,22,5967000.0
5967,5967999,20.516794933856264,37.71807371229763,0.08638451324950436,2142.257843732834,461.5752167701721,1775.226676940918,24121,5754,18367,18367,0,22,5968000.0
5968,5968999,20.515760176619338,37.71599191516267,0.08638292161378947,2142.6964859962463,461.6433222293854,1775.4345626831055,24127,5755,18372,18372,0,22,5969000.0
5969,5969999,20.514764672481782,37.71393500297445,0.08638295510344296,2143.1412642002106,461.71307277679443,1775.6492309570312,24133,5758,18375,18375,0,22,5970000.0
5970,5970999,20.51436307597585,37.71266242658756,0.08637354732309022,2143.6782355308533,461.7825720310211,1775.3734817504883,24139,5760,18379,18379,0,22,5971000.0
5971,5971999,20.51410900701374,37.711757930385666,0.08635587434526915,2144.1940352916718,461.85182666778564,1775.4109115600586,24144,5762,18382,18382,0,22,5972000.0
5972,5972999,20.51396181860425,37.711001506839914,0.08633399648040663,2144.493363380432,461.92019724845886,1776.2169647216797,24146,5763,18383,18383,0,22,5973000.0
5973,5973999,20.51375249049081,37.712914852091025,0.08631028685779563,2144.8480381965637,461.98933148384094,1776.712013244629,24150,5764,18386,18386,0,22,5974000.0
5974,5974999,20.513367893400833,37.71148353177433,0.0862990827393898,2145.1173532009125,462.0567011833191,1777.5791549682617,24158,5765,18393,18393,0,22,5975000.0
5975,5975999,20.513182780139662,37.71044105631573,0.08629110616081292,2145.451423406601,462.1260952949524,1777.8871154785156,24161,5766,18395,18395,0,22,5976000.0
5976,5976999,20.51330849792645,37.71039325910997,0.08628268837548714,2145.846789598465,462.1936836242676,1777.973648071289,24161,5766,18395,18395,0,22,5977000.0
5977,5977999,20.513684968819387,37.710968419580645,0.0862874368258102,2146.3196008205414,462.26403069496155,1777.8396377563477,24163,5767,18396,18396,0,22,5978000.0
5978,5978999,20.514022973372082,37.7129113105785,0.08628815468512041,2146.653640270233,462.3323357105255,1778.5201873779297,24167,5769,18398,18398,0,22,5979000.0
5979,5979999,20.514479733664096,37.7134709116328,0.08628681847729658,2147.119776248932,462.4011011123657,1778.5067901611328,24171,5771,18400,18400,0,22,5980000.0
5980,5980999,20.51521146595646,37.71515812441674,0.08628404200904083,2147.6794023513794,462.48373222351074,1778.6168670654297,24233,5773,18460,18460,0,22,5981000.0
5981,5981999,20.51592001928759,37.716013996544504,0.08628058365267144,2147.994241476059,462.55141973495483,1779.0648880004883,24233,5773,18460,18460,0,22,5982000.0
5982,5982999,20.516745231320716,37.71732338094061,0.08629042470709325,2148.438185453415,462.62111043930054,1779.123664855957,24245,5775,18470,18470,0,22,5983000.0
5983,5983999,20.517615436039033,37.71839912626256,0.08629038741003037,2148.9607214927673,462.691472530365,1778.7741317749023,24247,5776,18471,18471,0,22,5984000.0
5984,5984999,20.518468577237346,37.71958094074124,0.08629835508636263,2149.445324420929,462.7600681781769,1778.6218338012695,24247,5776,18471,18471,0,22,5985000.0
5985,5985999,20.519627911307722,37.72109285314646,0.08630103486679508,2149.6948750019073,462.8356444835663,1779.4652709960938,24247,5776,18471,18471,0,22,5986000.0
5986,5986999,20.521079665788942,37.72328079747769,0.08631280319246404,2150.344432115555,462.905992269516,1778.8712539672852,24262,5780,18482,18482,0,22,5987000.0
5987,5987999,20.521462369847683,37.7230678728465,0.08631124691677217,2150.713476896286,463.02442145347595,1779.8425521850586,24262,5780,18482,18482,0,22,5988000.0
5988,5988999,20.520795827401436,37.72191857909691,0.08628960643008987,2151.022262573242,463.09347462654114,1780.769172668457,24275,5780,18495,18495,0,22,5989000.0
5989,5989999,20.519772071762368,37.72040823815025,0.08627957773612904,2151.3430149555206,463.1644866466522,1781.3630676269531,24278,5780,18498,18498,0,22,5990000.0
5990,5990999,20.51887516918096,37.71937176093737,0.08627273265814506,2151.754575252533,463.23447823524475,1781.613540649414,24284,5781,18503,18503,0,22,5991000.0
5991,5991999,20.517943240081728,37.71764145572202,0.08627274988258071,2151.9668395519257,463.3040363788605,1782.5081329345703,24287,5781,18506,18506,0,22,5992000.0
5992,5992999,20.51697149213736,37.71600036356607,0.08627064996266132,2152.3321454524994,463.37349152565,1782.6968841552734,24287,5781,18506,18506,0,22,5993000.0
5993,5993999,20.515950668696547,37.71410697548089,0.08627049605991022,2152.886690378189,463.44539403915405,1782.3360214233398,24318,5784,18534,18534,0,22,5994000.0
5994,5994999,20.51481810441713,37.71197605077956,0.08627371857891786,2153.3934082984924,463.51714849472046,1782.1949462890625,24324,5787,18537,18537,0,22,5995000.0
5995,5995999,20.514297023653874,37.71131987659156,0.08626283889076014,2153.885069131851,463.5884602069855,1782.0281143188477,24326,5788,18538,18538,0,22,5996000.0
5996,5996999,20.513692703010715,37.710277209036235,0.08625382238237866,2154.1958153247833,463.6647012233734,1782.5664291381836,24326,5788,18538,18538,0,22,5997000.0
5997,5997999,20.51322039219522,37.7094896143278,0.0862455352485405,2154.7897338867188,463.737487077713,1781.9002685546875,24328,5789,18539,18539,0,22,5998000.0
5998,5998999,20.512773108446204,37.70864153117424,0.08623943677747348,2155.4831523895264,463.85779452323914,1782.0503158569336,24332,5791,18541,18541,0,22,5999000.0
5999,5999999,20.51223931062243,37.70772212724122,0.08623871061646704,2155.7807354927063,463.9311821460724,1782.665412902832,24332,5791,18541,18541,0,22,6000000.0
6000,6000999,20.51191605412183,37.70700281941662,0.08624008492960011,2156.280569076538,464.00241923332214,1782.5370407104492,24351,5792,18559,18559,0,22,6001000.0
6001,6001999,20.511431647370074,37.70582010428583,0.08624000198570247,2156.7040870189667,464.0749583244324,1782.5965881347656,24351,5792,18559,18559,0,22,6002000.0
6002,6002999,20.51068396114754,37.704002122654096,0.08624611448142971,2157.0180802345276,464.145307302475,1783.2099609375,24353,5793,18560,18560,0,22,6003000.0
6003,6003999,20.50988277397708,37.702261066616934,0.08625516032484803,2157.40470290184,464.21912240982056,1783.4415664672852,24355,5794,18561,18561,0,22,6004000.0
6004,6004999,20.508835109443815,37.700057187181095,0.08626606777897827,2157.9855604171753,464.29085421562195,1782.9218521118164,24357,5795,18562,18562,0,22,6005000.0
6005,6005999,20.508812187785576,37.69929817282775,0.0862449319068157,2158.298291683197,464.36163568496704,1783.8395309448242,24364,5795,18569,18569,0,22,6006000.0
6006,6006999,20.508134453264397,37.697944786012435,0.08623918688461152,2158.608853816986,464.4319636821747,1784.7567672729492,24369,5796,18573,18573,0,22,6007000.0
6007,6007999,20.50776522306753,37.70451020417006,0.08620237570888567,2158.9707305431366,464.5007083415985,1785.2970581054688,24373,5798,18575,18575,0,22,6008000.0
6008,6008999,20.50749866460603,37.70706591068568,0.08619364876761904,2159.497904062271,464.5694878101349,1785.0443725585938,24378,5800,18578,18578,0,22,6009000.0
6009,6009999,20.50679325724815,37.70549581824173,0.08618826365359844,2159.858366727829,464.6375524997711,1785.274787902832,24378,5800,18578,18578,0,22,6010000.0
6010,6010999,20.505973020143653,37.70390288164954,0.08618616820442737,2160.549238920212,464.7082152366638,1784.515281677246,24388,5804,18584,18584,0,22,6011000.0
6011,6011999,20.505124381769384,37.70210464317203,0.08618467721408174,2160.845677137375,464.7779004573822,1785.0697326660156,24388,5804,18584,18584,0,22,6012000.0
6012,6012999,20.5044780177266,37.700774870454126,0.08618042746386978,2161.3455533981323,464.8788957595825,1785.4197616577148,24390,5805,18585,18585,0,22,6013000.0
6013,6013999,20.504050904949388,37.699619108692566,0.08617410841482454,2161.6214833259583,464.94730854034424,1785.9190979003906,24390,5805,18585,18585,0,22,6014000.0
6014,6014999,20.50354351868205,37.69846322944015,0.08616666130239647,2161.9625494480133,465.01608443260193,1786.0732803344727,24392,5806,18586,18586,0,22,6015000.0
6015,6015999,20.502961028244403,37.69724372326001,0.08616046947362854,2162.564888715744,465.0863296985626,1785.449317932129,24398,5809,18589,18589,0,22,6016000.0
6016,6016999,20.50246875664895,37.695794507507856,0.08615312225663241,2163.1037549972534,465.1555383205414,1785.2050704956055,24402,5811,18591,18591,0,22,6017000.0
6017,6017999,20.502219181425367,37.69499738385019,0.08614475765693985,2163.5135095119476,465.22778272628784,1785.3841857910156,24402,5811,18591,18591,0,22,6018000.0
6018,6018999,20.50204879094045,37.695605063425916,0.08613132625665276,2163.773264169693,465.29668831825256,1786.0658874511719,24402,5811,18591,18591,0,22,6019000.0
6019,6019999,20.501845886683867,37.694558037421785,0.08612478709047988,2164.1816086769104,465.3696231842041,1786.0561218261719,24402,5811,18591,18591,0,22,6020000.0
6020,6020999,20.501950992466124,37.694406195140594,0.08611272396668967,2164.474184513092,465.4381790161133,1786.472511291504,24402,5811,18591,18591,0,22,6021000.0
6021,6021999,20.50180034605394,37.6937859694547,0.08610305782876682,2165.069420814514,465.50966811180115,1785.9747848510742,24408,5814,18594,18594,0,22,6022000.0
6022,6022999,20.501535592038763,37.69262328796319,0.08609467621847855,2165.3590924739838,465.57994532585144,1786.5206604003906,24408,5814,18594,18594,0,22,6023000.0
6023,6023999,20.501169434835948,37.69104631341795,0.0860878683499704,2165.709933280945,465.65067052841187,1786.8530807495117,24409,5815,18594,18594,0,22,6024000.0
6024,6024999,20.500687347474962,37.68961579257736,0.08608016517249295,2165.9568350315094,465.7200057506561,1787.7714767456055,24414,5815,18599,18599,0,22,6025000.0
6025,6025999,20.500475489671185,37.68946407126549,0.0860562002904166,2166.3732883930206,465.78875517845154,1788.234977722168,24420,5816,18604,18604,0,22,6026000.0
6026,6026999,20.499543055875943,37.68735873627078,0.08604952775366437,2166.6819183826447,465.85728931427,1788.7371063232422,24421,5816,18605,18605,0,22,6027000.0
6027,6027999,20.49859366907965,37.6858686458544,0.08604445109398595,2167.0440785884857,465.926637172699,1789.0411376953125,24421,5816,18605,18605,0,22,6028000.0
6028,6028999,20.497767282126276,37.68395089734537,0.08604193705074703,2167.4278326034546,465.99527978897095,1789.2654190063477,24426,5818,18608,18608,0,22,6029000.0
6029,6029999,20.496925872968898,37.68240123154721,0.086034740554507,2167.937532186508,466.0669729709625,1788.8026428222656,24426,5818,18608,18608,0,22,6030000.0
6030,6030999,20.49641953586775,37.68161709802916,0.0860264813864795,2168.1872873306274,466.13681960105896,1789.4932327270508,24426,5818,18608,18608,0,22,6031000.0
6031,6031999,20.495731672679902,37.6797864082721,0.08602137972936175,2168.7080590724945,466.2060282230377,1789.2412796020508,24430,5820,18610,18610,0,22,6032000.0
6032,6032999,20.49487596797252,37.67777640566511,0.08601777166628322,2169.0807712078094,466.2751250267029,1789.5800552368164,24434,5822,18612,18612,0,22,6033000.0
6033,6033999,20.49428933129506,37.676222293324166,0.08601064404983982,2169.5126802921295,466.347154378891,1789.8799133300781,24497,5823,18674,18674,0,22,6034000.0
6034,6034999,20.493686023646948,37.67489364135972,0.08600579054080659,2169.756603717804,466.4157474040985,1790.9860534667969,24497,5823,18674,18674,0,22,6035000.0
6035,6035999,20.493138865552044,37.67326589733209,0.08600111135205102,2170.1322650909424,466.4848384857178,1791.3621673583984,24499,5824,18675,18675,0,22,6036000.0
6036,6036999,20.492743894231623,37.67188376238746,0.08599826082906115,2170.484205722809,466.55411028862,1791.7792053222656,24501,5825,18676,18676,0,22,6037000.0
6037,6037999,20.49226735132002,37.670799244562936,0.08599437817510813,2171.051377058029,466.6250193119049,1791.4806900024414,24507,5828,18679,18679,0,22,6038000.0
6038,6038999,20.491805579890148,37.66942932993793,0.0859909899412189,2171.512387275696,466.69676518440247,1791.5680389404297,24511,5830,18681,18681,0,22,6039000.0
6039,6039999,20.491110074121707,37.66785685128627,0.08599384646902752,2172.0267963409424,466.76835322380066,1791.640998840332,24515,5832,18683,18683,0,22,6040000.0
6040,6040999,20.49028824407805,37.66605488046315,0.08600007685127087,2172.2748639583588,466.8378210067749,1792.5068054199219,24515,5832,18683,18683,0,22,6041000.0
6041,6041999,20.489810486268045,37.664746290910124,0.08600093793816288,2172.6265313625336,466.90806674957275,1792.9723815917969,24517,5833,18684,18684,0,22,6042000.0
6042,6042999,20.48900912641414,37.662846467709784,0.08601097758349963,2173.0705211162567,466.98077869415283,1792.9963760375977,24519,5834,18685,18685,0,22,6043000.0
6043,6043999,20.48830345810167,37.66114937572954,0.0860162859666137,2173.5627381801605,467.0510938167572,1793.0255584716797,24551,5836,18715,18715,0,22,6044000.0
6044,6044999,20.487573342636964,37.65943867659667,0.0860239212042464,2173.9121568202972,467.12098932266235,1793.382911682129,24551,5836,18715,18715,0,22,6045000.0
6045,6045999,20.486670339546002,37.65730675628207,0.08603213699366064,2174.2092475891113,467.18945574760437,1794.261589050293,24557,5837,18720,18720,0,22,6046000.0
6046,6046999,20.48557570413598,37.65645013376105,0.08603479043378792,2174.401956319809,467.25592827796936,1795.6006774902344,24567,5837,18730,18730,0,22,6047000.0
6047,6047999,20.484204466848187,37.65491380018451,0.08604243962589386,2174.83868932724,467.3247697353363,1795.7315216064453,24572,5839,18733,18733,0,22,6048000.0
6048,6048999,20.482707386100888,37.65253151059499,0.08605776694198874,2175.0730237960815,467.3913631439209,1796.5148544311523,24573,5839,18734,18734,0,22,6049000.0
6049,6049999,20.481388976208354,37.65049300733043,0.08606964864868183,2175.363447666168,467.45854139328003,1797.1158142089844,24576,5840,18736,18736,0,22,6050000.0
6050,6050999,20.480171748883567,37.64818374564139,0.08607730982244077,2175.8414747714996,467.52615785598755,1796.8046875,24577,5840,18737,18737,0,22,6051000.0
6051,6051999,20.47885515495011,37.645982411409975,0.08609221386251353,2176.1044352054596,467.5940668582916,1797.454978942871,24578,5840,18738,18738,0,22,6052000.0
6052,6052999,20.477591138550743,37.64367596877705,0.0861065681312384,2176.5350592136383,467.6608672142029,1797.3367233276367,24580,5841,18739,18739,0,22,6053000.0
6053,6053999,20.476338261263816,37.641462223548615,0.08611706351679038,2176.994495153427,467.7309374809265,1797.1667251586914,24584,5843,18741,18741,0,22,6054000.0
6054,6054999,20.475249721940266,37.639442664436686,0.0861293293844988,2177.2452726364136,467.79809045791626,1797.8128280639648,24585,5843,18742,18742,0,22,6055000.0
6055,6055999,20.47407809252705,37.63730448371046,0.0861435996743336,2177.496681690216,467.8662941455841,1798.3717651367188,24585,5843,18742,18742,0,22,6056000.0
6056,6056999,20.472878468174628,37.63518660508805,0.08615632458047562,2178.3207726478577,467.93579149246216,1796.9735412597656,24593,5847,18746,18746,0,22,6057000.0
6057,6057999,20.47170730374927,37.63311837504002,0.08616937129089708,2178.674600124359,468.0031774044037,1797.375877380371,24593,5847,18746,18746,0,22,6058000.0
6058,6058999,20.470347469995346,37.63071928861411,0.08618427805626538,2178.895924091339,468.0699362754822,1798.0760116577148,24593,5847,18746,18746,0,22,6059000.0
6059,6059999,20.469109166717043,37.62883857327958,0.08619641644747167,2179.411246061325,468.1375479698181,1797.5672912597656,24595,5848,18747,18747,0,22,6060000.0
6060,6060999,20.46806514038409,37.62719615776181,0.08620678623395406,2179.7997765541077,468.2098593711853,1797.787582397461,24599,5849,18750,18750,0,22,6061000.0
6061,6061999,20.46705810254451,37.62528466460748,0.0862111980550333,2180.190464258194,468.27720165252686,1797.8915176391602,24601,5850,18751,18751,0,22,6062000.0
6062,6062999,20.466379305114533,37.6242516072631,0.08621266986803877,2180.5746762752533,468.34515833854675,1798.0208892822266,24603,5851,18752,18752,0,22,6063000.0
6063,6063999,20.465501304681112,37.62301518509582,0.08621912331882997,2180.9274518489838,468.4163272380829,1798.236701965332,24603,5851,18752,18752,0,22,6064000.0
6064,6064999,20.4646219596871,37.62145328072265,0.08623027997687516,2181.2611055374146,468.48518466949463,1798.5622100830078,24605,5852,18753,18753,0,22,6065000.0
6065,6065999,20.463413638737727,37.619195794468624,0.08624651998438726,2181.604812860489,468.5533592700958,1798.8294372558594,24605,5852,18753,18753,0,22,6066000.0
6066,6066999,20.462688611640367,37.61724714982247,0.08624510339885283,2182.1805760860443,468.6232726573944,1798.5903854370117,24609,5854,18755,18755,0,22,6067000.0
6067,6067999,20.461477931531007,37.615054454295326,0.08624841121853788,2182.5220351219177,468.70086789131165,1799.0864639282227,24610,5854,18756,18756,0,22,6068000.0
6068,6068999,20.4606693340987,37.61355984093803,0.08624652170816427,2182.9439449310303,468.7713372707367,1799.0693664550781,24610,5854,18756,18756,0,22,6069000.0
6069,6069999,20.459718275760846,37.61157859395246,0.08625141105371414,2183.26664352417,468.8425681591034,1799.513198852539,24610,5854,18756,18756,0,22,6070000.0
6070,6070999,20.459160335070816,37.61016441048642,0.08624714395935973,2183.6475484371185,468.912317276001,1799.8247528076172,24612,5855,18757,18757,0,22,6071000.0
6071,6071999,20.45833732440762,37.60826256714252,0.08624824494880878,2184.199323415756,468.9819211959839,1799.3496322631836,24614,5856,18758,18758,0,22,6072000.0
6072,6072999,20.457709283299618,37.60674729477142,0.08624559125535303,2184.5274851322174,469.0513391494751,1799.6884002685547,24616,5857,18759,18759,0,22,6073000.0
6073,6073999,20.45708491441683,37.60517163925364,0.08624634385382135,2184.841001033783,469.1218373775482,1800.127426147461,24616,5857,18759,18759,0,22,6074000.0
6074,6074999,20.456707844776535,37.60396576470452,0.0862421486926338,2185.5184528827667,469.1931755542755,1799.2924423217773,24622,5860,18762,18762,0,22,6075000.0
6075,6075999,20.456072970944884,37.602718745303214,0.08624372114495182,2185.9885590076447,469.2637686729431,1799.1846466064453,24624,5861,18763,18763,0,22,6076000.0
6076,6076999,20.455363445457298,37.601098908867286,0.08624575300698634,2186.202998161316,469.3338780403137,1800.038917541504,24624,5861,18763,18763,0,22,6077000.0
6077,6077999,20.45464349556104,37.599377453169375,0.08624980282978778,2186.704845428467,469.4076385498047,1799.6820220947266,24628,5863,18765,18765,0,22,6078000.0
6078,6078999,20.453832490964363,37.59754922171787,0.08625635141010546,2187.0183482170105,469.4787542819977,1800.0744323730469,24628,5863,18765,18765,0,22,6079000.0
6079,6079999,20.452917104352625,37.595647399417835,0.0862656562623122,2187.594378232956,469.5500240325928,1799.372947692871,24628,5863,18765,18765,0,22,6080000.0
6080,6080999,20.45210971001222,37.59382125021822,0.08627636036055653,2188.110612630844,469.6215534210205,1799.1180877685547,24630,5864,18766,18766,0,22,6081000.0
6081,6081999,20.451217929839945,37.59181583971356,0.08628448514014975,2188.356142282486,469.6940243244171,1799.945068359375,24630,5864,18766,18766,0,22,6082000.0
6082,6082999,20.45031922211274,37.58995889449507,0.08629388771399582,2188.7126863002777,469.76264667510986,1800.1948928833008,24632,5865,18767,18767,0,22,6083000.0
6083,6083999,20.44962033875307,37.58902446795582,0.08629714246054421,2189.142449617386,469.8343322277069,1800.1373901367188,24636,5867,18769,18769,0,22,6084000.0
6084,6084999,20.44865577452941,37.58701181013142,0.0863091524192604,2189.5368621349335,469.90538001060486,1800.1963729858398,24636,5867,18769,18769,0,22,6085000.0
6085,6085999,20.447479420181075,37.58481559617298,0.08632313146546722,2189.9257259368896,469.9749195575714,1800.298927307129,24636,5867,18769,18769,0,22,6086000.0
6086,6086999,20.44666720847116,37.58297658403308,0.08631693664533835,2190.330764770508,470.04795932769775,1801.3332443237305,24658,5870,18788,18788,0,22,6087000.0
6087,6087999,20.445565936935644,37.5812067720591,0.08629996770602233,2190.5759353637695,470.11941504478455,1802.4911727905273,24661,5870,18791,18791,0,22,6088000.0
6088,6088999,20.44447562511505,37.579855712413256,0.08628804710579208,2190.774682998657,470.1899404525757,1803.5642776489258,24664,5870,18794,18794,0,22,6089000.0
6089,6089999,20.443522521690582,37.57808635654097,0.08629157601303472,2191.2574343681335,470.2619767189026,1803.7575149536133,24682,5873,18809,18809,0,22,6090000.0
6090,6090999,20.442523841666333,37.57613399410107,0.08628321689269947,2191.717343568802,470.3342549800873,1804.09033203125,24693,5876,18817,18817,0,22,6091000.0
6091,6091999,20.44136820294346,37.57408987619723,0.08627943024674589,2192.0409283638,470.40696454048157,1804.6231384277344,24697,5876,18821,18821,0,22,6092000.0
6092,6092999,20.440432452617582,37.57345603953294,0.08626969356663128,2192.394631385803,470.48114252090454,1805.0456924438477,24701,5877,18824,18824,0,22,6093000.0
6093,6093999,20.43962217001172,37.57182852699753,0.08626151013690608,2192.7837471961975,470.55408787727356,1805.2587966918945,24707,5878,18829,18829,0,22,6094000.0
6094,6094999,20.438766949510487,37.56991528842427,0.08625343114015538,2193.2144243717194,470.6271197795868,1805.3766708374023,24712,5880,18832,18832,0,22,6095000.0
6095,6095999,20.438069020631218,37.568358738528666,0.0862415606674376,2193.673110961914,470.70125222206116,1805.4459228515625,24723,5882,18841,18841,0,22,6096000.0
6096,6096999,20.437256110018097,37.566552324299224,0.08624008099710534,2194.0112879276276,470.7733664512634,1805.9677429199219,24725,5883,18842,18842,0,22,6097000.0
6097,6097999,20.436508253285893,37.564750856776705,0.0862342698134817,2194.545821905136,470.8459017276764,1805.7169494628906,24739,5886,18853,18853,0,22,6098000.0
6098,6098999,20.435604326380798,37.563183796561844,0.08623356562704554,2195.097269296646,470.91736245155334,1805.269416809082,24744,5888,18856,18856,0,22,6099000.0
6099,6099999,20.43475160077945,37.56161450176141,0.08623529953541254,2195.508420944214,470.98978209495544,1805.465087890625,24759,5889,18870,18870,0,22,6100000.0
6100,6100999,20.433834190069927,37.559798685675815,0.08623474482418636,2196.002162218094,471.0609378814697,1805.7207641601562,24767,5892,18875,18875,0,22,6101000.0
6101,6101999,20.433129483316726,37.558128563468905,0.08623288813585028,2196.3588314056396,471.1315803527832,1806.1979446411133,24771,5894,18877,18877,0,22,6102000.0
6102,6102999,20.432284324691103,37.55631059479766,0.0862318002260325,2196.7017064094543,471.2014603614807,1806.7186584472656,24773,5895,18878,18878,0,22,6103000.0
6103,6103999,20.43175406977975,37.55505841106734,0.08622678061142519,2196.948632955551,471.2704508304596,1807.4861450195312,24776,5896,18880,18880,0,22,6104000.0
6104,6104999,20.430913008664067,37.554333780855046,0.08622196608545118,2197.308694124222,471.3436357975006,1807.6581382751465,24777,5896,18881,18881,0,22,6105000.0
6105,6105999,20.42997908260985,37.55238993407969,0.08622408069328091,2197.7171263694763,471.41438579559326,1807.849323272705,24782,5898,18884,18884,0,22,6106000.0
6106,6106999,20.42907812790284,37.55052143148689,0.08622359642356503,2198.1420052051544,471.48621797561646,1807.8878364562988,24784,5899,18885,18885,0,22,6107000.0
6107,6107999,20.428277894134684,37.54913109536327,0.08621679803812377,2198.359534740448,471.55051445961,1809.2370948791504,24797,5900,18897,18897,0,22,6108000.0
6108,6108999,20.427320627688033,37.54811980467125,0.08620681637161831,2198.6349182128906,471.6155581474304,1810.0445442199707,24799,5900,18899,18899,0,22,6109000.0
6109,6109999,20.426406686886526,37.546272102894285,0.08619353408382091,2199.0302555561066,471.68030309677124,1810.323413848877,24808,5902,18906,18906,0,22,6110000.0
6110,6110999,20.42588998403944,37.54457650710469,0.08617461085576084,2199.399620771408,471.74438858032227,1810.5908241271973,24809,5902,18907,18907,0,22,6111000.0
6111,6111999,20.425948836460826,37.54376185486002,0.08613553802348806,2199.716371536255,471.8083555698395,1811.2079582214355,24816,5904,18912,18912,0,22,6112000.0
6112,6112999,20.426110007197313,37.54289570962783,0.08609956945850705,2200.0908303260803,471.8759038448334,1811.6509895324707,24829,5906,18923,18923,0,22,6113000.0
6113,6113999,20.42605437235766,37.541799972035335,0.08607327599434078,2200.5532076358795,471.94307041168213,1811.7678260803223,24833,5908,18925,18925,0,22,6114000.0
6114,6114999,20.425790157225485,37.540416532326226,0.08605146093104044,2200.902135372162,472.0086843967438,1812.3041648864746,24838,5910,18928,18928,0,22,6115000.0
6115,6115999,20.425460984371824,37.53887294012624,0.0860320092175334,2201.3032445907593,472.0748267173767,1812.7532234191895,24846,5913,18933,18933,0,22,6116000.0
6116,6116999,20.425257757217178,37.53790969295273,0.08601125551747801,2201.806966304779,472.1422710418701,1812.792064666748,24854,5916,18938,18938,0,22,6117000.0
6117,6117999,20.424927820074863,37.536486642994674,0.08599321303704566,2202.083865880966,472.20655846595764,1813.4112129211426,24856,5917,18939,18939,0,22,6118000.0
6118,6118999,20.424829757783304,37.535403378447896,0.08596839225451114,2202.694675922394,472.2779893875122,1813.1747093200684,24897,5922,18975,18975,0,22,6119000.0
6119,6119999,20.424472568124493,37.53423311424599,0.08595549603459163,2203.001789331436,472.345796585083,1813.7485313415527,24899,5923,18976,18976,0,22,6120000.0
6120,6120999,20.42403166952193,37.53282010692963,0.08594480183960451,2203.465349674225,472.41401076316833,1813.6647987365723,24903,5925,18978,18978,0,22,6121000.0
6121,6121999,20.42377723560944,37.53175083945824,0.08593293390556389,2203.8964591026306,472.4820554256439,1813.5585441589355,24903,5925,18978,18978,0,22,6122000.0
6122,6122999,20.42340553924951,37.53070996845566,0.08591937863313681,2204.191963195801,472.54660844802856,1814.2044868469238,24906,5926,18980,18980,0,22,6123000.0
6123,6123999,20.423106890905927,37.52952842379755,0.08590975961180924,2204.767880678177,472.61471009254456,1813.8237113952637,24912,5929,18983,18983,0,22,6124000.0
6124,6124999,20.42282307059949,37.52831003659276,0.08590031567783707,2205.057989358902,472.6803698539734,1814.3016166687012,24912,5929,18983,18983,0,22,6125000.0
6125,6125999,20.422340179450195,37.52681300862071,0.08589760580953298,2205.3069162368774,472.7485342025757,1814.9722862243652,24912,5929,18983,18983,0,22,6126000.0
6126,6126999,20.42200456554789,37.525454325011346,0.08589145772746143,2205.635231256485,472.81419944763184,1815.34037399292,24915,5930,18985,18985,0,22,6127000.0
6127,6127999,20.42144899958285,37.52429880850513,0.08588482571275335,2206.151835680008,472.88378143310547,1815.152530670166,24920,5932,18988,18988,0,22,6128000.0
6128,6128999,20.42066541584944,37.52269123775999,0.08588236202837995,2206.481008529663,472.9522728919983,1816.0163688659668,24928,5932,18996,18996,0,22,6129000.0
6129,6129999,20.419969268074677,37.52121868291259,0.08587533256826707,2206.8148601055145,473.02131938934326,1816.6174583435059,24932,5933,18999,18999,0,22,6130000.0
6130,6130999,20.419374845163848,37.51940201719794,0.08586647597536523,2207.222912311554,473.0886797904968,1816.8093528747559,24937,5934,19003,19003,0,22,6131000.0
6131,6131999,20.418807653169104,37.518476047881315,0.08585910454048062,2207.4760506153107,473.15660071372986,1817.4584007263184,24938,5934,19004,19004,0,22,6132000.0
6132,6132999,20.41808091097051,37.517262641810035,0.08585364920817828,2207.810240983963,473.22650718688965,1817.6812477111816,24938,5934,19004,19004,0,22,6133000.0
6133,6133999,20.417135846920996,37.51530539572681,0.08585581339044179,2208.185030937195,473.2954957485199,1817.7548789978027,24938,5934,19004,19004,0,22,6134000.0
6134,6134999,20.416229220331623,37.513779546826306,0.0858568125821153,2208.60227060318,473.3642632961273,1817.8390464782715,24941,5935,19006,19006,0,22,6135000.0
6135,6135999,20.415255242401546,37.51162307855906,0.08586246231940198,2208.9729130268097,473.43325901031494,1818.0303001403809,24944,5936,19008,19008,0,22,6136000.0
6136,6136999,20.414195149193418,37.509450079404736,0.08586956164742243,2209.2917478084564,473.50068187713623,1818.3421516418457,24944,5936,19008,19008,0,22,6137000.0
6137,6137999,20.41333498680633,37.50746083847756,0.08587444471500061,2209.6502690315247,473.5692808628082,1818.4686164855957,24944,5936,19008,19008,0,22,6138000.0
6138,6138999,20.412621095054288,37.50576327482095,0.08587778394243029,2210.006588935852,473.6418924331665,1818.6256408691406,24945,5936,19009,19009,0,22,6139000.0
6139,6139999,20.41165025213832,37.50370381633724,0.08588727445753275,2210.3364658355713,473.71064043045044,1818.8417663574219,24945,5936,19009,19009,0,22,6140000.0
6140,6140999,20.41083107960061,37.501680804817966,0.0858961697238021,2210.6936223506927,473.7801311016083,1818.9783477783203,24947,5937,19010,19010,0,22,6141000.0
6141,6141999,20.410072079537457,37.49982958315483,0.0859064585382594,2210.9878211021423,473.8496448993683,1819.3819580078125,24947,5937,19010,19010,0,22,6142000.0
6142,6142999,20.40912213829844,37.49777094216582,0.08591748710447356,2211.5194103717804,473.9181306362152,1818.9676818847656,24952,5939,19013,19013,0,22,6143000.0
6143,6143999,20.40803545014452,37.4955234093215,0.0859328668671977,2212.0516135692596,473.9867696762085,1818.5536499023438,24958,5942,19016,19016,0,22,6144000.0
6144,6144999,20.407215404306278,37.49523696758097,0.08593673963628845,2212.529939889908,474.0563635826111,1818.3747253417969,24961,5942,19019,19019,0,22,6145000.0
6145,6145999,20.406293655829373,37.49362697880165,0.08594218963229483,2213.0267927646637,474.1232421398163,1818.4508438110352,24968,5942,19026,19026,0,22,6146000.0
6146,6146999,20.40525095144831,37.49196542515424,0.08595371712955946,2213.272238254547,474.1928434371948,1819.4333190917969,24974,5942,19032,19032,0,22,6147000.0
6147,6147999,20.40434745206332,37.490730495608084,0.085959031325188,2213.5200638771057,474.26151394844055,1820.387435913086,24976,5943,19033,19033,0,22,6148000.0
6148,6148999,20.403394935390956,37.488900641196295,0.08596621860101683,2213.84375166893,474.3280441761017,1820.7781372070312,24979,5944,19035,19035,0,22,6149000.0
6149,6149999,20.402478923158572,37.487172160672564,0.08597093160356706,2214.213402032852,474.3945574760437,1820.9267578125,24982,5945,19037,19037,0,22,6150000.0
6150,6150999,20.4015524910574,37.48528495476639,0.0859717226032517,2214.7954988479614,474.46126079559326,1820.6096725463867,24994,5949,19045,19045,0,22,6151000.0
6151,6151999,20.400432977333548,37.48322514477924,0.085977317142504,2215.256001472473,474.5286295413971,1820.639633178711,24999,5951,19048,19048,0,22,6152000.0
6152,6152999,20.39963223941389,37.482257838344495,0.0859753483029373,2215.6626102924347,474.5961663722992,1820.8890838623047,25005,5953,19052,19052,0,22,6153000.0
6153,6153999,20.398612731873577,37.480337074340305,0.085976138534124,2216.0638065338135,474.6647434234619,1821.0422897338867,25008,5954,19054,19054,0,22,6154000.0
6154,6154999,20.39793098443317,37.479210327064784,0.08597873830848834,2216.3547360897064,474.73344683647156,1821.5825958251953,25010,5955,19055,19055,0,22,6155000.0
6155,6155999,20.39703417991694,37.47770916752975,0.08597836150495042,2217.004306793213,474.8068265914917,1820.7970123291016,25022,5957,19065,19065,0,22,6156000.0
6156,6156999,20.3958906344054,37.475604046545385,0.08598133854560552,2217.3199591636658,474.87413263320923,1821.2739028930664,25025,5958,19067,19067,0,22,6157000.0
6157,6157999,20.39515558745266,37.474163525119785,0.08598125845146776,2217.666446685791,474.94353342056274,1821.4831237792969,25025,5958,19067,19067,0,22,6158000.0
6158,6158999,20.39442210576836,37.47269905841364,0.08597883327042954,2218.0239329338074,475.0098421573639,1821.7158737182617,25025,5958,19067,19067,0,22,6159000.0
6159,6159999,20.393591866319714,37.471096852716784,0.08597874141581996,2218.5436515808105,475.07800364494324,1821.4556274414062,25033,5961,19072,19072,0,22,6160000.0
6160,6160999,20.39303867359618,37.46983898966646,0.08597443846229336,2218.94984459877,475.1455783843994,1821.6011047363281,25035,5962,19073,19073,0,22,6161000.0
6161,6161999,20.392328795237745,37.4682095694259,0.0859690194133712,2219.288135290146,475.21264457702637,1821.8453216552734,25035,5962,19073,19073,0,22,6162000.0
6162,6162999,20.391604360331026,37.466695521201906,0.08596675173366541,2219.784121990204,475.2811350822449,1821.5223083496094,25038,5964,19074,19074,0,22,6163000.0
6163,6163999,20.390829683896374,37.46503426580952,0.0859645219276679,2220.1126494407654,475.3485074043274,1821.8736953735352,25038,5964,19074,19074,0,22,6164000.0
6164,6164999,20.389823102590604,37.462870961370086,0.0859713575048704,2220.363540172577,475.4174761772156,1822.8524017333984,25047,5964,19083,19083,0,22,6165000.0
6165,6165999,20.388837042128095,37.46227735720912,0.08597092013415919,2220.5914833545685,475.4835274219513,1824.0220413208008,25052,5964,19088,19088,0,22,6166000.0
6166,6166999,20.387842050786784,37.46057525303343,0.08597290477921293,2220.9114124774933,475.54904532432556,1824.6845016479492,25056,5965,19091,19091,0,22,6167000.0
6167,6167999,20.38674387334141,37.45862542490477,0.0859761948323432,2221.2546212673187,475.61481070518494,1825.3034133911133,25061,5967,19094,19094,0,22,6168000.0
6168,6168999,20.385944526049666,37.457105071014915,0.08597475139965327,2221.4756219387054,475.6802337169647,1826.0704193115234,25061,5967,19094,19094,0,22,6169000.0
6169,6169999,20.384963711611785,37.45583317269363,0.08597543826080556,2221.959201335907,475.7498183250427,1825.8310317993164,25065,5969,19096,19096,0,22,6170000.0
6170,6170999,20.383946856310725,37.453845075845486,0.08597815751453897,2222.2634801864624,475.81745314598083,1826.2877655029297,25068,5970,19098,19098,0,22,6171000.0
6171,6171999,20.382939732071375,37.45201445329231,0.08598275227998109,2222.700645685196,475.88620233535767,1826.2240371704102,25072,5972,19100,19100,0,22,6172000.0
6172,6172999,20.381948932259697,37.45021871153993,0.08598521554477656,2223.236163854599,475.9538631439209,1825.7148208618164,25078,5974,19104,19104,0,22,6173000.0
6173,6173999,20.380851955121813,37.44815126283688,0.08598513626214999,2223.6079766750336,476.02181243896484,1825.9506912231445,25088,5975,19113,19113,0,22,6174000.0
6174,6174999,20.380175935011042,37.44912975466174,0.08596521467784879,2223.969462156296,476.091326713562,1826.302345275879,25090,5976,19114,19114,0,22,6175000.0
6175,6175999,20.3793723402583,37.44745758856861,0.08596031622716382,2224.3771464824677,476.159455537796,1826.3532943725586,25094,5978,19116,19116,0,22,6176000.0
6176,6176999,20.37888440277522,37.44650106413644,0.08594623028658377,2224.8670449256897,476.2280304431915,1826.0728912353516,25096,5979,19117,19117,0,22,6177000.0
6177,6177999,20.378172126972466,37.44515506307782,0.08594020097527444,2225.1704545021057,476.2998948097229,1826.6643676757812,25099,5980,19119,19119,0,22,6178000.0
6178,6178999,20.378231904789466,37.444910554089255,0.0859215659438135,2225.5918951034546,476.3693616390228,1826.473518371582,25099,5980,19119,19119,0,22,6179000.0
6179,6179999,20.378092452132215,37.44442344347082,0.0859106141065954,2225.926685810089,476.43688130378723,1827.1518096923828,25117,5982,19135,19135,0,22,6180000.0
6180,6180999,20.37805219031035,37.44414418734028,0.08590404208689617,2226.5312292575836,476.50523710250854,1826.7890853881836,25126,5985,19141,19141,0,22,6181000.0
6181,6181999,20.378361885324043,37.44470839077923,0.08588890192333642,2226.823277950287,476.58752942085266,1827.4838104248047,25126,5985,19141,19141,0,22,6182000.0
6182,6182999,20.378574856134158,37.44479584292191,0.08587660130400454,2227.1045939922333,476.65588307380676,1828.1206283569336,25128,5986,19142,19142,0,22,6183000.0
6183,6183999,20.378281593313343,37.44366631125204,0.08587952354799544,2227.5307693481445,476.7256302833557,1828.081558227539,25130,5987,19143,19143,0,22,6184000.0
6184,6184999,20.37784516544635,37.44238204709977,0.08587871441561368,2227.8374762535095,476.7928419113159,1828.5104751586914,25130,5987,19143,19143,0,22,6185000.0
6185,6185999,20.377217673609717,37.44079111417001,0.08587653564690434,2228.1378931999207,476.85849046707153,1829.2160720825195,25142,5987,19155,19155,0,22,6186000.0
6186,6186999,20.376333722431713,37.4389495404563,0.08586056555277166,2228.3865954875946,476.9261567592621,1830.4320755004883,25148,5987,19161,19161,0,22,6187000.0
6187,6187999,20.375608515377056,37.43799239659385,0.08584133694981455,2228.6969423294067,476.9973726272583,1831.1764221191406,25153,5988,19165,19165,0,22,6188000.0
6188,6188999,20.37473805942825,37.43685273484073,0.0858322473739701,2228.9747269153595,477.0619993209839,1832.0081024169922,25156,5989,19167,19167,0,22,6189000.0
6189,6189999,20.373773745605718,37.43480188885016,0.08582799846176159,2229.3946466445923,477.12721514701843,1832.0289916992188,25161,5991,19170,19170,0,22,6190000.0
6190,6190999,20.37278755224523,37.432913571662425,0.08582138709339326,2230.006089925766,477.19514417648315,1831.5320434570312,25170,5995,19175,19175,0,22,6191000.0
6191,6191999,20.371911087804474,37.43110936927653,0.08581381473058525,2230.382476568222,477.26006507873535,1832.027099609375,25174,5997,19177,19177,0,22,6192000.0
6192,6192999,20.371161928180385,37.42934578557719,0.08580900342827913,2230.5729327201843,477.3246626853943,1832.9935607910156,25174,5997,19177,19177,0,22,6193000.0
6193,6193999,20.370272133267374,37.427362649494796,0.08580918996934606,2230.883671283722,477.39110040664673,1833.4579696655273,25176,5998,19178,19178,0,22,6194000.0
6194,6194999,20.3694999736258,37.42570276393246,0.0858069522868089,2231.344628095627,477.4587371349335,1833.3384170532227,25182,6000,19182,19182,0,22,6195000.0
6195,6195999,20.368675871442882,37.42397151175909,0.08581273246990795,2231.937251329422,477.53481578826904,1832.981803894043,25216,6002,19214,19214,0,22,6196000.0
6196,6196999,20.368127467368303,37.42252178895542,0.0858173525003374,2232.315056324005,477.60137128829956,1833.1379699707031,25218,6003,19215,19215,0,22,6197000.0
6197,6197999,20.367384127461303,37.42079142318417,0.08582439953671661,2232.854804992676,477.66954159736633,1832.8712310791016,25226,6006,19220,19220,0,22,6198000.0
6198,6198999,20.366614601052444,37.41898121835608,0.08583192579655763,2233.0509078502655,477.73540139198303,1833.6981887817383,25226,6006,19220,19220,0,22,6199000.0
6199,6199999,20.36621206195203,37.41788872012103,0.08583320123624683,2233.4544973373413,477.8012230396271,1833.8188247680664,25226,6006,19220,19220,0,22,6200000.0
6200,6200999,20.36587061372851,37.41667178048598,0.08584208110212366,2233.698924779892,477.86610746383667,1834.6473770141602,25228,6007,19221,19221,0,22,6201000.0
6201,6201999,20.365485950884324,37.41656304698835,0.08584946202411214,2233.9929327964783,477.9309298992157,1834.9817123413086,25228,6007,19221,19221,0,22,6202000.0
6202,6202999,20.36506300716218,37.415200757614905,0.0858578620452588,2234.695651769638,477.99566674232483,1833.758285522461,25233,6009,19224,19224,0,22,6203000.0
6203,6203999,20.364921277343363,37.414103706182125,0.08585908280568921,2235.0573496818542,478.06336736679077,1834.1983947753906,25238,6011,19227,19227,0,22,6204000.0
6204,6204999,20.364410231512792,37.41251878039002,0.08586615291948385,2235.6267116069794,478.13079857826233,1833.6581115722656,25243,6013,19230,19230,0,22,6205000.0
6205,6205999,20.36370883801252,37.410630560800044,0.08586890535584935,2235.7964491844177,478.1963138580322,1834.6590881347656,25243,6013,19230,19230,0,22,6206000.0
6206,6206999,20.36344516988253,37.40894552314568,0.08584930946196978,2236.111414909363,478.2633738517761,1835.5031204223633,25254,6014,19240,19240,0,22,6207000.0
6207,6207999,20.362965297694107,37.40732599649257,0.08582741461186272,2236.5110087394714,478.33118748664856,1835.9311599731445,25259,6016,19243,19243,0,22,6208000.0
6208,6208999,20.362410511126267,37.40577451300231,0.0858129077980595,2236.750099658966,478.3971748352051,1836.7044296264648,25262,6017,19245,19245,0,22,6209000.0
6209,6209999,20.361713674926083,37.40403872135441,0.08579590786563762,2237.4232749938965,478.4664878845215,1836.1341400146484,25274,6022,19252,19252,0,22,6210000.0
6210,6210999,20.36128843138321,37.402766127773276,0.08577637366496638,2237.7643682956696,478.53681325912476,1836.5845184326172,25274,6022,19252,19252,0,22,6211000.0
6211,6211999,20.360654436140393,37.40125473412109,0.08576850261228253,2238.266982316971,478.606214761734,1836.4742050170898,25280,6025,19255,19255,0,22,6212000.0
6212,6212999,20.359964472618685,37.39984542225964,0.08575930669409337,2238.7156960964203,478.67662286758423,1836.4325103759766,25283,6026,19257,19257,0,22,6213000.0
6213,6213999,20.359312251623994,37.39846353572139,0.08575204113728707,2238.9583632946014,478.74525356292725,1837.1210632324219,25283,6026,19257,19257,0,22,6214000.0
6214,6214999,20.358457350607505,37.39671053150041,0.08574888659103941,2239.4963026046753,478.8153166770935,1836.895622253418,25297,6029,19268,19268,0,22,6215000.0
6215,6215999,20.357625286951407,37.39509617989998,0.08574522731628054,2239.7694613933563,478.8845911026001,1837.5269317626953,25299,6030,19269,19269,0,22,6216000.0
6216,6216999,20.357058775448376,37.3942962792503,0.08573850784397552,2240.3638536930084,478.95412158966064,1836.9668884277344,25307,6033,19274,19274,0,22,6217000.0
6217,6217999,20.356172101212145,37.39242637057723,0.0857396011217555,2240.658608675003,479.0232152938843,1837.385482788086,25307,6033,19274,19274,0,22,6218000.0
6218,6218999,20.355256209785676,37.39058249911519,0.08574029307466502,2241.055943250656,479.09468817710876,1837.6126403808594,25311,6035,19276,19276,0,22,6219000.0
6219,6219999,20.354297892418433,37.38877868610755,0.08573863523546199,2241.375797510147,479.1633024215698,1837.9629516601562,25314,6036,19278,19278,0,22,6220000.0
6220,6220999,20.35332702285465,37.387080163586596,0.08573573986184169,2241.838193178177,479.232216835022,1837.7708206176758,25317,6037,19280,19280,0,22,6221000.0
6221,6221999,20.352407289899396,37.3855778783408,0.08573849235426878,2242.1110332012177,479.30295610427856,1838.3724822998047,25317,6037,19280,19280,0,22,6222000.0
6222,6222999,20.351565742825517,37.38408344858926,0.08573655370208288,2242.6563971042633,479.3720016479492,1837.9111557006836,25321,6039,19282,19282,0,22,6223000.0
6223,6223999,20.35063122591467,37.38232464968984,0.08573650762472829,2242.8543088436127,479.4417247772217,1838.7676467895508,25321,6039,19282,19282,0,22,6224000.0
6224,6224999,20.34980599885098,37.38074852109426,0.08573209109272217,2243.4326601028442,479.51078605651855,1838.0859832763672,25325,6041,19284,19284,0,22,6225000.0
6225,6225999,20.348735159000526,37.378751000241365,0.08573611352126076,2243.598237991333,479.5793228149414,1839.0401153564453,25325,6041,19284,19284,0,22,6226000.0
6226,6226999,20.34755714921629,37.3765433322999,0.08574280859855199,2244.1528990268707,479.64771270751953,1838.573745727539,25329,6042,19287,19287,0,22,6227000.0
6227,6227999,20.34678284767494,37.37568121419637,0.08573802629485239,2244.3526368141174,479.71692728996277,1840.1282958984375,25343,6042,19301,19301,0,22,6228000.0
6228,6228999,20.34572908881979,37.37378951482764,0.08574150475646469,2244.7062010765076,479.7876193523407,1840.9075546264648,25347,6043,19304,19304,0,22,6229000.0
6229,6229999,20.344539681115034,37.37151914632032,0.08574896183854708,2244.900855779648,479.8537366390228,1841.9679641723633,25347,6043,19304,19304,0,22,6230000.0
6230,6230999,20.34375671542727,37.37147876415428,0.08574182502147387,2245.3155722618103,479.9207384586334,1842.1596755981445,25354,6045,19309,19309,0,22,6231000.0
6231,6231999,20.342563278169628,37.369289662883915,0.08574709905304656,2246.0106246471405,479.9905729293823,1841.6375350952148,25395,6050,19345,19345,0,22,6232000.0
6232,6232999,20.341618560435347,37.36751613253466,0.08575145540518736,2246.390013694763,480.05905199050903,1842.0823974609375,25400,6052,19348,19348,0,22,6233000.0
6233,6233999,20.3406769077655,37.36597502976101,0.08575418888781206,2246.8393993377686,480.1285648345947,1842.1615371704102,25404,6054,19350,19350,0,22,6234000.0
6234,6234999,20.339917503292387,37.36456634167451,0.08575573263254044,2247.224404335022,480.1974940299988,1842.3035278320312,25406,6055,19351,19351,0,22,6235000.0
6235,6235999,20.339156536575427,37.36308288645527,0.0857611019291239,2247.6419825553894,480.2668523788452,1842.6782836914062,25410,6057,19353,19353,0,22,6236000.0
6236,6236999,20.338668480361175,37.36233046057678,0.08575970396170673,2248.064824104309,480.33469891548157,1842.6786880493164,25413,6058,19355,19355,0,22,6237000.0
6237,6237999,20.33807729474349,37.361431108091594,0.08575771987393677,2248.321296453476,480.403480052948,1843.2834777832031,25413,6058,19355,19355,0,22,6238000.0
6238,6238999,20.33754090415674,37.36087319639558,0.08575661374491572,2248.817370891571,480.47293066978455,1842.9436950683594,25413,6058,19355,19355,0,22,6239000.0
6239,6239999,20.336986292630893,37.359639304330905,0.08575887445735197,2249.1050934791565,480.5411114692688,1843.481788635254,25413,6058,19355,19355,0,22,6240000.0
6240,6240999,20.336364441194238,37.35836719984005,0.08576359906511621,2249.390499830246,480.6097857952118,1843.9347610473633,25413,6058,19355,19355,0,22,6241000.0
6241,6241999,20.335729772665466,37.35692041606176,0.08576671131806379,2249.6561081409454,480.6790976524353,1844.5678405761719,25415,6059,19356,19356,0,22,6242000.0
6242,6242999,20.3352808221516,37.35637912941296,0.08575979323736116,2250.037276983261,480.7506260871887,1844.6357498168945,25417,6060,19357,19357,0,22,6243000.0
6243,6243999,20.33476057117249,37.35511622621235,0.08576643008917484,2250.542697906494,480.82023787498474,1844.5676727294922,25422,6062,19360,19360,0,22,6244000.0
6244,6244999,20.334287453702427,37.354177995950714,0.08576449552793741,2250.9972224235535,480.8888409137726,1844.407341003418,25424,6063,19361,19361,0,22,6245000.0
6245,6245999,20.333635027540975,37.35268450653283,0.08576082653877193,2251.4653124809265,480.9630482196808,1844.1965560913086,25426,6064,19362,19362,0,22,6246000.0
6246,6246999,20.333048922762377,37.35131149315935,0.08576173877439042,2251.7184262275696,481.03155541419983,1844.8651885986328,25426,6064,19362,19362,0,22,6247000.0
6247,6247999,20.332315116808925,37.34977419164039,0.08576050827257387,2252.176557779312,481.1010389328003,1844.7690048217773,25429,6065,19364,19364,0,22,6248000.0
6248,6248999,20.331074864423286,37.347774511537445,0.08576781782042031,2252.471812725067,481.16379833221436,1845.8384552001953,25445,6066,19379,19379,0,22,6249000.0
6249,6249999,20.329648403315968,37.34578782086137,0.08577632559045822,2252.7888083457947,481.2274398803711,1846.5368118286133,25450,6067,19383,19383,0,22,6250000.0
6250,6250999,20.32855588284442,37.34439388896393,0.08577893470605469,2253.0773968696594,481.29102087020874,1847.1791534423828,25453,6067,19386,19386,0,22,6251000.0
6251,6251999,20.327856803893226,37.343126033290496,0.085777426793338,2253.4453263282776,481.35555481910706,1847.5614624023438,25457,6068,19389,19389,0,22,6252000.0
6252,6252999,20.326953192079657,37.34127423468201,0.08577493353387566,2253.7508375644684,481.4200348854065,1848.4279861450195,25464,6070,19394,19394,0,22,6253000.0
6253,6253999,20.325998954972288,37.33921931995067,0.0857759345704795,2254.167414188385,481.48692560195923,1848.5295791625977,25467,6071,19396,19396,0,22,6254000.0
6254,6254999,20.324987891036002,37.33765345943767,0.08577378868120722,2254.616607904434,481.5527255535126,1848.6266479492188,25472,6073,19399,19399,0,22,6255000.0
6255,6255999,20.324431047605312,37.33688658158748,0.08576941732380505,2254.865825653076,481.6191473007202,1849.3599090576172,25472,6073,19399,19399,0,22,6256000.0
6256,6256999,20.32371262989117,37.335337084892515,0.08576777409335057,2255.26154088974,481.68427753448486,1849.5540313720703,25476,6074,19402,19402,0,22,6257000.0
6257,6257999,20.323234199985063,37.33411622728789,0.08576108689598605,2255.69304227829,481.7517125606537,1849.7091369628906,25489,6076,19413,19413,0,22,6258000.0
6258,6258999,20.322980788062154,37.33310989609331,0.08575446446038892,2256.2372930049896,481.81762647628784,1849.3838424682617,25493,6078,19415,19415,0,22,6259000.0
6259,6259999,20.322873811263257,37.33281337116485,0.08574471546707474,2256.5334792137146,481.8848567008972,1849.998924255371,25496,6079,19417,19417,0,22,6260000.0
6260,6260999,20.32261942958366,37.33179157592726,0.0857413068909304,2256.9015913009644,481.9519805908203,1850.3254013061523,25500,6081,19419,19419,0,22,6261000.0
6261,6261999,20.322457033806327,37.33101141350058,0.08573947169613261,2257.353239774704,482.02013206481934,1850.4117050170898,25503,6082,19421,19421,0,22,6262000.0
6262,6262999,20.322800786476236,37.33131624753739,0.08572612852887984,2257.8172426223755,482.0890121459961,1850.2982635498047,25506,6083,19423,19423,0,22,6263000.0
6263,6263999,20.322996168384034,37.33135634616778,0.08572833603743746,2258.054033279419,482.15619564056396,1850.9915161132812,25506,6083,19423,19423,0,22,6264000.0
6264,6264999,20.323185928498113,37.33101339235321,0.08572256811907564,2258.307481765747,482.22086572647095,1851.5560989379883,25506,6083,19423,19423,0,22,6265000.0
6265,6265999,20.32361461571071,37.3311495765239,0.08571641944603592,2258.8137402534485,482.28847575187683,1851.1440811157227,25508,6084,19424,19424,0,22,6266000.0
6266,6266999,20.323950920264544,37.33110256033706,0.08571112950726145,2259.3964896202087,482.35482597351074,1850.4714050292969,25510,6085,19425,19425,0,22,6267000.0
6267,6267999,20.323981069889463,37.3301612160165,0.08571058878310667,2259.764771461487,482.42112970352173,1850.9572677612305,25514,6087,19427,19427,0,22,6268000.0
6268,6268999,20.323662954587938,37.32898416191689,0.08571093013955067,2260.19197845459,482.4873728752136,1851.0209503173828,25514,6087,19427,19427,0,22,6269000.0
6269,6269999,20.32268105282388,37.327143687880294,0.0857187747601642,2260.3899943828583,482.55637645721436,1852.5743103027344,25529,6087,19442,19442,0,22,6270000.0
6270,6270999,20.321557724944892,37.32514709037255,0.08572807466668397,2260.7133269309998,482.6233148574829,1853.435401916504,25538,6089,19449,19449,0,22,6271000.0
6271,6271999,20.32048402321019,37.32378505771769,0.08573569459805608,2261.170841693878,482.69242334365845,1853.784408569336,25548,6092,19456,19456,0,22,6272000.0
6272,6272999,20.319204411577658,37.32166866009329,0.08574529178255286,2261.646892786026,482.76166677474976,1854.0604858398438,25567,6095,19472,19472,0,22,6273000.0
6273,6273999,20.317964539941606,37.31953250560913,0.08575794676701776,2261.892682313919,482.8276877403259,1854.748146057129,25567,6095,19472,19472,0,22,6274000.0
6274,6274999,20.316997221659474,37.31842607692653,0.085761062873699,2262.4940502643585,482.8976106643677,1854.2965545654297,25572,6097,19475,19475,0,22,6275000.0
6275,6275999,20.315785348991355,37.31654432129001,0.08576887226239815,2262.8380796909332,482.96522283554077,1854.6565399169922,25574,6098,19476,19476,0,22,6276000.0
6276,6276999,20.314696436924724,37.314935151443514,0.08577484023819326,2263.2425813674927,483.0336289405823,1854.8708801269531,25601,6099,19502,19502,0,22,6277000.0
6277,6277999,20.313577371733082,37.31301034404368,0.0857819071059267,2263.525433778763,483.1004662513733,1855.4560928344727,25601,6099,19502,19502,0,22,6278000.0
6278,6278999,20.312566841094238,37.31133350952188,0.08578957469956117,2263.882169485092,483.1687526702881,1855.551010131836,25601,6099,19502,19502,0,22,6279000.0
6279,6279999,20.311634514637284,37.309783239869105,0.08579494733223347,2264.3034155368805,483.2365028858185,1855.4795150756836,25601,6099,19502,19502,0,22,6280000.0
6280,6280999,20.31064488174659,37.307966906424944,0.08580443357740164,2264.830325603485,483.3038213253021,1855.0060348510742,25603,6100,19503,19503,0,22,6281000.0
6281,6281999,20.309873248799473,37.30651021791776,0.08581288762121164,2265.0445277690887,483.372935295105,1855.8077239990234,25603,6100,19503,19503,0,22,6282000.0
6282,6282999,20.309094243196615,37.3050800815865,0.0858221442912146,2265.4238073825836,483.4408736228943,1855.891456604004,25603,6100,19503,19503,0,22,6283000.0
6283,6283999,20.30809001322073,37.3032676586285,0.08583658883022927,2265.714005470276,483.5073220729828,1856.492790222168,25605,6101,19504,19504,0,22,6284000.0
6284,6284999,20.306932197942764,37.301068100117014,0.08585301430111447,2266.3878548145294,483.57511138916016,1855.4179992675781,25612,6104,19508,19508,0,22,6285000.0
6285,6285999,20.305787536690232,37.29882806244744,0.0858701175069676,2266.8005714416504,483.64258432388306,1855.6268768310547,25612,6104,19508,19508,0,22,6286000.0
6286,6286999,20.30495672237432,37.297332047008545,0.0858747983354411,2267.1358892917633,483.70782017707825,1856.6823501586914,25629,6105,19524,19524,0,22,6287000.0
6287,6287999,20.3041254111149,37.29593133551108,0.08588093379175143,2267.415155172348,483.77458357810974,1857.6809768676758,25631,6105,19526,19526,0,22,6288000.0
6288,6288999,20.303447670149414,37.29726855933734,0.08587580129566796,2267.652847766876,483.83858275413513,1858.6553421020508,25642,6106,19536,19536,0,22,6289000.0
6289,6289999,20.302611037724247,37.29608661333963,0.08588277221931728,2268.0289771556854,483.9035475254059,1858.8831481933594,25647,6107,19540,19540,0,22,6290000.0
6290,6290999,20.30174856577524,37.29465267137747,0.08589013515544774,2268.564747095108,493.0303854942322,1858.6360092163086,25654,6110,19544,19544,0,22,6291000.0
6291,6291999,20.300663111939283,37.292798869344885,0.085897420146686,2269.08051776886,493.097017288208,1858.8213195800781,25664,6114,19550,19550,0,22,6292000.0
6292,6292999,20.299586263124358,37.29094753312253,0.08590844843188017,2269.496094942093,493.1643249988556,1859.112922668457,25669,6116,19553,19553,0,22,6293000.0
6293,6293999,20.29855823854207,37.289225034253754,0.08591150315879625,2269.8193411827087,493.22951555252075,1859.6295318603516,25671,6117,19554,19554,0,22,6294000.0
6294,6294999,20.29755875654373,37.2872711243936,0.08591675406672983,2270.178554058075,493.2959156036377,1860.1706619262695,25676,6119,19557,19557,0,22,6295000.0
6295,6295999,20.296454524901012,37.285175411292734,0.08592335076794266,2270.416673183441,493.3620913028717,1860.9714126586914,25676,6119,19557,19557,0,22,6296000.0
6296,6296999,20.295691893063545,37.283955956582105,0.08592035069570303,2270.8794782161713,493.4293215274811,1860.7295379638672,25681,6121,19560,19560,0,22,6297000.0
6297,6297999,20.29493485646047,37.28238828236226,0.08592044283184841,2271.3441348075867,493.50011372566223,1860.7318878173828,25686,6123,19563,19563,0,22,6298000.0
6298,6298999,20.294266327764404,37.28119242818907,0.08591640431033531,2271.8981351852417,493.56940817832947,1860.3147201538086,25692,6125,19567,19567,0,22,6299000.0
6299,6299999,20.293686134906373,37.27996938465703,0.08591241037430608,2272.264780521393,493.63571190834045,1860.521141052246,25692,6125,19567,19567,0,22,6300000.0
6300,6300999,20.293090640502932,37.27852806398791,0.08591086680854187,2272.550357103348,493.70288157463074,1861.1091690063477,25694,6126,19568,19568,0,22,6301000.0
6301,6301999,20.292603353989737,37.27729213268948,0.08590937374365781,2272.9240629673004,493.76916694641113,1861.4116821289062,25698,6128,19570,19570,0,22,6302000.0
6302,6302999,20.292161202311693,37.276153079783974,0.08590505036252394,2273.358689546585,493.8386254310608,1861.4548416137695,25701,6129,19572,19572,0,22,6303000.0
6303,6303999,20.291926500088678,37.27600935556732,0.0858948902902017,2273.7843668460846,493.9073851108551,1861.269630432129,25701,6129,19572,19572,0,22,6304000.0
6304,6304999,20.29154494881896,37.2749152542888,0.08589018322129183,2274.1227765083313,493.97620964050293,1861.6505279541016,25701,6129,19572,19572,0,22,6305000.0
6305,6305999,20.290967604368255,37.274006764034354,0.08588464906392723,2274.5066578388214,494.0466992855072,1861.9392471313477,25704,6130,19574,19574,0,22,6306000.0
6306,6306999,20.290798738648288,37.27455500231269,0.08585275037977935,2274.85990190506,494.11391854286194,1863.1735229492188,25737,6132,19605,19605,0,22,6307000.0
6307,6307999,20.289857905295072,37.2735611885893,0.0858548449310731,2275.0414929389954,494.18003606796265,1864.4552993774414,25740,6132,19608,19608,0,22,6308000.0
6308,6308999,20.288888206516692,37.271642125770725,0.08585963198210156,2275.2945392131805,494.24605536460876,1865.0730819702148,25740,6132,19608,19608,0,22,6309000.0
6309,6309999,20.288166126706443,37.27078871559534,0.08586068658386303,2275.869001150131,494.31597876548767,1864.9244689941406,25750,6136,19614,19614,0,22,6310000.0
6310,6310999,20.28740039669591,37.26927729664582,0.08586216270506164,2276.2448377609253,494.3842430114746,1865.4443588256836,25755,6138,19617,19617,0,22,6311000.0
6311,6311999,20.286413330856984,37.267169588367594,0.08586836363230521,2276.795834541321,494.4528088569641,1865.298324584961,25763,6141,19622,19622,0,22,6312000.0
6312,6312999,20.285381130881657,37.26519367296828,0.08587165130403518,2277.0709245204926,494.5192186832428,1866.0493392944336,25765,6142,19623,19623,0,22,6313000.0
6313,6313999,20.28468734161526,37.263993591780014,0.08586973822781496,2277.311952352524,494.5881280899048,1866.7120208740234,25765,6142,19623,19623,0,22,6314000.0
6314,6314999,20.28367975343121,37.26206449857946,0.08587173188722808,2277.6764965057373,494.65725803375244,1866.9212646484375,25765,6142,19623,19623,0,22,6315000.0
6315,6315999,20.282956222933528,37.261114593092486,0.08586777618181463,2278.0567574501038,494.72452449798584,1867.0531921386719,25768,6143,19625,19625,0,22,6316000.0
6316,6316999,20.28210746740735,37.25980697703533,0.08586468213347942,2278.4844448566437,494.7935366630554,1866.9688720703125,25770,6144,19626,19626,0,22,6317000.0
6317,6317999,20.281460046116976,37.25843715419063,0.08586169721523107,2278.7385947704315,494.8620879650116,1867.6198806762695,25770,6144,19626,19626,0,22,6318000.0
6318,6318999,20.280803346140825,37.25850949063979,0.08585318610333637,2279.176374197006,494.9292035102844,1867.575424194336,25772,6145,19627,19627,0,22,6319000.0
6319,6319999,20.280115944938956,37.25712234358195,0.08585162975944371,2279.4802737236023,495.00068831443787,1868.060905456543,25775,6146,19629,19629,0,22,6320000.0
6320,6320999,20.279367780334855,37.25546137578885,0.08585148507457407,2279.8638532161713,495.07093477249146,1868.078956604004,25775,6146,19629,19629,0,22,6321000.0
6321,6321999,20.27878026601244,37.253996591376406,0.08585140847347561,2280.311886548996,495.13866448402405,1867.9169540405273,25778,6147,19631,19631,0,22,6322000.0
6322,6322999,20.27825566752779,37.25263508364559,0.08584771318843765,2280.8079323768616,495.20675897598267,1867.7456741333008,25783,6149,19634,19634,0,22,6323000.0
6323,6323999,20.27792062530292,37.25153550479473,0.08584083776866946,2281.271725177765,495.27424335479736,1867.480369567871,25783,6149,19634,19634,0,22,6324000.0
6324,6324999,20.277228423454332,37.249990833201416,0.08583757145327553,2281.7703511714935,495.34188771247864,1867.1536865234375,25785,6150,19635,19635,0,22,6325000.0
6325,6325999,20.27648661888612,37.24824093792263,0.08583606148583434,2282.149693965912,495.41117215156555,1867.4986877441406,25787,6151,19636,19636,0,22,6326000.0
6326,6326999,20.27577054381647,37.24713785755257,0.08583177884724169,2282.488013267517,495.48071789741516,1867.8516006469727,25787,6151,19636,19636,0,22,6327000.0
6327,6327999,20.274848719639404,37.24538775180268,0.085831781349066,2282.768125295639,495.54640316963196,1869.2261123657227,25809,6152,19657,19657,0,22,6328000.0
6328,6328999,20.274406994827988,37.244661370420054,0.08581603369954172,2282.9993209838867,495.6107816696167,1870.2694549560547,25810,6152,19658,19658,0,22,6329000.0
6329,6329999,20.273660534491857,37.24396288512679,0.0858085345238968,2283.2561826705933,495.6757791042328,1870.9561080932617,25813,6152,19661,19661,0,22,6330000.0
6330,6330999,20.272891797403435,37.24216092001298,0.08580579056946136,2283.5647258758545,495.7416093349457,1871.681053161621,25815,6153,19662,19662,0,22,6331000.0
6331,6331999,20.27204302518654,37.24024433483125,0.08580228940322987,2283.802078962326,495.8060646057129,1872.3653106689453,25817,6154,19663,19663,0,22,6332000.0
6332,6332999,20.271463956414298,37.238755450088,0.08579546939731109,2284.261732339859,495.87219047546387,1872.5999069213867,25883,6156,19727,19727,0,22,6333000.0
6333,6333999,20.270623796856437,37.23695281501417,0.08579250331905941,2284.8337864875793,495.9376974105835,1872.7215728759766,25894,6160,19734,19734,0,22,6334000.0
6334,6334999,20.269823059172996,37.23528868565621,0.0857920000833392,2285.123492717743,496.003005027771,1873.5728149414062,25897,6161,19736,19736,0,22,6335000.0
6335,6335999,20.26901315238588,37.234422381339044,0.08578643012672982,2285.490601539612,496.06774711608887,1874.0450820922852,25906,6163,19743,19743,0,22,6336000.0
6336,6336999,20.26828060413162,37.23278068480254,0.08578404221529301,2286.025633096695,496.1360900402069,1873.8654708862305,25908,6164,19744,19744,0,22,6337000.0
6337,6337999,20.26740276984246,37.23086666906309,0.08578560979597383,2286.3828403949738,496.2010703086853,1874.4296264648438,25913,6166,19747,19747,0,22,6338000.0
6338,6338999,20.266590573536703,37.22911449632349,0.08578337555199456,2286.6407113075256,496.2659025192261,1875.069465637207,25913,6166,19747,19747,0,22,6339000.0
6339,6339999,20.265894350669466,37.22795877307202,0.08577974506619257,2287.2479672431946,496.332533121109,1874.478889465332,25918,6168,19750,19750,0,22,6340000.0
6340,6340999,20.26518465132441,37.22625725145784,0.08577838536147908,2287.4917316436768,496.39916372299194,1875.3991622924805,25920,6169,19751,19751,0,22,6341000.0
6341,6341999,20.2643999077819,37.224346074891855,0.08577842905225097,2287.856009244919,496.46527910232544,1875.7793807983398,25924,6171,19753,19753,0,22,6342000.0
6342,6342999,20.26393086155765,37.22309003045797,0.0857729710793903,2288.19220995903,496.53363394737244,1876.1293716430664,25924,6171,19753,19753,0,22,6343000.0
6343,6343999,20.26341958649372,37.22152808724112,0.0857657377665273,2288.5467879772186,496.6022343635559,1876.5572128295898,25931,6172,19759,19759,0,22,6344000.0
6344,6344999,20.262737549138848,37.21989934282872,0.08576634436208375,2289.096175670624,496.6700530052185,1876.172737121582,25936,6174,19762,19762,0,22,6345000.0
6345,6345999,20.262130047672915,37.2182562517178,0.08576564452182833,2289.691273212433,496.73774552345276,1875.6514282226562,25941,6176,19765,19765,0,22,6346000.0
6346,6346999,20.261338772512328,37.216386354209384,0.08576760795364946,2290.1463861465454,496.8060202598572,1875.902816772461,25947,6178,19769,19769,0,22,6347000.0
6347,6347999,20.260312927006602,37.2143568623098,0.08577081771985995,2290.3463509082794,496.87127113342285,1877.3636779785156,25965,6178,19787,19787,0,22,6348000.0
6348,6348999,20.259418429733916,37.214313262917585,0.08576764622749045,2290.6885414123535,496.9392638206482,1878.4218063354492,25980,6180,19800,19800,0,22,6349000.0
6349,6349999,20.258397648756276,37.21398190751626,0.0857615528833956,2290.835572242737,497.00530672073364,1879.768699645996,25983,6180,19803,19803,0,22,6350000.0
6350,6350999,20.25755247880355,37.212634493385096,0.0857550581613078,2291.098760843277,497.07290983200073,1880.630256652832,25985,6181,19804,19804,0,22,6351000.0
6351,6351999,20.256710770018103,37.21122211851225,0.08575110565988864,2291.5211193561554,497.13846731185913,1880.7237396240234,25990,6183,19807,19807,0,22,6352000.0
6352,6352999,20.255870578185586,37.20980042899683,0.0857457371033663,2291.8713839054108,497.20596861839294,1881.077980041504,26002,6185,19817,19817,0,22,6353000.0
6353,6353999,20.254969788057675,37.208029578650425,0.08574666544389309,2292.344259738922,497.2746195793152,1881.0682220458984,26006,6187,19819,19819,0,22,6354000.0
6354,6354999,20.254080558024548,37.206460463249655,0.08574989828301971,2292.7526137828827,497.3423743247986,1881.277572631836,26011,6189,19822,19822,0,22,6355000.0
6355,6355999,20.253282751435787,37.20516948515113,0.08575152832732291,2293.005967617035,497.4100298881531,1882.000877380371,26011,6189,19822,19822,0,22,6356000.0
6356,6356999,20.252604815963892,37.204531738324576,0.0857497179570802,2293.5270988941193,497.4773950576782,1881.9037857055664,26017,6192,19825,19825,0,22,6357000.0
6357,6357999,20.25191255755395,37.20308486524749,0.08575897840248037,2293.8840494155884,497.5441982746124,1882.2633895874023,26019,6193,19826,19826,0,22,6358000.0
6358,6358999,20.25152187677482,37.20244751019706,0.08577085742251012,2294.1827688217163,497.611136674881,1882.6367263793945,26019,6193,19826,19826,0,22,6359000.0
6359,6359999,20.251926346699925,37.20351454837709,0.0857611420638168,2294.564962863922,497.68027091026306,1882.706283569336,26021,6194,19827,19827,0,22,6360000.0
6360,6360999,20.252065257257904,37.20405151072288,0.08575150411226984,2295.0466237068176,497.7488067150116,1882.4923934936523,26034,6196,19838,19838,0,22,6361000.0
6361,6361999,20.252466166475106,37.20441431856636,0.08575704063578604,2295.4839544296265,497.81765961647034,1882.6089401245117,26036,6197,19839,19839,0,22,6362000.0
6362,6362999,20.25288271219076,37.20473753271309,0.08576363662302922,2296.0086669921875,497.88656425476074,1882.5339736938477,26044,6201,19843,19843,0,22,6363000.0
6363,6363999,20.25389990807396,37.207033090871136,0.08574834626770711,2296.210739135742,497.95630168914795,1883.5062408447266,26044,6201,19843,19843,0,22,6364000.0
6364,6364999,20.254730187156824,37.207879009081104,0.08573996307538057,2296.605313062668,498.02405405044556,1883.7602005004883,26049,6203,19846,19846,0,22,6365000.0
6365,6365999,20.255609335559562,37.2087173322619,0.08573740144085606,2297.0665154457092,498.0958003997803,1883.5118103027344,26051,6204,19847,19847,0,22,6366000.0
6366,6366999,20.256147524254402,37.208754593024956,0.08574319931337904,2297.440727710724,498.1640784740448,1883.7043914794922,26053,6205,19848,19848,0,22,6367000.0
6367,6367999,20.25645635550193,37.20827423412524,0.08574353879269336,2297.759477376938,498.24292731285095,1884.3676528930664,26084,6206,19878,19878,0,22,6368000.0
6368,6368999,20.256186953469303,37.20717538971962,0.08572144143402471,2298.1774258613586,498.3114912509918,1885.2004318237305,26108,6207,19901,19901,0,22,6369000.0
6369,6369999,20.25568589929455,37.209196346384516,0.08568709127237628,2298.325567960739,498.3791801929474,1886.8238067626953,26110,6207,19903,19903,0,22,6370000.0
6370,6370999,20.255359971470668,37.209900904319724,0.0856537826313708,2298.57382273674,498.44721388816833,1887.8107528686523,26117,6208,19909,19909,0,22,6371000.0
6371,6371999,20.25502892950964,37.208897778834434,0.0856257220226635,2298.9689888954163,498.5176281929016,1888.4169158935547,26150,6210,19940,19940,0,22,6372000.0
6372,6372999,20.254592375778536,37.207613249176646,0.08561234507162918,2299.5461559295654,498.58606576919556,1887.9639434814453,26154,6212,19942,19942,0,22,6373000.0
6373,6373999,20.25419752348998,37.20789023560362,0.08558401393066806,2299.9065210819244,498.6549069881439,1888.3746795654297,26156,6213,19943,19943,0,22,6374000.0
6374,6374999,20.253701292910737,37.20659342543487,0.08556960185404083,2300.2424082756042,498.7232587337494,1889.0796127319336,26160,6215,19945,19945,0,22,6375000.0
6375,6375999,20.25322009492536,37.20558591587258,0.08555609955766486,2300.859588623047,498.7934637069702,1888.5511856079102,26166,6218,19948,19948,0,22,6376000.0
6376,6376999,20.252872275671493,37.204424378449374,0.08554179246743354,2301.241592645645,498.8660559654236,1888.9404525756836,26170,6220,19950,19950,0,22,6377000.0
6377,6377999,20.25249142276966,37.20325822706363,0.0855294098820879,2301.485915184021,498.93653297424316,1889.7750549316406,26170,6220,19950,19950,0,22,6378000.0
6378,6378999,20.252473754187445,37.203406538160884,0.08551943832689246,2301.7692205905914,499.00610733032227,1890.4441223144531,26172,6221,19951,19951,0,22,6379000.0
6379,6379999,20.252528573845453,37.20290981218134,0.08550497994575013,2302.149980068207,499.0757348537445,1890.668472290039,26174,6222,19952,19952,0,22,6380000.0
6380,6380999,20.252745842466307,37.202491009089464,0.08550442724511365,2302.6580200195312,499.15121126174927,1890.5242385864258,26180,6225,19955,19955,0,22,6381000.0
6381,6381999,20.25296640266602,37.202183700227216,0.08550169532757557,2302.9978964328766,499.2220547199249,1890.8765106201172,26182,6226,19956,19956,0,22,6382000.0
6382,6382999,20.25344431703913,37.202504408863895,0.08549663273371699,2303.5085306167603,499.29277086257935,1890.764259338379,26195,6228,19967,19967,0,22,6383000.0
6383,6383999,20.25399409733551,37.20296493372425,0.0855142973874694,2303.8487441539764,499.36398553848267,1891.0379791259766,26195,6228,19967,19967,0,22,6384000.0
6384,6384999,20.254390965709657,37.202888966390944,0.08552014654375939,2304.2961192131042,499.43336629867554,1890.9325637817383,26198,6229,19969,19969,0,22,6385000.0
6385,6385999,20.25521527349556,37.20358622183502,0.08552675272813637,2304.9250724315643,499.5058629512787,1890.2084426879883,26203,6231,19972,19972,0,22,6386000.0
6386,6386999,20.255825511681962,37.20466061532326,0.08553425842835782,2305.213390827179,499.5777585506439,1890.8810501098633,26205,6232,19973,19973,0,22,6387000.0
6387,6387999,20.25664409925874,37.20498055424529,0.08553589013159513,2305.610352039337,499.6529474258423,1891.0402145385742,26205,6232,19973,19973,0,22,6388000.0
6388,6388999,20.256896665422943,37.20456014040315,0.08553792670171567,2305.8918867111206,499.72396183013916,1891.6852264404297,26205,6232,19973,19973,0,22,6389000.0
6389,6389999,20.25708733246416,37.20411788196165,0.08548919985673542,2306.0805234909058,499.78797459602356,1893.0439453125,26219,6232,19987,19987,0,22,6390000.0
6390,6390999,20.256843965424608,37.203721133879625,0.08544999379077656,2306.3371410369873,499.8513252735138,1893.8690872192383,26221,6232,19989,19989,0,22,6391000.0
6391,6391999,20.256672400082515,37.20266590839233,0.08540270609098854,2306.541048526764,499.9154918193817,1894.8775253295898,26225,6232,19993,19993,0,22,6392000.0
6392,6392999,20.25683368994995,37.20212758595131,0.0853552967493506,2307.054629087448,499.9801127910614,1894.9389724731445,26234,6235,19999,19999,0,22,6393000.0
6393,6393999,20.25745767972121,37.20275932078451,0.0852989743908188,2307.4787545204163,500.0470778942108,1895.2492752075195,26240,6237,20003,20003,0,22,6394000.0
6394,6394999,20.257857353494884,37.20237834525833,0.08524892577915566,2307.8563470840454,500.11311292648315,1895.5211791992188,26243,6238,20005,20005,0,22,6395000.0
6395,6395999,20.258072609659507,37.201846360064565,0.08521783254660353,2308.488095998764,500.1780014038086,1895.1208724975586,26255,6243,20012,20012,0,22,6396000.0
6396,6396999,20.258442303872876,37.2014388845809,0.08518972808476333,2309.0167677402496,500.2455334663391,1895.4017486572266,26271,6247,20024,20024,0,22,6397000.0
6397,6397999,20.258518966714554,37.20057669452219,0.08517061580734098,2309.4328179359436,500.31253147125244,1895.747917175293,26276,6249,20027,20027,0,22,6398000.0
6398,6398999,20.25888438207745,37.20124387540124,0.08515020244671767,2309.6423847675323,500.3787088394165,1896.607032775879,26277,6249,20028,20028,0,22,6399000.0
6399,6399999,20.259239091652187,37.2006807551814,0.08513721825643106,2310.2934708595276,500.4492709636688,1895.9305572509766,26282,6251,20031,20031,0,22,6400000.0
6400,6400999,20.259477014287228,37.20009275787886,0.08512896959935279,2310.5881023406982,500.51467418670654,1896.5971298217773,26284,6252,20032,20032,0,22,6401000.0
6401,6401999,20.25994513423846,37.199750902531996,0.0851242632005057,2310.957716703415,500.58063101768494,1896.7613525390625,26287,6253,20034,20034,0,22,6402000.0
6402,6402999,20.26030295434305,37.19930991302663,0.0851132372332617,2311.392241716385,500.6506462097168,1896.8195343017578,26289,6254,20035,20035,0,22,6403000.0
6403,6403999,20.260485388271324,37.19883544384799,0.08510192959768026,2311.8052191734314,500.71776962280273,1896.9969177246094,26295,6256,20039,20039,0,22,6404000.0
6404,6404999,20.2608663756043,37.198533640953414,0.08508984396498431,2312.249251127243,500.78519010543823,1896.924217224121,26297,6257,20040,20040,0,22,6405000.0
6405,6405999,20.26100422843234,37.197736966105545,0.08508696062120458,2312.5564184188843,500.84943175315857,1897.3527908325195,26297,6257,20040,20040,0,22,6406000.0
6406,6406999,20.261291790510562,37.197335775935535,0.0850815706636372,2313.059839248657,500.9216947555542,1897.2020721435547,26309,6259,20050,20050,0,22,6407000.0
6407,6407999,20.26152894399289,37.19666170954311,0.08507932811696461,2313.4666504859924,500.989150762558,1897.235336303711,26309,6259,20050,20050,0,22,6408000.0
6408,6408999,20.2618868422268,37.19598447909176,0.0850666870124418,2313.825656890869,501.0550422668457,1897.5350646972656,26309,6259,20050,20050,0,22,6409000.0
6409,6409999,20.262133530854623,37.19510346023734,0.08505534294677453,2314.0306282043457,501.12268257141113,1898.3832778930664,26309,6259,20050,20050,0,22,6410000.0
6410,6410999,20.262051793919635,37.19392168216048,0.08502853289448908,2314.365151643753,501.18825006484985,1899.1642532348633,26319,6260,20059,20059,0,22,6411000.0
6411,6411999,20.262363843894253,37.194664787281226,0.08497317468007426,2314.7085847854614,501.2544107437134,1900.1491470336914,26334,6262,20072,20072,0,22,6412000.0
6412,6412999,20.26233456046484,37.194591952903565,0.08493735148100567,2315.1731922626495,501.32156467437744,1900.2931518554688,26340,6263,20077,20077,0,22,6413000.0
6413,6413999,20.26213836190656,37.19523807465029,0.08490169992448138,2315.472419500351,501.3927803039551,1901.0739669799805,26343,6264,20079,20079,0,22,6414000.0
6414,6414999,20.26174462476649,37.19394094325992,0.0848786325121379,2315.882184267044,501.46756529808044,1901.5238189697266,26353,6266,20087,20087,0,22,6415000.0
6415,6415999,20.261245563705504,37.19346234572932,0.08486089865394886,2316.3027262687683,501.53450298309326,1901.6275482177734,26359,6268,20091,20091,0,22,6416000.0
6416,6416999,20.260554437619252,37.19202597716894,0.08485142739639018,2316.7979283332825,501.6015362739563,1901.4532318115234,26365,6270,20095,20095,0,22,6417000.0
6417,6417999,20.260153674892457,37.19175500425816,0.08483280633121248,2317.3334617614746,501.6703464984894,1900.913833618164,26366,6270,20096,20096,0,22,6418000.0
6418,6418999,20.259535392716995,37.19033760216225,0.08482155100641631,2317.5749332904816,501.7361717224121,1901.6386337280273,26366,6270,20096,20096,0,22,6419000.0
6419,6419999,20.259035481325327,37.18909764415885,0.08481134426358372,2317.943866968155,501.8048346042633,1901.8734664916992,26366,6270,20096,20096,0,22,6420000.0
6420,6420999,20.258610156907512,37.187912993584284,0.08479744328492955,2318.2581679821014,501.876779794693,1902.3958740234375,26368,6271,20097,20097,0,22,6421000.0
6421,6421999,20.25812121242193,37.1867341639706,0.08478731103368453,2318.763323545456,501.9442992210388,1902.0846099853516,26371,6272,20099,20099,0,22,6422000.0
6422,6422999,20.25772663754999,37.18556489135027,0.08477560521501781,2319.26122379303,502.014511346817,1901.8259658813477,26377,6274,20103,20103,0,22,6423000.0
6423,6423999,20.2572528623475,37.18420328961865,0.08476676794302906,2319.746707677841,502.0832962989807,1901.7523803710938,26383,6276,20107,20107,0,22,6424000.0
6424,6424999,20.25664590638875,37.18260288500601,0.0847655744262178,2320.1266524791718,502.1549508571625,1902.010238647461,26386,6277,20109,20109,0,22,6425000.0
6425,6425999,20.25604507338825,37.18190578713575,0.08476600664247025,2320.6164333820343,502.2228240966797,1901.9281921386719,26403,6279,20124,20124,0,22,6426000.0
6426,6426999,20.25547213102341,37.181494063156535,0.08475583010166832,2320.811351299286,502.2931935787201,1903.0492553710938,26403,6279,20124,20124,0,22,6427000.0
6427,6427999,20.254738164367662,37.179785242279976,0.08475304030904485,2321.164892435074,502.36169934272766,1903.9375915527344,26429,6281,20148,20148,0,22,6428000.0
6428,6428999,20.254090849467016,37.178458758751816,0.08475309243127416,2321.6885282993317,502.4287006855011,1904.1077117919922,26446,6284,20162,20162,0,22,6429000.0
6429,6429999,20.253347374005564,37.176879496327345,0.08475445204434462,2321.8918035030365,502.49299669265747,1905.2275848388672,26448,6284,20164,20164,0,22,6430000.0
6430,6430999,20.252825832588453,37.17583803283018,0.08475037334113822,2322.16712141037,502.5585997104645,1905.9462432861328,26451,6285,20166,20166,0,22,6431000.0
6431,6431999,20.25221504320402,37.17441720163674,0.08474638245020116,2322.497986793518,502.6285128593445,1906.404640197754,26454,6286,20168,20168,0,22,6432000.0
6432,6432999,20.25175321568254,37.173755691517464,0.08474229321831683,2323.25762796402,502.69571185112,1905.3309020996094,26467,6291,20176,20176,0,22,6433000.0
6433,6433999,20.251305078568887,37.17287925528008,0.08473534271014171,2323.6602561473846,502.7626299858093,1905.5714874267578,26470,6292,20178,20178,0,22,6434000.0
6434,6434999,20.25097354962814,37.17229369773001,0.08472397587624836,2324.027609348297,502.8283679485321,1905.9860458374023,26475,6294,20181,20181,0,22,6435000.0
6435,6435999,20.250788629314606,37.171682686789495,0.08471205377278335,2324.4381828308105,502.89624786376953,1906.2655639648438,26479,6296,20183,20183,0,22,6436000.0
6436,6436999,20.250701939568334,37.171248169390516,0.08469886245181191,2325.0367205142975,502.96633291244507,1905.7820892333984,26488,6299,20189,20189,0,22,6437000.0
6437,6437999,20.250746601218246,37.170832955143005,0.08468780665063491,2325.3194720745087,503.032212972641,1906.3407363891602,26491,6300,20191,20191,0,22,6438000.0
6438,6438999,20.250557813104894,37.170027351020316,0.08467977901547896,2325.9865074157715,503.1029770374298,1905.4169998168945,26495,6302,20193,20193,0,22,6439000.0
6439,6439999,20.25054310527136,37.16947712625276,0.08467956428805834,2326.22865319252,503.17083263397217,1906.293212890625,26497,6303,20194,20194,0,22,6440000.0
6440,6440999,20.25081987350827,37.17003343260649,0.08467255943190899,2326.6513884067535,503.2390458583832,1906.4755783081055,26501,6305,20196,20196,0,22,6441000.0
6441,6441999,20.25084587934928,37.16948613224093,0.08466628055195458,2326.8782122135162,503.3059678077698,1907.2346115112305,26501,6305,20196,20196,0,22,6442000.0
6442,6442999,20.251093666579635,37.16918951737718,0.0846818196912682,2327.3143849372864,503.3747067451477,1907.132438659668,26504,6306,20198,20198,0,22,6443000.0
6443,6443999,20.2515374293806,37.16956775956933,0.0846773774600782,2327.832518339157,503.44440722465515,1906.8082427978516,26508,6308,20200,20200,0,22,6444000.0
6444,6444999,20.25165599110434,37.169145708902235,0.08467528191806806,2328.2638347148895,503.5151369571686,1906.7266540527344,26508,6308,20200,20200,0,22,6445000.0
6445,6445999,20.25198187150147,37.16979494813423,0.08467184393979421,2328.7035598754883,503.58255100250244,1906.8353576660156,26515,6309,20206,20206,0,22,6446000.0
6446,6446999,20.252183198159262,37.16939337521705,0.08466001166280268,2328.984797477722,503.65564465522766,1907.572395324707,26523,6310,20213,20213,0,22,6447000.0
6447,6447999,20.251949221031193,37.16813516911396,0.08465318793252508,2329.5007088184357,503.7245514392853,1907.7890548706055,26538,6312,20226,20226,0,22,6448000.0
6448,6448999,20.251763771674135,37.168163084180435,0.08464032379474318,2329.753954410553,503.7917528152466,1908.829490661621,26540,6312,20228,20228,0,22,6449000.0
6449,6449999,20.252304769878332,37.169139352241736,0.08462271904428509,2330.060940504074,503.8593399524689,1909.36767578125,26542,6312,20230,20230,0,22,6450000.0
6450,6450999,20.252707353347443,37.1695041132738,0.08460693767385474,2330.4146077632904,503.92694783210754,1909.9062576293945,26544,6313,20231,20231,0,22,6451000.0
6451,6451999,20.253568582193335,37.17015020381619,0.0845975102703358,2330.836957216263,503.9941692352295,1909.9900817871094,26549,6315,20234,20234,0,22,6452000.0
6452,6452999,20.254565997208875,37.172287542515505,0.08458308097331324,2331.393491744995,504.062198638916,1909.5152282714844,26555,6317,20238,20238,0,22,6453000.0
6453,6453999,20.255416490953287,37.172781138253534,0.0845827390537317,2331.8488080501556,504.129390001297,1909.6698455810547,26560,6319,20241,20241,0,22,6454000.0
6454,6454999,20.25678781212036,37.17443714508733,0.08457737752890138,2332.2623171806335,504.19709038734436,1909.7934188842773,26563,6320,20243,20243,0,22,6455000.0
6455,6455999,20.258098952431926,37.17604959985092,0.08458680784059613,2332.7396545410156,504.2674777507782,1909.8705749511719,26571,6323,20248,20248,0,22,6456000.0
6456,6456999,20.259458274371553,37.177083256548556,0.08460271510005835,2333.2002840042114,504.3356931209564,1909.9937133789062,26576,6325,20251,20251,0,22,6457000.0
6457,6457999,20.260874778521547,37.17878146730194,0.08463784094933857,2333.44837141037,504.4037711620331,1910.6350173950195,26576,6325,20251,20251,0,22,6458000.0
6458,6458999,20.262101461919702,37.17992172297083,0.08467702814789513,2333.9728932380676,504.47306537628174,1910.162338256836,26579,6326,20253,20253,0,22,6459000.0
6459,6459999,20.263482276517706,37.18101371068618,0.08469868091616528,2334.4325156211853,504.5413374900818,1910.2123260498047,26585,6328,20257,20257,0,22,6460000.0
6460,6460999,20.264927755110552,37.18226764647701,0.08473973963820003,2334.871524810791,504.60978055000305,1910.2180709838867,26590,6330,20260,20260,0,22,6461000.0
6461,6461999,20.26645445096797,37.183543419400834,0.08477120884278544,2335.305408000946,504.67908549308777,1910.1194076538086,26590,6330,20260,20260,0,22,6462000.0
6462,6462999,20.267755976303476,37.184255429258876,0.08480338668745457,2335.757227420807,504.7499768733978,1910.2117233276367,26595,6332,20263,20263,0,22,6463000.0
6463,6463999,20.269099566537683,37.1851155972868,0.08484042813931192,2336.0926451683044,504.8198971748352,1910.5965576171875,26597,6333,20264,20264,0,22,6464000.0
6464,6464999,20.270246957962183,37.185557357032174,0.08486178948793055,2336.6457846164703,504.8891625404358,1910.0310592651367,26599,6334,20265,20265,0,22,6465000.0
6465,6465999,20.27144778926323,37.185961585771445,0.08488097915587689,2337.0269417762756,504.9595603942871,1910.3369140625,26601,6335,20266,20266,0,22,6466000.0
6466,6466999,20.272178564889135,37.18548571284341,0.08489167310448043,2337.3539338111877,505.03904247283936,1910.8429946899414,26601,6335,20266,20266,0,22,6467000.0
6467,6467999,20.27223216636352,37.184611940482895,0.08488187166400907,2337.823440551758,505.10701870918274,1911.0998992919922,26612,6336,20276,20276,0,22,6468000.0
6468,6468999,20.271347626969913,37.18312413924429,0.0848807693748993,2338.097712993622,505.1725618839264,1912.163688659668,26619,6337,20282,20282,0,22,6469000.0
6469,6469999,20.27053135723996,37.18191650080468,0.0848781471983332,2338.478677034378,505.23778557777405,1912.599952697754,26628,6338,20290,20290,0,22,6470000.0
6470,6470999,20.26964378856861,37.18061012827319,0.08488002657069982,2339.0168237686157,505.3034384250641,1912.3407135009766,26634,6340,20294,20294,0,22,6471000.0
6471,6471999,20.268985691191247,37.17953866855685,0.08487529340095723,2339.4005789756775,505.3682475090027,1912.7823181152344,26638,6341,20297,20297,0,22,6472000.0
6472,6472999,20.268100107559945,37.178153842219274,0.0848719572007427,2339.7746365070343,505.43243193626404,1913.0014266967773,26641,6342,20299,20299,0,22,6473000.0
6473,6473999,20.267524895730244,37.1775194494085,0.08486713540011492,2340.2017755508423,505.4994819164276,1913.167709350586,26646,6344,20302,20302,0,22,6474000.0
6474,6474999,20.267084599171678,37.17669379858318,0.08486131147645326,2340.4854395389557,505.5646936893463,1913.818733215332,26649,6345,20304,20304,0,22,6475000.0
6475,6475999,20.266682654447056,37.17569760958916,0.08485712608509532,2340.858278274536,505.62980937957764,1913.9324951171875,26652,6346,20306,20306,0,22,6476000.0
6476,6476999,20.266316756054977,37.17463555372675,0.08485256891325055,2341.203421354294,505.6984508037567,1914.3225402832031,26656,6347,20309,20309,0,22,6477000.0
6477,6477999,20.266452553981733,37.17459315495414,0.08485536333955401,2341.6108870506287,505.76302886009216,1914.3794631958008,26659,6348,20311,20311,0,22,6478000.0
6478,6478999,20.266942992557507,37.17489097498712,0.0848522101551078,2342.125288248062,505.8285028934479,1914.0402297973633,26664,6350,20314,20314,0,22,6479000.0
6479,6479999,20.267448041615076,37.17550863037578,0.08485417601024725,2342.3776063919067,505.89487981796265,1914.8374481201172,26664,6350,20314,20314,0,22,6480000.0
6480,6480999,20.268126250892166,37.17640397878131,0.08484910810271917,2342.6607937812805,505.95908546447754,1915.225715637207,26664,6350,20314,20314,0,22,6481000.0
6481,6481999,20.269031809581353,37.1771835370758,0.08485349180668955,2342.9552404880524,506.0257501602173,1915.6030883789062,26664,6350,20314,20314,0,22,6482000.0
6482,6482999,20.270039965685545,37.17857565605974,0.08485368519382486,2343.2954902648926,506.09224796295166,1915.8273086547852,26666,6351,20315,20315,0,22,6483000.0
6483,6483999,20.270934296224848,37.179465916783855,0.08486655467654558,2343.695219039917,506.1623842716217,1915.8017044067383,26666,6351,20315,20315,0,22,6484000.0
6484,6484999,20.2722048842235,37.18161292466051,0.08486664833210167,2344.1516859531403,506.2270538806915,1915.6634902954102,26668,6352,20316,20316,0,22,6485000.0
6485,6485999,20.273186691942506,37.18266009805379,0.08486984792418295,2344.570214033127,506.29177474975586,1915.8614501953125,26673,6354,20319,20319,0,22,6486000.0
6486,6486999,20.274120770066773,37.18318343861114,0.08487179270318168,2344.8978354930878,506.35847067832947,1916.0938186645508,26673,6354,20319,20319,0,22,6487000.0
6487,6487999,20.274604989752753,37.18297176589075,0.08487019988418121,2345.356514930725,506.42520785331726,1916.1079330444336,26677,6356,20321,20321,0,22,6488000.0
6488,6488999,20.274605784764297,37.18280114974879,0.08483681223149164,2345.772470474243,506.4909477233887,1916.80322265625,26697,6358,20339,20339,0,22,6489000.0
6489,6489999,20.274062520605305,37.182570141956894,0.08477926253233681,2346.033462524414,506.55743885040283,1918.0951309204102,26701,6359,20342,20342,0,22,6490000.0
6490,6490999,20.273661376763027,37.18238917490379,0.08474104913173208,2346.231971502304,506.6224880218506,1919.1941299438477,26702,6359,20343,20343,0,22,6491000.0
6491,6491999,20.27314451263528,37.18146632360841,0.0847255663373997,2346.5874116420746,506.69319796562195,1919.7178497314453,26705,6360,20345,20345,0,22,6492000.0
6492,6492999,20.27270824373469,37.180263253296935,0.08470826045043844,2346.9224853515625,506.7596321105957,1920.16162109375,26708,6361,20347,20347,0,22,6493000.0
6493,6493999,20.271950376025327,37.179095054353844,0.08468859415148566,2347.1997113227844,506.8266587257385,1920.7804336547852,26710,6362,20348,20348,0,22,6494000.0
6494,6494999,20.271533946448624,37.17797894076015,0.0846613724110773,2347.719720363617,506.89479184150696,1920.7265167236328,26717,6365,20352,20352,0,22,6495000.0
6495,6495999,20.27105668370497,37.17922309721154,0.0846347385206383,2348.2433409690857,506.96888279914856,1920.6200332641602,26723,6368,20355,20355,0,22,6496000.0
6496,6496999,20.27039375185769,37.17784429747014,0.08461852920247048,2348.579436302185,507.0389907360077,1920.9377059936523,26724,6368,20356,20356,0,22,6497000.0
6497,6497999,20.269915954630395,37.17676375652798,0.0846019006482639,2348.8234939575195,507.1082305908203,1921.7032928466797,26725,6368,20357,20357,0,22,6498000.0
6498,6498999,20.26981602377272,37.17647863986628,0.08458498638266099,2349.248990535736,507.1799545288086,1921.7238464355469,26727,6369,20358,20358,0,22,6499000.0
6499,6499999,20.2700354055716,37.1763399117271,0.08455774559908147,2349.8005895614624,507.2479336261749,1921.188705444336,26729,6370,20359,20359,0,22,6500000.0
6500,6500999,20.270179172629906,37.175952795167206,0.08454040085923131,2350.039344549179,507.3165376186371,1921.9716491699219,26729,6370,20359,20359,0,22,6501000.0
6501,6501999,20.27015742758571,37.17526760992367,0.0845336152955497,2350.3707716464996,507.3861401081085,1922.3630447387695,26760,6371,20389,20389,0,22,6502000.0
6502,6502999,20.270913760024666,37.175812159912326,0.08452188698058039,2350.8417608737946,507.45561027526855,1922.1268920898438,26762,6372,20390,20390,0,22,6503000.0
6503,6503999,20.271646832845274,37.177067586877975,0.08450971356329773,2351.2821254730225,507.52489852905273,1922.276222229004,26766,6374,20392,20392,0,22,6504000.0
6504,6504999,20.27272492636181,37.178641970602136,0.08450051854921814,2351.6004128456116,507.59287095069885,1922.7929153442383,26768,6375,20393,20393,0,22,6505000.0
6505,6505999,20.27399348786916,37.180111785156456,0.08450694789536406,2351.934335231781,507.6613802909851,1923.1980743408203,26768,6375,20393,20393,0,22,6506000.0
6506,6506999,20.275567377412642,37.18328018515913,0.0845028448263796,2352.3626716136932,507.732052564621,1923.3896713256836,26772,6377,20395,20395,0,22,6507000.0
6507,6507999,20.277101609802518,37.1872089818198,0.0844941133845597,2352.955268383026,507.80048966407776,1922.84716796875,26783,6379,20404,20404,0,22,6508000.0
6508,6508999,20.277933217198864,37.18783903766282,0.08448865478222622,2353.2893192768097,507.8683784008026,1923.3299407958984,26785,6380,20405,20405,0,22,6509000.0
6509,6509999,20.27844412259802,37.18833824555828,0.08445723279642736,2353.4969050884247,507.9351727962494,1924.5704650878906,26795,6380,20415,20415,0,22,6510000.0
6510,6510999,20.278187742186212,37.187807550434606,0.08443407014505133,2353.733843564987,508.0066604614258,1925.7310485839844,26798,6380,20418,20418,0,22,6511000.0
6511,6511999,20.27776406122912,37.18646007642384,0.08441390544068061,2354.034833431244,508.07640957832336,1926.5206146240234,26803,6381,20422,20422,0,22,6512000.0
6512,6512999,20.27729078147359,37.18534675238866,0.08440109316870481,2354.3744230270386,508.1470203399658,1927.0452270507812,26814,6382,20432,20432,0,22,6513000.0
6513,6513999,20.27688500696054,37.18414131186638,0.08438868470076077,2354.9338116645813,508.21859192848206,1926.7890319824219,26824,6385,20439,20439,0,22,6514000.0
6514,6514999,20.276111512959602,37.18236664704871,0.08438004146481637,2355.424307346344,508.29552388191223,1927.0473937988281,26834,6387,20447,20447,0,22,6515000.0
6515,6515999,20.275716062756686,37.181101416708756,0.08436581647326358,2355.7905762195587,508.3664515018463,1927.4507217407227,26837,6388,20449,20449,0,22,6516000.0
6516,6516999,20.27506680392217,37.17953077133303,0.08436226391690405,2356.144884824753,508.44176721572876,1927.8184661865234,26837,6388,20449,20449,0,22,6517000.0
6517,6517999,20.274502583866468,37.178081152103495,0.08435542702449472,2356.569077730179,508.5123755931854,1928.0353775024414,26842,6390,20452,20452,0,22,6518000.0
6518,6518999,20.274184348731684,37.177292717288125,0.08433900430189578,2356.862957715988,508.5887131690979,1928.5756072998047,26842,6390,20452,20452,0,22,6519000.0
6519,6519999,20.273822155234814,37.17607461798164,0.08432750796133615,2357.2569019794464,508.65978717803955,1928.795265197754,26857,6391,20466,20466,0,22,6520000.0
6520,6520999,20.273386725919767,37.17492190734276,0.0843147612128905,2357.7635605335236,508.7330939769745,1929.0539932250977,26863,6394,20469,20469,0,22,6521000.0
6521,6521999,20.272833106162082,37.17339271752434,0.08431471064559515,2358.0990352630615,508.8058753013611,1929.778694152832,26865,6395,20470,20470,0,22,6522000.0
6522,6522999,20.272414058719654,37.17189333449602,0.08432092521762069,2358.396107196808,508.8762376308441,1930.4975509643555,26867,6396,20471,20471,0,22,6523000.0
6523,6523999,20.272009152074563,37.17045755962423,0.0843313070823305,2358.7255141735077,508.947128534317,1931.1782913208008,26870,6397,20473,20473,0,22,6524000.0
6524,6524999,20.271298623009084,37.16871445807206,0.08433807081465694,2359.0450637340546,509.0107741355896,1931.9633331298828,26884,6397,20487,20487,0,22,6525000.0
6525,6525999,20.270643134742794,37.16787480205533,0.08433638750526162,2359.5169064998627,509.0750894546509,1932.2284927368164,26896,6399,20497,20497,0,22,6526000.0
6526,6526999,20.270129188349372,37.16694858158904,0.08432888239867942,2359.9565708637238,509.1396050453186,1932.4603729248047,26901,6400,20501,20501,0,22,6527000.0
6527,6527999,20.269515905114883,37.16523306687025,0.08432261304375555,2360.1615130901337,509.2053461074829,1933.723617553711,26902,6400,20502,20502,0,22,6528000.0
6528,6528999,20.269077236386064,37.16353259712747,0.08431793495306228,2360.540112018585,509.2709927558899,1934.1567306518555,26908,6402,20506,20506,0,22,6529000.0
6529,6529999,20.268509407420005,37.16180451215801,0.08431262594454214,2360.7393646240234,509.3347063064575,1935.1594619750977,26908,6402,20506,20506,0,22,6530000.0
6530,6530999,20.26782356133017,37.16012036744029,0.08431304966635766,2361.1400275230408,509.40366101264954,1935.476936340332,26913,6404,20509,20509,0,22,6531000.0
6531,6531999,20.267036768660315,37.1584098413633,0.08431121190524771,2361.5918865203857,509.470849275589,1935.8818435668945,26920,6407,20513,20513,0,22,6532000.0
6532,6532999,20.266282155713192,37.156665740522584,0.08430311099012622,2362.3321738243103,509.5383059978485,1935.1465377807617,26933,6412,20521,20521,0,22,6533000.0
6533,6533999,20.26546633316261,37.15520184159525,0.08430400833074403,2362.765767812729,509.6090075969696,1935.48974609375,26939,6414,20525,20525,0,22,6534000.0
6534,6534999,20.2645385775094,37.15331882596871,0.08430655555968403,2363.0911931991577,509.6765546798706,1936.029556274414,26941,6415,20526,20526,0,22,6535000.0
6535,6535999,20.263803537382493,37.15181173278321,0.08430816040865063,2363.3142960071564,509.74272418022156,1936.9662475585938,26941,6415,20526,20526,0,22,6536000.0
6536,6536999,20.263082563391535,37.150480262915906,0.08430778584389953,2363.560956478119,509.80902338027954,1937.7979049682617,26943,6416,20527,20527,0,22,6537000.0
6537,6537999,20.26217755751185,37.14855029056053,0.08431373343083948,2363.9344651699066,509.87512397766113,1938.0505599975586,26948,6418,20530,20530,0,22,6538000.0
6538,6538999,20.261363761906825,37.14681022455817,0.08431886099809716,2364.4889421463013,509.9428253173828,1937.5436553955078,26950,6419,20531,20531,0,22,6539000.0
6539,6539999,20.260443047317942,37.144843352061365,0.08432773039880626,2364.9338660240173,510.0113775730133,1937.543930053711,26950,6419,20531,20531,0,22,6540000.0
6540,6540999,20.259533217616234,37.142872903727735,0.08433666097515624,2365.5347430706024,510.0804898738861,1937.388313293457,26959,6423,20536,20536,0,22,6541000.0
6541,6541999,20.258874621081624,37.14273263165616,0.08432696779972437,2365.8663470745087,510.1507978439331,1938.4039993286133,26971,6424,20547,20547,0,22,6542000.0
6542,6542999,20.257962807447075,37.140953857224844,0.08432797843895845,2366.3286125659943,510.220415353775,1938.6700897216797,26976,6426,20550,20550,0,22,6543000.0
6543,6543999,20.257409042171496,37.1414171584791,0.08431962432528972,2366.5780413150787,510.29041361808777,1939.5634994506836,26977,6426,20551,20551,0,22,6544000.0
6544,6544999,20.25663569853884,37.139929908287016,0.08431926852743765,2366.8884737491608,510.36053252220154,1940.1225967407227,26979,6426,20553,20553,0,22,6545000.0
6545,6545999,20.2560041048287,37.13878993051326,0.08431557399422107,2367.247318983078,510.43058037757874,1940.353042602539,26979,6426,20553,20553,0,22,6546000.0
6546,6546999,20.255475189725814,37.137505486677334,0.08431076024019235,2367.6431193351746,510.50097727775574,1940.4666442871094,26980,6426,20554,20554,0,22,6547000.0
6547,6547999,20.254765006211734,37.13615535875745,0.08431115593909477,2368.0717713832855,510.57311153411865,1941.0108947753906,26998,6428,20570,20570,0,22,6548000.0
6548,6548999,20.254157945667043,37.13467961852943,0.08430795312961425,2368.367470741272,510.64484572410583,1941.9285507202148,27002,6429,20573,20573,0,22,6549000.0
6549,6549999,20.253409157404253,37.13337290695432,0.08430387228575176,2368.650132417679,510.71784496307373,1942.5728225708008,27002,6429,20573,20573,0,22,6550000.0
6550,6550999,20.25286659346595,37.13215050976159,0.08429877970737187,2369.0764088630676,510.7900323867798,1942.595817565918,27005,6430,20575,20575,0,22,6551000.0
6551,6551999,20.252464867754277,37.131732553366454,0.08429336187574354,2369.380325317383,510.8619439601898,1943.2556991577148,27007,6431,20576,20576,0,22,6552000.0
6552,6552999,20.251898413081832,37.13038760552918,0.08429212082913096,2369.799247980118,510.9340546131134,1943.3594512939453,27010,6432,20578,20578,0,22,6553000.0
6553,6553999,20.251522244952103,37.129706492278416,0.084286243147489,2370.225519180298,511.0079369544983,1943.3128662109375,27012,6433,20579,20579,0,22,6554000.0
6554,6554999,20.25109762553688,37.128545165773026,0.08428087750847324,2370.672404050827,511.08057379722595,1943.3145751953125,27015,6434,20581,20581,0,22,6555000.0
6555,6555999,20.250611590170823,37.12717124533478,0.08428033537565571,2371.0314321517944,511.1525294780731,1943.4477767944336,27015,6434,20581,20581,0,22,6556000.0
6556,6556999,20.250217854086834,37.12589197876479,0.08428082980097273,2371.4751069545746,511.2251453399658,1943.4894638061523,27017,6435,20582,20582,0,22,6557000.0
6557,6557999,20.24956044765905,37.124387184785604,0.08428135511668733,2371.719481229782,511.2986443042755,1944.2090301513672,27017,6435,20582,20582,0,22,6558000.0
6558,6558999,20.24901576725718,37.1228680159554,0.08428169896701299,2372.246109008789,511.37089490890503,1943.7058792114258,27017,6435,20582,20582,0,22,6559000.0
6559,6559999,20.248295352759374,37.1216516660915,0.0842786298610938,2372.55185341835,511.44555711746216,1944.7789306640625,27038,6435,20603,20603,0,22,6560000.0
6560,6560999,20.24835349908429,37.12639131417712,0.08424691961343911,2372.741208553314,511.5121536254883,1946.2511596679688,27039,6435,20604,20604,0,22,6561000.0
6561,6561999,20.247721004293687,37.12495936105661,0.08424095813141574,2372.9808053970337,511.57908391952515,1947.5269088745117,27046,6436,20610,20610,0,22,6562000.0
6562,6562999,20.24725679395504,37.12445991480327,0.0842310970562381,2373.2686855793,511.64842462539673,1948.4658889770508,27048,6437,20611,20611,0,22,6563000.0
6563,6563999,20.246661308214843,37.122939210964645,0.08423077834830284,2373.5458171367645,511.71516275405884,1949.1718368530273,27051,6438,20613,20613,0,22,6564000.0
6564,6564999,20.246001639851794,37.12185716715217,0.0842235926710555,2374.043398141861,511.78486943244934,1949.1010284423828,27057,6440,20617,20617,0,22,6565000.0
6565,6565999,20.245251467884685,37.120782196019704,0.08421441786336092,2374.5780277252197,511.85351610183716,1949.2468566894531,27067,6444,20623,20623,0,22,6566000.0
6566,6566999,20.244577878745687,37.11930510496724,0.08421026878413795,2375.0035457611084,511.92163610458374,1949.6301727294922,27071,6446,20625,20625,0,22,6567000.0
6567,6567999,20.244199704937927,37.11877808429157,0.08420024570512563,2375.158908843994,511.9870855808258,1950.835350036621,27071,6446,20625,20625,0,22,6568000.0
6568,6568999,20.24393949805908,37.117967744742806,0.0841872703391876,2375.5187611579895,512.0534021854401,1951.2494583129883,27075,6448,20627,20627,0,22,6569000.0
6569,6569999,20.243321101051308,37.11665951221966,0.08418329976884253,2376.0190608501434,512.1220915317535,1951.1063690185547,27079,6450,20629,20629,0,22,6570000.0
6570,6570999,20.243092509692012,37.11606815022157,0.08417239611018545,2376.2538452148438,512.1908268928528,1951.8943557739258,27079,6450,20629,20629,0,22,6571000.0
6571,6571999,20.243150306304532,37.11580299950453,0.08416437817750655,2376.5751073360443,512.2590932846069,1952.3963623046875,27079,6450,20629,20629,0,22,6572000.0
6572,6572999,20.24335888288456,37.11539724728474,0.08415553095734418,2376.7791271209717,512.3260872364044,1953.218360900879,27079,6450,20629,20629,0,22,6573000.0
6573,6573999,20.243884521078805,37.11581359888382,0.08414680808938735,2377.193561077118,512.3942763805389,1953.2918395996094,27081,6451,20630,20630,0,22,6574000.0
6574,6574999,20.24459021572117,37.11648591128058,0.0841364272986127,2377.591632604599,512.4613285064697,1953.275505065918,27081,6451,20630,20630,0,22,6575000.0
6575,6575999,20.24619764167542,37.11947148609234,0.08413858687183151,2377.991856575012,512.5299365520477,1953.4038009643555,27084,6452,20632,20632,0,22,6576000.0
6576,6576999,20.247201241332398,37.12024959358187,0.08415408593240548,2378.7375087738037,512.5991299152374,1952.5214309692383,27092,6456,20636,20636,0,22,6577000.0
6577,6577999,20.248795984294034,37.12389697645703,0.08415793621038303,2379.0793557167053,512.6666784286499,1953.099235534668,27107,6457,20650,20650,0,22,6578000.0
6578,6578999,20.250444022734143,37.125980760596505,0.08416512534073406,2379.3385870456696,512.7339911460876,1954.0720596313477,27107,6457,20650,20650,0,22,6579000.0
6579,6579999,20.25135642636787,37.12657463589595,0.08417183683598084,2379.6843116283417,512.8015983104706,1954.6329727172852,27109,6458,20651,20651,0,22,6580000.0
6580,6580999,20.251725742813758,37.12684721629784,0.084163433091621,2380.1191778182983,512.8702824115753,1955.3897171020508,27142,6460,20682,20682,0,22,6581000.0
6581,6581999,20.251004533636632,37.125828276219735,0.08415642587744943,2380.299055814743,512.9388935565948,1957.0060653686523,27143,6460,20683,20683,0,22,6582000.0
6582,6582999,20.2506389915113,37.125498781701666,0.08414959499444907,2380.7097227573395,513.0067551136017,1957.24462890625,27145,6461,20684,20684,0,22,6583000.0
6583,6583999,20.25070238890201,37.12757637394688,0.08413270083414237,2380.9036848545074,513.0734477043152,1958.3312377929688,27145,6461,20684,20684,0,22,6584000.0
6584,6584999,20.250619324646173,37.12670546693183,0.08412537398381481,2381.281056165695,513.1417009830475,1958.6579971313477,27151,6463,20688,20688,0,22,6585000.0
6585,6585999,20.250713437800304,37.126598495928725,0.08411810001590736,2381.695929288864,513.2111229896545,1958.923698425293,27157,6466,20691,20691,0,22,6586000.0
6586,6586999,20.250745375338322,37.12577020950239,0.08411748017248488,2382.2095804214478,513.2831654548645,1959.0040435791016,27164,6469,20695,20695,0,22,6587000.0
6587,6587999,20.250799830509045,37.12572016104838,0.08411862417707949,2382.762304544449,513.3532934188843,1958.9680252075195,27171,6472,20699,20699,0,22,6588000.0
6588,6588999,20.251093346115958,37.12607473452678,0.08411875795196855,2383.130474090576,513.4240710735321,1959.3847045898438,27175,6474,20701,20701,0,22,6589000.0
6589,6589999,20.25153061572346,37.126406026805284,0.08411796196472132,2383.564444065094,513.4949555397034,1959.4635620117188,27178,6475,20703,20703,0,22,6590000.0
6590,6590999,20.252220254710345,37.12729452289438,0.08412148109738316,2383.9748821258545,513.5673105716705,1959.7772827148438,27188,6476,20712,20712,0,22,6591000.0
6591,6591999,20.25316219477768,37.1287845401884,0.08412900251111843,2384.1914715766907,513.6372649669647,1960.6417541503906,27188,6476,20712,20712,0,22,6592000.0
6592,6592999,20.254317313048496,37.13062493194699,0.08414539828093659,2384.4505722522736,513.7072875499725,1961.2351150512695,27188,6476,20712,20712,0,22,6593000.0
6593,6593999,20.256059997984096,37.13562011496287,0.08416528965067438,2384.7404255867004,513.7765591144562,1961.6278381347656,27188,6476,20712,20712,0,22,6594000.0
6594,6594999,20.257279733086285,37.13703886479876,0.08417859191567911,2385.292638540268,513.8467919826508,1960.9911651611328,27188,6476,20712,20712,0,22,6595000.0
6595,6595999,20.2593985224131,37.14289033304672,0.08420166862066214,2385.540326356888,513.9191207885742,1961.7919921875,27188,6476,20712,20712,0,22,6596000.0
6596,6596999,20.261672328073395,37.149911943713136,0.08421539814806678,2385.886496067047,513.9906363487244,1962.0264434814453,27188,6476,20712,20712,0,22,6597000.0
6597,6597999,20.263938242364038,37.15388991599427,0.08424974977447686,2386.272537469864,514.0603919029236,1962.2999877929688,27192,6478,20714,20714,0,22,6598000.0
6598,6598999,20.266023543030563,37.15827817067825,0.08428130188365135,2386.6523480415344,514.1322400569916,1962.3139419555664,27192,6478,20714,20714,0,22,6599000.0
6599,6599999,20.268406518574462,37.16232022936655,0.08431557095117292,2387.2340223789215,514.2023618221283,1961.9354629516602,27198,6481,20717,20717,0,22,6600000.0
6600,6600999,20.270020606633405,37.164382735098584,0.08434991036203399,2387.6609013080597,514.2728719711304,1962.037826538086,27200,6482,20718,20718,0,22,6601000.0
6601,6601999,20.270000447683277,37.16349038519276,0.08434266937541979,2387.952436208725,514.338182926178,1963.134750366211,27216,6482,20734,20734,0,22,6602000.0
6602,6602999,20.268991688633704,37.162052640147785,0.08434181438060029,2388.1853506565094,514.4027562141418,1964.239158630371,27220,6482,20738,20738,0,22,6603000.0
6603,6603999,20.26822396848845,37.16096580438931,0.0843363736793109,2388.388085603714,514.4665887355804,1965.1753158569336,27221,6482,20739,20739,0,22,6604000.0
6604,6604999,20.26744748717933,37.15966896470573,0.08433268112006542,2388.7778000831604,514.531578540802,1965.3713150024414,27223,6483,20740,20740,0,22,6605000.0
6605,6605999,20.26682908214495,37.15861826001929,0.08432735399921909,2389.222715854645,514.597992181778,1965.5768966674805,27231,6486,20745,20745,0,22,6606000.0
6606,6606999,20.265990192561116,37.15707177536674,0.08432562948606737,2389.74919462204,514.6644051074982,1965.3206100463867,27235,6488,20747,20747,0,22,6607000.0
6607,6607999,20.265115022765908,37.155356454671946,0.08432391606181366,2390.0719769001007,514.7354099750519,1966.0041694641113,27238,6489,20749,20749,0,22,6608000.0
6608,6608999,20.264315350053014,37.15369896501378,0.08432170919792159,2390.4684619903564,514.8021473884583,1966.0934257507324,27240,6490,20750,20750,0,22,6609000.0
6609,6609999,20.263540628573075,37.151945759519855,0.0843186040354682,2390.8849382400513,514.8687431812286,1966.3027076721191,27242,6491,20751,20751,0,22,6610000.0
6610,6610999,20.262899211676793,37.15067158235734,0.08431591552299633,2391.1461391448975,514.9362819194794,1966.9532737731934,27242,6491,20751,20751,0,22,6611000.0
6611,6611999,20.262293260076525,37.14918607851519,0.08431487491791145,2391.414691209793,515.0016810894012,1967.3971366882324,27242,6491,20751,20751,0,22,6612000.0
6612,6612999,20.261915422901552,37.14852659212232,0.0843151282876331,2391.9277687072754,515.0668230056763,1967.119228363037,27247,6493,20754,20754,0,22,6613000.0
6613,6613999,20.261370596509693,37.14710382944044,0.08431146940204826,2392.308065891266,515.1340372562408,1967.2329139709473,27249,6494,20755,20755,0,22,6614000.0
6614,6614999,20.261029380716803,37.14603020999712,0.08430891021809828,2392.6591534614563,515.2016425132751,1967.510829925537,27253,6495,20758,20758,0,22,6615000.0
6615,6615999,20.260595025803273,37.14455112622967,0.08430847812278564,2393.1538581848145,515.2675545215607,1967.4024696350098,27259,6497,20762,20762,0,22,6616000.0
6616,6616999,20.260556152624872,37.14387629442765,0.08430624853992863,2393.358942270279,515.3320248126984,1968.2414741516113,27259,6497,20762,20762,0,22,6617000.0
6617,6617999,20.260440482438298,37.14313886959757,0.08430203184369445,2393.739615917206,515.399293422699,1968.293056488037,27259,6497,20762,20762,0,22,6618000.0
6618,6618999,20.260164379653194,37.14190935150939,0.08429917807449383,2394.1341280937195,515.466521024704,1968.383945465088,27261,6498,20763,20763,0,22,6619000.0
6619,6619999,20.259967382999722,37.140751713183256,0.0842972551277349,2394.59756565094,515.5335884094238,1968.2266807556152,27264,6499,20765,20765,0,22,6620000.0
6620,6620999,20.259497832320584,37.1392918069778,0.08429644546715731,2394.9812331199646,515.5996162891388,1968.4832496643066,27275,6500,20775,20775,0,22,6621000.0
6621,6621999,20.259071625208804,37.13781624536835,0.08429244299798522,2395.406188249588,515.6651294231415,1968.5265083312988,27277,6501,20776,20776,0,22,6622000.0
6622,6622999,20.259615208712482,37.140340234605695,0.0841297791289084,2395.643866300583,515.7319796085358,1969.822597503662,27290,6501,20789,20789,0,22,6623000.0
6623,6623999,20.259112929271208,37.139445049565936,0.0841031472003706,2395.93128657341,515.7981443405151,1970.6680793762207,27294,6502,20792,20792,0,22,6624000.0
6624,6624999,20.258339857041275,37.13772454047182,0.08409111698187066,2396.354851961136,515.8646974563599,1970.7883033752441,27300,6504,20796,20796,0,22,6625000.0
6625,6625999,20.257943084221232,37.13638143342174,0.08407037506270221,2396.654172182083,515.932938337326,1971.3163032531738,27301,6504,20797,20797,0,22,6626000.0
6626,6626999,20.25727985643621,37.13508182529573,0.08406007695576334,2397.1183145046234,515.9999160766602,1971.463535308838,27309,6507,20802,20802,0,22,6627000.0
6627,6627999,20.25679072137611,37.13393156433502,0.08404396953670545,2397.4872403144836,516.0671923160553,1971.66548538208,27309,6507,20802,20802,0,22,6628000.0
6628,6628999,20.25608372898554,37.13235323086737,0.08403685515492743,2397.861256122589,516.1349084377289,1971.8932151794434,27312,6508,20804,20804,0,22,6629000.0
6629,6629999,20.255347642152444,37.13092044844272,0.08402757789659188,2398.155442714691,516.2028918266296,1972.311107635498,27312,6508,20804,20804,0,22,6630000.0
6630,6630999,20.25463354604916,37.12940049963359,0.08402141358211335,2398.5602827072144,516.271642446518,1972.4193229675293,27315,6509,20806,20806,0,22,6631000.0
6631,6631999,20.2538562554625,37.12763329177715,0.08401621311813545,2399.1200234889984,516.3396594524384,1971.9285011291504,27320,6511,20809,20809,0,22,6632000.0
6632,6632999,20.25297040877908,37.12596319342829,0.08401119522687084,2399.5228073596954,516.4080469608307,1972.2691688537598,27322,6512,20810,20810,0,22,6633000.0
6633,6633999,20.252138606347113,37.12437406902999,0.08400675725748552,2399.9168572425842,516.477511882782,1972.6014823913574,27326,6514,20812,20812,0,22,6634000.0
6634,6634999,20.251443558284212,37.12338434856375,0.0840000866926357,2400.335338115692,516.5466687679291,1972.6338005065918,27328,6515,20813,20813,0,22,6635000.0
6635,6635999,20.250810690410603,37.121996700892964,0.08399719029804009,2400.6549360752106,516.6161406040192,1972.9653053283691,27331,6516,20815,20815,0,22,6636000.0
6636,6636999,20.25013844469693,37.12086263799664,0.0839916943781206,2401.161947250366,516.6879317760468,1972.658290863037,27333,6517,20816,20816,0,22,6637000.0
6637,6637999,20.249504795111623,37.11933904653318,0.08398930107358216,2401.724939584732,516.760374546051,1972.321590423584,27338,6519,20819,20819,0,22,6638000.0
6638,6638999,20.248813268555356,37.11775510293227,0.08399031701793591,2401.9454526901245,516.8329718112946,1973.1150398254395,27338,6519,20819,20819,0,22,6639000.0
6639,6639999,20.24816334861266,37.11634586522657,0.08398574416747084,2402.6525144577026,516.9045603275299,1972.1120796203613,27344,6522,20822,20822,0,22,6640000.0
6640,6640999,20.247645588477234,37.11705613097941,0.08397370780419755,2403.1163413524628,516.9725878238678,1972.3755149841309,27352,6525,20827,20827,0,22,6641000.0
6641,6641999,20.246780596644925,37.115240356072626,0.08397986412057856,2403.6557013988495,517.0418288707733,1971.980525970459,27356,6527,20829,20829,0,22,6642000.0
6642,6642999,20.246457076316666,37.113847488442865,0.08396762799924706,2403.943212747574,517.1122057437897,1973.003086090088,27364,6528,20836,20836,0,22,6643000.0
6643,6643999,20.246274942665462,37.1131875157037,0.08394145762004124,2404.238002538681,517.1815004348755,1973.8817558288574,27365,6528,20837,20837,0,22,6644000.0
6644,6644999,20.245721409373118,37.111700254088596,0.08393042693686792,2404.6655671596527,517.2478523254395,1974.1254844665527,27368,6529,20839,20839,0,22,6645000.0
6645,6645999,20.24516407670381,37.11025725999425,0.08392217762131338,2405.2332537174225,517.3150980472565,1973.9370918273926,27376,6533,20843,20843,0,22,6646000.0
6646,6646999,20.245127314029816,37.109256655288235,0.08389886359032961,2405.540375471115,517.3908903598785,1974.719066619873,27384,6534,20850,20850,0,22,6647000.0
6647,6647999,20.24460563517662,37.1076352616982,0.08389081998499737,2405.8678810596466,517.4568746089935,1975.0319328308105,27386,6535,20851,20851,0,22,6648000.0
6648,6648999,20.244313877530924,37.10621448443011,0.08387388782318661,2406.320839881897,517.5256307125092,1975.0667304992676,27390,6537,20853,20853,0,22,6649000.0
6649,6649999,20.24400471180429,37.10497023155437,0.0838571053609578,2406.75678563118,517.594170331955,1975.1428108215332,27394,6539,20855,20855,0,22,6650000.0
6650,6650999,20.243581715727984,37.10370215493057,0.08384681968342844,2407.0852587223053,517.6635947227478,1975.433391571045,27394,6539,20855,20855,0,22,6651000.0
6651,6651999,20.243202869454937,37.10269314915567,0.0838348615671235,2407.4598338603973,517.7316401004791,1975.65571975708,27396,6540,20856,20856,0,22,6652000.0
6652,6652999,20.24288244428895,37.1015934458461,0.08383235566512648,2408.003875732422,517.8010649681091,1975.4355583190918,27402,6543,20859,20859,0,22,6653000.0
6653,6653999,20.24235358654231,37.10049208701907,0.08383270171877677,2408.4927592277527,517.8715806007385,1975.3278541564941,27406,6545,20861,20861,0,22,6654000.0
6654,6654999,20.24189547672828,37.09939435667881,0.0838329900522905,2408.918069124222,517.9404380321503,1975.2085762023926,27406,6545,20861,20861,0,22,6655000.0
6655,6655999,20.24145634086359,37.09894526464869,0.08383132485348566,2409.1866543293,518.0115504264832,1975.8042793273926,27406,6545,20861,20861,0,22,6656000.0
6656,6656999,20.240975859382264,37.09771598948133,0.08382962481486234,2409.516802072525,518.0810565948486,1976.1699104309082,27406,6545,20861,20861,0,22,6657000.0
6657,6657999,20.240896219593438,37.09750719949814,0.08383194953110906,2409.843760728836,518.1503856182098,1976.3737831115723,27406,6545,20861,20861,0,22,6658000.0
6658,6658999,20.240639762291586,37.09663072806138,0.08383013449168386,2410.2064990997314,518.2187867164612,1976.5664405822754,27406,6545,20861,20861,0,22,6659000.0
6659,6659999,20.240260999107072,37.09553941217705,0.08382716692586767,2410.6821870803833,518.2906966209412,1976.3384819030762,27408,6546,20862,20862,0,22,6660000.0
6660,6660999,20.239903795684956,37.0943885562069,0.08382495539004453,2410.954132795334,518.3595461845398,1976.834384918213,27408,6546,20862,20862,0,22,6661000.0
6661,6661999,20.239521141130716,37.093098843869406,0.08382445798056226,2411.4687507152557,518.430061340332,1976.4934730529785,27418,6547,20871,20871,0,22,6662000.0
6662,6662999,20.239023357947868,37.09158007246928,0.08382174948412413,2412.0440719127655,518.5001809597015,1975.886661529541,27429,6549,20880,20880,0,22,6663000.0
6663,6663999,20.239157374480886,37.091902673110916,0.083807898219597,2412.43257689476,518.5660495758057,1976.4220924377441,27437,6551,20886,20886,0,22,6664000.0
6664,6664999,20.239261543626778,37.0919528529282,0.08378803072857222,2412.8123445510864,518.6321728229523,1976.9244346618652,27441,6552,20889,20889,0,22,6665000.0
6665,6665999,20.23892324239581,37.09103268284767,0.08377502489133437,2413.0961384773254,518.6970989704132,1977.618854522705,27442,6552,20890,20890,0,22,6666000.0
6666,6666999,20.23877595901471,37.09019594986408,0.08375902909438349,2413.3790113925934,518.7602434158325,1978.3081016540527,27443,6552,20891,20891,0,22,6667000.0
6667,6667999,20.23921811122468,37.090317745307246,0.08372899190814065,2413.7133049964905,518.8267869949341,1978.8588600158691,27446,6553,20893,20893,0,22,6668000.0
6668,6668999,20.239417952614257,37.089952059677884,0.08370726103046777,2414.298047542572,518.8916590213776,1978.5204429626465,27452,6556,20896,20896,0,22,6669000.0
6669,6669999,20.240046727653617,37.09011058821718,0.08368052490764855,2414.5994691848755,518.9566848278046,1979.1868171691895,27454,6557,20897,20897,0,22,6670000.0
6670,6670999,20.240460460168396,37.08981115381764,0.08367661058145082,2415.110587835312,519.0227320194244,1979.1054496765137,27460,6560,20900,20900,0,22,6671000.0
6671,6671999,20.24085429171994,37.08946049172175,0.08364734143860941,2415.499841451645,519.0922043323517,1979.3762092590332,27463,6561,20902,20902,0,22,6672000.0
6672,6672999,20.241188078560143,37.08909297316659,0.08363492564784425,2415.872764825821,519.157876253128,1979.646686553955,27465,6562,20903,20903,0,22,6673000.0
6673,6673999,20.241580179613443,37.08958911670453,0.08361461321825969,2416.207070827484,519.2256917953491,1979.9444694519043,27465,6562,20903,20903,0,22,6674000.0
6674,6674999,20.242207635564114,37.0898229759276,0.08359022436051988,2416.9354767799377,519.2927417755127,1979.0438804626465,27477,6564,20913,20913,0,22,6675000.0
6675,6675999,20.242632448375176,37.089760837202654,0.08357697221632465,2417.4282944202423,519.3606824874878,1979.04642868042,27481,6566,20915,20915,0,22,6676000.0
6676,6676999,20.243526766489737,37.091115107746354,0.0835596976523072,2417.7354481220245,519.4285304546356,1979.5186805725098,27481,6566,20915,20915,0,22,6677000.0
6677,6677999,20.244666954557132,37.092853428771875,0.08355248720360697,2418.0732941627502,519.4947955608368,1980.0800743103027,27485,6568,20917,20917,0,22,6678000.0
6678,6678999,20.245589211696075,37.09384226384432,0.08353651417722807,2418.3634164333344,519.5611460208893,1980.5353202819824,27485,6568,20917,20917,0,22,6679000.0
6679,6679999,20.246830262314994,37.095986045701416,0.08353981547639089,2418.8637294769287,519.6283314228058,1980.3524742126465,27489,6570,20919,20919,0,22,6680000.0
6680,6680999,20.248017279650707,37.09777993236032,0.08355194876274519,2419.2808043956757,519.6957883834839,1980.6243782043457,27499,6571,20928,20928,0,22,6681000.0
6681,6681999,20.24927686250494,37.099842762848624,0.08356238654861747,2419.694795846939,519.763429403305,1980.7598152160645,27501,6572,20929,20929,0,22,6682000.0
6682,6682999,20.25096484545741,37.10300232071311,0.08358403210718612,2419.9262800216675,519.8354027271271,1981.5529899597168,27501,6572,20929,20929,0,22,6683000.0
6683,6683999,20.25230317902418,37.106040633851,0.08357639903417213,2420.430692911148,519.9065136909485,1981.312297821045,27503,6573,20930,20930,0,22,6684000.0
6684,6684999,20.25281826128734,37.10865068529814,0.08355112128920916,2420.717118024826,519.9725744724274,1982.1901512145996,27510,6573,20937,20937,0,22,6685000.0
6685,6685999,20.25308497559307,37.11893595152638,0.0834925657558947,2430.8483951091766,520.0397665500641,1982.8187828063965,27530,6575,20955,20955,0,22,6686000.0
6686,6686999,20.252866039713,37.11946287735473,0.08348443613376044,2431.3417551517487,520.1081786155701,1982.8772010803223,27541,6577,20964,20964,0,22,6687000.0
6687,6687999,20.252778905802373,37.12235571960345,0.08345938908685202,2431.7902870178223,520.1741361618042,1983.036808013916,27551,6579,20972,20972,0,22,6688000.0
6688,6688999,20.252311382478887,37.1216205910985,0.0834541906451104,2432.182172060013,520.2437345981598,1983.272533416748,27557,6580,20977,20977,0,22,6689000.0
6689,6689999,20.252279240893703,37.12422185802696,0.0834346778342191,2432.705392599106,520.3102533817291,1983.1684761047363,27574,6582,20992,20992,0,22,6690000.0
6690,6690999,20.25237643785013,37.124603200375105,0.08342972605111776,2433.1319303512573,520.3766958713531,1983.33304977417,27580,6584,20996,20996,0,22,6691000.0
6691,6691999,20.252145245555244,37.12367761762632,0.08342848683421644,2433.3305134773254,520.4440517425537,1984.2428245544434,27581,6584,20997,20997,0,22,6692000.0
6692,6692999,20.252847937817695,37.12580339343573,0.08340969187643277,2433.711501598358,520.510018825531,1984.4654579162598,27583,6585,20998,20998,0,22,6693000.0
6693,6693999,20.25321683956415,37.126723801460976,0.08339373067381994,2434.222099304199,520.5762400627136,1984.0947227478027,27585,6586,20999,20999,0,22,6694000.0
6694,6694999,20.254217992082705,37.12927333979145,0.08338549498739511,2434.5621197223663,520.6435279846191,1984.4097175598145,27585,6586,20999,20999,0,22,6695000.0
6695,6695999,20.255336873830583,37.1357944063043,0.0833571776863824,2435.028033733368,520.7094190120697,1984.4913063049316,27592,6589,21003,21003,0,22,6696000.0
6696,6696999,20.256411770945878,37.13817742012975,0.08334715738090681,2435.31502532959,520.7751741409302,1985.0491218566895,27593,6589,21004,21004,0,22,6697000.0
6697,6697999,20.257404470694492,37.14090545025587,0.08333372111548187,2435.8680295944214,520.842386007309,1984.6156730651855,27596,6590,21006,21006,0,22,6698000.0
6698,6698999,20.259345598557264,37.14765873251481,0.08330332385528061,2436.1240243911743,520.9096837043762,1985.3243598937988,27597,6590,21007,21007,0,22,6699000.0
6699,6699999,20.259812153007257,37.1478677581259,0.0832953773781625,2436.500356912613,520.9771313667297,1985.7736701965332,27603,6591,21012,21012,0,22,6700000.0
6700,6700999,20.259735109453906,37.14964222702711,0.08326767811359359,2436.9121510982513,521.049262046814,1986.2265129089355,27607,6592,21015,21015,0,22,6701000.0
6701,6701999,20.259424043625327,37.14942948018173,0.08325951079798855,2437.190171957016,521.114554643631,1987.0899696350098,27609,6593,21016,21016,0,22,6702000.0
6702,6702999,20.259752241476228,37.15056048583106,0.08323058462660038,2437.591278553009,521.1811261177063,1987.763828277588,27664,6596,21068,21068,0,22,6703000.0
6703,6703999,20.25970636765614,37.15056100305776,0.08321005602145448,2438.244081735611,521.2478272914886,1986.9685401916504,27668,6598,21070,21070,0,22,6704000.0
6704,6704999,20.259631108235496,37.150542247900226,0.08319790338151556,2438.5456926822662,521.3129246234894,1987.589687347412,27670,6599,21071,21071,0,22,6705000.0
6705,6705999,20.260018062621743,37.15119560345336,0.0831777862548101,2438.799310684204,521.3768122196198,1988.2009391784668,27670,6599,21071,21071,0,22,6706000.0
6706,6706999,20.260470447396763,37.15200415018652,0.0831473788492223,2439.3742110729218,521.4455802440643,1987.5895347595215,27674,6601,21073,21073,0,22,6707000.0
6707,6707999,20.261473230462297,37.15420813469723,0.08311800592045304,2439.839942932129,521.5097620487213,1987.594799041748,27680,6604,21076,21076,0,22,6708000.0
6708,6708999,20.262307667545425,37.1555350744987,0.08310112408766768,2440.1649482250214,521.5766260623932,1988.074779510498,27682,6605,21077,21077,0,22,6709000.0
6709,6709999,20.263520547325093,37.15717388943243,0.08308012281091381,2440.8353118896484,521.643904209137,1987.459629058838,27690,6609,21081,21081,0,22,6710000.0
6710,6710999,20.264381119886842,37.15846479387072,0.0830597199919183,2441.171513557434,521.711416721344,1987.928897857666,27692,6610,21082,21082,0,22,6711000.0
6711,6711999,20.265525981911143,37.16036011181312,0.08303917226454294,2441.6013538837433,521.7813766002655,1988.186580657959,27696,6612,21084,21084,0,22,6712000.0
6712,6712999,20.26696208425499,37.16334884257267,0.0830232655248071,2441.986737728119,521.84605717659,1988.2962532043457,27698,6613,21085,21085,0,22,6713000.0
6713,6713999,20.26832667457998,37.16499707272393,0.08301420540483162,2442.3451750278473,521.914288520813,1988.542652130127,27700,6614,21086,21086,0,22,6714000.0
6714,6714999,20.26988437172903,37.168021240390495,0.08300118526295752,2442.927817106247,521.979855298996,1988.1175575256348,27706,6617,21089,21089,0,22,6715000.0
6715,6715999,20.27099355066775,37.16916189018588,0.0829965194777178,2443.488288640976,522.046728849411,1987.8616523742676,27712,6620,21092,21092,0,22,6716000.0
6716,6716999,20.27239542988752,37.17050589760538,0.08299951302416153,2443.6999320983887,522.1153206825256,1988.7114219665527,27712,6620,21092,21092,0,22,6717000.0
6717,6717999,20.27364145845548,37.171596225013886,0.08299628612714549,2444.2886238098145,522.1825420856476,1988.2638893127441,27718,6623,21095,21095,0,22,6718000.0
6718,6718999,20.274096618334752,37.17269338025246,0.08297061746541268,2444.6371755599976,522.2487878799438,1988.7703971862793,27721,6623,21098,21098,0,22,6719000.0
6719,6719999,20.27390914365325,37.17399807192029,0.08295268771510989,2445.183589696884,522.3185396194458,1988.5190467834473,27730,6625,21105,21105,0,22,6720000.0
6720,6720999,20.273443922703894,37.172917134753234,0.0829468151252466,2445.5612428188324,522.3881182670593,1988.7656211853027,27733,6625,21108,21108,0,22,6721000.0
6721,6721999,20.27309946512937,37.17189426583156,0.08293914475187336,2445.9008073806763,522.4574332237244,1989.2483558654785,27735,6626,21109,21109,0,22,6722000.0
6722,6722999,20.272977990449874,37.17182918973623,0.0829301458549967,2446.308944940567,522.5259976387024,1989.2646293640137,27735,6626,21109,21109,0,22,6723000.0
6723,6723999,20.27285683805152,37.17105727838201,0.08291817725406114,2446.749677658081,522.5952877998352,1989.2474555969238,27737,6627,21110,21110,0,22,6724000.0
6724,6724999,20.27265156898515,37.17013458675996,0.08290906267835518,2447.1167936325073,522.6671674251556,1989.5536842346191,27738,6628,21110,21110,0,22,6725000.0
6725,6725999,20.272695922674625,37.16981968948819,0.082898358240729,2447.5681743621826,522.7375702857971,1989.6255073547363,27740,6629,21111,21111,0,22,6726000.0
6726,6726999,20.272640403585942,37.16917284399384,0.08289336453574325,2448.2288167476654,522.8095564842224,1988.8963050842285,27745,6632,21113,21113,0,22,6727000.0
6727,6727999,20.273064284952397,37.169586081169285,0.08288727769406601,2448.482213497162,522.880945444107,1989.6470069885254,27745,6632,21113,21113,0,22,6728000.0
6728,6728999,20.27334558560261,37.16927657406375,0.08289249189854164,2448.8387224674225,522.9505772590637,1989.9422187805176,27745,6632,21113,21113,0,22,6729000.0
6729,6729999,20.27367289138065,37.168861497660366,0.0828978540766585,2449.19255399704,523.022650718689,1990.2430152893066,27745,6632,21113,21113,0,22,6730000.0
6730,6730999,20.274243622765944,37.16915948933942,0.08289488942368806,2449.6503608226776,523.0949466228485,1990.0048866271973,27746,6633,21113,21113,0,22,6731000.0
6731,6731999,20.27463358523878,37.168929170686226,0.08289516741945668,2450.078639268875,523.1683759689331,1990.03560256958,27748,6634,21114,21114,0,22,6732000.0
6732,6732999,20.27504195541421,37.16859670503636,0.08288833468268642,2450.467453956604,523.2404429912567,1990.2542915344238,27749,6635,21114,21114,0,22,6733000.0
6733,6733999,20.275865757573545,37.16893284458722,0.08289086349554187,2450.8509624004364,523.3178651332855,1990.4474449157715,27749,6635,21114,21114,0,22,6734000.0
6734,6734999,20.276246180956637,37.16844784255234,0.0828871420645717,2451.2603752613068,523.3912234306335,1990.3819389343262,27749,6635,21114,21114,0,22,6735000.0
6735,6735999,20.276760353150923,37.16802192547496,0.08287941039125657,2451.758038520813,523.4703049659729,1990.1811408996582,27751,6636,21115,21115,0,22,6736000.0
6736,6736999,20.277175961788025,37.1675945002835,0.08287477785724795,2452.3432846069336,523.5434091091156,1989.5958366394043,27753,6637,21116,21116,0,22,6737000.0
6737,6737999,20.27767992275545,37.16704036294738,0.08286704788959132,2452.7288365364075,523.6185224056244,1989.7515296936035,27754,6638,21116,21116,0,22,6738000.0
6738,6738999,20.27768647830275,37.1658377561852,0.08286122512298966,2453.1044726371765,523.6911256313324,1990.1952095031738,27760,6639,21121,21121,0,22,6739000.0
6739,6739999,20.27693552649205,37.16423722078343,0.08286116388895148,2453.5237135887146,523.7569909095764,1990.495029449463,27766,6640,21126,21126,0,22,6740000.0
6740,6740999,20.27602009770199,37.163122791102595,0.08286196276558822,2453.687570810318,523.8258352279663,1991.7046012878418,27769,6640,21129,21129,0,22,6741000.0
6741,6741999,20.27528074523066,37.16183163928176,0.082860482319564,2454.1087307929993,523.8909924030304,1992.0562705993652,27775,6642,21133,21133,0,22,6742000.0
6742,6742999,20.274553216539008,37.16033025074663,0.0828619500266341,2454.4123718738556,523.9563496112823,1992.5477485656738,27777,6643,21134,21134,0,22,6743000.0
6743,6743999,20.273919405483362,37.15873103308901,0.08286260235748855,2454.8788089752197,524.0211215019226,1992.4117546081543,27779,6644,21135,21135,0,22,6744000.0
6744,6744999,20.273229600554057,37.15714017413188,0.08286638245693678,2455.3058001995087,524.0873787403107,1992.3297004699707,27781,6645,21136,21136,0,22,6745000.0
6745,6745999,20.272825544755953,37.15610412969166,0.08286444079611699,2455.5865046977997,524.1525523662567,1992.897159576416,27781,6645,21136,21136,0,22,6746000.0
6746,6746999,20.272369635422624,37.1552117043537,0.08286295562757418,2456.02912068367,524.2191076278687,1992.9514503479004,27785,6647,21138,21138,0,22,6747000.0
6747,6747999,20.27195807625534,37.15413263527669,0.08286257992493062,2456.3779311180115,524.2874298095703,1993.193157196045,27785,6647,21138,21138,0,22,6748000.0
6748,6748999,20.271661248131462,37.153752730567945,0.08286242035767577,2456.680515050888,524.3525426387787,1993.5919303894043,27785,6647,21138,21138,0,22,6749000.0
6749,6749999,20.271218674514483,37.15258208527738,0.0828658825474562,2457.1302070617676,524.4171314239502,1993.5306816101074,27789,6649,21140,21140,0,22,6750000.0
6750,6750999,20.271072548912702,37.15181986917782,0.08286514533602596,2457.4586765766144,524.4836864471436,1993.8374977111816,27789,6649,21140,21140,0,22,6751000.0
6751,6751999,20.27111438418775,37.15314963062124,0.08286080984275956,2457.8545377254486,524.5506589412689,1993.9222831726074,27789,6649,21140,21140,0,22,6752000.0
6752,6752999,20.271321604335263,37.15299437245349,0.08285661075745909,2458.4416270256042,524.6183533668518,1993.3503608703613,27795,6652,21143,21143,0,22,6753000.0
6753,6753999,20.271915020541158,37.15362929595501,0.0828494902383401,2458.73788022995,524.6843276023865,1993.83353805542,27795,6652,21143,21143,0,22,6754000.0
6754,6754999,20.2725923140695,37.1557419550837,0.08283564160646018,2459.0257472991943,524.74946641922,1994.2640419006348,27795,6652,21143,21143,0,22,6755000.0
6755,6755999,20.27352378776559,37.15678824853903,0.0828302795496687,2459.529503583908,524.8144085407257,1993.977367401123,27799,6654,21145,21145,0,22,6756000.0
6756,6756999,20.27427937255715,37.157685524855566,0.08281928281440865,2459.817357778549,524.8800268173218,1994.4302711486816,27799,6654,21145,21145,0,22,6757000.0
6757,6757999,20.27498843657966,37.15843374584543,0.08281218179123939,2460.100182533264,524.9445116519928,1994.864917755127,27799,6654,21145,21145,0,22,6758000.0
6758,6758999,20.274968490545245,37.15774695176374,0.082810386035989,2460.4855260849,525.0104115009308,1995.3275108337402,27806,6656,21150,21150,0,22,6759000.0
6759,6759999,20.274774475818898,37.157558479522905,0.08280282892548674,2460.8244400024414,525.080480337143,1995.8018608093262,27806,6656,21150,21150,0,22,6760000.0
6760,6760999,20.275090502988647,37.15881271004251,0.08278190969324517,2461.240631580353,525.1484229564667,1996.4756050109863,27878,6658,21220,21220,0,22,6761000.0
6761,6761999,20.275501429832417,37.15975847913254,0.08277002072965334,2461.6257457733154,525.2164664268494,1996.975025177002,27880,6659,21221,21221,0,22,6762000.0
6762,6762999,20.27641929561266,37.161098751383406,0.08275404652527596,2462.006152153015,525.2844114303589,1997.2893104553223,27880,6659,21221,21221,0,22,6763000.0
6763,6763999,20.27756118866025,37.16312750939037,0.08273534632243484,2462.268103837967,525.3514230251312,1998.0217781066895,27880,6659,21221,21221,0,22,6764000.0
6764,6764999,20.278453340509145,37.164120107978995,0.08272755507479879,2462.8700823783875,525.4190049171448,1997.403247833252,27882,6660,21222,21222,0,22,6765000.0
6765,6765999,20.279657931198354,37.166273273628875,0.08272060806881487,2463.284839630127,525.4887943267822,1997.7100639343262,27884,6661,21223,21223,0,22,6766000.0
6766,6766999,20.280600239580743,37.16756526348624,0.08271218194079966,2463.577749967575,525.5571975708008,1998.4938621520996,27886,6662,21224,21224,0,22,6767000.0
6767,6767999,20.281715418749798,37.168704828806334,0.08270687568504587,2463.8634445667267,525.6243386268616,1999.1618995666504,27888,6663,21225,21225,0,22,6768000.0
6768,6768999,20.283263433301894,37.170677792708716,0.08271607718391472,2464.4151153564453,525.6917407512665,1998.893856048584,27894,6666,21228,21228,0,22,6769000.0
6769,6769999,20.28478189729369,37.17295759299647,0.08271754713034762,2464.709074497223,525.7598700523376,1999.5340995788574,27896,6667,21229,21229,0,22,6770000.0
6770,6770999,20.286029865811646,37.174779357440855,0.08271075041593845,2465.1719496250153,525.8269913196564,1999.4653358459473,27898,6668,21230,21230,0,22,6771000.0
6771,6771999,20.287192459205123,37.17621586706925,0.08271420992590761,2465.5000705718994,525.8955366611481,2000.0121040344238,27901,6669,21232,21232,0,22,6772000.0
6772,6772999,20.288819772687184,37.17861000022891,0.0827118318166542,2465.7425854206085,525.9625597000122,2000.6589393615723,27901,6669,21232,21232,0,22,6773000.0
6773,6773999,20.290308813546876,37.18037117799377,0.08270702796947615,2466.068902015686,526.0298895835876,2001.0171012878418,27901,6669,21232,21232,0,22,6774000.0
6774,6774999,20.291923801288064,37.18203694582197,0.08270621351692697,2466.369695663452,526.0975642204285,2001.5034141540527,27901,6669,21232,21232,0,22,6775000.0
6775,6775999,20.293363491220436,37.18369617673431,0.08270323251555234,2466.8153750896454,526.170574426651,2001.3072319030762,27901,6669,21232,21232,0,22,6776000.0
6776,6776999,20.29467735373477,37.184723759015014,0.08270325451876803,2467.150960445404,526.2391185760498,2001.6652641296387,27901,6669,21232,21232,0,22,6777000.0
6777,6777999,20.295336915919695,37.1847076053274,0.08269591868327975,2467.444459915161,526.306807756424,2002.1624794006348,27901,6669,21232,21232,0,22,6778000.0
6778,6778999,20.294818708700397,37.183829909501746,0.08269020105749636,2467.760837316513,526.3742549419403,2002.966152191162,27909,6669,21240,21240,0,22,6779000.0
6779,6779999,20.29390096282626,37.18280859765866,0.08268852121330084,2468.0147516727448,526.440598487854,2003.8075370788574,27909,6669,21240,21240,0,22,6780000.0
6780,6780999,20.293099229689396,37.18116822940657,0.08268555495497087,2468.319370985031,526.5105085372925,2004.2760963439941,27911,6669,21242,21242,0,22,6781000.0
6781,6781999,20.29254998814458,37.18107021959142,0.08267711380224285,2468.650779724121,526.5771889686584,2004.6182289123535,27913,6670,21243,21243,0,22,6782000.0
6782,6782999,20.291872574421593,37.179463037541055,0.0826713993023559,2469.3594522476196,526.645781993866,2003.78413772583,27921,6674,21247,21247,0,22,6783000.0
6783,6783999,20.291028513772595,37.17766757676631,0.08267277668998418,2469.6914432048798,526.7150266170502,2004.3619117736816,27923,6675,21248,21248,0,22,6784000.0
6784,6784999,20.29026886332182,37.176290427512924,0.08267590242395528,2470.093714952469,526.7874970436096,2004.7232933044434,27927,6677,21250,21250,0,22,6785000.0
6785,6785999,20.289599502544714,37.174773089144395,0.08267644468012747,2470.7081849575043,526.8565282821655,2004.2458610534668,27933,6680,21253,21253,0,22,6786000.0
6786,6786999,20.289112838303076,37.174109080949066,0.08267001042682876,2471.2117931842804,526.9245345592499,2004.2104682922363,27937,6682,21255,21255,0,22,6787000.0
6787,6787999,20.288537394336107,37.17276168637116,0.08266826830269303,2471.4566881656647,526.9940347671509,2004.8536567687988,27937,6682,21255,21255,0,22,6788000.0
6788,6788999,20.288036295415836,37.17162621891363,0.08266339049059646,2471.92440032959,527.0643322467804,2004.7202796936035,27939,6683,21256,21256,0,22,6789000.0
6789,6789999,20.287705338529097,37.17099009090436,0.08265520294569428,2472.352124929428,527.1322567462921,2004.6743125915527,27939,6683,21256,21256,0,22,6790000.0
6790,6790999,20.287554886006685,37.17042302828152,0.08264395805319724,2472.646381855011,527.2017343044281,2005.1067237854004,27939,6683,21256,21256,0,22,6791000.0
6791,6791999,20.287465064397438,37.16979432921482,0.08263372114058087,2472.9478397369385,527.2720239162445,2005.529972076416,27939,6683,21256,21256,0,22,6792000.0
6792,6792999,20.287478957740777,37.16937567988315,0.08262097418744185,2473.2402968406677,527.3403623104095,2005.839412689209,27939,6683,21256,21256,0,22,6793000.0
6793,6793999,20.287873027916827,37.16957842301676,0.08260871777816459,2473.786503314972,527.4098834991455,2005.6285591125488,27945,6686,21259,21259,0,22,6794000.0
6794,6794999,20.288238498968415,37.16973341348405,0.08259793109139102,2474.4825353622437,527.4802856445312,2004.9394874572754,27953,6690,21263,21263,0,22,6795000.0
6795,6795999,20.289025057970736,37.170331898466266,0.08258635261883296,2474.8884234428406,527.5494184494019,2004.9915657043457,27953,6690,21263,21263,0,22,6796000.0
6796,6796999,20.289651439992912,37.170464619506994,0.08257841159952861,2475.0982868671417,527.6169528961182,2005.8669548034668,27953,6690,21263,21263,0,22,6797000.0
6797,6797999,20.290510243724544,37.17092627159483,0.08256478494870678,2475.5125303268433,527.6860597133636,2005.843593597412,27953,6690,21263,21263,0,22,6798000.0
6798,6798999,20.290779423767248,37.170445375941284,0.08255709447597082,2475.990559577942,527.7583210468292,2006.1362113952637,27961,6692,21269,21269,0,22,6799000.0
6799,6799999,20.290094188379467,37.1693757923656,0.0825472434689083,2476.277851819992,527.8234956264496,2006.8409385681152,27964,6693,21271,21271,0,22,6800000.0
6800,6800999,20.289609093220257,37.168312873295434,0.08253832600217414,2476.8157494068146,527.8891987800598,2006.406177520752,27967,6694,21273,21273,0,22,6801000.0
6801,6801999,20.289494746767364,37.16774027862092,0.08252983893123322,2477.1498873233795,527.9535393714905,2006.8803749084473,27968,6694,21274,21274,0,22,6802000.0
6802,6802999,20.289691798886313,37.16761638939493,0.08251198853339459,2477.550820827484,528.0177643299103,2007.127109527588,27970,6695,21275,21275,0,22,6803000.0
6803,6803999,20.28971159265155,37.16721776428817,0.08249789251702722,2477.8752806186676,528.0813038349152,2007.69828414917,27981,6696,21285,21285,0,22,6804000.0
6804,6804999,20.28971597483882,37.16641491695356,0.08249397031004946,2478.232267141342,528.1496379375458,2008.0509071350098,27984,6697,21287,21287,0,22,6805000.0
6805,6805999,20.28957871362878,37.16571681008408,0.08248876281761586,2478.785071372986,528.2144351005554,2007.6305122375488,27988,6699,21289,21289,0,22,6806000.0
6806,6806999,20.28963845810956,37.16529701836531,0.08247875961360362,2479.0366020202637,528.2788271903992,2008.313549041748,27988,6699,21289,21289,0,22,6807000.0
6807,6807999,20.28977161312173,37.16499211430426,0.08247443004942279,2479.244561433792,528.3428702354431,2009.0707206726074,27988,6699,21289,21289,0,22,6808000.0
6808,6808999,20.28994829515511,37.164373843221604,0.08246122638798492,2479.662952899933,528.409640789032,2009.1167106628418,27990,6700,21290,21290,0,22,6809000.0
6809,6809999,20.29009726787083,37.16364251909296,0.0824463514599888,2480.168758392334,528.4740705490112,2008.9991264343262,27996,6703,21293,21293,0,22,6810000.0
6810,6810999,20.290803120999605,37.16416313499473,0.08244119221508861,2480.4976274967194,528.5379731655121,2009.3264122009277,27998,6704,21294,21294,0,22,6811000.0
6811,6811999,20.291394022191827,37.16431221339297,0.08242411547107242,2481.1572575569153,528.6064903736115,2008.5246391296387,28009,6706,21303,21303,0,22,6812000.0
6812,6812999,20.29231147748297,37.164889071289416,0.08242146986800847,2481.531697034836,528.6721928119659,2008.8122901916504,28011,6707,21304,21304,0,22,6813000.0
6813,6813999,20.293226676147682,37.16541764774855,0.08242308972380141,2482.075448513031,528.7385194301605,2008.44087600708,28015,6709,21306,21306,0,22,6814000.0
6814,6814999,20.294197270571605,37.1659837765014,0.08241455381088969,2482.3151247501373,528.8034844398499,2009.277416229248,28015,6709,21306,21306,0,22,6815000.0
6815,6815999,20.295134839695258,37.166178304918624,0.08241106554199717,2482.6126866340637,528.8691444396973,2009.8614463806152,28026,6710,21316,21316,0,22,6816000.0
6816,6816999,20.296224534208832,37.16668323056657,0.0824125278407275,2482.8868231773376,528.9339003562927,2010.326244354248,28026,6710,21316,21316,0,22,6817000.0
6817,6817999,20.297315783780167,37.167051305836736,0.082410657542485,2483.1671743392944,528.9972896575928,2010.6778984069824,28026,6710,21316,21316,0,22,6818000.0
6818,6818999,20.298169604908136,37.16727821668639,0.08240572075330177,2483.7334966659546,529.0645503997803,2010.1517219543457,28028,6711,21317,21317,0,22,6819000.0
6819,6819999,20.297614056950675,37.16661518787154,0.08239738557684406,2483.984233379364,529.1322450637817,2010.9908332824707,28030,6711,21319,21319,0,22,6820000.0
6820,6820999,20.29690281283607,37.16568252926844,0.08239575275089872,2484.424860239029,529.1988599300385,2010.961711883545,28032,6712,21320,21320,0,22,6821000.0
6821,6821999,20.296156992272547,37.164165662900686,0.08240056210300262,2484.7395577430725,529.2667355537415,2011.4285697937012,28032,6712,21320,21320,0,22,6822000.0
6822,6822999,20.29542582970538,37.16264242036118,0.08240403277778763,2485.026871204376,529.3353252410889,2011.923038482666,28032,6712,21320,21320,0,22,6823000.0
6823,6823999,20.294725351856695,37.16137201407744,0.08240544187588683,2485.48166513443,529.403347492218,2011.984577178955,28048,6713,21335,21335,0,22,6824000.0
6824,6824999,20.29437083378401,37.16061068861343,0.08240392525997797,2485.9545612335205,529.4834976196289,2012.26420211792,28050,6714,21336,21336,0,22,6825000.0
6825,6825999,20.293900443385898,37.15953784858944,0.08240388851692138,2486.2063825130463,529.5528602600098,2012.9168586730957,28050,6714,21336,21336,0,22,6826000.0
6826,6826999,20.293404393866457,37.158309921441244,0.08240580455659463,2486.6962308883667,529.6272578239441,2012.836254119873,28060,6715,21345,21345,0,22,6827000.0
6827,6827999,20.292931684887936,37.15724227651611,0.0824063349753863,2486.973197698593,529.6971933841705,2013.325382232666,28060,6715,21345,21345,0,22,6828000.0
6828,6828999,20.29254127942142,37.156372681685,0.08240854968261213,2487.3941373825073,529.7661867141724,2013.4076347351074,28064,6717,21347,21347,0,22,6829000.0
6829,6829999,20.29249072721012,37.15598155777687,0.08240278577538829,2487.757583141327,529.8348183631897,2013.7028160095215,28066,6718,21348,21348,0,22,6830000.0
6830,6830999,20.292716458079173,37.15807340256457,0.08239513444465496,2488.1622347831726,529.9010224342346,2013.5380897521973,28066,6718,21348,21348,0,22,6831000.0
6831,6831999,20.293098112806536,37.15950079064476,0.08238461198535418,2488.581936120987,529.9704773426056,2013.3358879089355,28066,6718,21348,21348,0,22,6832000.0
6832,6832999,20.293314457285938,37.159817212167084,0.08238193360657686,2488.9196372032166,530.0404045581818,2013.721035003662,28068,6719,21349,21349,0,22,6833000.0
6833,6833999,20.293326667253332,37.15915767298602,0.08238669153500844,2489.2623007297516,530.1107070446014,2014.2200889587402,28070,6720,21350,21350,0,22,6834000.0
6834,6834999,20.293211149069286,37.15938191338471,0.08238927247347283,2489.5599060058594,530.1793880462646,2014.5739402770996,28070,6720,21350,21350,0,22,6835000.0
6835,6835999,20.293056373674574,37.15935869700665,0.08239548150686116,2490.295865535736,530.2478187084198,2013.7420768737793,28081,6722,21359,21359,0,22,6836000.0
6836,6836999,20.293019340355855,37.15936556761943,0.08238544510047385,2490.6536889076233,530.313146352768,2014.2056312561035,28081,6722,21359,21359,0,22,6837000.0
6837,6837999,20.293724585448455,37.16565446042028,0.08234937004333798,2490.8132712841034,530.3773376941681,2015.379711151123,28082,6722,21360,21360,0,22,6838000.0
6838,6838999,20.29377484462146,37.165113976721884,0.0823495873245026,2491.234180688858,530.4426474571228,2015.4333381652832,28084,6723,21361,21361,0,22,6839000.0
6839,6839999,20.294132838786172,37.166571539138936,0.08234886948467823,2491.584398508072,530.5077614784241,2015.686954498291,28086,6724,21362,21362,0,22,6840000.0
6840,6840999,20.294294146700132,37.16611201369497,0.08234664376499046,2492.2348082065582,530.5752530097961,2015.2292289733887,28094,6728,21366,21366,0,22,6841000.0
6841,6841999,20.294343975541704,37.16569433527232,0.08234334129148124,2492.709310531616,530.6412181854248,2015.113613128662,28098,6730,21368,21368,0,22,6842000.0
6842,6842999,20.294671035754604,37.16809584113909,0.08233076811903939,2493.0957803726196,530.7070846557617,2015.3448371887207,28100,6731,21369,21369,0,22,6843000.0
6843,6843999,20.29498636093652,37.16785463152929,0.08233205507135344,2493.466912508011,530.7725534439087,2015.4323539733887,28100,6731,21369,21369,0,22,6844000.0
6844,6844999,20.295303715507607,37.1679601954603,0.08233708938595774,2493.7872478961945,530.8392083644867,2015.8599739074707,28102,6732,21370,21370,0,22,6845000.0
6845,6845999,20.296137873666787,37.170768772607516,0.0823338519770459,2494.1732923984528,530.90602850914,2016.0215950012207,28104,6733,21371,21371,0,22,6846000.0
6846,6846999,20.2966305404544,37.171442146362054,0.08233337592001122,2494.68794965744,530.9738731384277,2015.648105621338,28107,6735,21372,21372,0,22,6847000.0
6847,6847999,20.297659664333025,37.172713826770206,0.08233795750953343,2495.0250613689423,531.0392994880676,2016.0032768249512,28109,6736,21373,21373,0,22,6848000.0
6848,6848999,20.298680380643894,37.174021622491594,0.0823401207157225,2495.3834989070892,531.1056799888611,2016.1988716125488,28109,6736,21373,21373,0,22,6849000.0
6849,6849999,20.299796758453436,37.17584180283282,0.08234252330498826,2495.622559070587,531.1811962127686,2016.9164085388184,28109,6736,21373,21373,0,22,6850000.0
6850,6850999,20.300674362629042,37.17649678703334,0.082348602033816,2496.135752916336,531.2478806972504,2016.6574821472168,28113,6738,21375,21375,0,22,6851000.0
6851,6851999,20.301926108326636,37.17911578135108,0.08235077854377781,2496.8185262680054,531.3163764476776,2015.919002532959,28121,6742,21379,21379,0,22,6852000.0
6852,6852999,20.302984947512748,37.18085684283673,0.08235657856522594,2497.191424846649,531.3854730129242,2016.227481842041,28122,6743,21379,21379,0,22,6853000.0
6853,6853999,20.30368317270143,37.18087430055253,0.08236614400246489,2497.5317420959473,531.4515657424927,2016.551815032959,28124,6744,21380,21380,0,22,6854000.0
6854,6854999,20.304454950631357,37.18195525866542,0.08231890188703694,2498.1784358024597,531.518226146698,2016.0176429748535,28137,6746,21391,21391,0,22,6855000.0
6855,6855999,20.30516795177247,37.18276405086358,0.08226371161927237,2498.5094962120056,531.5871937274933,2016.4900932312012,28137,6746,21391,21391,0,22,6856000.0
6856,6856999,20.30608632569528,37.18474747768942,0.08220633045716585,2498.8488466739655,531.6527988910675,2017.0730934143066,28142,6746,21396,21396,0,22,6857000.0
6857,6857999,20.306643760503693,37.18597973747113,0.08216282437417699,2499.234761953354,531.7193365097046,2017.405429840088,28146,6748,21398,21398,0,22,6858000.0
6858,6858999,20.307192826493306,37.1866348704318,0.08212527689827986,2499.507042169571,531.7861676216125,2018.0073127746582,28146,6748,21398,21398,0,22,6859000.0
6859,6859999,20.307855263465054,37.18755290271325,0.08210828084704158,2500.106297016144,531.853390455246,2017.4809761047363,28152,6751,21401,21401,0,22,6860000.0
6860,6860999,20.308036642190334,37.187108951036066,0.08210367648507588,2500.4731011390686,531.9193639755249,2017.9106483459473,28163,6752,21411,21411,0,22,6861000.0
6861,6861999,20.308625466222033,37.18761787904503,0.08208775684806191,2500.8859848976135,531.9848141670227,2018.2213172912598,28176,6754,21422,21422,0,22,6862000.0
6862,6862999,20.3092694273116,37.18796954739902,0.08208633642342344,2501.2221417427063,532.050369977951,2018.5977516174316,28178,6755,21423,21423,0,22,6863000.0
6863,6863999,20.30991319448614,37.18834991783377,0.08208076583005464,2501.530848503113,532.1175742149353,2018.9649620056152,28179,6755,21424,21424,0,22,6864000.0
6864,6864999,20.31075924580605,37.18889560320006,0.08208900002056041,2502.1654884815216,532.1872689723969,2018.12162399292,28183,6757,21426,21426,0,22,6865000.0
6865,6865999,20.311632208576373,37.189716431333196,0.08209921878821491,2502.6964857578278,532.2544341087341,2017.708652496338,28185,6758,21427,21427,0,22,6866000.0
6866,6866999,20.31214903351193,37.189856603070666,0.08211235210249546,2503.028660058975,532.3240311145782,2018.118251800537,28187,6759,21428,21428,0,22,6867000.0
6867,6867999,20.313147404251144,37.190833950223606,0.08212664486735333,2503.5202276706696,532.395257472992,2017.9687156677246,28191,6761,21430,21430,0,22,6868000.0
6868,6868999,20.314230831901845,37.191818490165296,0.08214313487590474,2503.8556609153748,532.462925195694,2018.392490386963,28193,6762,21431,21431,0,22,6869000.0
6869,6869999,20.315075217825378,37.19219970637688,0.08216019311459843,2504.2504489421844,532.5300476551056,2018.5897483825684,28197,6764,21433,21433,0,22,6870000.0
6870,6870999,20.31592178987596,37.19355926142755,0.08217367528102804,2504.75461101532,532.5969257354736,2018.3276863098145,28199,6765,21434,21434,0,22,6871000.0
6871,6871999,20.316823038971766,37.19405402426965,0.08218500329498024,2505.185338497162,532.6655268669128,2018.4594993591309,28201,6766,21435,21435,0,22,6872000.0
6872,6872999,20.317678134276903,37.194449678989876,0.08220429408416385,2505.61616396904,532.7330622673035,2018.5221366882324,28203,6767,21436,21436,0,22,6873000.0
6873,6873999,20.317658329619544,37.19340202607446,0.08220421360227104,2505.925713777542,532.8048644065857,2019.11722946167,28205,6768,21437,21437,0,22,6874000.0
6874,6874999,20.31836901403235,37.19565248978126,0.08217465981462724,2506.1306133270264,532.8704164028168,2020.3257942199707,28211,6768,21443,21443,0,22,6875000.0
6875,6875999,20.318736776978565,37.19755079403458,0.08212737632055889,2506.503993034363,532.9360070228577,2020.6806907653809,28214,6769,21445,21445,0,22,6876000.0
6876,6876999,20.318651109608297,37.19694429291198,0.08211008778211948,2506.7521567344666,533.0032432079315,2021.450023651123,28215,6769,21446,21446,0,22,6877000.0
6877,6877999,20.318651689345437,37.196162218288414,0.08209090223154591,2507.1273033618927,533.0667316913605,2021.654872894287,28219,6770,21449,21449,0,22,6878000.0
6878,6878999,20.318636790785206,37.195473951499274,0.08207456403475022,2507.503380060196,533.1303713321686,2021.7767295837402,28221,6771,21450,21450,0,22,6879000.0
6879,6879999,20.31879647349166,37.19530782316483,0.08205260361922628,2508.1604223251343,533.1931691169739,2021.0945167541504,28229,6775,21454,21454,0,22,6880000.0
6880,6880999,20.318753632353136,37.19447603465462,0.08204269074599468,2508.551908969879,533.2624704837799,2021.4260597229004,28233,6777,21456,21456,0,22,6881000.0
6881,6881999,20.318776866247067,37.194209349866725,0.08203217384344785,2509.1209211349487,533.3331487178802,2021.0764808654785,28237,6779,21458,21458,0,22,6882000.0
6882,6882999,20.318698951569793,37.193775212982565,0.08202933513881783,2509.41446352005,533.3990173339844,2021.7208061218262,28239,6780,21459,21459,0,22,6883000.0
6883,6883999,20.318680858323596,37.193410419366806,0.08203196619242359,2509.8314695358276,533.4657330513,2021.7460670471191,28241,6781,21460,21460,0,22,6884000.0
6884,6884999,20.31925476704535,37.19447943870302,0.08203093715072018,2510.176661014557,533.5339283943176,2021.9664878845215,28241,6781,21460,21460,0,22,6885000.0
6885,6885999,20.320194425424813,37.19643852844537,0.08203865210221195,2510.507588148117,533.5990269184113,2022.2610893249512,28241,6781,21460,21460,0,22,6886000.0
6886,6886999,20.321071860582347,37.19760550226914,0.08204230806579094,2510.8140676021576,533.6666202545166,2022.6065101623535,28241,6781,21460,21460,0,22,6887000.0
6887,6887999,20.322330263376017,37.20030130956469,0.08207006538555184,2511.143729686737,533.7307643890381,2022.7967643737793,28241,6781,21460,21460,0,22,6888000.0
6888,6888999,20.32346934510038,37.20191928114281,0.08209588984727179,2511.6264674663544,533.7963709831238,2022.75248336792,28245,6783,21462,21462,0,22,6889000.0
6889,6889999,20.324811412747145,37.203700226843736,0.08210872887953058,2512.1374049186707,533.862343788147,2022.4808387756348,28249,6785,21464,21464,0,22,6890000.0
6890,6890999,20.325918296113663,37.204953196196385,0.08213515744934152,2512.6730241775513,533.931382894516,2022.3130989074707,28253,6787,21466,21466,0,22,6891000.0
6891,6891999,20.326551184734054,37.20517414673867,0.0821499850640095,2512.909104347229,533.9976990222931,2023.041202545166,28253,6787,21466,21466,0,22,6892000.0
6892,6892999,20.326764577013428,37.20545176065629,0.08213674127712267,2513.330812692642,534.0629894733429,2023.4407234191895,28261,6788,21473,21473,0,22,6893000.0
6893,6893999,20.32641078069812,37.20569882513214,0.08212223437954935,2513.6559336185455,534.1304743289948,2024.160816192627,28266,6789,21477,21477,0,22,6894000.0
6894,6894999,20.325864056352938,37.20450401775186,0.08211761665208317,2514.0372035503387,534.1977019309998,2024.5453758239746,28273,6790,21483,21483,0,22,6895000.0
6895,6895999,20.32537919532235,37.203413545451696,0.08211235818546925,2514.3933000564575,534.2643599510193,2024.7474784851074,28273,6790,21483,21483,0,22,6896000.0
6896,6896999,20.324918101788334,37.202240372603455,0.08210782165207153,2514.807662963867,534.3317334651947,2025.0928688049316,28290,6792,21498,21498,0,22,6897000.0
6897,6897999,20.324581546491167,37.20096052729514,0.08210278113153435,2515.1109642982483,534.3997664451599,2025.8422813415527,28297,6793,21504,21504,0,22,6898000.0
6898,6898999,20.324033461914393,37.19984687141738,0.08210071473208325,2515.537973165512,534.4691858291626,2026.0358848571777,28299,6794,21505,21505,0,22,6899000.0
6899,6899999,20.323530235509285,37.19829530390046,0.08209957538764678,2515.714440345764,534.5469665527344,2027.0875434875488,28299,6794,21505,21505,0,22,6900000.0
6900,6900999,20.323081601407225,37.19687929281643,0.08209788407927121,2515.971120595932,534.6121962070465,2027.6040000915527,28300,6794,21506,21506,0,22,6901000.0
6901,6901999,20.3225944102762,37.19534706011953,0.08209643348978479,2516.3868811130524,534.6818172931671,2027.5416069030762,28300,6794,21506,21506,0,22,6902000.0
6902,6902999,20.322039033073217,37.194249457692045,0.0820962709810722,2516.720912694931,534.7501718997955,2027.7749366760254,28300,6794,21506,21506,0,22,6903000.0
6903,6903999,20.321556317654178,37.19293214406806,0.08209754287219406,2516.996166229248,534.8166537284851,2028.2621955871582,28301,6794,21507,21507,0,22,6904000.0
6904,6904999,20.32130425056503,37.191930574497924,0.08209581513589947,2517.2836303710938,534.8868381977081,2028.6144752502441,28301,6794,21507,21507,0,22,6905000.0
6905,6905999,20.32104739632311,37.19085714849009,0.08209689256815955,2517.731385946274,534.9549849033356,2028.3216514587402,28301,6794,21507,21507,0,22,6906000.0
6906,6906999,20.320829855037385,37.18993799068429,0.08209593576984608,2517.9313440322876,535.0260276794434,2029.113971710205,28302,6794,21508,21508,0,22,6907000.0
6907,6907999,20.32081082900959,37.18930304978947,0.08209394427197203,2518.2816853523254,535.0923125743866,2029.4889183044434,28318,6795,21523,21523,0,22,6908000.0
6908,6908999,20.320595360926184,37.18814060113847,0.08209469121064084,2518.863111257553,535.1616332530975,2029.0207786560059,28320,6796,21524,21524,0,22,6909000.0
6909,6909999,20.32042480317626,37.18708102870628,0.08209432327138155,2519.3378348350525,535.2316057682037,2029.025951385498,28324,6798,21526,21526,0,22,6910000.0
6910,6910999,20.3202278312028,37.18598132595297,0.0820928664721754,2519.675787448883,535.3022420406342,2029.4330787658691,28326,6799,21527,21527,0,22,6911000.0
6911,6911999,20.319675189159547,37.1843763488676,0.0820958314474256,2520.085473060608,535.3719742298126,2029.4843788146973,28328,6800,21528,21528,0,22,6912000.0
6912,6912999,20.319055937067787,37.18300244571875,0.0820948372413437,2520.4680695533752,535.4421169757843,2030.171230316162,28338,6802,21536,21536,0,22,6913000.0
6913,6913999,20.31825563792068,37.18167445690295,0.08208312396004602,2520.8375692367554,535.5122272968292,2030.835247039795,28343,6804,21539,21539,0,22,6914000.0
6914,6914999,20.31745782327413,37.180642556442855,0.08207678069239177,2521.214744091034,535.5846719741821,2031.5107460021973,28358,6806,21552,21552,0,22,6915000.0
6915,6915999,20.316850517575496,37.17940418634213,0.08206659184835041,2521.4742708206177,535.6546740531921,2032.1705207824707,28359,6806,21553,21553,0,22,6916000.0
6916,6916999,20.31619457399979,37.17784715588459,0.08205833405411256,2521.836269378662,535.7236292362213,2032.32084274292,28359,6806,21553,21553,0,22,6917000.0
6917,6917999,20.31574846140134,37.177121917497786,0.08204773259013964,2522.193039894104,535.7934727668762,2032.569248199463,28361,6807,21554,21554,0,22,6918000.0
6918,6918999,20.31541592685687,37.176435012858676,0.08203859266822322,2522.5671832561493,535.8647217750549,2032.8735237121582,28363,6808,21555,21555,0,22,6919000.0
6919,6919999,20.31497321485503,37.17580554709731,0.0820305210894533,2522.946184873581,535.9380719661713,2033.109531402588,28365,6809,21556,21556,0,22,6920000.0
6920,6920999,20.31466177734486,37.17553122552769,0.08201721198880707,2523.523190975189,536.0110282897949,2032.7675895690918,28371,6812,21559,21559,0,22,6921000.0
6921,6921999,20.3149958552254,37.1768491972771,0.08200480155730505,2524.0510861873627,536.0829999446869,2032.6412315368652,28386,6815,21571,21571,0,22,6922000.0
6922,6922999,20.315513676617954,37.1805508678874,0.08197586168000237,2524.4205718040466,536.1520576477051,2032.9301872253418,28388,6816,21572,21572,0,22,6923000.0
6923,6923999,20.31632261167198,37.18236277093682,0.08195110667177086,2524.947676181793,536.223516702652,2032.6592063903809,28390,6817,21573,21573,0,22,6924000.0
6924,6924999,20.317392335766854,37.18535036988042,0.08192712517153422,2525.3001329898834,536.2923631668091,2032.8695259094238,28390,6817,21573,21573,0,22,6925000.0
6925,6925999,20.318111881712063,37.18612163001338,0.08190793110860917,2525.8259189128876,536.3679139614105,2032.6650199890137,28394,6819,21575,21575,0,22,6926000.0
6926,6926999,20.319304400279634,37.18866724872908,0.08188932268737514,2526.1732544898987,536.4484341144562,2033.082920074463,28394,6819,21575,21575,0,22,6927000.0
6927,6927999,20.32045282573682,37.1909015173887,0.08187914708773192,2526.4179072380066,536.5190870761871,2033.8449363708496,28394,6819,21575,21575,0,22,6928000.0
6928,6928999,20.321492728842983,37.192802050318235,0.08186750326598391,2526.8936293125153,536.5905435085297,2033.520709991455,28394,6819,21575,21575,0,22,6929000.0
6929,6929999,20.322291808693606,37.19389798168132,0.08185705727964265,2527.2461547851562,536.6708741188049,2033.8662567138672,28395,6819,21576,21576,0,22,6930000.0
6930,6930999,20.323008228371567,37.19448692767716,0.08184232493949939,2527.5311896800995,536.7424867153168,2034.263656616211,28395,6819,21576,21576,0,22,6931000.0
6931,6931999,20.32356124932954,37.19481656035669,0.0818263778797318,2528.0095834732056,536.8107414245605,2034.0103302001953,28397,6820,21577,21577,0,22,6932000.0
6932,6932999,20.32376926090294,37.195219194196184,0.08181580647472608,2528.435781955719,536.8776450157166,2034.4203262329102,28407,6822,21585,21585,0,22,6933000.0
6933,6933999,20.32349522814918,37.194395113675405,0.08180649481614832,2528.764620065689,536.9418210983276,2035.1045837402344,28413,6823,21590,21590,0,22,6934000.0
6934,6934999,20.32315911484204,37.193341324858565,0.08180030831829554,2529.2005183696747,537.009782075882,2035.7493057250977,28431,6825,21606,21606,0,22,6935000.0
6935,6935999,20.32311426626943,37.192681231016564,0.0817862347403503,2529.495517730713,537.0756030082703,2036.4353942871094,28431,6825,21606,21606,0,22,6936000.0
6936,6936999,20.323136575768903,37.19218802927838,0.08177236679639766,2529.7638330459595,537.1409492492676,2037.0866241455078,28431,6825,21606,21606,0,22,6937000.0
6937,6937999,20.323026965429058,37.191071946546366,0.08175482222961916,2530.212054014206,537.209180355072,2037.0168113708496,28443,6826,21617,21617,0,22,6938000.0
6938,6938999,20.32312349600937,37.190195999132186,0.08173746567556628,2530.560765981674,537.2733352184296,2037.3922233581543,28445,6827,21618,21618,0,22,6939000.0
6939,6939999,20.323288702944875,37.18964807199694,0.0817224193303453,2530.861874818802,537.3379917144775,2037.8671607971191,28447,6828,21619,21619,0,22,6940000.0
6940,6940999,20.32332080067661,37.18895015533283,0.08170957690287595,2531.4983644485474,537.4035534858704,2037.3193321228027,28455,6832,21623,21623,0,22,6941000.0
6941,6941999,20.323737695494117,37.1913414355754,0.08166063389807277,2531.8776779174805,537.468817949295,2037.678066253662,28457,6833,21624,21624,0,22,6942000.0
6942,6942999,20.32431710743005,37.19180835940807,0.08163443105651147,2532.304712533951,537.533531665802,2037.8260383605957,28461,6835,21626,21626,0,22,6943000.0
6943,6943999,20.32475060753869,37.191734157102594,0.08161332890239481,2532.582864999771,537.5991704463959,2038.347339630127,28461,6835,21626,21626,0,22,6944000.0
6944,6944999,20.32563549118947,37.192603701173965,0.08157180719591794,2532.9702050685883,537.6655135154724,2038.4519538879395,28463,6836,21627,21627,0,22,6945000.0
6945,6945999,20.326725802539418,37.1935519114312,0.08153731192460145,2533.567093372345,537.7332253456116,2037.9976234436035,28469,6839,21630,21630,0,22,6946000.0
6946,6946999,20.327408443788478,37.19378999184236,0.08153235687997717,2533.8877923488617,537.7985622882843,2038.404369354248,28469,6839,21630,21630,0,22,6947000.0
6947,6947999,20.328312003860404,37.19446010794535,0.08151994483371794,2534.125958442688,537.8648250102997,2039.0686531066895,28469,6839,21630,21630,0,22,6948000.0
6948,6948999,20.32904915502683,37.19464600312929,0.08152014587266554,2534.809225797653,537.9308335781097,2038.5964469909668,28479,6844,21635,21635,0,22,6949000.0
6949,6949999,20.329705175229655,37.19469437039721,0.0815250808687129,2535.159323692322,537.9969668388367,2038.7919273376465,28479,6844,21635,21635,0,22,6950000.0
6950,6950999,20.33040509365761,37.19467600972282,0.08153249311707611,2535.439492225647,538.0623369216919,2039.266674041748,28479,6844,21635,21635,0,22,6951000.0
6951,6951999,20.330748057824135,37.1940790426177,0.08153816567209382,2535.897054195404,538.1291732788086,2039.1580543518066,28481,6845,21636,21636,0,22,6952000.0
6952,6952999,20.330837811290806,37.19438428543736,0.08152612769497203,2536.377646446228,538.194741487503,2039.124828338623,28486,6845,21641,21641,0,22,6953000.0
6953,6953999,20.330858061615547,37.194574329991134,0.08151154870602006,2536.800621509552,538.2595551013947,2039.5404472351074,28494,6848,21646,21646,0,22,6954000.0
6954,6954999,20.330730620451362,37.1942704257867,0.08150350868617384,2537.20662522316,538.326840877533,2040.014835357666,28501,6849,21652,21652,0,22,6955000.0
6955,6955999,20.330749381664127,37.194319903809024,0.08148837358504157,2537.7552099227905,538.3938674926758,2040.0359230041504,28518,6852,21666,21666,0,22,6956000.0
6956,6956999,20.330972816055887,37.19444037760663,0.08147493528116512,2538.18030333519,538.459635257721,2040.2784004211426,28522,6854,21668,21668,0,22,6957000.0
6957,6957999,20.331590511028992,37.19528622615064,0.08145984925161487,2538.4776883125305,538.5258014202118,2041.0099143981934,28524,6855,21669,21669,0,22,6958000.0
6958,6958999,20.331975836039607,37.1956239480518,0.08145136156458355,2538.7370183467865,538.5913670063019,2041.8205451965332,28526,6856,21670,21670,0,22,6959000.0
6959,6959999,20.33245341877924,37.196314777936244,0.08145189366437877,2539.247855424881,538.6594288349152,2041.8093070983887,28532,6859,21673,21673,0,22,6960000.0
6960,6960999,20.3336137151129,37.19990648299121,0.08145577873160592,2539.70681142807,538.726316690445,2041.979892730713,28536,6861,21675,21675,0,22,6961000.0
6961,6961999,20.334663401240444,37.20126972577405,0.08146566473016781,2540.1181461811066,538.7965581417084,2042.2789878845215,28562,6863,21699,21699,0,22,6962000.0
6962,6962999,20.33615391202912,37.20627948630154,0.08150543608369609,2540.6049058437347,538.8655669689178,2042.0906791687012,28564,6864,21700,21700,0,22,6963000.0
6963,6963999,20.33743586069628,37.2079160333194,0.08152423904173267,2541.047533273697,538.9354159832001,2042.0996437072754,28568,6866,21702,21702,0,22,6964000.0
6964,6964999,20.338912061472758,37.2103553439791,0.08157456287866183,2541.521730661392,539.0020189285278,2041.9572105407715,28570,6867,21703,21703,0,22,6965000.0
6965,6965999,20.34109884909911,37.214099595240484,0.08162839964706492,2541.8612287044525,539.0712432861328,2042.2818489074707,28570,6867,21703,21703,0,22,6966000.0
6966,6966999,20.342723193001238,37.216009017968005,0.08167498708652488,2542.3085947036743,539.140040397644,2042.4043083190918,28574,6869,21705,21705,0,22,6967000.0
6967,6967999,20.34486423531731,37.219270413943235,0.08172445391571248,2542.7215209007263,539.2081849575043,2042.5286140441895,28575,6869,21706,21706,0,22,6968000.0
6968,6968999,20.347001295657186,37.22410772494451,0.08174715251817533,2543.104239463806,539.2759919166565,2042.7391624450684,28575,6869,21706,21706,0,22,6969000.0
6969,6969999,20.348224363478085,37.22812533082097,0.08171897580740195,2543.444220304489,539.3431084156036,2043.409755706787,28583,6869,21714,21714,0,22,6970000.0
6970,6970999,20.349308903113272,37.234074863095636,0.08167292821037797,2543.868493795395,539.4110839366913,2044.0750541687012,28588,6871,21717,21717,0,22,6971000.0
6971,6971999,20.350382512362252,37.23884326266336,0.08164602933571108,2544.271926879883,539.4776084423065,2044.5700874328613,28593,6873,21720,21720,0,22,6972000.0
6972,6972999,20.351061253094446,37.241162271490225,0.08163177353792628,2544.5628383159637,539.543744802475,2045.1814613342285,28596,6874,21722,21722,0,22,6973000.0
6973,6973999,20.352070573964316,37.24436646525371,0.08160755721874335,2544.8892226219177,539.6099393367767,2045.6564292907715,28598,6875,21723,21723,0,22,6974000.0
6974,6974999,20.352939272734336,37.24728241744137,0.0815996258979903,2545.4365952014923,539.6760313510895,2045.4596214294434,28618,6878,21740,21740,0,22,6975000.0
6975,6975999,20.353590797075963,37.249006720756114,0.08159270794428919,2545.800663471222,539.7448220252991,2045.7001914978027,28618,6878,21740,21740,0,22,6976000.0
6976,6976999,20.35527310332856,37.257472655148945,0.0815635292441732,2546.19885969162,539.813770532608,2045.8788871765137,28620,6879,21741,21741,0,22,6977000.0
6977,6977999,20.356594240081126,37.26007664863531,0.08155418981888407,2546.5874898433685,539.8804619312286,2046.0900764465332,28622,6880,21742,21742,0,22,6978000.0
6978,6978999,20.357765533995295,37.261507351488355,0.08154720093622281,2547.0134320259094,539.9486808776855,2046.0433311462402,28624,6881,21743,21743,0,22,6979000.0
6979,6979999,20.35918027287158,37.26389368260502,0.08153597422356373,2547.6674387454987,540.0187423229218,2045.3802909851074,28639,6884,21755,21755,0,22,6980000.0
6980,6980999,20.36058778312145,37.26706859283714,0.08153239596187756,2547.9756281375885,540.0893242359161,2046.1159706115723,28641,6885,21756,21756,0,22,6981000.0
6981,6981999,20.362071726457447,37.2689244016391,0.08153923602719082,2548.486178636551,540.1591882705688,2045.9748878479004,28643,6886,21757,21757,0,22,6982000.0
6982,6982999,20.36440319801289,37.274131517518434,0.08154580019852908,2548.865449666977,540.2259426116943,2046.2755241394043,28645,6887,21758,21758,0,22,6983000.0
6983,6983999,20.366105431158157,37.277466365889886,0.08154697531907673,2549.1122863292694,540.2923090457916,2046.9412422180176,28645,6887,21758,21758,0,22,6984000.0
6984,6984999,20.36790161255551,37.280836766393755,0.08156037901920976,2549.40634560585,540.3573977947235,2047.4147605895996,28647,6888,21759,21759,0,22,6985000.0
6985,6985999,20.369639782615153,37.282639782725205,0.08156991080417786,2549.9079234600067,540.4252073764801,2047.259204864502,28651,6890,21761,21761,0,22,6986000.0
6986,6986999,20.370926865833358,37.28353078066417,0.08157880439015996,2550.2885076999664,540.4909288883209,2047.391658782959,28653,6891,21762,21762,0,22,6987000.0
6987,6987999,20.371441116367325,37.28436656462401,0.08155860540287663,2550.5824279785156,540.557683467865,2048.153408050537,28659,6891,21768,21768,0,22,6988000.0
6988,6988999,20.370939322072623,37.283807812961044,0.0815469928203798,2550.9062633514404,540.6256489753723,2048.672275543213,28662,6891,21771,21771,0,22,6989000.0
6989,6989999,20.370598828537027,37.28342097107453,0.08153488516113405,2551.3093893527985,540.6922376155853,2048.8978843688965,28667,6892,21775,21775,0,22,6990000.0
6990,6990999,20.370188682971552,37.28246011122739,0.08152799169218183,2551.552734851837,540.7571651935577,2049.5769233703613,28667,6892,21775,21775,0,22,6991000.0
6991,6991999,20.36996768094622,37.28172348889275,0.08151885442970008,2551.9318342208862,540.8243398666382,2049.731143951416,28670,6893,21777,21777,0,22,6992000.0
6992,6992999,20.36985737686801,37.281075759559656,0.08150884821769921,2552.422488927841,540.8971195220947,2049.520030975342,28672,6894,21778,21778,0,22,6993000.0
6993,6993999,20.369488499304772,37.279885810929564,0.0815049201860456,2552.8544521331787,540.9629423618317,2049.584789276123,28676,6896,21780,21780,0,22,6994000.0
6994,6994999,20.36960084539121,37.27949888781097,0.0814977317044212,2553.5073034763336,541.031252861023,2048.9972953796387,28682,6899,21783,21783,0,22,6995000.0
6995,6995999,20.369666670022475,37.279561126842566,0.08149349637706171,2553.966428041458,541.1006507873535,2048.988842010498,28694,6900,21794,21794,0,22,6996000.0
6996,6996999,20.369879306763654,37.27938399970327,0.0814899599303539,2554.1702740192413,541.1671175956726,2049.8925285339355,28694,6900,21794,21794,0,22,6997000.0
6997,6997999,20.37024425257991,37.27934240885661,0.08148673843731069,2554.6359214782715,541.233927488327,2049.74312210083,28698,6902,21796,21796,0,22,6998000.0
6998,6998999,20.370486071932184,37.2790458700506,0.08148541154538347,2554.88338971138,541.3004925251007,2050.385974884033,28698,6902,21796,21796,0,22,6999000.0
6999,6999999,20.3709746696179,37.27944007576158,0.08148730107174162,2555.346405506134,541.3686804771423,2050.211658477783,28700,6903,21797,21797,0,22,7000000.0
7000,7000999,20.37128578538961,37.279347624313466,0.08148285902619157,2555.7524814605713,541.4355599880219,2050.2262382507324,28701,6903,21798,21798,0,22,7001000.0
7001,7001999,20.371578477623434,37.279205920216945,0.08148127192006194,2556.086089372635,541.5017268657684,2050.6113624572754,28703,6904,21799,21799,0,22,7002000.0
7002,7002999,20.37211478768544,37.279556484429826,0.08148085082968792,2556.4700241088867,541.5688643455505,2050.524646759033,28703,6904,21799,21799,0,22,7003000.0
7003,7003999,20.372225639767066,37.279215705671966,0.08147512640318888,2556.872536420822,541.6407463550568,2050.5924110412598,28703,6904,21799,21799,0,22,7004000.0
7004,7004999,20.37269601453076,37.279075239923465,0.08147557377336268,2557.206111907959,541.7105107307434,2051.0551567077637,28705,6905,21800,21800,0,22,7005000.0
7005,7005999,20.372793354560162,37.27824379558515,0.08147565451146277,2557.6488556861877,541.7780575752258,2050.8906593322754,28707,6906,21801,21801,0,22,7006000.0
7006,7006999,20.37249998664238,37.27712173757395,0.08147504982489195,2558.0178742408752,541.8454451560974,2051.157070159912,28709,6907,21802,21802,0,22,7007000.0
7007,7007999,20.37188649437823,37.275698688815076,0.08147385786559047,2558.3093926906586,541.9098784923553,2051.874225616455,28714,6907,21807,21807,0,22,7008000.0
7008,7008999,20.371038021217682,37.274406109813825,0.08146395886870772,2558.6557474136353,541.9798393249512,2052.4348640441895,28719,6908,21811,21811,0,22,7009000.0
7009,7009999,20.370070855689224,37.27284875174915,0.08145742034131775,2558.977415084839,542.0437986850739,2052.9011268615723,28719,6908,21811,21811,0,22,7010000.0
7010,7010999,20.3694093515626,37.27185195394167,0.08144857384629989,2559.3114063739777,542.107191324234,2053.3827171325684,28723,6909,21814,21814,0,22,7011000.0
7011,7011999,20.368860304428274,37.27114731792912,0.08143750631897007,2559.6581168174744,542.1760468482971,2053.6592140197754,28726,6910,21816,21816,0,22,7012000.0
7012,7012999,20.368419784534193,37.27036635697696,0.08143001575665121,2560.2176706790924,542.2410700321198,2053.163745880127,28730,6912,21818,21818,0,22,7013000.0
7013,7013999,20.367909710876862,37.269991459010406,0.0814200422705118,2560.5207390785217,542.3094475269318,2053.8077964782715,28732,6913,21819,21819,0,22,7014000.0
7014,7014999,20.367565033849253,37.26910554877859,0.08141121543260077,2560.9937562942505,542.3743047714233,2053.6451148986816,28745,6915,21830,21830,0,22,7015000.0
7015,7015999,20.367080335339345,37.26814401452665,0.08140265583153827,2561.536356449127,542.4386398792267,2053.260051727295,28747,6916,21831,21831,0,22,7016000.0
7016,7016999,20.366882191322247,37.26778932114669,0.0813896687572424,2561.781239748001,542.5031230449677,2054.031764984131,28747,6916,21831,21831,0,22,7017000.0
7017,7017999,20.366716543073636,37.26717175130391,0.08137937186146382,2562.0678787231445,542.567461013794,2054.4893379211426,28747,6916,21831,21831,0,22,7018000.0
7018,7018999,20.366544014440475,37.26682397623856,0.08136866377235519,2562.4549067020416,542.6320855617523,2054.746082305908,28751,6918,21833,21833,0,22,7019000.0
7019,7019999,20.36616933929954,37.26611124182337,0.08136227677463692,2563.0388820171356,542.6969542503357,2054.5230445861816,28759,6922,21837,21837,0,22,7020000.0
7020,7020999,20.36618258638656,37.265787353287486,0.08135338318026863,2563.4230024814606,542.7644946575165,2054.7872200012207,28761,6923,21838,21838,0,22,7021000.0
7021,7021999,20.366172491923162,37.266824191219094,0.08133836784020287,2563.8304812908173,542.8289783000946,2054.663761138916,28763,6923,21840,21840,0,22,7022000.0
7022,7022999,20.365952190470647,37.266007873205695,0.08133322895074313,2564.2574396133423,542.8946766853333,2054.6386528015137,28765,6924,21841,21841,0,22,7023000.0
7023,7023999,20.365778449874355,37.265007376703885,0.08132633928001198,2564.570174217224,542.9627232551575,2055.0414085388184,28765,6924,21841,21841,0,22,7024000.0
7024,7024999,20.36577252824631,37.26440520224418,0.08132114469242435,2565.080893754959,543.0304846763611,2054.735828399658,28767,6925,21842,21842,0,22,7025000.0
7025,7025999,20.365610121638284,37.263532831939834,0.08131657610831267,2565.3994002342224,543.0954437255859,2055.0802421569824,28767,6925,21842,21842,0,22,7026000.0
7026,7026999,20.36543761358754,37.26266667638679,0.08131434319116404,2565.7488067150116,543.1641159057617,2055.3683433532715,28769,6926,21843,21843,0,22,7027000.0
7027,7027999,20.36529010179442,37.26316655841097,0.08130711185632389,2566.119154214859,543.2287359237671,2055.5479850769043,28771,6926,21845,21845,0,22,7028000.0
7028,7028999,20.364353357176082,37.262407551983685,0.08129897111640239,2566.631594657898,543.2946753501892,2055.470516204834,28778,6927,21851,21851,0,22,7029000.0
7029,7029999,20.36327749356598,37.261154639233574,0.08129623275668707,2567.0509655475616,543.359824180603,2055.6129112243652,28781,6928,21853,21853,0,22,7030000.0
7030,7030999,20.362572477431808,37.26192840972278,0.08128076771202497,2567.5617167949677,543.4268488883972,2055.528423309326,28787,6930,21857,21857,0,22,7031000.0
7031,7031999,20.361673446845167,37.26030851320528,0.08127987273565196,2567.8173117637634,543.4933636188507,2056.173931121826,28787,6930,21857,21857,0,22,7032000.0
7032,7032999,20.361039284227854,37.25913129740539,0.0812717406722464,2568.193261384964,543.5592787265778,2056.2817192077637,28788,6930,21858,21858,0,22,7033000.0
7033,7033999,20.36041044016228,37.25824394614218,0.08126503101801641,2568.71733379364,543.6257610321045,2056.333110809326,28811,6933,21878,21878,0,22,7034000.0
7034,7034999,20.359749398953845,37.25710191799621,0.08125913762905235,2569.100133419037,543.6909925937653,2056.5965461730957,28815,6935,21880,21880,0,22,7035000.0
7035,7035999,20.359060685857752,37.255735179667695,0.08125402073496069,2569.3507916927338,543.7562878131866,2057.254955291748,28818,6936,21882,21882,0,22,7036000.0
7036,7036999,20.35869334131788,37.254975753616776,0.08124527841438667,2569.6688680648804,543.8255565166473,2057.5498237609863,28818,6936,21882,21882,0,22,7037000.0
7037,7037999,20.358008944687764,37.25349596316515,0.08123969909176809,2570.213156938553,543.8928868770599,2057.17866897583,28822,6938,21884,21884,0,22,7038000.0
7038,7038999,20.357547040023892,37.252499464796784,0.0812311261051587,2570.631142616272,543.9586458206177,2057.1051292419434,28822,6938,21884,21884,0,22,7039000.0
7039,7039999,20.357213408293422,37.25169821611596,0.08122059274740323,2570.9246575832367,544.0260474681854,2057.5617027282715,28822,6938,21884,21884,0,22,7040000.0
7040,7040999,20.356893017019562,37.25068967739807,0.0812104896765875,2571.2044348716736,544.09241938591,2057.9921531677246,28822,6938,21884,21884,0,22,7041000.0
7041,7041999,20.356748538276896,37.251357936449146,0.08119469699848025,2571.4599330425262,544.1597201824188,2058.573154449463,28822,6938,21884,21884,0,22,7042000.0
7042,7042999,20.356707172766022,37.25095088849687,0.08118089280770824,2571.949887037277,544.2274022102356,2058.0247688293457,28824,6939,21885,21885,0,22,7043000.0
7043,7043999,20.356816396252732,37.250760633729534,0.08116745525608016,2572.547485113144,544.2955522537231,2057.3746070861816,28828,6941,21887,21887,0,22,7044000.0
7044,7044999,20.35665935301659,37.24976844911529,0.08115976532890701,2572.955954551697,544.3645575046539,2057.690929412842,28830,6942,21888,21888,0,22,7045000.0
7045,7045999,20.356977478228995,37.249427158968565,0.08115029730181511,2573.316335916519,544.4307959079742,2058.044002532959,28832,6943,21889,21889,0,22,7046000.0
7046,7046999,20.357195991867812,37.24890757451008,0.08113990573599772,2573.6418619155884,544.4974808692932,2058.422176361084,28834,6944,21890,21890,0,22,7047000.0
7047,7047999,20.357416578040045,37.24825323703236,0.08113207574739523,2574.2168283462524,544.5704329013824,2057.996738433838,28838,6946,21892,21892,0,22,7048000.0
7048,7048999,20.35733049541397,37.24760733705532,0.0811172270396221,2574.5400383472443,544.6387157440186,2058.6493949890137,28845,6946,21899,21899,0,22,7049000.0
7049,7049999,20.356881769089075,37.247435273585886,0.08110518090835372,2574.8416924476624,544.711009979248,2059.441608428955,28850,6947,21903,21903,0,22,7050000.0
7050,7050999,20.35629786742202,37.24671189657657,0.08109230856572813,2575.2086148262024,544.7765378952026,2059.8222007751465,28853,6948,21905,21905,0,22,7051000.0
7051,7051999,20.355813042242296,37.246138427681764,0.08107935388834753,2575.6458928585052,544.8457133769989,2060.093448638916,28867,6950,21917,21917,0,22,7052000.0
7052,7052999,20.355449908987694,37.24594896865707,0.08106400871754382,2576.0429933071136,544.913670539856,2060.4899559020996,28871,6952,21919,21919,0,22,7053000.0
7053,7053999,20.355539721670954,37.24676957220387,0.08103320992668939,2576.3218941688538,544.9815254211426,2061.0521125793457,28872,6952,21920,21920,0,22,7054000.0
7054,7054999,20.355331640085357,37.245999641960786,0.08102183116844552,2576.8810539245605,545.0559916496277,2060.858097076416,28879,6955,21924,21924,0,22,7055000.0
7055,7055999,20.355470628058335,37.24706493289863,0.08100574357107082,2577.526840209961,545.1259534358978,2060.1505165100098,28886,6958,21928,21928,0,22,7056000.0
7056,7056999,20.35543442037464,37.2469216720761,0.08098997314518719,2578.1209955215454,545.1956779956818,2060.091037750244,28923,6962,21961,21961,0,22,7057000.0
7057,7057999,20.355510901744957,37.246795336619535,0.0809817603303199,2578.4720804691315,545.2657289505005,2060.6254692077637,28926,6963,21963,21963,0,22,7058000.0
7058,7058999,20.355600606783167,37.24649095756523,0.08096713213068507,2578.802141904831,545.3342401981354,2060.982753753662,28926,6963,21963,21963,0,22,7059000.0
7059,7059999,20.35616169536356,37.24821269346932,0.08094959046703631,2579.0199506282806,545.4028956890106,2061.7432823181152,28926,6963,21963,21963,0,22,7060000.0
7060,7060999,20.356539575014395,37.248527714041096,0.08094126387611478,2579.3841230869293,545.4700064659119,2061.7619667053223,28926,6963,21963,21963,0,22,7061000.0
7061,7061999,20.3571615952808,37.250065822076394,0.08092918102334012,2579.7312395572662,545.5401225090027,2061.9708976745605,28926,6963,21963,21963,0,22,7062000.0
7062,7062999,20.35789433740485,37.25124345153796,0.080920906352688,2580.234471321106,545.6102838516235,2061.7780723571777,28939,6965,21974,21974,0,22,7063000.0
7063,7063999,20.35928204821684,37.25400519166439,0.08091805119673812,2580.6089017391205,545.6789200305939,2062.1136054992676,28941,6966,21975,21975,0,22,7064000.0
7064,7064999,20.360220586156046,37.25591630698115,0.0809172178519163,2581.1026554107666,545.7480490207672,2061.7371940612793,28941,6966,21975,21975,0,22,7065000.0
7065,7065999,20.361495682185534,37.258741317323945,0.0809105127966453,2581.4501774311066,545.8186631202698,2062.162914276123,28943,6967,21976,21976,0,22,7066000.0
7066,7066999,20.362855483121855,37.26126536113412,0.08091782141639114,2581.7313680648804,545.8880290985107,2062.6355323791504,28943,6967,21976,21976,0,22,7067000.0
7067,7067999,20.36455989593912,37.26526505325271,0.08093450688072013,2582.423095226288,545.9592003822327,2061.945568084717,28960,6971,21989,21989,0,22,7068000.0
7068,7068999,20.366138444768843,37.26746377532563,0.08094646027011532,2582.724823951721,546.0280659198761,2062.3452796936035,28960,6971,21989,21989,0,22,7069000.0
7069,7069999,20.366343151907614,37.267228798942384,0.08094138882199686,2583.165812253952,546.0932831764221,2062.657482147217,28968,6972,21996,21996,0,22,7070000.0
7070,7070999,20.36608241692714,37.26739625966538,0.08092537040343173,2583.580798149109,546.1570084095001,2063.054988861084,28974,6974,22000,22000,0,22,7071000.0
7071,7071999,20.365858499876328,37.267222050903754,0.08091041739282212,2583.933142900467,546.2211654186249,2063.4205589294434,28978,6975,22003,22003,0,22,7072000.0
7072,7072999,20.36601576383161,37.26843738716004,0.08089024983540549,2584.219695329666,546.2868640422821,2064.0521202087402,28981,6976,22005,22005,0,22,7073000.0
7073,7073999,20.366583375025492,37.270547072123556,0.08086467102575823,2584.7407677173615,546.3514590263367,2063.966655731201,28988,6979,22009,22009,0,22,7074000.0
7074,7074999,20.366808011637808,37.270498277567235,0.08085050895820234,2585.163718223572,546.4168074131012,2063.8856773376465,28988,6979,22009,22009,0,22,7075000.0
7075,7075999,20.367988153270332,37.273003795613924,0.08083609893428312,2585.675400018692,546.4852578639984,2063.815456390381,28994,6982,22012,22012,0,22,7076000.0
7076,7076999,20.36904951806725,37.27518108543379,0.08082165111496509,2585.8783600330353,546.5504202842712,2064.7374153137207,28994,6982,22012,22012,0,22,7077000.0
7077,7077999,20.36994528794383,37.27594106172376,0.08082066205232852,2586.3916652202606,546.6176888942719,2064.6072273254395,29000,6984,22016,22016,0,22,7078000.0
7078,7078999,20.371126988213838,37.277209297151636,0.08082930179217396,2586.6415305137634,546.6849195957184,2065.309757232666,29000,6984,22016,22016,0,22,7079000.0
7079,7079999,20.3729435455435,37.280503864637296,0.08084916302661604,2586.887870788574,546.7496914863586,2065.9433784484863,29000,6984,22016,22016,0,22,7080000.0
7080,7080999,20.37480251975179,37.283320008827204,0.08086595820490472,2587.5836668014526,546.8151664733887,2065.0510902404785,29006,6987,22019,22019,0,22,7081000.0
7081,7081999,20.37671145356454,37.28665600894662,0.08088332031843914,2587.9285821914673,546.8795318603516,2065.445011138916,29008,6988,22020,22020,0,22,7082000.0
7082,7082999,20.378758400230925,37.289698538360454,0.0809003013109042,2588.468743085861,546.9456901550293,2065.2610054016113,29014,6991,22023,22023,0,22,7083000.0
7083,7083999,20.38115112154623,37.293964478468034,0.0809214755469333,2589.0288434028625,547.0185928344727,2065.0648155212402,29020,6993,22027,22027,0,22,7084000.0
7084,7084999,20.383790374163635,37.29798433743572,0.08097631296503982,2589.2727093696594,547.0853836536407,2065.772602081299,29020,6993,22027,22027,0,22,7085000.0
7085,7085999,20.386076621774887,37.30082902688113,0.08102603361490424,2589.656740427017,547.1563374996185,2066.0579566955566,29022,6994,22028,22028,0,22,7086000.0
7086,7086999,20.388832528399835,37.305686673578016,0.08106963652774024,2590.0028970241547,547.2219152450562,2066.478992462158,29024,6995,22029,22029,0,22,7087000.0
7087,7087999,20.391504920691208,37.30986969263396,0.08113207010370549,2590.6492354869843,547.2888877391815,2065.911952972412,29030,6998,22032,22032,0,22,7088000.0
7088,7088999,20.39415683628629,37.31415802090562,0.08116494467142976,2591.0720312595367,547.3559081554413,2065.9805946350098,29032,6999,22033,22033,0,22,7089000.0
7089,7089999,20.396212798921134,37.318880476406,0.08118405194560907,2591.418205022812,547.42156457901,2066.478748321533,29034,7000,22034,22034,0,22,7090000.0
7090,7090999,20.39582108734918,37.31908582586578,0.081163669339688,2591.8031866550446,547.4881360530853,2066.972454071045,29042,7001,22041,22041,0,22,7091000.0
7091,7091999,20.396026847302178,37.32034529005808,0.08114666900298517,2592.313750267029,547.5534663200378,2066.8863639831543,29051,7003,22048,22048,0,22,7092000.0
7092,7092999,20.396291010489104,37.32307182343513,0.08112867178293304,2592.608828306198,547.6213977336884,2067.461414337158,29051,7003,22048,22048,0,22,7093000.0
7093,7093999,20.39650783405282,37.323272625024224,0.08111593671252093,2592.891228199005,547.686261177063,2067.9767875671387,29052,7003,22049,22049,0,22,7094000.0
7094,7094999,20.39684551553763,37.323609006062696,0.08110479697632711,2593.2621326446533,547.7530961036682,2068.2668952941895,29064,7004,22060,22060,0,22,7095000.0
7095,7095999,20.397317515318992,37.32416072362399,0.08109647826756816,2593.6692764759064,547.8204040527344,2068.3956565856934,29066,7005,22061,22061,0,22,7096000.0
7096,7096999,20.398153679466617,37.32557208425769,0.08109055029782364,2594.01513171196,547.8876717090607,2068.6739082336426,29068,7006,22062,22062,0,22,7097000.0
7097,7097999,20.399237396489184,37.32661034285609,0.08109031500158803,2594.4586522579193,547.9573357105255,2068.837657928467,29073,7008,22065,22065,0,22,7098000.0
7098,7098999,20.400636676039635,37.329081123853896,0.0810951873371969,2594.846772670746,548.0258855819702,2068.9190254211426,29073,7008,22065,22065,0,22,7099000.0
7099,7099999,20.40332006959935,37.33746447422003,0.08110568020163933,2595.453492164612,548.0919454097748,2068.1184272766113,29076,7010,22066,22066,0,22,7100000.0
7100,7100999,20.40576064563439,37.34184748693033,0.08113907321270586,2595.730749130249,548.1624460220337,2068.7589683532715,29076,7010,22066,22066,0,22,7101000.0
7101,7101999,20.408036553198777,37.34545246845086,0.08118700024892767,2596.171537399292,548.2307734489441,2068.7624168395996,29077,7011,22066,22066,0,22,7102000.0
7102,7102999,20.41133336242121,37.351772977930814,0.08124962018642401,2596.532631635666,548.3071882724762,2068.9776649475098,29077,7011,22066,22066,0,22,7103000.0
7103,7103999,20.414164397182805,37.357983264117166,0.0813206448265148,2596.9647443294525,548.3763527870178,2068.9002571105957,29079,7012,22067,22067,0,22,7104000.0
7104,7104999,20.41713503902754,37.365078830045654,0.08138147324703571,2597.2513217926025,548.444037437439,2069.468433380127,29079,7012,22067,22067,0,22,7105000.0
7105,7105999,20.41998841447401,37.36926366950699,0.08145123699023449,2597.797835111618,548.5178191661835,2069.093074798584,29088,7013,22075,22075,0,22,7106000.0
7106,7106999,20.42262029951498,37.37295183238135,0.08151481538568794,2598.1396923065186,548.587146282196,2069.366481781006,29088,7013,22075,22075,0,22,7107000.0
7107,7107999,20.424760688346424,37.375914189560305,0.08154356780683181,2598.6210527420044,548.6577250957489,2069.5551567077637,29106,7015,22091,22091,0,22,7108000.0
7108,7108999,20.42547239259583,37.3793031545348,0.08151112802697691,2598.9459552764893,548.7243785858154,2070.389736175537,29120,7016,22104,22104,0,22,7109000.0
7109,7109999,20.425868530626385,37.38495607497874,0.08147984645895312,2599.458715200424,548.7888941764832,2070.5810737609863,29128,7019,22109,22109,0,22,7110000.0
7110,7110999,20.426305124349042,37.38579580934315,0.08146762389350715,2599.9254598617554,548.8564846515656,2070.6947441101074,29130,7020,22110,22110,0,22,7111000.0
7111,7111999,20.4268156345943,37.38739259854971,0.08145911626693347,2600.2194952964783,548.9207022190094,2071.2220878601074,29132,7020,22112,22112,0,22,7112000.0
7112,7112999,20.427549072328866,37.38913738336011,0.08145729316608052,2600.60546875,548.9859888553619,2071.6419410705566,29141,7022,22119,22119,0,22,7113000.0
7113,7113999,20.428784232817883,37.39117717951262,0.0814721360185473,2601.212061882019,549.0526566505432,2071.284969329834,29147,7025,22122,22122,0,22,7114000.0
7114,7114999,20.430305974411446,37.39503982984263,0.08149327955455954,2601.5954415798187,549.1186611652374,2071.4417686462402,29149,7026,22123,22123,0,22,7115000.0
7115,7115999,20.432137164491216,37.399189416923925,0.08150392050952848,2601.886082172394,549.1842703819275,2071.9342002868652,29149,7026,22123,22123,0,22,7116000.0
7116,7116999,20.434411229394858,37.40820871397233,0.08152637122077455,2602.237585067749,549.2505841255188,2072.2354698181152,29151,7027,22124,22124,0,22,7117000.0
7117,7117999,20.43742219989639,37.41854848794451,0.08152990444208452,2602.563059568405,549.3171770572662,2072.5524101257324,29153,7028,22125,22125,0,22,7118000.0
7118,7118999,20.440653892937046,37.42708664683785,0.0816188583871289,2603.409476995468,549.3824298381805,2071.5464363098145,29167,7035,22132,22132,0,22,7119000.0
7119,7119999,20.443723720699293,37.43461268653666,0.08168993425977222,2604.0204668045044,549.4518547058105,2071.3813819885254,29175,7039,22136,22136,0,22,7120000.0
7120,7120999,20.446742502727595,37.44393543445964,0.08174474118053143,2604.357477903366,549.5189855098724,2071.9389305114746,29179,7041,22138,22138,0,22,7121000.0
7121,7121999,20.450387382179386,37.4535148972327,0.08188005237196605,2604.7235717773438,549.5847911834717,2072.253475189209,29181,7042,22139,22139,0,22,7122000.0
7122,7122999,20.454707059863345,37.466196224700774,0.08204344570732391,2605.290941953659,549.6516246795654,2071.838550567627,29197,7044,22153,22153,0,22,7123000.0
7123,7123999,20.45838213916435,37.47608964362599,0.082155306875078,2605.5436494350433,549.7213976383209,2072.710262298584,29197,7044,22153,22153,0,22,7124000.0
7124,7124999,20.46277997070737,37.48627534862612,0.08226613357192414,2605.9816994667053,549.7911419868469,2072.9980659484863,29201,7046,22155,22155,0,22,7125000.0
7125,7125999,20.466657858952843,37.49563486202231,0.08237581595014198,2606.5374648571014,549.8585951328278,2072.752826690674,29205,7048,22157,22157,0,22,7126000.0
7126,7126999,20.4701144913994,37.502641988276636,0.08251479422642294,2606.8447988033295,549.9285097122192,2073.5288887023926,29236,7049,22187,22187,0,22,7127000.0
7127,7127999,20.47160217054154,37.50574072101594,0.08252088723953799,2607.4254138469696,549.9951300621033,2073.3112983703613,29254,7051,22203,22203,0,22,7128000.0
7128,7128999,20.47212740245989,37.50700355080231,0.08250630077528687,2607.7213640213013,560.4328730106354,2074.124439239502,29255,7051,22204,22204,0,22,7129000.0
7129,7129999,20.472682289502437,37.509647760572605,0.08248540645676172,2608.0594449043274,560.5014476776123,2074.4114723205566,29255,7051,22204,22204,0,22,7130000.0
7130,7130999,20.472791829531047,37.51041264597593,0.08246776368839115,2608.5245926380157,560.5716650485992,2074.3474464416504,29257,7052,22205,22205,0,22,7131000.0
7131,7131999,20.473084356718033,37.51105368149115,0.08245624421013398,2608.9714317321777,560.6404695510864,2074.419651031494,29262,7054,22208,22208,0,22,7132000.0
7132,7132999,20.473326258694083,37.511527964548705,0.0824484555881766,2609.3072204589844,560.7080729007721,2074.9002799987793,29264,7055,22209,22209,0,22,7133000.0
7133,7133999,20.473325731676614,37.51182170102283,0.082441430000738,2609.769644498825,560.7757940292358,2074.715000152588,29266,7056,22210,22210,0,22,7134000.0
7134,7134999,20.473531622022836,37.51266849056051,0.08243485769118641,2610.2513489723206,560.8434269428253,2074.730785369873,29270,7058,22212,22212,0,22,7135000.0
7135,7135999,20.47371202308616,37.51261143264682,0.08243248769765654,2610.6341655254364,560.9148211479187,2074.9012031555176,29272,7059,22213,22213,0,22,7136000.0
7136,7136999,20.473958911226955,37.51282222788162,0.08242327351450496,2611.20947432518,560.9855840206146,2074.137310028076,29273,7059,22214,22214,0,22,7137000.0
7137,7137999,20.474032432425357,37.51257762877544,0.08242507192403137,2611.5545284748077,561.0533239841461,2074.6168098449707,29275,7060,22215,22215,0,22,7138000.0
7138,7138999,20.47413327125533,37.512095894841806,0.0824281593573819,2611.8051137924194,561.1230065822601,2075.2148399353027,29275,7060,22215,22215,0,22,7139000.0
7139,7139999,20.474194259732577,37.51146369886878,0.0824293031453498,2612.233761072159,561.1911976337433,2075.205020904541,29277,7061,22216,22216,0,22,7140000.0
7140,7140999,20.474649143865143,37.511430553978784,0.08242789767455383,2612.593736886978,561.262758731842,2075.3963584899902,29277,7061,22216,22216,0,22,7141000.0
7141,7141999,20.474832987326238,37.51184867480038,0.08242405644227291,2612.993136882782,561.3309690952301,2075.347728729248,29277,7061,22216,22216,0,22,7142000.0
7142,7142999,20.47495133960586,37.51101047642549,0.08242258214054332,2613.4241659641266,561.401992559433,2075.517002105713,29279,7062,22217,22217,0,22,7143000.0
7143,7143999,20.4748565624398,37.509748027981296,0.08242267731627528,2613.7784955501556,561.4727084636688,2075.8519325256348,29279,7062,22217,22217,0,22,7144000.0
7144,7144999,20.47502068679991,37.50898028832709,0.08239616115676918,2614.0976073741913,561.538548707962,2076.834239959717,29290,7063,22227,22227,0,22,7145000.0
7145,7145999,20.475188290678197,37.5090721951644,0.08237311954517779,2614.4349591732025,561.6032183170319,2077.5712852478027,29294,7064,22230,22230,0,22,7146000.0
7146,7146999,20.475258067545887,37.509354919491514,0.08236484937728239,2614.8074762821198,561.6704270839691,2077.980152130127,29298,7065,22233,22233,0,22,7147000.0
7147,7147999,20.474879386575903,37.5079561733051,0.08236297385032021,2615.2439658641815,561.7401249408722,2078.151355743408,29307,7067,22240,22240,0,22,7148000.0
7148,7148999,20.47498666125143,37.50847649097125,0.08236310660719337,2615.725909948349,561.8059492111206,2078.1137199401855,29311,7069,22242,22242,0,22,7149000.0
7149,7149999,20.4752559963466,37.50882683177306,0.08236725113852139,2616.1573026180267,561.8700580596924,2078.308681488037,29315,7071,22244,22244,0,22,7150000.0
7150,7150999,20.47534315312544,37.50881674389433,0.08235991479419069,2616.664001226425,561.9381160736084,2078.185894012451,29319,7073,22246,22246,0,22,7151000.0
7151,7151999,20.475635963919643,37.509316878414225,0.08235160709267686,2616.893610239029,562.0024449825287,2078.9855918884277,29319,7073,22246,22246,0,22,7152000.0
7152,7152999,20.475792054502637,37.50935578227915,0.0823593099028963,2617.3784425258636,562.0681304931641,2078.8451652526855,29321,7074,22247,22247,0,22,7153000.0
7153,7153999,20.476465777306775,37.51260021912765,0.08235219632535118,2617.8091657161713,562.1340413093567,2079.030735015869,29326,7076,22250,22250,0,22,7154000.0
7154,7154999,20.476974633832036,37.51357542821983,0.08236161310603252,2618.2578206062317,562.1999628543854,2079.0689125061035,29357,7077,22280,22280,0,22,7155000.0
7155,7155999,20.477557027291322,37.51423815065649,0.0823524271842695,2618.516977071762,562.2663915157318,2079.635898590088,29357,7077,22280,22280,0,22,7156000.0
7156,7156999,20.478021786813596,37.514386772369825,0.08235949480271831,2619.058806180954,562.336807012558,2079.4698219299316,29363,7080,22283,22283,0,22,7157000.0
7157,7157999,20.47842853841645,37.51454282979072,0.0823607271867759,2619.6446599960327,562.4066641330719,2079.2350578308105,29369,7083,22286,22286,0,22,7158000.0
7158,7158999,20.479375813604317,37.51759788862735,0.08236199794723309,2620.044403076172,562.4735038280487,2079.2943687438965,29369,7083,22286,22286,0,22,7159000.0
7159,7159999,20.479576491065952,37.51712450204426,0.08237710792100128,2620.4345207214355,562.5401713848114,2079.6262245178223,29373,7085,22288,22288,0,22,7160000.0
7160,7160999,20.47971883881315,37.51661254151928,0.08239297269462964,2620.849064350128,562.6060974597931,2079.931781768799,29378,7086,22292,22292,0,22,7161000.0
7161,7161999,20.480475600013474,37.526505152303045,0.08235156659242937,2621.2222747802734,562.6719138622284,2080.5502738952637,29391,7087,22304,22304,0,22,7162000.0
7162,7162999,20.48040752004383,37.53054313675723,0.0823320400684221,2621.5438549518585,562.7370054721832,2081.088390350342,29394,7088,22306,22306,0,22,7163000.0
7163,7163999,20.480193351430813,37.53038201958905,0.08232390971316028,2621.932846069336,562.8042974472046,2081.3102684020996,29396,7089,22307,22307,0,22,7164000.0
7164,7164999,20.480395500860734,37.53169287972348,0.08230636518389511,2622.2828073501587,562.8726921081543,2081.6475715637207,29399,7090,22309,22309,0,22,7165000.0
7165,7165999,20.48079723893813,37.532508071339855,0.08230022374416102,2622.8312685489655,562.9398531913757,2081.5519676208496,29406,7093,22313,22313,0,22,7166000.0
7166,7166999,20.481158338093877,37.532921769025776,0.08229027148886814,2623.305145263672,563.0079321861267,2081.343921661377,29408,7094,22314,22314,0,22,7167000.0
7167,7167999,20.48161363322021,37.53363534875531,0.0822813513657451,2623.6411888599396,563.0765290260315,2081.9837379455566,29422,7096,22326,22326,0,22,7168000.0
7168,7168999,20.482159248824598,37.53410998492132,0.08227294542576091,2623.9692301750183,563.1456942558289,2082.4501152038574,29434,7097,22337,22337,0,22,7169000.0
7169,7169999,20.482802070798822,37.53464801147917,0.08226505097385839,2624.546635389328,563.2154450416565,2082.1417961120605,29441,7100,22341,22341,0,22,7170000.0
7170,7170999,20.483975303582184,37.53826011061198,0.08225162632094085,2624.830154657364,563.2824747562408,2082.6800117492676,29441,7100,22341,22341,0,22,7171000.0
7171,7171999,20.484879449922364,37.539738494644126,0.08224865621069133,2625.290965795517,563.3519268035889,2082.561061859131,29443,7101,22342,22342,0,22,7172000.0
7172,7172999,20.485739742657362,37.54040982078679,0.0822480593568593,2625.6338210105896,563.4190647602081,2082.9100227355957,29446,7102,22344,22344,0,22,7173000.0
7173,7173999,20.48677286346437,37.541813279982016,0.08224809453238446,2626.0669918060303,563.4876022338867,2082.8902854919434,29448,7103,22345,22345,0,22,7174000.0
7174,7174999,20.48790457540825,37.54477920482354,0.08224789891040174,2626.447333574295,563.5550425052643,2083.0918464660645,29450,7104,22346,22346,0,22,7175000.0
7175,7175999,20.489199556332046,37.5462847617134,0.08225580905185814,2626.9034774303436,563.6229238510132,2083.1182136535645,29454,7106,22348,22348,0,22,7176000.0
7176,7176999,20.49013105347901,37.54679206980488,0.08225713776113297,2627.196219921112,563.6901957988739,2083.616771697998,29454,7106,22348,22348,0,22,7177000.0
7177,7177999,20.4912038979477,37.54782627481357,0.08226300577506007,2627.8242230415344,563.7586421966553,2083.116153717041,29461,7110,22351,22351,0,22,7178000.0
7178,7178999,20.492277666641094,37.54847164374194,0.08227671719497887,2628.3235669136047,563.8269906044006,2083.017063140869,29465,7112,22353,22353,0,22,7179000.0
7179,7179999,20.49315609412059,37.5485894438353,0.08227924685548971,2628.648600101471,563.8963406085968,2083.3863410949707,29465,7112,22353,22353,0,22,7180000.0
7180,7180999,20.494271175727448,37.54998979783953,0.08229151481087182,2629.1176941394806,563.9638106822968,2083.399082183838,29469,7114,22355,22355,0,22,7181000.0
7181,7181999,20.49492031991513,37.55081250337785,0.08227339111889997,2629.470252752304,564.0346322059631,2083.9361839294434,29477,7114,22363,22363,0,22,7182000.0
7182,7182999,20.495039876955214,37.550831206430416,0.08225149114265673,2629.719051837921,564.1022679805756,2084.703998565674,29477,7114,22363,22363,0,22,7183000.0
7183,7183999,20.49515398651467,37.55099663054405,0.08223354848397035,2630.1594421863556,564.1704943180084,2084.703456878662,29480,7115,22365,22365,0,22,7184000.0
7184,7184999,20.495451771255205,37.55075800615463,0.08221646292027462,2630.45467209816,564.2400522232056,2085.21976852417,29480,7115,22365,22365,0,22,7185000.0
7185,7185999,20.49546709833304,37.55015765653196,0.08221050481198877,2630.8582468032837,564.3101613521576,2085.37788772583,29484,7116,22368,22368,0,22,7186000.0
7186,7186999,20.495520237566186,37.550497311463026,0.08219988102805331,2631.1889991760254,564.3807966709137,2085.7767448425293,29484,7116,22368,22368,0,22,7187000.0
7187,7187999,20.496170281010556,37.55085124736879,0.08219649137551122,2631.686089515686,564.4553778171539,2085.55326461792,29486,7117,22369,22369,0,22,7188000.0
7188,7188999,20.496789285166106,37.55146714959977,0.08219757384917858,2632.2029373645782,564.5262563228607,2085.568759918213,29520,7119,22401,22401,0,22,7189000.0
7189,7189999,20.49739269595617,37.55206345594826,0.08219709244757945,2632.747748374939,564.5997114181519,2085.542896270752,29534,7122,22412,22412,0,22,7190000.0
7190,7190999,20.49843092419277,37.55334462452305,0.0822018176860333,2633.003027677536,564.6701772212982,2086.1852073669434,29534,7122,22412,22412,0,22,7191000.0
7191,7191999,20.4996340159806,37.55475149816016,0.08222557156247834,2633.3965423107147,564.7407519817352,2086.1889152526855,29535,7122,22413,22413,0,22,7192000.0
7192,7192999,20.501058855664112,37.557174045853515,0.08224318104541528,2633.8147077560425,564.813029050827,2086.076671600342,29535,7122,22413,22413,0,22,7193000.0
7193,7193999,20.502801021206206,37.560818809589456,0.08226871759262522,2634.289941549301,564.8854830265045,2086.0267295837402,29538,7124,22414,22414,0,22,7194000.0
7194,7194999,20.504401589925518,37.56243106373745,0.08230390427726664,2634.632246494293,564.9578366279602,2086.4710731506348,29540,7125,22415,22415,0,22,7195000.0
7195,7195999,20.50638231171264,37.565403995295725,0.08232778872354651,2634.9440314769745,565.0283780097961,2086.9062309265137,29540,7125,22415,22415,0,22,7196000.0
7196,7196999,20.50837221566765,37.56792646429448,0.0823681266695736,2635.379954099655,565.1006274223328,2086.9026832580566,29542,7126,22416,22416,0,22,7197000.0
7197,7197999,20.5103013008982,37.570296750325795,0.08240988467168786,2635.9903173446655,565.1730091571808,2086.3744621276855,29547,7129,22418,22418,0,22,7198000.0
7198,7198999,20.512270304616667,37.57231325825104,0.0824723770741379,2636.5579719543457,565.2468535900116,2085.912494659424,29556,7130,22426,22426,0,22,7199000.0
7199,7199999,20.514414994867828,37.5757339235969,0.0825362377492026,2636.8486251831055,565.3205926418304,2086.5390281677246,29556,7130,22426,22426,0,22,7200000.0
7200,7200999,20.51647948832022,37.57787020789933,0.08262379542236964,2637.1987278461456,565.3927853107452,2086.746105194092,29556,7130,22426,22426,0,22,7201000.0
7201,7201999,20.517818681591105,37.58014641352006,0.08265713179873002,2637.4533059597015,565.4623126983643,2087.6630516052246,29563,7131,22432,22432,0,22,7202000.0
7202,7202999,20.517825155662454,37.580233188758385,0.08264802977229391,2637.857452392578,565.5246336460114,2088.0859718322754,29577,7133,22444,22444,0,22,7203000.0
7203,7203999,20.51757175636084,37.57935795656785,0.08264316274456018,2638.473446369171,565.5903069972992,2087.6049308776855,29583,7136,22447,22447,0,22,7204000.0
7204,7204999,20.517630258946692,37.57922547063923,0.08263653325809395,2638.8301317691803,565.6553363800049,2088.110210418701,29586,7137,22449,22449,0,22,7205000.0
7205,7205999,20.51836782188732,37.580514555632575,0.08261878889797059,2639.270060777664,565.7222633361816,2088.3355751037598,29591,7139,22452,22452,0,22,7206000.0
7206,7206999,20.51950664112681,37.58264200640655,0.08260124967114901,2639.6422147750854,565.7876887321472,2088.749126434326,29620,7140,22480,22480,0,22,7207000.0
7207,7207999,20.521226777138835,37.58572080720958,0.08258602242716062,2640.098662376404,565.8528542518616,2088.849292755127,29624,7142,22482,22482,0,22,7208000.0
7208,7208999,20.52356529571052,37.59040971656263,0.08258947821177187,2640.713639497757,565.9192779064178,2088.5209770202637,29632,7146,22486,22486,0,22,7209000.0
7209,7209999,20.525643722709944,37.59414324445722,0.0826004952523346,2641.034863471985,565.9835970401764,2089.275592803955,29637,7148,22489,22489,0,22,7210000.0
7210,7210999,20.52825785579928,37.59885358169138,0.08263246092064269,2641.489965200424,566.0499441623688,2089.627414703369,29653,7151,22502,22502,0,22,7211000.0
7211,7211999,20.530878436734746,37.60314116203987,0.0826762380639039,2642.0925600528717,566.1165015697479,2089.2470207214355,29659,7154,22505,22505,0,22,7212000.0
7212,7212999,20.533349646330134,37.60721740207718,0.08273756379303132,2642.506745815277,566.1828637123108,2089.6176261901855,29663,7156,22507,22507,0,22,7213000.0
7213,7213999,20.535649895084823,37.610183305234614,0.08279605922486821,2642.932374238968,566.2491495609283,2089.7311515808105,29665,7157,22508,22508,0,22,7214000.0
7214,7214999,20.538283051453185,37.61407954361466,0.08286426001621594,2643.362327337265,566.3147752285004,2089.9471015930176,29669,7159,22510,22510,0,22,7215000.0
7215,7215999,20.541124992759546,37.62230983910827,0.08292307264381649,2643.693667411804,566.3794219493866,2090.3613319396973,29671,7160,22511,22511,0,22,7216000.0
7216,7216999,20.543357019669212,37.625015270149895,0.0830060072662192,2643.970486164093,566.4451205730438,2090.961254119873,29671,7160,22511,22511,0,22,7217000.0
7217,7217999,20.546012780440176,37.629835877017484,0.08308211413762889,2644.439230442047,566.5106127262115,2090.8727226257324,29675,7162,22513,22513,0,22,7218000.0
7218,7218999,20.54841346983798,37.632582448248705,0.08315675818301982,2644.916430711746,566.5763871669769,2090.5267066955566,29675,7162,22513,22513,0,22,7219000.0
7219,7219999,20.551219547122354,37.63643875613779,0.08322833426880516,2645.289097547531,566.6424765586853,2090.9536323547363,29677,7163,22514,22514,0,22,7220000.0
7220,7220999,20.553321043496002,37.6384400593453,0.08329246574059535,2645.648404121399,566.7102723121643,2091.266948699951,29679,7164,22515,22515,0,22,7221000.0
7221,7221999,20.553589626897637,37.63844304646596,0.08327972761544844,2645.9943764209747,566.7762327194214,2092.051570892334,29690,7165,22525,22525,0,22,7222000.0
7222,7222999,20.553074979316452,37.63792386171416,0.08326433941964817,2646.3326222896576,566.8424441814423,2092.794994354248,29695,7166,22529,22529,0,22,7223000.0
7223,7223999,20.55254815362773,37.63715806217872,0.08325132613553943,2646.6059687137604,566.9122140407562,2093.619915008545,29695,7166,22529,22529,0,22,7224000.0
7224,7224999,20.552257346330812,37.6364735606334,0.08324152307017041,2647.1088700294495,566.9817838668823,2093.5332374572754,29699,7168,22531,22531,0,22,7225000.0
7225,7225999,20.552069421375847,37.63581403020431,0.08322821138352965,2647.470370531082,567.0481374263763,2093.9380226135254,29703,7169,22534,22534,0,22,7226000.0
7226,7226999,20.55205221697799,37.635688174495094,0.08321363785940727,2647.9603559970856,567.1164119243622,2093.8656120300293,29707,7171,22536,22536,0,22,7227000.0
7227,7227999,20.552020361857487,37.63526648343013,0.08320118009512023,2648.213403940201,567.1834876537323,2094.646007537842,29709,7172,22537,22537,0,22,7228000.0
7228,7228999,20.55202126358311,37.6348925633193,0.0831925930988262,2648.7282292842865,567.2507975101471,2094.385715484619,29713,7174,22539,22539,0,22,7229000.0
7229,7229999,20.552267087250236,37.63560463860285,0.08317882902406581,2649.204214811325,567.3188192844391,2094.482967376709,29717,7176,22541,22541,0,22,7230000.0
7230,7230999,20.552525668464195,37.635256839283045,0.08316779111722405,2649.6211121082306,567.3916850090027,2094.7315406799316,29719,7177,22542,22542,0,22,7231000.0
7231,7231999,20.55281903930564,37.63524199244786,0.08316178730945412,2650.190079689026,567.4596705436707,2094.559024810791,29730,7180,22550,22550,0,22,7232000.0
7232,7232999,20.55300000231609,37.634901235324016,0.08315668952984523,2650.6295652389526,567.5278787612915,2094.777187347412,29734,7182,22552,22552,0,22,7233000.0
7233,7233999,20.553129453494222,37.63454700080909,0.08315082903923998,2651.01833319664,567.596310377121,2094.9542274475098,29736,7183,22553,22553,0,22,7234000.0
7234,7234999,20.553541285701698,37.6347037038728,0.08314324641332382,2651.5045659542084,567.6718609333038,2094.7943077087402,29738,7184,22554,22554,0,22,7235000.0
7235,7235999,20.55367203069105,37.63402488662657,0.08313876506504025,2651.791192293167,567.7391710281372,2095.365131378174,29738,7184,22554,22554,0,22,7236000.0
7236,7236999,20.554229757205995,37.63411778734474,0.08313551423787247,2652.1783788204193,567.8062653541565,2095.563190460205,29740,7185,22555,22555,0,22,7237000.0
7237,7237999,20.55445244348423,37.63347034226585,0.08313375160113634,2652.4737820625305,567.8761384487152,2096.1351051330566,29740,7185,22555,22555,0,22,7238000.0
7238,7238999,20.554518998799995,37.632596162552574,0.08313669690033265,2652.862708568573,567.9425649642944,2096.3997535705566,29742,7186,22556,22556,0,22,7239000.0
7239,7239999,20.554227077089717,37.631707881471705,0.08312515471511195,2653.2968497276306,568.0084147453308,2096.8069648742676,29755,7187,22568,22568,0,22,7240000.0
7240,7240999,20.55390051992204,37.631732480781515,0.08311312326497611,2653.7667520046234,568.0737535953522,2096.9236793518066,29761,7188,22573,22573,0,22,7241000.0
7241,7241999,20.553378909555374,37.6310778323679,0.08310598747153275,2654.0725100040436,568.1408421993256,2097.633975982666,29763,7189,22574,22574,0,22,7242000.0
7242,7242999,20.553077938084176,37.630791143612285,0.08309510771279893,2654.5406398773193,568.2084233760834,2097.7792930603027,29768,7191,22577,22577,0,22,7243000.0
7243,7243999,20.55275956294737,37.63062486033115,0.08308336706795028,2654.871265411377,568.2749907970428,2098.2091789245605,29770,7192,22578,22578,0,22,7244000.0
7244,7244999,20.55251144011825,37.63004348873816,0.08307506276399323,2655.385069131851,568.3399698734283,2098.1865043640137,29776,7195,22581,22581,0,22,7245000.0
7245,7245999,20.55225614839626,37.629408958585806,0.08306755168079016,2655.6363344192505,568.40651512146,2098.9111137390137,29776,7195,22581,22581,0,22,7246000.0
7246,7246999,20.552278330408587,37.62927394054202,0.0830559635556739,2655.979574918747,568.471931219101,2099.3065757751465,29779,7196,22583,22583,0,22,7247000.0
7247,7247999,20.552225137382994,37.62875638527877,0.08304779291041875,2656.267201423645,568.537430524826,2099.769557952881,29779,7196,22583,22583,0,22,7248000.0
7248,7248999,20.552614931966023,37.6292154539341,0.08303542547449305,2656.7244322299957,568.6032350063324,2099.4846229553223,29779,7196,22583,22583,0,22,7249000.0
7249,7249999,20.552999568545893,37.62968992002914,0.08302624996572672,2657.112354040146,568.6690442562103,2099.7499351501465,29781,7197,22584,22584,0,22,7250000.0
7250,7250999,20.553508925435825,37.63149153175581,0.08301115493943179,2657.311738729477,568.7351288795471,2100.5719261169434,29781,7197,22584,22584,0,22,7251000.0
7251,7251999,20.553726582855425,37.63135041372124,0.08300848859684296,2657.5615677833557,568.7988312244415,2101.1055030822754,29781,7197,22584,22584,0,22,7252000.0
7252,7252999,20.554329074776692,37.63162920788489,0.0830016229861168,2657.9774079322815,568.8665928840637,2101.132656097412,29782,7198,22584,22584,0,22,7253000.0
7253,7253999,20.55482811029125,37.631482661937355,0.08299817106819463,2658.532675743103,568.9325914382935,2100.623348236084,29786,7200,22586,22586,0,22,7254000.0
7254,7254999,20.555607294714004,37.63211433961771,0.08299004114156139,2658.831894159317,568.9986205101013,2101.04487991333,29786,7200,22586,22586,0,22,7255000.0
7255,7255999,20.556308765190668,37.63226258725816,0.08298730487700734,2659.433004140854,569.0647797584534,2100.6052436828613,29791,7203,22588,22588,0,22,7256000.0
7256,7256999,20.557211916570214,37.63312544852233,0.08298126741486755,2659.868947505951,569.1340494155884,2100.8585319519043,29793,7204,22589,22589,0,22,7257000.0
7257,7257999,20.55805010547483,37.63409562537227,0.0829785185102686,2660.3840625286102,569.2032935619354,2100.609676361084,29795,7205,22590,22590,0,22,7258000.0
7258,7258999,20.558589903978582,37.6352233003721,0.08295801470268982,2660.67875123024,569.2765305042267,2101.7879753112793,29806,7206,22600,22600,0,22,7259000.0
7259,7259999,20.558969014745497,37.63658585260147,0.08295163313954235,2660.910402774811,569.339955329895,2102.680103302002,29807,7206,22601,22601,0,22,7260000.0
7260,7260999,20.559018894396388,37.63751258072695,0.08293936582619232,2661.246844768524,569.4035694599152,2103.2047996520996,29816,7207,22609,22609,0,22,7261000.0
7261,7261999,20.558886387060184,37.63675999042296,0.08293172938144555,2661.6793401241302,569.4691412448883,2103.509006500244,29825,7209,22616,22616,0,22,7262000.0
7262,7262999,20.559061828887007,37.63671917530783,0.08292108899440087,2662.191550016403,569.5356001853943,2103.4985008239746,29831,7211,22620,22620,0,22,7263000.0
7263,7263999,20.55913469553727,37.63618154356145,0.0829156215115966,2662.616634130478,569.6016149520874,2103.663112640381,29833,7212,22621,22621,0,22,7264000.0
7264,7264999,20.55921367425529,37.63589968950063,0.08291356585712784,2662.947213411331,569.6670868396759,2103.9211463928223,29833,7212,22621,22621,0,22,7265000.0
7265,7265999,20.559178787433126,37.63587715900388,0.08290508425299004,2663.4260082244873,569.7348239421844,2103.8103981018066,29835,7213,22622,22622,0,22,7266000.0
7266,7266999,20.559590767248313,37.63813871794008,0.08289152818119805,2663.808085203171,569.8002412319183,2104.01224899292,29837,7214,22623,22623,0,22,7267000.0
7267,7267999,20.559937428944767,37.638202499441455,0.08288620665423196,2664.186383485794,569.864405632019,2104.1346321105957,29837,7214,22623,22623,0,22,7268000.0
7268,7268999,20.560412704329416,37.63883332181069,0.08287673679620577,2664.5744709968567,569.9305980205536,2104.3475303649902,29839,7215,22624,22624,0,22,7269000.0
7269,7269999,20.56087602699826,37.63905205186164,0.08287688736886678,2664.9059298038483,569.9968857765198,2104.7843742370605,29840,7216,22624,22624,0,22,7270000.0
7270,7270999,20.561579246829115,37.639508917739896,0.0828745472866802,2665.3278453350067,570.0636403560638,2104.7701377868652,29842,7217,22625,22625,0,22,7271000.0
7271,7271999,20.562177301956357,37.63973494924721,0.08287656834267365,2665.626786470413,570.1292457580566,2105.400592803955,29849,7218,22631,22631,0,22,7272000.0
7272,7272999,20.563083946873093,37.641002733952895,0.0828794057261435,2666.031158685684,570.202024936676,2105.5384941101074,29850,7219,22631,22631,0,22,7273000.0
7273,7273999,20.564458775774362,37.642937606118956,0.08287328166475494,2666.6121413707733,570.267929315567,2104.7695960998535,29850,7219,22631,22631,0,22,7274000.0
7274,7274999,20.56558419861266,37.64421291349259,0.08286312047347644,2666.9633877277374,570.3365724086761,2105.2151069641113,29850,7219,22631,22631,0,22,7275000.0
7275,7275999,20.565636727844286,37.643823629995325,0.08285555664453825,2667.22585773468,570.4015984535217,2106.8268089294434,29857,7219,22638,22638,0,22,7276000.0
7276,7276999,20.565799522379397,37.64533760234509,0.08284367647812496,2667.680279493332,570.4667747020721,2107.7373237609863,29860,7219,22641,22641,0,22,7277000.0
7277,7277999,20.565716777248646,37.64517576583756,0.0828399195832954,2668.415952205658,570.5332536697388,2107.828601837158,29869,7221,22648,22648,0,22,7278000.0
7278,7278999,20.56570367590619,37.644935495581066,0.08283775473864075,2669.0321950912476,570.6023721694946,2108.608699798584,29890,7223,22667,22667,0,22,7279000.0
7279,7279999,20.565874440401224,37.64499153897472,0.08283395825336215,2669.733259677887,570.6678018569946,2108.7668266296387,29893,7224,22669,22669,0,22,7280000.0
7280,7280999,20.566006372057824,37.64501760096242,0.08283465106039567,2670.2104766368866,570.7347428798676,2109.870220184326,29896,7224,22672,22672,0,22,7281000.0
7281,7281999,20.565976710818592,37.64485715460504,0.08283709247786519,2670.9937686920166,570.8001120090485,2109.659564971924,29901,7226,22675,22675,0,22,7282000.0
7282,7282999,20.56617345835102,37.644976087565915,0.08283509521236032,2671.626588344574,570.8673164844513,2109.960590362549,29901,7226,22675,22675,0,22,7283000.0
7283,7283999,20.566872799367584,37.64630294225473,0.08282688423568074,2672.2172610759735,570.933268070221,2110.5901069641113,29904,7227,22677,22677,0,22,7284000.0
7284,7284999,20.567709645053803,37.64764477327931,0.08282000578789694,2672.8860206604004,571.0007064342499,2110.834217071533,29904,7227,22677,22677,0,22,7285000.0
7285,7285999,20.56841340899423,37.64860622061454,0.08281028206533181,2673.536481142044,571.068690776825,2111.3813667297363,29907,7228,22679,22679,0,22,7286000.0
7286,7286999,20.569384988740968,37.65009322728044,0.08280790301431573,2674.51047706604,571.1355490684509,2110.426097869873,29915,7232,22683,22683,0,22,7287000.0
7287,7287999,20.570562018598157,37.65163648778588,0.08280731573185518,2675.1333792209625,571.2058963775635,2110.708225250244,29915,7232,22683,22683,0,22,7288000.0
7288,7288999,20.572077898571465,37.653933642908186,0.08280452156785689,2675.4839522838593,571.2738265991211,2112.1692085266113,29915,7232,22683,22683,0,22,7289000.0
7289,7289999,20.573769449806054,37.657715135354486,0.08280321418940573,2676.1919701099396,571.3442187309265,2112.2562141418457,29918,7233,22685,22685,0,22,7290000.0
7290,7290999,20.57508376836521,37.65891982057563,0.08280336345793038,2676.8069121837616,571.4176371097565,2112.838077545166,29921,7234,22687,22687,0,22,7291000.0
7291,7291999,20.576780409643654,37.6612101361386,0.08281057190981911,2677.44398021698,571.4898681640625,2113.234119415283,29923,7235,22688,22688,0,22,7292000.0
7292,7292999,20.57833201096929,37.66306793575332,0.08280773729043922,2678.14959359169,571.5592584609985,2113.2363929748535,29925,7236,22689,22689,0,22,7293000.0
7293,7293999,20.578824903524936,37.66300156487642,0.08280962130900182,2678.7993915081024,571.6263108253479,2113.551326751709,29930,7236,22694,22694,0,22,7294000.0
7294,7294999,20.578730299508408,37.662878835634956,0.08279235118813866,2679.2516753673553,571.6958076953888,2113.9749717712402,29933,7237,22696,22696,0,22,7295000.0
7295,7295999,20.57857666813703,37.66298198026074,0.08277433663983336,2679.543855190277,571.7625403404236,2114.9732398986816,29934,7237,22697,22697,0,22,7296000.0
7296,7296999,20.578430588834923,37.66283357859579,0.08275958427692798,2680.0656473636627,571.8319473266602,2115.155559539795,29939,7239,22700,22700,0,22,7297000.0
7297,7297999,20.578424621474383,37.66209961530721,0.08274817392927658,2680.5320093631744,571.9003150463104,2115.430721282959,29939,7239,22700,22700,0,22,7298000.0
7298,7298999,20.57863915314661,37.6625609963916,0.08273766554167461,2681.14542388916,571.9717085361481,2115.8864784240723,29967,7242,22725,22725,0,22,7299000.0
7299,7299999,20.57876760393477,37.66216514676734,0.08272807872382626,2681.6687157154083,572.0437567234039,2116.537364959717,29982,7244,22738,22738,0,22,7300000.0
7300,7300999,20.578922151184738,37.661611378919865,0.08272361068516743,2682.0481765270233,572.1132967472076,2117.4477500915527,29982,7244,22738,22738,0,22,7301000.0
7301,7301999,20.579318493497272,37.66149395089079,0.08271720667247195,2682.5381133556366,572.1852669715881,2117.9628257751465,29983,7244,22739,22739,0,22,7302000.0
7302,7302999,20.57998330642292,37.66215585909875,0.0827109199420486,2682.9880294799805,572.2552144527435,2118.6463584899902,29983,7244,22739,22739,0,22,7303000.0
7303,7303999,20.580700025795167,37.66286480117345,0.08270337335056677,2683.6233854293823,572.3243472576141,2118.480213165283,29985,7245,22740,22740,0,22,7304000.0
7304,7304999,20.581469165163345,37.66299628091791,0.08270183518162744,2684.160229921341,572.3981199264526,2118.884754180908,29988,7246,22742,22742,0,22,7305000.0
7305,7305999,20.582271913748514,37.6636708487034,0.08270252081923335,2684.631603002548,572.4694881439209,2119.6301765441895,29999,7247,22752,22752,0,22,7306000.0
7306,7306999,20.583062990020494,37.66418539081521,0.08270282498595627,2685.2208247184753,572.5404517650604,2119.663387298584,30001,7248,22753,22753,0,22,7307000.0
7307,7307999,20.584024174948734,37.664891676486874,0.08270433694772661,2685.714492082596,572.6119887828827,2119.9102516174316,30001,7248,22753,22753,0,22,7308000.0
7308,7308999,20.585306670639742,37.665900248515335,0.0827213181915798,2686.222504377365,572.6829090118408,2120.2125816345215,30001,7248,22753,22753,0,22,7309000.0
7309,7309999,20.586354458266886,37.66636223896856,0.0827350117015383,2686.8212847709656,572.7553777694702,2120.2166786193848,30003,7249,22754,22754,0,22,7310000.0
7310,7310999,20.587753423675558,37.66834789552667,0.08274487330778879,2687.5597019195557,572.8259084224701,2119.4892539978027,30003,7249,22754,22754,0,22,7311000.0
7311,7311999,20.58901655640927,37.669519394598126,0.08275998327711442,2687.9233152866364,572.8966448307037,2120.4726524353027,30005,7250,22755,22755,0,22,7312000.0
7312,7312999,20.590713043206183,37.672148587363765,0.08277632441410199,2688.3497290611267,572.9667773246765,2121.1578636169434,30005,7250,22755,22755,0,22,7313000.0
7313,7313999,20.59187602990505,37.67317968128798,0.08278766214251021,2688.9933276176453,573.0368928909302,2120.875217437744,30007,7251,22756,22756,0,22,7314000.0
7314,7314999,20.59167841919522,37.672937795755224,0.08277408384401441,2689.3887841701508,573.1044147014618,2121.936290740967,30015,7253,22762,22762,0,22,7315000.0
7315,7315999,20.5912484924489,37.67215807792051,0.08276473460611233,2689.69038438797,573.1744296550751,2123.0330085754395,30018,7253,22765,22765,0,22,7316000.0
7316,7316999,20.590869917393913,37.671622293045345,0.08275181838570977,2690.1281390190125,573.2428374290466,2123.5665855407715,30022,7254,22768,22768,0,22,7317000.0
7317,7317999,20.590345494533306,37.67026935347983,0.082745671577095,2690.4369320869446,573.3108098506927,2124.5343894958496,30022,7254,22768,22768,0,22,7318000.0
7318,7318999,20.590181677224898,37.67033833448288,0.0827320884905115,2690.9687180519104,573.3788113594055,2124.4928855895996,30024,7255,22769,22769,0,22,7319000.0
7319,7319999,20.59008710747004,37.66955448936463,0.08272240530202801,2691.7258727550507,573.4483597278595,2123.8746223449707,30039,7258,22781,22781,0,22,7320000.0
7320,7320999,20.589740729747486,37.66859762036462,0.08271369129631956,2692.1681661605835,573.5164020061493,2124.2585945129395,30041,7259,22782,22782,0,22,7321000.0
7321,7321999,20.58949072066625,37.66782716019766,0.08270729191085624,2692.573561191559,573.5862784385681,2124.824520111084,30043,7260,22783,22783,0,22,7322000.0
7322,7322999,20.589622288759266,37.66774869994385,0.08269984520544937,2693.144275665283,573.6564836502075,2124.792713165283,30047,7262,22785,22785,0,22,7323000.0
7323,7323999,20.58976931209802,37.667543981689434,0.08268966805358247,2693.4688382148743,573.7281675338745,2125.5730171203613,30047,7262,22785,22785,0,22,7324000.0
7324,7324999,20.590166465983653,37.66879437461312,0.08268093427641432,2693.9809381961823,573.7987532615662,2125.665874481201,30049,7263,22786,22786,0,22,7325000.0
7325,7325999,20.590256943905143,37.67005160366117,0.08266410943602631,2694.5392014980316,573.8747668266296,2125.589496612549,30051,7264,22787,22787,0,22,7326000.0
7326,7326999,20.59054690309869,37.66991034324442,0.082659934054931,2695.0786848068237,573.9463346004486,2125.6530265808105,30053,7265,22788,22788,0,22,7327000.0
7327,7327999,20.591019581107087,37.672098877574,0.0826468545141551,2695.665378808975,574.0233798027039,2125.613178253174,30055,7266,22789,22789,0,22,7328000.0
7328,7328999,20.59140663071145,37.672112898804436,0.08264486275678018,2696.315978527069,574.0935068130493,2125.4726066589355,30065,7269,22796,22796,0,22,7329000.0
7329,7329999,20.591725384754366,37.67196003968166,0.08264281122650952,2696.733325481415,574.1629314422607,2126.0338859558105,30067,7270,22797,22797,0,22,7330000.0
7330,7330999,20.592393786234826,37.67336493590078,0.08263004851386302,2697.325752258301,574.2316293716431,2125.7428550720215,30069,7271,22798,22798,0,22,7331000.0
7331,7331999,20.593233295529007,37.674143135141996,0.08262302092157148,2698.076592683792,574.303670167923,2125.687786102295,30148,7275,22873,22873,0,22,7332000.0
7332,7332999,20.593825145316305,37.67417504610811,0.0826253684780246,2698.675605535507,574.3846611976624,2126.060070037842,30152,7277,22875,22875,0,22,7333000.0
7333,7333999,20.59438544522196,37.67394200285903,0.08262746129824727,2699.2448472976685,574.4584736824036,2126.4857597351074,30156,7279,22877,22877,0,22,7334000.0
7334,7334999,20.594772951983824,37.67430665750276,0.08261991452571638,2699.709803581238,574.5284819602966,2127.0812492370605,30164,7280,22884,22884,0,22,7335000.0
7335,7335999,20.59406942308259,37.67339702119707,0.08261692676980048,2700.070245742798,574.5941939353943,2127.5991020202637,30166,7280,22886,22886,0,22,7336000.0
7336,7336999,20.59374608859182,37.67484311234541,0.08260143800895892,2700.4514260292053,574.6610307693481,2128.1606254577637,30169,7280,22889,22889,0,22,7337000.0
7337,7337999,20.593664953049345,37.676156244393276,0.08258719211987131,2700.784211397171,574.7295668125153,2128.942165374756,30171,7280,22891,22891,0,22,7338000.0
7338,7338999,20.593705187449864,37.67735636127441,0.08257225697837889,2701.436116218567,574.8023686408997,2128.850528717041,30181,7282,22899,22899,0,22,7339000.0
7339,7339999,20.594101849397433,37.679641986601474,0.0825514389202533,2701.7446949481964,574.86856508255,2129.766040802002,30181,7282,22899,22899,0,22,7340000.0
7340,7340999,20.594244953836863,37.68023461808317,0.08254121129966918,2702.172481060028,574.9402804374695,2130.130962371826,30181,7282,22899,22899,0,22,7341000.0
7341,7341999,20.5942778528129,37.68033338864793,0.08253538624647139,2702.6156754493713,575.0042545795441,2130.6024208068848,30185,7284,22901,22901,0,22,7342000.0
7342,7342999,20.594462334663415,37.68091126242403,0.0825285173038699,2703.0302019119263,575.0711104869843,2131.1930503845215,30197,7285,22912,22912,0,22,7343000.0
7343,7343999,20.594893612753555,37.682044322526366,0.08252789182881137,2703.3736124038696,575.1364710330963,2131.8871116638184,30197,7285,22912,22912,0,22,7344000.0
7344,7344999,20.595307018435108,37.68303123300658,0.08252601923047975,2704.234787464142,575.2041466236115,2130.7725257873535,30203,7288,22915,22915,0,22,7345000.0
7345,7345999,20.595741158672993,37.68405259108177,0.08252880461876344,2704.6998693943024,575.2744100093842,2131.3722038269043,30205,7289,22916,22916,0,22,7346000.0
7346,7346999,20.59579971827792,37.68371939244135,0.0825304591300049,2705.320363998413,575.3431179523468,2131.2770805358887,30211,7292,22919,22919,0,22,7347000.0
7347,7347999,20.59632898644883,37.68475426091971,0.08254125664204959,2705.6164603233337,575.4091558456421,2132.2696418762207,30211,7292,22919,22919,0,22,7348000.0
7348,7348999,20.596942841284758,37.685769398263005,0.08253269309176925,2706.063319206238,575.4751615524292,2132.538829803467,30211,7292,22919,22919,0,22,7349000.0
7349,7349999,20.59715337231944,37.68577058954606,0.08253838849474049,2706.430680990219,575.5462555885315,2133.385066986084,30211,7292,22919,22919,0,22,7350000.0
7350,7350999,20.59776767733928,37.68668479026118,0.08253338396700483,2706.880278110504,575.6117289066315,2133.726573944092,30213,7293,22920,22920,0,22,7351000.0
7351,7351999,20.598449685301098,37.687095372056454,0.0825326317078795,2707.3762078285217,575.6795122623444,2133.91801071167,30215,7294,22921,22921,0,22,7352000.0
7352,7352999,20.599170320559672,37.687888053296824,0.08252866771977985,2708.1666221618652,575.7477266788483,2133.2863121032715,30221,7297,22924,22924,0,22,7353000.0
7353,7353999,20.59990983830625,37.688347725042526,0.08252713083190022,2708.4905939102173,575.8133566379547,2134.187900543213,30221,7297,22924,22924,0,22,7354000.0
7354,7354999,20.6006822559457,37.689308176343964,0.08252113003908979,2708.9232234954834,575.8799383640289,2134.8525428771973,30226,7298,22928,22928,0,22,7355000.0
7355,7355999,20.600268388210477,37.68902582357914,0.08251269953876894,2709.318122625351,575.9517538547516,2135.3977012634277,30227,7298,22929,22929,0,22,7356000.0
7356,7356999,20.600285608107853,37.68972431286571,0.08249905142439207,2709.49161696434,576.0179591178894,2136.8526649475098,30228,7298,22930,22930,0,22,7357000.0
7357,7357999,20.600375561046675,37.69007851807652,0.08248917422848356,2709.9208023548126,576.0861518383026,2137.3455924987793,30232,7299,22933,22933,0,22,7358000.0
7358,7358999,20.60043431032161,37.69055579583976,0.0824770403431283,2710.294553041458,576.1550805568695,2137.8608741760254,30232,7299,22933,22933,0,22,7359000.0
7359,7359999,20.60030897412758,37.69028265848274,0.08247105820432044,2710.7416632175446,576.2243359088898,2138.197986602783,30246,7301,22945,22945,0,22,7360000.0
7360,7360999,20.6010292889702,37.69537040257205,0.0824405117599788,2711.455843925476,576.2939128875732,2137.509044647217,30253,7304,22949,22949,0,22,7361000.0
7361,7361999,20.60152589985688,37.69590171545697,0.08245159165131188,2712.0010483264923,576.3706679344177,2137.784885406494,30267,7306,22961,22961,0,22,7362000.0
7362,7362999,20.601940067253192,37.69669279962466,0.08245924537864624,2712.353949546814,576.4395277500153,2138.441692352295,30269,7307,22962,22962,0,22,7363000.0
7363,7363999,20.602444223330107,37.696978704345774,0.08246741670679592,2712.8901841640472,576.5108029842377,2138.4723930358887,30273,7309,22964,22964,0,22,7364000.0
7364,7364999,20.603289439625776,37.69867248228089,0.08247847603996006,2713.4277255535126,576.5831472873688,2138.5942420959473,30279,7312,22967,22967,0,22,7365000.0
7365,7365999,20.603796169325268,37.698762602089396,0.08248461537505014,2713.8639295101166,576.6566457748413,2138.8041648864746,30279,7312,22967,22967,0,22,7366000.0
7366,7366999,20.604700847795666,37.70016951482218,0.08249331810919702,2714.3773572444916,576.7266888618469,2138.5396308898926,30279,7312,22967,22967,0,22,7367000.0
7367,7367999,20.605744371319577,37.701359922137414,0.08250226936110683,2714.9054038524628,576.7974936962128,2138.678928375244,30281,7313,22968,22968,0,22,7368000.0
7368,7368999,20.60671002883352,37.70209894708445,0.08250914242272578,2715.255693912506,576.8691513538361,2139.378314971924,30283,7314,22969,22969,0,22,7369000.0
7369,7369999,20.608254536654005,37.70445348134603,0.08252454573386103,2715.7226147651672,576.944760799408,2139.6229515075684,30285,7315,22970,22970,0,22,7370000.0
7370,7370999,20.609540155833674,37.705636129385226,0.08253594949474408,2716.4156069755554,577.0190272331238,2139.055187225342,30297,7316,22981,22981,0,22,7371000.0
7371,7371999,20.61045155206383,37.70620433049462,0.08255045523724336,2716.736445903778,577.0886261463165,2140.020092010498,30309,7317,22992,22992,0,22,7372000.0
7372,7372999,20.61091040800823,37.70644025629263,0.08254536107697164,2717.3311545848846,577.1577949523926,2139.907688140869,30316,7318,22998,22998,0,22,7373000.0
7373,7373999,20.611005001560514,37.70808525215455,0.08253414254376878,2717.8490443229675,577.2253963947296,2140.262439727783,30333,7321,23012,23012,0,22,7374000.0
7374,7374999,20.61097885421973,37.70737633063123,0.08252907105177953,2718.0579059123993,577.2896690368652,2141.4583702087402,30334,7321,23013,23013,0,22,7375000.0
7375,7375999,20.610997996033074,37.70712489327876,0.08252436152659137,2718.652381181717,577.3559303283691,2141.105670928955,30339,7323,23016,23016,0,22,7376000.0
7376,7376999,20.611188277787008,37.707356671181415,0.08251431160476441,2718.919374704361,577.4229698181152,2141.863124847412,30339,7323,23016,23016,0,22,7377000.0
7377,7377999,20.611658070523383,37.70908944727119,0.0825014229793124,2719.5674760341644,577.4886047840118,2141.3824882507324,30345,7326,23019,23019,0,22,7378000.0
7378,7378999,20.61207029474521,37.7093786157655,0.08249432214925512,2719.9954931735992,577.5586478710175,2141.906635284424,30347,7327,23020,23020,0,22,7379000.0
7379,7379999,20.612513664449065,37.7096954933697,0.08249083327090456,2720.5099527835846,577.6245923042297,2141.8204765319824,30349,7328,23021,23021,0,22,7380000.0
7380,7380999,20.613018674861593,37.71017998031089,0.0824862034849354,2721.0834414958954,577.6947276592255,2141.802967071533,30361,7330,23031,23031,0,22,7381000.0
7381,7381999,20.613848145166223,37.71242365045061,0.0824789989664414,2721.370304584503,577.763909816742,2142.5039863586426,30361,7330,23031,23031,0,22,7382000.0
7382,7382999,20.614422951342004,37.71282690053826,0.08247651585076443,2721.945310115814,577.8325560092926,2142.3919792175293,30367,7333,23034,23034,0,22,7383000.0
7383,7383999,20.61495850815699,37.71494537889513,0.08246901196752321,2722.3806035518646,577.8975441455841,2142.691921234131,30369,7334,23035,23035,0,22,7384000.0
7384,7384999,20.615654168104324,37.71526246233472,0.08246703968723379,2722.6721279621124,577.9644818305969,2143.4316749572754,30369,7334,23035,23035,0,22,7385000.0
7385,7385999,20.61634489871703,37.71553413909731,0.0824681958153255,2723.150458574295,578.0317194461823,2143.302257537842,30369,7334,23035,23035,0,22,7386000.0
7386,7386999,20.616861036813273,37.715496937681344,0.0824697765881931,2723.653033733368,578.100399017334,2143.2271156311035,30371,7335,23036,23036,0,22,7387000.0
7387,7387999,20.61761261908823,37.715731986908196,0.08247214005688686,2724.0396831035614,578.1688888072968,2143.5877723693848,30371,7335,23036,23036,0,22,7388000.0
7388,7388999,20.6183476800561,37.71778840422569,0.08246316864507941,2724.4126994609833,578.2354621887207,2144.025608062744,30371,7335,23036,23036,0,22,7389000.0
7389,7389999,20.619185822447236,37.71822849535578,0.0824663690891223,2724.9321813583374,578.3025941848755,2143.9171562194824,30383,7336,23047,23047,0,22,7390000.0
7390,7390999,20.619925941331108,37.718234579198956,0.08247136327878879,2725.4309248924255,578.3715660572052,2143.845401763916,30384,7337,23047,23047,0,22,7391000.0
7391,7391999,20.620215407578705,37.719010319510865,0.08246405925783795,2725.815979719162,578.4403676986694,2144.424213409424,30391,7337,23054,23054,0,22,7392000.0
7392,7392999,20.619880694840305,37.71916076811592,0.08245524460074272,2726.202540874481,578.5061383247375,2144.9066200256348,30394,7338,23056,23056,0,22,7393000.0
7393,7393999,20.61919971831011,37.7180264582596,0.08245269087286111,2726.630672931671,578.5724222660065,2145.323215484619,30398,7340,23058,23058,0,22,7394000.0
7394,7394999,20.618701000807974,37.71798997163902,0.08244802666235995,2727.0515534877777,578.6399161815643,2145.6010932922363,30410,7341,23069,23069,0,22,7395000.0
7395,7395999,20.618468646790102,37.717953235827764,0.0824393541148285,2727.4406445026398,578.7097916603088,2145.974994659424,30412,7342,23070,23070,0,22,7396000.0
7396,7396999,20.61814021838031,37.71724455907788,0.08243410531101758,2727.7148535251617,578.7758815288544,2146.6721153259277,30412,7342,23070,23070,0,22,7397000.0
7397,7397999,20.617830829551394,37.71626576195362,0.08243037629805705,2728.3985936641693,578.845009803772,2145.999034881592,30426,7345,23081,23081,0,22,7398000.0
7398,7398999,20.617627682969687,37.71547871607753,0.08242549985486203,2728.9238941669464,578.9148983955383,2145.7715950012207,30426,7345,23081,23081,0,22,7399000.0
7399,7399999,20.617496431286863,37.71498959681361,0.08242196421142833,2729.2896242141724,578.9823079109192,2146.314594268799,30429,7346,23083,23083,0,22,7400000.0
7400,7400999,20.617662774107146,37.71529689933107,0.08241307863449043,2729.6708385944366,579.0497281551361,2146.558650970459,30429,7346,23083,23083,0,22,7401000.0
7401,7401999,20.617999923586304,37.71575009426853,0.08241554972060172,2730.079081296921,579.1236748695374,2146.875820159912,30431,7347,23084,23084,0,22,7402000.0
7402,7402999,20.61831582601617,37.71655087760151,0.08241199383351505,2730.6336336135864,579.1936602592468,2146.569492340088,30433,7348,23085,23085,0,22,7403000.0
7403,7403999,20.618395633593597,37.71664971999009,0.08240780143655657,2731.2953057289124,579.2642660140991,2146.0040855407715,30437,7350,23087,23087,0,22,7404000.0
7404,7404999,20.619050523715252,37.71862245608972,0.08240663295005057,2731.566011428833,579.3329861164093,2146.817569732666,30437,7350,23087,23087,0,22,7405000.0
7405,7405999,20.61988056810447,37.72079936599599,0.0824008782609843,2732.037897825241,579.4038939476013,2146.891986846924,30441,7352,23089,23089,0,22,7406000.0
7406,7406999,20.62096640433443,37.72453662088099,0.08239222801204027,2732.4578654766083,579.472909450531,2146.991382598877,30441,7352,23089,23089,0,22,7407000.0
7407,7407999,20.622283942272723,37.7273802021828,0.08239007925275543,2733.0170860290527,579.5439643859863,2147.0211219787598,30508,7355,23153,23153,0,22,7408000.0
7408,7408999,20.623919612812895,37.73389592015234,0.0823726074750627,2733.5739421844482,579.6141440868378,2147.581081390381,30514,7358,23156,23156,0,22,7409000.0
7409,7409999,20.62484400608696,37.73594851365838,0.08237127616241668,2733.9905712604523,579.6828310489655,2148.371852874756,30528,7360,23168,23168,0,22,7410000.0
7410,7410999,20.625248927797458,37.73679364015415,0.08236858220406573,2734.4511518478394,579.7538878917694,2148.907741546631,30541,7362,23179,23179,0,22,7411000.0
7411,7411999,20.625016716606133,37.738033889455075,0.08235132545574786,2734.9401264190674,579.8182184696198,2149.3142738342285,30553,7364,23189,23189,0,22,7412000.0
7412,7412999,20.624144769985026,37.73670019833059,0.08235130766303222,2735.491887331009,579.8832285404205,2149.3114051818848,30557,7366,23191,23191,0,22,7413000.0
7413,7413999,20.62341323230148,37.73568115420775,0.08234919968092558,2735.8891723155975,579.9494445323944,2149.5144538879395,30557,7366,23191,23191,0,22,7414000.0
7414,7414999,20.622763213221965,37.73470669999553,0.08234468117849136,2736.1440947055817,580.0143783092499,2150.438449859619,30557,7366,23191,23191,0,22,7415000.0
7415,7415999,20.622408144336106,37.7353153004129,0.08233357888518855,2736.519165277481,580.0781457424164,2150.807300567627,30559,7367,23192,23192,0,22,7416000.0
7416,7416999,20.62198687832881,37.7343585217562,0.0823298669814323,2737.203447341919,580.1459753513336,2150.08988571167,30565,7370,23195,23195,0,22,7417000.0
7417,7417999,20.621768126563282,37.73387616645838,0.0823228223950665,2737.4950735569,580.2198710441589,2150.9430503845215,30566,7370,23196,23196,0,22,7418000.0
7418,7418999,20.621535717473687,37.73321435234139,0.08231594921232166,2737.894357442856,580.2826068401337,2151.0830574035645,30566,7370,23196,23196,0,22,7419000.0
7419,7419999,20.621382770014584,37.73267359213144,0.08230830325478389,2738.349944591522,580.3475625514984,2151.2607078552246,30568,7371,23197,23197,0,22,7420000.0
7420,7420999,20.621507001366794,37.732742432172095,0.08229981641093209,2738.821272134781,580.413202047348,2151.4106636047363,30572,7373,23199,23199,0,22,7421000.0
7421,7421999,20.62144809229067,37.732191847469736,0.08229429590380821,2739.2016043663025,580.4772787094116,2151.772205352783,30574,7374,23200,23200,0,22,7422000.0
7422,7422999,20.621733586360943,37.73239797684128,0.0822876342072626,2739.7507717609406,580.5420179367065,2151.8152351379395,30580,7377,23203,23203,0,22,7423000.0
7423,7423999,20.622244515022036,37.73462938145284,0.08227780142879615,2740.19211268425,580.6102011203766,2152.0300254821777,30582,7378,23204,23204,0,22,7424000.0
7424,7424999,20.62273010384492,37.734986215265174,0.08228194538798439,2740.7894377708435,580.6755828857422,2151.6165885925293,30586,7380,23206,23206,0,22,7425000.0
7425,7425999,20.622966973546234,37.73498550822428,0.08228675182396938,2741.2111208438873,580.7449858188629,2151.8401069641113,30586,7380,23206,23206,0,22,7426000.0
7426,7426999,20.62365421271877,37.73581654231776,0.08229679200534912,2741.684884786606,580.8111455440521,2151.9880561828613,30590,7382,23208,23208,0,22,7427000.0
7427,7427999,20.623896521657322,37.73570167356596,0.08231090000262775,2742.194643974304,580.8795025348663,2151.8794746398926,30592,7383,23209,23209,0,22,7428000.0
7428,7428999,20.624244753272468,37.736557186104044,0.08231527243732695,2742.686007499695,580.9452311992645,2152.113353729248,30608,7386,23222,23222,0,22,7429000.0
7429,7429999,20.62450406752882,37.73638148284292,0.08231612594209592,2743.237649679184,581.0116221904755,2152.0108680725098,30621,7388,23233,23233,0,22,7430000.0
7430,7430999,20.624473038243252,37.73636644659106,0.08229440962292767,2743.6065821647644,581.0825455188751,2152.757511138916,30626,7388,23238,23238,0,22,7431000.0
7431,7431999,20.623744300543112,37.73476205456579,0.08228429697767192,2743.861983537674,581.1496045589447,2153.7452354431152,30626,7388,23238,23238,0,22,7432000.0
7432,7432999,20.62329338749521,37.73553749854006,0.08226371152839496,2744.294942140579,581.2220368385315,2153.9490089416504,30628,7389,23239,23239,0,22,7433000.0
7433,7433999,20.62271103946786,37.734692905130956,0.08225480585854739,2744.776312351227,581.2883038520813,2154.237407684326,30639,7392,23247,23247,0,22,7434000.0
7434,7434999,20.622411931484297,37.73393394751669,0.08224403931347735,2745.5066010951996,581.3577904701233,2153.442714691162,30655,7395,23260,23260,0,22,7435000.0
7435,7435999,20.62189807496729,37.73256059242849,0.08224322774545945,2745.9455955028534,581.4246199131012,2153.6360664367676,30656,7396,23260,23260,0,22,7436000.0
7436,7436999,20.62132920823666,37.73118974996078,0.08223853771493983,2746.2588119506836,581.494589805603,2154.2285118103027,30656,7396,23260,23260,0,22,7437000.0
7437,7437999,20.620996344132116,37.73016084259777,0.08223215994319966,2746.511782169342,581.561906337738,2155.036533355713,30656,7396,23260,23260,0,22,7438000.0
7438,7438999,20.620705630885624,37.72924253225433,0.08222499322108634,2746.8690876960754,581.6284644603729,2155.320659637451,30656,7396,23260,23260,0,22,7439000.0
7439,7439999,20.620489819628787,37.728531146206805,0.08221503502519611,2747.1899683475494,581.6975972652435,2155.860668182373,30656,7396,23260,23260,0,22,7440000.0
7440,7440999,20.620018915547387,37.72710631114215,0.08221228818747806,2747.5835494995117,581.7726571559906,2156.0467262268066,30656,7396,23260,23260,0,22,7441000.0
7441,7441999,20.619661484552616,37.72601465476566,0.08220687427428697,2748.446198940277,581.8398025035858,2154.9357719421387,30671,7401,23270,23270,0,22,7442000.0
7442,7442999,20.619340862187375,37.725098009984634,0.08220497802071935,2748.851980447769,581.9081556797028,2155.0636100769043,30671,7401,23270,23270,0,22,7443000.0
7443,7443999,20.618902520058608,37.72370248076257,0.0822038495103774,2749.1518235206604,581.9764323234558,2155.811237335205,30671,7401,23270,23270,0,22,7444000.0
7444,7444999,20.618424956151173,37.72227930144865,0.08220690914279083,2749.4893164634705,582.0438601970673,2156.1107063293457,30671,7401,23270,23270,0,22,7445000.0
7445,7445999,20.617898183708856,37.720777995916094,0.08220601553456242,2750.0137622356415,582.1111710071564,2156.300754547119,30690,7404,23286,23286,0,22,7446000.0
7446,7446999,20.61751348909349,37.71945354002077,0.08220805635319761,2750.4024744033813,582.1783890724182,2156.679630279541,30692,7405,23287,23287,0,22,7447000.0
7447,7447999,20.616900102943593,37.71783152754775,0.08221017688311283,2750.8844723701477,582.2474839687347,2156.774990081787,30694,7406,23288,23288,0,22,7448000.0
7448,7448999,20.616269340593192,37.71640995521994,0.08221243619161644,2751.212506532669,582.3174433708191,2157.4161262512207,30696,7407,23289,23289,0,22,7449000.0
7449,7449999,20.61605273973643,37.71572464023741,0.08219634013300281,2751.841863155365,582.3877098560333,2157.3599128723145,30703,7409,23294,23294,0,22,7450000.0
7450,7450999,20.61630854522511,37.71512276125213,0.08215197609546976,2752.2666008472443,582.4605333805084,2157.8368186950684,30707,7410,23297,23297,0,22,7451000.0
7451,7451999,20.616108610622934,37.71425936230144,0.08213063793876207,2752.600931406021,582.530059337616,2158.7226524353027,30715,7411,23304,23304,0,22,7452000.0
7452,7452999,20.615830101758167,37.713488780330636,0.08211266666196704,2752.917439699173,582.6003539562225,2159.328540802002,30716,7411,23305,23305,0,22,7453000.0
7453,7453999,20.615498745098908,37.71239821475242,0.08209896882868939,2753.4939575195312,582.6769802570343,2159.626766204834,30765,7414,23351,23351,0,22,7454000.0
7454,7454999,20.615319135769845,37.711619603250604,0.08209016827994076,2753.7809777259827,582.7511477470398,2160.9308128356934,30768,7415,23353,23353,0,22,7455000.0
7455,7455999,20.615095920963245,37.710504372879335,0.0820809853124661,2754.0486056804657,582.8214387893677,2161.740390777588,30768,7415,23353,23353,0,22,7456000.0
7456,7456999,20.61487723421103,37.70982669739087,0.08207307875310543,2754.685203075409,582.8930015563965,2161.366199493408,30774,7418,23356,23356,0,22,7457000.0
7457,7457999,20.614749975846106,37.71002473448825,0.08205663878815983,2755.013449192047,582.9699456691742,2162.127628326416,30776,7419,23357,23357,0,22,7458000.0
7458,7458999,20.61459979221075,37.70978763858557,0.08205837975904384,2755.406987428665,583.0416560173035,2162.549175262451,30778,7420,23358,23358,0,22,7459000.0
7459,7459999,20.614323082932593,37.7087918552405,0.08205331831151075,2755.7812464237213,583.1132318973541,2162.928005218506,30780,7421,23359,23359,0,22,7460000.0
7460,7460999,20.614125579124856,37.70817110639223,0.08205206366341433,2756.2337787151337,583.1860227584839,2163.049877166748,30782,7422,23360,23360,0,22,7461000.0
7461,7461999,20.613859297061296,37.70731376623699,0.0820456872736911,2756.668076276779,583.259607553482,2163.184886932373,30784,7423,23361,23361,0,22,7462000.0
7462,7462999,20.61372222995808,37.70678175398863,0.08204871767851096,2757.0323667526245,583.3338820934296,2163.440731048584,30784,7423,23361,23361,0,22,7463000.0
7463,7463999,20.613708644806707,37.706200677615584,0.08205578768201072,2757.7643535137177,583.4073631763458,2162.851535797119,30792,7427,23365,23365,0,22,7464000.0
7464,7464999,20.613588260144947,37.70567494422778,0.08205704131290059,2758.0997087955475,583.4783277511597,2163.3318672180176,30792,7427,23365,23365,0,22,7465000.0
7465,7465999,20.613899993673616,37.705663056855585,0.08205068333826926,2758.4837172031403,583.5498657226562,2163.6359214782715,30795,7428,23367,23367,0,22,7466000.0
7466,7466999,20.61444549048014,37.706920137374205,0.0820385725745596,2759.1115276813507,583.6232116222382,2163.036235809326,30797,7429,23368,23368,0,22,7467000.0
7467,7467999,20.614712566900433,37.706849388249815,0.08203153040055022,2759.454094171524,583.6986603736877,2163.5805168151855,30797,7429,23368,23368,0,22,7468000.0
7468,7468999,20.614709562592406,37.70622124983556,0.08202368398041304,2759.8075046539307,583.7735607624054,2163.9638710021973,30797,7429,23368,23368,0,22,7469000.0
7469,7469999,20.614529492394777,37.705265581376466,0.08201622157833188,2760.130309343338,583.843480348587,2164.8972663879395,30802,7430,23372,23372,0,22,7470000.0
7470,7470999,20.61396248164574,37.70638598617762,0.08200477057584743,2760.4695749282837,583.9063544273376,2165.505542755127,30805,7431,23374,23374,0,22,7471000.0
7471,7471999,20.61316913637553,37.705228452862414,0.08200492783522706,2760.943588733673,583.9783108234406,2165.669017791748,30807,7432,23375,23375,0,22,7472000.0
7472,7472999,20.612709394653546,37.704146147839005,0.08200218909635948,2761.294169664383,584.0463960170746,2166.134075164795,30808,7432,23376,23376,0,22,7473000.0
7473,7473999,20.612502822393115,37.704330742486604,0.08199783639224656,2761.874573469162,584.1120824813843,2165.7802543640137,30814,7434,23380,23380,0,22,7474000.0
7474,7474999,20.612202382384595,37.70323707999192,0.0819980260271923,2762.2387351989746,584.1819400787354,2166.4186515808105,30816,7435,23381,23381,0,22,7475000.0
7475,7475999,20.611940708894167,37.702648992229335,0.08199819763928962,2762.4940252304077,584.2473587989807,2167.2458839416504,30817,7435,23382,23382,0,22,7476000.0
7476,7476999,20.61183825148164,37.70192826778048,0.08200262428500926,2762.837347984314,584.3133690357208,2167.7076988220215,30820,7436,23384,23384,0,22,7477000.0
7477,7477999,20.612021986516663,37.70235191438747,0.08201215738620582,2763.3283207416534,584.3790726661682,2167.3857917785645,30820,7436,23384,23384,0,22,7478000.0
7478,7478999,20.612084297645424,37.70197756709114,0.08202501647920435,2763.658390522003,584.4456906318665,2167.847141265869,30820,7436,23384,23384,0,22,7479000.0
7479,7479999,20.612296991358672,37.70185056930543,0.08204376296848681,2764.102398633957,584.5110392570496,2167.930034637451,30830,7437,23393,23393,0,22,7480000.0
7480,7480999,20.6124718711981,37.70177945770464,0.08205947944599123,2764.565325021744,584.5785841941833,2167.9597358703613,30832,7438,23394,23394,0,22,7481000.0
7481,7481999,20.612515565005076,37.70134326886743,0.08207478631141607,2765.0171914100647,584.6443514823914,2167.982105255127,30834,7439,23395,23395,0,22,7482000.0
7482,7482999,20.612643164579634,37.70119315755533,0.082081929588954,2765.326792240143,584.7125272750854,2168.459613800049,30834,7439,23395,23395,0,22,7483000.0
7483,7483999,20.612808746160237,37.70080536020655,0.08208929005054344,2766.0712580680847,584.7855567932129,2167.7428398132324,30845,7442,23403,23403,0,22,7484000.0
7484,7484999,20.613018388167237,37.7005789743786,0.08209792694932971,2766.3635149002075,584.8590724468231,2168.445644378662,30845,7442,23403,23403,0,22,7485000.0
7485,7485999,20.612985261017315,37.699837713644314,0.08210299221773809,2766.7642226219177,584.9261593818665,2168.7765769958496,30847,7443,23404,23404,0,22,7486000.0
7486,7486999,20.61335930260505,37.699940657386655,0.08209649763465976,2767.037176847458,584.9912822246552,2169.460590362549,30847,7443,23404,23404,0,22,7487000.0
7487,7487999,20.613398356507144,37.69911421077554,0.08209026316905355,2767.517014503479,585.0586950778961,2169.4910011291504,30849,7444,23405,23405,0,22,7488000.0
7488,7488999,20.613338280909307,37.6983019760777,0.08208014665379548,2768.055016040802,585.1261825561523,2169.2672843933105,30853,7446,23407,23407,0,22,7489000.0
7489,7489999,20.613146264227403,37.69725887111666,0.08207535553966783,2768.615500688553,585.1945858001709,2169.4175453186035,30859,7449,23410,23410,0,22,7490000.0
7490,7490999,20.612468555852967,37.695670356724996,0.0820803127395976,2769.0084776878357,585.2659130096436,2170.1429710388184,30868,7450,23418,23418,0,22,7491000.0
7491,7491999,20.61168971623812,37.69390868379711,0.08209049918143962,2769.3188815116882,585.3348417282104,2170.8306846618652,30868,7450,23418,23418,0,22,7492000.0
7492,7492999,20.610944837373477,37.69271196713637,0.08209744834730226,2769.6839611530304,585.402529001236,2171.3270225524902,30870,7451,23419,23419,0,22,7493000.0
7493,7493999,20.610018741268714,37.69103733947315,0.08210664850597593,2770.3921167850494,585.4785192012787,2170.7263374328613,30891,7454,23437,23437,0,22,7494000.0
7494,7494999,20.609092319250436,37.68953617063134,0.08211205328415339,2770.659984111786,585.549727678299,2171.85445022583,30893,7454,23439,23439,0,22,7495000.0
7495,7495999,20.607969301972368,37.687647593610066,0.08212519394520978,2770.9169104099274,585.6181960105896,2172.7615089416504,30893,7454,23439,23439,0,22,7496000.0
7496,7496999,20.60699237234521,37.68590923572169,0.08213774597408152,2771.2731037139893,585.6892945766449,2173.34224319458,30895,7455,23440,23440,0,22,7497000.0
7497,7497999,20.606044227234527,37.684384981189176,0.0821487821055994,2771.541894674301,585.7587745189667,2174.023708343506,30895,7455,23440,23440,0,22,7498000.0
7498,7498999,20.605018785404653,37.6825974721652,0.0821611441424337,2771.991396188736,585.8286430835724,2174.097339630127,30897,7456,23441,23441,0,22,7499000.0
7499,7499999,20.60409437496228,37.68092360112673,0.08217531322395799,2772.3507709503174,585.8993635177612,2174.3423194885254,30897,7456,23441,23441,0,22,7500000.0
7500,7500999,20.60305847485948,37.67926688961929,0.0821902468319452,2772.701080799103,585.9700934886932,2174.6570625305176,30897,7456,23441,23441,0,22,7501000.0
7501,7501999,20.602293711431148,37.677906123562906,0.08220392400681553,2773.0596899986267,586.0394325256348,2174.890277862549,30897,7456,23441,23441,0,22,7502000.0
7502,7502999,20.601498035734085,37.677083911258364,0.08222009625459814,2773.464634656906,586.1128919124603,2175.0064735412598,30897,7456,23441,23441,0,22,7503000.0
7503,7503999,20.60078435817107,37.67660013100289,0.0822304424326159,2774.05046582222,586.1925292015076,2174.5081825256348,30897,7456,23441,23441,0,22,7504000.0
7504,7504999,20.59983174414627,37.674813791384686,0.082246774472584,2774.3202755451202,586.2644929885864,2175.2077445983887,30897,7456,23441,23441,0,22,7505000.0
7505,7505999,20.59908093563062,37.67386392749618,0.08225690761915105,2774.7769775390625,586.3338632583618,2175.612247467041,30906,7457,23449,23449,0,22,7506000.0
7506,7506999,20.598627317502903,37.67365052513769,0.0822584936246562,2775.056188106537,586.4060845375061,2176.6221504211426,30907,7457,23450,23450,0,22,7507000.0
7507,7507999,20.59792079822761,37.67208339411016,0.08226575645298495,2775.466879606247,586.4757692813873,2177.176280975342,30914,7459,23455,23455,0,22,7508000.0
7508,7508999,20.597231837895738,37.670804854159414,0.08227190147956809,2776.016173839569,586.542462348938,2177.131290435791,30920,7462,23458,23458,0,22,7509000.0
7509,7509999,20.596448414129366,37.669503823928174,0.08228121866579352,2776.289056777954,586.6085975170135,2177.913341522217,30920,7462,23458,23458,0,22,7510000.0
7510,7510999,20.595733115277902,37.66797011006478,0.08228159858206663,2776.930485725403,586.6764841079712,2177.2613105773926,30924,7464,23460,23460,0,22,7511000.0
7511,7511999,20.59488467758125,37.6662763815575,0.08228201923341127,2777.3642106056213,586.7436065673828,2177.6662101745605,30928,7466,23462,23462,0,22,7512000.0
7512,7512999,20.5943466844455,37.66511877273064,0.08227795160255946,2777.8294110298157,586.8097851276398,2177.8520851135254,30940,7468,23472,23472,0,22,7513000.0
7513,7513999,20.594013030203932,37.66444518831565,0.08227070232776412,2778.225144147873,586.877788066864,2178.1271629333496,30940,7468,23472,23472,0,22,7514000.0
7514,7514999,20.593502773411608,37.66326152371122,0.0822641229493507,2778.530498981476,586.9441883563995,2178.600269317627,30940,7468,23472,23472,0,22,7515000.0
7515,7515999,20.59313253774872,37.662288486044616,0.08225548081857526,2778.8448009490967,587.0115497112274,2179.049243927002,30940,7468,23472,23472,0,22,7516000.0
7516,7516999,20.5925915252045,37.661183387458564,0.08224955346735274,2779.3845529556274,587.0810480117798,2178.6539192199707,30942,7469,23473,23473,0,22,7517000.0
7517,7517999,20.59230487986602,37.66023275815975,0.0822431803344742,2779.793194770813,587.1487410068512,2178.7867164611816,30942,7469,23473,23473,0,22,7518000.0
7518,7518999,20.59198060768442,37.65919311475173,0.08223595136019568,2780.3211846351624,587.2167847156525,2178.2907371520996,30942,7469,23473,23473,0,22,7519000.0
7519,7519999,20.59182516361591,37.65924335389996,0.08222696529930507,2780.7952308654785,587.2852520942688,2178.263256072998,30958,7470,23488,23488,0,22,7520000.0
7520,7520999,20.591669420925633,37.65841396185223,0.0822187346622325,2781.0259597301483,587.3532192707062,2179.3286094665527,30958,7470,23488,23488,0,22,7521000.0
7521,7521999,20.591379098811533,37.657501562640086,0.08221025077407174,2781.3939197063446,587.4216089248657,2179.660083770752,30958,7470,23488,23488,0,22,7522000.0
7522,7522999,20.591113424517143,37.65630415022743,0.08220287111656743,2781.567483186722,587.4860372543335,2180.782901763916,30958,7470,23488,23488,0,22,7523000.0
7523,7523999,20.590646618047643,37.65495746176428,0.08219963630299787,2781.8734877109528,587.5538971424103,2181.2764320373535,30958,7470,23488,23488,0,22,7524000.0
7524,7524999,20.59026140636478,37.65436865964349,0.08219324379497639,2782.1300530433655,587.6215484142303,2182.2986640930176,30961,7470,23491,23491,0,22,7525000.0
7525,7525999,20.58974474022702,37.65361894127709,0.08218772637686944,2782.621136903763,587.6910936832428,2182.2626609802246,30966,7472,23494,23494,0,22,7526000.0
7526,7526999,20.589134365019333,37.65279042694278,0.08218407644015802,2783.085507631302,587.7647912502289,2182.2349891662598,30967,7472,23495,23495,0,22,7527000.0
7527,7527999,20.588418883272432,37.65123826560029,0.08218662716102831,2783.448551416397,587.8370838165283,2182.6446418762207,30969,7472,23497,23497,0,22,7528000.0
7528,7528999,20.58797866162991,37.65021615476001,0.0821838016205908,2783.860535144806,587.9063057899475,2182.7508277893066,30969,7472,23497,23497,0,22,7529000.0
7529,7529999,20.587484009019768,37.64894184487126,0.08218399502839835,2784.1947627067566,587.9809951782227,2183.2727088928223,30969,7472,23497,23497,0,22,7530000.0
7530,7530999,20.58676764329397,37.6472813818275,0.08218350491442383,2784.6072585582733,588.0520935058594,2183.410633087158,30970,7473,23497,23497,0,22,7531000.0
7531,7531999,20.586111491510742,37.64586940401756,0.08218688773937777,2785.0887010097504,588.1275753974915,2183.550136566162,30973,7475,23498,23498,0,22,7532000.0
7532,7532999,20.585293389697327,37.6443474113843,0.08219165355807323,2785.485469341278,588.1980223655701,2183.8978843688965,30975,7476,23499,23499,0,22,7533000.0
7533,7533999,20.584788298389142,37.64315336601205,0.08218880129585349,2785.944126367569,588.2693607807159,2183.9348793029785,30977,7477,23500,23500,0,22,7534000.0
7534,7534999,20.584225118038432,37.6419592938742,0.08218811794379532,2786.364815235138,588.3420441150665,2183.9402198791504,30977,7477,23500,23500,0,22,7535000.0
7535,7535999,20.583839863881398,37.641047420837076,0.0821854501421474,2786.782699108124,588.4162225723267,2183.890079498291,30977,7477,23500,23500,0,22,7536000.0
7536,7536999,20.583694693073774,37.641848658971774,0.08217373619071144,2787.183563232422,588.4867494106293,2184.0780448913574,30978,7478,23500,23500,0,22,7537000.0
7537,7537999,20.583614436374194,37.64155038339644,0.0821661885062146,2787.604380607605,588.5602045059204,2184.3707313537598,30981,7480,23501,23501,0,22,7538000.0
7538,7538999,20.583599613638885,37.6407285699494,0.08216212454400862,2788.229296684265,588.6396489143372,2183.8902015686035,30995,7482,23513,23513,0,22,7539000.0
7539,7539999,20.58372857039301,37.640203168849226,0.0821569360632658,2788.7665753364563,588.7104816436768,2183.7401008605957,31008,7484,23524,23524,0,22,7540000.0
7540,7540999,20.584111476082686,37.64012405825736,0.08214884569913194,2789.2713298797607,588.7849841117859,2183.4291954040527,31008,7484,23524,23524,0,22,7541000.0
7541,7541999,20.58405486390153,37.63947309712551,0.0821499978265342,2789.6888723373413,588.8650503158569,2183.636386871338,31010,7485,23525,23525,0,22,7542000.0
7542,7542999,20.583866255315073,37.6385019017362,0.08214939753473882,2790.0360181331635,588.9391510486603,2184.149402618408,31011,7486,23525,23525,0,22,7543000.0
7543,7543999,20.583655123532424,37.637428849452434,0.08214056367297995,2790.4267535209656,589.007497549057,2184.6716499328613,31013,7486,23527,23527,0,22,7544000.0
7544,7544999,20.58399074124255,37.63888232508448,0.08211636503611797,2790.816093444824,589.070454120636,2185.3163871765137,31015,7487,23528,23528,0,22,7545000.0
7545,7545999,20.58404753807143,37.63823044006553,0.08210006865372721,2791.0305602550507,589.1341125965118,2186.305332183838,31018,7487,23531,23531,0,22,7546000.0
7546,7546999,20.584187613836967,37.638362581564174,0.08208391105331803,2791.42914891243,589.2003729343414,2186.800121307373,31023,7489,23534,23534,0,22,7547000.0
7547,7547999,20.584103148134673,37.637438459261524,0.08207276811438202,2792.1021881103516,589.2659080028534,2186.3032188415527,31031,7493,23538,23538,0,22,7548000.0
7548,7548999,20.583985829717665,37.63681996908276,0.08206401446973166,2792.6108503341675,589.3326025009155,2186.4051933288574,31037,7496,23541,23541,0,22,7549000.0
7549,7549999,20.583950968403578,37.636039155422914,0.08205588153039656,2792.9916219711304,589.3968813419342,2186.6702919006348,31037,7496,23541,23541,0,22,7550000.0
7550,7550999,20.583863231004376,37.635676463278074,0.08205092623450139,2793.337333917618,589.462893486023,2187.081241607666,31037,7496,23541,23541,0,22,7551000.0
7551,7551999,20.583701301592498,37.634670737405585,0.08205097809891715,2793.6785340309143,589.5289943218231,2187.6337928771973,31039,7497,23542,23542,0,22,7552000.0
7552,7552999,20.583731542416757,37.63426584194728,0.08204050598117552,2793.939297914505,589.5939140319824,2188.234157562256,31039,7497,23542,23542,0,22,7553000.0
7553,7553999,20.583671653024435,37.63333487531641,0.08203349516555591,2794.4104330539703,589.6599633693695,2188.1647987365723,31041,7498,23543,23543,0,22,7554000.0
7554,7554999,20.583647547592964,37.63257304875466,0.08202322041589838,2794.7826030254364,589.7270019054413,2188.436794281006,31041,7498,23543,23543,0,22,7555000.0
7555,7555999,20.58336337207995,37.63130823847583,0.08201724423306511,2806.1903779506683,589.7919895648956,2188.1405448913574,31045,7500,23545,23545,0,22,7556000.0
7556,7556999,20.583168474771057,37.63047701297136,0.08200960528956958,2806.5938827991486,589.8577873706818,2188.41304397583,31047,7501,23546,23546,0,22,7557000.0
7557,7557999,20.582895711143117,37.629346261858004,0.08200608676842336,2806.9192836284637,589.9243280887604,2188.7620124816895,31047,7501,23546,23546,0,22,7558000.0
7558,7558999,20.582471528152645,37.62787259548231,0.08200245388319982,2807.421275615692,589.9932370185852,2188.594944000244,31049,7502,23547,23547,0,22,7559000.0
7559,7559999,20.582272106360225,37.62694081519493,0.08199646879096412,2807.717075109482,590.060046672821,2189.1506538391113,31049,7502,23547,23547,0,22,7560000.0
7560,7560999,20.58176145450429,37.62544224699118,0.08199507970528586,2808.0967106819153,590.1257636547089,2189.2039375305176,31049,7502,23547,23547,0,22,7561000.0
7561,7561999,20.58120600416302,37.62386517933231,0.08199490380195562,2808.3965623378754,590.1893072128296,2189.6006050109863,31049,7502,23547,23547,0,22,7562000.0
7562,7562999,20.580776485809462,37.62256208442931,0.08198977370954585,2808.9219102859497,590.2565503120422,2189.781726837158,31057,7504,23553,23553,0,22,7563000.0
7563,7563999,20.580945356532144,37.62252552195599,0.08194214352321583,2809.3213934898376,590.3309869766235,2190.0833625793457,31060,7505,23555,23555,0,22,7564000.0
7564,7564999,20.580542222318332,37.62168859566292,0.08192168970524416,2809.695050239563,590.3988585472107,2190.482654571533,31062,7506,23556,23556,0,22,7565000.0
7565,7565999,20.580187824006074,37.62056534270756,0.08190576169913655,2810.3002367019653,590.4659199714661,2190.2461128234863,31080,7509,23571,23571,0,22,7566000.0
7566,7566999,20.579579560383817,37.61920208345362,0.08190044260698126,2810.7789747714996,590.5346426963806,2190.2311210632324,31084,7511,23573,23573,0,22,7567000.0
7567,7567999,20.57902695372286,37.61794617682103,0.08189169662176699,2811.281217813492,590.6090259552002,2190.074390411377,31086,7512,23574,23574,0,22,7568000.0
7568,7568999,20.578214266046015,37.61634122709879,0.08188854922893674,2811.565901517868,590.6786789894104,2190.64847946167,31086,7512,23574,23574,0,22,7569000.0
7569,7569999,20.577466072116184,37.61508046093699,0.08188422890887492,2811.9811532497406,590.7507903575897,2190.696880340576,31086,7512,23574,23574,0,22,7570000.0
7570,7570999,20.5767712338083,37.614181245014585,0.08186895427047847,2812.429569005966,590.8172924518585,2190.653736114502,31088,7513,23575,23575,0,22,7571000.0
7571,7571999,20.576119980523963,37.61297556717597,0.08184487230456938,2812.6743524074554,590.8838474750519,2191.3587684631348,31088,7513,23575,23575,0,22,7572000.0
7572,7572999,20.5758411657947,37.612503870575914,0.08180786844080323,2813.0621869564056,590.9486079216003,2191.4726371765137,31089,7514,23575,23575,0,22,7573000.0
7573,7573999,20.575203965768203,37.61140720756565,0.08178346068955589,2813.6769168376923,591.0173225402832,2191.040050506592,31094,7517,23577,23577,0,22,7574000.0
7574,7574999,20.57464273668255,37.61060820579956,0.08176126868505629,2814.184506416321,591.093747138977,2190.9732933044434,31096,7518,23578,23578,0,22,7575000.0
7575,7575999,20.57425719571485,37.60956728477795,0.08175163889362436,2814.5883128643036,591.1664292812347,2191.0732765197754,31096,7518,23578,23578,0,22,7576000.0
7576,7576999,20.574250681380175,37.6105519420896,0.08174544254336424,2814.8416907787323,591.2349927425385,2191.7341957092285,31096,7518,23578,23578,0,22,7577000.0
7577,7577999,20.574889660792483,37.61232893090496,0.08174184567348164,2815.2532107830048,591.301805973053,2191.6952476501465,31096,7518,23578,23578,0,22,7578000.0
7578,7578999,20.575464004272963,37.615085184043956,0.08173097062158252,2815.5292479991913,591.3737952709198,2192.3101921081543,31096,7518,23578,23578,0,22,7579000.0
7579,7579999,20.57626801309378,37.62099546178492,0.08172417294516976,2816.014896631241,591.441000699997,2191.9377403259277,31098,7519,23579,23579,0,22,7580000.0
7580,7580999,20.576511894989732,37.622308344410705,0.0817224140011591,2816.4402470588684,591.5127685070038,2191.828556060791,31098,7519,23579,23579,0,22,7581000.0
7581,7581999,20.57681749727969,37.62398983939673,0.08171287020320894,2816.8796389102936,591.5813512802124,2192.1884117126465,31100,7520,23580,23580,0,22,7582000.0
7582,7582999,20.576138614285053,37.62268663547593,0.0817141351562265,2817.195554971695,591.6461932659149,2192.9781608581543,31102,7520,23582,23582,0,22,7583000.0
7583,7583999,20.575774246743833,37.62238848476799,0.08170989667613837,2817.492524623871,591.713296175003,2193.746868133545,31102,7520,23582,23582,0,22,7584000.0
7584,7584999,20.575518697513576,37.622035558340386,0.08170402106843988,2817.930318593979,591.7803685665131,2194.051860809326,31107,7521,23586,23586,0,22,7585000.0
7585,7585999,20.57519157036463,37.6214321071217,0.08169863508418007,2818.350485563278,591.8489735126495,2194.319606781006,31110,7522,23588,23588,0,22,7586000.0
7586,7586999,20.574963600455334,37.620415013618,0.08169468862416773,2818.943215608597,591.9179029464722,2193.7581520080566,31112,7523,23589,23589,0,22,7587000.0
7587,7587999,20.574882281094464,37.61993681032822,0.08168617189023164,2819.2983503341675,591.9846284389496,2194.1394081115723,31112,7523,23589,23589,0,22,7588000.0
7588,7588999,20.57498716574043,37.6197895991194,0.08167857037637971,2819.670746088028,592.056946516037,2194.610294342041,31114,7524,23590,23590,0,22,7589000.0
7589,7589999,20.575407042950197,37.62030022934815,0.0816718274260122,2819.8529119491577,592.1268301010132,2195.659824371338,31115,7524,23591,23591,0,22,7590000.0
7590,7590999,20.576352646676195,37.62218901300167,0.08166317475303131,2820.2856090068817,592.1973946094513,2195.742603302002,31117,7525,23592,23592,0,22,7591000.0
7591,7591999,20.577369450767367,37.62400888236496,0.0816630943080009,2820.7423620224,592.2669689655304,2195.7662773132324,31119,7526,23593,23593,0,22,7592000.0
7592,7592999,20.578354113176676,37.62585746604645,0.0816685081803099,2821.1478877067566,592.3359043598175,2196.1158485412598,31123,7528,23595,23595,0,22,7593000.0
7593,7593999,20.57977712039921,37.62846872780175,0.08166729864266375,2821.6795024871826,592.4064137935638,2195.813091278076,31125,7529,23596,23596,0,22,7594000.0
7594,7594999,20.58133914876012,37.63135080226756,0.08167529552279262,2822.2656915187836,592.4768891334534,2195.6231727600098,31131,7532,23599,23599,0,22,7595000.0
7595,7595999,20.583253284141456,37.63513794975447,0.08170073231174768,2822.669353246689,592.5460469722748,2196.1043968200684,31133,7533,23600,23600,0,22,7596000.0
7596,7596999,20.585275222209667,37.639059394758604,0.0817230507322283,2823.08193898201,592.6197671890259,2196.4086418151855,31135,7534,23601,23601,0,22,7597000.0
7597,7597999,20.586931408531214,37.641533494119656,0.0817495867795448,2823.5576848983765,592.6900570392609,2196.5399055480957,31149,7536,23613,23613,0,22,7598000.0
7598,7598999,20.588410249681743,37.64360305563663,0.08176779882347684,2824.038855791092,592.7616255283356,2196.235134124756,31149,7536,23613,23613,0,22,7599000.0
7599,7599999,20.590264875291336,37.64600782434018,0.08178634878191426,2824.3411734104156,592.8335781097412,2196.7914695739746,31149,7536,23613,23613,0,22,7600000.0
7600,7600999,20.59146834452276,37.64743590060975,0.08178410995581031,2824.793904542923,592.9042947292328,2196.9274101257324,31153,7538,23615,23615,0,22,7601000.0
7601,7601999,20.591539529242002,37.648040589198665,0.08175645669048948,2825.229394674301,592.9706976413727,2197.2292442321777,31156,7539,23617,23617,0,22,7602000.0
7602,7602999,20.59121819286297,37.64730953364062,0.08173816434676284,2825.548709154129,593.0341501235962,2197.896099090576,31156,7539,23617,23617,0,22,7603000.0
7603,7603999,20.591032561563956,37.64641309852815,0.08172438669522664,2825.8470754623413,593.1012876033783,2198.492862701416,31156,7539,23617,23617,0,22,7604000.0
7604,7604999,20.591008464249903,37.64649820292119,0.08170675774979075,2826.29859995842,593.1661705970764,2198.644229888916,31158,7540,23618,23618,0,22,7605000.0
7605,7605999,20.590809472600224,37.64563080768955,0.08169198536006483,2826.8570833206177,593.2320561408997,2198.52925491333,31163,7542,23621,23621,0,22,7606000.0
7606,7606999,20.590498614909546,37.644426774179074,0.08167947238333295,2827.2648844718933,593.2992076873779,2198.8659172058105,31165,7543,23622,23622,0,22,7607000.0
7607,7607999,20.590071273187043,37.643117625345894,0.08167016655390735,2827.513256788254,593.3637812137604,2199.702365875244,31165,7543,23622,23622,0,22,7608000.0
7608,7608999,20.589894418132676,37.64248906665285,0.08165405598095699,2827.898900747299,593.4289705753326,2199.922306060791,31167,7544,23623,23623,0,22,7609000.0
7609,7609999,20.589680863439455,37.641467494625914,0.08164147550199452,2828.153358221054,593.4934129714966,2200.6682929992676,31167,7544,23623,23623,0,22,7610000.0
7610,7610999,20.589265803225615,37.64031484583021,0.08163477286346987,2828.5942244529724,593.5614728927612,2200.5420417785645,31167,7544,23623,23623,0,22,7611000.0
7611,7611999,20.588973823595808,37.63922324299872,0.08162400474109477,2828.9092724323273,593.6295354366302,2201.0555152893066,31168,7544,23624,23624,0,22,7612000.0
7612,7612999,20.588728601204277,37.6384363984485,0.08161744525180104,2829.318815469742,593.6969361305237,2201.0752754211426,31168,7544,23624,23624,0,22,7613000.0
7613,7613999,20.588624362946717,37.63769305725759,0.08160778013650594,2829.9144592285156,593.7675786018372,2200.8886375427246,31172,7546,23626,23626,0,22,7614000.0
7614,7614999,20.58857422280848,37.63701936934346,0.08159769837243502,2830.3901059627533,593.8370018005371,2201.010227203369,31176,7548,23628,23628,0,22,7615000.0
7615,7615999,20.588678406867494,37.6364275756202,0.081588986527517,2830.7611775398254,593.9083461761475,2201.313091278076,31176,7548,23628,23628,0,22,7616000.0
7616,7616999,20.58888343219706,37.63595014066461,0.08158386804914597,2831.038025379181,593.97713804245,2202.0167350769043,31176,7548,23628,23628,0,22,7617000.0
7617,7617999,20.58948043521611,37.63622829880788,0.08157266951532005,2831.441824197769,594.0441443920135,2202.1666831970215,31178,7549,23629,23629,0,22,7618000.0
7618,7618999,20.590019288243052,37.63720123204369,0.08155558670521379,2831.8910410404205,594.1096584796906,2202.147304534912,31180,7550,23630,23630,0,22,7619000.0
7619,7619999,20.590597684314307,37.63722880031895,0.08154438369076378,2832.2900614738464,594.1756238937378,2202.2496910095215,31180,7550,23630,23630,0,22,7620000.0
7620,7620999,20.590721922507893,37.63640881427578,0.08153724236528814,2832.7126982212067,594.2439649105072,2202.510799407959,31182,7551,23631,23631,0,22,7621000.0
7621,7621999,20.59037816706007,37.6356086846869,0.08152532658894185,2833.2216424942017,594.3086194992065,2202.6357765197754,31188,7553,23635,23635,0,22,7622000.0
7622,7622999,20.5899534871024,37.63525449610909,0.08151252224541072,2833.6756455898285,594.3776183128357,2202.9375953674316,31193,7555,23638,23638,0,22,7623000.0
7623,7623999,20.58945722759291,37.633958974581375,0.08150879401702371,2834.077865123749,594.4486014842987,2203.3591957092285,31196,7555,23641,23641,0,22,7624000.0
7624,7624999,20.58922455970422,37.63364472553335,0.08150083022875965,2834.567556142807,594.5178093910217,2203.68705368042,31224,7557,23667,23667,0,22,7625000.0
7625,7625999,20.588859776993115,37.633255127825436,0.0814944943264424,2834.961928844452,594.587726354599,2203.9444694519043,31224,7557,23667,23667,0,22,7626000.0
7626,7626999,20.588609588767397,37.63268206805045,0.08148523778689198,2835.315614461899,594.6554551124573,2204.409008026123,31225,7557,23668,23668,0,22,7627000.0
7627,7627999,20.588382382195412,37.631862151118604,0.08147740032683382,2835.687750339508,594.7248156070709,2204.7337379455566,31226,7557,23669,23669,0,22,7628000.0
7628,7628999,20.58847604049037,37.63183847019009,0.08146958919009883,2836.2526638507843,594.7944054603577,2204.345447540283,31229,7559,23670,23670,0,22,7629000.0
7629,7629999,20.588520129423745,37.63148451320769,0.08146513663299881,2836.6072380542755,594.8652703762054,2204.8340034484863,31230,7560,23670,23670,0,22,7630000.0
7630,7630999,20.58898429617469,37.63203203025826,0.08146091943939615,2837.0152299404144,594.9369723796844,2204.9253730773926,31230,7560,23670,23670,0,22,7631000.0
7631,7631999,20.589364486388316,37.63206115023518,0.08145852026051437,2837.322825193405,595.0044777393341,2205.361240386963,31230,7560,23670,23670,0,22,7632000.0
7632,7632999,20.590185056710276,37.6333977919273,0.08145687425739934,2837.69317483902,595.0759902000427,2205.640895843506,31230,7560,23670,23670,0,22,7633000.0
7633,7633999,20.59085001751097,37.63414763874034,0.08145106437153693,2838.258663415909,595.147274017334,2205.2879371643066,31234,7562,23672,23672,0,22,7634000.0
7634,7634999,20.591422468291174,37.63473567751947,0.08146389617583216,2838.6176810264587,595.2184154987335,2206.0395317077637,31250,7563,23687,23687,0,22,7635000.0
7635,7635999,20.591810560103955,37.63490153036926,0.08147090362840093,2838.929311990738,595.2905600070953,2206.966022491455,31252,7564,23688,23688,0,22,7636000.0
7636,7636999,20.592329646836884,37.63527644120853,0.08146734858722249,2839.2522575855255,595.3607070446014,2207.878406524658,31256,7564,23692,23692,0,22,7637000.0
7637,7637999,20.592027136784466,37.6356068478083,0.0814586322271057,2839.4526314735413,595.4269886016846,2209.25736618042,31258,7564,23694,23694,0,22,7638000.0
7638,7638999,20.591860635236852,37.63569997969662,0.08145016119356818,2839.883576631546,595.4932065010071,2209.774471282959,31263,7566,23697,23697,0,22,7639000.0
7639,7639999,20.59144165566089,37.63579872712471,0.0814441213818492,2840.0942471027374,595.5583353042603,2210.80619430542,31264,7566,23698,23698,0,22,7640000.0
7640,7640999,20.590850250802802,37.63443230872654,0.08144366540116921,2840.8041253089905,595.62459897995,2210.179340362549,31272,7570,23702,23702,0,22,7641000.0
7641,7641999,20.590319634274667,37.633319034582556,0.08144371926952709,2841.121740579605,595.6985256671906,2210.834461212158,31272,7570,23702,23702,0,22,7642000.0
7642,7642999,20.58974907421025,37.632018603784346,0.08144293998666452,2841.504886865616,595.7647807598114,2211.1732749938965,31279,7571,23708,23708,0,22,7643000.0
7643,7643999,20.589218856057265,37.63066844915682,0.08144254414262408,2841.948288679123,595.8312048912048,2211.369701385498,31284,7573,23711,23711,0,22,7644000.0
7644,7644999,20.588826915153142,37.629763713680816,0.08143997891421983,2842.5602476596832,595.8973603248596,2210.6730155944824,31288,7575,23713,23713,0,22,7645000.0
7645,7645999,20.588161785350884,37.628289677599334,0.0814418225469794,2842.764749288559,595.9635224342346,2211.6733360290527,31288,7575,23713,23713,0,22,7646000.0
7646,7646999,20.587722057431733,37.627591968081575,0.0814388276489234,2843.1897604465485,596.0301575660706,2211.9349479675293,31321,7577,23744,23744,0,22,7647000.0
7647,7647999,20.58714502741556,37.62633675191351,0.08143694198291385,2843.491230726242,596.098881483078,2212.3861045837402,31321,7577,23744,23744,0,22,7648000.0
7648,7648999,20.586491393874525,37.6248248915726,0.08143785350580557,2844.0131816864014,596.1657671928406,2212.0823249816895,31323,7578,23745,23745,0,22,7649000.0
7649,7649999,20.586041594119816,37.62382034301285,0.08143314895582765,2844.5012967586517,596.2351524829865,2211.897731781006,31325,7579,23746,23746,0,22,7650000.0
7650,7650999,20.585575135207904,37.62273901484156,0.08143179298676961,2844.869085073471,596.3016681671143,2212.4843788146973,31341,7580,23761,23761,0,22,7651000.0
7651,7651999,20.58502394370767,37.62152654496141,0.08142957233688641,2845.0905282497406,596.3685908317566,2213.3904991149902,31341,7580,23761,23761,0,22,7652000.0
7652,7652999,20.584641509109638,37.620598049665496,0.08142326706607506,2845.5331134796143,596.4358599185944,2213.3152961730957,31341,7580,23761,23761,0,22,7653000.0
7653,7653999,20.584283922286,37.61971823965437,0.08141919244307938,2845.8809916973114,596.504905462265,2213.635845184326,31341,7580,23761,23761,0,22,7654000.0
7654,7654999,20.58379710085861,37.6185413004954,0.0814170738589376,2846.247890472412,596.5729289054871,2213.9603691101074,31341,7580,23761,23761,0,22,7655000.0
7655,7655999,20.583964989283423,37.622166560917414,0.0813810726253198,2846.710482597351,596.6398420333862,2214.3591957092285,31356,7582,23774,23774,0,22,7656000.0
7656,7656999,20.584004953539356,37.62226280973863,0.08136177156890179,2847.115720272064,596.7061157226562,2214.734775543213,31359,7583,23776,23776,0,22,7657000.0
7657,7657999,20.58392039895236,37.62245153383705,0.0813499190175776,2847.6055936813354,596.7719714641571,2214.8083305358887,31374,7585,23789,23789,0,22,7658000.0
7658,7658999,20.58378180709974,37.621677818609015,0.08134233589099482,2848.034660100937,596.8426246643066,2215.1521186828613,31376,7586,23790,23790,0,22,7659000.0
7659,7659999,20.583982060296954,37.621952406421364,0.08133362511071929,2848.3268523216248,596.9116053581238,2216.2572593688965,31391,7587,23804,23804,0,22,7660000.0
7660,7660999,20.584557706691825,37.62272115732643,0.08131834195682008,2848.781840801239,596.979875087738,2216.5209312438965,31396,7589,23807,23807,0,22,7661000.0
7661,7661999,20.585222294351166,37.62359334086293,0.08130533719697686,2849.2880403995514,597.048082113266,2216.536808013916,31400,7591,23809,23809,0,22,7662000.0
7662,7662999,20.58614851786676,37.625043893981065,0.08129319039283345,2849.8894369602203,597.1177222728729,2216.4502143859863,31408,7595,23813,23813,0,22,7663000.0
7663,7663999,20.586834983373755,37.62586924315735,0.08128558502843486,2850.397390604019,597.1848540306091,2216.3543434143066,31413,7597,23816,23816,0,22,7664000.0
7664,7664999,20.587920099240094,37.62693941254088,0.08128032860149348,2850.784123659134,597.2509789466858,2216.706027984619,31413,7597,23816,23816,0,22,7665000.0
7665,7665999,20.589005445558296,37.62871253842357,0.08127547724764306,2851.1058077812195,597.3181777000427,2217.271312713623,31415,7598,23817,23817,0,22,7666000.0
7666,7666999,20.590361823308356,37.6313876796317,0.08127233277804635,2851.5006635189056,597.3846578598022,2217.3477516174316,31415,7598,23817,23817,0,22,7667000.0
7667,7667999,20.59129945666237,37.63240552853558,0.08128057901927588,2851.8584389686584,597.4522931575775,2217.870029449463,31417,7599,23818,23818,0,22,7668000.0
7668,7668999,20.59311841347395,37.63562182375674,0.08129101185553678,2852.183237552643,597.5188684463501,2218.2802391052246,31417,7599,23818,23818,0,22,7669000.0
7669,7669999,20.59436711961992,37.63736595416684,0.08131090839294053,2852.692493915558,597.5864114761353,2218.1990699768066,31421,7601,23820,23820,0,22,7670000.0
7670,7670999,20.595963040782603,37.63993074297982,0.08133913091906142,2853.138683319092,597.6635444164276,2218.191173553467,31421,7601,23820,23820,0,22,7671000.0
7671,7671999,20.597875713369763,37.64361390852678,0.08136675288851325,2853.7025079727173,597.7335186004639,2217.761989593506,31423,7602,23821,23821,0,22,7672000.0
7672,7672999,20.59966534655636,37.646421031772775,0.08138864081719366,2854.0219316482544,597.8001039028168,2218.2827110290527,31423,7602,23821,23821,0,22,7673000.0
7673,7673999,20.601382910720055,37.64885997416762,0.08140172474119112,2854.4701447486877,597.8692488670349,2218.3387031555176,31425,7603,23822,23822,0,22,7674000.0
7674,7674999,20.60221678758786,37.65000029531919,0.08139174883167521,2854.8541526794434,597.934895992279,2219.057903289795,31429,7604,23825,23825,0,22,7675000.0
7675,7675999,20.602183497135524,37.64979160029047,0.08136852488836721,2855.093581676483,597.9998531341553,2220.217761993408,31430,7604,23826,23826,0,22,7676000.0
7676,7676999,20.602154403448676,37.64972111360262,0.08135648696442965,2855.5344376564026,598.0647027492523,2220.378604888916,31432,7605,23827,23827,0,22,7677000.0
7677,7677999,20.60227080944575,37.649916777074374,0.08134412866161145,2856.0222992897034,598.128821849823,2220.6950035095215,31439,7608,23831,23831,0,22,7678000.0
7678,7678999,20.60226770205852,37.6493500173031,0.08133352007707961,2856.32785820961,598.1950278282166,2221.2767448425293,31439,7608,23831,23831,0,22,7679000.0
7679,7679999,20.60273080452283,37.64957311745828,0.08132506429863129,2856.7126500606537,598.2592799663544,2221.665798187256,31441,7609,23832,23832,0,22,7680000.0
7680,7680999,20.6031805381388,37.64938860829817,0.08131774799333868,2857.1590089797974,598.3254632949829,2221.9848136901855,31445,7611,23834,23834,0,22,7681000.0
7681,7681999,20.60355810969511,37.64964430430447,0.08131152393074603,2857.3668174743652,598.3913016319275,2222.8491020202637,31445,7611,23834,23834,0,22,7682000.0
7682,7682999,20.604175835409574,37.65021637310386,0.08130529339401571,2858.0479311943054,598.455846786499,2221.9811973571777,31450,7613,23837,23837,0,22,7683000.0
7683,7683999,20.60526460348068,37.65177875239266,0.08129533975729653,2858.355586528778,598.5227818489075,2222.702693939209,31452,7614,23838,23838,0,22,7684000.0
7684,7684999,20.606186047217438,37.65256340235744,0.08130268568250998,2858.8052916526794,598.5895984172821,2222.8691596984863,31456,7616,23840,23840,0,22,7685000.0
7685,7685999,20.607117216703266,37.65322147120549,0.08131907348737222,2859.292742729187,598.6552441120148,2222.8984870910645,31470,7618,23852,23852,0,22,7686000.0
7686,7686999,20.607892226210197,37.65362163005768,0.08133477619608787,2859.74462890625,598.7235298156738,2222.8919105529785,31472,7619,23853,23853,0,22,7687000.0
7687,7687999,20.60922881127386,37.655133656438736,0.08135712968428577,2860.2224349975586,598.7890467643738,2222.581569671631,31472,7619,23853,23853,0,22,7688000.0
7688,7688999,20.610512153292355,37.65635584900635,0.08138127934808259,2860.5275666713715,598.8517534732819,2223.037799835205,31472,7619,23853,23853,0,22,7689000.0
7689,7689999,20.61161623913153,37.65739375292895,0.08140849795202498,2860.8051102161407,598.9151301383972,2223.6661643981934,31472,7619,23853,23853,0,22,7690000.0
7690,7690999,20.61275771905005,37.6583877886491,0.08142746312060833,2861.1051239967346,598.981125831604,2224.046863555908,31472,7619,23853,23853,0,22,7691000.0
7691,7691999,20.61355315801308,37.658731837300806,0.08144271081614529,2861.6092462539673,599.0477650165558,2223.762668609619,31474,7620,23854,23854,0,22,7692000.0
7692,7692999,20.614043953251635,37.65848342122873,0.08144763927140031,2862.172316789627,599.1163763999939,2223.090343475342,31474,7620,23854,23854,0,22,7693000.0
7693,7693999,20.61399318698501,37.65789867079412,0.08143643528545497,2862.422981262207,599.1844780445099,2224.1552543640137,31477,7620,23857,23857,0,22,7694000.0
7694,7694999,20.6135679481887,37.65841428065571,0.08142126081718781,2862.8525445461273,599.2512021064758,2224.444019317627,31480,7621,23859,23859,0,22,7695000.0
7695,7695999,20.613156306323393,37.658200760696204,0.0814144200000011,2863.3883726596832,599.3179829120636,2224.417621612549,31494,7624,23870,23870,0,22,7696000.0
7696,7696999,20.61248137195266,37.65698417427648,0.08141071739650996,2863.652376651764,599.3837757110596,2225.3993492126465,31496,7625,23871,23871,0,22,7697000.0
7697,7697999,20.61193724014201,37.65593233636344,0.08140540844644051,2864.1185641288757,599.4499280452728,2225.3861198425293,31500,7627,23873,23873,0,22,7698000.0
7698,7698999,20.611585874356585,37.654838369119894,0.08139982891510933,2864.4635677337646,599.5187582969666,2225.717975616455,31500,7627,23873,23873,0,22,7699000.0
7699,7699999,20.611244626682105,37.653625153532445,0.08139725329325331,2864.85502576828,599.5885810852051,2226.155834197998,31504,7629,23875,23875,0,22,7700000.0
7700,7700999,20.610879362702846,37.65249891843453,0.08139513309661195,2865.600446462631,599.6545939445496,2225.2559852600098,31512,7633,23879,23879,0,22,7701000.0
7701,7701999,20.610745971995996,37.65246400924378,0.0813938615765315,2865.869076490402,599.7234649658203,2225.9247550964355,31512,7633,23879,23879,0,22,7702000.0
7702,7702999,20.61081821297122,37.65222968832653,0.0813916473998616,2866.1985194683075,599.7969942092896,2226.5101280212402,31512,7633,23879,23879,0,22,7703000.0
7703,7703999,20.610692736810375,37.65184109339749,0.08139233646412314,2866.5465455055237,599.862557888031,2226.728588104248,31512,7633,23879,23879,0,22,7704000.0
7704,7704999,20.610756010049077,37.65186828546677,0.08139778334602799,2867.2566537857056,599.9301750659943,2225.8186225891113,31518,7636,23882,23882,0,22,7705000.0
7705,7705999,20.610814699505934,37.651613592666564,0.08141167429147822,2867.840009689331,599.9988305568695,2225.5960578918457,31524,7639,23885,23885,0,22,7706000.0
7706,7706999,20.611430734045854,37.65240629691054,0.08142767080290036,2868.2156476974487,600.0655953884125,2226.0771141052246,31529,7640,23889,23889,0,22,7707000.0
7707,7707999,20.61183970661003,37.65271941497089,0.08144208611366555,2868.508451461792,600.1326568126678,2226.608425140381,31529,7640,23889,23889,0,22,7708000.0
7708,7708999,20.612566609078982,37.65339984276454,0.08145355145112321,2868.8526062965393,600.2006018161774,2226.978702545166,31531,7641,23890,23890,0,22,7709000.0
7709,7709999,20.6135579614913,37.65448975426126,0.08145329139693347,2869.3044381141663,600.2745764255524,2227.0384483337402,31533,7642,23891,23891,0,22,7710000.0
7710,7710999,20.614021683698507,37.65455304584589,0.08145409582252838,2869.6456084251404,600.342972278595,2227.2604331970215,31533,7642,23891,23891,0,22,7711000.0
7711,7711999,20.614570964651147,37.655179890474386,0.08144614505681502,2870.2183015346527,600.4121751785278,2226.91548538208,31537,7644,23893,23893,0,22,7712000.0
7712,7712999,20.614888483068757,37.65484846620863,0.08141326768653756,2870.530549764633,600.4829323291779,2227.730869293213,31541,7645,23896,23896,0,22,7713000.0
7713,7713999,20.614890414817058,37.65549743492636,0.08137181560439122,2870.8340826034546,600.5546255111694,2228.978115081787,31555,7646,23909,23909,0,22,7714000.0
7714,7714999,20.614925977309227,37.65533144080549,0.08134344206887212,2870.9945628643036,600.6247336864471,2230.3925590515137,31556,7646,23910,23910,0,22,7715000.0
7715,7715999,20.614857957339296,37.65482521774094,0.081320359016546,2871.539527654648,600.6940197944641,2230.329692840576,31589,7648,23941,23941,0,22,7716000.0
7716,7716999,20.614647607028584,37.65393650253462,0.08129722633341674,2871.8459708690643,600.7661256790161,2230.878070831299,31589,7648,23941,23941,0,22,7717000.0
7717,7717999,20.614885129836395,37.65404341380084,0.08126742811009124,2872.4004802703857,600.8403503894806,2230.797161102295,31594,7650,23944,23944,0,22,7718000.0
7718,7718999,20.614709301339314,37.6530974256447,0.08124379933458015,2872.655394554138,600.9099507331848,2231.547519683838,31594,7650,23944,23944,0,22,7719000.0
7719,7719999,20.61480752997867,37.65266204207252,0.08121711279778432,2873.0007240772247,600.982565164566,2231.784656524658,31594,7650,23944,23944,0,22,7720000.0
7720,7720999,20.614668683260486,37.651834160875836,0.08119581767066852,2873.447262763977,601.0544090270996,2231.900043487549,31598,7652,23946,23946,0,22,7721000.0
7721,7721999,20.614651306667977,37.65111804971306,0.08117417263310778,2873.935589313507,601.127105474472,2231.990467071533,31602,7654,23948,23948,0,22,7722000.0
7722,7722999,20.614572099736694,37.65030194797843,0.08115518148556211,2874.4593727588654,601.2045278549194,2232.063373565674,31606,7656,23950,23950,0,22,7723000.0
7723,7723999,20.614347957434966,37.6493342636136,0.0811410679639899,2874.8953020572662,601.2773354053497,2232.1774253845215,31608,7657,23951,23951,0,22,7724000.0
7724,7724999,20.614131199768526,37.64849049769617,0.08112665573432765,2875.387127161026,601.3493435382843,2232.1940879821777,31621,7659,23962,23962,0,22,7725000.0
7725,7725999,20.614113187810222,37.6479818465119,0.08111991522548323,2875.696435213089,601.4209251403809,2232.6184730529785,31621,7659,23962,23962,0,22,7726000.0
7726,7726999,20.614094096398077,37.647755018973655,0.08110900023828949,2876.1806828975677,601.4932923316956,2232.5039405822754,31633,7660,23973,23973,0,22,7727000.0
7727,7727999,20.61415943251816,37.647158942739026,0.08109807415376591,2876.536608695984,601.5669722557068,2232.996837615967,31644,7661,23983,23983,0,22,7728000.0
7728,7728999,20.614180427949478,37.64661993055101,0.08108548625772316,2877.03036403656,601.6384987831116,2232.5735359191895,31644,7661,23983,23983,0,22,7729000.0
7729,7729999,20.61440879986937,37.646297279604454,0.0810710519631489,2877.481892824173,601.71058177948,2232.773090362549,31656,7663,23993,23993,0,22,7730000.0
7730,7730999,20.61433131117404,37.64543708927987,0.08106071797667636,2877.8797075748444,601.782068490982,2232.8140296936035,31656,7663,23993,23993,0,22,7731000.0
7731,7731999,20.614192511014217,37.64444986598136,0.08104640919664852,2878.3134150505066,601.8540670871735,2232.6922187805176,31656,7663,23993,23993,0,22,7732000.0
7732,7732999,20.613814428468437,37.643336263462224,0.08104184979036755,2878.6136527061462,601.9232203960419,2233.4818077087402,31658,7663,23995,23995,0,22,7733000.0
7733,7733999,20.61299788842312,37.64161551863144,0.08104311304091627,2878.999140739441,601.9867486953735,2233.740695953369,31658,7663,23995,23995,0,22,7734000.0
7734,7734999,20.61225577024559,37.64008365329923,0.08104053385086774,2879.4933750629425,602.0517287254333,2233.8734703063965,31662,7665,23997,23997,0,22,7735000.0
7735,7735999,20.611887397561542,37.63949766799229,0.0810330073340998,2879.8604102134705,602.117285490036,2234.445339202881,31665,7666,23999,23999,0,22,7736000.0
7736,7736999,20.611679874274913,37.63875730072269,0.08102357080958111,2880.617631673813,602.1846215724945,2233.6311836242676,31671,7669,24002,24002,0,22,7737000.0
7737,7737999,20.6114685090867,37.63848918400734,0.08101645736429863,2880.915694952011,602.2483632564545,2234.5026512145996,31673,7670,24003,24003,0,22,7738000.0
7738,7738999,20.611317999668515,37.638215470371016,0.08100525198687392,2881.3023869991302,602.3123285770416,2234.9407539367676,31675,7671,24004,24004,0,22,7739000.0
7739,7739999,20.611347608125623,37.63849053226036,0.0809915757201235,2881.575094938278,602.376624584198,2235.7969093322754,31677,7672,24005,24005,0,22,7740000.0
7740,7740999,20.611260551826504,37.63834463760597,0.08098973627662709,2882.0149614810944,602.4413597583771,2236.0348930358887,31681,7674,24007,24007,0,22,7741000.0
7741,7741999,20.611348294898,37.63931860045686,0.08098517457487953,2882.4715073108673,602.5086460113525,2236.1923027038574,31685,7676,24009,24009,0,22,7742000.0
7742,7742999,20.611696325298016,37.64085532049212,0.08097232441033286,2883.0537679195404,602.5773327350616,2236.040699005127,31693,7678,24015,24015,0,22,7743000.0
7743,7743999,20.61171892255132,37.64079117308603,0.08096891454312949,2883.447342634201,602.6427366733551,2236.1827354431152,31693,7678,24015,24015,0,22,7744000.0
7744,7744999,20.611779381709816,37.64084359190642,0.08097293791274218,2883.8856358528137,602.7080569267273,2236.4421577453613,31697,7680,24017,24017,0,22,7745000.0
7745,7745999,20.612382223682467,37.64291284319101,0.08096860717422749,2884.152889728546,602.7732753753662,2237.1131858825684,31697,7680,24017,24017,0,22,7746000.0
7746,7746999,20.612769491210837,37.644861362027726,0.0809604102670225,2884.5261857509613,602.8381206989288,2237.298915863037,31707,7681,24026,24026,0,22,7747000.0
7747,7747999,20.613180183895853,37.64518863984052,0.08095469320245652,2884.9365804195404,602.9044373035431,2237.471996307373,31709,7682,24027,24027,0,22,7748000.0
7748,7748999,20.613866640421275,37.64617428322915,0.08094655970254938,2885.4265275001526,602.9755930900574,2237.457805633545,31711,7683,24028,24028,0,22,7749000.0
7749,7749999,20.614461008969716,37.64653228171301,0.08094258276817445,2886.142004966736,603.0422928333282,2236.631290435791,31717,7686,24031,24031,0,22,7750000.0
7750,7750999,20.61511417201128,37.64690821631469,0.0809421595386397,2886.4232733249664,603.1090314388275,2237.3832511901855,31717,7686,24031,24031,0,22,7751000.0
7751,7751999,20.615359345213278,37.6467031290928,0.08094861542250498,2886.8280787467957,603.1758818626404,2237.6115684509277,31719,7687,24032,24032,0,22,7752000.0
7752,7752999,20.615587101553153,37.646638764250454,0.0809242630204966,2887.1467492580414,603.241072177887,2238.484272003174,31721,7687,24034,24034,0,22,7753000.0
7753,7753999,20.615360614394604,37.646134320990654,0.08091758955101036,2887.8132877349854,603.3136169910431,2238.1647605895996,31727,7690,24037,24037,0,22,7754000.0
7754,7754999,20.614937776915514,37.64504886662833,0.0809157122160058,2888.1788544654846,603.3834793567657,2238.8622398376465,31730,7691,24039,24039,0,22,7755000.0
7755,7755999,20.614470361746317,37.64406916985963,0.0809143520131469,2888.439378976822,603.4523234367371,2239.706157684326,31730,7691,24039,24039,0,22,7756000.0
7756,7756999,20.61397055274478,37.64286295579262,0.08091157738072663,2888.75731754303,603.5219326019287,2240.1333045959473,31730,7691,24039,24039,0,22,7757000.0
7757,7757999,20.613581437286815,37.641829670479126,0.08090780193777414,2889.2407524585724,603.593626499176,2240.1624031066895,31735,7693,24042,24042,0,22,7758000.0
7758,7758999,20.613066609406676,37.64055810821678,0.08090353534231076,2889.7886185646057,603.6619091033936,2240.0706520080566,31745,7695,24050,24050,0,22,7759000.0
7759,7759999,20.61270392663653,37.63952264774834,0.08089923469343241,2890.4086112976074,603.7328975200653,2239.5903816223145,31749,7697,24052,24052,0,22,7760000.0
7760,7760999,20.6125267299104,37.638809146056495,0.08089401121331108,2890.8650629520416,603.8037760257721,2239.735195159912,31751,7698,24053,24053,0,22,7761000.0
7761,7761999,20.61230227236842,37.6377740896388,0.08088785669673615,2891.190684080124,603.8774271011353,2240.4422492980957,31752,7699,24053,24053,0,22,7762000.0
7762,7762999,20.612033693029577,37.63671980690346,0.08088263306231169,2891.504766702652,603.9482591152191,2240.939052581787,31752,7699,24053,24053,0,22,7763000.0
7763,7763999,20.61191483059,37.63589107312788,0.0808801107693119,2891.948185443878,604.0194520950317,2241.0985069274902,31763,7700,24063,24063,0,22,7764000.0
7764,7764999,20.611630238438522,37.63474980832829,0.0808760544372763,2892.416814804077,604.0904407501221,2241.0348625183105,31765,7701,24064,24064,0,22,7765000.0
7765,7765999,20.611270045063044,37.633530407967434,0.08087425713278218,2892.7222537994385,604.1600995063782,2241.4928550720215,31765,7701,24064,24064,0,22,7766000.0
7766,7766999,20.610929261654242,37.63224471347289,0.08087228928803758,2893.3718163967133,604.2315900325775,2241.3584327697754,31785,7704,24081,24081,0,22,7767000.0
7767,7767999,20.610415199295215,37.63172424786506,0.08087199617446061,2893.7341191768646,604.3035435676575,2242.1511573791504,31787,7705,24082,24082,0,22,7768000.0
7768,7768999,20.610918780004877,37.634529945237304,0.08086427041676258,2894.0761590003967,604.3705444335938,2243.1342124938965,31792,7706,24086,24086,0,22,7769000.0
7769,7769999,20.611146143424314,37.63537491546679,0.08087871000215152,2894.4649085998535,604.4365103244781,2243.579502105713,31794,7707,24087,24087,0,22,7770000.0
7770,7770999,20.611018463176674,37.63518875050298,0.08087063593928356,2894.743444919586,604.5074837207794,2244.2835121154785,31794,7707,24087,24087,0,22,7771000.0
7771,7771999,20.61164629360103,37.63677252350594,0.08086463713746572,2895.2733533382416,604.5737729072571,2244.0305137634277,31801,7708,24093,24093,0,22,7772000.0
7772,7772999,20.61226892497157,37.63846085968561,0.08085363209589769,2895.720118999481,604.6436493396759,2244.568058013916,31816,7709,24107,24107,0,22,7773000.0
7773,7773999,20.612821385838288,37.63934005278931,0.08084490997318972,2896.0681235790253,604.7095265388489,2245.3531761169434,31827,7710,24117,24117,0,22,7774000.0
7774,7774999,20.61370501625701,37.640650425055526,0.08084965988796966,2896.3596048355103,604.7759838104248,2246.216335296631,31829,7711,24118,24118,0,22,7775000.0
7775,7775999,20.614991940808068,37.644834229472465,0.08082551795019632,2896.656800508499,604.8429915904999,2246.962688446045,31831,7712,24119,24119,0,22,7776000.0
7776,7776999,20.615965657585996,37.646430447462095,0.08082586314513285,2897.0082128047943,604.9116070270538,2247.2787437438965,31831,7712,24119,24119,0,22,7777000.0
7777,7777999,20.617303818254427,37.648274883937916,0.08082711363879513,2897.312063932419,604.9794607162476,2247.7142906188965,31831,7712,24119,24119,0,22,7778000.0
7778,7778999,20.61886054642536,37.65094149067338,0.08082433118061472,2897.6097135543823,605.0458934307098,2248.1559867858887,31831,7712,24119,24119,0,22,7779000.0
7779,7779999,20.620477527584477,37.65372124243037,0.08081972394847103,2897.9659633636475,605.1140785217285,2248.433979034424,31833,7713,24120,24120,0,22,7780000.0
7780,7780999,20.622170950032206,37.65657630591626,0.0808282402540671,2898.5938239097595,605.183488368988,2247.9730339050293,31839,7716,24123,24123,0,22,7781000.0
7781,7781999,20.62359092994784,37.65887785383518,0.08082929924996074,2899.0476508140564,605.2524075508118,2248.199993133545,31844,7718,24126,24126,0,22,7782000.0
7782,7782999,20.62541299742456,37.66171392989112,0.08085413143716502,2899.398108959198,605.3215622901917,2248.660129547119,31846,7719,24127,24127,0,22,7783000.0
7783,7783999,20.626896367873844,37.66348978601614,0.08086032158097345,2899.8796067237854,605.390321969986,2248.555820465088,31848,7720,24128,24128,0,22,7784000.0
7784,7784999,20.628772514701712,37.66609246807723,0.08088374438041346,2900.4307100772858,605.4602084159851,2248.3963584899902,31853,7722,24131,24131,0,22,7785000.0
7785,7785999,20.630081673711267,37.667572331570085,0.08089716099724964,2900.7946383953094,605.5293440818787,2248.640239715576,31853,7722,24131,24131,0,22,7786000.0
7786,7786999,20.6302657077095,37.66703356097623,0.08087899988299097,2901.0041811466217,605.6005260944366,2250.0208778381348,31856,7722,24134,24134,0,22,7787000.0
7787,7787999,20.630177259604523,37.66645321414103,0.08085596512206494,2901.3047993183136,605.670375585556,2250.800304412842,31859,7723,24136,24136,0,22,7788000.0
7788,7788999,20.62968518912429,37.66557918320467,0.08084904734587384,2901.6571497917175,605.739554643631,2251.0904273986816,31859,7723,24136,24136,0,22,7789000.0
7789,7789999,20.629370830419212,37.66506042497772,0.08084291097080776,2902.1790833473206,605.8078963756561,2251.0267906188965,31873,7725,24148,24148,0,22,7790000.0
7790,7790999,20.628892896908695,37.66382516414512,0.08083924222624927,2902.7255330085754,605.8787150382996,2250.941394805908,31879,7728,24151,24151,0,22,7791000.0
7791,7791999,20.62873281295292,37.663213128280255,0.08083184827265388,2903.1207876205444,605.9496462345123,2251.372402191162,31884,7730,24154,24154,0,22,7792000.0
7792,7792999,20.62901270311713,37.66334370087838,0.08082371250626008,2903.62238073349,606.0208840370178,2251.4710121154785,31888,7732,24156,24156,0,22,7793000.0
7793,7793999,20.629500504822516,37.66481974254647,0.08081719497537554,2903.8427765369415,606.098001241684,2252.2821769714355,31888,7732,24156,24156,0,22,7794000.0
7794,7794999,20.62979249030511,37.66506683552831,0.08081640324112027,2904.1986541748047,606.1693394184113,2252.5941047668457,31889,7732,24157,24157,0,22,7795000.0
7795,7795999,20.6304481322698,37.66605199674945,0.08082258029241796,2904.68714427948,606.2475438117981,2252.4610023498535,31891,7733,24158,24158,0,22,7796000.0
7796,7796999,20.631359523498755,37.6691061323299,0.08082127904931258,2905.061265707016,606.3185586929321,2252.7053260803223,31891,7733,24158,24158,0,22,7797000.0
7797,7797999,20.631874785011465,37.66971176883529,0.08083273062012386,2905.526987552643,606.393045425415,2252.9002799987793,31895,7735,24160,24160,0,22,7798000.0
7798,7798999,20.6323623880037,37.670283676967,0.08084193247123383,2906.015201330185,606.4629056453705,2252.8641319274902,31899,7737,24162,24162,0,22,7799000.0
7799,7799999,20.632810872902958,37.67072644576714,0.08084907591379797,2906.468971014023,606.5416333675385,2252.8156929016113,31899,7737,24162,24162,0,22,7800000.0
7800,7800999,20.63364027191102,37.67207544648586,0.08086358373475022,2906.870530605316,606.6207909584045,2252.8946113586426,31899,7737,24162,24162,0,22,7801000.0
7801,7801999,20.634152707660412,37.67258909088464,0.08087951778470337,2907.175605773926,606.6972954273224,2253.4115409851074,31899,7737,24162,24162,0,22,7802000.0
7802,7802999,20.634577548810526,37.672444240576304,0.08088865936308076,2907.5251014232635,606.7660191059113,2253.8232917785645,31901,7738,24163,24163,0,22,7803000.0
7803,7803999,20.635154887906367,37.67348576167999,0.080891594213508,2908.0201835632324,606.8375217914581,2253.416591644287,31901,7738,24163,24163,0,22,7804000.0
7804,7804999,20.635464693607396,37.6731113353005,0.08088669874960364,2908.392331123352,606.9166326522827,2253.6393089294434,31901,7738,24163,24163,0,22,7805000.0
7805,7805999,20.635420953255675,37.67298986452221,0.08088350479050688,2908.7919404506683,606.9866127967834,2254.0754737854004,31903,7738,24165,24165,0,22,7806000.0
7806,7806999,20.634967659229265,37.67453807803102,0.08086266442758105,2909.280401468277,607.0553500652313,2254.263683319092,31906,7739,24167,24167,0,22,7807000.0
7807,7807999,20.63423811315296,37.673610854612754,0.0808636168807727,2909.611122608185,607.1185009479523,2254.6604499816895,31907,7739,24168,24168,0,22,7808000.0
7808,7808999,20.63357506672705,37.67212118013936,0.0808643625694786,2910.149176836014,607.1832973957062,2254.705852508545,31922,7742,24180,24180,0,22,7809000.0
7809,7809999,20.633002773114026,37.67074274335975,0.08085318761402271,2910.5093398094177,607.2496008872986,2255.2797203063965,31933,7743,24190,24190,0,22,7810000.0
7810,7810999,20.632640607561306,37.66991460027938,0.08084672764436951,2910.9442777633667,607.3134791851044,2255.296802520752,31935,7744,24191,24191,0,22,7811000.0
7811,7811999,20.632791773284662,37.669676722490664,0.0808132635579828,2911.3971560001373,607.3787844181061,2255.549419403076,31939,7746,24193,24193,0,22,7812000.0
7812,7812999,20.63320968045341,37.67002134678548,0.08079300004161394,2911.7292425632477,607.4451475143433,2256.216464996338,31941,7747,24194,24194,0,22,7813000.0
7813,7813999,20.633645397694952,37.67094932547383,0.08077663861548423,2911.9749517440796,607.5101978778839,2256.997646331787,31941,7747,24194,24194,0,22,7814000.0
7814,7814999,20.63446832713053,37.67230706583833,0.08076345041530653,2912.58168053627,607.5812320709229,2256.4999198913574,31945,7749,24196,24196,0,22,7815000.0
7815,7815999,20.6353595457364,37.674351287023725,0.08075120794872637,2912.998019218445,607.6495585441589,2256.6478996276855,31945,7749,24196,24196,0,22,7816000.0
7816,7816999,20.63600710160151,37.67577230074681,0.08073924322282444,2913.524655342102,607.716849565506,2256.383098602295,31956,7750,24206,24206,0,22,7817000.0
7817,7817999,20.63654781805646,37.676836052408376,0.0807316947686989,2913.876437187195,607.7840757369995,2256.7573585510254,31956,7750,24206,24206,0,22,7818000.0
7818,7818999,20.63726312769485,37.67915403526008,0.08072610864227325,2914.260020494461,607.850926399231,2257.0153846740723,31958,7751,24207,24207,0,22,7819000.0
7819,7819999,20.638089486583937,37.6810542644266,0.08072407706907292,2914.4315786361694,607.9138491153717,2258.007495880127,31958,7751,24207,24207,0,22,7820000.0
7820,7820999,20.638661373032992,37.68169808635257,0.08071415520890057,2914.737106323242,607.9790723323822,2258.372570037842,31958,7751,24207,24207,0,22,7821000.0
7821,7821999,20.639364322137407,37.683333363342,0.08070501237637229,2915.191455602646,608.044243812561,2258.360851287842,31968,7752,24216,24216,0,22,7822000.0
7822,7822999,20.640091202556683,37.685220250918405,0.08069549708159862,2915.6894295215607,608.1094763278961,2258.233959197998,31972,7754,24218,24218,0,22,7823000.0
7823,7823999,20.64070241861837,37.68684508652324,0.0806831585162493,2916.1557784080505,608.1753742694855,2258.280040740967,31974,7755,24219,24219,0,22,7824000.0
7824,7824999,20.640765709306805,37.68734824241211,0.08066482759906923,2916.641298532486,608.2432396411896,2258.6436347961426,31988,7757,24231,24231,0,22,7825000.0
7825,7825999,20.640835221440913,37.68702305340143,0.08064615994858082,2916.937568664551,608.3101029396057,2259.3393058776855,31989,7757,24232,24232,0,22,7826000.0
7826,7826999,20.640880721656668,37.6864213132003,0.08062252917169033,2917.1765429973602,608.3749821186066,2260.231662750244,31989,7757,24232,24232,0,22,7827000.0
7827,7827999,20.641010779605185,37.68614985025305,0.08059091243484273,2917.6606669425964,608.4486932754517,2260.4509315490723,31993,7759,24234,24234,0,22,7828000.0
7828,7828999,20.64113173184958,37.68594680109654,0.08056312745121375,2918.305195093155,608.5173745155334,2260.0954093933105,32004,7762,24242,24242,0,22,7829000.0
7829,7829999,20.641023204642607,37.68499481449009,0.08055037006358878,2918.5981109142303,608.5941300392151,2260.8623695373535,32006,7763,24243,24243,0,22,7830000.0
7830,7830999,20.64079930248302,37.68391840778914,0.08054143963676585,2919.098997116089,608.6627020835876,2260.758930206299,32010,7765,24245,24245,0,22,7831000.0
7831,7831999,20.64062596621241,37.683071458859814,0.08053111537830271,2919.597813606262,608.7297880649567,2260.739025115967,32015,7767,24248,24248,0,22,7832000.0
7832,7832999,20.640655609393242,37.68260860547014,0.08051482749682504,2919.857218980789,608.797865152359,2261.416202545166,32015,7767,24248,24248,0,22,7833000.0
7833,7833999,20.640652654387768,37.68201524155456,0.08050787515568236,2920.39679813385,608.8650498390198,2261.1046409606934,32019,7769,24250,24250,0,22,7834000.0
7834,7834999,20.64034591287226,37.68102165316365,0.08050438051462527,2921.12038731575,608.934751033783,2260.452854156494,32034,7772,24262,24262,0,22,7835000.0
7835,7835999,20.63999415335757,37.679854595330056,0.08050378487440157,2921.3880746364594,609.0072190761566,2261.238384246826,32034,7772,24262,24262,0,22,7836000.0
7836,7836999,20.639807553981235,37.6788475328194,0.08050258919796327,2921.8554587364197,609.0758986473083,2261.1886711120605,32038,7774,24264,24264,0,22,7837000.0
7837,7837999,20.639396838348976,37.67768078153872,0.08050162191385579,2922.108761548996,609.1436822414398,2261.8068504333496,32038,7774,24264,24264,0,22,7838000.0
7838,7838999,20.639168018339944,37.67675561804278,0.08049944302189671,2922.735429763794,609.2166936397552,2261.117488861084,32040,7775,24265,24265,0,22,7839000.0
7839,7839999,20.638882321335196,37.675641556623404,0.08049714138846198,2923.17328953743,609.2855672836304,2261.447986602783,32044,7777,24267,24267,0,22,7840000.0
7840,7840999,20.63842470169293,37.67438893091095,0.08049820396191243,2923.577784538269,609.3565595149994,2261.614070892334,32044,7777,24267,24267,0,22,7841000.0
7841,7841999,20.63791735869865,37.67313188660485,0.08049651591471563,2923.9706671237946,609.42627120018,2261.798236846924,32044,7777,24267,24267,0,22,7842000.0
7842,7842999,20.637386592135925,37.67236797572783,0.08049433828987951,2924.428354024887,609.4944105148315,2261.617893218994,32044,7777,24267,24267,0,22,7843000.0
7843,7843999,20.63752364749796,37.67392606300024,0.08048160345899691,2924.6886427402496,609.5630378723145,2262.5784034729004,32044,7777,24267,24267,0,22,7844000.0
7844,7844999,20.637188698000607,37.67325112504314,0.08047899690429494,2924.945032119751,609.6295127868652,2263.4954872131348,32046,7778,24268,24268,0,22,7845000.0
7845,7845999,20.63693424867194,37.67312192289346,0.08047951959059829,2925.3588242530823,609.6970524787903,2263.6284980773926,32048,7779,24269,24269,0,22,7846000.0
7846,7846999,20.63697372830019,37.67382626336922,0.08046867735417762,2925.836523294449,609.7638199329376,2263.436138153076,32050,7780,24270,24270,0,22,7847000.0
7847,7847999,20.637449391960995,37.67514016581763,0.08046178085582123,2926.558324575424,609.8321256637573,2262.8898887634277,32069,7783,24286,24286,0,22,7848000.0
7848,7848999,20.637779219232094,37.675544301707184,0.08045904098594825,2926.868868112564,609.9014103412628,2263.7044258117676,32070,7783,24287,24287,0,22,7849000.0
7849,7849999,20.638676647427324,37.677460985159,0.08045472913462626,2927.229516506195,609.9703366756439,2264.250057220459,32072,7784,24288,24288,0,22,7850000.0
7850,7850999,20.639653412908082,37.67926321687231,0.08046491036116277,2927.6627616882324,610.0377852916718,2264.17826461792,32074,7785,24289,24289,0,22,7851000.0
7851,7851999,20.640915296485215,37.681802878327936,0.08046572584075706,2928.0750873088837,610.1068067550659,2264.356700897217,32074,7785,24289,24289,0,22,7852000.0
7852,7852999,20.642535578071065,37.685988572836976,0.08048220625337643,2928.578033208847,610.1813018321991,2264.461643218994,32078,7787,24291,24291,0,22,7853000.0
7853,7853999,20.644965649432553,37.694822251459186,0.08049167703965032,2929.031501054764,610.2507750988007,2264.442699432373,32080,7788,24292,24292,0,22,7854000.0
7854,7854999,20.6471468460399,37.70016379095011,0.08051048445612907,2929.460090637207,610.3201863765717,2264.487331390381,32080,7788,24292,24292,0,22,7855000.0
7855,7855999,20.64840298626345,37.701897020133316,0.0805275812557038,2929.8237290382385,610.3885498046875,2265.0573768615723,32084,7790,24294,24294,0,22,7856000.0
7856,7856999,20.650640423389223,37.70662023114253,0.08057723306552722,2930.2135417461395,610.460027217865,2265.3623237609863,32086,7791,24295,24295,0,22,7857000.0
7857,7857999,20.652426638223876,37.71065777628645,0.08060417600808856,2930.509204149246,610.5293514728546,2265.8448448181152,32086,7791,24295,24295,0,22,7858000.0
7858,7858999,20.654166737892734,37.71315230417299,0.08062764729431426,2930.963942527771,610.5999262332916,2266.035259246826,32095,7793,24302,24302,0,22,7859000.0
7859,7859999,20.65629896422865,37.71711900995553,0.08065541618162597,2931.4361867904663,610.6712007522583,2265.9239234924316,32097,7794,24303,24303,0,22,7860000.0
7860,7860999,20.65824305439743,37.72049270548076,0.08068751623622983,2931.77938580513,610.7402021884918,2266.2156944274902,32097,7794,24303,24303,0,22,7861000.0
7861,7861999,20.659997683071317,37.72323118100691,0.08072437585109937,2932.170504808426,610.8123524188995,2266.362049102783,32097,7794,24303,24303,0,22,7862000.0
7862,7862999,20.66084075536512,37.72433519945276,0.0806997445905786,2932.5557022094727,610.8780875205994,2266.967929840088,32101,7795,24306,24306,0,22,7863000.0
7863,7863999,20.662164947504905,37.72731175007843,0.08067910003624512,2932.881915807724,610.9427516460419,2267.7534980773926,32101,7795,24306,24306,0,22,7864000.0
7864,7864999,20.663155287265926,37.7295990252034,0.08066240368786348,2933.296319246292,611.0128703117371,2268.2489433288574,32114,7796,24318,24318,0,22,7865000.0
7865,7865999,20.664390325648792,37.731690693517095,0.0806421943535699,2933.663255214691,611.0770592689514,2268.9372596740723,32119,7797,24322,24322,0,22,7866000.0
7866,7866999,20.66520449361452,37.73291596588425,0.08062650576978292,2934.1497967243195,611.1440751552582,2269.271831512451,32124,7799,24325,24325,0,22,7867000.0
7867,7867999,20.666507556389657,37.73507877955358,0.08060758393838341,2934.626979827881,611.2136776447296,2269.1712226867676,32124,7799,24325,24325,0,22,7868000.0
7868,7868999,20.667361022744767,37.73552623170979,0.08060538914005344,2934.8402206897736,611.2795596122742,2270.1146812438965,32125,7799,24326,24326,0,22,7869000.0
7869,7869999,20.668356165281107,37.73628339803547,0.0806086838867236,2935.273275613785,611.3459496498108,2270.1332969665527,32126,7799,24327,24327,0,22,7870000.0
7870,7870999,20.669680349873463,37.73795771842873,0.08060892110924267,2935.6321651935577,611.4096417427063,2270.5651206970215,32128,7800,24328,24328,0,22,7871000.0
7871,7871999,20.671027163680144,37.73981727674137,0.08062402698621807,2936.082260608673,611.4782929420471,2270.6729621887207,32130,7801,24329,24329,0,22,7872000.0
7872,7872999,20.67250289891285,37.741655451861945,0.08063891474268559,2936.3096265792847,611.5430986881256,2271.4939918518066,32130,7801,24329,24329,0,22,7873000.0
7873,7873999,20.67408318052531,37.743631520733366,0.08065305939520728,2936.766170501709,611.6112022399902,2271.4003257751465,32132,7802,24330,24330,0,22,7874000.0
7874,7874999,20.675951056748072,37.748350637913816,0.08067385776101477,2937.324251651764,611.6774961948395,2271.4156455993652,32138,7805,24333,24333,0,22,7875000.0
7875,7875999,20.677793238724984,37.75223329700964,0.08068980125746339,2937.786687850952,611.7437989711761,2271.5484733581543,32142,7807,24335,24335,0,22,7876000.0
7876,7876999,20.6796144868731,37.75455604712514,0.08073317735717422,2938.3342661857605,611.8107612133026,2271.286106109619,32161,7809,24352,24352,0,22,7877000.0
7877,7877999,20.68135729770185,37.756410931080445,0.08077423424184416,2938.6337554454803,611.8767404556274,2271.832248687744,32162,7809,24353,24353,0,22,7878000.0
7878,7878999,20.683215019556645,37.75883469111591,0.08081826823114102,2939.1020703315735,611.942106962204,2271.813877105713,32164,7810,24354,24354,0,22,7879000.0
7879,7879999,20.68490518394937,37.76060408621601,0.08086214187235474,2939.694759130478,612.0099642276764,2271.296131134033,32168,7812,24356,24356,0,22,7880000.0
7880,7880999,20.68603348429587,37.76131823364187,0.0808786206729315,2940.1765389442444,612.0766026973724,2271.2404823303223,32170,7813,24357,24357,0,22,7881000.0
7881,7881999,20.68658361304874,37.7615726608528,0.08086347428537988,2940.6875994205475,612.1431255340576,2271.428394317627,32173,7814,24359,24359,0,22,7882000.0
7882,7882999,20.686228443249625,37.76075421031456,0.08085662267504323,2941.272076845169,612.2143762111664,2271.432315826416,32188,7817,24371,24371,0,22,7883000.0
7883,7883999,20.685902528197353,37.76065652588408,0.08084857612512308,2941.59503698349,612.2826347351074,2272.1492195129395,32189,7817,24372,24372,0,22,7884000.0
7884,7884999,20.685488371005334,37.759862693051446,0.08084335162289857,2942.0615248680115,612.3567171096802,2272.4183387756348,32191,7818,24373,24373,0,22,7885000.0
7885,7885999,20.685068972644135,37.75892990382434,0.08083891393535125,2942.3902759552,612.4277579784393,2273.560863494873,32209,7819,24390,24390,0,22,7886000.0
7886,7886999,20.68472881781957,37.75788099360757,0.08083730237958586,2942.6484608650208,612.4981360435486,2274.458751678467,32210,7819,24391,24391,0,22,7887000.0
7887,7887999,20.68476993951334,37.75794826673846,0.08083365688188338,2943.0474791526794,612.568835735321,2274.699306488037,32212,7820,24392,24392,0,22,7888000.0
7888,7888999,20.684465818990542,37.757137231202655,0.08082975150847715,2943.5198318958282,612.6399641036987,2274.9845695495605,32225,7822,24403,24403,0,22,7889000.0
7889,7889999,20.684486907179206,37.75675209527418,0.08082823625634339,2944.0819840431213,612.7141897678375,2274.6221199035645,32237,7823,24414,24414,0,22,7890000.0
7890,7890999,20.68441631528184,37.75788975273635,0.08081997751034009,2944.4287667274475,612.7864320278168,2275.065845489502,32238,7823,24415,24415,0,22,7891000.0
7891,7891999,20.684366972517786,37.757401478039654,0.08081765897831494,2944.807459592819,612.8576333522797,2275.4005393981934,32240,7824,24416,24416,0,22,7892000.0
7892,7892999,20.68426273155152,37.75671573282845,0.08082186343181896,2945.2177867889404,612.9274792671204,2275.665256500244,32242,7825,24417,24417,0,22,7893000.0
7893,7893999,20.683993611691644,37.75567979396461,0.0808259923193132,2945.7246267795563,612.9989485740662,2275.586887359619,32246,7827,24419,24419,0,22,7894000.0
7894,7894999,20.683813562174997,37.7547626127527,0.08082748843419385,2946.173995256424,613.0716731548309,2275.5133018493652,32246,7827,24419,24419,0,22,7895000.0
7895,7895999,20.68343219458661,37.75343806533872,0.08083277926700161,2946.693506717682,613.1438341140747,2275.555675506592,32258,7829,24429,24429,0,22,7896000.0
7896,7896999,20.682960518786206,37.752042449161394,0.08083835390816729,2946.963398218155,613.2155225276947,2276.2851600646973,32258,7829,24429,24429,0,22,7897000.0
7897,7897999,20.683616953960843,37.75215038597756,0.08079942271746265,2947.4836716651917,613.2830562591553,2276.4314765930176,32271,7830,24441,24441,0,22,7898000.0
7898,7898999,20.684374214582277,37.752732496358334,0.08074843632526041,2947.840703010559,613.3502194881439,2277.2295722961426,32273,7831,24442,24442,0,22,7899000.0
7899,7899999,20.684935582386135,37.75252979132653,0.08069749715858121,2948.3477494716644,613.4169795513153,2277.76029586792,32295,7834,24461,24461,0,22,7900000.0
7900,7900999,20.685573361783796,37.75268493982276,0.08065636050872582,2948.568994283676,613.4850337505341,2278.9340782165527,32296,7834,24462,24462,0,22,7901000.0
7901,7901999,20.686102707473005,37.752301407115645,0.08061887306083493,2948.839619398117,613.5522339344025,2279.8281593322754,32298,7835,24463,24463,0,22,7902000.0
7902,7902999,20.68680786869937,37.75245459635231,0.08058661798034172,2949.337967157364,613.6206464767456,2279.9175605773926,32302,7837,24465,24465,0,22,7903000.0
7903,7903999,20.687388224023255,37.752513402849125,0.08056419949115978,2949.9115359783173,613.689207315445,2279.730068206787,32318,7840,24478,24478,0,22,7904000.0
7904,7904999,20.688374622207913,37.753672796741085,0.08053322660429496,2950.364627599716,613.757294178009,2280.0241737365723,32322,7842,24480,24480,0,22,7905000.0
7905,7905999,20.689691467566913,37.75522803423969,0.08052807143268415,2950.819478034973,613.8258879184723,2280.2420768737793,32326,7844,24482,24482,0,22,7906000.0
7906,7906999,20.69093393629036,37.759405998102665,0.0805144151355569,2951.285176515579,613.8941431045532,2280.427272796631,32330,7846,24484,24484,0,22,7907000.0
7907,7907999,20.69230395234257,37.76344185451993,0.08050661712823104,2951.6615698337555,613.9628345966339,2280.8453788757324,32332,7847,24485,24485,0,22,7908000.0
7908,7908999,20.693289821439006,37.76459487146569,0.08050716962512561,2952.247493982315,614.0310869216919,2280.7786445617676,32347,7850,24497,24497,0,22,7909000.0
7909,7909999,20.694715567212263,37.76698112439922,0.08050596388068909,2952.6642775535583,614.0984442234039,2281.2550315856934,32351,7852,24499,24499,0,22,7910000.0
7910,7910999,20.696037051223872,37.76876900078525,0.08050725627269961,2952.959801197052,614.1666135787964,2281.909900665283,32351,7852,24499,24499,0,22,7911000.0
7911,7911999,20.698302060822748,37.78227327697194,0.08046907192484964,2953.3943161964417,614.2351462841034,2282.141368865967,32363,7854,24509,24509,0,22,7912000.0
7912,7912999,20.700221279129675,37.785293133960174,0.0804798206657279,2953.912522792816,614.3088083267212,2282.112201690674,32367,7856,24511,24511,0,22,7913000.0
7913,7913999,20.702586321762382,37.789468736484366,0.08049393788456494,2954.59246301651,614.3757195472717,2281.133373260498,32369,7857,24512,24512,0,22,7914000.0
7914,7914999,20.704322338540702,37.792247804401235,0.08050720364767172,2955.008359193802,614.4426505565643,2281.3162727355957,32369,7857,24512,24512,0,22,7915000.0
7915,7915999,20.705556189908563,37.793157804002945,0.08045312239543767,2955.26002573967,614.5103764533997,2282.523853302002,32369,7857,24512,24512,0,22,7916000.0
7916,7916999,20.706109066950393,37.793042730228215,0.08042129035326395,2955.4875905513763,614.5839407444,2283.716449737549,32369,7857,24512,24512,0,22,7917000.0
7917,7917999,20.706299722115812,37.792646591827385,0.08039896481227393,2956.130657196045,614.6545038223267,2283.234577178955,32375,7860,24515,24515,0,22,7918000.0
7918,7918999,20.706648311394364,37.79280703483386,0.08040071174386543,2956.4472227096558,614.7263219356537,2283.8094596862793,32375,7860,24515,24515,0,22,7919000.0
7919,7919999,20.706953694831682,37.792665430901835,0.08040023063561597,2956.7486658096313,614.7976186275482,2284.315891265869,32375,7860,24515,24515,0,22,7920000.0
7920,7920999,20.707240115043987,37.792462694929334,0.08040309018191394,2957.5257501602173,614.8682341575623,2283.2923622131348,32381,7863,24518,24518,0,22,7921000.0
7921,7921999,20.70766800211051,37.792364968135146,0.080407101001436,2957.9543108940125,614.944619178772,2283.636646270752,32383,7864,24519,24519,0,22,7922000.0
7922,7922999,20.708606934234314,37.793459012115555,0.0804109557878201,2958.214478492737,615.0153963565826,2284.373805999756,32383,7864,24519,24519,0,22,7923000.0
7923,7923999,20.70960016652361,37.79476416805142,0.08040619259109738,2958.4238941669464,615.0870833396912,2285.258045196533,32383,7864,24519,24519,0,22,7924000.0
7924,7924999,20.710281916357104,37.79519561145912,0.080433092908062,2959.008308649063,615.1576309204102,2284.659564971924,32385,7865,24520,24520,0,22,7925000.0
7925,7925999,20.711259689054316,37.796177269801696,0.0804427212824016,2959.413778066635,615.2307333946228,2284.9320106506348,32387,7866,24521,24521,0,22,7926000.0
7926,7926999,20.71249261218883,37.79989259545687,0.080445994531822,2959.7735669612885,615.300665140152,2285.2674827575684,32389,7867,24522,24522,0,22,7927000.0
7927,7927999,20.71361836958281,37.80090745746076,0.08046864075554494,2960.162435770035,615.3730297088623,2285.429485321045,32389,7867,24522,24522,0,22,7928000.0
7928,7928999,20.714839655436734,37.80217799494603,0.08048862524652023,2960.4936559200287,615.4435596466064,2285.7722969055176,32389,7867,24522,24522,0,22,7929000.0
7929,7929999,20.716125177608852,37.804610551278756,0.08049698133334782,2960.902663230896,615.5165581703186,2285.974552154541,32391,7868,24523,24523,0,22,7930000.0
7930,7930999,20.717227864390384,37.80542081853373,0.08052050519397713,2961.3463366031647,615.5872483253479,2285.937068939209,32393,7869,24524,24524,0,22,7931000.0
7931,7931999,20.71862252965935,37.80801857906672,0.08053325853431481,2961.7296736240387,615.6609876155853,2286.1380729675293,32393,7869,24524,24524,0,22,7932000.0
7932,7932999,20.719407337873424,37.807939312293904,0.08055211485052438,2962.071860551834,615.7284882068634,2286.569553375244,32395,7870,24525,24525,0,22,7933000.0
7933,7933999,20.719935244872993,37.808675717860744,0.08053630326756345,2962.4495718479156,615.7953798770905,2287.182117462158,32397,7870,24527,24527,0,22,7934000.0
7934,7934999,20.71978576723329,37.808317220644625,0.0805160718540272,2962.852198123932,615.861554145813,2287.715175628662,32399,7871,24528,24528,0,22,7935000.0
7935,7935999,20.71941357236915,37.80781192137358,0.08050617479787658,2963.2630438804626,615.926985502243,2288.3045692443848,32412,7873,24539,24539,0,22,7936000.0
7936,7936999,20.719462202304072,37.80768785734987,0.08049254168275877,2963.7601351737976,615.992992401123,2288.236469268799,32414,7874,24540,24540,0,22,7937000.0
7937,7937999,20.719328848841585,37.80713559319937,0.08048395272806308,2963.9669597148895,616.0569548606873,2289.2485008239746,32414,7874,24540,24540,0,22,7938000.0
7938,7938999,20.719347587553408,37.80690152952331,0.08047957571234743,2964.418315887451,616.1236207485199,2289.242618560791,32416,7875,24541,24541,0,22,7939000.0
7939,7939999,20.719339560896724,37.80614454427323,0.08047168477374278,2964.9144282341003,616.1932592391968,2289.2178688049316,32418,7876,24542,24542,0,22,7940000.0
7940,7940999,20.719356293626625,37.80542253598024,0.08047006973650794,2965.4036157131195,616.2594406604767,2289.178478240967,32422,7878,24544,24544,0,22,7941000.0
7941,7941999,20.719664478120464,37.808103788437435,0.08045481867902093,2965.674448490143,616.3278934955597,2289.801616668701,32422,7878,24544,24544,0,22,7942000.0
7942,7942999,20.72001297016809,37.807970691467034,0.08045412477437353,2965.9797582626343,616.3929100036621,2290.1946601867676,32422,7878,24544,24544,0,22,7943000.0
7943,7943999,20.720535385641586,37.80991172601626,0.08044447927526932,2966.527538537979,616.4587182998657,2289.9528160095215,32434,7879,24555,24555,0,22,7944000.0
7944,7944999,20.721436995873884,37.81258583885835,0.08043320317903069,2966.915292263031,616.5258440971375,2290.1534996032715,32436,7880,24556,24556,0,22,7945000.0
7945,7945999,20.72273983452796,37.814424959242736,0.08042945362174792,2967.1759128570557,616.5917546749115,2290.772449493408,32436,7880,24556,24556,0,22,7946000.0
7946,7946999,20.724008049583134,37.81600404568829,0.0804321808440367,2967.726573228836,616.658814907074,2290.561550140381,32440,7882,24558,24558,0,22,7947000.0
7947,7947999,20.725731175346326,37.818166899769054,0.08043536940153284,2968.1014676094055,616.730813741684,2290.992908477783,32442,7883,24559,24559,0,22,7948000.0
7948,7948999,20.72727709264642,37.819619079804006,0.080448841573454,2968.589517593384,616.7984349727631,2291.0412940979004,32446,7885,24561,24561,0,22,7949000.0
7949,7949999,20.72903681419586,37.823093330666495,0.08044750457905347,2969.1097774505615,616.8653557300568,2290.636775970459,32448,7886,24562,24562,0,22,7950000.0
7950,7950999,20.730085792522853,37.82372108697237,0.08045270688917339,2969.443071603775,616.9304599761963,2290.9317512512207,32448,7886,24562,24562,0,22,7951000.0
7951,7951999,20.730320919934144,37.82299519802343,0.08044915049384982,2970.091236114502,616.9970953464508,2290.656970977783,32455,7889,24566,24566,0,22,7952000.0
7952,7952999,20.73019140822879,37.82273167551984,0.0804363547421616,2970.6066370010376,617.0734760761261,2291.1313285827637,32460,7891,24569,24569,0,22,7953000.0
7953,7953999,20.7301019910006,37.82317002539374,0.08042479602881136,2970.92706823349,617.1392376422882,2291.8375205993652,32462,7892,24570,24570,0,22,7954000.0
7954,7954999,20.730097848635566,37.82307333834412,0.08041860755161823,2971.312391757965,617.2066113948822,2292.008502960205,32462,7892,24570,24570,0,22,7955000.0
7955,7955999,20.730407113191074,37.82380944674091,0.08040418170497865,2971.949291229248,617.2724401950836,2291.3048210144043,32466,7894,24572,24572,0,22,7956000.0
7956,7956999,20.730889865271653,37.825174298592046,0.08039887516487965,2972.3113639354706,617.3411293029785,2291.7947425842285,32468,7895,24573,24573,0,22,7957000.0
7957,7957999,20.731669848358827,37.82685794058653,0.0803892498633515,2972.605553627014,617.4078326225281,2292.393711090088,32468,7895,24573,24573,0,22,7958000.0
7958,7958999,20.732169503894042,37.82782642610382,0.08038181703769953,2973.1084594726562,617.4769909381866,2292.4354286193848,32474,7898,24576,24576,0,22,7959000.0
7959,7959999,20.73254345095703,37.82817290791886,0.08037079082526333,2973.571456670761,617.546644449234,2292.7310218811035,32477,7900,24577,24577,0,22,7960000.0
7960,7960999,20.73328705246669,37.8296231937322,0.0803699201551088,2973.82763171196,617.6190638542175,2293.4499702453613,32477,7900,24577,24577,0,22,7961000.0
7961,7961999,20.733916122307104,37.831801512754,0.08036314571416103,2974.357586622238,617.6934990882874,2293.1494789123535,32479,7901,24578,24578,0,22,7962000.0
7962,7962999,20.734564912772417,37.83314802321948,0.0803704706541648,2974.8133227825165,617.759982585907,2293.373302459717,32484,7903,24581,24581,0,22,7963000.0
7963,7963999,20.73501374903007,37.83393763700979,0.08036043549489702,2975.1106119155884,617.8261642456055,2293.916606903076,32484,7903,24581,24581,0,22,7964000.0
7964,7964999,20.73614119228709,37.837912263268336,0.08035606488676006,2975.4614284038544,617.893994808197,2294.2164268493652,32486,7904,24582,24582,0,22,7965000.0
7965,7965999,20.736956757907343,37.83915581015198,0.08033977069288023,2976.0129749774933,617.9619233608246,2293.677532196045,32488,7905,24583,24583,0,22,7966000.0
7966,7966999,20.73801001369065,37.84031753670019,0.0803350628049655,2976.438164949417,618.0306584835052,2293.6898078918457,32488,7905,24583,24583,0,22,7967000.0
7967,7967999,20.739216978689345,37.84317104077128,0.0803272359225401,2976.741704940796,618.1010518074036,2294.197910308838,32488,7905,24583,24583,0,22,7968000.0
7968,7968999,20.740173167962883,37.84440273184185,0.08030887242386386,2977.179693222046,618.1685128211975,2294.2645378112793,32490,7906,24584,24584,0,22,7969000.0
7969,7969999,20.740663228154375,37.845488281085466,0.08027265162417807,2977.5578966140747,618.2388074398041,2295.038730621338,32493,7907,24586,24586,0,22,7970000.0
7970,7970999,20.74064017030759,37.84508102583573,0.08026074726843069,2977.76372218132,618.3074371814728,2296.3455924987793,32494,7907,24587,24587,0,22,7971000.0
7971,7971999,20.74043593653059,37.84482603757178,0.08024632899548578,2978.268210887909,618.3793435096741,2296.2036170959473,32494,7907,24587,24587,0,22,7972000.0
7972,7972999,20.740221592858703,37.84372416083513,0.08023534741362215,2978.5767529010773,618.4471638202667,2296.832286834717,32494,7907,24587,24587,0,22,7973000.0
7973,7973999,20.739916446151092,37.8426184545044,0.08022778405067699,2978.9793808460236,618.5164279937744,2296.9514198303223,32496,7908,24588,24588,0,22,7974000.0
7974,7974999,20.73970580268822,37.841790949804455,0.0802209680581073,2979.5945575237274,618.5853617191315,2296.5195960998535,32502,7911,24591,24591,0,22,7975000.0
7975,7975999,20.739389939349785,37.84088453561245,0.08021717493505864,2980.0403497219086,618.652325630188,2296.6300086975098,32506,7913,24593,24593,0,22,7976000.0
7976,7976999,20.73899611827586,37.83977687779983,0.08021527575252341,2980.4279837608337,618.7231817245483,2296.737537384033,32506,7913,24593,24593,0,22,7977000.0
7977,7977999,20.738790109262364,37.84093280961878,0.0801994714811275,2980.720622777939,618.7924206256866,2297.2696800231934,32507,7913,24594,24594,0,22,7978000.0
7978,7978999,20.738435729917352,37.84004503092448,0.08019228281568158,2981.2002255916595,618.8608291149139,2297.0280418395996,32509,7914,24595,24595,0,22,7979000.0
7979,7979999,20.73796494882305,37.83873622376376,0.08018786906391961,2981.58638048172,618.9314434528351,2297.1951789855957,32509,7914,24595,24595,0,22,7980000.0
7980,7980999,20.73790482493261,37.838374884724665,0.08017878739111262,2981.940586090088,619.0013983249664,2297.5856971740723,32511,7915,24596,24596,0,22,7981000.0
7981,7981999,20.73781321556498,37.83927584684044,0.08017008645152635,2982.2342796325684,619.0692880153656,2298.00777053833,32511,7915,24596,24596,0,22,7982000.0
7982,7982999,20.737524997006194,37.83809786134842,0.08016544800050707,2982.4802601337433,619.1387484073639,2298.661647796631,32511,7915,24596,24596,0,22,7983000.0
7983,7983999,20.737455302362733,37.837565795932306,0.08015794346577354,2982.964406490326,619.2087378501892,2298.687656402588,32515,7917,24598,24598,0,22,7984000.0
7984,7984999,20.737347191438783,37.836721597047095,0.08014996953806075,2983.368857383728,619.2781398296356,2298.7554893493652,32516,7918,24598,24598,0,22,7985000.0
7985,7985999,20.737196464361535,37.835731366023374,0.08014291423370845,2983.957195520401,619.34987616539,2298.3552055358887,32520,7920,24600,24600,0,22,7986000.0
7986,7986999,20.736909082356327,37.83437694478301,0.0801391334635515,2984.532858133316,619.4199864864349,2297.769687652588,32522,7921,24601,24601,0,22,7987000.0
7987,7987999,20.73673649359878,37.83335766102324,0.08013575201565615,2984.9173934459686,619.492561340332,2297.8892402648926,32522,7921,24601,24601,0,22,7988000.0
7988,7988999,20.736373435263793,37.8321012407644,0.08013282214374184,2985.207976579666,619.5652511119843,2298.451198577881,32522,7921,24601,24601,0,22,7989000.0
7989,7989999,20.735989552624257,37.83079246448721,0.08012298273804497,2985.5890963077545,619.629825592041,2299.2482566833496,32536,7922,24614,24614,0,22,7990000.0
7990,7990999,20.735917451528536,37.83005134065702,0.08009471742232199,2985.9791774749756,619.6934418678284,2299.7219200134277,32538,7923,24615,24615,0,22,7991000.0
7991,7991999,20.73587233347762,37.82915468909041,0.08006569970645949,2986.314428806305,619.7567505836487,2300.1743812561035,32538,7923,24615,24615,0,22,7992000.0
7992,7992999,20.736281614054114,37.8288127699627,0.0800258310263281,2986.699933052063,619.8223321437836,2300.720127105713,32540,7924,24616,24616,0,22,7993000.0
7993,7993999,20.73689222798568,37.828748348667176,0.07998240800221457,2987.022425174713,619.8872127532959,2301.2711753845215,32540,7924,24616,24616,0,22,7994000.0
7994,7994999,20.73800314127292,37.82898036519737,0.07993066550487626,2987.6897978782654,619.9539561271667,2300.57084274292,32546,7927,24619,24619,0,22,7995000.0
7995,7995999,20.739111881399403,37.8292908353862,0.07988527046087945,2987.8546783924103,620.0197129249573,2301.7694664001465,32546,7927,24619,24619,0,22,7996000.0
7996,7996999,20.739837174593326,37.82907719555161,0.07984983460002737,2988.3913412094116,620.0844268798828,2301.804615020752,32554,7931,24623,24623,0,22,7997000.0
7997,7997999,20.740804423294296,37.82959089035849,0.07981151225602667,2988.986030817032,620.1488537788391,2301.6753883361816,32562,7935,24627,24627,0,22,7998000.0
7998,7998999,20.74146910767681,37.82951848700869,0.07978025589562221,2989.50248670578,620.2136132717133,2301.8719902038574,32568,7938,24630,24630,0,22,7999000.0
7999,7999999,20.74231105363571,37.82948848243726,0.07974297572711786,2989.7950406074524,620.2778415679932,2302.3753929138184,32568,7938,24630,24630,0,22,8000000.0
8000,8000999,20.743241927335795,37.82975900090889,0.07970323517662237,2990.3596107959747,620.3428406715393,2302.228199005127,32601,7940,24661,24661,0,22,8001000.0
8001,8001999,20.744204041414342,37.83025084593503,0.07965785372203682,2990.6471343040466,620.4063305854797,2302.852062225342,32601,7940,24661,24661,0,22,8002000.0
8002,8002999,20.745225134430214,37.8306597108753,0.0796191873715314,2991.0305490493774,620.4699213504791,2303.104763031006,32603,7941,24662,24662,0,22,8003000.0
8003,8003999,20.745946672567914,37.83049840639363,0.07957926860436426,2991.2360327243805,620.5328357219696,2303.844425201416,32603,7941,24662,24662,0,22,8004000.0
8004,8004999,20.746906659117005,37.830587032443866,0.07954005626911964,2991.5369243621826,620.5974853038788,2304.2359886169434,32603,7941,24662,24662,0,22,8005000.0
8005,8005999,20.74779252286136,37.830543925306124,0.07950716305293293,2992.0811698436737,620.6634833812714,2303.480945587158,32603,7941,24662,24662,0,22,8006000.0
8006,8006999,20.748536515784476,37.83028108254072,0.07947323158510633,2992.628570795059,620.7284791469574,2303.095691680908,32615,7942,24673,24673,0,22,8007000.0
8007,8007999,20.749356441255557,37.830063561374345,0.07943571394905546,2993.0145597457886,620.7938497066498,2303.3650093078613,32617,7943,24674,24674,0,22,8008000.0
8008,8008999,20.749918870538306,37.82942322353151,0.07940833943695547,2993.300805091858,620.8601775169373,2303.90767288208,32617,7943,24674,24674,0,22,8009000.0
8009,8009999,20.749759919805264,37.828320552235255,0.07939266085211494,2993.646061182022,620.9261548519135,2304.7522163391113,32619,7944,24675,24675,0,22,8010000.0
8010,8010999,20.74930422166775,37.82717274757194,0.07938715666100704,2993.990294456482,620.9922127723694,2305.564250946045,32621,7945,24676,24676,0,22,8011000.0
8011,8011999,20.748811991630944,37.8261207239435,0.07938593718214082,2994.375827550888,621.058821439743,2306.0017433166504,32623,7946,24677,24677,0,22,8012000.0
8012,8012999,20.748154277842662,37.824723160515894,0.07938675654876448,2994.8610079288483,621.1308963298798,2306.254909515381,32627,7948,24679,24679,0,22,8013000.0
8013,8013999,20.74754972259876,37.82347646990798,0.07938584441108842,2995.170720100403,621.1969327926636,2306.9029960632324,32629,7949,24680,24680,0,22,8014000.0
8014,8014999,20.746804364634652,37.822059661637304,0.07938775006638743,2995.5497086048126,621.2627477645874,2306.9010276794434,32630,7949,24681,24681,0,22,8015000.0
8015,8015999,20.746250508161644,37.82096692182746,0.07938516634022641,2996.030187368393,621.3301205635071,2306.8669471740723,32634,7951,24683,24683,0,22,8016000.0
8016,8016999,20.745852137297447,37.82021993691519,0.07938370496630709,2996.479483604431,621.3980255126953,2307.00248336792,32638,7953,24685,24685,0,22,8017000.0
8017,8017999,20.745443586603937,37.81924553146633,0.07937992931946203,2996.9993352890015,621.4648518562317,2306.8029747009277,32640,7954,24686,24686,0,22,8018000.0
8018,8018999,20.744994424052077,37.81834923681896,0.07937630191119494,2997.390159368515,621.5300600528717,2307.0629234313965,32642,7955,24687,24687,0,22,8019000.0
8019,8019999,20.744510436507284,37.817251277298794,0.0793775900219984,2997.9117209911346,621.596269607544,2307.040630340576,32672,7957,24715,24715,0,22,8020000.0
8020,8020999,20.74434148887002,37.81835674309079,0.0793668232056921,2998.4389963150024,621.6622474193573,2306.878604888916,32685,7959,24726,24726,0,22,8021000.0
8021,8021999,20.743726095391114,37.81690527496376,0.07936942029377347,2998.7261323928833,621.7289807796478,2307.3564109802246,32685,7959,24726,24726,0,22,8022000.0
8022,8022999,20.74359960524171,37.81858287306018,0.07935984869342616,2999.1269252300262,633.2989201545715,2307.639263153076,32687,7960,24727,24727,0,22,8023000.0
8023,8023999,20.743318353322312,37.817871047454,0.07935672176043851,2999.4845004081726,633.3688502311707,2307.937641143799,32687,7960,24727,24727,0,22,8024000.0
8024,8024999,20.742751217435696,37.81639123086304,0.07936342675158636,2999.8267438411713,633.4349377155304,2308.1984062194824,32687,7960,24727,24727,0,22,8025000.0
8025,8025999,20.742377452302527,37.81590534297322,0.07936142646878896,3000.2421498298645,633.498368024826,2308.8427696228027,32689,7961,24728,24728,0,22,8026000.0
8026,8026999,20.7418907960159,37.81518627879302,0.0793600914911482,3000.710991382599,633.5697019100189,2309.2972450256348,32693,7963,24730,24730,0,22,8027000.0
8027,8027999,20.74124991086306,37.814247714039226,0.07935843752647076,3001.0128679275513,633.6359312534332,2310.099842071533,32696,7964,24732,24732,0,22,8028000.0
8028,8028999,20.74052304182486,37.812977007118704,0.07936145834176378,3001.420933008194,633.7027659416199,2310.2673835754395,32698,7965,24733,24733,0,22,8029000.0
8029,8029999,20.73999156216543,37.81204622394381,0.0793604916542402,3001.7447538375854,633.7728073596954,2310.651424407959,32698,7965,24733,24733,0,22,8030000.0
8030,8030999,20.739281357617227,37.81066131105921,0.07936217979861127,3002.1837561130524,633.837569475174,2310.628086090088,32700,7966,24734,24734,0,22,8031000.0
8031,8031999,20.738903113376185,37.81059145523197,0.07935274777189671,3002.378837585449,633.9025917053223,2311.4902992248535,32700,7966,24734,24734,0,22,8032000.0
8032,8032999,20.73877815051275,37.81075101236667,0.07934259837726187,3002.796924352646,633.9674344062805,2311.3829612731934,32700,7966,24734,24734,0,22,8033000.0
8033,8033999,20.738707276345448,37.810911073928885,0.07933486905067855,3003.2341940402985,634.0312912464142,2311.267017364502,32702,7967,24735,24735,0,22,8034000.0
8034,8034999,20.738678765068478,37.810632992578526,0.07932650103894967,3003.5160143375397,634.0962264537811,2311.8433876037598,32702,7967,24735,24735,0,22,8035000.0
8035,8035999,20.73886693082991,37.81102560930437,0.0793191917068583,3003.87806224823,634.1615586280823,2311.990032196045,32702,7967,24735,24735,0,22,8036000.0
8036,8036999,20.739243256040538,37.811275791537156,0.07931195771478283,3004.359094619751,634.2261724472046,2311.9813346862793,32715,7969,24746,24746,0,22,8037000.0
8037,8037999,20.739770420861987,37.81202412316484,0.07930235675561403,3004.868292093277,634.2920866012573,2311.6890144348145,32731,7970,24761,24761,0,22,8038000.0
8038,8038999,20.74095779418607,37.814864793232644,0.07928689708808734,3005.200450897217,634.3582122325897,2312.160846710205,32731,7970,24761,24761,0,22,8039000.0
8039,8039999,20.74168318182796,37.81569088951749,0.07928007892613742,3005.6375403404236,634.4253540039062,2312.3570823669434,32733,7971,24762,24762,0,22,8040000.0
8040,8040999,20.742791801586822,37.81717068585762,0.07927393554377771,3005.929655313492,634.4903547763824,2313.0917167663574,32735,7972,24763,24763,0,22,8041000.0
8041,8041999,20.7436331142114,37.817895613026224,0.07926987520007178,3006.428344488144,634.5546867847443,2312.595561981201,32735,7972,24763,24763,0,22,8042000.0
8042,8042999,20.744357487427166,37.81841451499124,0.07926293519380045,3006.7192521095276,634.6185383796692,2313.162654876709,32735,7972,24763,24763,0,22,8043000.0
8043,8043999,20.744984193086562,37.81864545183734,0.07923935607270305,3007.188379049301,634.686674118042,2313.403781890869,32737,7973,24764,24764,0,22,8044000.0
8044,8044999,20.745822377425327,37.82110031595103,0.07919919457600522,3007.60716176033,634.7540767192841,2313.827251434326,32740,7974,24766,24766,0,22,8045000.0
8045,8045999,20.746052824061312,37.82179857606215,0.07917062993318813,3008.228291273117,634.821852684021,2313.5609169006348,32746,7977,24769,24769,0,22,8046000.0
8046,8046999,20.74627640681711,37.82312673549131,0.07914317243560687,3008.494106054306,634.8905746936798,2314.2931938171387,32746,7977,24769,24769,0,22,8047000.0
8047,8047999,20.74626208705964,37.82282969148433,0.07912528181965717,3009.056289434433,634.963216304779,2314.186664581299,32752,7980,24772,24772,0,22,8048000.0
8048,8048999,20.746095710147078,37.82196627293306,0.07911592329456285,3009.455729484558,635.0320258140564,2314.381259918213,32754,7981,24773,24773,0,22,8049000.0
8049,8049999,20.74587482543945,37.82121199136028,0.07910872636857191,3009.7889943122864,635.1004173755646,2314.728168487549,32755,7981,24774,24774,0,22,8050000.0
8050,8050999,20.745792565770696,37.82051688673665,0.07910337067087325,3010.2469918727875,635.1704618930817,2314.8414192199707,32759,7983,24776,24776,0,22,8051000.0
8051,8051999,20.745667960564305,37.82004089980928,0.0790949999331968,3010.5824389457703,635.2377452850342,2315.1263389587402,32759,7983,24776,24776,0,22,8052000.0
8052,8052999,20.7454532758068,37.81965331903319,0.07909033870481685,3011.000930070877,635.3042769432068,2315.1105613708496,32761,7984,24777,24777,0,22,8053000.0
8053,8053999,20.745333156450396,37.819192542471,0.0790859833834674,3011.287709236145,635.3727803230286,2315.664806365967,32761,7984,24777,24777,0,22,8054000.0
8054,8054999,20.74541217944862,37.81947237763713,0.07908025042907185,3011.6348037719727,635.4388258457184,2315.9211235046387,32763,7985,24778,24778,0,22,8055000.0
8055,8055999,20.745684967775816,37.81982952178307,0.07907784566313036,3012.1642773151398,635.5100100040436,2315.594867706299,32765,7986,24779,24779,0,22,8056000.0
8056,8056999,20.745885949410813,37.81965128616154,0.07907578151544525,3012.4931020736694,635.5784583091736,2315.8066902160645,32765,7986,24779,24779,0,22,8057000.0
8057,8057999,20.746294602094046,37.819944085407556,0.07906950845358984,3013.0618855953217,635.64701795578,2315.457592010498,32776,7988,24788,24788,0,22,8058000.0
8058,8058999,20.746907143149425,37.82151611995994,0.07906519411164792,3013.6765954494476,635.7163650989532,2314.800395965576,32778,7989,24789,24789,0,22,8059000.0
8059,8059999,20.747789973653983,37.824527502143745,0.0790541271044749,3013.8756337165833,635.7834906578064,2315.744731903076,32778,7989,24789,24789,0,22,8060000.0
8060,8060999,20.74832978829342,37.82493697351308,0.07905265865421163,3014.2857160568237,635.8517405986786,2315.534610748291,32778,7989,24789,24789,0,22,8061000.0
8061,8061999,20.748889281766267,37.82518486387547,0.07904868898048667,3014.653483390808,635.9270770549774,2315.7633171081543,32778,7989,24789,24789,0,22,8062000.0
8062,8062999,20.74894277729325,37.82462912127985,0.0790445032602004,3015.053305864334,635.9996106624603,2315.9970512390137,32780,7990,24790,24790,0,22,8063000.0
8063,8063999,20.749738208072454,37.82544213350667,0.0790034292455375,3015.452662229538,636.0649347305298,2316.668109893799,32782,7990,24792,24792,0,22,8064000.0
8064,8064999,20.750621104361656,37.82661709788223,0.07896455528080515,3015.885318994522,636.1274094581604,2317.1514625549316,32787,7992,24795,24795,0,22,8065000.0
8065,8065999,20.75128087042644,37.82727166755534,0.07891487033931355,3016.0928571224213,636.190479516983,2318.190891265869,32787,7992,24795,24795,0,22,8066000.0
8066,8066999,20.751932855871086,37.8273311323119,0.07888116027001801,3016.58358001709,636.254504442215,2318.2374839782715,32792,7994,24798,24798,0,22,8067000.0
8067,8067999,20.75287184264929,37.82818782109471,0.07885647454249134,3016.769715309143,636.3170208930969,2319.224452972412,32792,7994,24798,24798,0,22,8068000.0
8068,8068999,20.754131159152397,37.83043456783837,0.07882638981365775,3017.0129568576813,636.3799691200256,2319.863796234131,32792,7994,24798,24798,0,22,8069000.0
8069,8069999,20.755812536793893,37.8333911324187,0.07881502831031917,3017.3526804447174,636.4419491291046,2320.138599395752,32794,7995,24799,24799,0,22,8070000.0
8070,8070999,20.757391543250222,37.836407773561874,0.07880453354333405,3018.0648186206818,636.506023645401,2319.4491996765137,32802,7999,24803,24803,0,22,8071000.0
8071,8071999,20.75950480666413,37.84123530441439,0.07879667022619485,3018.5004076957703,636.5698616504669,2319.4981803894043,32804,8000,24804,24804,0,22,8072000.0
8072,8072999,20.761874109831606,37.84627858318232,0.078805323740338,3018.7490224838257,636.6347467899323,2320.2431297302246,32804,8000,24804,24804,0,22,8073000.0
8073,8073999,20.764270750880424,37.851012323758326,0.07882964061730613,3019.4363718032837,636.6993522644043,2319.6823387145996,32812,8004,24808,24808,0,22,8074000.0
8074,8074999,20.766310280778914,37.85525218831832,0.07884992995253604,3019.782378435135,636.7627139091492,2320.126079559326,32814,8005,24809,24809,0,22,8075000.0
8075,8075999,20.768709245811518,37.86057235202308,0.07888640911086897,3020.164202451706,636.8283150196075,2320.455249786377,32817,8006,24811,24811,0,22,8076000.0
8076,8076999,20.771342078797765,37.86743151945093,0.07891238134671474,3020.67529463768,636.8962433338165,2320.0313987731934,32817,8006,24811,24811,0,22,8077000.0
8077,8077999,20.774056116955027,37.87263863846575,0.07897722769199422,3020.972775697708,636.9588499069214,2320.501247406006,32817,8006,24811,24811,0,22,8078000.0
8078,8078999,20.7772493926959,37.8814182138402,0.07902633613021015,3021.4464337825775,637.0238964557648,2320.3742713928223,32819,8007,24812,24812,0,22,8079000.0
8079,8079999,20.780705644535047,37.88859968503937,0.07908009431459195,3021.726449728012,637.0888776779175,2320.9775581359863,32820,8007,24813,24813,0,22,8080000.0
8080,8080999,20.78219373384788,37.88985491943262,0.07908680282454073,3022.126381635666,637.1535124778748,2321.451160430908,32822,8008,24814,24814,0,22,8081000.0
8081,8081999,20.78322542197809,37.89282340247662,0.07907004114866945,3022.7502434253693,637.2180068492889,2320.855297088623,32825,8009,24816,24816,0,22,8082000.0
8082,8082999,20.784196191217855,37.89489000421841,0.07904897951147205,3023.245864391327,637.2830362319946,2320.9053688049316,32828,8011,24817,24817,0,22,8083000.0
8083,8083999,20.78523805591086,37.89740723218749,0.07902183281081254,3023.546226501465,637.3485867977142,2321.479877471924,32829,8011,24818,24818,0,22,8084000.0
8084,8084999,20.78599246424546,37.89871756092112,0.07901694901275269,3024.064335823059,637.4123797416687,2321.321346282959,32833,8013,24820,24820,0,22,8085000.0
8085,8085999,20.78673160001928,37.90069232024358,0.07900212524259098,3024.457854986191,637.4760739803314,2321.740322113037,32836,8015,24821,24821,0,22,8086000.0
8086,8086999,20.787361426677535,37.90142385193854,0.07900106418558217,3024.882264852524,637.5409605503082,2321.9982566833496,32840,8017,24823,24823,0,22,8087000.0
8087,8087999,20.787980929737074,37.90201384917465,0.07899632651653288,3025.0767681598663,637.6053309440613,2322.8818702697754,32840,8017,24823,24823,0,22,8088000.0
8088,8088999,20.788791969639945,37.90280480761885,0.07900682363974099,3025.4426646232605,637.6712222099304,2322.9445838928223,32840,8017,24823,24823,0,22,8089000.0
8089,8089999,20.78987962556758,37.904502568325555,0.07900918179966776,3025.803694009781,637.7362861633301,2323.203998565674,32842,8018,24824,24824,0,22,8090000.0
8090,8090999,20.790953120652276,37.90616686700662,0.07901762480391172,3026.3373465538025,637.8030626773834,2322.4791374206543,32842,8018,24824,24824,0,22,8091000.0
8091,8091999,20.792374126178583,37.91079532717678,0.07901420424403405,3026.704862356186,637.8693549633026,2322.556484222412,32842,8018,24824,24824,0,22,8092000.0
8092,8092999,20.793318816852157,37.91176538289362,0.07901453559873217,3027.1395978927612,637.9352312088013,2322.539821624756,32842,8018,24824,24824,0,22,8093000.0
8093,8093999,20.794589234359783,37.914401739809904,0.07901998942584054,3027.3972597122192,638.0000932216644,2323.092128753662,32842,8018,24824,24824,0,22,8094000.0
8094,8094999,20.796260452819165,37.91772274420378,0.07902979196457338,3027.7406294345856,638.0637402534485,2323.3644218444824,32844,8019,24825,24825,0,22,8095000.0
8095,8095999,20.798013582336914,37.92190009140673,0.07902897645362106,3028.0824851989746,638.1309676170349,2323.548442840576,32844,8019,24825,24825,0,22,8096000.0
8096,8096999,20.799845308497567,37.92569698770119,0.0790314049490094,3028.6850385665894,638.1957926750183,2323.1615562438965,32858,8021,24837,24837,0,22,8097000.0
8097,8097999,20.80133700498696,37.92834564674941,0.0790381177925239,3029.0074548721313,638.2691957950592,2323.7935523986816,32860,8022,24838,24838,0,22,8098000.0
8098,8098999,20.802948159090317,37.93101897967723,0.07905536578084194,3029.2568814754486,638.3324778079987,2324.350803375244,32860,8022,24838,24838,0,22,8099000.0
8099,8099999,20.80416488257973,37.93237128955345,0.07903717963854628,3029.7047979831696,638.397941827774,2324.535556793213,32862,8023,24839,24839,0,22,8100000.0
8100,8100999,20.803806439846806,37.93145272546332,0.0790260395630985,3029.9940097332,638.4668934345245,2325.4272422790527,32862,8023,24839,24839,0,22,8101000.0
8101,8101999,20.803642097825666,37.93116819259568,0.07901332494588942,3030.4270479679108,638.5345568656921,2325.743869781494,32874,8024,24850,24850,0,22,8102000.0
8102,8102999,20.803568886498205,37.93098487292511,0.0789984417579741,3030.7349996566772,638.6020741462708,2326.3460426330566,32875,8024,24851,24851,0,22,8103000.0
8103,8103999,20.803492572096616,37.93027186088773,0.07898838007082609,3031.0333919525146,638.6690123081207,2326.8642234802246,32875,8024,24851,24851,0,22,8104000.0
8104,8104999,20.803354207976014,37.9297477260994,0.07897789739111283,3031.4094367027283,638.7438042163849,2327.164333343506,32875,8024,24851,24851,0,22,8105000.0
8105,8105999,20.803131363202613,37.92936637865661,0.07896602248943041,3031.7603390216827,638.8121376037598,2327.601016998291,32877,8025,24852,24852,0,22,8106000.0
8106,8106999,20.803031560024195,37.92837566792115,0.07895813015002218,3032.3393042087555,638.8809103965759,2327.199390411377,32882,8027,24855,24855,0,22,8107000.0
8107,8107999,20.80302976297409,37.928132280186006,0.07894776986797569,3032.68706035614,638.9499983787537,2327.5930366516113,32883,8028,24855,24855,0,22,8108000.0
8108,8108999,20.802844896568573,37.92714268880519,0.0789426331831472,3033.0638291835785,639.0203442573547,2327.987003326416,32884,8029,24855,24855,0,22,8109000.0
8109,8109999,20.802813286591945,37.92660090819131,0.07893378501632553,3033.402442932129,639.0896792411804,2328.284107208252,32884,8029,24855,24855,0,22,8110000.0
8110,8110999,20.802925778976263,37.92610989971979,0.07892753004223152,3033.8442599773407,639.1597006320953,2328.1563301086426,32885,8029,24856,24856,0,22,8111000.0
8111,8111999,20.80304179830021,37.9256732151429,0.07891951408590758,3034.190112352371,639.2282326221466,2328.448040008545,32886,8029,24857,24857,0,22,8112000.0
8112,8112999,20.803273195939678,37.92556660009894,0.07891309542076685,3034.4528591632843,639.298572063446,2329.1077461242676,32886,8029,24857,24857,0,22,8113000.0
8113,8113999,20.803361449558324,37.925007313424736,0.07890781692292592,3034.792191505432,639.3667891025543,2329.290470123291,32886,8029,24857,24857,0,22,8114000.0
8114,8114999,20.803621304915048,37.92463090320864,0.07890246028224135,3035.3241198062897,639.435962677002,2328.8593101501465,32889,8030,24859,24859,0,22,8115000.0
8115,8115999,20.803958578990198,37.92424788099529,0.07889717619572645,3035.9349541664124,639.5067880153656,2328.198513031006,32892,8032,24860,24860,0,22,8116000.0
8116,8116999,20.804447260821888,37.925310640822836,0.07888600889681785,3036.3361716270447,639.579606294632,2328.9527168273926,32907,8034,24873,24873,0,22,8117000.0
8117,8117999,20.804571507983475,37.924519342076,0.0788840027731571,3036.538100004196,639.6483871936798,2330.039463043213,32908,8034,24874,24874,0,22,8118000.0
8118,8118999,20.804778982844685,37.923935640452385,0.07888112232221167,3036.8714985847473,639.7175793647766,2330.3347358703613,32908,8034,24874,24874,0,22,8119000.0
8119,8119999,20.804846144118674,37.92541335262708,0.07886611319560055,3037.135349035263,639.7855079174042,2331.2532844543457,32908,8034,24874,24874,0,22,8120000.0
8120,8120999,20.804112504074446,37.92434598066034,0.07885973486222009,3037.521946668625,639.8456881046295,2331.661205291748,32910,8035,24875,24875,0,22,8121000.0
8121,8121999,20.80350719778045,37.92372667866793,0.07884925616104721,3037.7596142292023,639.9071474075317,2332.5318489074707,32910,8035,24875,24875,0,22,8122000.0
8122,8122999,20.803094390521146,37.92262777753355,0.07884566591085929,3038.287940979004,639.9690215587616,2332.3693199157715,32913,8036,24877,24877,0,22,8123000.0
8123,8123999,20.8028159702237,37.92167800194227,0.07883760377876325,3038.5846433639526,640.0341811180115,2333.1661643981934,32915,8037,24878,24878,0,22,8124000.0
8124,8124999,20.802632574628067,37.92089317797248,0.07882933849221707,3038.866584300995,640.0964229106903,2333.955135345459,32927,8038,24889,24889,0,22,8125000.0
8125,8125999,20.80277554651025,37.92188933327638,0.0788141206093751,3039.388947725296,640.1597237586975,2333.531467437744,32929,8039,24890,24890,0,22,8126000.0
8126,8126999,20.802432162517132,37.92081292265005,0.07880951193263341,3039.7673857212067,640.2241621017456,2333.688648223877,32929,8039,24890,24890,0,22,8127000.0
8127,8127999,20.80228269904411,37.92031988478997,0.07880048383076,3040.0021946430206,640.2860963344574,2334.4185218811035,32930,8039,24891,24891,0,22,8128000.0
8128,8128999,20.802353249762646,37.91982814542415,0.07878739540036495,3040.2471528053284,640.3479082584381,2335.3001594543457,32932,8040,24892,24892,0,22,8129000.0
8129,8129999,20.802147722245515,37.91874669674602,0.07877912035728207,3040.7210869789124,640.4108543395996,2335.297031402588,32944,8042,24902,24902,0,22,8130000.0
8130,8130999,20.80242487942354,37.91903610920091,0.0787672399032554,3041.2534952163696,640.4736194610596,2334.93989944458,32946,8043,24903,24903,0,22,8131000.0
8131,8131999,20.802649318803688,37.92131919385372,0.07875117527627407,3041.6298072338104,640.5405204296112,2335.2758750915527,32948,8044,24904,24904,0,22,8132000.0
8132,8132999,20.802796713481438,37.920840812138636,0.07874178237690177,3042.1589624881744,640.6052343845367,2335.0115852355957,32950,8045,24905,24905,0,22,8133000.0
8133,8133999,20.802865116584435,37.92034412208097,0.07874025836261311,3042.5228683948517,640.6710941791534,2335.1783332824707,32950,8045,24905,24905,0,22,8134000.0
8134,8134999,20.802997979424187,37.91979860860076,0.07873638275721806,3042.776504278183,640.7354636192322,2335.902156829834,32950,8045,24905,24905,0,22,8135000.0
8135,8135999,20.80331555532848,37.91965006354229,0.07872731519720555,3043.0666551589966,640.7981433868408,2336.288761138916,32950,8045,24905,24905,0,22,8136000.0
8136,8136999,20.803652497776643,37.919355971933406,0.07872583514934417,3043.3445370197296,640.8614912033081,2336.7468070983887,32950,8045,24905,24905,0,22,8137000.0
8137,8137999,20.80387876121246,37.9188396358118,0.07872177889887466,3043.869130373001,640.92711353302,2336.5309867858887,32954,8047,24907,24907,0,22,8138000.0
8138,8138999,20.804160392423753,37.91832340214769,0.07871844663116867,3044.163158893585,640.9908723831177,2337.115467071533,32957,8048,24909,24909,0,22,8139000.0
8139,8139999,20.80407183738571,37.917379548664876,0.0787144920011108,3044.8672726154327,641.0539796352386,2336.4330101013184,32965,8052,24913,24913,0,22,8140000.0
8140,8140999,20.804548887797953,37.91714484466261,0.07868947144382987,3045.2544820308685,641.121479511261,2337.055187225342,32965,8052,24913,24913,0,22,8141000.0
8141,8141999,20.80501627340752,37.91714406623481,0.07865889681089178,3045.657846927643,641.1906547546387,2337.550037384033,32967,8053,24914,24914,0,22,8142000.0
8142,8142999,20.805417206744398,37.91722304579916,0.07862206974800445,3045.958994626999,641.255692243576,2338.3137245178223,32967,8053,24914,24914,0,22,8143000.0
8143,8143999,20.805459870359584,37.91673476377766,0.07859890248883494,3046.32075881958,641.3244559764862,2338.7105674743652,32969,8054,24915,24915,0,22,8144000.0
8144,8144999,20.80564837726451,37.917088643810246,0.07857269881622242,3046.5883510112762,641.3914759159088,2339.3687705993652,32969,8054,24915,24915,0,22,8145000.0
8145,8145999,20.8058841336708,37.916906346204314,0.07854487196147086,3046.9795892238617,641.459193944931,2339.506130218506,32972,8055,24917,24917,0,22,8146000.0
8146,8146999,20.80612671647165,37.91684666311523,0.07851886874231873,3047.4730281829834,641.526261806488,2339.456775665283,32976,8057,24919,24919,0,22,8147000.0
8147,8147999,20.806209379030946,37.91649282333713,0.0785012870220193,3047.7731046676636,641.5937039852142,2340.001682281494,32976,8057,24919,24919,0,22,8148000.0
8148,8148999,20.806563929614114,37.91667117887127,0.07849572886772993,3048.317646741867,641.6614854335785,2339.8634071350098,32981,8060,24921,24921,0,22,8149000.0
8149,8149999,20.80692936279059,37.91707611171406,0.07849532216649169,3048.71640253067,641.7310767173767,2340.036205291748,32981,8060,24921,24921,0,22,8150000.0
8150,8150999,20.807346688902353,37.91779384261566,0.07848165542915397,3049.2106812000275,641.8002505302429,2339.9196434020996,32985,8062,24923,24923,0,22,8151000.0
8151,8151999,20.80782478218948,37.91861812880147,0.07848046576130896,3049.6387057304382,641.8688611984253,2339.918514251709,32985,8062,24923,24923,0,22,8152000.0
8152,8152999,20.808199664596234,37.92010678400038,0.07848316743307515,3050.09290266037,641.938441991806,2339.828540802002,32986,8063,24923,24923,0,22,8153000.0
8153,8153999,20.80873996304152,37.9217102640945,0.07849384088581102,3050.4771823883057,642.0066609382629,2340.0983390808105,32988,8064,24924,24924,0,22,8154000.0
8154,8154999,20.809728074281978,37.92319533534808,0.07851618377860081,3050.737524986267,642.0756666660309,2340.8454780578613,32988,8064,24924,24924,0,22,8155000.0
8155,8155999,20.81029992998134,37.92350340621963,0.07852535294780172,3051.090547800064,642.1440258026123,2341.0404472351074,32988,8064,24924,24924,0,22,8156000.0
8156,8156999,20.810670416555023,37.92361812222622,0.07853479513747896,3051.595896244049,642.2115807533264,2341.1943397521973,32992,8066,24926,24926,0,22,8157000.0
8157,8157999,20.811588595594653,37.92537922803329,0.07849757580011352,3051.8307898044586,642.2747075557709,2342.2942390441895,32993,8066,24927,24927,0,22,8158000.0
8158,8158999,20.812866342221835,37.92995624930273,0.07845909242178939,3052.264839887619,642.3378279209137,2342.6608924865723,33005,8067,24938,24938,0,22,8159000.0
8159,8159999,20.813859026277505,37.93159032598773,0.07843262017457475,3052.6201379299164,642.4020335674286,2343.0302543640137,33005,8067,24938,24938,0,22,8160000.0
8160,8160999,20.814928322088655,37.93258538634027,0.07839856369176124,3053.0387341976166,642.4666607379913,2343.3823890686035,33009,8069,24940,24940,0,22,8161000.0
8161,8161999,20.815630290149155,37.93293980908005,0.07837883527995226,3053.4127933979034,642.5316805839539,2343.7700538635254,33011,8070,24941,24941,0,22,8162000.0
8162,8162999,20.81650849405661,37.933579214562954,0.0783527440218188,3053.662882566452,642.5956449508667,2344.5186882019043,33011,8070,24941,24941,0,22,8163000.0
8163,8163999,20.817468892694322,37.934849775926,0.07832265121821025,3053.942212820053,642.6587107181549,2345.0815238952637,33012,8070,24942,24942,0,22,8164000.0
8164,8164999,20.818397779256408,37.93557448860048,0.07830188670000016,3054.4705169200897,642.7228600978851,2344.8358039855957,33016,8072,24944,24944,0,22,8165000.0
8165,8165999,20.81910779719036,37.936122096138554,0.0782817582984845,3054.817440509796,642.7876234054565,2345.2219276428223,33018,8073,24945,24945,0,22,8166000.0
8166,8166999,20.820393039460207,37.941428812521764,0.07825027776328464,3055.418293952942,642.8517525196075,2344.8533363342285,33024,8076,24948,24948,0,22,8167000.0
8167,8167999,20.821898158146368,37.94454338230353,0.07822720687822649,3055.793755054474,642.9169113636017,2345.2192573547363,33027,8077,24950,24950,0,22,8168000.0
8168,8168999,20.823602223500817,37.94795795950062,0.07821004498695139,3056.2644834518433,642.9819447994232,2345.0371589660645,33029,8078,24951,24951,0,22,8169000.0
8169,8169999,20.8253245725771,37.95109849899617,0.07820952883865318,3056.717028617859,643.0512537956238,2345.091785430908,33031,8079,24952,24952,0,22,8170000.0
8170,8170999,20.827710029008593,37.95794093493061,0.07820249832755866,3057.0009026527405,643.1160190105438,2345.6006813049316,33031,8079,24952,24952,0,22,8171000.0
8171,8171999,20.82966913512308,37.96141718110751,0.07820561867083275,3057.258148908615,643.1801652908325,2346.268268585205,33033,8080,24953,24953,0,22,8172000.0
8172,8172999,20.831421963485866,37.96492282804684,0.07820632333887911,3057.695450782776,643.2450084686279,2346.2614402770996,33037,8082,24955,24955,0,22,8173000.0
8173,8173999,20.83286014678368,37.96761414635619,0.0782105218806266,3058.165824174881,643.3099706172943,2346.018939971924,33039,8083,24956,24956,0,22,8174000.0
8174,8174999,20.83397641093661,37.969253771987304,0.07820303126394712,3058.461682319641,643.3747217655182,2347.031078338623,33041,8084,24957,24957,0,22,8175000.0
8175,8175999,20.83464821236759,37.97003357165254,0.07815788229845111,3058.852877140045,643.4421651363373,2347.4590492248535,33043,8085,24958,24958,0,22,8176000.0
8176,8176999,20.834776092853524,37.96940782230511,0.07814368910396452,3059.351718902588,643.5088548660278,2347.374210357666,33047,8087,24960,24960,0,22,8177000.0
8177,8177999,20.834883051635426,37.96940896677613,0.07813221085827926,3059.8546154499054,643.5769431591034,2347.4839515686035,33051,8089,24962,24962,0,22,8178000.0
8178,8178999,20.835005731507874,37.96903813014403,0.07812187502813683,3060.107745885849,643.6429221630096,2348.2056007385254,33051,8089,24962,24962,0,22,8179000.0
8179,8179999,20.8350983339023,37.969352730575935,0.07811150914718779,3060.5540657043457,643.7114582061768,2348.1248664855957,33053,8090,24963,24963,0,22,8180000.0
8180,8180999,20.835266801792407,37.96910997919097,0.07810265544390027,3060.9350447654724,643.7807257175446,2348.2917671203613,33053,8090,24963,24963,0,22,8181000.0
8181,8181999,20.835657632827708,37.96903363935923,0.07809410241945047,3061.281219959259,643.8483505249023,2348.7005348205566,33054,8091,24963,24963,0,22,8182000.0
8182,8182999,20.836332474356645,37.96956533985585,0.07808650116611726,3061.757835149765,643.9175553321838,2348.5096855163574,33056,8092,24964,24964,0,22,8183000.0
8183,8183999,20.83724323536564,37.97086122501446,0.07808450244975429,3062.1649906635284,643.9885427951813,2348.6828117370605,33056,8092,24964,24964,0,22,8184000.0
8184,8184999,20.838312443957815,37.97221288604447,0.07808623507670409,3062.566001176834,644.058596611023,2348.764377593994,33056,8092,24964,24964,0,22,8185000.0
8185,8185999,20.839114710501327,37.973028261924775,0.0780919308745831,3062.830062389374,644.1282188892365,2349.3591117858887,33056,8092,24964,24964,0,22,8186000.0
8186,8186999,20.840328801270662,37.97441213497273,0.07810027479192416,3063.294649362564,644.2002925872803,2349.2208213806152,33057,8093,24964,24964,0,22,8187000.0
8187,8187999,20.841769386170863,37.976195641918544,0.07810742723240949,3063.807790994644,644.2741091251373,2348.926113128662,33058,8094,24964,24964,0,22,8188000.0
8188,8188999,20.84339120506358,37.97821314992145,0.07812005408058598,3064.1885685920715,644.3448901176453,2349.3599128723145,33060,8095,24965,24965,0,22,8189000.0
8189,8189999,20.844708186198176,37.97949735990075,0.07813502269339012,3064.6539776325226,644.4171149730682,2349.278102874756,33072,8096,24976,24976,0,22,8190000.0
8190,8190999,20.846415175105268,37.982260801367055,0.07816142746581889,3065.058295249939,644.4881167411804,2349.375545501709,33074,8097,24977,24977,0,22,8191000.0
8191,8191999,20.848327502106592,37.98489478097111,0.07819174002636275,3065.6523785591125,644.5582845211029,2348.9248390197754,33078,8099,24979,24979,0,22,8192000.0
8192,8192999,20.850133547597558,37.98878474888653,0.07822159890186209,3066.107281446457,644.6321513652802,2348.9332313537598,33079,8100,24979,24979,0,22,8193000.0
8193,8193999,20.85153922074794,37.98988565463325,0.07824422816535737,3066.4301295280457,644.7048237323761,2349.369197845459,33079,8100,24979,24979,0,22,8194000.0
8194,8194999,20.852475227997544,37.99109310829283,0.07822792923170507,3066.956322669983,644.7744877338409,2349.405200958252,33095,8101,24994,24994,0,22,8195000.0
8195,8195999,20.852921705578762,37.99210420805313,0.07819596653858496,3067.1937894821167,644.836550951004,2350.49507522583,33097,8101,24996,24996,0,22,8196000.0
8196,8196999,20.853166349394836,37.99253273923972,0.07816252927836786,3067.6244580745697,644.8984336853027,2350.8208351135254,33101,8103,24998,24998,0,22,8197000.0
8197,8197999,20.853593952011494,37.99239775899561,0.07811913646962676,3067.8755674362183,644.9611570835114,2351.582057952881,33101,8103,24998,24998,0,22,8198000.0
8198,8198999,20.853864211267343,37.992046384139115,0.07808976168519277,3068.2680060863495,645.0230939388275,2351.992778778076,33105,8105,25000,25000,0,22,8199000.0
8199,8199999,20.854396697542736,37.9918200136698,0.07805861804652503,3068.622653245926,645.0865550041199,2352.451946258545,33109,8107,25002,25002,0,22,8200000.0
8200,8200999,20.85428027956606,37.99076692206073,0.07804358216970508,3069.2184727191925,645.1523134708405,2352.1286811828613,33115,8110,25005,25005,0,22,8201000.0
8201,8201999,20.854398937332686,37.99245009854267,0.07802061303131402,3069.870733499527,645.2179827690125,2351.57426071167,33121,8113,25008,25008,0,22,8202000.0
8202,8202999,20.854249604976026,37.99154451687848,0.07800981280002439,3070.2952783107758,645.2820873260498,2351.7049522399902,33124,8114,25010,25010,0,22,8203000.0
8203,8203999,20.854320414409045,37.9910495656045,0.0779998098578355,3070.6854462623596,645.3474276065826,2352.0599479675293,33128,8116,25012,25012,0,22,8204000.0
8204,8204999,20.854390346990506,37.99065931796624,0.07799019643965877,3071.104078054428,645.4099946022034,2352.200008392334,33130,8117,25013,25013,0,22,8205000.0
8205,8205999,20.854536741545438,37.99032237218356,0.07797982749574561,3071.5795588493347,645.474000453949,2352.1210899353027,33141,8118,25023,25023,0,22,8206000.0
8206,8206999,20.854839605279746,37.99032858848902,0.07797205507131144,3071.7604520320892,645.5371911525726,2353.062358856201,33141,8118,25023,25023,0,22,8207000.0
8207,8207999,20.855343521364183,37.99324682138505,0.07794738717795235,3072.2930471897125,645.6019673347473,2352.968982696533,33157,8121,25036,25036,0,22,8208000.0
8208,8208999,20.8556700535451,37.99312100528318,0.07793320997473818,3072.678436756134,645.6658565998077,2353.2146339416504,33159,8122,25037,25037,0,22,8209000.0
8209,8209999,20.85601809373546,37.99320484139168,0.07792537330879801,3073.0844910144806,645.7310507297516,2353.1834144592285,33159,8122,25037,25037,0,22,8210000.0
8210,8210999,20.856413170105697,37.99308933036669,0.07791241422669881,3073.415690422058,645.7972731590271,2353.5440788269043,33159,8122,25037,25037,0,22,8211000.0
8211,8211999,20.85685695418372,37.992906572797494,0.07790327927556451,3073.6645913124084,645.8621942996979,2354.1733436584473,33159,8122,25037,25037,0,22,8212000.0
8212,8212999,20.856956316842453,37.99238499248421,0.07789408384704932,3074.2821209430695,645.9276728630066,2353.413829803467,33163,8124,25039,25039,0,22,8213000.0
8213,8213999,20.857039892407112,37.99162557374748,0.0778877426458423,3074.840705871582,645.9960610866547,2353.2007637023926,33167,8126,25041,25041,0,22,8214000.0
8214,8214999,20.85730433416972,37.99172179524039,0.07786526201597976,3075.223059654236,646.0603342056274,2353.8013801574707,33169,8127,25042,25042,0,22,8215000.0
8215,8215999,20.857735098645033,37.99117009536101,0.07782498141859351,3075.4878475666046,646.1258285045624,2354.6237449645996,33170,8127,25043,25043,0,22,8216000.0
8216,8216999,20.8578886512149,37.99138724147667,0.07779618106029995,3075.9119992256165,646.1912744045258,2354.9156761169434,33174,8129,25045,25045,0,22,8217000.0
8217,8217999,20.857763343890262,37.99074163352994,0.07777509560731488,3076.2024006843567,646.257161617279,2355.564441680908,33176,8130,25046,25046,0,22,8218000.0
8218,8218999,20.857581902250978,37.98976972254455,0.07775071914692067,3076.571097135544,646.3211834430695,2355.679874420166,33176,8130,25046,25046,0,22,8219000.0
8219,8219999,20.857405069335627,37.988789899974954,0.07774088219264863,3077.094039440155,646.3873159885406,2355.3511390686035,33181,8132,25049,25049,0,22,8220000.0
8220,8220999,20.85695341082629,37.98778527820207,0.07773724095041579,3077.4621064662933,646.4546999931335,2355.4833793640137,33181,8132,25049,25049,0,22,8221000.0
8221,8221999,20.85642809781702,37.986572017113936,0.07773217558584289,3077.8098208904266,646.5194756984711,2355.9248008728027,33183,8133,25050,25050,0,22,8222000.0
8222,8222999,20.856252433553784,37.98586234351976,0.07772405011193317,3078.1816523075104,646.5843224525452,2356.032497406006,33183,8133,25050,25050,0,22,8223000.0
8223,8223999,20.855997327783307,37.985250970109085,0.07771585985929796,3078.4601407051086,646.6489267349243,2356.4933891296387,33184,8133,25051,25051,0,22,8224000.0
8224,8224999,20.855611128501973,37.98428299540794,0.07771192238518843,3078.74152469635,646.7153494358063,2356.91060256958,33184,8133,25051,25051,0,22,8225000.0
8225,8225999,20.85534507603137,37.98333463306309,0.07770322565225463,3079.1353254318237,646.7818052768707,2357.1418647766113,33187,8135,25052,25052,0,22,8226000.0
8226,8226999,20.85530951391065,37.98277239182517,0.077695560435741,3079.54803442955,646.8477342128754,2356.9590034484863,33187,8135,25052,25052,0,22,8227000.0
8227,8227999,20.85535455357993,37.98232748193288,0.07768562659917688,3079.9147515296936,646.9155724048615,2357.3054542541504,33188,8136,25052,25052,0,22,8228000.0
8228,8228999,20.85557580145939,37.9820449048727,0.07767913820342143,3080.416139602661,646.9819300174713,2356.9903678894043,33190,8137,25053,25053,0,22,8229000.0
8229,8229999,20.85608467250583,37.98216504210112,0.07766939388611094,3080.959678888321,647.0489418506622,2356.7961463928223,33196,8140,25056,25056,0,22,8230000.0
8230,8230999,20.856572326421045,37.98228502919675,0.07766064533621464,3081.237571001053,647.1142449378967,2357.3170204162598,33196,8140,25056,25056,0,22,8231000.0
8231,8231999,20.857000544192946,37.98219047820593,0.07765630758329944,3081.7245569229126,647.181848526001,2357.3216514587402,33210,8142,25068,25068,0,22,8232000.0
8232,8232999,20.857270619122126,37.98198707384481,0.07764895318372311,3082.153151035309,647.2503147125244,2357.136989593506,33210,8142,25068,25068,0,22,8233000.0
8233,8233999,20.857503561770628,37.981448108064725,0.07764266537134934,3082.4461648464203,647.3176188468933,2357.5509757995605,33210,8142,25068,25068,0,22,8234000.0
8234,8234999,20.857475008247604,37.982018789338106,0.07763467134060897,3083.003894329071,647.3881635665894,2357.518222808838,33226,8145,25081,25081,0,22,8235000.0
8235,8235999,20.857713682265107,37.98268783980426,0.07760362758723471,3083.39373755455,647.4572107791901,2358.1663932800293,33230,8146,25084,25084,0,22,8236000.0
8236,8236999,20.85797712417256,37.9824222033655,0.07756706103639655,3083.6932578086853,647.5243926048279,2359.052532196045,33232,8147,25085,25085,0,22,8237000.0
8237,8237999,20.858047055753413,37.98251760594874,0.0775593163506747,3084.0973947048187,647.5917148590088,2359.389263153076,33234,8148,25086,25086,0,22,8238000.0
8238,8238999,20.858240507818632,37.982758600619185,0.07754433928037552,3084.447229862213,647.6613190174103,2359.879238128662,33236,8149,25087,25087,0,22,8239000.0
8239,8239999,20.858389815392727,37.98227192542015,0.0775305640086883,3085.0646002292633,647.7299056053162,2359.2774085998535,33250,8151,25099,25099,0,22,8240000.0
8240,8240999,20.85859082901075,37.9823310266825,0.07751525073786925,3085.6178455352783,647.8012716770172,2359.2553672790527,33256,8154,25102,25102,0,22,8241000.0
8241,8241999,20.85875844998727,37.98196620506285,0.07750585411110733,3085.9068760871887,647.8702306747437,2359.7918434143066,33256,8154,25102,25102,0,22,8242000.0
8242,8242999,20.858803053065685,37.98143161410197,0.07750056655142434,3086.387050151825,647.9403495788574,2359.6977882385254,33258,8155,25103,25103,0,22,8243000.0
8243,8243999,20.858935725430683,37.981004616795126,0.07749304718523153,3086.7284178733826,648.0111117362976,2360.2128944396973,33261,8156,25105,25105,0,22,8244000.0
8244,8244999,20.85909446349596,37.980960044030574,0.0774840729655375,3086.995510816574,648.0800054073334,2360.8877449035645,33263,8157,25106,25106,0,22,8245000.0
8245,8245999,20.859439873807705,37.98108491422775,0.07747645624645239,3087.420243501663,648.1486282348633,2360.979778289795,33265,8158,25107,25107,0,22,8246000.0
8246,8246999,20.85974703143313,37.98125368135547,0.0774764720026434,3087.859974384308,648.2165386676788,2360.9070472717285,33267,8159,25108,25108,0,22,8247000.0
8247,8247999,20.8599463881398,37.9810501216384,0.07747415391177315,3088.37367272377,648.285796880722,2360.547595977783,33269,8160,25109,25109,0,22,8248000.0
8248,8248999,20.86067937912094,37.98340257215179,0.07747022746161136,3088.7190370559692,648.3537616729736,2361.0556449890137,33271,8161,25110,25110,0,22,8249000.0
8249,8249999,20.861314050443905,37.983709779438975,0.07747147319613024,3088.8856267929077,648.4194662570953,2362.029628753662,33271,8161,25110,25110,0,22,8250000.0
8250,8250999,20.861893517237668,37.983799661674546,0.07747799122914567,3089.3783371448517,648.4897224903107,2361.876895904541,33273,8162,25111,25111,0,22,8251000.0
8251,8251999,20.862857375009682,37.98530531195582,0.07747914668536693,3089.9348776340485,648.557510137558,2361.3555870056152,33285,8163,25122,25122,0,22,8252000.0
8252,8252999,20.863635726547162,37.98656442710207,0.07748469247392398,3090.2722811698914,648.6246254444122,2361.5605125427246,33285,8163,25122,25122,0,22,8253000.0
8253,8253999,20.864594322618306,37.987431376296726,0.07748861834434362,3090.6827607154846,648.691564321518,2361.467685699463,33285,8163,25122,25122,0,22,8254000.0
8254,8254999,20.865304207167213,37.98750423914167,0.07748831551443691,3091.1033132076263,648.7600390911102,2361.783664703369,33292,8164,25128,25128,0,22,8255000.0
8255,8255999,20.865588847119575,37.98842608478381,0.07747349252876501,3091.5789465904236,648.821818113327,2361.9034843444824,33295,8165,25130,25130,0,22,8256000.0
8256,8256999,20.866204193934824,37.98940008474088,0.07746196828055996,3091.883876800537,648.8830907344818,2362.546657562256,33296,8165,25131,25131,0,22,8257000.0
8257,8257999,20.867408771595223,37.991519580963306,0.07744753781740898,3092.31839966774,648.9464709758759,2362.843662261963,33298,8166,25132,25132,0,22,8258000.0
8258,8258999,20.86836381195921,37.99587191603154,0.07743119620479988,3092.6138577461243,649.0109412670135,2363.6432151794434,33300,8167,25133,25133,0,22,8259000.0
8259,8259999,20.869372963282274,37.997536333128785,0.07743007594748852,3093.129611492157,649.0740513801575,2363.5024223327637,33304,8169,25135,25135,0,22,8260000.0
8260,8260999,20.870275562659327,37.998475484575735,0.07742676457849351,3093.6891033649445,649.1384854316711,2363.417667388916,33310,8172,25138,25138,0,22,8261000.0
8261,8261999,20.871479923733784,38.00012307876709,0.07743092475943858,3094.2912113666534,649.2027695178986,2363.344005584717,33318,8176,25142,25142,0,22,8262000.0
8262,8262999,20.872524736024946,38.0011699643,0.07743479909812778,3094.493574142456,649.2663977146149,2364.373882293701,33319,8176,25143,25143,0,22,8263000.0
8263,8263999,20.873857608447718,38.00271735821333,0.07744010001428503,3094.8969371318817,649.3298268318176,2364.7549476623535,33323,8178,25145,25145,0,22,8264000.0
8264,8264999,20.87488996283567,38.00499843295418,0.07744717627800579,3095.3841605186462,649.3939249515533,2364.768482208252,33327,8180,25147,25147,0,22,8265000.0
8265,8265999,20.876126814506893,38.006556559988546,0.07746205367973291,3095.714290857315,649.4579482078552,2365.087718963623,33327,8180,25147,25147,0,22,8266000.0
8266,8266999,20.87748120081566,38.008143002091884,0.07747768332836968,3096.158621788025,649.5240449905396,2365.0782890319824,33329,8181,25148,25148,0,22,8267000.0
8267,8267999,20.878774475807052,38.009401457183486,0.07749732270777931,3096.4711861610413,649.5880649089813,2365.7030906677246,33331,8182,25149,25149,0,22,8268000.0
8268,8268999,20.880198276773147,38.01108816515075,0.07752387749361456,3096.714010477066,649.6521553993225,2366.3718299865723,33331,8182,25149,25149,0,22,8269000.0
8269,8269999,20.88203193181871,38.01497683968761,0.07754770511380349,3096.9233717918396,649.7152225971222,2367.1386375427246,33331,8182,25149,25149,0,22,8270000.0
8270,8270999,20.883404424821695,38.016158111843716,0.07757326998333669,3097.416506767273,649.778861284256,2366.695713043213,33331,8182,25149,25149,0,22,8271000.0
8271,8271999,20.88495733361207,38.01763936204998,0.07759906233201841,3097.918131828308,649.8450918197632,2366.4232063293457,33333,8183,25150,25150,0,22,8272000.0
8272,8272999,20.88642033256641,38.018816910899176,0.07762786132841804,3098.387757539749,649.9121642112732,2366.5531044006348,33337,8185,25152,25152,0,22,8273000.0
8273,8273999,20.88704891341228,38.01957119819591,0.0776231440743409,3098.9355552196503,649.9766080379486,2366.544589996338,33341,8187,25154,25154,0,22,8274000.0
8274,8274999,20.886795482353552,38.020638970908664,0.07761501730230425,3099.230387687683,650.0426671504974,2367.4795570373535,33342,8187,25155,25155,0,22,8275000.0
8275,8275999,20.88652992302315,38.020815234188795,0.07760458820450311,3099.479698896408,650.1100199222565,2368.323459625244,33342,8187,25155,25155,0,22,8276000.0
8276,8276999,20.886263703068995,38.02133342598448,0.07759497397568338,3099.8360986709595,650.1784126758575,2368.6401405334473,33342,8187,25155,25155,0,22,8277000.0
8277,8277999,20.886153432761475,38.02117323609333,0.07758624751401466,3100.1324763298035,650.2435274124146,2369.2314949035645,33342,8187,25155,25155,0,22,8278000.0
8278,8278999,20.885907548041352,38.020857874481116,0.07757993317231138,3100.6222019195557,650.3112199306488,2369.1241722106934,33346,8189,25157,25157,0,22,8279000.0
8279,8279999,20.886013393986477,38.02062519871632,0.07757056944066432,3100.915364265442,650.3776180744171,2369.694004058838,33346,8189,25157,25157,0,22,8280000.0
8280,8280999,20.886369926203294,38.021257626249785,0.07756083854085916,3101.272305727005,650.4459869861603,2370.092601776123,33348,8190,25158,25158,0,22,8281000.0
8281,8281999,20.886585092405944,38.02125920962038,0.07755098048916376,3101.722722053528,650.512707233429,2370.052143096924,33350,8191,25159,25159,0,22,8282000.0
8282,8282999,20.886816616872895,38.02136556177036,0.07753988548565294,3102.2070603370667,650.5787651538849,2369.7831687927246,33352,8192,25160,25160,0,22,8283000.0
8283,8283999,20.887350807898635,38.022062893378774,0.07752843389429565,3102.6258506774902,650.6449325084686,2369.7072792053223,33352,8192,25160,25160,0,22,8284000.0
8284,8284999,20.88786479526207,38.02246696316943,0.07751701666307842,3102.8922069072723,650.7105898857117,2370.5458030700684,33354,8193,25161,25161,0,22,8285000.0
8285,8285999,20.888385579176504,38.02274798546026,0.07750850716847935,3103.489296913147,650.7779741287231,2370.1080894470215,33358,8195,25163,25163,0,22,8286000.0
8286,8286999,20.888687624983344,38.02268342598639,0.07750490542185318,3104.027662038803,650.8468387126923,2369.913974761963,33362,8197,25165,25165,0,22,8287000.0
8287,8287999,20.889118825980763,38.022643789111555,0.07750065156958263,3104.5140495300293,650.9133725166321,2369.691318511963,33364,8198,25166,25166,0,22,8288000.0
8288,8288999,20.889420618624847,38.02258036712129,0.07749760503617531,3104.970491886139,650.9816117286682,2369.4554862976074,33364,8198,25166,25166,0,22,8289000.0
8289,8289999,20.88954270570459,38.021908805558866,0.07749347606710177,3105.137104988098,651.0475027561188,2370.750576019287,33364,8198,25166,25166,0,22,8290000.0
8290,8290999,20.88955936328166,38.02316591068588,0.07748168847960946,3105.334610939026,651.1105234622955,2372.192127227783,33367,8198,25169,25169,0,22,8291000.0
8291,8291999,20.88911377050795,38.022107109268305,0.07748174092321825,3105.5893256664276,651.1745355129242,2373.378734588623,33369,8199,25170,25170,0,22,8292000.0
8292,8292999,20.88886196093987,38.02196268373728,0.07747571960862953,3106.0963933467865,651.2383389472961,2373.295581817627,33371,8200,25171,25171,0,22,8293000.0
8293,8293999,20.888589974777652,38.0212270876119,0.0774716089415951,3106.2941575050354,651.3030028343201,2374.363842010498,33371,8200,25171,25171,0,22,8294000.0
8294,8294999,20.888411108994504,38.02076161702592,0.07746553091697073,3106.553448677063,651.3671791553497,2375.000087738037,33371,8200,25171,25171,0,22,8295000.0
8295,8295999,20.888302534885135,38.02078631897636,0.07745851959580208,3106.9903078079224,651.4340841770172,2375.064723968506,33374,8201,25173,25173,0,22,8296000.0
8296,8296999,20.888274549477057,38.021044158613236,0.07744858817687783,3107.4098501205444,651.4972386360168,2375.1158866882324,33376,8202,25174,25174,0,22,8297000.0
8297,8297999,20.88830267942946,38.02102286272757,0.07743866753872453,3107.998194217682,651.5645976066589,2374.4980964660645,33389,8203,25186,25186,0,22,8298000.0
8298,8298999,20.88844588176543,38.0211833546091,0.07742823788076492,3108.1596579551697,651.6287326812744,2375.567615509033,33389,8203,25186,25186,0,22,8299000.0
8299,8299999,20.88846986534955,38.02084846486421,0.0774200280184687,3108.370678663254,651.6953144073486,2376.362537384033,33389,8203,25186,25186,0,22,8300000.0
8300,8300999,20.88875494554203,38.021853781349186,0.07740637869325273,3108.788476228714,651.7583177089691,2376.3743171691895,33391,8204,25187,25187,0,22,8301000.0
8301,8301999,20.88892697811408,38.02169246852901,0.0773975160055792,3109.144722223282,651.8252322673798,2376.7051963806152,33393,8205,25188,25188,0,22,8302000.0
8302,8302999,20.889261438456042,38.02212552653146,0.0773866098829159,3109.8875982761383,651.8948965072632,2375.983783721924,33401,8209,25192,25192,0,22,8303000.0
8303,8303999,20.889375968372594,38.02216641958159,0.07737666006460209,3110.5693945884705,651.9599649906158,2375.2577476501465,33407,8212,25195,25195,0,22,8304000.0
8304,8304999,20.889426200681328,38.022003997998624,0.07737036733315417,3110.8404669761658,652.0271112918854,2375.9701957702637,33407,8212,25195,25195,0,22,8305000.0
8305,8305999,20.889781925994306,38.022064939129756,0.07735839452871873,3111.082041501999,652.0922667980194,2376.665584564209,33407,8212,25195,25195,0,22,8306000.0
8306,8306999,20.889926451612126,38.02183883797879,0.07735105768351791,3111.5450341701508,652.1577627658844,2376.6494941711426,33409,8213,25196,25196,0,22,8307000.0
8307,8307999,20.89014861119004,38.022394573146684,0.07733802293442094,3111.9812293052673,652.2263174057007,2376.8150901794434,33411,8214,25197,25197,0,22,8308000.0
8308,8308999,20.88995979496115,38.02151412967127,0.07733016798884751,3112.2251992225647,652.2902987003326,2377.426616668701,33411,8214,25197,25197,0,22,8309000.0
8309,8309999,20.891148143990495,38.022512519529606,0.07725600061894211,3112.7122814655304,652.3582639694214,2377.619861602783,33426,8216,25210,25210,0,22,8310000.0
8310,8310999,20.89119961383269,38.02226370028492,0.07722061271298208,3113.1573569774628,652.4296021461487,2377.7382469177246,33428,8217,25211,25211,0,22,8311000.0
8311,8311999,20.89125495731113,38.02260742404717,0.07719769157009926,3113.6947014331818,652.4988460540771,2378.0189323425293,33447,8220,25227,25227,0,22,8312000.0
8312,8312999,20.89130143070939,38.02277325708629,0.07717147687246129,3113.9007856845856,652.566880941391,2379.3663444519043,33447,8220,25227,25227,0,22,8313000.0
8313,8313999,20.891284763312864,38.022916499590934,0.07715248788231654,3114.0948395729065,652.6351897716522,2380.404094696045,33447,8220,25227,25227,0,22,8314000.0
8314,8314999,20.891670433068576,38.02310402832477,0.07713208274383576,3114.2590141296387,652.703638792038,2381.4296913146973,33448,8220,25228,25228,0,22,8315000.0
8315,8315999,20.89196467399668,38.02333156432669,0.07711753118861131,3114.950254678726,652.7737267017365,2381.023937225342,33485,8224,25261,25261,0,22,8316000.0
8316,8316999,20.892042945513644,38.02332940872512,0.0771084497184934,3115.382004261017,652.8451564311981,2381.111759185791,33487,8225,25262,25262,0,22,8317000.0
8317,8317999,20.892218113567694,38.02296478571671,0.0771014924396678,3115.6928346157074,652.9164941310883,2381.7722206115723,33490,8226,25264,25264,0,22,8318000.0
8318,8318999,20.892335157212727,38.0226462724239,0.0770982770080686,3116.076901912689,652.9854145050049,2381.980411529541,33492,8227,25265,25265,0,22,8319000.0
8319,8319999,20.892784143246757,38.02290021160976,0.07710403588379444,3116.5882432460785,653.0537459850311,2381.9548683166504,33496,8229,25267,25267,0,22,8320000.0
8320,8320999,20.893121934467693,38.02315563517504,0.07710393528250148,3116.953143119812,653.1258149147034,2382.342426300049,33498,8230,25268,25268,0,22,8321000.0
8321,8321999,20.89320723386588,38.02296606506444,0.07710473738118873,3117.2749354839325,653.1934945583344,2382.6932792663574,33498,8230,25268,25268,0,22,8322000.0
8322,8322999,20.893527478047034,38.02305508418968,0.07710653060662154,3117.5848803520203,653.2635695934296,2383.142292022705,33498,8230,25268,25268,0,22,8323000.0
8323,8323999,20.893949842138817,38.023510812326194,0.07710273439577708,3117.9594597816467,653.3316004276276,2383.4276390075684,33500,8231,25269,25269,0,22,8324000.0
8324,8324999,20.894328782383017,38.023493553460106,0.07710309208029276,3118.458284854889,653.4003036022186,2383.3794593811035,33504,8233,25271,25271,0,22,8325000.0
8325,8325999,20.894670844710944,38.02343121187448,0.07710253882546958,3118.8253214359283,653.4692800045013,2383.4748573303223,33504,8233,25271,25271,0,22,8326000.0
8326,8326999,20.895182119559998,38.02393467721256,0.07710942203650395,3119.295380592346,653.5384821891785,2383.0549125671387,33504,8233,25271,25271,0,22,8327000.0
8327,8327999,20.895828264457815,38.024682659232724,0.07711209624793514,3119.716037273407,653.6098330020905,2382.949230194092,33504,8233,25271,25271,0,22,8328000.0
8328,8328999,20.896222767103456,38.02470624531643,0.07711209604326208,3120.043785095215,653.678870677948,2383.452648162842,33506,8234,25272,25272,0,22,8329000.0
8329,8329999,20.896837365793445,38.0258651705626,0.07707374527741773,3120.241064310074,653.7417821884155,2384.7979621887207,33509,8234,25275,25275,0,22,8330000.0
8330,8330999,20.897642919946467,38.02611973688363,0.07702357202844246,3120.4327278137207,653.8035893440247,2386.005558013916,33509,8234,25275,25275,0,22,8331000.0
8331,8331999,20.898431954629384,38.0271591294255,0.07697802556300493,3120.840342283249,653.8664615154266,2386.3922004699707,33514,8236,25278,25278,0,22,8332000.0
8332,8332999,20.899338752621027,38.02870378449661,0.07694250618472087,3121.244067668915,653.9297251701355,2386.8325538635254,33516,8237,25279,25279,0,22,8333000.0
8333,8333999,20.90000796890484,38.02903439582032,0.07691662888926609,3121.6445937156677,653.9918577671051,2387.225383758545,33520,8239,25281,25281,0,22,8334000.0
8334,8334999,20.900871303793707,38.03035343722899,0.07690988895248563,3122.0801236629486,654.0538530349731,2387.0666007995605,33520,8239,25281,25281,0,22,8335000.0
8335,8335999,20.901458307834712,38.03060621661792,0.07691113501788227,3122.516574382782,654.1183021068573,2387.1194038391113,33522,8240,25282,25282,0,22,8336000.0
8336,8336999,20.902225050776316,38.03145013511754,0.07691100072310098,3122.7511188983917,654.1806874275208,2387.870014190674,33522,8240,25282,25282,0,22,8337000.0
8337,8337999,20.90298443893043,38.032494433822244,0.07691099647191213,3123.047777891159,654.245397567749,2388.358600616455,33525,8241,25284,25284,0,22,8338000.0
8338,8338999,20.903950528338736,38.03371361142519,0.07692721566963556,3123.546680212021,654.3093466758728,2387.9606590270996,33527,8242,25285,25285,0,22,8339000.0
8339,8339999,20.905221729937963,38.03567312945622,0.07695033217180602,3124.027186155319,654.3741056919098,2387.8687782287598,33529,8243,25286,25286,0,22,8340000.0
8340,8340999,20.906309034682327,38.037348509623705,0.07697086254828567,3124.580358505249,654.4389326572418,2387.9132957458496,33537,8247,25290,25290,0,22,8341000.0
8341,8341999,20.907387855318277,38.038459673018295,0.07698741011036503,3125.0774064064026,654.5035588741302,2387.637851715088,33539,8248,25291,25291,0,22,8342000.0
8342,8342999,20.908898437579193,38.04067500128988,0.07699983002234989,3125.496755361557,654.5698721408844,2387.5346183776855,33539,8248,25291,25291,0,22,8343000.0
8343,8343999,20.91078879627056,38.04358057458715,0.07701411852524587,3125.8488912582397,654.6340074539185,2388.0004844665527,33551,8249,25302,25302,0,22,8344000.0
8344,8344999,20.91238476693671,38.04531504289496,0.07703457751908904,3126.1394674777985,654.6984584331512,2388.4464073181152,33551,8249,25302,25302,0,22,8345000.0
8345,8345999,20.91451524471113,38.04846839438247,0.07704604288669081,3126.42933011055,654.7646813392639,2388.9346046447754,33551,8249,25302,25302,0,22,8346000.0
8346,8346999,20.916155520768907,38.05034115580398,0.07705971021249747,3127.0232129096985,654.828898191452,2388.124668121338,33553,8250,25303,25303,0,22,8347000.0
8347,8347999,20.918011220070955,38.052371796691055,0.07706005571614571,3127.3975989818573,654.8934154510498,2388.375415802002,33553,8250,25303,25303,0,22,8348000.0
8348,8348999,20.919071966705868,38.052745629685255,0.07705395655907177,3127.6986441612244,654.9557754993439,2389.258647918701,33565,8251,25314,25314,0,22,8349000.0
8349,8349999,20.920369571250518,38.05442736594041,0.07696332777168002,3128.176218032837,655.0234572887421,2389.515224456787,33570,8253,25317,25317,0,22,8350000.0
8350,8350999,20.920976285945976,38.05492250516865,0.07690229755214195,3128.5266251564026,655.0894827842712,2390.6031913757324,33587,8255,25332,25332,0,22,8351000.0
8351,8351999,20.9215470488606,38.05559066038093,0.0768622982435595,3128.733982563019,655.157479763031,2391.756618499756,33587,8255,25332,25332,0,22,8352000.0
8352,8352999,20.921973446170394,38.055275228343774,0.07681698713036156,3129.1114716529846,655.2228219509125,2391.9844398498535,33589,8256,25333,25333,0,22,8353000.0
8353,8353999,20.92204804102058,38.054499804475086,0.0767840079880785,3129.3835818767548,655.2898862361908,2392.5777320861816,33590,8256,25334,25334,0,22,8354000.0
8354,8354999,20.921942354465973,38.05349123643876,0.07676333053455409,3129.827534198761,655.3570115566254,2392.6184577941895,33594,8258,25336,25336,0,22,8355000.0
8355,8355999,20.921881234477002,38.052599008411974,0.07674097880177166,3130.1035623550415,655.4221568107605,2393.1486778259277,33594,8258,25336,25336,0,22,8356000.0
8356,8356999,20.92173142914278,38.051709455617285,0.07672641110382994,3130.4777314662933,655.488439321518,2393.388370513916,33596,8259,25337,25337,0,22,8357000.0
8357,8357999,20.921729624605227,38.05109360532538,0.07670819341851975,3130.9710965156555,655.5553209781647,2393.0551567077637,33598,8260,25338,25338,0,22,8358000.0
8358,8358999,20.9215126198545,38.050075434771074,0.0766941762139638,3131.2133662700653,655.6228775978088,2393.7198905944824,33598,8260,25338,25338,0,22,8359000.0
8359,8359999,20.921333642786507,38.04927558808134,0.07668298193892498,3131.845615386963,655.6901512145996,2393.211627960205,33604,8263,25341,25341,0,22,8360000.0
8360,8360999,20.921022922367047,38.04834260126185,0.07667666848067811,3132.1262493133545,655.7584190368652,2393.69144821167,33604,8263,25341,25341,0,22,8361000.0
8361,8361999,20.92082219884085,38.047416942891104,0.07667046253791132,3132.495759487152,655.8241801261902,2393.892017364502,33606,8264,25342,25342,0,22,8362000.0
8362,8362999,20.920499117891133,38.046557191393866,0.07666609194617113,3132.7974441051483,655.8928294181824,2394.2579307556152,33606,8264,25342,25342,0,22,8363000.0
8363,8363999,20.92021383835261,38.04536127861093,0.07666041402923751,3133.1286194324493,655.96195936203,2394.556697845459,33606,8264,25342,25342,0,22,8364000.0
8364,8364999,20.92000962744209,38.04438262241405,0.07665321913636702,3133.521035671234,656.027186870575,2394.4043159484863,33606,8264,25342,25342,0,22,8365000.0
8365,8365999,20.91983325261884,38.0434726601714,0.07664561483202581,3134.158035516739,656.0995712280273,2394.126308441162,33631,8267,25364,25364,0,22,8366000.0
8366,8366999,20.919588454728828,38.042447229015806,0.07663888328266699,3134.7761704921722,656.1695783138275,2393.5333518981934,33635,8269,25366,25366,0,22,8367000.0
8367,8367999,20.919252228254837,38.04136950348131,0.07663425614702479,3135.0124950408936,656.2363088130951,2394.2525672912598,33635,8269,25366,25366,0,22,8368000.0
8368,8368999,20.918878731863956,38.040466513747056,0.0766268554498939,3135.390143632889,656.302451133728,2394.284900665283,33635,8269,25366,25366,0,22,8369000.0
8369,8369999,20.920609061070923,38.04152660807469,0.07652960562478595,3135.891847848892,656.3713192939758,2394.9603691101074,33644,8272,25372,25372,0,22,8370000.0
8370,8370999,20.921512688920657,38.04189445010744,0.07646135840308155,3136.2491574287415,656.4372477531433,2395.822925567627,33648,8274,25374,25374,0,22,8371000.0
8371,8371999,20.92197177723388,38.04142115421047,0.07640719598123036,3136.5129973888397,656.5038628578186,2396.703342437744,33650,8275,25375,25375,0,22,8372000.0
8372,8372999,20.9221937643941,38.040691722671895,0.07636781896915523,3136.9247245788574,656.5703070163727,2397.102527618408,33654,8277,25377,25377,0,22,8373000.0
8373,8373999,20.9223059947112,38.04106077491189,0.07634139782954119,3137.552941799164,656.6375603675842,2396.6012077331543,33660,8280,25380,25380,0,22,8374000.0
8374,8374999,20.922163306257747,38.040063840486724,0.07631764355836335,3138.0838644504547,656.7058165073395,2396.3864097595215,33664,8282,25382,25382,0,22,8375000.0
8375,8375999,20.92173470393666,38.0391496258791,0.0763047139819718,3138.431309938431,656.7764582633972,2396.861484527588,33666,8283,25383,25383,0,22,8376000.0
8376,8376999,20.92145542214115,38.04051973381811,0.07628825727872879,3138.831513404846,656.8464560508728,2397.0856590270996,33694,8284,25410,25410,0,22,8377000.0
8377,8377999,20.921096416463698,38.040470667657075,0.07627273555829428,3139.1716496944427,656.9134998321533,2397.497486114502,33696,8285,25411,25411,0,22,8378000.0
8378,8378999,20.920708049700185,38.039709523709625,0.07626443636177516,3139.5220913887024,656.9818549156189,2397.604724884033,33696,8285,25411,25411,0,22,8379000.0
8379,8379999,20.920015748952228,38.03825127606529,0.07625940294310729,3139.987517595291,657.0493059158325,2397.5226707458496,33699,8286,25413,25413,0,22,8380000.0
8380,8380999,20.919467574543223,38.037092380902116,0.07625142567996512,3140.4214301109314,657.1187388896942,2397.448299407959,33701,8287,25414,25414,0,22,8381000.0
8381,8381999,20.91918030206791,38.037401501062675,0.07623492377612151,3140.740732908249,657.1880223751068,2397.758617401123,33701,8287,25414,25414,0,22,8382000.0
8382,8382999,20.918862225707286,38.036605011438986,0.0762239053579511,3141.248012304306,657.2565009593964,2397.3974418640137,33712,8288,25424,25424,0,22,8383000.0
8383,8383999,20.918712242335022,38.03616847926609,0.07621431170064097,3141.6139748096466,657.323490858078,2397.533779144287,33712,8288,25424,25424,0,22,8384000.0
8384,8384999,20.918405066211793,38.03535836634947,0.07620544570164811,3142.030287027359,657.3930613994598,2397.6093940734863,33723,8289,25434,25434,0,22,8385000.0
8385,8385999,20.918441854021317,38.03513737129332,0.07619671961250551,3142.408507823944,657.4640755653381,2397.7171897888184,33723,8289,25434,25434,0,22,8386000.0
8386,8386999,20.918148739392798,38.03435294417895,0.0761886737594788,3142.8134286403656,657.5340800285339,2397.5105628967285,33723,8289,25434,25434,0,22,8387000.0
8387,8387999,20.91803460832948,38.03355257110928,0.07617403321425131,3143.111068248749,657.6048901081085,2397.9814643859863,33723,8289,25434,25434,0,22,8388000.0
8388,8388999,20.918133486611044,38.03476716897097,0.07616607504698658,3143.448844909668,657.6730291843414,2398.2297401428223,33723,8289,25434,25434,0,22,8389000.0
8389,8389999,20.91777336596982,38.03364700032979,0.0761570866035074,3143.900446176529,657.7368152141571,2398.5443153381348,33732,8290,25442,25442,0,22,8390000.0
8390,8390999,20.91719676723585,38.032177207887166,0.07614790203139077,3144.249830007553,657.7988123893738,2398.978733062744,33736,8290,25446,25446,0,22,8391000.0
8391,8391999,20.917022776758603,38.031568332289794,0.0761315336452274,3144.646638393402,657.8619320392609,2399.379009246826,33741,8291,25450,25450,0,22,8392000.0
8392,8392999,20.916944082432728,38.0305767721425,0.07611281517656454,3145.2892351150513,657.9241933822632,2398.9904289245605,33748,8294,25454,25454,0,22,8393000.0
8393,8393999,20.917130063193433,38.03006170682155,0.07609327857480042,3145.4955608844757,657.9921410083771,2400.018283843994,33748,8294,25454,25454,0,22,8394000.0
8394,8394999,20.91744164310716,38.02953719196838,0.07607622785273482,3145.9622333049774,658.0546572208405,2400.3260612487793,33754,8297,25457,25457,0,22,8395000.0
8395,8395999,20.917574630445383,38.02894517204818,0.07606585903701568,3146.5058193206787,658.1185913085938,2400.2812156677246,33760,8300,25460,25460,0,22,8396000.0
8396,8396999,20.917629893025754,38.02809366491407,0.07605533789356456,3146.799421787262,658.1826333999634,2400.762462615967,33760,8300,25460,25460,0,22,8397000.0
8397,8397999,20.918071776016234,38.030923241714625,0.07603613032658241,3147.1828243732452,658.2458138465881,2401.044178009033,33762,8301,25461,25461,0,22,8398000.0
8398,8398999,20.91850270891685,38.031364348964225,0.07602233514809853,3147.5078570842743,658.3100945949554,2401.5866661071777,33764,8302,25462,25462,0,22,8399000.0
8399,8399999,20.918844289304538,38.03116582447609,0.07601198517691565,3148.1160657405853,658.3747737407684,2401.2098655700684,33771,8305,25466,25466,0,22,8400000.0
8400,8400999,20.919209338180238,38.03139906224129,0.07599662139531871,3148.441512823105,658.4396269321442,2401.5364570617676,33771,8305,25466,25466,0,22,8401000.0
8401,8401999,20.91983776210236,38.032242654244726,0.07597059813248619,3148.912632226944,658.5061984062195,2401.3716468811035,33773,8306,25467,25467,0,22,8402000.0
8402,8402999,20.920406369452245,38.03261231190215,0.0759550424508223,3149.3439753055573,658.5691366195679,2401.6004219055176,33777,8308,25469,25469,0,22,8403000.0
8403,8403999,20.92092801585431,38.03282132820533,0.07593745382322492,3149.6829619407654,658.634369134903,2401.8878898620605,33777,8308,25469,25469,0,22,8404000.0
8404,8404999,20.921384922047327,38.03264283273345,0.07592901242341454,3150.12149810791,658.7001805305481,2402.078212738037,33781,8310,25471,25471,0,22,8405000.0
8405,8405999,20.92205329070096,38.03319329111787,0.07592649837362642,3150.5182461738586,658.7651302814484,2402.5140342712402,33785,8312,25473,25473,0,22,8406000.0
8406,8406999,20.92277267153741,38.033350642476634,0.07592002831550448,3151.0387513637543,658.8310360908508,2402.4477577209473,33789,8314,25475,25475,0,22,8407000.0
8407,8407999,20.92338352378812,38.03356218068767,0.07591825450704992,3151.381691455841,658.8974139690399,2402.873279571533,33789,8314,25475,25475,0,22,8408000.0
8408,8408999,20.92366761564138,38.033160500292624,0.07591961958121396,3151.9208176136017,658.9625384807587,2402.5868492126465,33793,8316,25477,25477,0,22,8409000.0
8409,8409999,20.923307647480268,38.03259657752602,0.07591291157415203,3152.173495531082,659.0265831947327,2403.7327156066895,33801,8316,25485,25485,0,22,8410000.0
8410,8410999,20.922951420192657,38.032317151225804,0.07590794904336962,3152.4690227508545,659.0935635566711,2404.623752593994,33807,8317,25490,25490,0,22,8411000.0
8411,8411999,20.922312856615985,38.03095654938873,0.07590799754360977,3152.9134936332703,659.1587917804718,2405.044910430908,33814,8319,25495,25495,0,22,8412000.0
8412,8412999,20.921837238131626,38.02983808092275,0.07590765928741905,3153.3706080913544,659.2232937812805,2405.129650115967,33817,8320,25497,25497,0,22,8413000.0
8413,8413999,20.921394391126405,38.028696272708174,0.07590522936285393,3153.732024908066,659.2916593551636,2405.6472663879395,33830,8321,25509,25509,0,22,8414000.0
8414,8414999,20.920713698495913,38.027265672707664,0.07590459723039011,3154.255152463913,659.35795545578,2405.588840484619,33834,8323,25511,25511,0,22,8415000.0
8415,8415999,20.92012307255684,38.0261176657629,0.07590192708430932,3154.762812614441,659.4254307746887,2405.888042449951,33840,8326,25514,25514,0,22,8416000.0
8416,8416999,20.919821678573438,38.0251739943524,0.07589291006051602,3155.137547016144,659.4914598464966,2406.1827354431152,33840,8326,25514,25514,0,22,8417000.0
8417,8417999,20.919531696973298,38.02450241052297,0.07588004502012058,3155.477257013321,659.556911945343,2406.7911491394043,33842,8327,25515,25515,0,22,8418000.0
8418,8418999,20.91912668332051,38.02324923131884,0.07587189779878523,3155.8222739696503,659.6216385364532,2406.968723297119,33842,8327,25515,25515,0,22,8419000.0
8419,8419999,20.918950133266335,38.02250374105148,0.07586475974927598,3156.1272439956665,659.689633846283,2407.3632850646973,33842,8327,25515,25515,0,22,8420000.0
8420,8420999,20.918806073618725,38.02177829177341,0.07585250177971048,3156.6566054821014,659.7564845085144,2407.1064491271973,33847,8329,25518,25518,0,22,8421000.0
8421,8421999,20.91865168695752,38.020907682619054,0.07583834667054246,3157.0100395679474,659.8239140510559,2407.5537071228027,33850,8330,25520,25520,0,22,8422000.0
8422,8422999,20.918589733348224,38.02028674231088,0.07582978592949019,3157.487316608429,659.8905370235443,2407.4537086486816,33852,8331,25521,25521,0,22,8423000.0
8423,8423999,20.918597806372066,38.02073345424225,0.07581771637202273,3157.8903663158417,659.9593341350555,2407.8099250793457,33855,8332,25523,25523,0,22,8424000.0
8424,8424999,20.918530694324133,38.020954202602525,0.07580385871909356,3158.1778495311737,660.0259776115417,2408.2882804870605,33855,8332,25523,25523,0,22,8425000.0
8425,8425999,20.918099581593623,38.01970890235497,0.07579893156129602,3158.4264800548553,660.0899560451508,2408.993137359619,33855,8332,25523,25523,0,22,8426000.0
8426,8426999,20.917584295967654,38.01858181938891,0.0758014114901917,3158.6065304279327,660.1534967422485,2410.883457183838,33879,8332,25547,25547,0,22,8427000.0
8427,8427999,20.917179249312756,38.02017548109648,0.07577042299355918,3158.8886630535126,660.2160246372223,2412.04984664917,33892,8333,25559,25559,0,22,8428000.0
8428,8428999,20.916800572130025,38.019572796363704,0.07577962536033922,3159.140898704529,660.2799499034882,2413.1349601745605,33897,8334,25563,25563,0,22,8429000.0
8429,8429999,20.91619305582657,38.01856126427597,0.07577808147623943,3159.4355669021606,660.3434658050537,2413.767719268799,33900,8335,25565,25565,0,22,8430000.0
8430,8430999,20.915662132288883,38.017696381687436,0.07577983599521854,3160.060205221176,660.4085943698883,2413.5785179138184,33910,8339,25571,25571,0,22,8431000.0
8431,8431999,20.915487964802296,38.01736730874778,0.07577931629722245,3160.5261781215668,660.4751672744751,2413.977153778076,33918,8342,25576,25576,0,22,8432000.0
8432,8432999,20.915190858547874,38.01652564581834,0.0757780045595624,3160.91597700119,660.5391697883606,2414.5279808044434,33922,8344,25578,25578,0,22,8433000.0
8433,8433999,20.914764750523947,38.01569223812245,0.07577663880926433,3161.1085369586945,660.6042392253876,2415.4799308776855,33923,8344,25579,25579,0,22,8434000.0
8434,8434999,20.914664029513123,38.01595878687918,0.07577238143892417,3161.50617480278,660.6695520877838,2415.8704261779785,33928,8346,25582,25582,0,22,8435000.0
8435,8435999,20.9145216851207,38.015459929737716,0.07577614951795364,3162.2843651771545,660.7359683513641,2414.960231781006,33936,8350,25586,25586,0,22,8436000.0
8436,8436999,20.914255072628627,38.01446221208809,0.07577986576144768,3162.6867985725403,660.8010642528534,2415.4582862854004,33941,8352,25589,25589,0,22,8437000.0
8437,8437999,20.914205970523916,38.01409278861763,0.07578825406968359,3163.0654480457306,660.8682267665863,2415.8005867004395,33944,8353,25591,25591,0,22,8438000.0
8438,8438999,20.9140386727596,38.01332970572794,0.07578740880726298,3163.389185667038,660.9347450733185,2416.3408393859863,33946,8354,25592,25592,0,22,8439000.0
8439,8439999,20.914244882676325,38.01338563960079,0.07578531612465522,3163.961368560791,661.0011785030365,2416.0579414367676,33960,8356,25604,25604,0,22,8440000.0
8440,8440999,20.91424053559099,38.01270889377052,0.0757791176135213,3164.4126691818237,661.0677175521851,2416.3759117126465,33964,8358,25606,25606,0,22,8441000.0
8441,8441999,20.914393847490935,38.012318553483865,0.07577777037881561,3164.91765332222,661.1332759857178,2416.1808738708496,33967,8359,25608,25608,0,22,8442000.0
8442,8442999,20.914672123147994,38.01203907220807,0.07577559057046124,3165.1747393608093,661.2005486488342,2416.7917518615723,33967,8359,25608,25608,0,22,8443000.0
8443,8443999,20.914694098504214,38.01208907072994,0.07576668274239162,3165.5733699798584,661.2677249908447,2416.8937797546387,33967,8359,25608,25608,0,22,8444000.0
8444,8444999,20.91478099558881,38.01366692414797,0.07575483438837116,3165.7457914352417,661.3334589004517,2417.986660003662,33967,8359,25608,25608,0,22,8445000.0
8445,8445999,20.91444683176569,38.0132715277023,0.07574823872044634,3166.136824131012,661.4024879932404,2418.7205543518066,33975,8360,25615,25615,0,22,8446000.0
8446,8446999,20.913931918724245,38.01231088606722,0.07574651760477646,3166.423756837845,661.4704442024231,2420.0175743103027,33990,8361,25629,25629,0,22,8447000.0
8447,8447999,20.91366990392603,38.01247710219674,0.07574165732342353,3166.620785713196,661.5400021076202,2421.175968170166,33990,8361,25629,25629,0,22,8448000.0
8448,8448999,20.913510092344584,38.01261856414218,0.07573530925156191,3167.0143847465515,661.6080918312073,2421.6762351989746,33994,8363,25631,25631,0,22,8449000.0
8449,8449999,20.913563636746453,38.01247955580209,0.07573620790125002,3167.3487572669983,661.675995349884,2422.245708465576,33996,8364,25632,25632,0,22,8450000.0
8450,8450999,20.91375603519599,38.01270557379279,0.07573943143873507,3167.640285015106,661.7450685501099,2422.8790855407715,33999,8365,25634,25634,0,22,8451000.0
8451,8451999,20.913913883099514,38.01261667701326,0.07574599686921246,3167.9820902347565,661.8165266513824,2423.2731742858887,34001,8366,25635,25635,0,22,8452000.0
8452,8452999,20.914035318330846,38.012389618878196,0.07575291820861763,3168.572772502899,661.8860447406769,2422.852062225342,34005,8368,25637,25637,0,22,8453000.0
8453,8453999,20.91445813907745,38.01291649773834,0.07575875348583505,3168.937257528305,661.956047296524,2423.1569480895996,34006,8368,25638,25638,0,22,8454000.0
8454,8454999,20.914821227971423,38.01307754485309,0.0757710965031031,3169.1379256248474,662.0265684127808,2424.0573234558105,34006,8368,25638,25638,0,22,8455000.0
8455,8455999,20.914887460498168,38.01323262320747,0.07577903462354463,3169.5385224819183,662.0981388092041,2424.1640129089355,34008,8369,25639,25639,0,22,8456000.0
8456,8456999,20.915440478807586,38.014186152810055,0.07579535990543762,3170.1530685424805,662.1683881282806,2423.4227256774902,34011,8370,25641,25641,0,22,8457000.0
8457,8457999,20.91548808034584,38.01396952565599,0.07579686674238395,3170.3957657814026,662.2383277416229,2424.1637229919434,34011,8370,25641,25641,0,22,8458000.0
8458,8458999,20.916086576464174,38.0149688185346,0.07580269998501077,3170.8126657009125,662.3102338314056,2424.3801918029785,34015,8372,25643,25643,0,22,8459000.0
8459,8459999,20.916486070062696,38.01522531498584,0.07580864961048084,3171.101460456848,662.3792419433594,2424.8251457214355,34015,8372,25643,25643,0,22,8460000.0
8460,8460999,20.91685420524983,38.01534121269192,0.07581198559438618,3171.570780515671,662.4499680995941,2424.6847953796387,34017,8373,25644,25644,0,22,8461000.0
8461,8461999,20.9174931672496,38.01601509274174,0.0758192988449492,3172.2206099033356,662.5201804637909,2423.846378326416,34019,8374,25645,25645,0,22,8462000.0
8462,8462999,20.918040414960238,38.01693604047198,0.07583252800692963,3172.54527592659,662.5922288894653,2424.172389984131,34019,8374,25645,25645,0,22,8463000.0
8463,8463999,20.918374146164265,38.0169836838632,0.07583879992626519,3172.8871862888336,662.6622142791748,2424.4036445617676,34019,8374,25645,25645,0,22,8464000.0
8464,8464999,20.918598172119314,38.01668733096805,0.07585209079973887,3173.290552139282,662.7323415279388,2424.5287590026855,34019,8374,25645,25645,0,22,8465000.0
8465,8465999,20.918124926433638,38.01684274073205,0.07584679356265556,3173.6091828346252,662.7999792098999,2425.605701446533,34030,8374,25656,25656,0,22,8466000.0
8466,8466999,20.917371199145528,38.015882293928925,0.07584771944481306,3173.9078896045685,662.8626651763916,2426.5016899108887,34033,8375,25658,25658,0,22,8467000.0
8467,8467999,20.91683275627246,38.01515565509193,0.07584352550143769,3174.4095375537872,662.9263191223145,2426.397731781006,34037,8377,25660,25660,0,22,8468000.0
8468,8468999,20.916204471691938,38.013914195045814,0.07584319256417305,3174.766788959503,662.9885087013245,2426.927059173584,34039,8378,25661,25661,0,22,8469000.0
8469,8469999,20.915838613076943,38.013882904599996,0.07583356805237473,3175.1735644340515,663.0527293682098,2427.394733428955,34053,8380,25673,25673,0,22,8470000.0
8470,8470999,20.9153279005642,38.01338113815752,0.075831191674682,3175.758737564087,663.1166915893555,2427.194309234619,34061,8383,25678,25678,0,22,8471000.0
8471,8471999,20.91487063328871,38.012460795816814,0.0758284808171994,3176.3673617839813,663.1842668056488,2427.0159339904785,34069,8386,25683,25683,0,22,8472000.0
8472,8472999,20.91445974926807,38.01192470457265,0.0758251761766996,3176.7636036872864,663.2492485046387,2427.4091300964355,34073,8388,25685,25685,0,22,8473000.0
8473,8473999,20.914410786170674,38.012008570474265,0.07582716519571964,3177.201842069626,663.3144967556,2427.6131553649902,34075,8389,25686,25686,0,22,8474000.0
8474,8474999,20.914871044415076,38.01279532447954,0.07582338602017613,3177.6785068511963,663.3793222904205,2427.7551918029785,34080,8391,25689,25689,0,22,8475000.0
8475,8475999,20.91546383826851,38.01374566591234,0.07582708396388349,3178.110770702362,663.4437868595123,2427.854648590088,34083,8392,25691,25691,0,22,8476000.0
8476,8476999,20.916426995723217,38.01591170737207,0.07582778295290193,3178.4427332878113,663.5073590278625,2428.177593231201,34083,8392,25691,25691,0,22,8477000.0
8477,8477999,20.91784680927471,38.019281240164986,0.07583763064976012,3178.797110080719,663.5748319625854,2428.629566192627,34086,8393,25693,25693,0,22,8478000.0
8478,8478999,20.919232488681526,38.02265237669487,0.07584376832950357,3179.1728847026825,663.645895242691,2429.0608863830566,34088,8394,25694,25694,0,22,8479000.0
8479,8479999,20.92060747368067,38.026590654051105,0.0758859262731364,3179.5298182964325,663.7101187705994,2429.532703399658,34090,8395,25695,25695,0,22,8480000.0
8480,8480999,20.92145855236598,38.027601163612424,0.07590599713115598,3179.7400398254395,663.7732403278351,2430.275905609131,34090,8395,25695,25695,0,22,8481000.0
8481,8481999,20.922937062936864,38.031489249055504,0.07593026479550102,3180.2575011253357,663.836966753006,2429.849391937256,34092,8396,25696,25696,0,22,8482000.0
8482,8482999,20.9240021040038,38.03264011257357,0.07596716677538828,3180.829131126404,663.9020204544067,2429.369426727295,34094,8397,25697,25697,0,22,8483000.0
8483,8483999,20.92491258034365,38.03409774269034,0.07597540823789695,3181.067215204239,663.9657511711121,2430.2451362609863,34094,8397,25697,25697,0,22,8484000.0
8484,8484999,20.925279642899355,38.03442066282167,0.0759486138480594,3181.5771403312683,664.0332562923431,2430.5307579040527,34104,8398,25706,25706,0,22,8485000.0
8485,8485999,20.925206344915065,38.03391982193885,0.07593930960239403,3181.921488046646,664.0979897975922,2431.2962532043457,34108,8399,25709,25709,0,22,8486000.0
8486,8486999,20.92531449877519,38.0341007550726,0.07592975818119507,3182.248106241226,664.1684052944183,2431.961582183838,34111,8400,25711,25711,0,22,8487000.0
8487,8487999,20.92546578776001,38.03444449139021,0.07591656706106098,3182.6555638313293,664.2355170249939,2432.2594566345215,34115,8401,25714,25714,0,22,8488000.0
8488,8488999,20.925639341806374,38.03432847616058,0.07591342242931554,3183.0395307540894,664.3023953437805,2432.283634185791,34115,8401,25714,25714,0,22,8489000.0
8489,8489999,20.92571083528166,38.03385857862799,0.075905936622926,3183.3731319904327,664.3672180175781,2432.7674446105957,34117,8402,25715,25715,0,22,8490000.0
8490,8490999,20.925810877941213,38.03341164207571,0.07590024849136667,3183.861173391342,664.4404561519623,2432.611354827881,34121,8403,25718,25718,0,22,8491000.0
8491,8491999,20.92585331657943,38.033048532635014,0.07589712069843468,3184.161264181137,664.5084829330444,2433.2557411193848,34123,8404,25719,25719,0,22,8492000.0
8492,8492999,20.926073851606333,38.03365346826997,0.07588932824246519,3184.6359102725983,664.5760996341705,2433.2605628967285,34126,8405,25721,25721,0,22,8493000.0
8493,8493999,20.926206276252408,38.03326331750949,0.07588423827443325,3184.898477077484,664.6439561843872,2434.0062294006348,34126,8405,25721,25721,0,22,8494000.0
8494,8494999,20.92639363220087,38.033267145738506,0.07588203595915655,3185.406140089035,664.7120387554169,2433.9593544006348,34130,8407,25723,25723,0,22,8495000.0
8495,8495999,20.926561972167164,38.032922901353906,0.07587755308515132,3185.680939435959,664.7788586616516,2434.4685020446777,34130,8407,25723,25723,0,22,8496000.0
8496,8496999,20.926557021319905,38.032312570509255,0.07587587208509916,3186.210693359375,664.8465046882629,2434.1804237365723,34134,8409,25725,25725,0,22,8497000.0
8497,8497999,20.926587661120912,38.03169414175874,0.0758709388868879,3186.4926540851593,664.9137127399445,2434.748119354248,34134,8409,25725,25725,0,22,8498000.0
8498,8498999,20.9267425123417,38.03140087276409,0.07586807444780319,3186.9356904029846,664.9802298545837,2434.765613555908,34137,8410,25727,25727,0,22,8499000.0
8499,8499999,20.92675025236588,38.03084606525676,0.0758634416517362,3187.180111169815,665.0480704307556,2435.4522285461426,34137,8410,25727,25727,0,22,8500000.0
8500,8500999,20.92683724268374,38.030482540107705,0.07585545132687077,3187.55153298378,665.1146430969238,2435.8995399475098,34151,8412,25739,25739,0,22,8501000.0
8501,8501999,20.926919819974206,38.0309047562312,0.0758442339115235,3188.042539834976,665.1825361251831,2435.387836456299,34151,8412,25739,25739,0,22,8502000.0
8502,8502999,20.926694794580797,38.02985163230612,0.07584099103902597,3188.28218126297,665.2496826648712,2436.197238922119,34151,8412,25739,25739,0,22,8503000.0
8503,8503999,20.92658630014256,38.02904405873017,0.07583628466246528,3188.9369037151337,665.3179976940155,2435.538806915283,34158,8415,25743,25743,0,22,8504000.0
8504,8504999,20.925802579287772,38.02743349232501,0.07583989864640606,3189.2353513240814,665.383367061615,2436.5938682556152,34167,8415,25752,25752,0,22,8505000.0
8505,8505999,20.92482561617718,38.02588694159141,0.07584387848711882,3189.671079158783,665.4503679275513,2437.2040824890137,34174,8417,25757,25757,0,22,8506000.0
8506,8506999,20.923940385491843,38.0243027921922,0.07584747988929763,3189.9733171463013,665.5185222625732,2437.9628562927246,34177,8418,25759,25759,0,22,8507000.0
8507,8507999,20.923131837257905,38.02336910137661,0.0758488703374498,3190.359090566635,665.5844750404358,2438.549617767334,34181,8420,25761,25761,0,22,8508000.0
8508,8508999,20.922299549984626,38.02188295065925,0.07584929189496126,3190.859965324402,665.6533925533295,2438.652156829834,34185,8422,25763,25763,0,22,8509000.0
8509,8509999,20.921611139378513,38.02092210889989,0.07584979358825461,3191.1903743743896,665.7228729724884,2439.0744285583496,34185,8422,25763,25763,0,22,8510000.0
8510,8510999,20.920877081609746,38.01978663854602,0.0758511580502017,3191.5867354869843,665.7899959087372,2439.347255706787,34187,8423,25764,25764,0,22,8511000.0
8511,8511999,20.92019191720198,38.01911262170455,0.07585753815883,3192.0108399391174,665.8569853305817,2439.43892288208,34189,8424,25765,25765,0,22,8512000.0
8512,8512999,20.919967212018346,38.01967916259866,0.07586532142157465,3192.5604038238525,665.9258761405945,2439.2723426818848,34193,8426,25767,25767,0,22,8513000.0
8513,8513999,20.92037234687681,38.02237535425291,0.0758767755003098,3192.989979028702,665.9961445331573,2439.284610748291,34193,8426,25767,25767,0,22,8514000.0
8514,8514999,20.92048447241884,38.02507462126602,0.07586681789937555,3193.343730211258,666.0646643638611,2439.517505645752,34193,8426,25767,25767,0,22,8515000.0
8515,8515999,20.920545233607104,38.02573756561085,0.07585898922602674,3193.5846407413483,666.1315407752991,2440.297992706299,34193,8426,25767,25767,0,22,8516000.0
8516,8516999,20.920773654251633,38.02674434085995,0.07584173004841677,3194.1694614887238,666.1994361877441,2439.9702110290527,34199,8429,25770,25770,0,22,8517000.0
8517,8517999,20.92110891633961,38.02742274154617,0.07582593237072288,3194.4816720485687,666.265864610672,2440.5360984802246,34201,8430,25771,25771,0,22,8518000.0
8518,8518999,20.921354065078276,38.02771740104725,0.07581903701486248,3194.8697617053986,666.3344595432281,2440.884304046631,34203,8431,25772,25772,0,22,8519000.0
8519,8519999,20.921925172796254,38.02925607283292,0.07580326723591768,3195.1279780864716,666.4022331237793,2441.4449577331543,34203,8431,25772,25772,0,22,8520000.0
8520,8520999,20.92277861305204,38.0306364261849,0.07579351972198922,3195.454666852951,666.4692258834839,2441.764636993408,34203,8431,25772,25772,0,22,8521000.0
8521,8521999,20.92348041865678,38.03190858444701,0.07577834445755138,3195.9992246627808,666.5366704463959,2441.5266456604004,34207,8433,25774,25774,0,22,8522000.0
8522,8522999,20.92394544734906,38.032395544068514,0.07577160790860715,3208.7232961654663,666.6061799526215,2441.460422515869,34207,8433,25774,25774,0,22,8523000.0
8523,8523999,20.923942944764224,38.032234833646875,0.07576811439117836,3209.1997911930084,666.6733710765839,2441.298984527588,34207,8433,25774,25774,0,22,8524000.0
8524,8524999,20.923707123401563,38.031702541562794,0.07575685095186402,3209.5453927516937,666.7364294528961,2442.176975250244,34214,8434,25780,25780,0,22,8525000.0
8525,8525999,20.923349723757983,38.030843565457474,0.07574947275281851,3209.89529132843,666.798547744751,2442.509288787842,34215,8434,25781,25781,0,22,8526000.0
8526,8526999,20.923279312299254,38.03042672263242,0.07573697625073073,3210.2552342414856,666.8622188568115,2442.848247528076,34218,8434,25784,25784,0,22,8527000.0
8527,8527999,20.923141736359614,38.02964225861986,0.07572760447466087,3210.754628419876,666.9265444278717,2442.8628883361816,34223,8436,25787,25787,0,22,8528000.0
8528,8528999,20.923282274062846,38.02936759035121,0.07571999434261967,3211.014700651169,666.9925801753998,2443.8522911071777,34226,8437,25789,25789,0,22,8529000.0
8529,8529999,20.92356465082012,38.02970016840246,0.0757060955749862,3211.3648641109467,667.0560977458954,2444.377597808838,34228,8438,25790,25790,0,22,8530000.0
8530,8530999,20.92387616471456,38.030044034557115,0.07569759166611023,3211.751524209976,667.1188991069794,2444.5968132019043,34230,8439,25791,25791,0,22,8531000.0
8531,8531999,20.924281112580175,38.0309367597092,0.07568501671971761,3212.0993065834045,667.1842594146729,2445.161823272705,34232,8440,25792,25792,0,22,8532000.0
8532,8532999,20.92476951248963,38.03151023192522,0.07567587973992851,3212.5576541423798,667.2494530677795,2445.4857902526855,34241,8443,25798,25798,0,22,8533000.0
8533,8533999,20.924993617830925,38.031593122264105,0.07567354574070861,3213.103905439377,667.3156661987305,2445.1865196228027,34247,8445,25802,25802,0,22,8534000.0
8534,8534999,20.926070895577034,38.03511453767961,0.07566430403599167,3213.6232709884644,667.3817384243011,2444.9889030456543,34249,8446,25803,25803,0,22,8535000.0
8535,8535999,20.927310539748525,38.03679964109262,0.07566999917688788,3214.0998837947845,667.447182893753,2445.099376678467,34255,8448,25807,25807,0,22,8536000.0
8536,8536999,20.928504091211217,38.038479015825914,0.07567136657580742,3214.5551443099976,667.5140323638916,2445.4085578918457,34270,8450,25820,25820,0,22,8537000.0
8537,8537999,20.929945174241855,38.04080954199927,0.07567800150381998,3214.7589712142944,667.5797829627991,2446.2047386169434,34270,8450,25820,25820,0,22,8538000.0
8538,8538999,20.931338843506467,38.04278807049225,0.07569031857137987,3215.248656272888,667.6456382274628,2446.1009483337402,34274,8452,25822,25822,0,22,8539000.0
8539,8539999,20.932974825360766,38.04515403945144,0.07570456323034691,3215.8931324481964,667.7116258144379,2445.6005363464355,34283,8455,25828,25828,0,22,8540000.0
8540,8540999,20.93522194288232,38.04936740587108,0.07571397405882407,3216.551167488098,667.7774014472961,2444.854480743408,34289,8457,25832,25832,0,22,8541000.0
8541,8541999,20.937188874509616,38.052173026750744,0.07573945529809512,3216.849835395813,667.8445038795471,2445.666904449463,34292,8458,25834,25834,0,22,8542000.0
8542,8542999,20.93895381125378,38.05445115941093,0.07576983511764279,3217.3035855293274,667.9085011482239,2445.8622856140137,34297,8460,25837,25837,0,22,8543000.0
8543,8543999,20.939448028520797,38.05463996490881,0.07576832231172137,3217.5572097301483,667.973616361618,2446.987865447998,34301,8460,25841,25841,0,22,8544000.0
8544,8544999,20.939961958267133,38.056208216231376,0.07575297470385056,3217.955585718155,668.041544675827,2447.801128387451,34306,8462,25844,25844,0,22,8545000.0
8545,8545999,20.940879683862207,38.05823826307085,0.07574191718575696,3218.144671678543,668.1076304912567,2448.814929962158,34306,8462,25844,25844,0,22,8546000.0
8546,8546999,20.942011594742485,38.06151522045791,0.07572997534747172,3218.672490119934,668.1750531196594,2449.032482147217,34326,8465,25861,25861,0,22,8547000.0
8547,8547999,20.943160874351538,38.063106602486826,0.07573338796294005,3219.0553164482117,668.243411064148,2449.4361610412598,34330,8466,25864,25864,0,22,8548000.0
8548,8548999,20.9446222697937,38.06566877314106,0.07573748343243081,3219.4522471427917,668.3120307922363,2449.69877243042,34333,8467,25866,25866,0,22,8549000.0
8549,8549999,20.9462659467583,38.06897771698092,0.07573076256984257,3219.8937549591064,668.3795404434204,2449.8723106384277,34348,8469,25879,25879,0,22,8550000.0
8550,8550999,20.94845578129665,38.07575011657565,0.07574601125184866,3220.285781621933,668.4531273841858,2450.567539215088,34363,8470,25893,25893,0,22,8551000.0
8551,8551999,20.95057813619701,38.08069237216219,0.07575205406140029,3220.536550760269,668.5247023105621,2451.4038887023926,34364,8470,25894,25894,0,22,8552000.0
8552,8552999,20.953207118615598,38.08789509961219,0.07576073755358836,3221.0081067085266,668.5971095561981,2451.7101097106934,34369,8472,25897,25897,0,22,8553000.0
8553,8553999,20.955686086761375,38.09476643388529,0.07578673626005306,3221.4612855911255,668.668496131897,2451.8000144958496,34373,8473,25900,25900,0,22,8554000.0
8554,8554999,20.95811661041281,38.10061937196089,0.07581146728103128,3221.7685191631317,668.7416472434998,2452.3129692077637,34373,8473,25900,25900,0,22,8555000.0
8555,8555999,20.960883555709266,38.10670804999802,0.07583301950634536,3222.1730420589447,668.8137586116791,2452.607494354248,34376,8474,25902,25902,0,22,8556000.0
8556,8556999,20.963489634951667,38.1120776674447,0.07581976754339526,3222.7537372112274,668.8848216533661,2452.432872772217,34391,8477,25914,25914,0,22,8557000.0
8557,8557999,20.965864485172784,38.11733714604413,0.07581283929342575,3223.0011694431305,668.954211473465,2453.1625785827637,34391,8477,25914,25914,0,22,8558000.0
8558,8558999,20.968038699592846,38.12101853758083,0.07580141976107946,3223.6353888511658,669.0234110355377,2452.7741355895996,34407,8480,25927,25927,0,22,8559000.0
8559,8559999,20.969000390431106,38.12350760598768,0.07577902529903602,3224.062348842621,669.0885224342346,2453.425075531006,34423,8481,25942,25942,0,22,8560000.0
8560,8560999,20.968985250689553,38.12371339000598,0.07576689246340318,3224.463981628418,669.1523628234863,2454.1648750305176,34429,8483,25946,25946,0,22,8561000.0
8561,8561999,20.969184839592607,38.123898247825494,0.07575816127619006,3224.8592286109924,669.2180469036102,2454.7432594299316,34439,8485,25954,25954,0,22,8562000.0
8562,8562999,20.96920175197088,38.12384261153137,0.07575044272568687,3225.0710847377777,669.2917666435242,2455.711696624756,34440,8485,25955,25955,0,22,8563000.0
8563,8563999,20.969025948056213,38.12295055529521,0.0757459417298979,3225.639939546585,669.3622274398804,2455.721996307373,34456,8488,25968,25968,0,22,8564000.0
8564,8564999,20.969094014290846,38.122496065858165,0.07573707240896688,3226.0066628456116,669.4281668663025,2455.8934593200684,34457,8488,25969,25969,0,22,8565000.0
8565,8565999,20.96927994986716,38.122309877085556,0.07573149196563966,3226.4416358470917,669.4938061237335,2456.2079887390137,34462,8490,25972,25972,0,22,8566000.0
8566,8566999,20.969553154074678,38.122660989626645,0.07572021136460316,3226.73769903183,669.5586483478546,2456.8267860412598,34465,8491,25974,25974,0,22,8567000.0
8567,8567999,20.969706285551037,38.12283636057964,0.07571178954831348,3227.2688014507294,669.6247801780701,2456.5404090881348,34469,8493,25976,25976,0,22,8568000.0
8568,8568999,20.97006333732252,38.12303312680199,0.07570453257938559,3227.965919971466,669.6947662830353,2456.01704788208,34477,8496,25981,25981,0,22,8569000.0
8569,8569999,20.970348109319406,38.123052691494514,0.07569750730614166,3228.4697120189667,669.7618684768677,2455.9545936584473,34482,8498,25984,25984,0,22,8570000.0
8570,8570999,20.970639066131163,38.122931704139205,0.07569209029559021,3228.969563484192,669.8281896114349,2456.1354331970215,34489,8501,25988,25988,0,22,8571000.0
8571,8571999,20.971038367264462,38.122935271835324,0.07568833739463399,3229.2617478370667,669.8936104774475,2456.86128616333,34491,8502,25989,25989,0,22,8572000.0
8572,8572999,20.97149166726593,38.12298032846796,0.07568913219820028,3229.5378375053406,669.9594626426697,2457.454776763916,34491,8502,25989,25989,0,22,8573000.0
8573,8573999,20.971956962568793,38.12298388088944,0.07568566247355724,3229.9914679527283,670.0252275466919,2457.4331016540527,34493,8503,25990,25990,0,22,8574000.0
8574,8574999,20.972797671327196,38.123757394091236,0.07568979287186883,3230.249019384384,670.0931348800659,2458.0371131896973,34493,8503,25990,25990,0,22,8575000.0
8575,8575999,20.97307790931154,38.12344580319604,0.0756913872576398,3230.774602651596,670.1612186431885,2457.9050941467285,34497,8505,25992,25992,0,22,8576000.0
8576,8576999,20.97343509567204,38.123376137112864,0.07569373402072466,3231.1743643283844,670.2270534038544,2458.1267051696777,34500,8506,25994,25994,0,22,8577000.0
8577,8577999,20.973630070709362,38.12287161879846,0.07569570293008143,3231.5544390678406,670.2957766056061,2458.6122703552246,34515,8507,26008,26008,0,22,8578000.0
8578,8578999,20.973440061872207,38.12225443110422,0.07568605623141345,3231.8781344890594,670.3610904216766,2459.893871307373,34529,8508,26021,26021,0,22,8579000.0
8579,8579999,20.973019459885673,38.12174724830242,0.07567816437212982,3232.205097436905,670.4280097484589,2460.47367477417,34530,8508,26022,26022,0,22,8580000.0
8580,8580999,20.972501361207733,38.12055673764413,0.07567320086212137,3232.6322722434998,670.4941003322601,2460.6654319763184,34532,8509,26023,26023,0,22,8581000.0
8581,8581999,20.97228250527469,38.12014271868542,0.07566514977280658,3232.837048768997,670.5597681999207,2461.6964683532715,34532,8509,26023,26023,0,22,8582000.0
8582,8582999,20.971974021277155,38.119400029157035,0.07565862554788472,3233.2198905944824,670.624094247818,2461.87349319458,34534,8510,26024,26024,0,22,8583000.0
8583,8583999,20.971676682152104,38.11859329305022,0.07565160528848036,3233.813090801239,670.6916735172272,2461.4815940856934,34538,8512,26026,26026,0,22,8584000.0
8584,8584999,20.971631155942454,38.1184408868944,0.0756398979129731,3234.1857237815857,670.7566132545471,2461.8708000183105,34541,8513,26028,26028,0,22,8585000.0
8585,8585999,20.97159411129936,38.11803169409755,0.07563305508801588,3234.7165088653564,670.82244181633,2461.756534576416,34546,8515,26031,26031,0,22,8586000.0
8586,8586999,20.971786023895778,38.11836973191882,0.07561910498860136,3235.1665403842926,670.8894054889679,2462.1090660095215,34552,8517,26035,26035,0,22,8587000.0
8587,8587999,20.972245120096122,38.119469206321824,0.0756062234232262,3235.3673663139343,670.954252243042,2463.102062225342,34552,8517,26035,26035,0,22,8588000.0
8588,8588999,20.972497738248485,38.1198463040263,0.07560031670390199,3235.704858779907,671.0226876735687,2463.330539703369,34552,8517,26035,26035,0,22,8589000.0
8589,8589999,20.97268666715559,38.11982349520313,0.07559476384488084,3236.0444247722626,671.0880784988403,2463.7946586608887,34554,8518,26036,26036,0,22,8590000.0
8590,8590999,20.972953315621382,38.11989434461651,0.07559094546944034,3236.420738220215,671.1538138389587,2464.170177459717,34556,8519,26037,26037,0,22,8591000.0
8591,8591999,20.97305477141524,38.11974189302234,0.07558863120775716,3236.8550148010254,671.221333026886,2463.9687843322754,34556,8519,26037,26037,0,22,8592000.0
8592,8592999,20.973297222467416,38.11975756907746,0.07558530498743854,3237.3775749206543,671.2885673046112,2463.6300926208496,34559,8520,26039,26039,0,22,8593000.0
8593,8593999,20.973551994513112,38.11982586937822,0.07558346305302721,3237.7195274829865,671.3588304519653,2463.939167022705,34559,8520,26039,26039,0,22,8594000.0
8594,8594999,20.973695386963666,38.119256449034516,0.07558140819771186,3238.080348968506,671.4271998405457,2464.252414703369,34561,8521,26040,26040,0,22,8595000.0
8595,8595999,20.973914458320543,38.119010927634626,0.07557827889912916,3238.577479362488,671.4997987747192,2464.2132606506348,34563,8522,26041,26041,0,22,8596000.0
8596,8596999,20.973865053342593,38.118181372693165,0.07557534041846625,3239.026644229889,671.5689380168915,2464.210178375244,34565,8523,26042,26042,0,22,8597000.0
8597,8597999,20.973832087778156,38.11830702292969,0.07557236335891859,3239.4141507148743,671.6404664516449,2464.5421104431152,34567,8524,26043,26043,0,22,8598000.0
8598,8598999,20.973582315636968,38.11749878065333,0.07555715094300619,3239.8404083251953,671.706506729126,2465.2426719665527,34584,8525,26059,26059,0,22,8599000.0
8599,8599999,20.973348996377005,38.11714965738019,0.07555914180408041,3240.2401571273804,671.7704017162323,2465.727741241455,34587,8526,26061,26061,0,22,8600000.0
8600,8600999,20.972804178096872,38.11597620951931,0.07558271296206698,3240.4450590610504,671.8353049755096,2466.668155670166,34587,8526,26061,26061,0,22,8601000.0
8601,8601999,20.972301381170148,38.11480535645133,0.0755910699375667,3240.723530292511,671.9052832126617,2467.20210647583,34587,8526,26061,26061,0,22,8602000.0
8602,8602999,20.971829285795074,38.114028904345574,0.07559239274167007,3241.3923473358154,671.969967842102,2466.9093742370605,34597,8530,26067,26067,0,22,8603000.0
8603,8603999,20.97159555227283,38.1133094345961,0.07559216567533544,3241.8220179080963,672.034298658371,2466.888080596924,34600,8531,26069,26069,0,22,8604000.0
8604,8604999,20.97131149037944,38.11310659582295,0.07558146206691829,3242.2181248664856,672.0981397628784,2467.30562210083,34616,8533,26083,26083,0,22,8605000.0
8605,8605999,20.970855487087725,38.11208718103034,0.07557629047431025,3242.711439371109,672.1632564067841,2467.5987586975098,34622,8536,26086,26086,0,22,8606000.0
8606,8606999,20.970520368826264,38.11105692786481,0.07557835874269137,3243.069741487503,672.2319571971893,2468.106830596924,34625,8537,26088,26088,0,22,8607000.0
8607,8607999,20.970140126958423,38.110345531316504,0.07557782924155021,3243.539605140686,672.2970747947693,2468.0671882629395,34627,8538,26089,26089,0,22,8608000.0
8608,8608999,20.96965586104695,38.10911070135143,0.0755773291277907,3243.96785902977,672.3630278110504,2468.2322578430176,34629,8539,26090,26090,0,22,8609000.0
8609,8609999,20.96921876707838,38.10936365409618,0.07557872013654865,3244.299983024597,672.4269959926605,2468.562526702881,34629,8539,26090,26090,0,22,8610000.0
8610,8610999,20.968836817790287,38.108389902222356,0.07557951221730053,3244.78493642807,672.4909114837646,2468.616008758545,34634,8541,26093,26093,0,22,8611000.0
8611,8611999,20.96822510522658,38.10738870127921,0.07558563723003164,3245.0811307430267,672.5573229789734,2469.2462425231934,34636,8542,26094,26094,0,22,8612000.0
8612,8612999,20.967883268835454,38.10629109877248,0.07558700056285628,3245.5395419597626,672.6226179599762,2469.1222648620605,34639,8543,26096,26096,0,22,8613000.0
8613,8613999,20.96744886858143,38.10518772380115,0.07559049306622645,3245.8762679100037,672.6870810985565,2469.3421363830566,34639,8543,26096,26096,0,22,8614000.0
8614,8614999,20.96704398805347,38.10398310177665,0.0755965618317137,3246.503551006317,672.752185344696,2468.5587043762207,34645,8545,26100,26100,0,22,8615000.0
8615,8615999,20.96659323303009,38.10279169397677,0.07560119861232006,3247.0867626667023,672.8203890323639,2468.2426795959473,34650,8547,26103,26103,0,22,8616000.0
8616,8616999,20.966105906288345,38.10160483749288,0.07560688303920571,3247.3960688114166,672.8858911991119,2468.7509803771973,34650,8547,26103,26103,0,22,8617000.0
8617,8617999,20.965401119326042,38.10012416240719,0.07561070208000953,3247.9006848335266,672.9535639286041,2468.729923248291,34654,8549,26105,26105,0,22,8618000.0
8618,8618999,20.964724479951474,38.100732650515006,0.07560434262837412,3248.3423974514008,673.0192642211914,2469.450168609619,34665,8551,26114,26114,0,22,8619000.0
8619,8619999,20.963704125292868,38.09916572769058,0.07560902057923458,3248.52832531929,673.0858120918274,2470.6099967956543,34666,8551,26115,26115,0,22,8620000.0
8620,8620999,20.96278982890031,38.09790921177445,0.0756128802216488,3248.970572948456,673.15190076828,2470.672710418701,34669,8552,26117,26117,0,22,8621000.0
8621,8621999,20.962070244487755,38.09680658421181,0.07561492844251616,3249.174086332321,673.2168018817902,2471.66752243042,34669,8552,26117,26117,0,22,8622000.0
8622,8622999,20.961354934709025,38.095719642710826,0.07561623933923978,3249.4199566841125,673.2833704948425,2472.263568878174,34671,8552,26119,26119,0,22,8623000.0
8623,8623999,20.960629951934706,38.094571903996616,0.07562058443853548,3250.0754754543304,673.3502769470215,2471.9501991271973,34678,8556,26122,26122,0,22,8624000.0
8624,8624999,20.959859968540314,38.09317359576863,0.07562497411179148,3250.3755548000336,673.4188275337219,2472.441074371338,34678,8556,26122,26122,0,22,8625000.0
8625,8625999,20.959109717502095,38.09220899634176,0.0756256902671385,3250.6615192890167,673.486005783081,2472.9241523742676,34678,8556,26122,26122,0,22,8626000.0
8626,8626999,20.95858930091274,38.092157076593246,0.07562247023183,3250.970198869705,673.5529100894928,2473.1812629699707,34678,8556,26122,26122,0,22,8627000.0
8627,8627999,20.95808948190291,38.09321214864135,0.07561453497672355,3251.345451116562,673.6237807273865,2473.4780082702637,34680,8557,26123,26123,0,22,8628000.0
8628,8628999,20.95757391141653,38.09243605502062,0.07562089281236617,3252.1022045612335,673.6918289661407,2472.343318939209,34685,8560,26125,26125,0,22,8629000.0
8629,8629999,20.957228351938145,38.09362424472665,0.07561608297141231,3252.5974357128143,673.761684179306,2472.6812019348145,34690,8563,26127,26127,0,22,8630000.0
8630,8630999,20.956881512282212,38.09284117358085,0.07561504143651043,3252.8859164714813,673.8315160274506,2473.2390937805176,34690,8563,26127,26127,0,22,8631000.0
8631,8631999,20.956708415111578,38.092241020163776,0.07561609892270305,3253.1758375167847,673.9004588127136,2473.709873199463,34690,8563,26127,26127,0,22,8632000.0
8632,8632999,20.956404083663706,38.091423408325,0.07561994644555381,3253.5695683956146,673.9701282978058,2473.6242485046387,34690,8563,26127,26127,0,22,8633000.0
8633,8633999,20.956226937522526,38.090814104769215,0.07562220722895074,3254.017299890518,674.0390477180481,2473.5221824645996,34692,8564,26128,26128,0,22,8634000.0
8634,8634999,20.956133265707596,38.090290443507676,0.075622636094687,3254.3522601127625,674.1116170883179,2473.9060554504395,34692,8564,26128,26128,0,22,8635000.0
8635,8635999,20.9560040194749,38.08976047394426,0.07562329623161379,3254.920131444931,674.1796853542328,2473.31986618042,34704,8565,26139,26139,0,22,8636000.0
8636,8636999,20.955668048710322,38.088717207350506,0.07562734798560067,3255.1888813972473,674.2486090660095,2473.8182411193848,34704,8565,26139,26139,0,22,8637000.0
8637,8637999,20.955482135172627,38.088069458068894,0.07562474678668252,3255.618473291397,674.318525314331,2473.9167442321777,34716,8566,26150,26150,0,22,8638000.0
8638,8638999,20.955062568908765,38.08753551013852,0.07562112027327306,3255.9135529994965,674.3870131969452,2475.0032691955566,34729,8567,26162,26162,0,22,8639000.0
8639,8639999,20.95425770188723,38.08663882343136,0.07561943224409018,3256.265257835388,674.4549059867859,2475.7904777526855,34744,8568,26176,26176,0,22,8640000.0
8640,8640999,20.953421294760194,38.085329523841935,0.07561934693633621,3256.514382839203,674.5226409435272,2476.6276206970215,34745,8568,26177,26177,0,22,8641000.0
8641,8641999,20.9527880759693,38.084460453142114,0.07561730213218598,3256.9112586975098,674.5916774272919,2477.2599754333496,34749,8570,26179,26179,0,22,8642000.0
8642,8642999,20.95197103236515,38.08321797927896,0.07561918469283446,3257.2759623527527,674.658727645874,2477.8519859313965,34755,8572,26183,26183,0,22,8643000.0
8643,8643999,20.951318835858803,38.0820899676191,0.07561775246117264,3257.728967189789,674.7281935214996,2477.800022125244,34757,8573,26184,26184,0,22,8644000.0
8644,8644999,20.950671026472445,38.08104535957756,0.07561583527522286,3258.0841886997223,674.7976040840149,2478.2273139953613,34757,8573,26184,26184,0,22,8645000.0
8645,8645999,20.95003948561227,38.07977804417967,0.07561379010623082,3258.2448132038116,674.8642749786377,2479.2094917297363,34757,8573,26184,26184,0,22,8646000.0
8646,8646999,20.94932923612076,38.078338665453515,0.07561353806869531,3258.85569190979,674.9342322349548,2478.8560829162598,34765,8576,26189,26189,0,22,8647000.0
8647,8647999,20.94868899878275,38.07701946612938,0.07561110341541566,3259.5056993961334,675.0034885406494,2478.4551887512207,34771,8579,26192,26192,0,22,8648000.0
8648,8648999,20.948050652974057,38.07565108281156,0.07560864945919166,3259.9943816661835,675.0737211704254,2478.326976776123,34774,8580,26194,26194,0,22,8649000.0
8649,8649999,20.947568012981147,38.07464321835064,0.07560069220840326,3260.40779709816,675.1452307701111,2478.486225128174,34776,8581,26195,26195,0,22,8650000.0
8650,8650999,20.947230300217345,38.073805450420366,0.07558874171096797,3260.7588696479797,675.214197397232,2478.9352378845215,34778,8582,26196,26196,0,22,8651000.0
8651,8651999,20.946835473459853,38.07312525224122,0.07557865948547104,3261.25590801239,675.2851469516754,2478.8521308898926,34783,8584,26199,26199,0,22,8652000.0
8652,8652999,20.946473487031692,38.072132288945916,0.07556935352751648,3261.8275215625763,675.3560461997986,2478.635456085205,34790,8587,26203,26203,0,22,8653000.0
8653,8653999,20.94624809632376,38.071337483632185,0.07555695000316309,3262.3462471961975,675.42591547966,2478.4898796081543,34795,8589,26206,26206,0,22,8654000.0
8654,8654999,20.946073939825137,38.07072153496075,0.07554821409264512,3262.6947236061096,675.495542049408,2478.9367713928223,34808,8590,26218,26218,0,22,8655000.0
8655,8655999,20.94579585347172,38.069785003339476,0.07554201760549573,3263.3749351501465,675.5654666423798,2478.0217628479004,34812,8592,26220,26220,0,22,8656000.0
8656,8656999,20.94557429527724,38.06916748186333,0.07553390785570502,3263.6418027877808,675.6372411251068,2478.74955368042,34812,8592,26220,26220,0,22,8657000.0
8657,8657999,20.945540688782245,38.06860188167705,0.07552254792771207,3263.9309029579163,675.708393573761,2479.2479667663574,34812,8592,26220,26220,0,22,8658000.0
8658,8658999,20.945176535739854,38.067548237064436,0.07551633495790855,3264.2876060009003,675.7779340744019,2479.637348175049,34814,8593,26221,26221,0,22,8659000.0
8659,8659999,20.94453114459337,38.066994454590265,0.07551196672021065,3264.6160769462585,675.839586019516,2480.6392860412598,34825,8594,26231,26231,0,22,8660000.0
8660,8660999,20.943809729050585,38.066315991020375,0.0755084008903606,3265.004867553711,675.9043457508087,2480.970645904541,34827,8595,26232,26232,0,22,8661000.0
8661,8661999,20.94309488746912,38.06512271580148,0.07550660547546817,3265.262279033661,675.9683179855347,2481.6766471862793,34828,8595,26233,26233,0,22,8662000.0
8662,8662999,20.942793914509984,38.06508863912634,0.0754983685513585,3265.5554971694946,676.0314192771912,2482.2215843200684,34828,8595,26233,26233,0,22,8663000.0
8663,8663999,20.942298271453428,38.06376724394483,0.07549362211296695,3266.2483155727386,676.0963530540466,2481.8323402404785,34859,8599,26260,26260,0,22,8664000.0
8664,8664999,20.941931350527177,38.06259655929087,0.07548460179046146,3266.476410150528,676.1613836288452,2482.58549118042,34859,8599,26260,26260,0,22,8665000.0
8665,8665999,20.941674598870446,38.06158872016942,0.0754762185397746,3266.9825835227966,676.2262992858887,2482.5097312927246,34864,8601,26263,26263,0,22,8666000.0
8666,8666999,20.941297873376815,38.06043330517985,0.07546861492531132,3267.4011936187744,676.2923169136047,2482.6777687072754,34867,8602,26265,26265,0,22,8667000.0
8667,8667999,20.94105433438906,38.060045640489484,0.07545877408849111,3267.8659567832947,676.3565936088562,2482.8710289001465,34873,8604,26269,26269,0,22,8668000.0
8668,8668999,20.940713061916583,38.058857056984195,0.07545295907810978,3268.5550088882446,676.4239151477814,2482.8064918518066,34894,8609,26285,26285,0,22,8669000.0
8669,8669999,20.940341335000618,38.05769896063262,0.07544886964479991,3268.977509498596,676.4907693862915,2483.1928367614746,34900,8611,26289,26289,0,22,8670000.0
8670,8670999,20.939979833851567,38.05659763713285,0.0754441477563561,3269.4621210098267,676.5571331977844,2483.096691131592,34903,8612,26291,26291,0,22,8671000.0
8671,8671999,20.939788471800426,38.055806203515914,0.07543913600613694,3269.993501186371,676.6222102642059,2482.7885398864746,34906,8613,26293,26293,0,22,8672000.0
8672,8672999,20.939775957660906,38.055250074865874,0.0754312262621546,3270.2380368709564,676.6952431201935,2483.6354637145996,34906,8613,26293,26293,0,22,8673000.0
8673,8673999,20.93972998588075,38.05453352148844,0.0754249912763002,3270.543044090271,676.7673411369324,2484.0761222839355,34906,8613,26293,26293,0,22,8674000.0
8674,8674999,20.939750735645084,38.05387516847887,0.07541747333096738,3270.7992572784424,676.8338725566864,2484.633533477783,34906,8613,26293,26293,0,22,8675000.0
8675,8675999,20.940009827852464,38.053499902444344,0.07541001205489495,3271.1843481063843,676.9000234603882,2484.8049964904785,34908,8614,26294,26294,0,22,8676000.0
8676,8676999,20.94019587582318,38.05312911455469,0.07540469656280535,3271.60679602623,676.9655134677887,2484.7391929626465,34908,8614,26294,26294,0,22,8677000.0
8677,8677999,20.940275643011567,38.05264011160282,0.07539862598834868,3271.9215059280396,677.035587310791,2485.2335777282715,34908,8614,26294,26294,0,22,8678000.0
8678,8678999,20.940195140603812,38.051787166897,0.0753971416515663,3272.1724166870117,677.1009414196014,2485.7159538269043,34908,8614,26294,26294,0,22,8679000.0
8679,8679999,20.9402746072444,38.0512434638276,0.07538939932152433,3272.7700839042664,677.1729881763458,2485.8592262268066,34924,8616,26308,26308,0,22,8680000.0
8680,8680999,20.940380512212368,38.05172216610237,0.07537851778654547,3273.0107457637787,677.2384963035583,2487.0732917785645,34927,8616,26311,26311,0,22,8681000.0
8681,8681999,20.940272661559614,38.051719652355274,0.07536886903332574,3273.4345541000366,677.3038558959961,2487.6599159240723,34933,8618,26315,26315,0,22,8682000.0
8682,8682999,20.940395000096895,38.05156340593988,0.07535460703615093,3273.7572164535522,677.3722984790802,2488.4205284118652,34936,8619,26317,26317,0,22,8683000.0
8683,8683999,20.940548195100206,38.05197543997979,0.07534577121546693,3274.361978530884,677.4389736652374,2488.438335418701,34955,8623,26332,26332,0,22,8684000.0
8684,8684999,20.94091912440894,38.05237108530813,0.07533867996340315,3274.6818063259125,677.5115180015564,2489.1608123779297,34958,8624,26334,26334,0,22,8685000.0
8685,8685999,20.941008350222045,38.05263007411956,0.07533068230383688,3275.1528367996216,677.5771226882935,2489.125846862793,34960,8625,26335,26335,0,22,8686000.0
8686,8686999,20.94130911740597,38.05376894715651,0.07531557286426438,3275.951378107071,677.6490135192871,2488.6521377563477,34970,8630,26340,26340,0,22,8687000.0
8687,8687999,20.94168729280094,38.05390361833443,0.07531668959830151,3276.209973335266,677.715398311615,2489.4664001464844,34970,8630,26340,26340,0,22,8688000.0
8688,8688999,20.942314328890227,38.05619939111908,0.07531065944055204,3276.6895916461945,677.7838571071625,2489.3933486938477,34972,8631,26341,26341,0,22,8689000.0
8689,8689999,20.94282448462924,38.05700367778222,0.07532185925260404,3277.110449552536,677.852569103241,2489.5785369873047,34974,8632,26342,26342,0,22,8690000.0
8690,8690999,20.943986502357692,38.05913737671645,0.07533750014672413,3277.579748392105,677.9214103221893,2489.570381164551,34977,8633,26344,26344,0,22,8691000.0
8691,8691999,20.94521073129542,38.061786709058126,0.07535897053368923,3278.067752599716,677.990257024765,2489.315460205078,34979,8634,26345,26345,0,22,8692000.0
8692,8692999,20.94637628390156,38.06364843680448,0.07538352984208174,3278.325615644455,678.0597808361053,2490.1021118164062,34979,8634,26345,26345,0,22,8693000.0
8693,8693999,20.948094788596244,38.068037495507674,0.0753978386156069,3278.703652381897,678.1263422966003,2490.3145446777344,34979,8634,26345,26345,0,22,8694000.0
8694,8694999,20.949534564560043,38.071039074147926,0.07541436546582458,3278.9219360351562,678.193598985672,2491.164031982422,34979,8634,26345,26345,0,22,8695000.0
8695,8695999,20.950443795080922,38.07274488793031,0.07543210555401292,3279.313197374344,678.2622797489166,2491.2200927734375,34979,8634,26345,26345,0,22,8696000.0
8696,8696999,20.951370781311294,38.07446779456244,0.07543365811545699,3279.914134502411,678.3299543857574,2491.3652954101562,34989,8636,26353,26353,0,22,8697000.0
8697,8697999,20.951099760175296,38.0739812749715,0.07542489668518315,3280.282706260681,678.396671295166,2491.9548568725586,34993,8637,26356,26356,0,22,8698000.0
8698,8698999,20.951007672396745,38.07387605263138,0.07541471708933678,3280.988192796707,678.4643416404724,2491.2810821533203,35002,8640,26362,26362,0,22,8699000.0
8699,8699999,20.950499699161274,38.072863629259366,0.07541165281964646,3281.2741973400116,678.5299022197723,2491.974494934082,35002,8640,26362,26362,0,22,8700000.0
8700,8700999,20.950170701700007,38.07228686696495,0.07540486058285789,3281.7735006809235,678.5999624729156,2492.227226257324,35019,8643,26376,26376,0,22,8701000.0
8701,8701999,20.949705613993963,38.07124929502246,0.07539468373553693,3282.256535768509,678.6659276485443,2492.0010375976562,35021,8644,26377,26377,0,22,8702000.0
8702,8702999,20.94912407769719,38.069869506822066,0.0753909662782124,3282.661596059799,678.7372627258301,2492.276077270508,35023,8645,26378,26378,0,22,8703000.0
8703,8703999,20.948747461632838,38.06896974211681,0.07538449585353069,3283.3543355464935,678.8123981952667,2491.930107116699,35033,8649,26384,26384,0,22,8704000.0
8704,8704999,20.948405822752957,38.06806943814754,0.07537936953192537,3283.8684253692627,678.8819265365601,2492.1336364746094,35040,8652,26388,26388,0,22,8705000.0
8705,8705999,20.94814205528787,38.067388274771766,0.07537134464761175,3284.2825243473053,678.9485654830933,2492.6300888061523,35045,8654,26391,26391,0,22,8706000.0
8706,8706999,20.948027993126363,38.06729513427323,0.07536266399542779,3284.6625385284424,679.0211572647095,2492.8258743286133,35045,8654,26391,26391,0,22,8707000.0
8707,8707999,20.94787053008436,38.06659599139559,0.07535561057295592,3285.2296891212463,679.0908949375153,2492.606903076172,35050,8656,26394,26394,0,22,8708000.0
8708,8708999,20.947742111024606,38.06587754013231,0.0753487462212743,3285.6101071834564,679.1563379764557,2492.9550018310547,35053,8657,26396,26396,0,22,8709000.0
8709,8709999,20.947932815117237,38.065955628672505,0.07533928459698647,3285.9961218833923,679.2262570858002,2493.3124923706055,35055,8658,26397,26397,0,22,8710000.0
8710,8710999,20.948014119798874,38.06561360158456,0.07533432349841152,3286.3503997325897,679.2937157154083,2493.793411254883,35058,8659,26399,26399,0,22,8711000.0
8711,8711999,20.948068760038474,38.06549848236038,0.07532737066345707,3286.72229552269,679.3618965148926,2494.102180480957,35060,8660,26400,26400,0,22,8712000.0
8712,8712999,20.948345690066517,38.06531260464051,0.07532263412448614,3287.0561215877533,679.4286525249481,2494.246421813965,35060,8660,26400,26400,0,22,8713000.0
8713,8713999,20.94861977527283,38.06539789539031,0.07531639969105497,3287.5309669971466,679.4974179267883,2493.8406143188477,35060,8660,26400,26400,0,22,8714000.0
8714,8714999,20.949013090287416,38.065435240668265,0.07531115168347402,3287.8984179496765,679.5651099681854,2494.1796112060547,35063,8661,26402,26402,0,22,8715000.0
8715,8715999,20.94906287041566,38.06500212588232,0.07530694791092596,3288.3250625133514,679.6340501308441,2494.463218688965,35065,8663,26402,26402,0,22,8716000.0
8716,8716999,20.949038489158912,38.06519532497657,0.07526619555103076,3288.7137269973755,679.698888540268,2495.3223037719727,35079,8664,26415,26415,0,22,8717000.0
8717,8717999,20.94847374566406,38.06445010279715,0.07525605818811287,3289.190118789673,679.7635436058044,2495.5071334838867,35086,8666,26420,26420,0,22,8718000.0
8718,8718999,20.947951886581507,38.06337628114887,0.0752468870141555,3289.5960664749146,679.8318510055542,2495.8500595092773,35089,8667,26422,26422,0,22,8719000.0
8719,8719999,20.94757358448396,38.06249331101544,0.0752356148058394,3289.9012389183044,679.8981628417969,2496.579216003418,35091,8668,26423,26423,0,22,8720000.0
8720,8720999,20.9470275390276,38.061483657665725,0.07522907033040238,3290.3312389850616,679.96501994133,2496.6203689575195,35093,8669,26424,26424,0,22,8721000.0
8721,8721999,20.94634852681134,38.06007910685945,0.07522543006942872,3290.8080761432648,680.0318922996521,2496.6200256347656,35098,8671,26427,26427,0,22,8722000.0
8722,8722999,20.945864031096534,38.059179771675716,0.07521595956234028,3291.3032026290894,680.0985765457153,2496.4741592407227,35100,8672,26428,26428,0,22,8723000.0
8723,8723999,20.94528563710379,38.05782111592715,0.07520988665391437,3291.8208422660828,680.1650469303131,2496.876708984375,35108,8675,26433,26433,0,22,8724000.0
8724,8724999,20.94497765988081,38.05728842130826,0.0751989271161273,3292.07945394516,680.2302842140198,2497.859306335449,35111,8676,26435,26435,0,22,8725000.0
8725,8725999,20.944532822162735,38.056159092830256,0.0751910031194285,3292.351737976074,680.296389579773,2498.28556060791,35111,8676,26435,26435,0,22,8726000.0
8726,8726999,20.944085956666562,38.055022951334934,0.0751854445886857,3292.826126098633,680.3624105453491,2498.1684188842773,35114,8677,26437,26437,0,22,8727000.0
8727,8727999,20.943699105401098,38.0540634798659,0.07517890360520085,3293.3837807178497,680.4312341213226,2497.9048767089844,35120,8679,26441,26441,0,22,8728000.0
8728,8728999,20.943387713911285,38.053165171809106,0.07517361067740902,3293.8600635528564,680.4986710548401,2497.8445739746094,35122,8680,26442,26442,0,22,8729000.0
8729,8729999,20.94342398349091,38.05288215718178,0.07516408264590346,3294.182666540146,680.5659530162811,2498.207275390625,35122,8680,26442,26442,0,22,8730000.0
8730,8730999,20.94330325187028,38.05217972497539,0.07515923366051114,3294.4137423038483,680.6331343650818,2498.8605346679688,35122,8680,26442,26442,0,22,8731000.0
8731,8731999,20.943301546215363,38.0516222512874,0.07515177463678191,3295.0459022521973,680.7005565166473,2498.0578384399414,35134,8681,26453,26453,0,22,8732000.0
8732,8732999,20.943484393783983,38.05127507941045,0.07514445820106819,3295.303187608719,680.7730157375336,2498.9322967529297,35134,8681,26453,26453,0,22,8733000.0
8733,8733999,20.94373068503395,38.05096685778829,0.0751381256215905,3295.562056541443,680.8420677185059,2499.4823150634766,35134,8681,26453,26453,0,22,8734000.0
8734,8734999,20.94371676398104,38.050227804877686,0.07513289796836031,3296.1018805503845,680.9108471870422,2499.1406478881836,35137,8682,26455,26455,0,22,8735000.0
8735,8735999,20.94377173284373,38.049795290199235,0.07512761136079149,3296.3866798877716,680.9796440601349,2499.6158142089844,35137,8682,26455,26455,0,22,8736000.0
8736,8736999,20.94362464048521,38.04995053408528,0.07511566121636537,3296.8060505390167,681.0446560382843,2500.1873321533203,35153,8683,26470,26470,0,22,8737000.0
8737,8737999,20.943967988588547,38.05244308529075,0.07510885488816677,3297.056337118149,681.1096863746643,2501.4248580932617,35164,8684,26480,26480,0,22,8738000.0
8738,8738999,20.943780128377487,38.05300744267787,0.0751183564654192,3297.4095356464386,681.1717691421509,2501.997627258301,35169,8686,26483,26483,0,22,8739000.0
8739,8739999,20.944144183006674,38.05554933072496,0.07514619911169218,3297.762446641922,681.2355077266693,2502.7355575561523,35174,8688,26486,26486,0,22,8740000.0
8740,8740999,20.944615560589938,38.05771269403026,0.0751379425639449,3298.355946302414,681.3009359836578,2502.5127029418945,35180,8691,26489,26489,0,22,8741000.0
8741,8741999,20.94503278789141,38.0604035048738,0.07515028733122031,3298.785021543503,681.3665051460266,2502.6603469848633,35186,8692,26494,26494,0,22,8742000.0
8742,8742999,20.94573722365623,38.063392645177245,0.07517751513750215,3299.2594060897827,681.4306774139404,2503.0745697021484,35192,8695,26497,26497,0,22,8743000.0
8743,8743999,20.94604804266481,38.06483195639627,0.07519979681312883,3299.664905309677,681.4951221942902,2503.240821838379,35194,8696,26498,26498,0,22,8744000.0
8744,8744999,20.946557917406928,38.06642169289094,0.0752331973634095,3299.891914367676,681.5581481456757,2504.044578552246,35194,8696,26498,26498,0,22,8745000.0
8745,8745999,20.947199362973326,38.06811593158121,0.07524316846058021,3300.497303009033,681.6235988140106,2503.7867736816406,35201,8699,26502,26502,0,22,8746000.0
8746,8746999,20.947844397446623,38.06923058899189,0.07526826878818049,3300.9323320388794,681.688987493515,2503.9990463256836,35203,8700,26503,26503,0,22,8747000.0
8747,8747999,20.948631897080766,38.07248459412093,0.07528864297314164,3301.2344937324524,681.7539184093475,2504.6722869873047,35215,8701,26514,26514,0,22,8748000.0
8748,8748999,20.94981360555945,38.07434195090108,0.07531237287967518,3301.589275121689,681.8179085254669,2504.931739807129,35221,8702,26519,26519,0,22,8749000.0
8749,8749999,20.95065148564785,38.07546752122382,0.07534633620640652,3301.98787856102,681.8878352642059,2505.2022705078125,35223,8703,26520,26520,0,22,8750000.0
8750,8750999,20.95194298779964,38.077719399357505,0.0753637680536845,3302.538403749466,681.9525799751282,2504.8250732421875,35225,8704,26521,26521,0,22,8751000.0
8751,8751999,20.953288198555356,38.07991260178956,0.07539177103297201,3303.197193622589,682.0180277824402,2504.0058059692383,35229,8706,26523,26523,0,22,8752000.0
8752,8752999,20.95444935814156,38.081611023568556,0.0754160357006719,3303.535329580307,682.0832290649414,2504.5054473876953,35231,8707,26524,26524,0,22,8753000.0
8753,8753999,20.955701372740535,38.08295164264339,0.07542122952421093,3303.8035056591034,682.147385597229,2505.1331939697266,35231,8707,26524,26524,0,22,8754000.0
8754,8754999,20.955779717192303,38.08298073115167,0.07541189957732253,3304.173266172409,682.2170653343201,2505.98690032959,35244,8708,26536,26536,0,22,8755000.0
8755,8755999,20.9554194794852,38.08379848878183,0.07540028243709618,3304.562592983246,682.2809422016144,2506.576446533203,35250,8709,26541,26541,0,22,8756000.0
8756,8756999,20.954926822036505,38.08306476961783,0.07539486957473451,3304.763852596283,682.3573791980743,2507.6996154785156,35250,8709,26541,26541,0,22,8757000.0
8757,8757999,20.954832161912915,38.084012392227216,0.07538237563838601,3305.035971403122,682.4228413105011,2508.291374206543,35250,8709,26541,26541,0,22,8758000.0
8758,8758999,20.95450609713072,38.083587435431006,0.07537738024697915,3305.4486076831818,682.4876501560211,2508.717170715332,35254,8711,26543,26543,0,22,8759000.0
8759,8759999,20.954427047646732,38.08321081268502,0.07537078099855443,3306.0481173992157,682.5563225746155,2508.7117919921875,35270,8715,26555,26555,0,22,8760000.0
8760,8760999,20.954425593386606,38.08286436710914,0.07536310383783507,3306.523223400116,682.6234402656555,2508.7806854248047,35275,8717,26558,26558,0,22,8761000.0
8761,8761999,20.954620389346275,38.08296670294736,0.07535318915433431,3307.184398651123,682.6908612251282,2508.7044219970703,35287,8722,26565,26565,0,22,8762000.0
8762,8762999,20.955262343550828,38.08416797617355,0.07534513559081457,3307.7373328208923,682.7574961185455,2508.6897735595703,35294,8724,26570,26570,0,22,8763000.0
8763,8763999,20.95624493112637,38.086219816425746,0.07534434721354888,3308.2493529319763,682.8266756534576,2508.806221008301,35299,8726,26573,26573,0,22,8764000.0
8764,8764999,20.957278072774496,38.0880844970271,0.0753419222074938,3308.601502895355,682.8930077552795,2509.2692337036133,35302,8727,26575,26575,0,22,8765000.0
8765,8765999,20.95863604815733,38.09053916681773,0.07534459110751157,3308.889522075653,682.9585108757019,2509.979164123535,35304,8728,26576,26576,0,22,8766000.0
8766,8766999,20.96008612228732,38.093440435213715,0.07535213777094674,3309.357449054718,683.0257873535156,2509.859344482422,35306,8729,26577,26577,0,22,8767000.0
8767,8767999,20.961693384936567,38.09639189340266,0.07536350943259529,3309.655962705612,683.0919342041016,2510.455047607422,35308,8730,26578,26578,0,22,8768000.0
8768,8768999,20.96350066519127,38.09939899456604,0.0753895627550285,3310.3644330501556,683.1585583686829,2509.720344543457,35326,8733,26593,26593,0,22,8769000.0
8769,8769999,20.965445456926645,38.10276644507244,0.07542331900264576,3310.7862696647644,683.2238490581512,2509.9510192871094,35328,8734,26594,26594,0,22,8770000.0
8770,8770999,20.96773817423263,38.10819122058393,0.07545269798455745,3311.173346757889,683.2908203601837,2510.219841003418,35340,8735,26605,26605,0,22,8771000.0
8771,8771999,20.969474329118178,38.11073800893409,0.07549445440765168,3311.6802706718445,683.3566513061523,2510.1561431884766,35346,8737,26609,26609,0,22,8772000.0
8772,8772999,20.971380099120054,38.113781121867795,0.07553792412286287,3312.181129693985,683.4244759082794,2510.062660217285,35351,8739,26612,26612,0,22,8773000.0
8773,8773999,20.9733092691056,38.11654093579162,0.07556900452151172,3312.5942692756653,683.4916172027588,2510.0415267944336,35351,8739,26612,26612,0,22,8774000.0
8774,8774999,20.97383501801187,38.116646018095736,0.07556551050278004,3312.9196257591248,683.5649771690369,2511.0617065429688,35361,8739,26622,26622,0,22,8775000.0
8775,8775999,20.973639339476364,38.11695301859103,0.0755587855211971,3313.0781223773956,683.6326236724854,2512.5984420776367,35364,8739,26625,26625,0,22,8776000.0
8776,8776999,20.97331342699569,38.1159653907545,0.07555266676479988,3313.5033161640167,683.6999340057373,2513.0619354248047,35369,8741,26628,26628,0,22,8777000.0
8777,8777999,20.97297381349904,38.11513186523973,0.07554821840353643,3314.0396044254303,683.7669589519501,2513.3994903564453,35375,8744,26631,26631,0,22,8778000.0
8778,8778999,20.97259161054723,38.11413522156462,0.0755418112586258,3314.2680304050446,683.8349232673645,2514.261116027832,35375,8744,26631,26631,0,22,8779000.0
8779,8779999,20.972336306398464,38.11331723931454,0.07553614366636852,3315.028406858444,683.9031238555908,2513.8007278442383,35415,8749,26666,26666,0,22,8780000.0
8780,8780999,20.972178777370402,38.11276902383674,0.07553217731806261,3315.425710916519,683.9724206924438,2514.1277770996094,35417,8750,26667,26667,0,22,8781000.0
8781,8781999,20.972080524756407,38.11223344532752,0.07553129740469533,3316.039495944977,684.0413193702698,2514.146270751953,35426,8754,26672,26672,0,22,8782000.0
8782,8782999,20.971960847526635,38.11186422283298,0.07552672542277661,3316.41179561615,684.1100461483002,2514.4800720214844,35429,8755,26674,26674,0,22,8783000.0
8783,8783999,20.971946724817194,38.11134373644125,0.07552925055910109,3316.6885979175568,684.1786379814148,2515.0545959472656,35429,8755,26674,26674,0,22,8784000.0
8784,8784999,20.97202116090604,38.11115335906758,0.07553039263161954,3317.0269412994385,684.2467129230499,2515.3319244384766,35429,8755,26674,26674,0,22,8785000.0
8785,8785999,20.972202145159475,38.11127296935229,0.07553785683442282,3317.2836904525757,684.3162612915039,2516.0021438598633,35429,8755,26674,26674,0,22,8786000.0
8786,8786999,20.97252187957057,38.111544168478744,0.07553362599444458,3317.767684698105,684.3870828151703,2516.084915161133,35433,8757,26676,26676,0,22,8787000.0
8787,8787999,20.972828932965736,38.11183981973243,0.07553137761564122,3318.1347749233246,684.4546155929565,2516.204475402832,35433,8757,26676,26676,0,22,8788000.0
8788,8788999,20.97301361518809,38.11170960681271,0.07553172646768869,3318.335956811905,684.5226266384125,2517.025810241699,35433,8757,26676,26676,0,22,8789000.0
8789,8789999,20.973472211445205,38.1121887593824,0.07553994302333134,3318.8834245204926,684.5931706428528,2516.53702545166,35435,8758,26677,26677,0,22,8790000.0
8790,8790999,20.974098006635305,38.112928196612025,0.07554015305553363,3319.246299266815,684.6621799468994,2516.819023132324,35437,8759,26678,26678,0,22,8791000.0
8791,8791999,20.97460247777397,38.11326623156345,0.07554784917590907,3319.617940425873,684.730899810791,2516.9765625,35437,8759,26678,26678,0,22,8792000.0
8792,8792999,20.975004990289833,38.113454342049025,0.07554976239151956,3320.1695759296417,684.80464220047,2516.793930053711,35442,8761,26681,26681,0,22,8793000.0
8793,8793999,20.975303686753957,38.11348230643396,0.07555195958162586,3320.4471769332886,684.8743269443512,2517.3451614379883,35442,8761,26681,26681,0,22,8794000.0
8794,8794999,20.975586128504997,38.11307354346687,0.0755521024202861,3320.856737136841,684.9431867599487,2517.5252227783203,35446,8762,26684,26684,0,22,8795000.0
8795,8795999,20.97547193844672,38.116994664715634,0.07552634847421791,3321.589874982834,685.0070922374725,2517.2844161987305,35469,8767,26702,26702,0,22,8796000.0
8796,8796999,20.9750227148197,38.11592565555982,0.075521549579049,3322.0394146442413,685.0738370418549,2518.102607727051,35489,8770,26719,26719,0,22,8797000.0
8797,8797999,20.9749225822744,38.116389634290854,0.07551181818842301,3322.348020553589,685.1371829509735,2518.7161178588867,35491,8770,26721,26721,0,22,8798000.0
8798,8798999,20.974949823746947,38.116148600775595,0.07550371922710142,3323.1166903972626,685.2018694877625,2518.3442306518555,35503,8775,26728,26728,0,22,8799000.0
8799,8799999,20.975037929021926,38.11569048113987,0.07549553461858094,3323.279618740082,685.2667741775513,2519.6853561401367,35503,8775,26728,26728,0,22,8800000.0
8800,8800999,20.97504229770361,38.11494607598942,0.07548704957591312,3323.717695951462,685.3309209346771,2520.0359268188477,35507,8777,26730,26730,0,22,8801000.0
8801,8801999,20.975270538160775,38.11682647648963,0.07547373254668222,3324.134776353836,685.3963985443115,2520.4605407714844,35512,8779,26733,26733,0,22,8802000.0
8802,8802999,20.975369643346347,38.116286695148645,0.07547111116580207,3324.5462732315063,685.4609603881836,2520.921188354492,35517,8781,26736,26736,0,22,8803000.0
8803,8803999,20.97582785158852,38.11722213961318,0.07546841765845425,3324.8886749744415,685.5260624885559,2521.3881454467773,35519,8782,26737,26737,0,22,8804000.0
8804,8804999,20.976620671530263,38.118682664444535,0.07547696914178081,3325.4022300243378,685.5913574695587,2521.4157485961914,35523,8784,26739,26739,0,22,8805000.0
8805,8805999,20.977347114266713,38.11977183129442,0.07548976844222166,3325.8276484012604,685.6552195549011,2521.9093017578125,35527,8786,26741,26741,0,22,8806000.0
8806,8806999,20.977983652953704,38.12051135713269,0.07550780942167234,3326.4206187725067,685.7204837799072,2521.8333892822266,35544,8789,26755,26755,0,22,8807000.0
8807,8807999,20.978638204181284,38.122339271441845,0.07555205884390004,3326.749853849411,685.7869327068329,2522.486930847168,35546,8790,26756,26756,0,22,8808000.0
8808,8808999,20.979210310740918,38.12282962682344,0.07557578226999784,3327.1200094223022,685.8629598617554,2523.0130310058594,35548,8791,26757,26757,0,22,8809000.0
8809,8809999,20.979998253067006,38.124655335868646,0.075599534323049,3327.3411753177643,685.9294271469116,2523.844696044922,35548,8791,26757,26757,0,22,8810000.0
8810,8810999,20.981302900010043,38.1287022632471,0.07562434720418243,3327.7569222450256,685.9945559501648,2523.745559692383,35548,8791,26757,26757,0,22,8811000.0
8811,8811999,20.98265378258239,38.13287210253483,0.07564433325308484,3328.193609237671,686.0614280700684,2523.8115310668945,35550,8792,26758,26758,0,22,8812000.0
8812,8812999,20.98362452749294,38.13555423333238,0.075665230577177,3328.6141731739044,686.1277582645416,2524.2253952026367,35555,8794,26761,26761,0,22,8813000.0
8813,8813999,20.984483825468953,38.136336948426184,0.07569040060072907,3329.316576719284,686.1940944194794,2523.7991943359375,35563,8798,26765,26765,0,22,8814000.0
8814,8814999,20.984790714268684,38.13692652125823,0.0756831356849127,3329.696234226227,686.2601878643036,2524.833854675293,35575,8800,26775,26775,0,22,8815000.0
8815,8815999,20.984851501102128,38.13741158391954,0.07567027847282093,3330.2072987556458,686.3271641731262,2525.2709045410156,35588,8803,26785,26785,0,22,8816000.0
8816,8816999,20.9851214411728,38.1382561202156,0.07566062922687966,3330.488094806671,686.396369934082,2525.9220581054688,35588,8803,26785,26785,0,22,8817000.0
8817,8817999,20.985350808314646,38.139723962463556,0.07564733358937625,3330.736444711685,686.4631018638611,2526.6337890625,35588,8803,26785,26785,0,22,8818000.0
8818,8818999,20.98559802391078,38.140317003414246,0.07563518735456665,3331.357131958008,686.5322260856628,2526.313835144043,35605,8806,26799,26799,0,22,8819000.0
8819,8819999,20.98563459665153,38.14030474388129,0.07562548593275187,3331.703410387039,686.6008191108704,2526.7688369750977,35607,8807,26800,26800,0,22,8820000.0
8820,8820999,20.985675955430363,38.140210493877554,0.07561624120003063,3332.0859587192535,686.6688978672028,2527.0925674438477,35609,8808,26801,26801,0,22,8821000.0
8821,8821999,20.985568325502914,38.13941493061089,0.07561444326117628,3332.367935180664,686.7360196113586,2527.617141723633,35610,8808,26802,26802,0,22,8822000.0
8822,8822999,20.98574723753528,38.1411118314329,0.07561119297212049,3332.7798206806183,686.8063077926636,2527.839553833008,35612,8809,26803,26803,0,22,8823000.0
8823,8823999,20.985678089009454,38.14039867869076,0.07560384061398051,3333.3509860038757,686.8742792606354,2527.472396850586,35615,8811,26804,26804,0,22,8824000.0
8824,8824999,20.98552481983852,38.139678756573055,0.07560193196966114,3333.6907460689545,686.9419724941254,2527.9997024536133,35618,8812,26806,26806,0,22,8825000.0
8825,8825999,20.98540209816758,38.13906323343325,0.07559679998383761,3334.066459417343,687.0097124576569,2528.086898803711,35618,8812,26806,26806,0,22,8826000.0
8826,8826999,20.98547800854135,38.13855867663247,0.07559281641720328,3334.4497542381287,687.0787229537964,2528.063804626465,35618,8812,26806,26806,0,22,8827000.0
8827,8827999,20.98550467055898,38.137969071573,0.07558474589574582,3334.957443714142,687.1491229534149,2527.9959411621094,35622,8814,26808,26808,0,22,8828000.0
8828,8828999,20.985559590378603,38.13738944392619,0.07557673693767641,3335.3984422683716,687.218533039093,2528.0661087036133,35623,8815,26808,26808,0,22,8829000.0
8829,8829999,20.98528817542836,38.13624919833026,0.07557335386765573,3335.7266755104065,687.2876324653625,2528.373847961426,35623,8815,26808,26808,0,22,8830000.0
8830,8830999,20.9850993880883,38.13524710801564,0.07556834637994558,3336.0453777313232,687.3562998771667,2528.7259368896484,35623,8815,26808,26808,0,22,8831000.0
8831,8831999,20.985241796394487,38.1352837291722,0.07552304299602342,3336.5231940746307,687.4205062389374,2529.23193359375,35642,8816,26826,26826,0,22,8832000.0
8832,8832999,20.985232348056897,38.135890302191456,0.07549020314997001,3336.673643350601,687.4836361408234,2530.7565994262695,35643,8816,26827,26827,0,22,8833000.0
8833,8833999,20.985230539336992,38.13618155850584,0.07545519339783058,3337.1008467674255,687.5486936569214,2531.134521484375,35648,8818,26830,26830,0,22,8834000.0
8834,8834999,20.98500703949922,38.1355373882204,0.07542343256583994,3337.3110780715942,687.6121919155121,2532.0104598999023,35648,8818,26830,26830,0,22,8835000.0
8835,8835999,20.98483767413052,38.13512418396577,0.07538516975022591,3337.7233114242554,687.6783542633057,2532.482734680176,35653,8820,26833,26833,0,22,8836000.0
8836,8836999,20.98447230345865,38.13435478427662,0.07536992322723635,3338.449539899826,687.7431945800781,2532.1503143310547,35667,8825,26842,26842,0,22,8837000.0
8837,8837999,20.984240440677084,38.13443109340659,0.07534371213236746,3338.752119779587,687.8090801239014,2532.866653442383,35669,8826,26843,26843,0,22,8838000.0
8838,8838999,20.98379866522479,38.1343779237311,0.07533123528257513,3339.266128063202,687.8771855831146,2533.098663330078,35676,8829,26847,26847,0,22,8839000.0
8839,8839999,20.983373736557624,38.133585272973185,0.07532089268670339,3339.5501618385315,687.9413840770721,2533.6791763305664,35677,8829,26848,26848,0,22,8840000.0
8840,8840999,20.983107697338465,38.13307728029806,0.07530892228395591,3340.044797897339,688.0091876983643,2533.7418823242188,35681,8831,26850,26850,0,22,8841000.0
8841,8841999,20.982760234006903,38.132271743975814,0.07529779967920447,3340.4179499149323,688.0743677616119,2534.1317749023438,35683,8832,26851,26851,0,22,8842000.0
8842,8842999,20.982447837914396,38.131625894300456,0.07528969108036476,3341.020254611969,688.1387031078339,2533.923728942871,35692,8836,26856,26856,0,22,8843000.0
8843,8843999,20.98227679918069,38.13100533996605,0.07527750899307684,3341.4123134613037,688.2089591026306,2534.2150650024414,35694,8837,26857,26857,0,22,8844000.0
8844,8844999,20.982227116550145,38.13079476347356,0.07526376604507945,3341.7822575569153,688.2747008800507,2534.6069946289062,35696,8838,26858,26858,0,22,8845000.0
8845,8845999,20.98216489667246,38.130427123350444,0.07525599053598409,3342.1145219802856,688.3402059078217,2535.1237182617188,35698,8839,26859,26859,0,22,8846000.0
8846,8846999,20.982183389677214,38.13103335266041,0.07524351877753532,3343.076011657715,688.4111762046814,2534.189743041992,35731,8845,26886,26886,0,22,8847000.0
8847,8847999,20.98218775949044,38.13056010807146,0.07523156465907821,3343.3831791877747,688.4778110980988,2534.8444290161133,35733,8846,26887,26887,0,22,8848000.0
8848,8848999,20.982032889245772,38.12989537533614,0.0752214922066956,3343.7477416992188,688.5435791015625,2535.2233657836914,35735,8847,26888,26888,0,22,8849000.0
8849,8849999,20.98182016629508,38.1291391859457,0.07521351246109997,3343.9817090034485,688.6091635227203,2535.8963775634766,35735,8847,26888,26888,0,22,8850000.0
8850,8850999,20.98120938481759,38.127995263167875,0.07521202867236465,3344.3120753765106,688.6767044067383,2536.4934844970703,35743,8847,26896,26896,0,22,8851000.0
8851,8851999,20.980293263927354,38.126964035078544,0.07521349655020038,3344.64767742157,688.7424433231354,2537.1908798217773,35748,8848,26900,26900,0,22,8852000.0
8852,8852999,20.979546185526843,38.126495793150156,0.07521194152490773,3344.9744081497192,688.8075168132782,2537.606689453125,35748,8848,26900,26900,0,22,8853000.0
8853,8853999,20.978735988135238,38.12501861321428,0.07521308582812025,3345.3317654132843,688.8742833137512,2538.2507705688477,35750,8849,26901,26901,0,22,8854000.0
8854,8854999,20.978022721786644,38.12376378740553,0.07521515981825067,3345.696638584137,688.9416952133179,2538.6158142089844,35762,8850,26912,26912,0,22,8855000.0
8855,8855999,20.977358783344748,38.122401524231265,0.07521550035470925,3346.3028428554535,689.0087926387787,2538.5227127075195,35771,8854,26917,26917,0,22,8856000.0
8856,8856999,20.97667364787227,38.12116011602419,0.07521600995711053,3346.5637652873993,689.0765337944031,2539.2359466552734,35771,8854,26917,26917,0,22,8857000.0
8857,8857999,20.975946915733253,38.12001840440166,0.07521545097142468,3347.17781829834,689.1449112892151,2538.9574584960938,35778,8857,26921,26921,0,22,8858000.0
8858,8858999,20.97522599360763,38.11882079489387,0.07521571937449811,3347.506171941757,689.2129578590393,2539.3630905151367,35778,8857,26921,26921,0,22,8859000.0
8859,8859999,20.974593345485463,38.117618937621174,0.07521443380579274,3347.851049900055,689.2807664871216,2539.7568893432617,35791,8858,26933,26933,0,22,8860000.0
8860,8860999,20.973945957143588,38.116586592959294,0.07521208115250211,3348.2305161952972,689.3505063056946,2540.077796936035,35793,8859,26934,26934,0,22,8861000.0
8861,8861999,20.973303520088557,38.11527534526475,0.07521120933000114,3348.9097294807434,689.4194900989532,2539.401596069336,35801,8862,26939,26939,0,22,8862000.0
8862,8862999,20.972716415519635,38.11399822121853,0.07521036252594415,3349.535294532776,689.4890053272247,2538.8675537109375,35816,8864,26952,26952,0,22,8863000.0
8863,8863999,20.972149969371998,38.11278177528633,0.07520821344002893,3349.8738074302673,689.5570735931396,2539.1567916870117,35816,8864,26952,26952,0,22,8864000.0
8864,8864999,20.9716809442641,38.11296069333206,0.07520151314770807,3350.192929983139,689.6245753765106,2539.5137786865234,35816,8864,26952,26952,0,22,8865000.0
8865,8865999,20.971090369454025,38.11172899659615,0.07520261690511088,3350.5543162822723,689.6930525302887,2539.9370346069336,35828,8865,26963,26963,0,22,8866000.0
8866,8866999,20.97055623099309,38.11054295145824,0.07520312458481548,3351.1321268081665,689.7604601383209,2539.474708557129,35832,8867,26965,26965,0,22,8867000.0
8867,8867999,20.970083756528897,38.10928912365542,0.07520332991018142,3351.5768876075745,689.8306179046631,2539.4835891723633,35834,8868,26966,26966,0,22,8868000.0
8868,8868999,20.969649916068327,38.10886001487343,0.07519935355926854,3351.914928674698,689.8984653949738,2539.749771118164,35834,8868,26966,26966,0,22,8869000.0
8869,8869999,20.969061782193467,38.107641049343314,0.07519837075882807,3352.4619433879852,689.9667749404907,2539.584373474121,35849,8870,26979,26979,0,22,8870000.0
8870,8870999,20.96837359424052,38.10631072759441,0.07519749608015047,3352.8752975463867,690.0349044799805,2539.4401092529297,35849,8870,26979,26979,0,22,8871000.0
8871,8871999,20.967880772943793,38.10597048415724,0.07519300575116294,3353.229954957962,690.0995528697968,2540.464553833008,35864,8871,26993,26993,0,22,8872000.0
8872,8872999,20.96748593342029,38.105714200365014,0.07517851704188361,3353.5331375598907,690.1652908325195,2541.4379272460938,35876,8872,27004,27004,0,22,8873000.0
8873,8873999,20.966929972869178,38.1046426664223,0.07517158045288119,3353.9715538024902,690.2303874492645,2541.652198791504,35888,8873,27015,27015,0,22,8874000.0
8874,8874999,20.966914058979064,38.104687394631696,0.07516024308004532,3354.41029214859,690.296142578125,2541.9469833374023,35892,8875,27017,27017,0,22,8875000.0
8875,8875999,20.96685226198369,38.10449452897641,0.07514812851771879,3354.668619632721,690.3613936901093,2542.5060806274414,35892,8875,27017,27017,0,22,8876000.0
8876,8876999,20.96669053704147,38.10402835313845,0.07514580793524495,3355.297085762024,690.4263241291046,2542.153335571289,35898,8878,27020,27020,0,22,8877000.0
8877,8877999,20.96661127976065,38.10370979512065,0.07514211164279183,3355.722718000412,690.4928822517395,2542.5485305786133,35902,8880,27022,27022,0,22,8878000.0
8878,8878999,20.966429556859723,38.103216234665254,0.07513418160510488,3356.034078359604,690.5581731796265,2542.9609603881836,35902,8880,27022,27022,0,22,8879000.0
8879,8879999,20.966551147414364,38.102955213000016,0.07512608175299906,3356.5692987442017,690.6217868328094,2542.788246154785,35908,8882,27026,27026,0,22,8880000.0
8880,8880999,20.966557326884747,38.10242852035967,0.07512850113238057,3356.963674068451,690.6874392032623,2543.072410583496,35910,8883,27027,27027,0,22,8881000.0
8881,8881999,20.96664598099739,38.10220062128762,0.07512510252461368,3357.4014117717743,690.7523868083954,2543.230598449707,35912,8884,27028,27028,0,22,8882000.0
8882,8882999,20.966582936371346,38.10163405562757,0.07512273746683595,3357.9732537269592,690.8182075023651,2543.1150436401367,35939,8887,27052,27052,0,22,8883000.0
8883,8883999,20.9665659772814,38.10110284579659,0.07511974046260861,3358.2389266490936,690.885448217392,2543.7092895507812,35939,8887,27052,27052,0,22,8884000.0
8884,8884999,20.966620188544507,38.10069143731817,0.0751192387323042,3358.6744015216827,690.9524691104889,2543.6510314941406,35942,8888,27054,27054,0,22,8885000.0
8885,8885999,20.966777538837675,38.100428026949196,0.07511741631073143,3359.0246748924255,691.0183515548706,2544.0513610839844,35944,8889,27055,27055,0,22,8886000.0
8886,8886999,20.966855141285617,38.09988209334167,0.07511340150458834,3359.638687610626,691.0857934951782,2543.2173233032227,35946,8890,27056,27056,0,22,8887000.0
8887,8887999,20.9671431555907,38.0996095940605,0.07511288934549265,3360.1815440654755,691.1510510444641,2543.054328918457,35950,8892,27058,27058,0,22,8888000.0
8888,8888999,20.96719945071303,38.09904923005228,0.07510882761888882,3360.462954759598,691.2176456451416,2543.647819519043,35950,8892,27058,27058,0,22,8889000.0
8889,8889999,20.96728515708559,38.09841678460584,0.07510514446965155,3360.9569935798645,691.2827594280243,2543.680030822754,35955,8894,27061,27061,0,22,8890000.0
8890,8890999,20.96715340337816,38.09758285727458,0.07509788795658767,3361.287105321884,691.349999666214,2544.0164337158203,35955,8894,27061,27061,0,22,8891000.0
8891,8891999,20.96661436442351,38.09703420559192,0.07505034561374968,3361.483027935028,691.4171590805054,2545.4881439208984,35968,8894,27074,27074,0,22,8892000.0
8892,8892999,20.965747048356075,38.09593119854854,0.07504776541612235,3361.748074531555,691.4822797775269,2546.1560974121094,35969,8894,27075,27075,0,22,8893000.0
8893,8893999,20.964915437599757,38.09453259697126,0.07504641208330598,3362.1398735046387,691.5481841564178,2546.4528732299805,35971,8895,27076,27076,0,22,8894000.0
8894,8894999,20.964272119695178,38.0935387211599,0.07504199034570935,3362.355217695236,691.6146409511566,2547.320930480957,35972,8895,27077,27077,0,22,8895000.0
8895,8895999,20.96370876180818,38.09258441172887,0.07503855392690228,3363.0519647598267,691.6811180114746,2547.0412521362305,35984,8900,27084,27084,0,22,8896000.0
8896,8896999,20.963174489846033,38.09193981766417,0.07503221332761034,3363.478188276291,691.7489349842072,2547.3649673461914,35989,8902,27087,27087,0,22,8897000.0
8897,8897999,20.962545303085083,38.091144884923736,0.0750302410676662,3363.88436460495,691.8164436817169,2547.7911987304688,35993,8904,27089,27089,0,22,8898000.0
8898,8898999,20.96164467565954,38.08955961737587,0.07503321830859178,3364.115997314453,691.8817903995514,2548.5144424438477,35993,8904,27089,27089,0,22,8899000.0
8899,8899999,20.960897010954817,38.08812348208444,0.0750341202161332,3364.491489171982,691.9471399784088,2548.7595825195312,35996,8905,27091,27091,0,22,8900000.0
8900,8900999,20.96034125123138,38.087067980754625,0.07503415205255815,3365.2569591999054,692.0134327411652,2547.930076599121,36005,8909,27096,27096,0,22,8901000.0
8901,8901999,20.959816346741846,38.087757233374894,0.07502629442363251,3365.5987782478333,692.0800106525421,2548.3296432495117,36007,8910,27097,27097,0,22,8902000.0
8902,8902999,20.959110966859388,38.08638282216179,0.07502876369770484,3365.9530227184296,692.1471765041351,2548.595718383789,36007,8910,27097,27097,0,22,8903000.0
8903,8903999,20.958630996963088,38.08538029761598,0.07502830760451384,3366.293880224228,692.2155876159668,2548.822235107422,36008,8910,27098,27098,0,22,8904000.0
8904,8904999,20.95806211310366,38.08428605499724,0.07503136340290839,3366.7853660583496,692.28342628479,2548.3078994750977,36008,8910,27098,27098,0,22,8905000.0
8905,8905999,20.9577375839484,38.08358944831117,0.07502933747459184,3367.1975054740906,692.3500545024872,2548.5052947998047,36010,8911,27099,27099,0,22,8906000.0
8906,8906999,20.957499505578085,38.082853939885354,0.07502548184552016,3367.5849051475525,692.4163024425507,2548.709915161133,36012,8912,27100,27100,0,22,8907000.0
8907,8907999,20.957114372457983,38.08185016022505,0.07502917068005277,3367.8667862415314,692.48410820961,2549.200881958008,36012,8912,27100,27100,0,22,8908000.0
8908,8908999,20.956749565625685,38.0809238757734,0.07503139159353289,3368.29300904274,692.5502123832703,2549.088653564453,36013,8913,27100,27100,0,22,8909000.0
8909,8909999,20.95628451952053,38.07992550146366,0.07503194454952689,3368.5922486782074,692.6184265613556,2549.697280883789,36015,8914,27101,27101,0,22,8910000.0
8910,8910999,20.955760181846927,38.078773666157524,0.07502943261491701,3368.9777500629425,692.6854422092438,2549.9194869995117,36016,8915,27101,27101,0,22,8911000.0
8911,8911999,20.955088962750512,38.077369499114916,0.07502859087577785,3369.2858471870422,692.7570428848267,2551.0781173706055,36026,8916,27110,27110,0,22,8912000.0
8912,8912999,20.954198231976694,38.07586653552547,0.0750277179185076,3369.852515935898,692.8269774913788,2551.185478210449,36034,8919,27115,27115,0,22,8913000.0
8913,8913999,20.95343538342762,38.07463030448741,0.07502708968916949,3370.1740148067474,692.89603972435,2552.201499938965,36049,8920,27129,27129,0,22,8914000.0
8914,8914999,20.952867565936156,38.073517633825126,0.07502373797149375,3370.5360107421875,692.9651083946228,2553.116439819336,36056,8922,27134,27134,0,22,8915000.0
8915,8915999,20.95224777023584,38.07305990461903,0.07501803101198223,3370.6975407600403,693.0363364219666,2554.369644165039,36056,8922,27134,27134,0,22,8916000.0
8916,8916999,20.951536117443784,38.0717743212878,0.07501671079748462,3371.1519906520844,693.1073343753815,2554.52645111084,36061,8924,27137,27137,0,22,8917000.0
8917,8917999,20.95098905332608,38.07068862848651,0.07501157364036093,3371.6071741580963,693.1776437759399,2554.814323425293,36067,8926,27141,27141,0,22,8918000.0
8918,8918999,20.9505016117565,38.06994100881286,0.07500735470613218,3372.074381828308,693.2514095306396,2554.834243774414,36070,8927,27143,27143,0,22,8919000.0
8919,8919999,20.950106558537353,38.069139654617466,0.07500150823466922,3372.476266860962,693.3253908157349,2555.1678619384766,36082,8928,27154,27154,0,22,8920000.0
8920,8920999,20.94994384125357,38.06906959712641,0.07499498654380266,3373.019234895706,693.3967068195343,2555.0417404174805,36086,8930,27156,27156,0,22,8921000.0
8921,8921999,20.94984379510978,38.068833868235885,0.07499117214478179,3373.1864392757416,693.467125415802,2556.178382873535,36086,8930,27156,27156,0,22,8922000.0
8922,8922999,20.950016661822588,38.06941344463126,0.07499437798846265,3373.6368024349213,693.5371096134186,2556.3722534179688,36100,8932,27168,27168,0,22,8923000.0
8923,8923999,20.950102122677304,38.06980010585623,0.07499558762507064,3374.2347931861877,693.6074953079224,2556.059913635254,36106,8935,27171,27171,0,22,8924000.0
8924,8924999,20.950415308321567,38.07039810087426,0.07501516331404767,3374.6511363983154,693.6791520118713,2556.4745559692383,36120,8937,27183,27183,0,22,8925000.0
8925,8925999,20.950932894126815,38.07126159886286,0.07505689557226236,3375.113135576248,693.748863697052,2556.511863708496,36123,8938,27185,27185,0,22,8926000.0
8926,8926999,20.95141057395962,38.072135593130135,0.07509623692860545,3375.4378566741943,693.8196322917938,2556.8042755126953,36123,8938,27185,27185,0,22,8927000.0
8927,8927999,20.952182523397877,38.07366550606786,0.07511104551920755,3375.764407157898,693.8899540901184,2557.103416442871,36123,8938,27185,27185,0,22,8928000.0
8928,8928999,20.953140215409512,38.07623234553411,0.07511917215024333,3376.2234432697296,693.9599854946136,2557.1463317871094,36128,8940,27188,27188,0,22,8929000.0
8929,8929999,20.953700251441877,38.0772452878102,0.07514288494674515,3376.8388941287994,694.0331473350525,2556.7952575683594,36133,8942,27191,27191,0,22,8930000.0
8930,8930999,20.954356997646787,38.078559549797426,0.07515604652976116,3377.3528876304626,694.1041412353516,2557.01602935791,36139,8945,27194,27194,0,22,8931000.0
8931,8931999,20.95393286073441,38.07806429722133,0.07514650667038791,3377.6437113285065,694.166886806488,2558.2469177246094,36155,8946,27209,27209,0,22,8932000.0
8932,8932999,20.953507499498254,38.07808475555213,0.07513775285912971,3377.926538705826,694.2304301261902,2559.218635559082,36159,8947,27212,27212,0,22,8933000.0
8933,8933999,20.95305841684299,38.07736119470051,0.07513185516922105,3378.4256234169006,694.2930450439453,2559.3364334106445,36179,8949,27230,27230,0,22,8934000.0
8934,8934999,20.95283376902894,38.077728898132314,0.075120547010457,3378.6637585163116,694.3563964366913,2560.2824630737305,36180,8949,27231,27231,0,22,8935000.0
8935,8935999,20.95278675925521,38.07706692456426,0.07510907815646561,3378.927309513092,694.4206318855286,2561.2887649536133,36192,8950,27242,27242,0,22,8936000.0
8936,8936999,20.952582230240694,38.07623659749407,0.07510024874069943,3379.521021604538,694.4862082004547,2561.0276260375977,36199,8953,27246,27246,0,22,8937000.0
8937,8937999,20.95242580818197,38.07599598876103,0.07508888122312707,3379.8313241004944,694.5509161949158,2561.745086669922,36201,8954,27247,27247,0,22,8938000.0
8938,8938999,20.952313293571404,38.0772532779206,0.07507785940599654,3380.3189051151276,694.6143665313721,2561.899757385254,36208,8957,27251,27251,0,22,8939000.0
8939,8939999,20.95221690942807,38.076676480752184,0.07507141012070195,3380.7695410251617,694.6796035766602,2562.150535583496,36213,8959,27254,27254,0,22,8940000.0
8940,8940999,20.952094630542337,38.07599178196818,0.07506620272830833,3381.431677341461,694.7458827495575,2562.0546875,36231,8963,27268,27268,0,22,8941000.0
8941,8941999,20.952099142690784,38.075236782784074,0.07506239190108577,3381.9354894161224,694.8124461174011,2562.2002487182617,36245,8965,27280,27280,0,22,8942000.0
8942,8942999,20.952074492058607,38.07483077433592,0.07505775213056709,3382.2472972869873,694.8774938583374,2562.5729064941406,36245,8965,27280,27280,0,22,8943000.0
8943,8943999,20.95224635527534,38.074581840873385,0.07505255782393738,3382.6949620246887,694.9426674842834,2562.887405395508,36250,8967,27283,27283,0,22,8944000.0
8944,8944999,20.952478051912607,38.07435640058421,0.07505248374269835,3382.860025882721,695.0098724365234,2563.875457763672,36250,8967,27283,27283,0,22,8945000.0
8945,8945999,20.95278226847442,38.07423150989538,0.07505271674840963,3383.330206155777,695.0741093158722,2563.8892669677734,36255,8969,27286,27286,0,22,8946000.0
8946,8946999,20.952963672046053,38.073679020849006,0.07505550486425794,3383.743525505066,695.1406977176666,2564.268699645996,36259,8971,27288,27288,0,22,8947000.0
8947,8947999,20.95335054835767,38.07354259732638,0.07505421574909721,3384.262237548828,695.2082543373108,2564.157600402832,36264,8973,27291,27291,0,22,8948000.0
8948,8948999,20.95391902286296,38.07374839035702,0.07505619965911037,3384.642851829529,695.27472448349,2564.5091857910156,36266,8974,27292,27292,0,22,8949000.0
8949,8949999,20.95436274524897,38.07368800842523,0.07505663904357363,3385.2017505168915,695.3411648273468,2564.3320846557617,36271,8976,27295,27295,0,22,8950000.0
8950,8950999,20.95479727978481,38.07408275414005,0.0750547251544168,3385.5393319129944,695.4074821472168,2564.6321563720703,36271,8976,27295,27295,0,22,8951000.0
8951,8951999,20.954707157474505,38.07334819671274,0.07505095506628712,3385.7844591140747,695.4749798774719,2565.8983459472656,36283,8976,27307,27307,0,22,8952000.0
8952,8952999,20.954026666315052,38.07235586984205,0.07504792951321726,3386.0708482265472,695.5411229133606,2566.9104080200195,36285,8976,27309,27309,0,22,8953000.0
8953,8953999,20.95338735523413,38.072268534132206,0.07504250850309213,3386.2221426963806,695.6058192253113,2568.223892211914,36285,8976,27309,27309,0,22,8954000.0
8954,8954999,20.952721024967893,38.07118676749261,0.07504261302258097,3386.638636827469,695.6710238456726,2568.720413208008,36289,8978,27311,27311,0,22,8955000.0
8955,8955999,20.952028678276722,38.070650087574975,0.07504043908673652,3387.057986497879,695.7371797561646,2568.923110961914,36292,8979,27313,27313,0,22,8956000.0
8956,8956999,20.951510970205494,38.070478782585575,0.07503411079473887,3387.4604971408844,695.8016588687897,2569.352226257324,36298,8981,27317,27317,0,22,8957000.0
8957,8957999,20.95091709850188,38.06928404274249,0.07503209957255186,3388.077368736267,695.8685266971588,2569.2312240600586,36308,8985,27323,27323,0,22,8958000.0
8958,8958999,20.95028771240447,38.06810599671342,0.07502942678595814,3388.4614295959473,695.936811208725,2569.793342590332,36310,8986,27324,27324,0,22,8959000.0
8959,8959999,20.949754757949652,38.067124224272305,0.07502597281601375,3388.6947588920593,696.0015645027161,2570.5942001342773,36311,8986,27325,27325,0,22,8960000.0
8960,8960999,20.949320844470193,38.06833389722393,0.07501271603911186,3389.1193001270294,696.0666790008545,2570.766181945801,36314,8987,27327,27327,0,22,8961000.0
8961,8961999,20.948985993897,38.067479352715495,0.0750065541788899,3389.520998239517,696.1370530128479,2570.78426361084,36314,8987,27327,27327,0,22,8962000.0
8962,8962999,20.948688422077538,38.06679908715709,0.0750010891054339,3389.962872028351,696.2040543556213,2571.064125061035,36318,8989,27329,27329,0,22,8963000.0
8963,8963999,20.948614155126233,38.0667197704175,0.07499306171492715,3390.307158946991,696.2701153755188,2571.3339462280273,36320,8990,27330,27330,0,22,8964000.0
8964,8964999,20.9483049042873,38.06587655610142,0.07499083830567244,3390.722459793091,696.3376884460449,2571.572822570801,36324,8992,27332,27332,0,22,8965000.0
8965,8965999,20.94825078597129,38.0653799483918,0.07498425128835529,3391.1522464752197,696.4042868614197,2571.6294326782227,36326,8993,27333,27333,0,22,8966000.0
8966,8966999,20.948138821090254,38.064525316662206,0.07498113872959755,3391.520221710205,696.4702188968658,2571.955146789551,36329,8994,27335,27335,0,22,8967000.0
8967,8967999,20.94797500239875,38.063685044070155,0.074977564553244,3392.2243568897247,696.5383083820343,2571.283058166504,36336,8997,27339,27339,0,22,8968000.0
8968,8968999,20.947848408881487,38.06406122052315,0.07496984389824046,3392.5356776714325,696.6051766872406,2572.1299896240234,36339,8998,27341,27341,0,22,8969000.0
8969,8969999,20.94773171769569,38.06365909329183,0.07496738557762117,3392.870458126068,696.6711349487305,2572.8577423095703,36344,8998,27346,27346,0,22,8970000.0
8970,8970999,20.94739014410547,38.06309035668461,0.074962227771734,3393.159693002701,696.7354898452759,2573.585090637207,36345,8998,27347,27347,0,22,8971000.0
8971,8971999,20.947031292527097,38.06223307907614,0.07496040030262863,3393.5177874565125,696.8028523921967,2574.026710510254,36347,8999,27348,27348,0,22,8972000.0
8972,8972999,20.946781393063603,38.06186152864761,0.07495912630837487,3393.77996635437,696.8676970005035,2574.8385162353516,36350,9000,27350,27350,0,22,8973000.0
8973,8973999,20.946677325797186,38.06194193555476,0.07495704812281356,3394.301025390625,696.9346797466278,2575.070701599121,36384,9003,27381,27381,0,22,8974000.0
8974,8974999,20.946411050233543,38.06119657529164,0.07495268373807862,3394.5024468898773,697.0008237361908,2575.938621520996,36384,9003,27381,27381,0,22,8975000.0
8975,8975999,20.946615710521918,38.06348183859227,0.07493919539622529,3394.958994626999,697.0671715736389,2576.0216674804688,36389,9005,27384,27384,0,22,8976000.0
8976,8976999,20.94657948820467,38.06308474749057,0.07493439146146941,3395.305299758911,697.1346023082733,2576.2538299560547,36390,9005,27385,27385,0,22,8977000.0
8977,8977999,20.946956211712983,38.063359443543085,0.07492881524900064,3395.757269382477,697.1993527412415,2576.033737182617,36390,9005,27385,27385,0,22,8978000.0
8978,8978999,20.947374189610407,38.0638297739213,0.07492304659478044,3396.064397573471,697.2671704292297,2576.602340698242,36392,9006,27386,27386,0,22,8979000.0
8979,8979999,20.948180841042372,38.06466289758338,0.0749149220283265,3396.476951122284,697.3329095840454,2576.661392211914,36395,9007,27388,27388,0,22,8980000.0
8980,8980999,20.94864170491003,38.06614236758133,0.07490407284089351,3396.800662755966,697.3983597755432,2577.0336837768555,36395,9007,27388,27388,0,22,8981000.0
8981,8981999,20.94937175936857,38.06693758768055,0.07489862199458563,3397.4750685691833,697.4656219482422,2576.461944580078,36403,9010,27393,27393,0,22,8982000.0
8982,8982999,20.950429067656767,38.0689750238978,0.07489393363077823,3397.9394063949585,697.5339097976685,2576.6493759155273,36408,9012,27396,27396,0,22,8983000.0
8983,8983999,20.951411071566366,38.07030135764718,0.07489295091078929,3398.4435529708862,697.6014730930328,2576.575798034668,36412,9014,27398,27398,0,22,8984000.0
8984,8984999,20.952718793789806,38.071472822494044,0.07489464042901028,3398.8709733486176,697.6665050983429,2576.731903076172,36416,9015,27401,27401,0,22,8985000.0
8985,8985999,20.95369352719152,38.072028537360325,0.07489908060886208,3399.3696484565735,697.7335786819458,2576.714828491211,36421,9017,27404,27404,0,22,8986000.0
8986,8986999,20.95464315646622,38.07343756085123,0.07490034827297265,3399.809586048126,697.7989356517792,2576.738311767578,36423,9018,27405,27405,0,22,8987000.0
8987,8987999,20.955193158551868,38.073194953851484,0.07489698348000295,3400.168047428131,697.8636891841888,2577.0395126342773,36424,9019,27405,27405,0,22,8988000.0
8988,8988999,20.95532691305731,38.07251399299511,0.07488415273113758,3400.6036565303802,697.9306154251099,2577.5268478393555,36438,9021,27417,27417,0,22,8989000.0
8989,8989999,20.954934074061136,38.071384386675874,0.07487870643293315,3401.1533885002136,697.9967994689941,2577.1964950561523,36446,9023,27423,27423,0,22,8990000.0
8990,8990999,20.954843732620247,38.07095211928158,0.07487863357628644,3401.450830221176,698.0621538162231,2577.689895629883,36446,9023,27423,27423,0,22,8991000.0
8991,8991999,20.954766834169952,38.07038827843327,0.07487623569802293,3401.987017393112,698.1283774375916,2577.2819442749023,36458,9024,27434,27434,0,22,8992000.0
8992,8992999,20.954568751168086,38.06949051292984,0.07488247319142971,3402.318354845047,698.1953480243683,2577.605827331543,36458,9024,27434,27434,0,22,8993000.0
8993,8993999,20.95498551588335,38.07017372336715,0.07489484427429627,3402.707937002182,698.260650396347,2577.7656173706055,36460,9025,27435,27435,0,22,8994000.0
8994,8994999,20.95559845016119,38.071247811218015,0.07491386521723609,3403.140252351761,698.3255879878998,2577.8094482421875,36462,9026,27436,27436,0,22,8995000.0
8995,8995999,20.95616054425559,38.07206029681595,0.07492525344813261,3403.4625639915466,698.3989758491516,2578.2866744995117,36462,9026,27436,27436,0,22,8996000.0
8996,8996999,20.957231389817427,38.0742794284847,0.0749462739575224,3403.8945693969727,698.4638726711273,2578.1792602539062,36464,9027,27437,27437,0,22,8997000.0
8997,8997999,20.9582304503405,38.076108074164104,0.07495741466378192,3404.239042043686,698.5283007621765,2578.4555435180664,36464,9027,27437,27437,0,22,8998000.0
8998,8998999,20.959605701857637,38.07928159372248,0.07498628459822665,3404.59375,698.5982060432434,2579.0646896362305,36527,9028,27499,27499,0,22,8999000.0
8999,8999999,20.96141072503154,38.082859873444626,0.07502629457801802,3404.9092757701874,698.6631231307983,2579.9053344726562,36528,9029,27499,27499,0,22,9000000.0
9000,9000999,20.963060863197178,38.08707379124555,0.07504856687307726,3405.2971353530884,698.7317657470703,2580.130302429199,36528,9029,27499,27499,0,22,9001000.0
9001,9001999,20.96493617447375,38.090157446615414,0.07508210805246174,3406.1030011177063,698.7991244792938,2579.193229675293,36534,9032,27502,27502,0,22,9002000.0
9002,9002999,20.967012248473736,38.09357310915365,0.07513478882511138,3406.4119143486023,698.8660218715668,2579.868309020996,36534,9032,27502,27502,0,22,9003000.0
9003,9003999,20.96902528946674,38.09666968875239,0.07517052987839834,3406.78342795372,698.9362411499023,2580.5519790649414,36548,9033,27515,27515,0,22,9004000.0
9004,9004999,20.970954419715394,38.09928749811285,0.07522644568122783,3406.9429743289948,699.0025715827942,2581.936798095703,36548,9033,27515,27515,0,22,9005000.0
9005,9005999,20.972646615563082,38.101187909162945,0.0752631937799666,3407.260368824005,699.0688621997833,2582.587387084961,36550,9034,27516,27516,0,22,9006000.0
9006,9006999,20.974443353309564,38.103590444429685,0.07529609211269661,3407.9561355113983,699.1381978988647,2582.1619033813477,36566,9037,27529,27529,0,22,9007000.0
9007,9007999,20.97549931103857,38.10514388611131,0.0753096203131155,3408.257512331009,699.2043569087982,2583.4794692993164,36578,9038,27540,27540,0,22,9008000.0
9008,9008999,20.974873050041314,38.103897876198616,0.07530607005162182,3408.7197818756104,699.2688155174255,2583.7601928710938,36580,9038,27542,27542,0,22,9009000.0
9009,9009999,20.974387642185103,38.10298908767843,0.07530103790202458,3409.084002017975,699.3334867954254,2584.47127532959,36583,9039,27544,27544,0,22,9010000.0
9010,9010999,20.974175135112045,38.102564864536845,0.07529294103575956,3409.6293120384216,699.3989136219025,2584.61515045166,36588,9041,27547,27547,0,22,9011000.0
9011,9011999,20.974054698501753,38.103021790006835,0.07528364788131825,3410.127589702606,699.463760137558,2584.8872985839844,36593,9043,27550,27550,0,22,9012000.0
9012,9012999,20.973731102492806,38.102321489546185,0.07527759303399995,3410.4524850845337,699.5279531478882,2585.579032897949,36595,9043,27552,27552,0,22,9013000.0
9013,9013999,20.97336676295571,38.10129816248043,0.07527535170426625,3410.765193939209,699.5904541015625,2586.0664672851562,36595,9043,27552,27552,0,22,9014000.0
9014,9014999,20.97321530065525,38.1007566382036,0.0752683070785587,3411.4127888679504,699.6584088802338,2585.7310943603516,36603,9046,27557,27557,0,22,9015000.0
9015,9015999,20.973351773814034,38.10265940669198,0.07525288000334152,3411.8038132190704,699.7218489646912,2586.1257400512695,36606,9047,27559,27559,0,22,9016000.0
9016,9016999,20.973676792187913,38.10333267703119,0.07524117248582185,3412.1111404895782,699.7903523445129,2586.557861328125,36606,9047,27559,27559,0,22,9017000.0
9017,9017999,20.974094474756587,38.10412341582356,0.07523626428160846,3413.0341351032257,699.8550343513489,2585.735137939453,36619,9053,27566,27566,0,22,9018000.0
9018,9018999,20.97463320699756,38.104798464541915,0.0752317704103429,3413.542553663254,699.9205906391144,2586.014175415039,36633,9055,27578,27578,0,22,9019000.0
9019,9019999,20.97530719486572,38.106233308549356,0.07522956170258221,3413.7905235290527,699.9938457012177,2586.943778991699,36633,9055,27578,27578,0,22,9020000.0
9020,9020999,20.976022484498838,38.107133058912034,0.07522590596600365,3414.116266489029,700.061202287674,2587.307945251465,36633,9055,27578,27578,0,22,9021000.0
9021,9021999,20.97680627690915,38.10830374469409,0.07522420681625164,3414.6720571517944,700.1273970603943,2587.0751190185547,36647,9057,27590,27590,0,22,9022000.0
9022,9022999,20.977704627761945,38.10974687563904,0.07522767778961303,3415.375203847885,700.1939001083374,2586.5008239746094,36663,9060,27603,27603,0,22,9023000.0
9023,9023999,20.978721687012566,38.11225063933189,0.07523097425342473,3415.744805574417,700.2609848976135,2586.9394912719727,36665,9061,27604,27604,0,22,9024000.0
9024,9024999,20.979743253559754,38.1135795568619,0.07524661391719856,3416.0818588733673,700.3294870853424,2587.6133422851562,36667,9062,27605,27605,0,22,9025000.0
9025,9025999,20.980672142557225,38.115131580426095,0.07526937300330305,3416.5301756858826,700.3968832492828,2587.7241973876953,36669,9063,27606,27606,0,22,9026000.0
9026,9026999,20.981313802055592,38.115663210417246,0.07527704268122992,3416.9779813289642,700.4636235237122,2587.77685546875,36671,9064,27607,27607,0,22,9027000.0
9027,9027999,20.981285222447227,38.11537709219843,0.07527528965601682,3417.2316031455994,700.5313405990601,2589.0122299194336,36677,9064,27613,27613,0,22,9028000.0
9028,9028999,20.980710354461113,38.11429899257949,0.07527268662445996,3417.6474368572235,700.5971312522888,2589.556709289551,36682,9066,27616,27616,0,22,9029000.0
9029,9029999,20.9801644483481,38.11307832087048,0.07527126378100402,3418.0433263778687,700.6709656715393,2590.094627380371,36684,9067,27617,27617,0,22,9030000.0
9030,9030999,20.97969543201851,38.11233430390411,0.0752671521624233,3418.4911935329437,700.7373652458191,2590.2234115600586,36687,9068,27619,27619,0,22,9031000.0
9031,9031999,20.97921613874725,38.111251136956035,0.07526242733617383,3418.7717480659485,700.804874420166,2590.7900161743164,36688,9068,27620,27620,0,22,9032000.0
9032,9032999,20.978546691003885,38.109935734802264,0.0752610481579652,3419.1337110996246,700.8731772899628,2591.2060928344727,36691,9069,27622,27622,0,22,9033000.0
9033,9033999,20.978051323730377,38.1088362937432,0.0752612093115419,3419.6269760131836,700.9407114982605,2591.241180419922,36696,9071,27625,27625,0,22,9034000.0
9034,9034999,20.977276994996863,38.10737762640807,0.07526328972473251,3419.978658914566,701.0074298381805,2591.737548828125,36698,9072,27626,27626,0,22,9035000.0
9035,9035999,20.97671519245978,38.10798041727984,0.07525449419807684,3420.5204820632935,701.0765419006348,2591.4275131225586,36700,9073,27627,27627,0,22,9036000.0
9036,9036999,20.976158355306243,38.10719996884187,0.07525225229566568,3420.874674320221,701.1444721221924,2591.9777221679688,36703,9074,27629,27629,0,22,9037000.0
9037,9037999,20.975684037069932,38.10619608842749,0.07524972828079235,3421.5401480197906,701.211439371109,2591.396659851074,36711,9077,27634,27634,0,22,9038000.0
9038,9038999,20.975109510578417,38.105202631639486,0.07524721630914288,3421.882440328598,701.2788500785828,2591.7794494628906,36711,9077,27634,27634,0,22,9039000.0
9039,9039999,20.974589919039186,38.10435809875061,0.07524579623918293,3422.306896686554,701.3493432998657,2591.843086242676,36712,9078,27634,27634,0,22,9040000.0
9040,9040999,20.97398724390416,38.103189847906926,0.07524437127174344,3422.659791946411,701.4156663417816,2592.214111328125,36713,9079,27634,27634,0,22,9041000.0
9041,9041999,20.973571481194814,38.10226961853767,0.07524112949769146,3423.2070717811584,701.4837591648102,2591.738639831543,36725,9080,27645,27645,0,22,9042000.0
9042,9042999,20.973174834943237,38.10148948363757,0.07524297900997123,3423.614982366562,701.5518202781677,2591.9979705810547,36727,9081,27646,27646,0,22,9043000.0
9043,9043999,20.972726262484063,38.10044690496998,0.07524133782662623,3423.956738948822,701.6216504573822,2592.164878845215,36727,9081,27646,27646,0,22,9044000.0
9044,9044999,20.972259014537183,38.09932309549046,0.07524229007577632,3424.295695543289,701.6887435913086,2592.4730072021484,36727,9081,27646,27646,0,22,9045000.0
9045,9045999,20.971792077629104,38.09814537759837,0.07523834948570396,3424.6614043712616,701.7571654319763,2592.5434646606445,36727,9081,27646,27646,0,22,9046000.0
9046,9046999,20.971238940507348,38.097103104942526,0.07523872763389217,3425.0649020671844,714.882429599762,2592.769973754883,36739,9082,27657,27657,0,22,9047000.0
9047,9047999,20.97077277480835,38.0960322779396,0.07522978770496336,3425.349152803421,714.9493896961212,2593.6956939697266,36752,9082,27670,27670,0,22,9048000.0
9048,9048999,20.970067902844995,38.09522979616543,0.0752265127894336,3425.623472929001,715.0242304801941,2594.813545227051,36753,9082,27671,27671,0,22,9049000.0
9049,9049999,20.969307614303965,38.09410884981314,0.07522474285721781,3426.0119841098785,715.0946867465973,2595.535903930664,36765,9083,27682,27682,0,22,9050000.0
9050,9050999,20.968651367890672,38.09336046479792,0.07522379890978581,3426.557337999344,715.1636736392975,2595.8725662231445,36777,9086,27691,27691,0,22,9051000.0
9051,9051999,20.96820381740894,38.092759177026004,0.07521658679643495,3426.971268892288,715.2309248447418,2596.1735763549805,36780,9087,27693,27693,0,22,9052000.0
9052,9052999,20.96760427376254,38.092055494144745,0.07521279313614548,3427.2108068466187,715.3075332641602,2597.098342895508,36780,9087,27693,27693,0,22,9053000.0
9053,9053999,20.967170360398278,38.0910409147703,0.07520682798889711,3427.6441645622253,715.3745658397675,2597.626884460449,36794,9089,27705,27705,0,22,9054000.0
9054,9054999,20.96662818710143,38.089781118853786,0.07520310633002925,3427.978636741638,715.4416983127594,2598.2665481567383,36796,9090,27706,27706,0,22,9055000.0
9055,9055999,20.966310677805296,38.089089092809445,0.07519722865806577,3428.6969034671783,715.5102508068085,2597.8304290771484,36814,9094,27720,27720,0,22,9056000.0
9056,9056999,20.965945848378023,38.088093702170035,0.07519240907198355,3429.3494353294373,715.5828247070312,2597.7961654663086,36835,9097,27738,27738,0,22,9057000.0
9057,9057999,20.96558390489567,38.087177495447044,0.07518727339778009,3429.767368078232,715.6520359516144,2598.5784301757812,36839,9099,27740,27740,0,22,9058000.0
9058,9058999,20.965202574017145,38.0863303935696,0.07518176316645897,3430.0497431755066,715.7206048965454,2599.677375793457,36841,9100,27741,27741,0,22,9059000.0
9059,9059999,20.965086182570882,38.0858521615457,0.07517361601663797,3430.4065799713135,715.7893042564392,2599.9618606567383,36841,9100,27741,27741,0,22,9060000.0
9060,9060999,20.96483681051009,38.08515541768644,0.07516599085858955,3430.7407236099243,715.8599812984467,2600.600875854492,36843,9101,27742,27742,0,22,9061000.0
9061,9061999,20.964737055335572,38.08494891103403,0.07515811720004206,3431.0030088424683,715.9295539855957,2601.257713317871,36843,9101,27742,27742,0,22,9062000.0
9062,9062999,20.96477155833623,38.08468234525585,0.07515087741865634,3431.43222284317,715.9985983371735,2601.4243698120117,36845,9102,27743,27743,0,22,9063000.0
9063,9063999,20.964979645499017,38.08451748980388,0.07514572403090114,3431.812848329544,716.0671265125275,2601.792770385742,36845,9102,27743,27743,0,22,9064000.0
9064,9064999,20.965082541881117,38.084226398988605,0.07513987928075716,3432.180765390396,716.13583111763,2602.318260192871,36847,9103,27744,27744,0,22,9065000.0
9065,9065999,20.96531910741019,38.08406229727102,0.07512953633745245,3432.560026407242,716.2045097351074,2602.687828063965,36850,9104,27746,27746,0,22,9066000.0
9066,9066999,20.965490306008974,38.083662314108146,0.07512493948718257,3432.966128349304,716.2744061946869,2602.8179626464844,36850,9104,27746,27746,0,22,9067000.0
9067,9067999,20.965746807151277,38.08346855149151,0.07511940958945329,3433.2827422618866,716.343428850174,2603.369239807129,36850,9104,27746,27746,0,22,9068000.0
9068,9068999,20.965375522505372,38.08245733658722,0.075110823377876,3433.916754961014,716.406448841095,2602.779640197754,36852,9105,27747,27747,0,22,9069000.0
9069,9069999,20.965170812942844,38.083291740265736,0.0750955762057317,3434.445692539215,716.4717280864716,2603.2675018310547,36870,9107,27763,27763,0,22,9070000.0
9070,9070999,20.96533942295022,38.08605397576808,0.0750783563638815,3434.949694633484,716.5357797145844,2603.669563293457,36877,9109,27768,27768,0,22,9071000.0
9071,9071999,20.965230388463485,38.08533642648155,0.07506860530472104,3435.3882791996,716.599767446518,2603.9420318603516,36879,9110,27769,27769,0,22,9072000.0
9072,9072999,20.965553694114014,38.08534765246899,0.07505190473521406,3435.766746520996,716.6660177707672,2604.3583984375,36880,9110,27770,27770,0,22,9073000.0
9073,9073999,20.965996542715587,38.08609266922878,0.07504177503151632,3436.2635731697083,716.7298896312714,2604.684600830078,36889,9113,27776,27776,0,22,9074000.0
9074,9074999,20.96679383742398,38.08699302682863,0.07503479265984858,3436.71812748909,716.8042898178101,2604.8866806030273,36891,9114,27777,27777,0,22,9075000.0
9075,9075999,20.967836757691057,38.088342099292184,0.07504114279726981,3437.137536048889,716.8692219257355,2605.1731567382812,36894,9115,27779,27779,0,22,9076000.0
9076,9076999,20.96886756252597,38.09006412547587,0.07506041808425556,3437.471297264099,716.9329555034637,2605.817070007324,36896,9116,27780,27780,0,22,9077000.0
9077,9077999,20.970443607393072,38.09328285837512,0.07509024596228664,3438.096161842346,716.9997270107269,2605.438507080078,36904,9119,27785,27785,0,22,9078000.0
9078,9078999,20.971713184211854,38.09520216618079,0.07511624587309296,3438.7967445850372,717.0661556720734,2605.1980209350586,36944,9123,27821,27821,0,22,9079000.0
9079,9079999,20.973737863136808,38.10041193661516,0.07515424490003497,3438.9686760902405,717.1299519538879,2606.235549926758,36944,9123,27821,27821,0,22,9080000.0
9080,9080999,20.975393563226532,38.10328209288563,0.0752136103018729,3439.5429508686066,717.1955661773682,2606.0413513183594,36952,9126,27826,27826,0,22,9081000.0
9081,9081999,20.977540979628408,38.10730139033879,0.07529317201123564,3440.0986363887787,717.2608172893524,2605.8559036254883,36958,9128,27830,27830,0,22,9082000.0
9082,9082999,20.98016827310279,38.11531961789459,0.07537674202915823,3440.4623222351074,717.324304819107,2606.3031692504883,36961,9129,27832,27832,0,22,9083000.0
9083,9083999,20.982240085644644,38.118733482274564,0.0755025152242772,3440.8794972896576,717.3890550136566,2606.457145690918,36963,9130,27833,27833,0,22,9084000.0
9084,9084999,20.98418474742839,38.1216886642212,0.0755913218128339,3441.411008119583,717.4567816257477,2606.336265563965,36968,9132,27836,27836,0,22,9085000.0
9085,9085999,20.98651231147059,38.12610921766941,0.07566693933201762,3441.8683094978333,717.5227499008179,2606.370506286621,36970,9133,27837,27837,0,22,9086000.0
9086,9086999,20.988433722375497,38.128811544185666,0.0757488519834787,3442.1385622024536,717.5873789787292,2606.977607727051,36971,9133,27838,27838,0,22,9087000.0
9087,9087999,20.990183918009905,38.131991983306065,0.07580982930493063,3442.5361034870148,717.6524524688721,2607.314193725586,36983,9134,27849,27849,0,22,9088000.0
9088,9088999,20.990805338792285,38.13309710125503,0.0757880544427948,3442.850830078125,717.7179803848267,2608.3576736450195,36992,9134,27858,27858,0,22,9089000.0
9089,9089999,20.990516362591194,38.13253207113088,0.07577973604198152,3443.295657634735,717.786780834198,2608.9139556884766,36996,9136,27860,27860,0,22,9090000.0
9090,9090999,20.990409537943474,38.13269063292793,0.07577015065930626,3443.658756017685,717.8605315685272,2609.803779602051,36998,9137,27861,27861,0,22,9091000.0
9091,9091999,20.990218402981686,38.132186976863416,0.07576004982336615,3444.0899560451508,717.9278116226196,2610.138870239258,37003,9139,27864,27864,0,22,9092000.0
9092,9092999,20.98997626009084,38.13151951002857,0.07575573218472265,3444.46111035347,717.9964509010315,2610.92147064209,37017,9141,27876,27876,0,22,9093000.0
9093,9093999,20.98984814116209,38.13126416342411,0.07574879216852082,3444.893836259842,718.065358877182,2611.078712463379,37019,9142,27877,27877,0,22,9094000.0
9094,9094999,20.989667087802005,38.130743096537536,0.07574287198135266,3445.510013103485,718.1350290775299,2611.0283432006836,37026,9145,27881,27881,0,22,9095000.0
9095,9095999,20.989605475395933,38.13232080664304,0.0757325293310972,3445.8403749465942,718.2049083709717,2611.479507446289,37026,9145,27881,27881,0,22,9096000.0
9096,9096999,20.989325352438325,38.131365259398045,0.07572721535283189,3446.2427065372467,718.2736616134644,2611.7487411499023,37028,9146,27882,27882,0,22,9097000.0
9097,9097999,20.989272011904458,38.13072701268982,0.07572290246227964,3446.6863956451416,718.3441345691681,2611.990852355957,37030,9147,27883,27883,0,22,9098000.0
9098,9098999,20.9891862056824,38.13023462976254,0.07572398656018087,3446.969498157501,718.4140477180481,2612.427848815918,37030,9147,27883,27883,0,22,9099000.0
9099,9099999,20.989369689835822,38.13022955194566,0.07571877578005526,3447.2314016819,718.4827551841736,2612.959892272949,37030,9147,27883,27883,0,22,9100000.0
9100,9100999,20.98950708959561,38.13009775552262,0.07571444725699605,3447.759162902832,718.5514371395111,2612.5592193603516,37032,9148,27884,27884,0,22,9101000.0
9101,9101999,20.98985390639657,38.130122640737135,0.07570824687300903,3448.4832594394684,718.6221623420715,2611.861297607422,37043,9152,27891,27891,0,22,9102000.0
9102,9102999,20.99024121778467,38.13018012192421,0.07570121370750149,3448.7401959896088,718.6928308010101,2612.6056060791016,37043,9152,27891,27891,0,22,9103000.0
9103,9103999,20.990411550633624,38.129755335858334,0.07569901066423512,3449.339243888855,718.7613022327423,2611.930992126465,37046,9153,27893,27893,0,22,9104000.0
9104,9104999,20.990441803593566,38.129140140150646,0.07569567603375416,3449.551134824753,718.8283162117004,2612.8743057250977,37046,9153,27893,27893,0,22,9105000.0
9105,9105999,20.9903220443504,38.128509332515954,0.07568381732598284,3449.908387184143,718.8945322036743,2613.931640625,37057,9154,27903,27903,0,22,9106000.0
9106,9106999,20.99011389709859,38.12789642204671,0.07567751020358826,3450.2893419265747,718.9602904319763,2614.7032623291016,37063,9156,27907,27907,0,22,9107000.0
9107,9107999,20.98965149640683,38.12701404559631,0.07567280038204416,3450.500956058502,719.0246386528015,2615.70703125,37063,9156,27907,27907,0,22,9108000.0
9108,9108999,20.989252363783024,38.12658553337654,0.07566769624930159,3450.968633413315,719.0890154838562,2615.875129699707,37078,9158,27920,27920,0,22,9109000.0
9109,9109999,20.98884548706807,38.12580690027061,0.07566430191807794,3451.5260257720947,719.1620471477509,2615.6137084960938,37084,9160,27924,27924,0,22,9110000.0
9110,9110999,20.988543092659025,38.12501300751757,0.07566028272401071,3452.1561646461487,719.2265658378601,2615.516128540039,37095,9164,27931,27931,0,22,9111000.0
9111,9111999,20.988285834701607,38.12418091246686,0.07565616338981629,3452.46790266037,719.2906024456024,2616.2428665161133,37098,9165,27933,27933,0,22,9112000.0
9112,9112999,20.98818234484732,38.12369983857999,0.07565252382733068,3452.8798546791077,719.3562018871307,2616.486831665039,37100,9166,27934,27934,0,22,9113000.0
9113,9113999,20.98819598346001,38.1233141911258,0.07564832328876403,3453.328855037689,719.420449256897,2616.8046875,37104,9168,27936,27936,0,22,9114000.0
9114,9114999,20.988140197993737,38.12297642057965,0.07564075729175301,3453.9356818199158,719.4851312637329,2616.4174423217773,37111,9171,27940,27940,0,22,9115000.0
9115,9115999,20.988184417517857,38.122612105854856,0.0756324636236877,3454.389075279236,719.5508148670197,2616.6777114868164,37125,9173,27952,27952,0,22,9116000.0
9116,9116999,20.988590057878106,38.122876319317825,0.07562531005857998,3454.9623198509216,719.617335319519,2616.578414916992,37132,9176,27956,27956,0,22,9117000.0
9117,9117999,20.988998022314412,38.12294674252532,0.0756172984889143,3455.5857589244843,719.6865994930267,2616.240264892578,37147,9178,27969,27969,0,22,9118000.0
9118,9118999,20.9895064285082,38.123490837721505,0.07561105138012458,3456.0422761440277,719.7533316612244,2616.321792602539,37149,9179,27970,27970,0,22,9119000.0
9119,9119999,20.989849831116842,38.123494211403894,0.0756074695374297,3456.3119835853577,719.8187079429626,2616.9019470214844,37149,9179,27970,27970,0,22,9120000.0
9120,9120999,20.990407450308094,38.12408455108443,0.07560263402837508,3456.5132851600647,719.8842356204987,2617.725067138672,37149,9179,27970,27970,0,22,9121000.0
9121,9121999,20.991032811097032,38.1245503963017,0.07559847822023813,3456.965465068817,719.9506466388702,2617.4311141967773,37149,9179,27970,27970,0,22,9122000.0
9122,9122999,20.991653881286283,38.125125586042174,0.07559193147584331,3457.210183620453,720.0173172950745,2618.094383239746,37149,9179,27970,27970,0,22,9123000.0
9123,9123999,20.99203770037654,38.12519583472338,0.07558568723198211,3457.871190071106,720.0845367908478,2617.2765197753906,37152,9181,27971,27971,0,22,9124000.0
9124,9124999,20.99223823295767,38.12510610083572,0.07555955096189748,3458.205992937088,720.1510033607483,2618.105827331543,37157,9181,27976,27976,0,22,9125000.0
9125,9125999,20.991701736180552,38.12393518614683,0.07554946551877129,3458.568428516388,720.2164690494537,2618.7264099121094,37160,9182,27978,27978,0,22,9126000.0
9126,9126999,20.99115671204496,38.122813283171325,0.07554010843990433,3459.0493326187134,720.2841572761536,2619.0449295043945,37166,9184,27982,27982,0,22,9127000.0
9127,9127999,20.990687777662302,38.12208424759857,0.07553038775115073,3459.3292603492737,720.3498601913452,2619.6947860717773,37166,9184,27982,27982,0,22,9128000.0
9128,9128999,20.990174826065985,38.121202475927646,0.0755234896767335,3459.6831483840942,720.4150395393372,2620.090835571289,37168,9185,27983,27983,0,22,9129000.0
9129,9129999,20.98960154857155,38.11993223247459,0.07552007299277574,3460.089746952057,720.4829800128937,2620.003044128418,37168,9185,27983,27983,0,22,9130000.0
9130,9130999,20.9891225421786,38.118871153307374,0.0755111461074972,3460.4242854118347,720.5481872558594,2620.269805908203,37168,9185,27983,27983,0,22,9131000.0
9131,9131999,20.988498667029592,38.11763660799939,0.0755077445103367,3460.8088989257812,720.6137857437134,2620.3024520874023,37168,9185,27983,27983,0,22,9132000.0
9132,9132999,20.988059620194317,38.116675914638186,0.0755008873113252,3461.008092403412,720.6799669265747,2621.1514053344727,37168,9185,27983,27983,0,22,9133000.0
9133,9133999,20.987786057717916,38.11595878481788,0.0754904712667589,3461.3380994796753,720.7458469867706,2621.3501510620117,37168,9185,27983,27983,0,22,9134000.0
9134,9134999,20.98745314414478,38.11501599395214,0.07548263653444098,3461.722691297531,720.8133268356323,2621.557258605957,37170,9186,27984,27984,0,22,9135000.0
9135,9135999,20.986941605635334,38.1137113947147,0.07547922293842158,3462.5020921230316,720.8800389766693,2620.611213684082,37177,9189,27988,27988,0,22,9136000.0
9136,9136999,20.986544466215555,38.11293529888172,0.07547100580470978,3462.753748655319,720.9481227397919,2621.61222076416,37177,9189,27988,27988,0,22,9137000.0
9137,9137999,20.986374926602405,38.11240499774905,0.07546369968718747,3463.066493034363,721.013808965683,2622.3037033081055,37180,9190,27990,27990,0,22,9138000.0
9138,9138999,20.98613170099965,38.11160044239685,0.07545926818919912,3463.485773086548,721.0799829959869,2622.749137878418,37185,9192,27993,27993,0,22,9139000.0
9139,9139999,20.985859519525224,38.11080140115306,0.07545151355600221,3464.185076713562,721.1497073173523,2622.2445907592773,37195,9196,27999,27999,0,22,9140000.0
9140,9140999,20.98561031902983,38.10995356398535,0.0754454873696353,3464.566540002823,721.2184836864471,2622.4778900146484,37195,9196,27999,27999,0,22,9141000.0
9141,9141999,20.9852911691299,38.10891667586608,0.07544245640803249,3464.8585166931152,721.2846710681915,2623.0576400756836,37195,9196,27999,27999,0,22,9142000.0
9142,9142999,20.984843074608378,38.107831501055514,0.07543668435664619,3465.2021017074585,721.3562664985657,2623.484031677246,37195,9196,27999,27999,0,22,9143000.0
9143,9143999,20.984325067633144,38.1069249410633,0.07543498356724787,3465.4977481365204,721.422660112381,2623.9403915405273,37195,9196,27999,27999,0,22,9144000.0
9144,9144999,20.983807728700008,38.10575998745376,0.07543308455925968,3465.8153507709503,721.490517616272,2624.817352294922,37205,9197,28008,28008,0,22,9145000.0
9145,9145999,20.982764207769208,38.10450790930051,0.0754363273268488,3466.0110247135162,721.5533537864685,2626.2882766723633,37210,9197,28013,28013,0,22,9146000.0
9146,9146999,20.981780432287422,38.10316452122318,0.07543799024343611,3466.2831065654755,721.6189813613892,2627.0876235961914,37210,9197,28013,28013,0,22,9147000.0
9147,9147999,20.980935274670337,38.102098462497814,0.07543720620439964,3466.6605911254883,721.6808686256409,2627.577621459961,37212,9198,28014,28014,0,22,9148000.0
9148,9148999,20.980158956111957,38.10124854028479,0.07543562434043372,3466.9236001968384,721.7436213493347,2628.411331176758,37214,9199,28015,28015,0,22,9149000.0
9149,9149999,20.97938756764774,38.0998464979279,0.07543689580903501,3467.4779436588287,721.806056022644,2628.3198165893555,37231,9202,28029,28029,0,22,9150000.0
9150,9150999,20.978634845094607,38.098483561243114,0.07543798239534505,3468.3456161022186,721.8707265853882,2627.4684829711914,37241,9207,28034,28034,0,22,9151000.0
9151,9151999,20.97790953529423,38.09743974781165,0.0754386743740384,3468.706417322159,721.9331486225128,2628.1445922851562,37245,9209,28036,28036,0,22,9152000.0
9152,9152999,20.977241692642366,38.09635918813381,0.07543713410595587,3469.1200268268585,721.9974589347839,2628.516258239746,37252,9210,28042,28042,0,22,9153000.0
9153,9153999,20.976630006514895,38.0951682085928,0.07543600074033507,3469.336796760559,722.0610914230347,2629.365234375,37252,9210,28042,28042,0,22,9154000.0
9154,9154999,20.976001901366715,38.093818672839184,0.07543675260334348,3469.690666913986,722.1239290237427,2629.6966400146484,37254,9211,28043,28043,0,22,9155000.0
9155,9155999,20.975328632056485,38.092506314797646,0.07543643090528307,3470.180883407593,722.1890201568604,2629.789665222168,37260,9213,28047,28047,0,22,9156000.0
9156,9156999,20.97479563979768,38.09140528694584,0.07543431031176817,3470.5222318172455,722.253258228302,2630.2354278564453,37262,9214,28048,28048,0,22,9157000.0
9157,9157999,20.974479804998154,38.09084366197676,0.07543167847079968,3470.9491918087006,722.3185667991638,2630.093147277832,37262,9214,28048,28048,0,22,9158000.0
9158,9158999,20.974164450038053,38.09016076641316,0.07542928875707566,3471.2409875392914,722.3813440799713,2630.4872665405273,37262,9214,28048,28048,0,22,9159000.0
9159,9159999,20.97401497917239,38.08984635719381,0.07542304704580949,3471.778563976288,722.4479646682739,2630.227279663086,37267,9216,28051,28051,0,22,9160000.0
9160,9160999,20.974079687068528,38.09016992544051,0.07541627099741255,3472.236632823944,722.5123980045319,2630.4707107543945,37291,9218,28073,28073,0,22,9161000.0
9161,9161999,20.974348709200857,38.09123011867009,0.07540988417437977,3472.7501533031464,722.5782432556152,2630.1221466064453,37293,9219,28074,28074,0,22,9162000.0
9162,9162999,20.974640739996165,38.09240413888769,0.07540547695216071,3473.0513076782227,722.6430239677429,2630.5127716064453,37293,9219,28074,28074,0,22,9163000.0
9163,9163999,20.974851523129015,38.09274659756805,0.07539896408709645,3473.501158475876,722.7088894844055,2630.1912231445312,37293,9219,28074,28074,0,22,9164000.0
9164,9164999,20.974007570533296,38.09127523649283,0.07540566665633497,3473.7932653427124,722.7752635478973,2631.1519622802734,37299,9219,28080,28080,0,22,9165000.0
9165,9165999,20.97328939028727,38.091187941167796,0.07540075569589444,3474.2432584762573,722.842179775238,2631.3321838378906,37303,9220,28083,28083,0,22,9166000.0
9166,9166999,20.97258245725079,38.09030737245613,0.07540061508964502,3474.6642558574677,722.907958984375,2631.4045639038086,37303,9220,28083,28083,0,22,9167000.0
9167,9167999,20.971830113855425,38.089154614902775,0.07540022148017378,3474.9064376354218,722.9714369773865,2632.263916015625,37304,9220,28084,28084,0,22,9168000.0
9168,9168999,20.97118893582077,38.088290959229845,0.0753977255770304,3475.0679540634155,723.0354552268982,2633.3296966552734,37304,9220,28084,28084,0,22,9169000.0
9169,9169999,20.97045813827424,38.087143625178044,0.07539899143734019,3475.3223366737366,723.1003091335297,2633.819854736328,37305,9220,28085,28085,0,22,9170000.0
9170,9170999,20.969715555898368,38.08579525244547,0.075401558509536,3475.8291375637054,723.1648831367493,2633.7027282714844,37310,9222,28088,28088,0,22,9171000.0
9171,9171999,20.968977281991833,38.08446321874603,0.07540392421178987,3476.261621236801,723.2319209575653,2634.069923400879,37315,9224,28091,28091,0,22,9172000.0
9172,9172999,20.968465444154734,38.0836319185047,0.07540084937682467,3476.6311042308807,723.2977283000946,2634.248649597168,37315,9224,28091,28091,0,22,9173000.0
9173,9173999,20.96788180946572,38.08242462421434,0.07540055605455276,3477.0597364902496,723.3654065132141,2634.3672637939453,37317,9225,28092,28092,0,22,9174000.0
9174,9174999,20.967386187507614,38.08174280091689,0.07539906929753848,3477.4086215496063,723.4324402809143,2634.5873107910156,37317,9225,28092,28092,0,22,9175000.0
9175,9175999,20.96685775441115,38.080678044139084,0.07539770872221341,3478.2307181358337,723.5012340545654,2633.207588195801,37321,9227,28094,28094,0,22,9176000.0
9176,9176999,20.966599012289233,38.08016707180391,0.07539304752440379,3478.6108255386353,723.5666010379791,2633.8308715820312,37325,9229,28096,28096,0,22,9177000.0
9177,9177999,20.966287545889564,38.07937725561819,0.07538981920132004,3478.8100876808167,723.6327936649323,2634.7174224853516,37325,9229,28096,28096,0,22,9178000.0
9178,9178999,20.966286272011985,38.07949651601078,0.07538226505944234,3479.1575243473053,723.6996545791626,2635.1541061401367,37328,9230,28098,28098,0,22,9179000.0
9179,9179999,20.966286604814627,38.07930778270043,0.07537559361229373,3479.719489812851,723.7670016288757,2634.7071685791016,37333,9232,28101,28101,0,22,9180000.0
9180,9180999,20.96662507428362,38.081060931172566,0.0753619185714065,3480.1189303398132,723.8335766792297,2634.933738708496,37335,9233,28102,28102,0,22,9181000.0
9181,9181999,20.966624150323593,38.080890246748204,0.07535537979102236,3480.593853712082,723.9016137123108,2634.779495239258,37338,9234,28104,28104,0,22,9182000.0
9182,9182999,20.96667328067969,38.08088421603609,0.07534666081383656,3480.960545063019,723.9674775600433,2634.971939086914,37338,9234,28104,28104,0,22,9183000.0
9183,9183999,20.96640963906457,38.0802658454005,0.07534124061994829,3481.26135802269,724.0343101024628,2636.2680282592773,37349,9235,28114,28114,0,22,9184000.0
9184,9184999,20.966111736147834,38.07984004981094,0.07533957965948046,3481.4997556209564,724.103423833847,2637.3469467163086,37350,9235,28115,28115,0,22,9185000.0
9185,9185999,20.966185849950882,38.080463504561834,0.07533166310683392,3481.8183736801147,724.1718051433563,2638.4279556274414,37367,9236,28131,28131,0,22,9186000.0
9186,9186999,20.966297529175844,38.08061844194439,0.0753235273472227,3482.1053833961487,724.2406983375549,2639.560401916504,37369,9237,28132,28132,0,22,9187000.0
9187,9187999,20.96619581595922,38.079942436307995,0.0753182523519561,3482.3452455997467,724.3094637393951,2640.433219909668,37369,9237,28132,28132,0,22,9188000.0
9188,9188999,20.966196774655508,38.079433689677394,0.07531328403495086,3482.8475511074066,724.3807380199432,2640.384323120117,37374,9239,28135,28135,0,22,9189000.0
9189,9189999,20.966412702465487,38.07946570820618,0.07531192057900893,3483.368049621582,724.4520561695099,2640.6053771972656,37380,9242,28138,28138,0,22,9190000.0
9190,9190999,20.966576161365715,38.07938500647138,0.07531090306774224,3483.6684527397156,724.5234799385071,2641.447685241699,37382,9243,28139,28139,0,22,9191000.0
9191,9191999,20.967147165922484,38.08054684170936,0.07531240669522776,3484.088067293167,724.5930709838867,2641.7926025390625,37387,9245,28142,28142,0,22,9192000.0
9192,9192999,20.967575076204827,38.08140163341798,0.0753145456302996,3484.617161989212,724.6643481254578,2641.78849029541,37391,9247,28144,28144,0,22,9193000.0
9193,9193999,20.968273365333257,38.08251514564709,0.07534505119875645,3484.8724975585938,724.7336797714233,2642.4816970825195,37391,9247,28144,28144,0,22,9194000.0
9194,9194999,20.96959244677135,38.09291275941038,0.07535252314177676,3485.232370376587,724.8058710098267,2642.6581268310547,37391,9247,28144,28144,0,22,9195000.0
9195,9195999,20.970270999507168,38.09366729917146,0.07537594261687364,3485.7364468574524,724.8772442340851,2642.6438217163086,37396,9249,28147,28147,0,22,9196000.0
9196,9196999,20.97144856602017,38.09585694962577,0.07540141569404313,3486.206392765045,724.9487268924713,2642.8370666503906,37400,9251,28149,28149,0,23,9197000.0
9197,9197999,20.972460932011735,38.09838773746255,0.07544281446785284,3486.6410183906555,725.0207030773163,2642.917350769043,37402,9252,28150,28150,0,23,9198000.0
9198,9198999,20.973498979965214,38.09987056667658,0.07547592249185708,3486.9691405296326,725.0932443141937,2643.3313751220703,37402,9252,28150,28150,0,23,9199000.0
9199,9199999,20.975421295489664,38.10518890772373,0.07552610419130912,3487.478273153305,725.1659145355225,2643.3824157714844,37406,9254,28152,28152,0,23,9200000.0
9200,9200999,20.976844372388534,38.107727800567616,0.07556730341007423,3487.6911187171936,725.2387835979462,2644.2189559936523,37406,9254,28152,28152,0,23,9201000.0
9201,9201999,20.978126849097098,38.10968786541123,0.07559972454601538,3488.1027359962463,725.3090362548828,2644.146369934082,37406,9254,28152,28152,0,23,9202000.0
9202,9202999,20.978461432026748,38.10943589925326,0.07560617201623465,3488.6704473495483,725.3753278255463,2644.107582092285,37414,9256,28158,28158,0,23,9203000.0
9203,9203999,20.978148035558277,38.109790756408046,0.07559321744294922,3488.9676234722137,725.4369926452637,2644.848876953125,37418,9257,28161,28161,0,23,9204000.0
9204,9204999,20.977727441627156,38.10935429574429,0.07558454825508865,3489.336332798004,725.4993133544922,2645.0520782470703,37420,9257,28163,28163,0,23,9205000.0
9205,9205999,20.97738554533714,38.10887193342897,0.07557783640321236,3489.722989797592,725.5631988048553,2645.4781341552734,37423,9258,28165,28165,0,23,9206000.0
9206,9206999,20.977320915198227,38.10855174173942,0.07556397603879073,3490.134677171707,725.6270513534546,2645.7852478027344,37425,9259,28166,28166,0,23,9207000.0
9207,9207999,20.97729917253693,38.10834788534515,0.07554772929069697,3490.350048303604,725.6904089450836,2646.6080474853516,37426,9259,28167,28167,0,23,9208000.0
9208,9208999,20.97711567486427,38.10780298070145,0.0755360954281794,3490.922427177429,725.7550051212311,2646.461357116699,37434,9262,28172,28172,0,23,9209000.0
9209,9209999,20.977080770032952,38.10745450007184,0.07552323074898526,3491.4168677330017,725.8194646835327,2646.3720321655273,37437,9263,28174,28174,0,23,9210000.0
9210,9210999,20.977108818751617,38.10748938136448,0.07551126720911894,3491.786007165909,725.8840336799622,2646.753936767578,37440,9264,28176,28176,0,23,9211000.0
9211,9211999,20.977532049392135,38.108383465766764,0.07550176441233425,3492.183315038681,725.9470071792603,2647.3487701416016,37457,9266,28191,28191,0,23,9212000.0
9212,9212999,20.977984236658124,38.109848945976466,0.07549709707127483,3493.0206983089447,726.0150475502014,2646.4805068969727,37470,9271,28199,28199,0,23,9213000.0
9213,9213999,20.978300358280396,38.10993262642729,0.07550194234558905,3493.427580356598,726.0799176692963,2646.758087158203,37472,9272,28200,28200,0,23,9214000.0
9214,9214999,20.978730676529864,38.11030925526386,0.07550228662646652,3493.7172560691833,726.1446492671967,2647.2920532226562,37472,9272,28200,28200,0,23,9215000.0
9215,9215999,20.979153697671002,38.110553844177524,0.07550568937543445,3494.032062768936,726.2109262943268,2647.905517578125,37474,9273,28201,28201,0,23,9216000.0
9216,9216999,20.979923377229625,38.11175002897098,0.07550922709859942,3494.616237640381,726.2766091823578,2647.76766204834,37483,9276,28207,28207,0,23,9217000.0
9217,9217999,20.980890792562292,38.11314416455856,0.07551904612195537,3494.940196752548,726.3411321640015,2648.04727935791,37483,9276,28207,28207,0,23,9218000.0
9218,9218999,20.982301768326394,38.11680321222166,0.07552752660182305,3495.277223587036,726.4059679508209,2648.304229736328,37483,9276,28207,28207,0,23,9219000.0
9219,9219999,20.9836865449752,38.119198600633766,0.07554414695681777,3495.7658689022064,726.4739651679993,2648.1904907226562,37486,9277,28209,28209,0,23,9220000.0
9220,9220999,20.98534033907008,38.123646868487825,0.07556777914600699,3496.307096719742,726.5404007434845,2648.030372619629,37491,9279,28212,28212,0,23,9221000.0
9221,9221999,20.986807346221433,38.1253030259433,0.07559050397606992,3496.750513076782,726.6040375232697,2647.963523864746,37493,9280,28213,28213,0,23,9222000.0
9222,9222999,20.98706527656093,38.12617905984065,0.07559143859157258,3497.1873540878296,726.6697137355804,2648.6001739501953,37501,9282,28219,28219,0,23,9223000.0
9223,9223999,20.986385611572434,38.12492857649673,0.07558982636642464,3497.4404163360596,726.7375571727753,2649.5514526367188,37501,9282,28219,28219,0,23,9224000.0
9224,9224999,20.98566723694746,38.12372645575411,0.07559150323805908,3497.7461473941803,726.8051788806915,2650.0921173095703,37503,9282,28221,28221,0,23,9225000.0
9225,9225999,20.98516499067388,38.123165203436905,0.07558603399372488,3498.317774295807,726.8743522167206,2649.831657409668,37508,9284,28224,28224,0,23,9226000.0
9226,9226999,20.984680590319858,38.12224785071579,0.07558341541557523,3498.673393011093,726.9422678947449,2650.3064346313477,37510,9285,28225,28225,0,23,9227000.0
9227,9227999,20.98417770053961,38.12111285683227,0.07558118047342477,3499.290374279022,727.010904788971,2649.8871994018555,37516,9288,28228,28228,0,23,9228000.0
9228,9228999,20.983587871595795,38.11996186511004,0.07557929007636055,3499.605687856674,727.0780582427979,2650.5486068725586,37518,9289,28229,28229,0,23,9229000.0
9229,9229999,20.983165304330562,38.11911849752819,0.07557631091759609,3500.3575065135956,727.1467025279999,2650.065742492676,37529,9294,28235,28235,0,23,9230000.0
9230,9230999,20.98298664830106,38.11850040373872,0.07557099723446103,3501.121104478836,727.2158639431,2649.536605834961,37538,9298,28240,28240,0,23,9231000.0
9231,9231999,20.98287642211421,38.11918727510111,0.07556070190988584,3501.4291462898254,727.2849519252777,2650.3025970458984,37541,9299,28242,28242,0,23,9232000.0
9232,9232999,20.98289088513113,38.11912819902195,0.07555318112594944,3502.035155057907,727.355651140213,2649.7765197753906,37545,9301,28244,28244,0,23,9233000.0
9233,9233999,20.98291534143635,38.11910719966208,0.07554735106924582,3502.3625869750977,727.426566362381,2650.457618713379,37547,9302,28245,28245,0,23,9234000.0
9234,9234999,20.98305817502595,38.11881278569326,0.0755411059033132,3502.742746591568,727.4977557659149,2650.5678176879883,37547,9302,28245,28245,0,23,9235000.0
9235,9235999,20.983190874549734,38.11845023580561,0.07553415951664078,3503.3700144290924,727.5682928562164,2650.058036804199,37562,9304,28258,28258,0,23,9236000.0
9236,9236999,20.9831293689928,38.117704603759194,0.07552858444707178,3503.54243683815,727.638822555542,2651.1110229492188,37562,9304,28258,28258,0,23,9237000.0
9237,9237999,20.983037705654418,38.116957653961485,0.0755247618576349,3504.0641458034515,727.7080814838409,2650.512237548828,37562,9304,28258,28258,0,23,9238000.0
9238,9238999,20.98286408349958,38.116049804133056,0.07552108087996667,3504.564352750778,727.7819662094116,2650.658378601074,37565,9305,28260,28260,0,23,9239000.0
9239,9239999,20.982274955606748,38.11571211879692,0.07552100786708771,3504.988717317581,727.8461964130402,2651.418167114258,37581,9307,28274,28274,0,23,9240000.0
9240,9240999,20.981517736432455,38.11461678123935,0.0755236473604114,3505.46089720726,727.911883354187,2651.9328231811523,37587,9309,28278,28278,0,23,9241000.0
9241,9241999,20.981011041089268,38.11477473257513,0.07552231199865267,3505.7868344783783,727.9785692691803,2652.5202026367188,37587,9309,28278,28278,0,23,9242000.0
9242,9242999,20.980226970959738,38.11369280396623,0.07552551438139721,3506.185691356659,728.0447385311127,2652.7320556640625,37600,9310,28290,28290,0,23,9243000.0
9243,9243999,20.97945957468089,38.11232167280508,0.07552797227261687,3506.573221206665,728.1085202693939,2652.9781646728516,37602,9311,28291,28291,0,23,9244000.0
9244,9244999,20.97857757053981,38.11084269304181,0.07552936442794478,3506.98051404953,728.1744921207428,2653.204345703125,37605,9312,28293,28293,0,23,9245000.0
9245,9245999,20.977839440889348,38.10962868028976,0.07552832714135516,3507.339706659317,728.2392485141754,2653.306465148926,37605,9312,28293,28293,0,23,9246000.0
9246,9246999,20.977292226671963,38.10875624984959,0.07552540850982958,3507.7450087070465,728.3063971996307,2653.5119552612305,37607,9313,28294,28294,0,23,9247000.0
9247,9247999,20.976794121009046,38.10788135937153,0.07552266161003363,3508.1887640953064,728.3724844455719,2653.6647567749023,37610,9314,28296,28296,0,23,9248000.0
9248,9248999,20.976240285396454,38.10695069442162,0.07551918105383248,3508.609122276306,728.4379317760468,2654.075340270996,37619,9316,28303,28303,0,23,9249000.0
9249,9249999,20.975800344852907,38.10609209218726,0.07551620329892661,3509.019326210022,728.5068092346191,2653.9997901916504,37623,9317,28306,28306,0,23,9250000.0
9250,9250999,20.975434396520104,38.10517092099802,0.07551157960567112,3509.570816040039,728.5736720561981,2653.4961128234863,37625,9318,28307,28307,0,23,9251000.0
9251,9251999,20.975142595976788,38.10457621359629,0.07550608535253489,3510.0169456005096,728.6410090923309,2653.5616493225098,37627,9319,28308,28308,0,23,9252000.0
9252,9252999,20.974972986950316,38.10484480019687,0.07549638563109462,3510.403355360031,728.7068042755127,2653.7751960754395,37629,9320,28309,28309,0,23,9253000.0
9253,9253999,20.974718654232408,38.10405694805368,0.07549155530629859,3510.796484708786,728.77361369133,2653.9112968444824,37631,9321,28310,28310,0,23,9254000.0
9254,9254999,20.974444461392714,38.10318936134052,0.07548846594618897,3511.3009300231934,728.8399748802185,2653.9276847839355,37650,9323,28327,28327,0,23,9255000.0
9255,9255999,20.974332713775095,38.10317716332395,0.07548066234574569,3511.9511303901672,728.9065632820129,2653.4126777648926,37656,9325,28331,28331,0,23,9256000.0
9256,9256999,20.974053108588855,38.10283932297014,0.07547326903550744,3512.158432483673,728.9738490581512,2654.373508453369,37656,9325,28331,28331,0,23,9257000.0
9257,9257999,20.973762562708206,38.10199482973025,0.07546850086249901,3512.5285515785217,729.0401618480682,2654.480541229248,37656,9325,28331,28331,0,23,9258000.0
9258,9258999,20.97304208499991,38.10112818984731,0.07546802401383013,3512.79012799263,729.1054146289825,2655.6584510803223,37661,9326,28335,28335,0,23,9259000.0
9259,9259999,20.972006506619472,38.099572156575796,0.07547475458156938,3513.1057472229004,729.1731317043304,2656.1978874206543,37661,9326,28335,28335,0,23,9260000.0
9260,9260999,20.970973261529334,38.09791895121501,0.0754818160026135,3513.33412194252,729.2408595085144,2656.9127235412598,37662,9326,28336,28336,0,23,9261000.0
9261,9261999,20.970119414822975,38.09654040058519,0.07548714972151072,3513.6829290390015,729.3075323104858,2657.123722076416,37662,9326,28336,28336,0,23,9262000.0
9262,9262999,20.96939143293785,38.09538678364462,0.07549018915463157,3514.076165676117,729.3775134086609,2657.302257537842,37666,9327,28339,28339,0,23,9263000.0
9263,9263999,20.968644134724645,38.09407146399656,0.07549480779493012,3514.7499821186066,729.447155714035,2656.915050506592,37687,9330,28357,28357,0,23,9264000.0
9264,9264999,20.96791485340928,38.09280736636067,0.07549901619383448,3514.9463539123535,729.5167367458344,2658.0619773864746,37687,9330,28357,28357,0,23,9265000.0
9265,9265999,20.96704383063828,38.09125248405557,0.07550377021602206,3515.231457233429,729.5852108001709,2658.5609703063965,37687,9330,28357,28357,0,23,9266000.0
9266,9266999,20.966342350734042,38.09100391828138,0.07550199680098912,3515.6392788887024,729.6539256572723,2659.108600616455,37704,9332,28372,28372,0,23,9267000.0
9267,9267999,20.9657538216239,38.09021359799397,0.07550111278433091,3515.8577778339386,729.7235999107361,2660.222911834717,37705,9332,28373,28373,0,23,9268000.0
9268,9268999,20.965136053962333,38.089330162628016,0.07549975112563456,3516.0908114910126,729.7923955917358,2661.098819732666,37705,9332,28373,28373,0,23,9269000.0
9269,9269999,20.964458312357866,38.087999947343775,0.07550070678891652,3516.324198961258,729.8607897758484,2661.8317832946777,37705,9332,28373,28373,0,23,9270000.0
9270,9270999,20.96400374134307,38.087265902947685,0.07549924220512239,3516.57199716568,729.9319939613342,2662.4090156555176,37705,9332,28373,28373,0,23,9271000.0
9271,9271999,20.963397447316623,38.08620326320822,0.07549931274499222,3516.85311293602,730.0013275146484,2662.8072776794434,37705,9332,28373,28373,0,23,9272000.0
9272,9272999,20.96288205038977,38.08510440173728,0.07549886033915476,3517.2605979442596,730.0717439651489,2662.643207550049,37705,9332,28373,28373,0,23,9273000.0
9273,9273999,20.962302023911914,38.083887151601004,0.07549982688285806,3517.806905031204,730.1431615352631,2662.2624473571777,37707,9333,28374,28374,0,23,9274000.0
9274,9274999,20.96194345537159,38.08288674878629,0.07549941162424878,3518.0895290374756,730.2121639251709,2662.705104827881,37707,9333,28374,28374,0,23,9275000.0
9275,9275999,20.96157395739285,38.08285085953423,0.0754962812931409,3518.474826812744,730.2831451892853,2662.916759490967,37709,9334,28375,28375,0,23,9276000.0
9276,9276999,20.96102300373409,38.081652105245986,0.07549859367013934,3518.8875880241394,730.3535087108612,2662.838123321533,37709,9334,28375,28375,0,23,9277000.0
9277,9277999,20.960404972656956,38.08042112193907,0.07550078102231339,3519.159264087677,730.4221744537354,2663.308277130127,37709,9334,28375,28375,0,23,9278000.0
9278,9278999,20.959714870871924,38.07971882504713,0.0755003665311954,3519.491025686264,730.4913737773895,2663.581645965576,37709,9334,28375,28375,0,23,9279000.0
9279,9279999,20.95912673590865,38.078463356161265,0.0754961417096327,3519.795825242996,730.5537829399109,2664.6006507873535,37721,9335,28386,28386,0,23,9280000.0
9280,9280999,20.958431361966714,38.07752887607803,0.07548785492913812,3520.2220845222473,730.6181962490082,2664.883632659912,37723,9336,28387,28387,0,23,9281000.0
9281,9281999,20.957724324862717,38.07611909456681,0.07548507141556193,3520.5091049671173,730.6821768283844,2665.452823638916,37723,9336,28387,28387,0,23,9282000.0
9282,9282999,20.95706694128114,38.07475929230677,0.07548436588122598,3520.910138130188,730.7454640865326,2665.6897773742676,37726,9337,28389,28389,0,23,9283000.0
9283,9283999,20.95635790426164,38.073316734510826,0.07548684559629482,3521.1437776088715,730.8066086769104,2666.3439140319824,37727,9337,28390,28390,0,23,9284000.0
9284,9284999,20.955656263401707,38.07200660807503,0.07548845953296268,3521.731069803238,730.871663570404,2666.1045722961426,37734,9340,28394,28394,0,23,9285000.0
9285,9285999,20.955015028619854,38.07064030971293,0.0754887417308655,3521.9742805957794,730.9359078407288,2666.7722206115723,37735,9340,28395,28395,0,23,9286000.0
9286,9286999,20.954373164818684,38.06947584521395,0.0754888899190096,3522.768282175064,730.999841928482,2665.508930206299,37742,9343,28399,28399,0,23,9287000.0
9287,9287999,20.953876596897143,38.068410703411,0.07548238348311664,3523.060075521469,731.06445479393,2666.019763946533,37743,9343,28400,28400,0,23,9288000.0
9288,9288999,20.953509226733928,38.06884043057924,0.07547320457744067,3523.4821066856384,731.1293158531189,2666.211139678955,37745,9344,28401,28401,0,23,9289000.0
9289,9289999,20.953017491980493,38.0679473619522,0.07547010330080317,3523.8885667324066,731.1955926418304,2666.481586456299,37748,9345,28403,28403,0,23,9290000.0
9290,9290999,20.952383847774502,38.066685423498456,0.07547018082007673,3524.2445418834686,731.259268283844,2666.608310699463,37748,9345,28403,28403,0,23,9291000.0
9291,9291999,20.951824292587858,38.06554813389689,0.07546698110379457,3524.6234214305878,731.3246257305145,2666.9321250915527,37751,9346,28405,28405,0,23,9292000.0
9292,9292999,20.95128147668164,38.064361450452466,0.07546604000776191,3524.988310098648,731.3887708187103,2667.1997413635254,37754,9347,28407,28407,0,23,9293000.0
9293,9293999,20.9508461914776,38.06326102422004,0.07546335388357894,3525.2555692195892,731.4533181190491,2667.7088737487793,37754,9347,28407,28407,0,23,9294000.0
9294,9294999,20.950327570936466,38.06199171800211,0.07546396922611798,3525.9763462543488,731.5195479393005,2667.1739082336426,37772,9351,28421,28421,0,23,9295000.0
9295,9295999,20.94992992208518,38.060916323855814,0.07546305383662621,3526.37410736084,731.5852494239807,2667.4037742614746,37774,9352,28422,28422,0,23,9296000.0
9296,9296999,20.9493477552937,38.05958096920194,0.07546130626818837,3526.776443719864,731.6498098373413,2667.334857940674,37774,9352,28422,28422,0,23,9297000.0
9297,9297999,20.948609271198514,38.058093764819276,0.07546356299704471,3527.0220201015472,731.7145793437958,2667.8919792175293,37774,9352,28422,28422,0,23,9298000.0
9298,9298999,20.947843124969072,38.056601797045424,0.0754669693457175,3527.2485585212708,731.7776718139648,2668.8652992248535,37781,9352,28429,28429,0,23,9299000.0
9299,9299999,20.946746185291953,38.0549452524047,0.07548026675783381,3527.500639438629,731.845205783844,2670.20064163208,37785,9353,28432,28432,0,23,9300000.0
9300,9300999,20.945763524553858,38.05355759427644,0.07548535628739217,3527.874892473221,731.9116411209106,2670.6914253234863,37787,9354,28433,28433,0,23,9301000.0
9301,9301999,20.944865391896027,38.05237366903637,0.07548949630844248,3528.1445655822754,731.9786946773529,2671.282627105713,37787,9354,28433,28433,0,23,9302000.0
9302,9302999,20.94407878400317,38.05111127244987,0.07549350727207638,3528.505110025406,732.0442266464233,2671.3122901916504,37788,9354,28434,28434,0,23,9303000.0
9303,9303999,20.943226421409953,38.049833609886534,0.07549436375820273,3528.864382982254,732.1087369918823,2671.844051361084,37790,9355,28435,28435,0,23,9304000.0
9304,9304999,20.94228703063876,38.04878652396182,0.07550073866079798,3529.0563011169434,732.1739530563354,2672.5162467956543,37790,9355,28435,28435,0,23,9305000.0
9305,9305999,20.94135269756804,38.04727239613308,0.07550435445250614,3529.612823486328,732.2403647899628,2671.984951019287,37796,9356,28440,28440,0,23,9306000.0
9306,9306999,20.940459380593378,38.04577132182971,0.07550538102849313,3529.992909193039,732.306939125061,2672.2347450256348,37798,9357,28441,28441,0,23,9307000.0
9307,9307999,20.939946934452173,38.04799127838161,0.07548893800530321,3530.4267830848694,732.3740668296814,2672.2764778137207,37800,9358,28442,28442,0,23,9308000.0
9308,9308999,20.93929703981194,38.04686010760255,0.07548493858632599,3530.7016139030457,732.4402849674225,2672.8627967834473,37800,9358,28442,28442,0,23,9309000.0
9309,9309999,20.938750682066253,38.045829673123535,0.07547260527385957,3531.0838849544525,732.5067794322968,2673.1076622009277,37802,9359,28443,28443,0,23,9310000.0
9310,9310999,20.938235233901064,38.04482440063437,0.07546420299906553,3531.7194809913635,732.5748207569122,2672.6997871398926,37814,9362,28452,28452,0,23,9311000.0
9311,9311999,20.937766475716636,38.04390870251857,0.07545639344742494,3532.1068823337555,732.6439278125763,2673.0846672058105,37815,9363,28452,28452,0,23,9312000.0
9312,9312999,20.93748253623718,38.043162765262295,0.07544929894369634,3532.389310359955,732.7112917900085,2673.552875518799,37815,9363,28452,28452,0,23,9313000.0
9313,9313999,20.937247342948286,38.04241745082312,0.07544030448623462,3532.690751552582,732.7790553569794,2673.9815788269043,37815,9363,28452,28452,0,23,9314000.0
9314,9314999,20.93714294872895,38.04195035049792,0.075440020047147,3533.2842257022858,732.847065448761,2673.711727142334,37821,9366,28455,28455,0,23,9315000.0
9315,9315999,20.937074548040027,38.041407176397534,0.07544125798976042,3533.563663005829,732.9156620502472,2674.2376670837402,37821,9366,28455,28455,0,23,9316000.0
9316,9316999,20.936961193381286,38.04078307036691,0.07543692172667926,3533.8466432094574,732.98406291008,2674.728748321533,37821,9366,28455,28455,0,23,9317000.0
9317,9317999,20.93686869635939,38.04020712823342,0.07542670973186683,3534.0945720672607,733.0509328842163,2675.3119010925293,37821,9366,28455,28455,0,23,9318000.0
9318,9318999,20.93630378368794,38.038984101383974,0.07542543545505409,3534.681007862091,733.1188254356384,2674.6498222351074,37823,9367,28456,28456,0,23,9319000.0
9319,9319999,20.9355861795413,38.03755160226587,0.07542776236305015,3535.0391545295715,733.1840171813965,2675.295192718506,37829,9368,28461,28461,0,23,9320000.0
9320,9320999,20.93455144705959,38.03597836935339,0.07543416787008284,3535.450585126877,733.2509529590607,2675.7461738586426,37837,9369,28468,28468,0,23,9321000.0
9321,9321999,20.933920392792533,38.03500360856212,0.07543161468242021,3535.744188308716,733.3179755210876,2676.4170875549316,37839,9369,28470,28470,0,23,9322000.0
9322,9322999,20.933233209574727,38.0339038049036,0.07543257324127572,3536.1649055480957,733.3844726085663,2676.682605743408,37842,9370,28472,28472,0,23,9323000.0
9323,9323999,20.93261274940215,38.03254366834718,0.07542986721531508,3536.4362132549286,733.4504837989807,2677.4743461608887,37843,9370,28473,28473,0,23,9324000.0
9324,9324999,20.9321082820927,38.03148377334905,0.07542472327361593,3536.7141451835632,733.5177545547485,2678.282497406006,37846,9371,28475,28475,0,23,9325000.0
9325,9325999,20.931476102880886,38.03021371877214,0.07541854627718103,3537.0213210582733,733.5845980644226,2678.7906913757324,37846,9371,28475,28475,0,23,9326000.0
9326,9326999,20.930861106066114,38.02893127377714,0.07541428552142071,3537.466184616089,733.653395652771,2678.954319000244,37852,9373,28479,28479,0,23,9327000.0
9327,9327999,20.930212686006286,38.02763915209514,0.0754110198377822,3538.1374163627625,733.7210550308228,2678.5996742248535,37862,9377,28485,28485,0,23,9328000.0
9328,9328999,20.929572324961452,38.02651981475667,0.0754102445189534,3538.6651933193207,733.7900242805481,2678.6732292175293,37869,9380,28489,28489,0,23,9329000.0
9329,9329999,20.928835173356976,38.02517106322586,0.07541123495019142,3539.136698484421,733.8582081794739,2678.9420890808105,37875,9382,28493,28493,0,23,9330000.0
9330,9330999,20.928286179063516,38.02428198339285,0.07540477542765167,3539.3904004096985,733.9266142845154,2679.5645866394043,37875,9382,28493,28493,0,23,9331000.0
9331,9331999,20.927623991386213,38.02308924772479,0.07540037640656383,3539.99969291687,733.9954981803894,2679.227870941162,37881,9385,28496,28496,0,23,9332000.0
9332,9332999,20.927035706196712,38.022098621504426,0.07539892184154129,3540.6186435222626,734.0644674301147,2679.2251930236816,37891,9389,28502,28502,0,23,9333000.0
9333,9333999,20.926415468339467,38.02097195306865,0.07539746218298815,3540.937557697296,734.1322536468506,2679.558864593506,37891,9389,28502,28502,0,23,9334000.0
9334,9334999,20.926005639164728,38.02013573244957,0.07539139265598438,3541.238891839981,734.1989877223969,2679.8941383361816,37891,9389,28502,28502,0,23,9335000.0
9335,9335999,20.925803946861194,38.0196464583412,0.07538338948657519,3541.667726755142,734.2683362960815,2679.729335784912,37891,9389,28502,28502,0,23,9336000.0
9336,9336999,20.92577671357567,38.01983148653901,0.07537334672650597,3542.0427157878876,734.3353629112244,2679.7395515441895,37891,9389,28502,28502,0,23,9337000.0
9337,9337999,20.92575513801417,38.020282349173755,0.07536340720653101,3542.34282207489,734.4041812419891,2680.314479827881,37894,9390,28504,28504,0,23,9338000.0
9338,9338999,20.926181090685716,38.02154809305639,0.0753475122192766,3542.61691904068,734.4719071388245,2680.7048301696777,37894,9390,28504,28504,0,23,9339000.0
9339,9339999,20.926087389485282,38.02177924274518,0.0753374845261362,3543.1929025650024,734.5405130386353,2680.622043609619,37910,9392,28518,28518,0,23,9340000.0
9340,9340999,20.925164319193822,38.02054507137929,0.0753428523952997,3543.722892522812,734.6033804416656,2680.5985069274902,37917,9394,28523,28523,0,23,9341000.0
9341,9341999,20.924544537125765,38.02018664601919,0.07534347748947534,3543.9125032424927,734.6669647693634,2681.7330436706543,37918,9394,28524,28524,0,23,9342000.0
9342,9342999,20.92387505073955,38.01879776152811,0.07534412878535901,3544.152104139328,734.7294766902924,2682.5533561706543,37919,9394,28525,28525,0,23,9343000.0
9343,9343999,20.92352780888826,38.02003915563735,0.07533115060484341,3544.556303501129,734.7947764396667,2682.9764137268066,37927,9396,28531,28531,0,23,9344000.0
9344,9344999,20.923172171696212,38.01976607291978,0.0753261840931968,3545.0602202415466,734.8582496643066,2682.816074371338,37929,9397,28532,28532,0,23,9345000.0
9345,9345999,20.92280979811075,38.01914338589853,0.07531921998188296,3545.439512729645,734.921936750412,2682.9974327087402,37929,9397,28532,28532,0,23,9346000.0
9346,9346999,20.9224435591993,38.01805936769696,0.07531318538437748,3545.8489537239075,734.9871468544006,2683.1875343322754,37931,9398,28533,28533,0,23,9347000.0
9347,9347999,20.92195029945989,38.01695440183195,0.07530879075708052,3546.340640306473,735.0524611473083,2683.337673187256,37935,9400,28535,28535,0,23,9348000.0
9348,9348999,20.921405741616116,38.01566344141499,0.07530748596698,3546.7618095874786,735.1170861721039,2683.6934928894043,37940,9402,28538,28538,0,23,9349000.0
9349,9349999,20.921104949910887,38.01518573946374,0.07530053798180525,3547.071508407593,735.1815083026886,2684.321086883545,37943,9403,28540,28540,0,23,9350000.0
9350,9350999,20.920729560679813,38.014429645668855,0.07529332151172696,3547.4719109535217,735.2469911575317,2684.5629844665527,37945,9404,28541,28541,0,23,9351000.0
9351,9351999,20.920357841231162,38.0135346637635,0.07528775537131671,3547.8882303237915,735.3129413127899,2684.6964378356934,37947,9405,28542,28542,0,23,9352000.0
9352,9352999,20.919903358825866,38.01236121692668,0.0752838053600916,3548.304694414139,735.3772521018982,2684.9175605773926,37959,9406,28553,28553,0,23,9353000.0
9353,9353999,20.919590113646745,38.011331301206155,0.0752796712091871,3548.6309807300568,735.4423549175262,2685.5456047058105,37961,9407,28554,28554,0,23,9354000.0
9354,9354999,20.919280781709077,38.01039854916734,0.0752740729686967,3549.048320055008,735.5058360099792,2685.5674934387207,37964,9408,28556,28556,0,23,9355000.0
9355,9355999,20.9189262008653,38.00934561387732,0.07526838315278817,3549.39061999321,735.5700256824493,2685.7080039978027,37964,9408,28556,28556,0,23,9356000.0
9356,9356999,20.918665794257407,38.00847568236759,0.07526369737661809,3549.8538360595703,735.6371295452118,2685.809383392334,37970,9410,28560,28560,0,23,9357000.0
9357,9357999,20.918283564830855,38.007387992391145,0.0752616492698418,3550.2381699085236,735.7030098438263,2685.8804512023926,37970,9410,28560,28560,0,23,9358000.0
9358,9358999,20.917869795995262,38.006268626929995,0.07525882349164581,3550.74245595932,735.7696151733398,2685.837474822998,37985,9412,28573,28573,0,23,9359000.0
9359,9359999,20.917460095703003,38.00563663487951,0.07525323652704119,3551.3261852264404,735.8370726108551,2685.437587738037,37990,9414,28576,28576,0,23,9360000.0
9360,9360999,20.916928692287602,38.00536660563492,0.07525448369097543,3551.6358296871185,735.902836561203,2686.4122428894043,37995,9415,28580,28580,0,23,9361000.0
9361,9361999,20.915926089592322,38.003757059157856,0.07526502692235737,3552.196968793869,735.9702208042145,2686.2466163635254,38001,9417,28584,28584,0,23,9362000.0
9362,9362999,20.915115235907944,38.003018127097,0.07526973830249872,3552.6241447925568,736.0395720005035,2686.479190826416,38003,9418,28585,28585,0,23,9363000.0
9363,9363999,20.9144219473197,38.0024110045756,0.07527052874475526,3552.9881134033203,736.1071548461914,2686.886074066162,38004,9418,28586,28586,0,23,9364000.0
9364,9364999,20.913815089948557,38.00138179171999,0.07527079376474044,3553.3006122112274,736.1739058494568,2687.3457374572754,38004,9418,28586,28586,0,23,9365000.0
9365,9365999,20.913225219572894,38.00038411531574,0.07527331516855151,3553.608636379242,736.2410724163055,2687.7703742980957,38004,9418,28586,28586,0,23,9366000.0
9366,9366999,20.91265954174409,37.999991212883245,0.0752702558918188,3554.213635444641,736.3116688728333,2687.5511436462402,38010,9421,28589,28589,0,23,9367000.0
9367,9367999,20.91212269840698,37.9989771516083,0.07527117991978216,3554.7334747314453,736.3835694789886,2687.6649436950684,38014,9423,28591,28591,0,23,9368000.0
9368,9368999,20.91169004647892,37.998526962740605,0.07526927441544295,3555.039659500122,736.4539811611176,2688.2244911193848,38014,9423,28591,28591,0,23,9369000.0
9369,9369999,20.91128069769623,37.99777710672853,0.07527076409213407,3555.6987557411194,736.5246579647064,2687.768772125244,38029,9425,28604,28604,0,23,9370000.0
9370,9370999,20.91083323166627,37.996650094161375,0.07527290652397478,3556.0144743919373,736.5946569442749,2688.232883453369,38029,9425,28604,28604,0,23,9371000.0
9371,9371999,20.910405988926218,37.99573138074429,0.07527590808085349,3556.372909784317,736.6656858921051,2688.700008392334,38031,9426,28605,28605,0,23,9372000.0
9372,9372999,20.909980643918093,37.99474923691087,0.0752819722027297,3556.718357563019,736.7373323440552,2688.9199180603027,38031,9426,28605,28605,0,23,9373000.0
9373,9373999,20.9094660038813,37.99351877619883,0.07528912785388076,3557.1827828884125,736.8076665401459,2688.8825187683105,38034,9427,28607,28607,0,23,9374000.0
9374,9374999,20.909127600452162,37.99255212425567,0.07529426010639417,3557.671154499054,736.8799636363983,2689.1112174987793,38049,9428,28621,28621,0,23,9375000.0
9375,9375999,20.908636294259953,37.99145244132849,0.0753019494925884,3558.0936868190765,736.9623568058014,2689.5711555480957,38052,9429,28623,28623,0,23,9376000.0
9376,9376999,20.90798930020632,37.99007929104751,0.07530819607397521,3558.4512038230896,737.0334267616272,2690.0971870422363,38055,9430,28625,28625,0,23,9377000.0
9377,9377999,20.90724449794983,37.98926198150512,0.0753178928412701,3558.7399871349335,737.0983231067657,2691.2679405212402,38065,9430,28635,28635,0,23,9378000.0
9378,9378999,20.90637834371218,37.9881806157252,0.07532323724742251,3559.0326986312866,737.161461353302,2692.277614593506,38067,9431,28636,28636,0,23,9379000.0
9379,9379999,20.90553953303595,37.9867772064335,0.07533053248157817,3559.1903128623962,737.2268779277802,2693.4479637145996,38067,9431,28636,28636,0,23,9380000.0
9380,9380999,20.90469776108317,37.98549715405587,0.07533423204017475,3559.418604850769,737.2902040481567,2694.149745941162,38068,9431,28637,28637,0,23,9381000.0
9381,9381999,20.903985304817915,37.98425355676895,0.07533677888670709,3559.7722651958466,737.3533887863159,2694.3119163513184,38068,9431,28637,28637,0,23,9382000.0
9382,9382999,20.90329919746648,37.98352635296722,0.07533580694639885,3560.306649208069,737.4231412410736,2694.156421661377,38072,9433,28639,28639,0,23,9383000.0
9383,9383999,20.902726527893307,37.982689750780146,0.07533419797447871,3560.8479330539703,737.4871683120728,2694.1275062561035,38079,9436,28643,28643,0,23,9384000.0
9384,9384999,20.90213723171141,37.982224094199495,0.07533016038308371,3561.1407141685486,737.5530762672424,2694.5726280212402,38079,9436,28643,28643,0,23,9385000.0
9385,9385999,20.901569792961503,37.98121276398368,0.07532991591346894,3561.4839005470276,737.6179196834564,2695.09428024292,38081,9437,28644,28644,0,23,9386000.0
9386,9386999,20.901102282970296,37.980465850230686,0.07532749927560856,3561.9266290664673,737.6828408241272,2695.39554977417,38095,9439,28656,28656,0,23,9387000.0
9387,9387999,20.90104004958288,37.98047333503187,0.07532062111347848,3562.353875875473,737.7503578662872,2695.420871734619,38095,9439,28656,28656,0,23,9388000.0
9388,9388999,20.900877426311112,37.98023310196105,0.07531615542248515,3562.708298921585,737.8166859149933,2695.7397117614746,38099,9440,28659,28659,0,23,9389000.0
9389,9389999,20.900939571644948,37.98043777130009,0.07531028849646548,3563.2036216259003,737.8817307949066,2695.7952995300293,38104,9442,28662,28662,0,23,9390000.0
9390,9390999,20.900898690786402,37.98053597274788,0.07530729945070169,3563.770350456238,737.9487283229828,2695.4919624328613,38109,9444,28665,28665,0,23,9391000.0
9391,9391999,20.901167641047323,37.98112727207049,0.07530237558880315,3564.1700489521027,738.0154638290405,2695.7502403259277,38125,9445,28680,28680,0,23,9392000.0
9392,9392999,20.901493856005395,37.98164058090598,0.07529765291847168,3564.723526954651,738.0838718414307,2695.4364051818848,38128,9446,28682,28682,0,23,9393000.0
9393,9393999,20.901711075396406,37.98191148091143,0.07528993448659471,3565.0964663028717,738.1507258415222,2695.6988945007324,38128,9446,28682,28682,0,23,9394000.0
9394,9394999,20.901850479405894,37.982424923494925,0.07528339467315048,3565.365139245987,738.2157552242279,2696.5774116516113,38130,9447,28683,28683,0,23,9395000.0
9395,9395999,20.90199934295267,37.98242959169758,0.07527477896867962,3565.8418593406677,738.2835812568665,2696.5442237854004,38133,9448,28685,28685,0,23,9396000.0
9396,9396999,20.901675582557733,37.981845981798436,0.07527347894965164,3566.2048029899597,738.3486473560333,2697.3542137145996,38145,9449,28696,28696,0,23,9397000.0
9397,9397999,20.900692328218664,37.980695590374566,0.07527936458033302,3566.532459974289,738.4131877422333,2698.241367340088,38150,9450,28700,28700,0,23,9398000.0
9398,9398999,20.899739170732843,37.97961970182795,0.07528397038995238,3566.8715143203735,738.4780812263489,2698.835391998291,38154,9451,28703,28703,0,23,9399000.0
9399,9399999,20.89892045816115,37.97828492942868,0.07528766892903915,3567.157863855362,738.5422787666321,2699.878406524658,38170,9452,28718,28718,0,23,9400000.0
9400,9400999,20.898313169418557,37.97748988788694,0.07528467901563107,3567.405182361603,738.6069214344025,2701.093288421631,38173,9453,28720,28720,0,23,9401000.0
9401,9401999,20.897683446540366,37.97691670728828,0.07527968633635829,3567.9917089939117,738.6735310554504,2700.79838180542,38178,9455,28723,28723,0,23,9402000.0
9402,9402999,20.896995977813464,37.975613382171616,0.0752795957679846,3568.49519944191,738.740395784378,2700.921733856201,38183,9457,28726,28726,0,23,9403000.0
9403,9403999,20.89632699296637,37.97437914868397,0.07528059221671402,3568.800308704376,738.8057556152344,2701.6401329040527,38185,9458,28727,28727,0,23,9404000.0
9404,9404999,20.89558359561008,37.973104584489384,0.07528195286654649,3569.3768656253815,738.8720519542694,2701.3430519104004,38190,9460,28730,28730,0,23,9405000.0
9405,9405999,20.89493397717213,37.97186260287773,0.07528322147757727,3569.685683488846,738.9381113052368,2702.1659660339355,38192,9461,28731,28731,0,23,9406000.0
9406,9406999,20.894318889258322,37.97067308854493,0.07528386037366797,3570.070623397827,739.0041825771332,2702.3661460876465,38194,9462,28732,28732,0,23,9407000.0
9407,9407999,20.89372524778878,37.969574543344905,0.07528750836441822,3570.5266773700714,739.07111287117,2702.3651084899902,38196,9463,28733,28733,0,23,9408000.0
9408,9408999,20.89313485147167,37.96842575924629,0.07528692882043064,3570.801972389221,739.1376974582672,2702.9253120422363,38196,9463,28733,28733,0,23,9409000.0
9409,9409999,20.89257914246367,37.96751137435238,0.07528812938951224,3571.2378284931183,739.2039053440094,2702.9781532287598,38198,9464,28734,28734,0,23,9410000.0
9410,9410999,20.8921741596215,37.966624938198,0.07528911159182061,3571.6511306762695,739.2717764377594,2703.315906524658,38212,9466,28746,28746,0,23,9411000.0
9411,9411999,20.891783158939923,37.965663159816,0.07529072551928861,3572.0598015785217,739.3376767635345,2703.150852203369,38212,9466,28746,28746,0,23,9412000.0
9412,9412999,20.891366236392937,37.96474680831873,0.07529221625821947,3572.45365524292,739.4040062427521,2703.299533843994,38215,9467,28748,28748,0,23,9413000.0
9413,9413999,20.890972287457725,37.9639345416127,0.07529310399762845,3572.9323918819427,739.4712681770325,2703.1216773986816,38218,9468,28750,28750,0,23,9414000.0
9414,9414999,20.89055031265659,37.96389751679397,0.07529179596853686,3573.4018042087555,739.5387177467346,2703.095630645752,38220,9469,28751,28751,0,23,9415000.0
9415,9415999,20.889866268361732,37.962602227802364,0.07529350836033555,3573.64076423645,739.6073677539825,2703.8347663879395,38220,9469,28751,28751,0,23,9416000.0
9416,9416999,20.889184505779923,37.961316336030535,0.07529576681503003,3574.2461063861847,739.6748657226562,2703.6377143859863,38227,9472,28755,28755,0,23,9417000.0
9417,9417999,20.888594387744952,37.96000596832253,0.07529268995455063,3574.585470676422,739.737752199173,2704.8708000183105,38244,9473,28771,28771,0,23,9418000.0
9418,9418999,20.887790059513122,37.95876125423815,0.07529258859420307,3574.7747282981873,739.8012325763702,2705.917339324951,38244,9473,28771,28771,0,23,9419000.0
9419,9419999,20.8869154493884,37.95720497227843,0.07529694465041603,3575.3148255348206,739.8651270866394,2706.159381866455,38251,9476,28775,28775,0,23,9420000.0
9420,9420999,20.88606633794425,37.9557642235127,0.07529989797972447,3575.6998262405396,739.9291586875916,2706.9709815979004,38286,9478,28808,28808,0,23,9421000.0
9421,9421999,20.885372585816597,37.95455662104023,0.07529842548200505,3576.1084172725677,739.9923877716064,2707.3074378967285,38291,9480,28811,28811,0,23,9422000.0
9422,9422999,20.884592473588132,37.95317351758067,0.07530028115136389,3576.523250579834,740.0557115077972,2707.7038078308105,38295,9482,28813,28813,0,23,9423000.0
9423,9423999,20.88384120104992,37.951789215470505,0.0753045634784989,3576.883280277252,740.1211988925934,2708.28568649292,38297,9483,28814,28814,0,23,9424000.0
9424,9424999,20.88300740744633,37.950361505289216,0.0753075666354841,3577.4913868904114,740.1843566894531,2708.076343536377,38304,9486,28818,28818,0,23,9425000.0
9425,9425999,20.882269142451726,37.94904067652328,0.07531041895696744,3577.9151685237885,740.2504336833954,2708.383472442627,38306,9487,28819,28819,0,23,9426000.0
9426,9426999,20.88164212796275,37.94804465325605,0.07531096839071771,3578.2144327163696,740.3162157535553,2709.1903038024902,38308,9488,28820,28820,0,23,9427000.0
9427,9427999,20.8808325494854,37.946577964667554,0.07531554851423561,3578.5458455085754,740.3809185028076,2709.4162788391113,38308,9488,28820,28820,0,23,9428000.0
9428,9428999,20.880223520037713,37.945390159282006,0.07531409742653739,3578.9975967407227,740.4462158679962,2709.5317039489746,38312,9490,28822,28822,0,23,9429000.0
9429,9429999,20.879604629120767,37.944296763582976,0.07531365584493599,3579.448940515518,740.5097713470459,2709.7740211486816,38327,9492,28835,28835,0,23,9430000.0
9430,9430999,20.878957962703748,37.94303395912941,0.07531588422121172,3579.9952380657196,740.5764529705048,2709.4669914245605,38332,9494,28838,28838,0,23,9431000.0
9431,9431999,20.87838197867141,37.94211800266893,0.07531774495397436,3580.4491469860077,740.640531539917,2709.497585296631,38335,9495,28840,28840,0,23,9432000.0
9432,9432999,20.87777283777776,37.940874691947,0.0753200518493995,3580.8964920043945,740.7049033641815,2709.4512062072754,38338,9496,28842,28842,0,23,9433000.0
9433,9433999,20.877139971668765,37.939544524006706,0.07532414984156777,3581.232239484787,740.7691607475281,2709.6912879943848,38338,9496,28842,28842,0,23,9434000.0
9434,9434999,20.87651826070011,37.93822447449775,0.07532720002612436,3581.7316608428955,740.8343646526337,2709.533893585205,38340,9497,28843,28843,0,23,9435000.0
9435,9435999,20.87583925403964,37.93684699700184,0.0753315913852648,3582.014317750931,740.8991525173187,2709.999095916748,38340,9497,28843,28843,0,23,9436000.0
9436,9436999,20.875028835263596,37.93534322033516,0.07533910597001547,3582.50203704834,740.9634621143341,2709.8800010681152,38343,9498,28845,28845,0,23,9437000.0
9437,9437999,20.874333410477867,37.9341483620736,0.07534043775108146,3582.849721431732,741.0303068161011,2710.931095123291,38357,9499,28858,28858,0,23,9438000.0
9438,9438999,20.873703723096895,37.93351710744538,0.07533891207606835,3583.1211450099945,741.0992045402527,2712.0656700134277,38360,9500,28860,28860,0,23,9439000.0
9439,9439999,20.873120229524396,37.9325247095672,0.07534202692110492,3583.4441685676575,741.1679508686066,2712.831287384033,38363,9501,28862,28862,0,23,9440000.0
9440,9440999,20.87247928347773,37.93127888603916,0.07534298277862661,3583.688105583191,741.2312116622925,2713.522289276123,38364,9501,28863,28863,0,23,9441000.0
9441,9441999,20.871779189825862,37.93007842831961,0.07534341731809313,3584.501787185669,741.2967512607574,2712.927501678467,38379,9507,28872,28872,0,23,9442000.0
9442,9442999,20.87117062266705,37.929090133884216,0.07534131053650406,3585.199976682663,741.3631129264832,2712.526599884033,38388,9511,28877,28877,0,23,9443000.0
9443,9443999,20.870647767288965,37.92821003675287,0.07533820613066988,3585.4671771526337,741.4297561645508,2713.2854804992676,38388,9511,28877,28877,0,23,9444000.0
9444,9444999,20.870051684118472,37.92755934018844,0.07533695772839044,3585.738432407379,741.4951901435852,2713.8999519348145,38388,9511,28877,28877,0,23,9445000.0
9445,9445999,20.869502635540208,37.9265579247827,0.07533516358974524,3586.1459929943085,741.5620036125183,2714.3607902526855,38402,9513,28889,28889,0,23,9446000.0
9446,9446999,20.868890948021697,37.92549147176522,0.07533394427569218,3586.6003127098083,741.6292009353638,2714.553997039795,38406,9515,28891,28891,0,23,9447000.0
9447,9447999,20.868508007344523,37.924627262532965,0.07532752719513403,3586.9988107681274,741.6958560943604,2714.4180641174316,38406,9515,28891,28891,0,23,9448000.0
9448,9448999,20.868013949763075,37.92403034843865,0.07532295040005921,3587.277123451233,741.7614583969116,2714.9181327819824,38406,9515,28891,28891,0,23,9449000.0
9449,9449999,20.86748232327349,37.922931246570954,0.07532062984524801,3587.6617884635925,741.8263511657715,2715.079013824463,38408,9516,28892,28892,0,23,9450000.0
9450,9450999,20.86699245432288,37.921797846011046,0.07531661242960241,3588.3683540821075,741.8946170806885,2714.6711616516113,38426,9520,28906,28906,0,23,9451000.0
9451,9451999,20.866589569630648,37.9209857255085,0.07531059108089766,3588.826160669327,741.9624509811401,2714.602756500244,38429,9521,28908,28908,0,23,9452000.0
9452,9452999,20.86641938323738,37.92031511332161,0.07530330864004908,3589.372217655182,742.0293233394623,2714.545383453369,38458,9523,28935,28935,0,23,9453000.0
9453,9453999,20.86625267135256,37.919821540078715,0.0752948666461466,3589.6839892864227,742.0969290733337,2715.127468109131,38458,9523,28935,28935,0,23,9454000.0
9454,9454999,20.86612229473419,37.91918303686907,0.07528785766354662,3589.98255610466,742.1650176048279,2715.6131706237793,38458,9523,28935,28935,0,23,9455000.0
9455,9455999,20.86601717387622,37.9193844081144,0.07527913639955075,3590.3552372455597,742.2302670478821,2715.637622833252,38458,9523,28935,28935,0,23,9456000.0
9456,9456999,20.866045692828827,37.91984093290073,0.07527503657931534,3590.5601511001587,742.2946617603302,2716.4762992858887,38458,9523,28935,28935,0,23,9457000.0
9457,9457999,20.865727440841134,37.91950900110053,0.07527642948281121,3590.7920439243317,742.3604626655579,2717.6080284118652,38462,9523,28939,28939,0,23,9458000.0
9458,9458999,20.864988492767583,37.9188637002938,0.0752777450480937,3591.1158318519592,742.4280304908752,2718.41206741333,38466,9524,28942,28942,0,23,9459000.0
9459,9459999,20.86416655154479,37.91755924534947,0.07528133046013608,3591.466126203537,742.4942517280579,2718.9422721862793,38469,9525,28944,28944,0,23,9460000.0
9460,9460999,20.863401705677443,37.91636970239412,0.07528375282856825,3591.7939598560333,742.562912940979,2719.357509613037,38469,9525,28944,28944,0,23,9461000.0
9461,9461999,20.86263549842482,37.9151044034153,0.07528405711466934,3592.151311159134,742.6298730373383,2719.8153495788574,38484,9526,28958,28958,0,23,9462000.0
9462,9462999,20.861964411346207,37.916367604619694,0.07527631671586166,3592.5898909568787,742.6994881629944,2720.5029640197754,38491,9528,28963,28963,0,23,9463000.0
9463,9463999,20.861163460928868,37.91500966347452,0.07527483882745933,3592.8495733737946,742.7672786712646,2721.5854988098145,38493,9529,28964,28964,0,23,9464000.0
9464,9464999,20.860397852931207,37.913670191798275,0.07527186383270146,3593.1581451892853,742.8373799324036,2722.1407737731934,38495,9530,28965,28965,0,23,9465000.0
9465,9465999,20.85978736875436,37.91315415745704,0.07526588917163612,3593.5813813209534,742.9058408737183,2722.227138519287,38497,9531,28966,28966,0,23,9466000.0
9466,9466999,20.85924399013242,37.91219660515929,0.07526101330470414,3593.8521728515625,742.9746286869049,2722.703510284424,38497,9531,28966,28966,0,23,9467000.0
9467,9467999,20.858627930794995,37.91098332270294,0.07526001644265146,3594.3506422042847,743.0437483787537,2722.4502754211426,38509,9532,28977,28977,0,23,9468000.0
9468,9468999,20.858178679846375,37.91030812678891,0.07525335718182313,3594.9606437683105,743.1143605709076,2722.1833839416504,38515,9535,28980,28980,0,23,9469000.0
9469,9469999,20.857570655765578,37.90908247692515,0.07525014392733043,3595.2854850292206,743.1862995624542,2722.594150543213,38515,9535,28980,28980,0,23,9470000.0
9470,9470999,20.85707188282781,37.90815895657784,0.07524696821366328,3595.5575194358826,743.257404088974,2723.121913909912,38515,9535,28980,28980,0,23,9471000.0
9471,9471999,20.856696205012206,37.90735343149945,0.07524001286485371,3595.757150888443,743.3266198635101,2723.8526344299316,38515,9535,28980,28980,0,23,9472000.0
9472,9472999,20.85623673229569,37.90656917956067,0.07523663508820533,3596.236813545227,743.3973622322083,2723.306163787842,38515,9535,28980,28980,0,23,9473000.0
9473,9473999,20.856075458126437,37.90607101051163,0.07522953834827051,3596.6852769851685,743.4660971164703,2723.032917022705,38515,9535,28980,28980,0,23,9474000.0
9474,9474999,20.855913927668876,37.905298696296796,0.0752232090611561,3597.0602984428406,743.5377879142761,2723.5037803649902,38520,9537,28983,28983,0,23,9475000.0
9475,9475999,20.855653423391736,37.90452964756004,0.07522108898550894,3597.4220521450043,743.608011007309,2723.669178009033,38520,9537,28983,28983,0,23,9476000.0
9476,9476999,20.855374647203888,37.90371327878719,0.07521410035500309,3597.6921861171722,743.6788306236267,2724.0903129577637,38520,9537,28983,28983,0,23,9477000.0
9477,9477999,20.854945217037343,37.90265598470026,0.07521236109954621,3598.086417913437,743.7478551864624,2724.2374000549316,38524,9538,28986,28986,0,23,9478000.0
9478,9478999,20.854059949033786,37.90116129373681,0.07521589324576039,3598.538320541382,743.8121254444122,2724.5735664367676,38535,9540,28995,28995,0,23,9479000.0
9479,9479999,20.85307075790141,37.89957687346412,0.07522099588665798,3598.770733356476,743.8742678165436,2725.468364715576,38539,9540,28999,28999,0,23,9480000.0
9480,9480999,20.852281208457676,37.89850208824362,0.07521969912045023,3599.260597229004,743.9355614185333,2725.69388961792,38544,9542,29002,29002,0,23,9481000.0
9481,9481999,20.851641293412605,37.897203200397215,0.07521669536123188,3599.5550842285156,743.9996058940887,2726.618221282959,38547,9543,29004,29004,0,23,9482000.0
9482,9482999,20.851187159780753,37.89645938399505,0.07520896899294183,3599.823010444641,744.0638554096222,2727.4421577453613,38549,9544,29005,29005,0,23,9483000.0
9483,9483999,20.850885291084115,37.89559625949905,0.07519829888356588,3600.162457704544,744.1294069290161,2727.774929046631,38550,9544,29006,29006,0,23,9484000.0
9484,9484999,20.850686670166706,37.89489157600058,0.07519041495673529,3600.6803913116455,744.1929008960724,2727.7656898498535,38555,9546,29009,29009,0,23,9485000.0
9485,9485999,20.850303050936407,37.894118491198505,0.07518839501019303,3601.4244997501373,744.2580256462097,2727.0293159484863,38565,9550,29015,29015,0,23,9486000.0
9486,9486999,20.85024789937389,37.89372976076917,0.07517972390644678,3601.9205133914948,744.323005437851,2727.43892288208,38572,9553,29019,29019,0,23,9487000.0
9487,9487999,20.850225835046377,37.893324834057154,0.07517878202387329,3602.5309703350067,744.3876101970673,2727.174015045166,38576,9555,29021,29021,0,23,9488000.0
9488,9488999,20.85085097053924,37.89469594392473,0.07517655840580018,3602.737832546234,744.4518456459045,2728.1521186828613,38576,9555,29021,29021,0,23,9489000.0
9489,9489999,20.851561231409754,37.89672786730922,0.07517930281245255,3603.052079677582,744.5157911777496,2728.772602081299,38578,9556,29022,29022,0,23,9490000.0
9490,9490999,20.85217323845321,37.898011271604624,0.07517976201113885,3603.3411753177643,744.5793364048004,2729.526195526123,38585,9557,29028,29028,0,23,9491000.0
9491,9491999,20.85299280159441,37.900174852079836,0.07518482905449708,3603.836710691452,744.6451091766357,2729.623279571533,38590,9559,29031,29031,0,23,9492000.0
9492,9492999,20.854261303787037,37.90404127037807,0.07518782676889146,3604.1582589149475,744.7103273868561,2729.869396209717,38590,9559,29031,29031,0,23,9493000.0
9493,9493999,20.85592029546989,37.91037600782255,0.07520254425983464,3604.6449398994446,744.7770519256592,2729.6812171936035,38593,9560,29033,29033,0,23,9494000.0
9494,9494999,20.857467690779885,37.91467018642365,0.0752246005568934,3605.1729593276978,744.8455727100372,2729.6765785217285,38598,9562,29036,29036,0,23,9495000.0
9495,9495999,20.859170306734022,37.91803697029069,0.07523438040268604,3605.505601167679,744.9106063842773,2729.960247039795,38598,9562,29036,29036,0,23,9496000.0
9496,9496999,20.860681930831735,37.92121129960886,0.07525551299819144,3605.9616248607635,744.9780340194702,2730.1734504699707,38608,9564,29044,29044,0,23,9497000.0
9497,9497999,20.861669857824047,37.92323028049923,0.07524896702002726,3606.843998670578,745.042426109314,2729.3491249084473,38622,9569,29053,29053,0,23,9498000.0
9498,9498999,20.861177187046533,37.92259855760392,0.07524858640164844,3607.192902326584,745.1103780269623,2730.2199211120605,38626,9570,29056,29056,0,23,9499000.0
9499,9499999,20.860643325662917,37.92245818219406,0.07525060587248089,3607.4877500534058,745.1786088943481,2730.889751434326,38629,9570,29059,29059,0,23,9500000.0
9500,9500999,20.86009017799446,37.92182248122191,0.07525437215459008,3607.7436757087708,745.2453043460846,2731.67378616333,38629,9570,29059,29059,0,23,9501000.0
9501,9501999,20.859638150327893,37.921121300225764,0.07525768285236989,3608.0574748516083,745.3144943714142,2732.730152130127,38645,9571,29074,29074,0,23,9502000.0
9502,9502999,20.859040244352833,37.92018205557513,0.07526103570242682,3608.4531922340393,745.385929107666,2733.2177543640137,38648,9572,29076,29076,0,23,9503000.0
9503,9503999,20.858447348245605,37.91927467157669,0.07526255527853087,3608.638761997223,745.4549686908722,2734.28812789917,38648,9572,29076,29076,0,23,9504000.0
9504,9504999,20.85781195468359,37.91828989061245,0.07526661270878587,3609.1873664855957,745.5241222381592,2734.2125205993652,38662,9574,29088,29088,0,23,9505000.0
9505,9505999,20.857215196731225,37.917327472509385,0.0752702371774826,3609.43261885643,745.5925068855286,2734.8959922790527,38662,9574,29088,29088,0,23,9506000.0
9506,9506999,20.856794145539762,37.916618768416186,0.07527275521032106,3609.9444801807404,745.6620509624481,2734.6524391174316,38664,9575,29089,29089,0,23,9507000.0
9507,9507999,20.856642968303813,37.91650088685625,0.07527052161393888,3610.326598882675,745.7299454212189,2735.1712608337402,38676,9576,29100,29100,0,23,9508000.0
9508,9508999,20.85640812395178,37.9161769250593,0.07527198028456805,3610.8060462474823,745.8010342121124,2735.3884239196777,38690,9578,29112,29112,0,23,9509000.0
9509,9509999,20.85618464019494,37.91565453999842,0.07527415200912901,3611.1092641353607,745.8713099956512,2735.821491241455,38690,9578,29112,29112,0,23,9510000.0
9510,9510999,20.856168509917698,37.915719321332624,0.07527455642869996,3611.518673658371,745.9401724338531,2735.933765411377,38692,9579,29113,29113,0,23,9511000.0
9511,9511999,20.85612985270935,37.91530133612316,0.07528133973297024,3612.1508576869965,746.010810136795,2735.6798667907715,38698,9582,29116,29116,0,23,9512000.0
9512,9512999,20.855952100109118,37.91467558070914,0.07528429439286555,3612.7171790599823,746.0807163715363,2735.040699005127,38698,9582,29116,29116,0,23,9513000.0
9513,9513999,20.855992825083103,37.915025425084394,0.07528277954500273,3613.0476837158203,746.1513888835907,2735.456798553467,38698,9582,29116,29116,0,23,9514000.0
9514,9514999,20.855782559059435,37.914349456671175,0.07527684549600899,3613.2367928028107,746.2204995155334,2736.8921546936035,38702,9582,29120,29120,0,23,9515000.0
9515,9515999,20.855795198809446,37.91433786452236,0.07525525430910096,3614.0751361846924,746.2858333587646,2736.2259941101074,38713,9587,29126,29126,0,23,9516000.0
9516,9516999,20.855954713194347,37.91430751936202,0.0752174523636826,3614.29669380188,746.3524239063263,2737.3328971862793,38713,9587,29126,29126,0,23,9517000.0
9517,9517999,20.8557097708724,37.913526514076366,0.07520813929428527,3614.6091306209564,746.4174253940582,2737.9884147644043,38715,9588,29127,29127,0,23,9518000.0
9518,9518999,20.855629942717975,37.91364840114191,0.07518616197615524,3614.902574300766,746.4821870326996,2738.449550628662,38715,9588,29127,29127,0,23,9519000.0
9519,9519999,20.855406201651142,37.91337191699122,0.07516802945011536,3615.2297241687775,746.5477488040924,2738.6999549865723,38715,9588,29127,29127,0,23,9520000.0
9520,9520999,20.855054814853567,37.91241793638481,0.07514825829367455,3615.786256790161,746.614639043808,2738.508502960205,38719,9590,29129,29129,0,23,9521000.0
9521,9521999,20.85484600015805,37.912393997837995,0.07513350376595462,3616.286155939102,746.6821248531342,2738.517063140869,38723,9592,29131,29131,0,23,9522000.0
9522,9522999,20.85458294643816,37.91195562164915,0.07511860576716023,3616.5302922725677,746.7489328384399,2739.247646331787,38723,9592,29131,29131,0,23,9523000.0
9523,9523999,20.85422038155357,37.911244672581994,0.07511081720759094,3617.006192922592,746.8152005672455,2739.054660797119,38735,9593,29142,29142,0,23,9524000.0
9524,9524999,20.853931013425566,37.91108610855715,0.07509667255131558,3617.2855491638184,746.8824162483215,2739.547992706299,38736,9593,29143,29143,0,23,9525000.0
9525,9525999,20.853700731599893,37.91055185901851,0.07508242430487988,3617.9614164829254,746.9503352642059,2738.987331390381,38753,9596,29157,29157,0,23,9526000.0
9526,9526999,20.85329005005627,37.90950445927867,0.07507219717240887,3618.332526922226,747.017632484436,2739.0794792175293,38753,9596,29157,29157,0,23,9527000.0
9527,9527999,20.853394984827567,37.912528691694035,0.07504833544485578,3618.6902389526367,747.0841958522797,2739.4217262268066,38755,9597,29158,29158,0,23,9528000.0
9528,9528999,20.853236500741477,37.91190251528342,0.07504444565844981,3619.315197467804,747.153529882431,2739.1549949645996,38762,9600,29162,29162,0,23,9529000.0
9529,9529999,20.85304288927496,37.9113506451011,0.07503392764161887,3619.510748386383,747.2188782691956,2740.016773223877,38762,9600,29162,29162,0,23,9530000.0
9530,9530999,20.852870618127326,37.91071949137936,0.0750212834936469,3619.8276660442352,747.2847621440887,2740.306926727295,38762,9600,29162,29162,0,23,9531000.0
9531,9531999,20.852706464394796,37.91025638177796,0.07501119477062745,3620.299354314804,747.3508775234222,2740.188404083252,38764,9601,29163,29163,0,23,9532000.0
9532,9532999,20.852347435332636,37.90924580923069,0.07500486318015354,3620.6594245433807,747.4176936149597,2740.455310821533,38765,9602,29163,29163,0,23,9533000.0
9533,9533999,20.851971417489317,37.908607717336814,0.0750029668083686,3621.0371482372284,747.4837226867676,2740.511661529541,38765,9602,29163,29163,0,23,9534000.0
9534,9534999,20.85134613831805,37.9076396656797,0.0749971355520056,3621.277830839157,747.5520989894867,2741.933322906494,38774,9602,29172,29172,0,23,9535000.0
9535,9535999,20.850632598792043,37.90641793179969,0.07499308991053244,3621.5882902145386,747.6194131374359,2742.6891288757324,38777,9603,29174,29174,0,23,9536000.0
9536,9536999,20.850122911753427,37.90538314195371,0.07498772814897237,3622.0925364494324,747.6890788078308,2743.1268882751465,38784,9606,29178,29178,0,23,9537000.0
9537,9537999,20.849603193206008,37.904396165031606,0.07498446431305117,3622.409430742264,747.757630109787,2743.8275032043457,38786,9607,29179,29179,0,23,9538000.0
9538,9538999,20.849178132346392,37.90381383490618,0.07497699007269443,3622.6559932231903,747.8252618312836,2744.5010108947754,38786,9607,29179,29179,0,23,9539000.0
9539,9539999,20.848999911790308,37.90397418863319,0.07497009259818554,3623.1545350551605,747.895439863205,2744.2410621643066,38788,9608,29180,29180,0,23,9540000.0
9540,9540999,20.848855886428,37.904326493422836,0.07495971819107561,3623.5407626628876,747.9647605419159,2744.624767303467,38790,9609,29181,29181,0,23,9541000.0
9541,9541999,20.84879027446682,37.90433367774162,0.07495709160607078,3624.0784256458282,748.0353152751923,2744.5328407287598,38804,9611,29193,29193,0,23,9542000.0
9542,9542999,20.848841388759602,37.90465545069853,0.07494801581416266,3624.534746170044,748.1041302680969,2744.831455230713,38809,9613,29196,29196,0,23,9543000.0
9543,9543999,20.84929572781504,37.905949787078406,0.07494196540832465,3625.0579884052277,748.1750378608704,2744.777202606201,38813,9615,29198,29198,0,23,9544000.0
9544,9544999,20.849840330153636,37.90714967501003,0.07493848143465909,3625.3982031345367,748.2452490329742,2745.041156768799,38813,9615,29198,29198,0,23,9545000.0
9545,9545999,20.85055900107266,37.90888234133935,0.07493655657336618,3625.8230533599854,748.315099477768,2745.3036613464355,38817,9617,29200,29200,0,23,9546000.0
9546,9546999,20.851531887167976,37.911251201555565,0.07493280384963508,3626.5445766448975,748.3898191452026,2744.7069358825684,38824,9620,29204,29204,0,23,9547000.0
9547,9547999,20.852571340762815,37.91346371064152,0.07493489606549708,3626.7051961421967,748.4579799175262,2745.857234954834,38824,9620,29204,29204,0,23,9548000.0
9548,9548999,20.853748077823855,37.91600956760264,0.07493530823354178,3627.335422039032,748.5276367664337,2745.216564178467,38829,9622,29207,29207,0,23,9549000.0
9549,9549999,20.85466718825344,37.9176707194438,0.07494864042821048,3627.663893699646,748.5972967147827,2745.48286819458,38829,9622,29207,29207,0,23,9550000.0
9550,9550999,20.855762577198973,37.920261721020495,0.07495540666631362,3628.125504732132,748.6668350696564,2745.39204788208,38831,9623,29208,29208,0,23,9551000.0
9551,9551999,20.85689787092594,37.9222747600877,0.07496526530883929,3628.3678390979767,748.7363398075104,2746.0584983825684,38831,9623,29208,29208,0,23,9552000.0
9552,9552999,20.857818596584476,37.9236585636141,0.07497037209025315,3628.8129518032074,748.8047485351562,2745.9604301452637,38833,9624,29209,29209,0,23,9553000.0
9553,9553999,20.858079555098097,37.92382437836634,0.07497348578886698,3629.398155450821,748.8818559646606,2745.8032569885254,38837,9626,29211,29211,0,23,9554000.0
9554,9554999,20.858015313469114,37.92324371073785,0.07494978095706473,3629.7080850601196,748.952255487442,2746.7790870666504,38843,9626,29217,29217,0,23,9555000.0
9555,9555999,20.857345012962814,37.921924575145255,0.07494638658602693,3630.225278377533,749.0158505439758,2747.0410194396973,38853,9629,29224,29224,0,23,9556000.0
9556,9556999,20.856912375290868,37.921895291668996,0.07493690869600766,3630.7260279655457,749.0835342407227,2747.362979888916,38858,9631,29227,29227,0,23,9557000.0
9557,9557999,20.856398529939234,37.92076228909306,0.0749321583433159,3631.0945451259613,749.1466495990753,2747.8599967956543,38861,9632,29229,29229,0,23,9558000.0
9558,9558999,20.855844983010837,37.91977973886892,0.07492815397849628,3631.801085472107,749.2119195461273,2747.114414215088,38866,9634,29232,29232,0,23,9559000.0
9559,9559999,20.85526474400177,37.91862535903707,0.07492611986110087,3632.3700733184814,749.2749891281128,2747.1668815612793,38873,9637,29236,29236,0,23,9560000.0
9560,9560999,20.854740283432818,37.917402752232015,0.07492055887173588,3632.678790807724,749.3418929576874,2747.7995262145996,38875,9638,29237,29237,0,23,9561000.0
9561,9561999,20.854095117849553,37.91613529842186,0.07491874882828975,3632.9884548187256,749.4069600105286,2748.3566398620605,38878,9639,29239,29239,0,23,9562000.0
9562,9562999,20.853554786848306,37.914900501683604,0.07491775779237186,3633.506432056427,749.472048997879,2748.117160797119,38883,9641,29242,29242,0,23,9563000.0
9563,9563999,20.85298456955517,37.91388001450602,0.07492083729851406,3633.8593854904175,749.5381460189819,2748.5676765441895,38885,9642,29243,29243,0,23,9564000.0
9564,9564999,20.85242374385094,37.91281002904929,0.07492041718242515,3634.6649508476257,749.6024363040924,2747.801654815674,38894,9646,29248,29248,0,23,9565000.0
9565,9565999,20.85188495632566,37.91179147489615,0.0749201697813423,3634.9782571792603,749.6684467792511,2748.540828704834,38906,9647,29259,29259,0,23,9566000.0
9566,9566999,20.851395333034162,37.910879810345854,0.07492084079876837,3635.324400663376,749.7334449291229,2748.7289390563965,38906,9647,29259,29259,0,23,9567000.0
9567,9567999,20.85087236178617,37.90993816685884,0.07492380108173091,3635.6958429813385,749.79927110672,2748.7928504943848,38906,9647,29259,29259,0,23,9568000.0
9568,9568999,20.85045688675411,37.90914488222308,0.07492663293633428,3636.0032284259796,749.8636982440948,2749.213779449463,38906,9647,29259,29259,0,23,9569000.0
9569,9569999,20.85004970299479,37.90832671562929,0.07492753660658713,3636.346180200577,749.9277307987213,2749.2801780700684,38906,9647,29259,29259,0,23,9570000.0
9570,9570999,20.849637708896537,37.90756630332714,0.07492894390305938,3636.768846988678,749.9953083992004,2749.1096382141113,38906,9647,29259,29259,0,23,9571000.0
9571,9571999,20.849275514045893,37.90686717032951,0.0749272828417733,3637.196841239929,750.0593066215515,2749.1773414611816,38909,9648,29261,29261,0,23,9572000.0
9572,9572999,20.848689310857235,37.90571426925118,0.07493036133638287,3637.4868245124817,750.1247947216034,2749.6113624572754,38909,9648,29261,29261,0,23,9573000.0
9573,9573999,20.84794460839277,37.904433012249015,0.07493547769981102,3638.0152242183685,750.1887264251709,2749.531970977783,38914,9650,29264,29264,0,23,9574000.0
9574,9574999,20.847288949339404,37.903446333510864,0.07493839629892096,3638.4071831703186,750.2521634101868,2750.2530403137207,38928,9651,29277,29277,0,23,9575000.0
9575,9575999,20.846735444349175,37.90419140713903,0.07493787562211585,3638.846235513687,750.3190021514893,2750.6313514709473,38932,9653,29279,29279,0,23,9576000.0
9576,9576999,20.84602085883882,37.90298578090062,0.07494867449852305,3639.1826190948486,750.3860881328583,2751.3132286071777,38935,9654,29281,29281,0,23,9577000.0
9577,9577999,20.845348701577272,37.902023195379826,0.07495036306305336,3639.3789224624634,750.4509830474854,2752.338222503662,38935,9654,29281,29281,0,23,9578000.0
9578,9578999,20.844699638803046,37.90091766595937,0.07495060263727693,3639.7338528633118,750.5161280632019,2752.6272010803223,38937,9655,29282,29282,0,23,9579000.0
9579,9579999,20.844009747936035,37.89982238996883,0.07495200587681039,3640.1885306835175,750.5820505619049,2752.8658027648926,38942,9657,29285,29285,0,23,9580000.0
9580,9580999,20.84315084058664,37.89836441173304,0.07495727681022324,3640.6391916275024,750.6498970985413,2753.1581230163574,38946,9659,29287,29287,0,23,9581000.0
9581,9581999,20.84234858160229,37.89707840486046,0.07496360518094813,3641.0251643657684,750.7152752876282,2753.384548187256,38949,9660,29289,29289,0,23,9582000.0
9582,9582999,20.841554114816173,37.895688346127166,0.07496621382407975,3641.466439962387,750.7819528579712,2753.2718391418457,38960,9661,29299,29299,0,23,9583000.0
9583,9583999,20.8407490843244,37.89429686480843,0.0749696049127454,3642.035809278488,750.8484678268433,2752.9784202575684,38965,9663,29302,29302,0,23,9584000.0
9584,9584999,20.839972353992387,37.89292182594254,0.07497148916653007,3642.5778913497925,750.9149284362793,2752.80326461792,38970,9665,29305,29305,0,23,9585000.0
9585,9585999,20.8392109646246,37.891595628048684,0.07497009828667478,3643.0865120887756,750.9822239875793,2752.6307106018066,38975,9667,29308,29308,0,23,9586000.0
9586,9586999,20.838406333596165,37.89028990361103,0.07497024153994158,3643.6024832725525,751.0510039329529,2752.4833335876465,38978,9668,29310,29310,0,23,9587000.0
9587,9587999,20.837943486523265,37.89034287567006,0.07496300946585255,3643.840996026993,751.1157784461975,2753.214626312256,38978,9668,29310,29310,0,23,9588000.0
9588,9588999,20.837283057470636,37.88907073921896,0.07495928063635304,3644.1880571842194,751.1805543899536,2753.47310256958,38980,9669,29311,29311,0,23,9589000.0
9589,9589999,20.836498372832562,37.88775585583713,0.07496059600019989,3644.501459121704,751.2454776763916,2753.705539703369,38980,9669,29311,29311,0,23,9590000.0
9590,9590999,20.83582966399385,37.88650653927126,0.0749605291192873,3644.9522852897644,751.3116610050201,2753.4052696228027,38980,9669,29311,29311,0,23,9591000.0
9591,9591999,20.835121783261982,37.88510789400164,0.07496318347429454,3645.2865748405457,751.3768327236176,2753.6082878112793,38980,9669,29311,29311,0,23,9592000.0
9592,9592999,20.83435290537552,37.88371046741617,0.07496509669639051,3645.898330450058,751.4444003105164,2753.078868865967,38984,9671,29313,29313,0,23,9593000.0
9593,9593999,20.833412692636465,37.88230921433979,0.0749682153176745,3646.257354259491,751.5103628635406,2753.467113494873,38986,9672,29314,29314,0,23,9594000.0
9594,9594999,20.83251588692015,37.880805408081244,0.07497474119142322,3646.713583946228,751.5760600566864,2754.31791305542,39010,9674,29336,29336,0,23,9595000.0
9595,9595999,20.83161032777537,37.88033014221592,0.07497198220794277,3646.860190629959,751.6413834095001,2756.032642364502,39011,9674,29337,29337,0,23,9596000.0
9596,9596999,20.83061320033783,37.87877821807096,0.07497648157266357,3647.0464839935303,751.707412481308,2757.2081718444824,39012,9674,29338,29338,0,23,9597000.0
9597,9597999,20.829684722503888,37.877567621858574,0.07497911327035955,3647.3714864254,751.7738316059113,2757.951877593994,39017,9675,29342,29342,0,23,9598000.0
9598,9598999,20.82874711697149,37.87609956643616,0.07498388293386382,3647.8547537326813,751.8412485122681,2758.2138328552246,39021,9677,29344,29344,0,23,9599000.0
9599,9599999,20.827768312420215,37.87468457921071,0.07498662495923403,3648.280574321747,751.9086740016937,2758.758029937744,39026,9679,29347,29347,0,23,9600000.0
9600,9600999,20.827066326414116,37.873521845156425,0.07498667877927545,3648.5076966285706,751.9757823944092,2759.607364654541,39026,9679,29347,29347,0,23,9601000.0
9601,9601999,20.826401690174745,37.87252701919674,0.07498579688903562,3648.700533390045,752.042153596878,2760.38179397583,39026,9679,29347,29347,0,23,9602000.0
9602,9602999,20.825659834120454,37.871407394430406,0.07498936830131031,3649.3572080135345,752.109822511673,2759.9837608337402,39032,9682,29350,29350,0,23,9603000.0
9603,9603999,20.825045808850035,37.87047573622396,0.0749886781046728,3649.69638133049,752.176442861557,2760.4856452941895,39036,9683,29353,29353,0,23,9604000.0
9604,9604999,20.8244410476388,37.86945121132539,0.07498585295763349,3663.617216348648,752.2451882362366,2761.0009727478027,39039,9684,29355,29355,0,23,9605000.0
9605,9605999,20.824058769589175,37.86908721561077,0.07498260835662329,3664.0960745811462,752.3124871253967,2761.1326942443848,39043,9686,29357,29357,0,23,9606000.0
9606,9606999,20.823634286289668,37.86830827160694,0.07498662323700167,3664.5368769168854,752.3813850879669,2761.1572761535645,39045,9687,29358,29358,0,23,9607000.0
9607,9607999,20.82323209266408,37.86750062993888,0.07499520900570567,3665.1713814735413,752.4487881660461,2760.747058868408,39052,9690,29362,29362,0,23,9608000.0
9608,9608999,20.823140445860435,37.867272260684864,0.07499112917809359,3665.584596157074,752.5182690620422,2761.287509918213,39056,9692,29364,29364,0,23,9609000.0
9609,9609999,20.822786309088244,37.866454897094094,0.07498962648617435,3666.1987369060516,752.587397813797,2760.9668617248535,39066,9695,29371,29371,0,23,9610000.0
9610,9610999,20.822452971322427,37.86557202841287,0.0749903946670577,3666.612202167511,752.6588742733002,2761.172939300537,39068,9696,29372,29372,0,23,9611000.0
9611,9611999,20.822385512513307,37.86554883370821,0.07499093121272105,3666.948335647583,752.7277920246124,2761.6598014831543,39070,9697,29373,29373,0,23,9612000.0
9612,9612999,20.822060406619478,37.86473187451995,0.07498491800833718,3667.368186712265,752.7974412441254,2761.7832374572754,39072,9698,29374,29374,0,23,9613000.0
9613,9613999,20.82175012278861,37.863914262412116,0.07498767996631395,3667.801734685898,752.8662149906158,2761.9112968444824,39074,9699,29375,29375,0,23,9614000.0
9614,9614999,20.821223540489044,37.86286264601521,0.0749848955742155,3668.137813091278,752.9325180053711,2762.8143882751465,39087,9700,29387,29387,0,23,9615000.0
9615,9615999,20.820313219045627,37.86152519836712,0.07498651061280759,3668.4494194984436,752.9929370880127,2763.7607612609863,39096,9701,29395,29395,0,23,9616000.0
9616,9616999,20.819760333172756,37.860764399980944,0.0749838480255155,3668.775412797928,753.0545721054077,2764.644130706787,39104,9702,29402,29402,0,23,9617000.0
9617,9617999,20.819441455668905,37.86012957422137,0.07498165371480336,3668.992222070694,753.1188290119171,2765.6433753967285,39105,9702,29403,29403,0,23,9618000.0
9618,9618999,20.819770227515853,37.8609437443694,0.07497767029860236,3669.2181491851807,753.1803247928619,2766.629138946533,39106,9702,29404,29404,0,23,9619000.0
9619,9619999,20.82032950233831,37.86148842616896,0.07498146469521572,3669.413153409958,753.242992401123,2767.6586875915527,39107,9702,29405,29405,0,23,9620000.0
9620,9620999,20.82136344743096,37.863071530647225,0.07498938649191522,3669.8421506881714,753.3054144382477,2768.1871223449707,39112,9704,29408,29408,0,23,9621000.0
9621,9621999,20.82240454326533,37.86619645068859,0.07500693181440266,3670.623142004013,753.3702023029327,2767.911876678467,39127,9710,29417,29417,0,23,9622000.0
9622,9622999,20.823548460012244,37.86865454075105,0.07504186677167635,3670.9216306209564,753.4344029426575,2768.7801399230957,39129,9711,29418,29418,0,23,9623000.0
9623,9623999,20.824946995543023,37.87089831996512,0.07507845037132266,3671.331540107727,753.497576713562,2769.251735687256,39135,9713,29422,29422,0,23,9624000.0
9624,9624999,20.826282256187284,37.87394451465017,0.07511418340119225,3672.0810482501984,753.5627102851868,2768.601634979248,39149,9717,29432,29432,0,23,9625000.0
9625,9625999,20.827668413763934,37.87617881747954,0.07517625866560018,3672.380283355713,753.6275150775909,2769.1805992126465,39149,9717,29432,29432,0,23,9626000.0
9626,9626999,20.828945856837038,37.879288099024265,0.07521340041012481,3672.7031655311584,753.6932423114777,2769.6038246154785,39149,9717,29432,29432,0,23,9627000.0
9627,9627999,20.830299386787686,37.881129303606926,0.07527371317364162,3672.943766117096,753.7577419281006,2770.3540000915527,39149,9717,29432,29432,0,23,9628000.0
9628,9628999,20.831604617975557,37.88306072705385,0.07531456712390128,3673.3967139720917,753.8212504386902,2770.3220252990723,39161,9718,29443,29443,0,23,9629000.0
9629,9629999,20.833364774147896,37.88560046651391,0.07538042705485315,3674.0037841796875,753.887749671936,2770.108783721924,39169,9721,29448,29448,0,23,9630000.0
9630,9630999,20.83487360488932,37.88829451996376,0.07544780687663122,3674.3283112049103,753.9526631832123,2770.782947540283,39171,9722,29449,29449,0,23,9631000.0
9631,9631999,20.83672096047871,37.891546713461416,0.07552210861962849,3674.830697774887,754.0175721645355,2770.8033180236816,39175,9724,29451,29451,0,23,9632000.0
9632,9632999,20.83829964791846,37.894228461893974,0.07557765306017183,3675.430993080139,754.0819795131683,2770.6019020080566,39182,9727,29455,29455,0,23,9633000.0
9633,9633999,20.83934828332335,37.895007819368494,0.07560522547885051,3675.9335899353027,754.1472675800323,2770.5482902526855,39188,9729,29459,29459,0,23,9634000.0
9634,9634999,20.839728041542788,37.895248579403585,0.07559788708006587,3676.4530169963837,754.2146480083466,2771.1029777526855,39203,9732,29471,29471,0,23,9635000.0
9635,9635999,20.83935244388809,37.89528485071698,0.07559584453179435,3676.850891828537,754.2830953598022,2771.6481895446777,39205,9733,29472,29472,0,23,9636000.0
9636,9636999,20.839029950044992,37.89531939191908,0.07559454517719766,3677.094983816147,754.3489940166473,2772.524227142334,39205,9733,29472,29472,0,23,9637000.0
9637,9637999,20.838690609999055,37.89519513070389,0.07559326524941101,3677.34455537796,754.4148926734924,2773.225643157959,39206,9733,29473,29473,0,23,9638000.0
9638,9638999,20.83820331302098,37.89422742579592,0.07559493751431434,3677.768440246582,754.4810948371887,2773.8414268493652,39224,9735,29489,29489,0,23,9639000.0
9639,9639999,20.837824147706794,37.89323625038664,0.07559427494603566,3677.9720146656036,754.5493462085724,2774.991916656494,39225,9735,29490,29490,0,23,9640000.0
9640,9640999,20.83740031788573,37.89235794228791,0.07559555055459155,3678.3686838150024,754.6176311969757,2775.215518951416,39227,9736,29491,29491,0,23,9641000.0
9641,9641999,20.837115105596116,37.89358641676402,0.07558664754363598,3678.766872882843,754.686262845993,2775.4541358947754,39239,9737,29502,29502,0,23,9642000.0
9642,9642999,20.83681755411831,37.89283417444179,0.07558469522056477,3679.4027938842773,754.756588935852,2775.1745796203613,39249,9740,29509,29509,0,23,9643000.0
9643,9643999,20.836572340897085,37.89225283791445,0.07558160589131524,3679.792499780655,754.8258192539215,2775.2820014953613,39249,9740,29509,29509,0,23,9644000.0
9644,9644999,20.836412319689263,37.89318188695137,0.07557533058652632,3680.058103322983,754.8945348262787,2776.2324028015137,39251,9741,29510,29510,0,23,9645000.0
9645,9645999,20.836064732611483,37.892320244445614,0.07557341926562144,3680.533876657486,754.9619886875153,2776.1269035339355,39255,9742,29513,29513,0,23,9646000.0
9646,9646999,20.83568500628101,37.891229664573615,0.07557443932263397,3680.823811531067,755.0297703742981,2776.5772438049316,39255,9742,29513,29513,0,23,9647000.0
9647,9647999,20.83547396935155,37.890493577533036,0.07557331817944224,3681.263581752777,755.098217010498,2776.5428886413574,39259,9743,29516,29516,0,23,9648000.0
9648,9648999,20.835003169701796,37.889252416349805,0.07557527520050378,3681.747768640518,755.1656272411346,2776.388240814209,39263,9744,29519,29519,0,23,9649000.0
9649,9649999,20.834487988092256,37.888014651415645,0.07557853876442877,3682.1247189044952,755.2353432178497,2776.5722846984863,39263,9744,29519,29519,0,23,9650000.0
9650,9650999,20.833895675495885,37.88672606421181,0.07558235133071389,3682.4600098133087,755.3027610778809,2776.843776702881,39263,9744,29519,29519,0,23,9651000.0
9651,9651999,20.833263563208284,37.88566783399086,0.07558768979013342,3682.6963863372803,755.3678729534149,2778.160472869873,39278,9744,29534,29534,0,23,9652000.0
9652,9652999,20.83235708710741,37.88427792777403,0.07559915185345867,3683.00998711586,755.4308731555939,2778.803699493408,39279,9744,29535,29535,0,23,9653000.0
9653,9653999,20.831349319144287,37.8826864775612,0.07560975047913499,3683.554426908493,755.495299577713,2779.0474739074707,39295,9747,29548,29548,0,23,9654000.0
9654,9654999,20.830465099226725,37.881367202094914,0.07561716392724449,3683.8109006881714,755.5592069625854,2780.031467437744,39299,9748,29551,29551,0,23,9655000.0
9655,9655999,20.829654141223585,37.88023581597769,0.07562159304625826,3684.0301620960236,755.6240994930267,2780.8310585021973,39300,9748,29552,29552,0,23,9656000.0
9656,9656999,20.828858269841483,37.879042885412495,0.07562724285636224,3684.586714744568,755.690022945404,2780.6074256896973,39306,9750,29556,29556,0,23,9657000.0
9657,9657999,20.82808056714275,37.878038836342924,0.07562889172313236,3684.959428548813,755.7607171535492,2781.1131706237793,39308,9751,29557,29557,0,23,9658000.0
9658,9658999,20.82738892367881,37.8769869412085,0.07563100699268,3685.303756713867,755.8259375095367,2781.5676612854004,39310,9752,29558,29558,0,23,9659000.0
9659,9659999,20.82674997004918,37.875897515387,0.0756330731018795,3685.9212045669556,755.8921415805817,2781.570041656494,39320,9756,29564,29564,0,23,9660000.0
9660,9660999,20.826284441822743,37.87509287485856,0.07563338328429747,3686.259181499481,755.9581544399261,2781.934238433838,39322,9757,29565,29565,0,23,9661000.0
9661,9661999,20.825712548735964,37.87417953337499,0.0756336705983669,3686.489177942276,756.023255109787,2782.6439170837402,39322,9757,29565,29565,0,23,9662000.0
9662,9662999,20.82519634205447,37.87333999724177,0.07563275765531918,3686.976031064987,756.0882470607758,2782.6217002868652,39326,9759,29567,29567,0,23,9663000.0
9663,9663999,20.82482959223248,37.872755794544794,0.07563226932457356,3687.4050829410553,756.155651807785,2782.64457321167,39328,9760,29568,29568,0,23,9664000.0
9664,9664999,20.824443000718002,37.87207520254051,0.07563193154328018,3688.002831220627,756.2221541404724,2782.4528770446777,39334,9763,29571,29571,0,23,9665000.0
9665,9665999,20.82407042568227,37.871559772518886,0.07562862204101584,3688.5180501937866,756.2896494865417,2782.2368507385254,39336,9764,29572,29572,0,23,9666000.0
9666,9666999,20.823832110298145,37.87170749866448,0.07562316806083502,3689.1225910186768,756.3566584587097,2781.7522926330566,39342,9766,29576,29576,0,23,9667000.0
9667,9667999,20.8234986553086,37.870988996252706,0.07562096066042101,3689.3930213451385,756.4235162734985,2782.3418769836426,39342,9766,29576,29576,0,23,9668000.0
9668,9668999,20.822948735849796,37.8698619524611,0.07562192455432648,3689.8088557720184,756.4899067878723,2782.488269805908,39344,9767,29577,29577,0,23,9669000.0
9669,9669999,20.82233380388398,37.86868058012128,0.07562066017955316,3690.240238904953,756.5566399097443,2782.6028480529785,39348,9768,29580,29580,0,23,9670000.0
9670,9670999,20.821615249940983,37.86737632991131,0.07562531337986589,3690.477451324463,756.6226546764374,2783.8679542541504,39366,9768,29598,29598,0,23,9671000.0
9671,9671999,20.82068498392034,37.86606520066058,0.07563155550327838,3690.8003566265106,756.688107252121,2784.823871612549,39369,9769,29600,29600,0,23,9672000.0
9672,9672999,20.82003713458525,37.865590320685634,0.07562980665018426,3691.134071111679,756.7534050941467,2785.5511207580566,39372,9770,29602,29602,0,23,9673000.0
9673,9673999,20.819284807134554,37.86446984050565,0.0756326965538443,3691.314774990082,756.8187210559845,2786.636775970459,39372,9770,29602,29602,0,23,9674000.0
9674,9674999,20.81861191853753,37.86371202564035,0.07563181494109517,3691.846471309662,756.8851044178009,2786.8098487854004,39398,9773,29625,29625,0,23,9675000.0
9675,9675999,20.81794394339771,37.86261252646566,0.0756331553783165,3692.275101661682,756.9512665271759,2786.959545135498,39400,9774,29626,29626,0,23,9676000.0
9676,9676999,20.817361227026907,37.861599006490415,0.07563298790784911,3692.5525300502777,757.0177404880524,2787.395191192627,39400,9774,29626,29626,0,23,9677000.0
9677,9677999,20.816794036672277,37.86071411339214,0.07563208361346097,3693.0414259433746,757.0841672420502,2787.449405670166,39414,9776,29638,29638,0,23,9678000.0
9678,9678999,20.81628071365487,37.85986240615717,0.0756331680799992,3693.3870096206665,757.1515555381775,2787.8319511413574,39416,9777,29639,29639,0,23,9679000.0
9679,9679999,20.815790884992307,37.859115618075485,0.07563284257386238,3693.917035341263,757.2178356647491,2787.794666290283,39420,9779,29641,29641,0,23,9680000.0
9680,9680999,20.815285620815544,37.858158816452864,0.07563171321023077,3694.1904866695404,757.285947561264,2788.3379707336426,39420,9779,29641,29641,0,23,9681000.0
9681,9681999,20.814797830867143,37.85720762433736,0.07563046716934141,3694.472618341446,757.3514411449432,2788.6977882385254,39420,9779,29641,29641,0,23,9682000.0
9682,9682999,20.814575141707998,37.85776717242052,0.07562702192538606,3695.119809627533,757.418869972229,2788.228946685791,39426,9782,29644,29644,0,23,9683000.0
9683,9683999,20.81422985782178,37.856940692365626,0.07562766577319624,3695.42196559906,757.4857907295227,2788.8617668151855,39427,9783,29644,29644,0,23,9684000.0
9684,9684999,20.813806036685097,37.855963459329566,0.07562949321117851,3696.147098302841,757.5538339614868,2788.209705352783,39442,9786,29656,29656,0,23,9685000.0
9685,9685999,20.813472987906014,37.85503149365378,0.07563124369801266,3696.4991450309753,757.6226525306702,2788.647922515869,39444,9787,29657,29657,0,23,9686000.0
9686,9686999,20.813130475975928,37.85419658103284,0.07563041962634387,3696.9293310642242,757.6909191608429,2788.6983375549316,39446,9788,29658,29658,0,23,9687000.0
9687,9687999,20.813054734991887,37.85366080752731,0.0756250317541255,3697.3297832012177,757.758930683136,2788.9119606018066,39448,9789,29659,29659,0,23,9688000.0
9688,9688999,20.81287978624703,37.85293670714125,0.0756229050242595,3697.79221868515,757.8264265060425,2788.8548469543457,39450,9790,29660,29660,0,23,9689000.0
9689,9689999,20.81234036284503,37.85181744113704,0.0756215969266204,3698.1554658412933,757.8954946994781,2789.6476554870605,39466,9791,29675,29675,0,23,9690000.0
9690,9690999,20.811762142210927,37.85050958220946,0.07562448579191494,3698.7332651615143,757.9651327133179,2790.0698280334473,39490,9794,29696,29696,0,23,9691000.0
9691,9691999,20.811134604016214,37.84940005271264,0.07562094927972152,3699.053598880768,758.0281045436859,2791.192241668701,39501,9795,29706,29706,0,23,9692000.0
9692,9692999,20.810467067667236,37.84819496349037,0.07562071385549518,3699.3553380966187,758.0927996635437,2792.16117477417,39503,9796,29707,29707,0,23,9693000.0
9693,9693999,20.810104914470823,37.84777417094515,0.07561535545902842,3699.505017518997,758.157035112381,2793.4628562927246,39504,9796,29708,29708,0,23,9694000.0
9694,9694999,20.809552544378946,37.846683374092486,0.07561336599917512,3699.893464565277,758.2194657325745,2793.7521324157715,39507,9797,29710,29710,0,23,9695000.0
9695,9695999,20.809247027245153,37.8460039806056,0.07560957103340737,3700.4822862148285,758.2826693058014,2793.866443634033,39514,9800,29714,29714,0,23,9696000.0
9696,9696999,20.808822643661667,37.84507057081207,0.0756080632497641,3700.936358690262,758.3479323387146,2794.242908477783,39528,9802,29726,29726,0,23,9697000.0
9697,9697999,20.80836287799863,37.84418325258147,0.07560970352134877,3701.277709722519,758.4119846820831,2794.8385887145996,39530,9803,29727,29727,0,23,9698000.0
9698,9698999,20.807994892154785,37.84353188758375,0.07560542467305009,3701.642560005188,758.4757361412048,2795.2697944641113,39534,9804,29730,29730,0,23,9699000.0
9699,9699999,20.807562054588534,37.84241716742581,0.07560287904958307,3702.2088963985443,758.5419855117798,2795.156162261963,39544,9807,29737,29737,0,23,9700000.0
9700,9700999,20.806983507912893,37.841180737179,0.0756045870301355,3702.8245985507965,758.6070952415466,2795.0223274230957,39551,9810,29741,29741,0,23,9701000.0
9701,9701999,20.80642666849105,37.83995193689712,0.07560751528060639,3703.2540357112885,758.6709651947021,2795.1069145202637,39553,9811,29742,29742,0,23,9702000.0
9702,9702999,20.805863648643264,37.83908722162713,0.07560800855830996,3703.5673220157623,758.7359635829926,2795.773899078369,39555,9812,29743,29743,0,23,9703000.0
9703,9703999,20.805523211894663,37.84301013695229,0.07559525201469353,3703.889921426773,758.8003904819489,2796.122486114502,39555,9812,29743,29743,0,23,9704000.0
9704,9704999,20.80516593319589,37.8431309680432,0.07558860879535412,3704.284893989563,758.8655457496643,2796.406681060791,39557,9813,29744,29744,0,23,9705000.0
9705,9705999,20.80465128179316,37.84192648875118,0.07558920518896561,3704.749261856079,758.9304270744324,2796.3205070495605,39559,9814,29745,29745,0,23,9706000.0
9706,9706999,20.804095769056694,37.84073528895503,0.0755899839468126,3705.283063173294,758.9963917732239,2796.215908050537,39563,9816,29747,29747,0,23,9707000.0
9707,9707999,20.803518863338613,37.83940127988918,0.07559193096771355,3705.500700235367,759.0659503936768,2797.1236610412598,39563,9816,29747,29747,0,23,9708000.0
9708,9708999,20.80298145191772,37.838220391317655,0.07559169355383322,3705.8112297058105,759.1302864551544,2797.443103790283,39563,9816,29747,29747,0,23,9709000.0
9709,9709999,20.802373603255713,37.8369723690998,0.0755928396393244,3706.1247544288635,759.1935114860535,2797.7050971984863,39563,9816,29747,29747,0,23,9710000.0
9710,9710999,20.801639281894538,37.83584083198599,0.07559639336691282,3706.4086151123047,759.2598984241486,2798.8785514831543,39583,9816,29767,29767,0,23,9711000.0
9711,9711999,20.800693265421348,37.834534028303125,0.07559986348382242,3706.70045876503,759.3255937099457,2799.953800201416,39585,9817,29768,29768,0,23,9712000.0
9712,9712999,20.79984905711754,37.83335499884063,0.07560358925246113,3707.023490190506,759.3914005756378,2800.7075004577637,39597,9818,29779,29779,0,23,9713000.0
9713,9713999,20.799182075975235,37.83245468214858,0.07560424846395142,3707.5329327583313,759.4569199085236,2801.042621612549,39615,9821,29794,29794,0,23,9714000.0
9714,9714999,20.798591926029648,37.83147966032459,0.07560299161900963,3707.764413356781,759.5227143764496,2801.7802391052246,39615,9821,29794,29794,0,23,9715000.0
9715,9715999,20.798124811979775,37.83049321476615,0.07560078119785829,3708.1143000125885,759.5886266231537,2802.117046356201,39617,9822,29795,29795,0,23,9716000.0
9716,9716999,20.797542818954682,37.82925877058538,0.07560130835575618,3708.951596021652,759.6553077697754,2801.41499710083,39628,9827,29801,29801,0,23,9717000.0
9717,9717999,20.796911310499688,37.82801828014458,0.07560230920758826,3709.332073688507,759.7220280170441,2801.7877616882324,39630,9828,29802,29802,0,23,9718000.0
9718,9718999,20.796437718392927,37.82707634327346,0.07560118963703955,3709.649910211563,759.7890269756317,2802.1640434265137,39630,9828,29802,29802,0,23,9719000.0
9719,9719999,20.79603904279393,37.82612054675566,0.07559866877679677,3710.039268732071,759.8566069602966,2802.3984031677246,39632,9829,29803,29803,0,23,9720000.0
9720,9720999,20.795790408860263,37.825464599151665,0.07559605593707297,3710.3526260852814,759.923431634903,2802.96284866333,39634,9830,29804,29804,0,23,9721000.0
9721,9721999,20.79540753411854,37.82463237911443,0.07559839788266387,3710.732808828354,759.9900946617126,2803.231517791748,39636,9831,29805,29805,0,23,9722000.0
9722,9722999,20.79498102831686,37.82378145929678,0.07559742522515778,3711.346381664276,760.0575268268585,2802.5577125549316,39638,9832,29806,29806,0,23,9723000.0
9723,9723999,20.794895075191228,37.82337087119289,0.07559570482182598,3711.719445705414,760.123715877533,2802.976329803467,39641,9833,29808,29808,0,23,9724000.0
9724,9724999,20.7947027788711,37.82287858354498,0.07559478122240293,3712.178900241852,760.1920883655548,2803.1741676330566,39645,9835,29810,29810,0,23,9725000.0
9725,9725999,20.794802446608436,37.82288519147475,0.07559899410605175,3712.414994955063,760.2584290504456,2803.941738128662,39645,9835,29810,29810,0,23,9726000.0
9726,9726999,20.795177746699117,37.82297361337314,0.07560097838233304,3712.7416763305664,760.3256101608276,2804.2359886169434,39645,9835,29810,29810,0,23,9727000.0
9727,9727999,20.79566434352944,37.8233804549619,0.07559993223283967,3713.0771856307983,760.3931860923767,2804.829563140869,39647,9836,29811,29811,0,23,9728000.0
9728,9728999,20.795917292020818,37.82328110231037,0.07559843692501378,3713.383364677429,760.4614367485046,2805.057559967041,39647,9836,29811,29811,0,23,9729000.0
9729,9729999,20.795886120727243,37.82310058092549,0.07559502248837102,3713.8216824531555,760.5272274017334,2804.799045562744,39647,9836,29811,29811,0,23,9730000.0
9730,9730999,20.79530945623533,37.82216808832317,0.07559566238009863,3714.2466440200806,760.5952568054199,2805.7985038757324,39669,9837,29832,29832,0,23,9731000.0
9731,9731999,20.794308073401982,37.820780709748504,0.07560042484444374,3714.443077802658,760.661985874176,2807.1561012268066,39670,9837,29833,29833,0,23,9732000.0
9732,9732999,20.79342902133794,37.819409912949425,0.07560315028869169,3714.7428851127625,760.7290086746216,2808.1890449523926,39673,9838,29835,29835,0,23,9733000.0
9733,9733999,20.79261468283508,37.8180395756129,0.07560625080327554,3714.89732670784,760.7941744327545,2809.332416534424,39673,9838,29835,29835,0,23,9734000.0
9734,9734999,20.791870462412366,37.81684716424474,0.07560644455862842,3715.402868270874,760.8603167533875,2809.3701133728027,39677,9840,29837,29837,0,23,9735000.0
9735,9735999,20.79109740863759,37.815453701800315,0.07560929931766047,3715.7076823711395,760.9272949695587,2810.1846961975098,39689,9841,29848,29848,0,23,9736000.0
9736,9736999,20.7901991877009,37.814019779525466,0.07561361070402828,3716.371083498001,760.9950823783875,2809.7485160827637,39707,9844,29863,29863,0,23,9737000.0
9737,9737999,20.78934024631019,37.812545528187265,0.07561732355372841,3716.71679854393,761.0629341602325,2810.2679176330566,39709,9845,29864,29864,0,23,9738000.0
9738,9738999,20.788593053270414,37.81129987633925,0.07561905663081547,3717.2651629447937,761.1296660900116,2809.859706878662,39711,9846,29865,29865,0,23,9739000.0
9739,9739999,20.78794754115596,37.81035262539683,0.07561891438515622,3717.643498659134,761.1981143951416,2810.5026817321777,39715,9848,29867,29867,0,23,9740000.0
9740,9740999,20.787368576118876,37.80931231353274,0.07562288735307265,3717.9517784118652,761.2660415172577,2811.086887359619,39717,9849,29868,29868,0,23,9741000.0
9741,9741999,20.786821499641327,37.80833431560593,0.0756232819486019,3718.308418035507,761.3322458267212,2811.468463897705,39719,9850,29869,29869,0,23,9742000.0
9742,9742999,20.786233582253654,37.80724681440381,0.07562261538492987,3718.792123556137,761.4043469429016,2811.636157989502,39725,9852,29873,29873,0,23,9743000.0
9743,9743999,20.78567856814622,37.80616382359859,0.07562316596375096,3719.1638176441193,761.4718034267426,2812.1008491516113,39727,9853,29874,29874,0,23,9744000.0
9744,9744999,20.785219991776078,37.80527115160589,0.0756222767211241,3719.687059402466,761.5438306331635,2811.9240684509277,39729,9854,29875,29875,0,23,9745000.0
9745,9745999,20.784879368384896,37.80467525346618,0.0756196057148828,3719.97901058197,761.6132082939148,2812.4113578796387,39729,9854,29875,29875,0,23,9746000.0
9746,9746999,20.784471104685455,37.803895484209306,0.07561791697002385,3720.3345572948456,761.6903700828552,2812.598979949951,39729,9854,29875,29875,0,23,9747000.0
9747,9747999,20.784117319212108,37.80294600956883,0.07561760393548767,3720.8675615787506,761.7583255767822,2812.5122261047363,39733,9856,29877,29877,0,23,9748000.0
9748,9748999,20.783688790229352,37.80209452721051,0.07561566780966367,3721.1818413734436,761.8282129764557,2813.025302886963,39736,9857,29879,29879,0,23,9749000.0
9749,9749999,20.783199337519143,37.80107286022554,0.07561520016518752,3721.715155363083,761.896436214447,2812.6799354553223,39738,9858,29880,29880,0,23,9750000.0
9750,9750999,20.782729752885373,37.79997792008419,0.07561667968841446,3721.91837143898,761.9618053436279,2813.8773155212402,39745,9858,29887,29887,0,23,9751000.0
9751,9751999,20.781790657265635,37.79861191507432,0.07561927074793107,3722.2525787353516,762.0250055789948,2814.684299468994,39753,9859,29894,29894,0,23,9752000.0
9752,9752999,20.78096205088437,37.79740652882194,0.07562339375819394,3722.550892353058,762.0884096622467,2815.623706817627,39769,9860,29909,29909,0,23,9753000.0
9753,9753999,20.780325148882596,37.796362863671874,0.07562498587368782,3722.977678537369,762.1533875465393,2815.9647789001465,39772,9861,29911,29911,0,23,9754000.0
9754,9754999,20.779672976084697,37.795971077484865,0.07562237110542847,3723.2688994407654,762.2186107635498,2816.850238800049,39775,9862,29913,29913,0,23,9755000.0
9755,9755999,20.77908935856399,37.79523145837404,0.07561962978738146,3723.7442467212677,762.2843871116638,2816.864604949951,39787,9863,29924,29924,0,23,9756000.0
9756,9756999,20.778502135230013,37.794242051228515,0.07562053121328205,3724.3547942638397,762.3484182357788,2816.685718536377,39804,9866,29938,29938,0,23,9757000.0
9757,9757999,20.778003492483073,37.79326612155283,0.07562234308566895,3724.827821493149,762.4167296886444,2817.1759910583496,39808,9868,29940,29940,0,23,9758000.0
9758,9758999,20.777678555773853,37.79288852346822,0.0756264781709175,3725.2573688030243,762.4894325733185,2817.6375007629395,39812,9870,29942,29942,0,23,9759000.0
9759,9759999,20.777326787848395,37.792413892470194,0.0756288411030529,3725.620088815689,762.5527589321136,2818.095691680908,39814,9871,29943,29943,0,23,9760000.0
9760,9760999,20.777160648166603,37.79225075837082,0.07563525637086799,3726.1204974651337,762.6187462806702,2817.9259071350098,39816,9872,29944,29944,0,23,9761000.0
9761,9761999,20.77707418387714,37.792552977446974,0.07564683496668234,3726.3603019714355,762.6817970275879,2818.711193084717,39816,9872,29944,29944,0,23,9762000.0
9762,9762999,20.77706869116011,37.79260090730019,0.07564911555643028,3726.788518667221,762.7461249828339,2819.0438804626465,39821,9874,29947,29947,0,23,9763000.0
9763,9763999,20.77729943749977,37.79320925872101,0.07564680559617298,3727.029296875,762.8106157779694,2819.711643218994,39821,9874,29947,29947,0,23,9764000.0
9764,9764999,20.777201018532523,37.79286369155776,0.07564936559427748,3727.6069691181183,762.8742327690125,2819.5366554260254,39829,9877,29952,29952,0,23,9765000.0
9765,9765999,20.777470738630765,37.793433967316474,0.07566363994531689,3727.961366176605,762.9395422935486,2819.597988128662,39829,9877,29952,29952,0,23,9766000.0
9766,9766999,20.777750718113573,37.79388535047342,0.07566858813925337,3728.477526664734,763.0064010620117,2819.2858848571777,39833,9878,29955,29955,0,23,9767000.0
9767,9767999,20.777956699589804,37.79495786577594,0.07566799702066929,3728.8221678733826,763.0699284076691,2819.775936126709,39835,9879,29956,29956,0,23,9768000.0
9768,9768999,20.778446320055203,37.7960782580133,0.07567589151557419,3729.0611579418182,763.1334056854248,2820.3561973571777,39835,9879,29956,29956,0,23,9769000.0
9769,9769999,20.77858737105795,37.796003686253385,0.07567641113729251,3729.427372455597,763.1974325180054,2820.6480827331543,39837,9880,29957,29957,0,23,9770000.0
9770,9770999,20.77849700151141,37.795752973202774,0.07567373480289563,3729.853709459305,763.2606997489929,2820.5562477111816,39839,9880,29959,29959,0,23,9771000.0
9771,9771999,20.777705645845483,37.7947537363778,0.07567831279742865,3729.995620727539,763.3242163658142,2822.4290733337402,39850,9880,29970,29970,0,23,9772000.0
9772,9772999,20.776998898899016,37.79390019553666,0.07568119290380237,3730.3573575019836,763.3890826702118,2823.038806915283,39854,9881,29973,29973,0,23,9773000.0
9773,9773999,20.776387434091195,37.792919814618024,0.07568100597862049,3730.5820043087006,763.4542677402496,2824.0252799987793,39854,9881,29973,29973,0,23,9774000.0
9774,9774999,20.775674235525535,37.79167019595635,0.0756834121453499,3730.8562774658203,763.5197145938873,2824.6279792785645,39855,9881,29974,29974,0,23,9775000.0
9775,9775999,20.775035045036862,37.7905241158446,0.07568701895546992,3731.3543865680695,763.5855112075806,2824.707431793213,39869,9883,29986,29986,0,23,9776000.0
9776,9776999,20.77431700193286,37.78937520294344,0.07568911594928418,3732.0786607265472,763.6528186798096,2824.2942085266113,39877,9887,29990,29990,0,23,9777000.0
9777,9777999,20.773568952849494,37.78800035161251,0.07569121202981022,3732.550544977188,763.7199945449829,2824.431827545166,39881,9889,29992,29992,0,23,9778000.0
9778,9778999,20.772957297419264,37.786827100943405,0.0756911514363926,3733.0391335487366,763.7865393161774,2824.6568031311035,39885,9891,29994,29994,0,23,9779000.0
9779,9779999,20.772353359112742,37.78578345889415,0.0756919740066726,3733.532411813736,763.8534460067749,2824.8934593200684,39889,9893,29996,29996,0,23,9780000.0
9780,9780999,20.771663225685217,37.78452457817823,0.07569555798542604,3733.8849370479584,763.9207527637482,2825.448169708252,39891,9894,29997,29997,0,23,9781000.0
9781,9781999,20.771014569657645,37.78321291984682,0.07569643293681505,3734.258195877075,763.9879338741302,2825.9266929626465,39895,9895,30000,30000,0,23,9782000.0
9782,9782999,20.770437023993335,37.78202977421912,0.07569818309801934,3734.5563428401947,764.0538387298584,2826.3963584899902,39895,9895,30000,30000,0,23,9783000.0
9783,9783999,20.769941217579813,37.782314957624095,0.07569644798589259,3735.084208011627,764.1198046207428,2825.9046058654785,39897,9896,30001,30001,0,23,9784000.0
9784,9784999,20.769393176787148,37.781077011376915,0.0757004296578021,3735.520132780075,764.18852186203,2825.99662399292,39899,9897,30002,30002,0,23,9785000.0
9785,9785999,20.768905640550884,37.78083464829276,0.07570022132558829,3735.8082342147827,764.255628824234,2826.5652198791504,39899,9897,30002,30002,0,23,9786000.0
9786,9786999,20.768439796812338,37.77977387954437,0.07570326262753257,3736.008769750595,764.3221967220306,2827.4006538391113,39899,9897,30002,30002,0,23,9787000.0
9787,9787999,20.76797990298544,37.77944699982464,0.07570367078490703,3736.442255973816,764.394907951355,2827.9807929992676,39920,9898,30022,30022,0,23,9788000.0
9788,9788999,20.767386329347477,37.77887035196848,0.07570248304907357,3736.6674823760986,764.4612736701965,2829.305103302002,39923,9898,30025,30025,0,23,9789000.0
9789,9789999,20.766913676416806,37.77859817285657,0.07570091331903583,3736.9716007709503,764.5251913070679,2830.0073738098145,39924,9898,30026,30026,0,23,9790000.0
9790,9790999,20.766305454628146,37.777458778752795,0.07570295566174223,3737.254378080368,764.5893354415894,2830.62699508667,39924,9898,30026,30026,0,23,9791000.0
9791,9791999,20.765902399241114,37.77659094119898,0.07570120085580134,3737.4068105220795,764.6535189151764,2831.679256439209,39924,9898,30026,30026,0,23,9792000.0
9792,9792999,20.76572320416137,37.779783004708015,0.07568387484468853,3737.841826915741,764.7184166908264,2832.0145988464355,39931,9900,30031,30031,0,23,9793000.0
9793,9793999,20.76543502378046,37.77934455282128,0.07567831633162558,3738.1784451007843,764.7823195457458,2832.4537620544434,39933,9901,30032,30032,0,23,9794000.0
9794,9794999,20.76530843443087,37.77904104677813,0.07567175004989124,3738.7689604759216,764.8472788333893,2832.3070793151855,39939,9904,30035,30035,0,23,9795000.0
9795,9795999,20.76528217019684,37.77959111678507,0.07566587897749188,3739.467011451721,764.9153409004211,2832.210720062256,39948,9908,30040,30040,0,23,9796000.0
9796,9796999,20.765228976271064,37.7793016400997,0.07566296321094279,3739.9803659915924,764.9819078445435,2832.2659187316895,39952,9910,30042,30042,0,23,9797000.0
9797,9797999,20.765354832294527,37.779522251034685,0.07566429806063346,3740.451804161072,765.0496125221252,2832.6189002990723,39956,9912,30044,30044,0,23,9798000.0
9798,9798999,20.765345754491012,37.779321684096494,0.07566619738620461,3740.7737250328064,765.1139938831329,2833.232898712158,39958,9913,30045,30045,0,23,9799000.0
9799,9799999,20.765330082953614,37.77916428638963,0.07566188539461549,3741.2739634513855,765.1793591976166,2833.3568153381348,39964,9915,30049,30049,0,23,9800000.0
9800,9800999,20.765275678753852,37.77894782217647,0.07566096762562635,3741.575344324112,765.2447082996368,2834.040294647217,39966,9916,30050,30050,0,23,9801000.0
9801,9801999,20.765312534469164,37.778825178645114,0.07565666600100918,3742.00994181633,765.3094811439514,2834.0583305358887,39970,9917,30053,30053,0,23,9802000.0
9802,9802999,20.765474175571956,37.7788084312237,0.07565073566936587,3742.4735684394836,765.3756568431854,2834.268970489502,39974,9919,30055,30055,0,23,9803000.0
9803,9803999,20.765559961827268,37.778686290187,0.07564437814451908,3743.0258796215057,765.4436912536621,2834.0265007019043,39980,9921,30059,30059,0,23,9804000.0
9804,9804999,20.765655426675906,37.77839933557765,0.075636033723121,3743.41202044487,765.5091326236725,2834.3985481262207,39982,9922,30060,30060,0,23,9805000.0
9805,9805999,20.765527040392215,37.777679440116515,0.07562738145194225,3743.7582681179047,765.5735483169556,2834.8914222717285,39986,9923,30063,30063,0,23,9806000.0
9806,9806999,20.765328198809144,37.77684688173463,0.07562331021821656,3744.188991546631,765.6398189067841,2835.2698402404785,40000,9924,30076,30076,0,23,9807000.0
9807,9807999,20.764543952846285,37.77578805424443,0.07562382168212767,3744.3256816864014,765.7037394046783,2837.0971488952637,40010,9924,30086,30086,0,23,9808000.0
9808,9808999,20.76387115794513,37.774801308729515,0.07562348361304128,3744.625937461853,765.7676794528961,2838.0387535095215,40015,9925,30090,30090,0,23,9809000.0
9809,9809999,20.76355019953961,37.77483051698203,0.07561581931904193,3745.038637161255,765.8329327106476,2838.5852394104004,40019,9927,30092,30092,0,23,9810000.0
9810,9810999,20.763141672708826,37.77457839674427,0.07561108348269874,3745.654316663742,765.8979568481445,2838.688404083252,40030,9931,30099,30099,0,23,9811000.0
9811,9811999,20.762945571405606,37.77405615487558,0.07560752512811464,3746.1813900470734,765.9627001285553,2838.958827972412,40036,9934,30102,30102,0,23,9812000.0
9812,9812999,20.76256038444456,37.77323606828732,0.0756093608841295,3746.6743247509003,766.0301203727722,2839.154125213623,40040,9936,30104,30104,0,23,9813000.0
9813,9813999,20.76245593085873,37.773419617169516,0.07560531556156314,3746.8940527439117,766.0961065292358,2839.9912071228027,40040,9936,30104,30104,0,23,9814000.0
9814,9814999,20.762495152016623,37.7735559271797,0.07560555355614107,3747.2244770526886,766.1609387397766,2840.5475425720215,40042,9937,30105,30105,0,23,9815000.0
9815,9815999,20.762601954335416,37.77391943361727,0.07561246335296323,3747.898939371109,766.2283029556274,2840.3862342834473,40052,9941,30111,30111,0,23,9816000.0
9816,9816999,20.762805185417353,37.774273341257114,0.07561435736595945,3748.2227177619934,766.293881893158,2840.7993965148926,40052,9941,30111,30111,0,23,9817000.0
9817,9817999,20.762977949082806,37.77465002443241,0.07562978548789312,3748.5766327381134,766.3602869510651,2841.1919288635254,40054,9942,30112,30112,0,23,9818000.0
9818,9818999,20.763019007523784,37.7746156540021,0.07563768481371558,3748.8497366905212,766.4255990982056,2841.748363494873,40054,9942,30112,30112,0,23,9819000.0
9819,9819999,20.763106696841827,37.77446323470736,0.07564761250016694,3749.3520543575287,766.4927651882172,2841.8022651672363,40060,9944,30116,30116,0,23,9820000.0
9820,9820999,20.763150791851096,37.774292814237086,0.07565547157661812,3749.6648190021515,766.5580277442932,2842.5084495544434,40062,9945,30117,30117,0,23,9821000.0
9821,9821999,20.763175345527824,37.77406652640361,0.07566064698304198,3750.0389227867126,766.6244282722473,2842.514186859131,40062,9945,30117,30117,0,23,9822000.0
9822,9822999,20.763333698268095,37.77400083404937,0.07565967223254377,3750.56591629982,766.6904623508453,2842.4549598693848,40066,9947,30119,30119,0,23,9823000.0
9823,9823999,20.763442280420424,37.77388312459379,0.0756618500699594,3750.924486398697,766.7560374736786,2842.6408500671387,40066,9947,30119,30119,0,23,9824000.0
9824,9824999,20.763602070862042,37.773812466905156,0.07565038713313232,3751.408397436142,766.8225781917572,2842.394458770752,40069,9948,30121,30121,0,23,9825000.0
9825,9825999,20.76368502128514,37.773548243033396,0.0756387187160753,3751.9207348823547,766.8885424137115,2842.1438941955566,40073,9949,30124,30124,0,23,9826000.0
9826,9826999,20.763686839581354,37.77318948324532,0.07563008488902634,3752.3517858982086,766.9538190364838,2842.664867401123,40090,9950,30140,30140,0,23,9827000.0
9827,9827999,20.762887976559053,37.77190575004946,0.0756321697685377,3752.488228082657,767.0166599750519,2844.443904876709,40098,9950,30148,30148,0,23,9828000.0
9828,9828999,20.76207448401461,37.7708827746869,0.07563608921377785,3752.778068780899,767.0801076889038,2845.532642364502,40102,9951,30151,30151,0,23,9829000.0
9829,9829999,20.761272171634268,37.769803906744,0.07563770572977768,3753.167474746704,767.1433169841766,2845.964900970459,40106,9952,30154,30154,0,23,9830000.0
9830,9830999,20.760466468658137,37.76840717304509,0.07564121659616618,3753.7358639240265,767.2081015110016,2845.9860038757324,40114,9955,30159,30159,0,23,9831000.0
9831,9831999,20.759666106088737,37.767146062559796,0.0756441276383426,3753.9338603019714,767.2720921039581,2846.977153778076,40114,9955,30159,30159,0,23,9832000.0
9832,9832999,20.758944037833476,37.76576313581958,0.07564611505635244,3754.5636167526245,767.3366811275482,2846.82857131958,40130,9958,30172,30172,0,23,9833000.0
9833,9833999,20.75814749175042,37.76449887727489,0.07564818438321996,3755.0927724838257,767.4019069671631,2847.104274749756,40137,9961,30176,30176,0,23,9834000.0
9834,9834999,20.757438710507436,37.76315025865189,0.07564907960241896,3755.4425070285797,767.466584444046,2847.6638221740723,40139,9962,30177,30177,0,23,9835000.0
9835,9835999,20.75670938805256,37.76182857544181,0.07565084006757594,3755.8592092990875,767.5305693149567,2848.087230682373,40143,9964,30179,30179,0,23,9836000.0
9836,9836999,20.756160755303313,37.76083894576546,0.07564890245750933,3756.0985260009766,767.5947940349579,2848.8169898986816,40143,9964,30179,30179,0,23,9837000.0
9837,9837999,20.755557857837907,37.75987429165472,0.0756487927421372,3756.5479352474213,767.6596620082855,2849.106243133545,40149,9966,30183,30183,0,23,9838000.0
9838,9838999,20.755105232910278,37.7590813640063,0.0756476537077454,3757.0884807109833,767.7245137691498,2848.7604026794434,40151,9967,30184,30184,0,23,9839000.0
9839,9839999,20.754557019973483,37.758041630029695,0.07564904684531737,3757.739462852478,767.7888996601105,2848.4054527282715,40157,9970,30187,30187,0,23,9840000.0
9840,9840999,20.754016894101145,37.757013182445704,0.07564921849311768,3757.9870109558105,767.8520834445953,2849.2335929870605,40157,9970,30187,30187,0,23,9841000.0
9841,9841999,20.75361890384968,37.756135734842005,0.07564877808299775,3758.226347208023,767.9150545597076,2849.931324005127,40157,9970,30187,30187,0,23,9842000.0
9842,9842999,20.75356920190604,37.755997241578015,0.07564298202409481,3758.5387551784515,767.9784078598022,2850.304431915283,40157,9970,30187,30187,0,23,9843000.0
9843,9843999,20.753524765441654,37.755824066637146,0.07564151328319946,3759.1782314777374,768.0432546138763,2849.9603843688965,40163,9973,30190,30190,0,23,9844000.0
9844,9844999,20.753625504641057,37.75582482894898,0.07563967376476644,3759.5190801620483,768.1081364154816,2850.561290740967,40165,9974,30191,30191,0,23,9845000.0
9845,9845999,20.753583702237155,37.75552577953109,0.07564041941215327,3759.7954893112183,768.1723546981812,2851.1703758239746,40165,9974,30191,30191,0,23,9846000.0
9846,9846999,20.753041654874295,37.754532871625074,0.07564169580139968,3760.18993806839,768.2367305755615,2852.0651359558105,40189,9975,30214,30214,0,23,9847000.0
9847,9847999,20.752398725447943,37.753756393394326,0.07564002540066095,3760.4818875789642,768.3012118339539,2853.2452812194824,40192,9976,30216,30216,0,23,9848000.0
9848,9848999,20.75183236187859,37.752617489551405,0.0756400780530142,3760.735219478607,768.365965127945,2854.3161125183105,40194,9977,30217,30217,0,23,9849000.0
9849,9849999,20.751552383382254,37.75218421111663,0.07563779747850874,3760.9885795116425,768.429322719574,2854.9957542419434,40194,9977,30217,30217,0,23,9850000.0
9850,9850999,20.751164594493176,37.75122082615101,0.07563716797083142,3761.3872866630554,768.4929995536804,2855.487735748291,40198,9979,30219,30219,0,23,9851000.0
9851,9851999,20.75104404400757,37.75067607955351,0.07563380368142691,3761.9520242214203,768.5606541633606,2855.3026847839355,40202,9981,30221,30221,0,23,9852000.0
9852,9852999,20.75085448995786,37.75004095072822,0.0756339812342951,3762.293479681015,768.6265115737915,2855.8421592712402,40204,9982,30222,30222,0,23,9853000.0
9853,9853999,20.75071601028453,37.7494548263715,0.075632472829684,3762.695151090622,768.6910643577576,2856.3308753967285,40216,9984,30232,30232,0,23,9854000.0
9854,9854999,20.75057730533083,37.74878103678873,0.0756326955963178,3763.1830191612244,768.7553882598877,2856.4391288757324,40220,9986,30234,30234,0,23,9855000.0
9855,9855999,20.750379074262803,37.748035193346844,0.07563254715182144,3763.7705194950104,768.8221011161804,2856.3971824645996,40224,9988,30236,30236,0,23,9856000.0
9856,9856999,20.75011963246249,37.74720112296995,0.07563062833066625,3764.0007638931274,768.8860061168671,2857.1180458068848,40224,9988,30236,30236,0,23,9857000.0
9857,9857999,20.749946215733523,37.746436656469875,0.07562342134324462,3764.3950560092926,768.9526832103729,2857.3153114318848,40226,9989,30237,30237,0,23,9858000.0
9858,9858999,20.749748432451927,37.74559275117989,0.07562006405838162,3764.941185951233,769.0179159641266,2857.081684112549,40230,9991,30239,30239,0,23,9859000.0
9859,9859999,20.749559244325212,37.74486433442712,0.07561779831626592,3765.1788308620453,769.0847775936127,2857.7423210144043,40230,9991,30239,30239,0,23,9860000.0
9860,9860999,20.749582633315995,37.74685378770813,0.07560672463189866,3765.4624693393707,769.1509861946106,2858.1883964538574,40230,9991,30239,30239,0,23,9861000.0
9861,9861999,20.749398025028437,37.74602581390063,0.07560072403002949,3765.8278300762177,769.217574596405,2858.473918914795,40232,9992,30240,30240,0,23,9862000.0
9862,9862999,20.749226297660716,37.74513176520013,0.0755942730042819,3766.3764004707336,769.2844021320343,2857.900722503662,40234,9993,30241,30241,0,23,9863000.0
9863,9863999,20.74911884231627,37.744560450015385,0.07559155191300704,3766.7921562194824,769.3513190746307,2858.0788230895996,40236,9994,30242,30242,0,23,9864000.0
9864,9864999,20.748828204423,37.743624607374265,0.07558901016415887,3767.225916147232,769.4170663356781,2858.043254852295,40238,9995,30243,30243,0,23,9865000.0
9865,9865999,20.74839462890421,37.74260549006872,0.07559152543836589,3767.656687259674,769.4845747947693,2858.0776405334473,40240,9996,30244,30244,0,23,9866000.0
9866,9866999,20.74810226950375,37.74257044594673,0.07558522512737298,3767.8503251075745,769.5511472225189,2859.6783561706543,40260,9996,30264,30264,0,23,9867000.0
9867,9867999,20.74752533079846,37.741466263557925,0.07557940343819702,3768.3091809749603,769.6169118881226,2860.2928504943848,40268,9998,30270,30270,0,23,9868000.0
9868,9868999,20.746898851130876,37.7402062261995,0.07557616766266106,3768.7117359638214,769.6857898235321,2861.2087593078613,40282,10000,30282,30282,0,23,9869000.0
9869,9869999,20.746472772044843,37.739217585814146,0.07556469388844533,3768.9831433296204,769.7532482147217,2862.1604347229004,40284,10001,30283,30283,0,23,9870000.0
9870,9870999,20.745920811913038,37.73891508227876,0.07555422283870072,3769.5433208942413,769.8210949897766,2862.296802520752,40291,10004,30287,30287,0,23,9871000.0
9871,9871999,20.74547062129093,37.73798409482847,0.07554412675500699,3769.920164823532,769.8877432346344,2862.7655906677246,40293,10005,30288,30288,0,23,9872000.0
9872,9872999,20.74497653653558,37.736967947060336,0.07553564982369132,3770.345807313919,769.9552574157715,2862.9845390319824,40295,10006,30289,30289,0,23,9873000.0
9873,9873999,20.744511633292436,37.73628347039646,0.07552674144241855,3770.7241775989532,770.0239107608795,2863.4251823425293,40297,10007,30290,30290,0,23,9874000.0
9874,9874999,20.744047400663003,37.73513832552035,0.07552092233259633,3771.0412197113037,770.0913317203522,2864.0333366394043,40299,10008,30291,30291,0,23,9875000.0
9875,9875999,20.74374277749122,37.73462590527751,0.07550874989647638,3771.400048971176,770.1576704978943,2864.424503326416,40302,10009,30293,30293,0,23,9876000.0
9876,9876999,20.743433351401716,37.7337452830343,0.07549909814214384,3771.8890426158905,770.227019071579,2864.2386360168457,40304,10010,30294,30294,0,23,9877000.0
9877,9877999,20.743170476901547,37.733193847872634,0.07549002554851247,3772.2858324050903,770.2946922779083,2864.4796714782715,40306,10011,30295,30295,0,23,9878000.0
9878,9878999,20.74297714696665,37.73267422155296,0.07547631050624903,3772.7670142650604,770.36327958107,2864.260486602783,40308,10012,30296,30296,0,23,9879000.0
9879,9879999,20.742696010453656,37.73181826447608,0.07546851123925258,3773.338128089905,770.4308524131775,2864.0366554260254,40314,10014,30300,30300,0,23,9880000.0
9880,9880999,20.74254895889807,37.73202572312026,0.07545743317784348,3773.846260070801,770.4993832111359,2864.086658477783,40318,10016,30302,30302,0,23,9881000.0
9881,9881999,20.742397094470824,37.731303847547004,0.07544777382802992,3774.13360953331,770.5689361095428,2864.5406379699707,40318,10016,30302,30302,0,23,9882000.0
9882,9882999,20.742241943740215,37.73045218806518,0.0754424680140161,3774.5717363357544,770.6376104354858,2864.5107231140137,40320,10017,30303,30303,0,23,9883000.0
9883,9883999,20.742041038559247,37.72973154314064,0.07543775953977239,3774.9509932994843,770.7055222988129,2864.6816749572754,40320,10017,30303,30303,0,23,9884000.0
9884,9884999,20.741789760051365,37.72878634957462,0.07543231334673706,3775.261624097824,770.7747938632965,2865.303150177002,40322,10018,30304,30304,0,23,9885000.0
9885,9885999,20.741656895458927,37.728031391461684,0.07542564039695354,3775.5834238529205,770.8430116176605,2865.5452842712402,40322,10018,30304,30304,0,23,9886000.0
9886,9886999,20.74131010986396,37.72759653263113,0.07541574900608317,3775.9036769866943,770.9097921848297,2866.2775230407715,40335,10018,30317,30317,0,23,9887000.0
9887,9887999,20.740793738179665,37.72786064679451,0.07540172580271398,3776.2125976085663,770.9709734916687,2867.200107574463,40343,10019,30324,30324,0,23,9888000.0
9888,9888999,20.74027020283659,37.726786889232,0.07539002553122531,3776.5167965888977,771.0326523780823,2868.147487640381,40348,10020,30328,30328,0,23,9889000.0
9889,9889999,20.739944089788857,37.7259353373969,0.07537713208776764,3776.9681267738342,771.0965342521667,2868.5754432678223,40354,10022,30332,30332,0,23,9890000.0
9890,9890999,20.739580734862844,37.72498288443813,0.07536502921218424,3777.117000579834,771.1594882011414,2869.8221702575684,40354,10022,30332,30332,0,23,9891000.0
9891,9891999,20.739354550703663,37.72417186512865,0.07535424124160583,3777.5440368652344,771.2241177558899,2870.0472984313965,40356,10023,30333,30333,0,23,9892000.0
9892,9892999,20.739049835177855,37.7232375659868,0.07534334793554742,3777.9258699417114,771.2897751331329,2870.6536750793457,40360,10025,30335,30335,0,23,9893000.0
9893,9893999,20.739105618770246,37.723960437271806,0.07532432808355216,3778.576746940613,771.3540298938751,2870.555332183838,40370,10029,30341,30341,0,23,9894000.0
9894,9894999,20.73895936193732,37.72341136338776,0.07532466026746454,3778.7958533763885,771.4172792434692,2871.4356956481934,40370,10029,30341,30341,0,23,9895000.0
9895,9895999,20.738800798549878,37.72280302848105,0.07532955197242197,3779.326028585434,771.4826076030731,2871.5696983337402,40376,10032,30344,30344,0,23,9896000.0
9896,9896999,20.738918561408607,37.72286093823132,0.07533585458861347,3779.6070725917816,771.5472111701965,2872.049129486084,40376,10032,30344,30344,0,23,9897000.0
9897,9897999,20.739192605439246,37.72318818731745,0.07535782513586164,3780.017992258072,771.6115520000458,2871.8528785705566,40376,10032,30344,30344,0,23,9898000.0
9898,9898999,20.73964336826191,37.724684899715456,0.07535604472775381,3780.338661670685,771.6767280101776,2872.1295127868652,40376,10032,30344,30344,0,23,9899000.0
9899,9899999,20.740160467202024,37.725658566901075,0.07536633959672145,3780.8007786273956,771.7401304244995,2872.0928535461426,40379,10033,30346,30346,0,23,9900000.0
9900,9900999,20.740667832979316,37.72757868729539,0.07537745753903013,3781.438299179077,771.8050668239594,2871.9168739318848,40387,10036,30351,30351,0,23,9901000.0
9901,9901999,20.74121080893259,37.72814429452871,0.0754071581639949,3781.7540185451508,771.8682491779327,2872.4633445739746,40389,10037,30352,30352,0,23,9902000.0
9902,9902999,20.741826280428537,37.72877080522027,0.07542136503863073,3782.3401045799255,771.9333693981171,2872.133716583252,40393,10039,30354,30354,0,23,9903000.0
9903,9903999,20.742285165262793,37.728902628989786,0.07544957498780425,3782.6639981269836,771.9993407726288,2872.5141944885254,40393,10039,30354,30354,0,23,9904000.0
9904,9904999,20.742940713813695,37.730055471622165,0.07546510216973334,3783.053768157959,772.0643126964569,2872.685558319092,40395,10040,30355,30355,0,23,9905000.0
9905,9905999,20.74350155715707,37.73043852011216,0.0754767904278485,3783.3787653446198,772.1294264793396,2872.988697052002,40396,10040,30356,30356,0,23,9906000.0
9906,9906999,20.74365681355165,37.73033878582765,0.07548028214905456,3783.6216926574707,772.1930663585663,2873.72562789917,40396,10040,30356,30356,0,23,9907000.0
9907,9907999,20.743070632385145,37.72961678182301,0.07547548175483709,3784.002930164337,772.2680702209473,2875.1992149353027,40425,10042,30383,30383,0,23,9908000.0
9908,9908999,20.74242780620207,37.72860795848327,0.0754735243365614,3784.1823465824127,772.3336746692657,2876.5188179016113,40425,10042,30383,30383,0,23,9909000.0
9909,9909999,20.74190216968517,37.728008631090745,0.0754718589472394,3784.553109407425,772.3993234634399,2876.9986305236816,40430,10043,30387,30387,0,23,9910000.0
9910,9910999,20.741234446015593,37.72701527328306,0.07547392187037705,3784.8766758441925,772.4657583236694,2877.3882331848145,40431,10043,30388,30388,0,23,9911000.0
9911,9911999,20.740503067160564,37.72571317207047,0.07547841255674625,3785.1961097717285,772.5305564403534,2877.6373023986816,40432,10043,30389,30389,0,23,9912000.0
9912,9912999,20.73973746023384,37.72442564563893,0.07548053004237654,3785.8718242645264,772.5977981090546,2877.3818702697754,40458,10046,30412,30412,0,23,9913000.0
9913,9913999,20.73915164589704,37.72404948238555,0.07547814282287613,3786.211484670639,772.6637320518494,2877.9661445617676,40460,10047,30413,30413,0,23,9914000.0
9914,9914999,20.738464070172306,37.72302436832519,0.07547898556138755,3786.5146145820618,772.7298443317413,2878.5959663391113,40462,10048,30414,30414,0,23,9915000.0
9915,9915999,20.737770682239926,37.72185616775414,0.0754795414808388,3786.7432086467743,772.7957739830017,2879.285259246826,40462,10048,30414,30414,0,23,9916000.0
9916,9916999,20.73711201944914,37.72074815151447,0.07548244507760382,3787.1389343738556,772.8619832992554,2879.4342918395996,40465,10049,30416,30416,0,23,9917000.0
9917,9917999,20.73647269728094,37.71977707380007,0.07548375399717222,3787.727869987488,772.9290387630463,2878.9641075134277,40471,10051,30420,30420,0,23,9918000.0
9918,9918999,20.73603087573516,37.7190543884711,0.07548208053946359,3788.0501050949097,772.9944627285004,2879.3362998962402,40471,10051,30420,30420,0,23,9919000.0
9919,9919999,20.735475079427545,37.71786290798666,0.07548831730510175,3788.3723289966583,773.0613181591034,2879.564556121826,40471,10051,30420,30420,0,23,9920000.0
9920,9920999,20.734996534519535,37.71688907196197,0.07549115825085861,3788.647192001343,773.1268150806427,2880.0252952575684,40472,10051,30421,30421,0,23,9921000.0
9921,9921999,20.734442045664018,37.715639185279194,0.0754957149040385,3789.09179854393,773.1955416202545,2880.0208320617676,40474,10052,30422,30422,0,23,9922000.0
9922,9922999,20.733847972389583,37.71436150007077,0.07550250528064961,3789.4871468544006,773.2616882324219,2880.217311859131,40478,10053,30425,30425,0,23,9923000.0
9923,9923999,20.73317056558821,37.713097655550236,0.07550971755570535,3790.062176465988,773.328531742096,2880.100482940674,40487,10056,30431,30431,0,23,9924000.0
9924,9924999,20.732298138930382,37.71171518090797,0.07551350460545303,3790.4390194416046,773.3932993412018,2881.0996055603027,40505,10057,30448,30448,0,23,9925000.0
9925,9925999,20.731554083327858,37.71057813952396,0.07551988551610889,3790.807662963867,773.4576971530914,2882.0048332214355,40512,10059,30453,30453,0,23,9926000.0
9926,9926999,20.730795151192652,37.709644241572896,0.07552333971612202,3791.039243221283,773.5231575965881,2882.8847846984863,40512,10059,30453,30453,0,23,9927000.0
9927,9927999,20.730012320193865,37.70827210964308,0.07552833098673628,3791.3107800483704,773.5870888233185,2883.516300201416,40512,10059,30453,30453,0,23,9928000.0
9928,9928999,20.729228416454486,37.70696181641103,0.07553411535482946,3791.607741355896,773.6514475345612,2884.1751823425293,40515,10060,30455,30455,0,23,9929000.0
9929,9929999,20.72844596994372,37.70565155172541,0.07553876431102424,3792.018853187561,773.7154994010925,2884.515651702881,40519,10062,30457,30457,0,23,9930000.0
9930,9930999,20.727714085559118,37.70439830143493,0.07554272324924172,3792.463549375534,773.7817234992981,2884.7908973693848,40524,10064,30460,30460,0,23,9931000.0
9931,9931999,20.7270362085549,37.70326063540424,0.07554347547037277,3792.9551763534546,773.8484201431274,2885.067096710205,40528,10066,30462,30462,0,23,9932000.0
9932,9932999,20.72644252412143,37.70229532688887,0.07554187100623488,3793.3511741161346,773.9165961742401,2885.557216644287,40530,10067,30463,30463,0,23,9933000.0
9933,9933999,20.726012770779466,37.7015322918396,0.07553882420667002,3793.799701690674,773.9814093112946,2885.521068572998,40532,10068,30464,30464,0,23,9934000.0
9934,9934999,20.725672536921717,37.70091329303294,0.0755385348799239,3794.1292259693146,774.0477590560913,2885.8386573791504,40532,10068,30464,30464,0,23,9935000.0
9935,9935999,20.725339644663045,37.70060752389711,0.0755374310665281,3794.474529504776,774.1148200035095,2886.3491172790527,40534,10069,30465,30465,0,23,9936000.0
9936,9936999,20.725167877698365,37.70021842572578,0.07553054508041701,3794.831151485443,774.179904460907,2886.526035308838,40534,10069,30465,30465,0,23,9937000.0
9937,9937999,20.725101587290833,37.70003325444401,0.07552626265172613,3795.2808401584625,774.2473900318146,2886.516368865967,40536,10070,30466,30466,0,23,9938000.0
9938,9938999,20.72522660797226,37.70010548953991,0.07552022472581732,3795.8746111392975,774.3129005432129,2886.284938812256,40558,10073,30485,30485,0,23,9939000.0
9939,9939999,20.725305942662867,37.700283121628985,0.0755159227231944,3796.196193218231,774.3814375400543,2887.247043609619,40560,10074,30486,30486,0,23,9940000.0
9940,9940999,20.72531636450665,37.70005932468704,0.07551132145466555,3796.8350536823273,774.4486494064331,2887.1736488342285,40570,10077,30493,30493,0,23,9941000.0
9941,9941999,20.725439258380014,37.70044525188409,0.07550113021156646,3797.184843301773,774.5149261951447,2887.7870445251465,40572,10078,30494,30494,0,23,9942000.0
9942,9942999,20.725195875916466,37.69977914481455,0.07549502543879894,3797.459525823593,774.5805819034576,2888.410747528076,40572,10078,30494,30494,0,23,9943000.0
9943,9943999,20.724522027536086,37.69876631489623,0.07549662489173348,3797.9335289001465,774.6500697135925,2889.408992767334,40601,10079,30522,30522,0,23,9944000.0
9944,9944999,20.723744874740223,37.69767225329728,0.07549670460491364,3798.124952316284,774.7151069641113,2890.6617317199707,40602,10079,30523,30523,0,23,9945000.0
9945,9945999,20.72308862209998,37.69681944603174,0.07549509946671462,3798.6239466667175,774.7814362049103,2890.8563499450684,40607,10081,30526,30526,0,23,9946000.0
9946,9946999,20.7223345740772,37.6954812000371,0.07549683425281106,3799.1369276046753,774.8476476669312,2890.971866607666,40611,10083,30528,30528,0,23,9947000.0
9947,9947999,20.721728654187636,37.694355625774236,0.0754951859293218,3799.4345524311066,774.912752866745,2891.7072257995605,40613,10084,30529,30529,0,23,9948000.0
9948,9948999,20.721036631347772,37.69315186024533,0.0754956109083389,3799.923789024353,774.9795968532562,2891.781063079834,40619,10086,30533,30533,0,23,9949000.0
9949,9949999,20.720364173767365,37.692007033934324,0.07549784597142306,3800.2887754440308,775.0537443161011,2892.1691703796387,40619,10086,30533,30533,0,23,9950000.0
9950,9950999,20.719773347907342,37.69104038996487,0.0754980251731272,3800.694974422455,775.1207182407379,2892.4205360412598,40622,10087,30535,30535,0,23,9951000.0
9951,9951999,20.71933847068863,37.69059661470001,0.07549412493326602,3801.174826860428,775.189918756485,2892.7153129577637,40628,10089,30539,30539,0,23,9952000.0
9952,9952999,20.718880857374565,37.68980809497394,0.07549205736646958,3801.524571418762,775.257541179657,2893.0414085388184,40632,10090,30542,30542,0,23,9953000.0
9953,9953999,20.718359505201445,37.68880155306405,0.07549463960147285,3801.8841931819916,775.3266780376434,2893.476703643799,40634,10091,30543,30543,0,23,9954000.0
9954,9954999,20.718047576397133,37.6881818807435,0.07549809292550413,3802.271867752075,775.3941171169281,2893.735164642334,40636,10092,30544,30544,0,23,9955000.0
9955,9955999,20.717675553849052,37.68737000911067,0.07549776314446499,3802.71661400795,775.4642095565796,2893.900646209717,40638,10093,30545,30545,0,23,9956000.0
9956,9956999,20.717345795707566,37.68692049587405,0.07549528027601071,3803.230268716812,775.5330440998077,2893.887035369873,40646,10095,30551,30551,0,23,9957000.0
9957,9957999,20.717007431851513,37.686181494030784,0.075495415720775,3803.4270734786987,775.6004753112793,2894.6567039489746,40646,10095,30551,30551,0,23,9958000.0
9958,9958999,20.716735900466283,37.68566057774799,0.07549694738579404,3803.754255771637,775.6699726581573,2894.8011054992676,40646,10095,30551,30551,0,23,9959000.0
9959,9959999,20.716560925925183,37.68495557991717,0.07549615764921669,3804.242807865143,775.741400718689,2894.679302215576,40648,10096,30552,30552,0,23,9960000.0
9960,9960999,20.716110512728605,37.68389727030671,0.07549854675503065,3804.803916454315,775.8114809989929,2894.0472679138184,40651,10097,30554,30554,0,23,9961000.0
9961,9961999,20.715773337014603,37.68311139461808,0.07549860849640921,3805.303219795227,775.8798677921295,2894.135227203369,40655,10099,30556,30556,0,23,9962000.0
9962,9962999,20.71535595454005,37.6821288619001,0.07549820081089065,3805.7450139522552,775.9479534626007,2894.6320762634277,40669,10101,30568,30568,0,23,9963000.0
9963,9963999,20.714786999524506,37.681123717066924,0.0754952174432808,3806.0287244319916,776.0113060474396,2895.7076835632324,40682,10101,30581,30581,0,23,9964000.0
9964,9964999,20.713869997295244,37.679718974461615,0.07549608058547475,3806.2824182510376,776.0735189914703,2896.9056663513184,40688,10102,30586,30586,0,23,9965000.0
9965,9965999,20.713000641696688,37.67847144304925,0.07549784994634057,3806.5387523174286,776.13440990448,2897.8499183654785,40692,10103,30589,30589,0,23,9966000.0
9966,9966999,20.712205651305716,37.677259609808594,0.07549963205097387,3807.0658247470856,776.1982626914978,2897.907138824463,40697,10105,30592,30592,0,23,9967000.0
9967,9967999,20.711549575388375,37.676536255978846,0.07549749011953111,3807.4114487171173,776.2629730701447,2898.4254417419434,40699,10106,30593,30593,0,23,9968000.0
9968,9968999,20.710749691961972,37.67521862247834,0.07549997398077635,3807.7495913505554,776.3254101276398,2898.8743629455566,40701,10107,30594,30594,0,23,9969000.0
9969,9969999,20.709967578148568,37.673872647813475,0.07550162164720864,3808.2000539302826,776.3870656490326,2899.1077308654785,40705,10109,30596,30596,0,23,9970000.0
9970,9970999,20.709380681524294,37.673098588699396,0.07550005589203179,3808.7645630836487,776.4499871730804,2899.09370803833,40713,10112,30601,30601,0,23,9971000.0
9971,9971999,20.708807877841295,37.67210312746462,0.07549903793810664,3809.259484052658,776.5124385356903,2899.134250640869,40717,10114,30603,30603,0,23,9972000.0
9972,9972999,20.70835520202558,37.671451723528136,0.07549841775383603,3809.82036113739,776.5769875049591,2899.2381172180176,40725,10117,30608,30608,0,23,9973000.0
9973,9973999,20.708098774124604,37.671337681963216,0.0754976295549954,3810.1103324890137,776.6391439437866,2899.956775665283,40729,10118,30611,30611,0,23,9974000.0
9974,9974999,20.70774607034063,37.6706643346252,0.07549928080842572,3810.460871219635,776.7015404701233,2900.111171722412,40729,10118,30611,30611,0,23,9975000.0
9975,9975999,20.707515068644334,37.6703288708021,0.07549625846472607,3810.991571187973,776.7670905590057,2900.2241859436035,40739,10121,30618,30618,0,23,9976000.0
9976,9976999,20.707819482484016,37.67101850589794,0.07549229307255612,3811.4087805747986,776.8322043418884,2900.6392250061035,40743,10123,30620,30620,0,23,9977000.0
9977,9977999,20.70819674147534,37.67204686628798,0.07549472405356039,3811.8670275211334,776.8956654071808,2900.598773956299,40747,10124,30623,30623,0,23,9978000.0
9978,9978999,20.708858015681297,37.673413390551815,0.07549567115735045,3812.148474216461,776.9599163532257,2901.133502960205,40747,10124,30623,30623,0,23,9979000.0
9979,9979999,20.709649992419045,37.67449498681635,0.07549500849064217,3812.4115827083588,777.0241808891296,2901.5918159484863,40747,10124,30623,30623,0,23,9980000.0
9980,9980999,20.71035029308354,37.67545415832197,0.07549101770464695,3812.9293508529663,777.088180065155,2901.2484016418457,40749,10125,30624,30624,0,23,9981000.0
9981,9981999,20.71144504318664,37.67704489359945,0.07548844584479819,3813.2465476989746,777.1531412601471,2901.713878631592,40749,10125,30624,30624,0,23,9982000.0
9982,9982999,20.712021809506343,37.677595420178356,0.07548253568375995,3813.6861503124237,777.217217206955,2901.7151527404785,40753,10126,30627,30627,0,23,9983000.0
9983,9983999,20.71175467897492,37.67698809339682,0.07547316096885792,3814.054122686386,777.285566329956,2902.9630851745605,40773,10128,30645,30645,0,23,9984000.0
9984,9984999,20.711115231151584,37.67620018495912,0.07546805701440906,3814.3028264045715,777.3500373363495,2904.24898147583,40775,10129,30646,30646,0,23,9985000.0
9985,9985999,20.710437482586094,37.67506469946556,0.07546350359261711,3814.6159460544586,777.4155178070068,2904.7302284240723,40775,10129,30646,30646,0,23,9986000.0
9986,9986999,20.709692303519255,37.673762090710845,0.07546407448799908,3814.878957748413,777.4819836616516,2905.3091621398926,40775,10129,30646,30646,0,23,9987000.0
9987,9987999,20.708997466683645,37.67246423420173,0.07546281089125129,3815.1346983909607,777.5477995872498,2905.8425483703613,40775,10129,30646,30646,0,23,9988000.0
9988,9988999,20.708341592078533,37.67147667074052,0.07546143270311101,3815.6615829467773,777.613710641861,2905.794261932373,40780,10131,30649,30649,0,23,9989000.0
9989,9989999,20.70758655119146,37.67007259202985,0.07546290206410655,3815.9990553855896,777.6782767772675,2906.2275886535645,40782,10132,30650,30650,0,23,9990000.0
9990,9990999,20.706941293071225,37.66898259323156,0.07546258554961172,3816.363998413086,777.7505741119385,2906.473575592041,40785,10133,30652,30652,0,23,9991000.0
9991,9991999,20.706436095202093,37.668032231184824,0.07546051379225682,3816.8441610336304,777.8179659843445,2906.684398651123,40789,10135,30654,30654,0,23,9992000.0
9992,9992999,20.705920048369553,37.668703388602474,0.0754505679989178,3817.3242897987366,777.8834459781647,2906.920566558838,40793,10137,30656,30656,0,23,9993000.0
9993,9993999,20.705464434046913,37.66773856606521,0.07544830726511098,3817.590005636215,777.9484918117523,2907.3999519348145,40793,10137,30656,30656,0,23,9994000.0
9994,9994999,20.70507111893229,37.6667563266778,0.07544498252792675,3818.095974445343,778.0141651630402,2907.4116249084473,40797,10139,30658,30658,0,23,9995000.0
9995,9995999,20.704549195566486,37.66564676524431,0.0754426099015092,3818.6963353157043,778.0809280872345,2906.950092315674,40804,10141,30663,30663,0,23,9996000.0
9996,9996999,20.704305628399553,37.66582143662163,0.0754319749761847,3819.12797498703,778.1461596488953,2907.045551300049,40808,10142,30666,30666,0,23,9997000.0
9997,9997999,20.70392301339915,37.66504378164476,0.07542918399643095,3819.460030555725,778.2148821353912,2907.2804832458496,40808,10142,30666,30666,0,23,9998000.0
9998,9998999,20.70349029470567,37.6640528123071,0.0754262764440824,3820.019063234329,778.2808485031128,2907.010684967041,40812,10144,30668,30668,0,23,9999000.0
9999,9999999,20.70327812550035,37.663312114402295,0.07542007654018434,3820.2592272758484,778.3472557067871,2907.670696258545,40812,10144,30668,30668,0,23,10000000.0
10000,10000999,20.702973998298877,37.66241133980113,0.07541681788818899,3820.751019001007,778.4131815433502,2907.4548530578613,40816,10145,30671,30671,0,23,10001000.0
10001,10001999,20.70268834290018,37.661634818720806,0.0754123764679786,3821.075282096863,778.4798305034637,2907.778423309326,40816,10145,30671,30671,0,23,10002000.0
10002,10002999,20.702236655634056,37.66057035789962,0.07540903963165912,3821.583453655243,778.5471608638763,2907.2244758605957,40816,10145,30671,30671,0,23,10003000.0
10003,10003999,20.70158782682713,37.659451921079956,0.07540146800562864,3822.0468487739563,778.6158480644226,2908.163242340088,40833,10147,30686,30686,0,23,10004000.0
10004,10004999,20.700845748987938,37.65854099221542,0.07539688318085747,3822.286972284317,778.6842706203461,2909.119441986084,40833,10147,30686,30686,0,23,10005000.0
10005,10005999,20.700059280931004,37.657507616310404,0.0753956353988211,3822.7088260650635,778.7583589553833,2909.582378387451,40835,10148,30687,30687,0,23,10006000.0
10006,10006999,20.699532935258627,37.657171279209884,0.0753885868164964,3822.9184761047363,778.8338742256165,2910.597873687744,40836,10148,30688,30688,0,23,10007000.0
10007,10007999,20.699002117731666,37.65618137525474,0.07538619114684941,3823.147672176361,778.902024269104,2911.2270011901855,40836,10148,30688,30688,0,23,10008000.0
10008,10008999,20.69833574000694,37.655151369333836,0.07538312554979087,3823.7543914318085,778.9710986614227,2911.031467437744,40842,10151,30691,30691,0,23,10009000.0
10009,10009999,20.69800384249296,37.654765972572086,0.0753751245536406,3824.1681287288666,779.0399878025055,2911.825023651123,40860,10153,30707,30707,0,23,10010000.0
10010,10010999,20.697625628284847,37.65433294145557,0.07536768540197603,3824.4953706264496,779.1208503246307,2912.690044403076,40862,10154,30708,30708,0,23,10011000.0
10011,10011999,20.69756861029,37.65484318001952,0.07535572358611475,3824.794140100479,779.1892116069794,2913.5275382995605,40864,10155,30709,30709,0,23,10012000.0
10012,10012999,20.697243569298518,37.65394979966608,0.07535085919582363,3824.9894115924835,779.2575314044952,2914.4474296569824,40864,10155,30709,30709,0,23,10013000.0
10013,10013999,20.697415729181724,37.65457538372247,0.07534398119830255,3825.305511713028,779.32777094841,2914.7129554748535,40864,10155,30709,30709,0,23,10014000.0
10014,10014999,20.697375040279006,37.65414847391331,0.07534707707353461,3825.5307655334473,779.3974506855011,2915.4420433044434,40864,10155,30709,30709,0,23,10015000.0
10015,10015999,20.697449703946745,37.65384983160691,0.07534512223026224,3826.2306258678436,779.4689736366272,2914.5596504211426,40868,10157,30711,30711,0,23,10016000.0
10016,10016999,20.697785351045454,37.65407221123975,0.07534828100071067,3826.4724481105804,779.5384719371796,2915.2436180114746,40868,10157,30711,30711,0,23,10017000.0
10017,10017999,20.698064239926243,37.65403395382143,0.07535048279781509,3826.9716279506683,779.614542722702,2915.1651344299316,40871,10158,30713,30713,0,23,10018000.0
10018,10018999,20.698493567755705,37.6544229055835,0.07535406765673758,3827.5665516853333,779.6850798130035,2914.785343170166,40875,10160,30715,30715,0,23,10019000.0
10019,10019999,20.699026741799372,37.654960718516165,0.0753568952613175,3827.9214487075806,779.7555027008057,2915.3268699645996,40877,10161,30716,30716,0,23,10020000.0
10020,10020999,20.69960395234216,37.655214315621016,0.07536047811754909,3828.4471061229706,779.8268580436707,2915.227024078369,40881,10163,30718,30718,0,23,10021000.0
10021,10021999,20.700132363084105,37.65530676206068,0.07536334668348488,3828.736303091049,779.8996422290802,2915.636692047119,40881,10163,30718,30718,0,23,10022000.0
10022,10022999,20.700518675009437,37.655162876596236,0.07536404373580885,3829.289032936096,779.9699263572693,2915.378719329834,40885,10165,30720,30720,0,23,10023000.0
10023,10023999,20.700451134337392,37.6545558369784,0.07536135140591149,3829.5867862701416,780.0364122390747,2916.608860015869,40912,10166,30746,30746,0,23,10024000.0
10024,10024999,20.69954008684659,37.65335116092841,0.07536303996916194,3829.8369946479797,780.0985958576202,2917.4235191345215,40916,10166,30750,30750,0,23,10025000.0
10025,10025999,20.698937067784872,37.653212255985366,0.0753576485273405,3830.1530623435974,780.15980052948,2918.312244415283,40922,10167,30755,30755,0,23,10026000.0
10026,10026999,20.698150684198282,37.652468448838405,0.07535539104408517,3830.546671152115,780.2240605354309,2919.0151176452637,40928,10169,30759,30759,0,23,10027000.0
10027,10027999,20.69745467899235,37.65120140271592,0.07535495470404785,3830.6967375278473,780.2878046035767,2920.2830238342285,40928,10169,30759,30759,0,23,10028000.0
10028,10028999,20.69671358868929,37.64995881605721,0.07535360084096498,3831.0051848888397,780.3501770496368,2921.114490509033,40933,10170,30763,30763,0,23,10029000.0
10029,10029999,20.696025696868816,37.64877216571298,0.07535372699988774,3831.54487156868,780.4135909080505,2921.267520904541,40942,10173,30769,30769,0,23,10030000.0
10030,10030999,20.695467862958665,37.64772786634231,0.07535113652034175,3831.946794986725,780.4774966239929,2921.582462310791,40944,10174,30770,30770,0,23,10031000.0
10031,10031999,20.69494892598374,37.64839687915444,0.07534117088478465,3832.423863172531,780.5420529842377,2921.8752937316895,40948,10176,30772,30772,0,23,10032000.0
10032,10032999,20.69445920245114,37.64738913799113,0.07533739809599349,3832.7053780555725,780.6063377857208,2922.4506797790527,40948,10176,30772,30772,0,23,10033000.0
10033,10033999,20.694075258788104,37.646575886655185,0.07533521145399491,3833.240562915802,780.6698186397552,2922.404064178467,40954,10178,30776,30776,0,23,10034000.0
10034,10034999,20.69391684500138,37.64614485997467,0.07532982856163462,3833.5879583358765,780.7352635860443,2923.049617767334,40957,10179,30778,30778,0,23,10035000.0
10035,10035999,20.69364483167445,37.64548126991985,0.07532536343614005,3834.098302602768,780.7997403144836,2923.1909980773926,40971,10181,30790,30790,0,23,10036000.0
10036,10036999,20.693719574150546,37.645435283255935,0.0753192474547768,3834.3323006629944,780.863828420639,2923.9259452819824,40971,10181,30790,30790,0,23,10037000.0
10037,10037999,20.693742956755095,37.64523814870596,0.07531240134831396,3834.933189868927,780.9316456317902,2923.7675743103027,40979,10184,30795,30795,0,23,10038000.0
10038,10038999,20.69376478304211,37.644794780569555,0.07530806756696284,3835.2894752025604,780.9958109855652,2924.194965362549,40981,10185,30796,30796,0,23,10039000.0
10039,10039999,20.694105394365888,37.64488339102181,0.07530154540790324,3835.896964073181,781.0623879432678,2924.013515472412,40989,10188,30801,30801,0,23,10040000.0
10040,10040999,20.69434159325034,37.64457179068471,0.07529734925261444,3836.2158176898956,781.1320905685425,2924.560085296631,40989,10188,30801,30801,0,23,10041000.0
10041,10041999,20.694476972137625,37.644159973813885,0.07529429912224705,3836.5573835372925,781.1963837146759,2924.8240242004395,40989,10188,30801,30801,0,23,10042000.0
10042,10042999,20.694663803364534,37.643820836256864,0.07528952805147127,3837.180830001831,781.2615325450897,2924.610195159912,40999,10191,30808,30808,0,23,10043000.0
10043,10043999,20.694714203400505,37.64416703056097,0.07528505101508498,3837.577218055725,781.328188419342,2924.94388961792,41001,10192,30809,30809,0,23,10044000.0
10044,10044999,20.694056733143697,37.642957555490966,0.07528670631783263,3837.8401362895966,781.3945529460907,2926.3138847351074,41011,10193,30818,30818,0,23,10045000.0
10045,10045999,20.69359548081008,37.643318039502205,0.07528073606859254,3838.125846385956,781.4638447761536,2927.0568199157715,41011,10193,30818,30818,0,23,10046000.0
10046,10046999,20.692840837143997,37.64191748181919,0.07528429611304066,3838.421709060669,781.5316891670227,2927.7477989196777,41013,10193,30820,30820,0,23,10047000.0
10047,10047999,20.69220836647913,37.640810860720926,0.07528726425650756,3838.791104078293,781.6016199588776,2928.260753631592,41018,10194,30824,30824,0,23,10048000.0
10048,10048999,20.691683204463587,37.64124813152897,0.07528205134545929,3839.231271982193,781.6699798107147,2928.589641571045,41033,10195,30838,30838,0,23,10049000.0
10049,10049999,20.69120252877355,37.640446831212266,0.07528090675711985,3839.4970183372498,781.7395894527435,2929.865520477295,41036,10196,30840,30840,0,23,10050000.0
10050,10050999,20.690716127766642,37.63949430572312,0.07527920022839696,3839.8574364185333,781.8092334270477,2930.382999420166,41038,10197,30841,30841,0,23,10051000.0
10051,10051999,20.69025210266201,37.63864660772069,0.07527848290866679,3840.3203592300415,781.8800802230835,2930.7548179626465,41042,10199,30843,30843,0,23,10052000.0
10052,10052999,20.689687995501266,37.63746829694772,0.07527925741785169,3840.559827566147,781.9515376091003,2931.5312309265137,41042,10199,30843,30843,0,23,10053000.0
10053,10053999,20.689415442438023,37.63694006131409,0.07527575154629795,3841.0652079582214,782.0217876434326,2931.5400199890137,41046,10201,30845,30845,0,23,10054000.0
10054,10054999,20.68898128019735,37.635926687993134,0.07527809957105003,3841.5376284122467,782.093325138092,2931.461582183838,41050,10202,30848,30848,0,23,10055000.0
10055,10055999,20.688557163826747,37.63506669063806,0.07528125789624063,3842.049166917801,782.1645987033844,2931.666645050049,41056,10204,30852,30852,0,23,10056000.0
10056,10056999,20.68814471742208,37.63396466488482,0.0752833108131582,3842.2566859722137,782.2351140975952,2932.567279815674,41056,10204,30852,30852,0,23,10057000.0
10057,10057999,20.687769000321655,37.63286307643657,0.07528692063021414,3842.725101709366,782.3052515983582,2932.2654609680176,41056,10204,30852,30852,0,23,10058000.0
10058,10058999,20.687507828804062,37.63188818341925,0.07529170544888808,3843.0489404201508,782.3756124973297,2932.5973320007324,41056,10204,30852,30852,0,23,10059000.0
10059,10059999,20.687169711705277,37.630816893817965,0.07529471364366336,3843.3772761821747,782.4461591243744,2932.8782691955566,41056,10204,30852,30852,0,23,10060000.0
10060,10060999,20.686746917784795,37.62965046733286,0.07529919418452413,3843.987249851227,782.5170986652374,2932.8597450256348,41072,10206,30866,30866,0,23,10061000.0
10061,10061999,20.686056671778623,37.62916604969961,0.07530580002059462,3844.2576899528503,782.5802142620087,2933.9493293762207,41080,10206,30874,30874,0,23,10062000.0
10062,10062999,20.685388569276256,37.627999859835114,0.07531650516893751,3844.3988893032074,782.6440541744232,2935.4029655456543,41080,10206,30874,30874,0,23,10063000.0
10063,10063999,20.68471145100679,37.62680652799956,0.07532521253054147,3844.6836161613464,782.707117319107,2936.3543968200684,41082,10207,30875,30875,0,23,10064000.0
10064,10064999,20.683901822475303,37.625433079082974,0.07533869476100863,3845.0765619277954,782.7725491523743,2936.9824256896973,41089,10209,30880,30880,0,23,10065000.0
10065,10065999,20.683157879752397,37.62419026899522,0.07534781322706141,3845.5446174144745,782.8365812301636,2937.2462272644043,41093,10211,30882,30882,0,23,10066000.0
10066,10066999,20.68237573841881,37.62290476854251,0.07535702032011504,3846.1978175640106,782.9037799835205,2937.138126373291,41100,10214,30886,30886,0,23,10067000.0
10067,10067999,20.681647768332518,37.62193634025578,0.07536260440034848,3846.383831501007,782.970282793045,2938.1079597473145,41100,10214,30886,30886,0,23,10068000.0
10068,10068999,20.680968182520363,37.62092410527675,0.0753672375120501,3846.830971479416,783.0367588996887,2938.1950492858887,41102,10215,30887,30887,0,23,10069000.0
10069,10069999,20.68022109667637,37.6197396072281,0.07537712722200651,3847.0280163288116,783.1024549007416,2939.0993156433105,41102,10215,30887,30887,0,23,10070000.0
10070,10070999,20.679625796984805,37.61861469231965,0.07538530263471821,3847.6137187480927,783.1681907176971,2938.978733062744,41108,10218,30890,30890,0,23,10071000.0
10071,10071999,20.678997352836113,37.61746509753839,0.07539496296094905,3848.348628282547,783.2351377010345,2938.7286491394043,41127,10222,30905,30905,0,23,10072000.0
10072,10072999,20.67849296129318,37.61649400798939,0.07540007825605177,3849.0489060878754,783.3000392913818,2938.378894805908,41133,10225,30908,30908,0,23,10073000.0
10073,10073999,20.67794854036348,37.61532255658122,0.07540567747540883,3849.323829650879,783.3639748096466,2939.0824012756348,41133,10225,30908,30908,0,23,10074000.0
10074,10074999,20.677425456403903,37.61425235099803,0.07541262453839093,3849.5707972049713,783.4290907382965,2939.858425140381,41133,10225,30908,30908,0,23,10075000.0
10075,10075999,20.676884677615668,37.61312272600509,0.0754185874737271,3850.010920524597,783.4935352802277,2939.995838165283,41135,10226,30909,30909,0,23,10076000.0
10076,10076999,20.676259878269043,37.61230905904023,0.07542319765898009,3850.331596851349,783.5603811740875,2940.722682952881,41137,10227,30910,30910,0,23,10077000.0
10077,10077999,20.675700405434505,37.6115674350929,0.07542272981069953,3850.5697226524353,783.6257569789886,2942.302822113037,41160,10227,30933,30933,0,23,10078000.0
10078,10078999,20.675065362317262,37.61063520133667,0.07542501538579971,3850.7400233745575,783.6907532215118,2943.788356781006,41161,10227,30934,30934,0,23,10079000.0
10079,10079999,20.674289962200483,37.60926426492094,0.07543257998712039,3850.919899702072,783.7566714286804,2944.9323768615723,41161,10227,30934,30934,0,23,10080000.0
10080,10080999,20.673678008135543,37.60829036454194,0.07543639777997668,3851.144005537033,783.8222396373749,2945.686580657959,41161,10227,30934,30934,0,23,10081000.0
10081,10081999,20.672983966724164,37.60716722946478,0.07544249771225298,3851.514251470566,783.8869833946228,2946.0407676696777,41163,10228,30935,30935,0,23,10082000.0
10082,10082999,20.672386508965815,37.60624990543762,0.07544420265301954,3851.950521469116,783.9523847103119,2946.3051414489746,41167,10230,30937,30937,0,23,10083000.0
10083,10083999,20.671709679975947,37.60544602799138,0.07544573147144262,3852.3868284225464,784.0191059112549,2946.607738494873,41171,10232,30939,30939,0,23,10084000.0
10084,10084999,20.671157282346055,37.60470074589374,0.07544294934133478,3852.828722715378,784.0848519802094,2946.954662322998,41175,10234,30941,30941,0,23,10085000.0
10085,10085999,20.67060965736247,37.603876301226265,0.07544159821983609,3853.1178979873657,784.1565883159637,2947.490161895752,41175,10234,30941,30941,0,23,10086000.0
10086,10086999,20.6699519163607,37.60279208309212,0.0754441317919815,3853.8628854751587,784.2265176773071,2946.9900856018066,41185,10238,30947,30947,0,23,10087000.0
10087,10087999,20.669495477971747,37.60210720544366,0.07544653653960942,3854.3787608146667,784.2937269210815,2946.8978691101074,41189,10240,30949,30949,0,23,10088000.0
10088,10088999,20.669000663264008,37.60168541794872,0.07544312089210725,3854.6366741657257,784.3611268997192,2947.5803565979004,41189,10240,30949,30949,0,23,10089000.0
10089,10089999,20.668414990488817,37.600484294503055,0.07544677559593338,3854.9932250976562,784.4279270172119,2948.028835296631,41191,10241,30950,30950,0,23,10090000.0
10090,10090999,20.667931773905543,37.59956576928726,0.07544550651517767,3855.518898010254,784.4944479465485,2947.6161003112793,41193,10242,30951,30951,0,23,10091000.0
10091,10091999,20.667513684729,37.598859889973745,0.07544211257038358,3855.956501722336,784.56063580513,2947.6963691711426,41197,10243,30954,30954,0,23,10092000.0
10092,10092999,20.66704321318528,37.59797677288284,0.07544011416171625,3856.332406759262,784.628968000412,2947.8833198547363,41197,10243,30954,30954,0,23,10093000.0
10093,10093999,20.66663601753563,37.597821513970125,0.07543330347243193,3856.6023287773132,784.6958427429199,2948.5898399353027,41198,10244,30954,30954,0,23,10094000.0
10094,10094999,20.666037384832798,37.59663022504586,0.07543183530468789,3856.8340044021606,784.7628228664398,2949.202564239502,41198,10244,30954,30954,0,23,10095000.0
10095,10095999,20.665492852291035,37.595847082666886,0.07542804172765893,3857.2318341732025,784.8294169902802,2949.02388381958,41198,10244,30954,30954,0,23,10096000.0
10096,10096999,20.664966884819496,37.595381819334534,0.07542854292579149,3857.7059359550476,784.893604516983,2949.791400909424,41217,10246,30971,30971,0,23,10097000.0
10097,10097999,20.66408366106281,37.59403140066356,0.07543224446866814,3858.0169792175293,784.9570863246918,2950.5392875671387,41219,10246,30973,30973,0,23,10098000.0
10098,10098999,20.66330376969109,37.59292285206858,0.07543415882558102,3858.2054512500763,785.0196666717529,2951.6505851745605,41219,10246,30973,30973,0,23,10099000.0
10099,10099999,20.662591116069443,37.591912649738354,0.07543548198582195,3858.609513282776,785.0814321041107,2952.174549102783,41225,10248,30977,30977,0,23,10100000.0
10100,10100999,20.662159346955235,37.59172504090547,0.07543039129898521,3859.2442638874054,785.1445772647858,2952.0027351379395,41231,10251,30980,30980,0,23,10101000.0
10101,10101999,20.661660710972786,37.59178128239507,0.07542648437512367,3859.713056087494,785.2080829143524,2952.3400840759277,41237,10253,30984,30984,0,23,10102000.0
10102,10102999,20.661380728793663,37.592648945080775,0.07542048027682235,3859.977843284607,785.2695488929749,2953.2741355895996,41239,10254,30985,30985,0,23,10103000.0
10103,10103999,20.661610375083693,37.59523262511861,0.07541605806830176,3860.518318414688,785.3322994709015,2953.345157623291,41250,10257,30993,30993,0,23,10104000.0
10104,10104999,20.66193575240854,37.59733751948713,0.07541666147327153,3861.038863658905,785.3971762657166,2953.499614715576,41254,10259,30995,30995,0,23,10105000.0
10105,10105999,20.662172683818955,37.598844585019656,0.07543086828317902,3861.4193301200867,785.4596529006958,2953.9226722717285,41256,10260,30996,30996,0,23,10106000.0
10106,10106999,20.663010497486002,37.60262222936376,0.07542839367271159,3861.8266174793243,785.5242385864258,2954.2046089172363,41258,10261,30997,30997,0,23,10107000.0
10107,10107999,20.663829453851573,37.6057990209381,0.07543258739027947,3862.3586795330048,785.5918157100677,2954.2305335998535,41264,10263,31001,31001,0,23,10108000.0
10108,10108999,20.66495375927749,37.60942763741343,0.07543228335545027,3862.6712567806244,785.6551644802094,2954.7647438049316,41266,10264,31002,31002,0,23,10109000.0
10109,10109999,20.666107914599767,37.61335959302447,0.0754364609666428,3863.1854898929596,785.7199592590332,2955.0537757873535,41272,10267,31005,31005,0,23,10110000.0
10110,10110999,20.66772151043685,37.61905711115553,0.07542393651275325,3863.6507420539856,785.7878568172455,2955.1698417663574,41274,10268,31006,31006,0,23,10111000.0
10111,10111999,20.669485488586623,37.62501101366651,0.07542572316818541,3864.074252843857,785.8522045612335,2955.5422706604004,41278,10270,31008,31008,0,23,10112000.0
10112,10112999,20.67108776090074,37.628411881455776,0.07543481130136187,3864.562268257141,785.9170453548431,2955.373218536377,41282,10271,31011,31011,0,23,10113000.0
10113,10113999,20.672497708315422,37.63101967100315,0.0754594890222392,3864.9884371757507,785.9828226566315,2955.318347930908,41282,10271,31011,31011,0,23,10114000.0
10114,10114999,20.673675574754178,37.63284122613971,0.07546754707188463,3865.299142599106,786.0487661361694,2955.7977409362793,41282,10271,31011,31011,0,23,10115000.0
10115,10115999,20.674389193598525,37.63413611729459,0.07546845017326442,3865.695913553238,786.1127753257751,2956.2977027893066,41288,10273,31015,31015,0,23,10116000.0
10116,10116999,20.673932245466588,37.63348865029703,0.07546777483369638,3865.9949588775635,786.178145647049,2957.832004547119,41318,10274,31044,31044,0,23,10117000.0
10117,10117999,20.673421228832577,37.633160007973075,0.07546583225159675,3866.247444152832,786.2440073490143,2959.06107711792,41321,10275,31046,31046,0,23,10118000.0
10118,10118999,20.672633086137083,37.63187342351242,0.0754702952454559,3866.471189260483,786.3091154098511,2959.8523597717285,41322,10275,31047,31047,0,23,10119000.0
10119,10119999,20.67200294552719,37.630753286285255,0.0754717539043881,3866.6665358543396,786.3731136322021,2960.7100715637207,41322,10275,31047,31047,0,23,10120000.0
10120,10120999,20.67139189939224,37.6299160318402,0.07547098684513698,3867.3170125484467,786.4396357536316,2960.387607574463,41331,10278,31053,31053,0,23,10121000.0
10121,10121999,20.670604162091454,37.62850196225825,0.07547525592393767,3867.742134809494,786.5064613819122,2960.753391265869,41333,10279,31054,31054,0,23,10122000.0
10122,10122999,20.66985721829779,37.627217113401976,0.07547813663081127,3867.9391882419586,786.5720915794373,2961.6076850891113,41333,10279,31054,31054,0,23,10123000.0
10123,10123999,20.66927054804983,37.62618966758434,0.07547875569528573,3868.2763543128967,786.6372117996216,2962.0562324523926,41345,10280,31065,31065,0,23,10124000.0
10124,10124999,20.668566334701268,37.62495691425834,0.07548238644760696,3868.7089343070984,786.7028203010559,2962.1063957214355,41347,10281,31066,31066,0,23,10125000.0
10125,10125999,20.668047029352177,37.62391493361871,0.07548104876223183,3869.393500328064,786.769109249115,2961.8167457580566,41365,10285,31080,31080,0,23,10126000.0
10126,10126999,20.66737463709176,37.622746360753524,0.07548286378289104,3870.169636964798,786.8385841846466,2961.212879180908,41383,10289,31094,31094,0,23,10127000.0
10127,10127999,20.666738853663734,37.62162715643308,0.07548313680732532,3870.7167234420776,786.9077830314636,2961.2503700256348,41387,10291,31096,31096,0,23,10128000.0
10128,10128999,20.6662775859317,37.6210111006943,0.0754822740182266,3870.9875943660736,786.9758906364441,2961.879741668701,41387,10291,31096,31096,0,23,10129000.0
10129,10129999,20.665718071055068,37.619822793202786,0.07548490770416783,3871.2225081920624,787.0437111854553,2962.603343963623,41387,10291,31096,31096,0,23,10130000.0
10130,10130999,20.665356218837886,37.618977188488124,0.07548371486900562,3871.506111383438,787.1118543148041,2962.997745513916,41387,10291,31096,31096,0,23,10131000.0
10131,10131999,20.664984974806902,37.6181921360522,0.07547912461088357,3872.087655544281,787.17959856987,2962.9089012145996,41395,10294,31101,31101,0,23,10132000.0
10132,10132999,20.664601638951968,37.61720160891056,0.07547935405976025,3872.4072885513306,787.2463614940643,2963.2640800476074,41395,10294,31101,31101,0,23,10133000.0
10133,10133999,20.664174297896814,37.616268563427234,0.07547922644267135,3872.788157224655,787.3157165050507,2963.2464866638184,41395,10294,31101,31101,0,23,10134000.0
10134,10134999,20.66378513050207,37.61538637080198,0.07547669426441894,3873.1741387844086,787.383807182312,2963.290470123291,41395,10294,31101,31101,0,23,10135000.0
10135,10135999,20.663181443951792,37.61425741756637,0.0754767654441556,3873.5681755542755,787.4499816894531,2963.5767250061035,41397,10295,31102,31102,0,23,10136000.0
10136,10136999,20.66247856347469,37.6129525263747,0.07548068824776821,3873.7148694992065,787.5183527469635,2965.325298309326,41407,10295,31112,31112,0,23,10137000.0
10137,10137999,20.661858163576543,37.61191363032293,0.07547308071702963,3873.863311290741,787.5830719470978,2966.561450958252,41407,10295,31112,31112,0,23,10138000.0
10138,10138999,20.66112860524486,37.61066969948355,0.0754732835814832,3874.3708164691925,787.6485552787781,2966.4493675231934,41409,10296,31113,31113,0,23,10139000.0
10139,10139999,20.66037816831409,37.609641194414884,0.07547238278747825,3874.576303958893,787.7134830951691,2967.374279022217,41410,10296,31114,31114,0,23,10140000.0
10140,10140999,20.65969917869949,37.608392221476265,0.07547174269051127,3874.910760164261,787.7794942855835,2968.019817352295,41413,10297,31116,31116,0,23,10141000.0
10141,10141999,20.658983619812314,37.60726988486275,0.07547253448797175,3875.2128751277924,787.8468799591064,2968.3809547424316,41413,10297,31116,31116,0,23,10142000.0
10142,10142999,20.658533855317728,37.60626481077589,0.07546609294840456,3875.567912340164,787.9136433601379,2968.704357147217,41415,10298,31117,31117,0,23,10143000.0
10143,10143999,20.657832811943283,37.60494848017133,0.07546585963304242,3876.1422386169434,787.9817757606506,2968.536319732666,41421,10301,31120,31120,0,23,10144000.0
10144,10144999,20.657301174884914,37.604071106483474,0.07546366266103832,3876.727826356888,788.0497136116028,2968.2764015197754,41426,10303,31123,31123,0,23,10145000.0
10145,10145999,20.656722293260984,37.603036185432096,0.07546565500081892,3877.1788437366486,788.1175768375397,2968.700580596924,41431,10305,31126,31126,0,23,10146000.0
10146,10146999,20.65611000503081,37.60195974321394,0.07546740521756445,3877.9109835624695,788.1870949268341,2968.03706741333,41449,10308,31141,31141,0,23,10147000.0
10147,10147999,20.65563186241399,37.601167954542625,0.07546692462070392,3878.142378091812,788.255285024643,2968.8346061706543,41449,10308,31141,31141,0,23,10148000.0
10148,10148999,20.65506022371523,37.60015015484613,0.07546568662120867,3878.3375549316406,788.3214929103851,2969.622081756592,41449,10308,31141,31141,0,23,10149000.0
10149,10149999,20.654515029052543,37.59905922539752,0.0754657402184219,3878.7424988746643,788.388153553009,2969.3731803894043,41449,10308,31141,31141,0,23,10150000.0
10150,10150999,20.654129982968247,37.59838320628065,0.07546293398296211,3879.1887776851654,788.4558997154236,2969.266429901123,41451,10309,31142,31142,0,23,10151000.0
10151,10151999,20.65366228220366,37.597451237990384,0.07546379404260484,3879.579228401184,788.5240585803986,2969.323024749756,41451,10309,31142,31142,0,23,10152000.0
10152,10152999,20.653245167911436,37.596467528169335,0.0754616081719689,3879.864363193512,788.5912420749664,2969.732967376709,41451,10309,31142,31142,0,23,10153000.0
10153,10153999,20.652950237734338,37.5957525607949,0.07545837154111168,3880.3351686000824,788.6600394248962,2969.95121383667,41466,10311,31155,31155,0,23,10154000.0
10154,10154999,20.652507145847185,37.59469973318489,0.07545752653040982,3880.699090719223,788.7272691726685,2969.9709815979004,41466,10311,31155,31155,0,23,10155000.0
10155,10155999,20.651932747827587,37.593510361843464,0.07545780992624973,3881.024137020111,788.7942228317261,2970.2100410461426,41466,10311,31155,31155,0,23,10156000.0
10156,10156999,20.651495635535227,37.59247499228253,0.07545855316597772,3881.42280125618,788.85879778862,2970.7420082092285,41477,10312,31165,31165,0,23,10157000.0
10157,10157999,20.650779752562826,37.59117066627132,0.07546163380543858,3881.5934221744537,788.9212870597839,2971.943874359131,41480,10312,31168,31168,0,23,10158000.0
10158,10158999,20.650129078742644,37.5899312301517,0.07546391957429632,3882.1195244789124,788.9832375049591,2972.0395011901855,41494,10314,31180,31180,0,23,10159000.0
10159,10159999,20.64972464075799,37.588903481040695,0.075462944541414,3882.691210269928,789.0472531318665,2972.1237297058105,41502,10317,31185,31185,0,23,10160000.0
10160,10160999,20.649282117092323,37.58780236519203,0.07546105550976379,3882.965614795685,789.1124637126923,2973.105854034424,41505,10318,31187,31187,0,23,10161000.0
10161,10161999,20.649132931698293,37.58743743455776,0.07545500052254228,3883.202760219574,789.1749589443207,2973.923671722412,41505,10318,31187,31187,0,23,10162000.0
10162,10162999,20.649165793202492,37.58724537830999,0.07545097981214677,3883.660040140152,789.2386033535004,2973.8623847961426,41507,10319,31188,31188,0,23,10163000.0
10163,10163999,20.649175274507645,37.58670953136219,0.07544711747334987,3884.0684525966644,789.301572561264,2974.0917472839355,41510,10320,31190,31190,0,23,10164000.0
10164,10164999,20.649157640651687,37.586227369258836,0.07544730754784512,3884.419176340103,789.3645949363708,2974.6161613464355,41512,10321,31191,31191,0,23,10165000.0
10165,10165999,20.64915418040477,37.58578937703791,0.07545349448644523,3885.2745633125305,789.4303510189056,2974.0759468078613,41531,10326,31205,31205,0,23,10166000.0
10166,10166999,20.649413944829597,37.58588681628971,0.07546748854652152,3885.5865185260773,789.4954025745392,2974.755626678467,41533,10327,31206,31206,0,23,10167000.0
10167,10167999,20.64964005235519,37.58595157219887,0.07548660924539263,3886.11957859993,789.5615859031677,2974.942111968994,41541,10330,31211,31211,0,23,10168000.0
10168,10168999,20.649678766680744,37.585651155657594,0.07550386129753506,3886.554635286331,789.6251313686371,2975.365894317627,41545,10332,31213,31213,0,23,10169000.0
10169,10169999,20.649823670669587,37.5857134745114,0.07551758254550234,3886.8775725364685,789.6881713867188,2975.6172523498535,41545,10332,31213,31213,0,23,10170000.0
10170,10170999,20.65001201650186,37.58568102628695,0.07552687559542792,3887.474722146988,789.7534458637238,2975.2103843688965,41550,10334,31216,31216,0,23,10171000.0
10171,10171999,20.650173265915917,37.585474820614586,0.07554283019442576,3887.9130506515503,789.8168480396271,2975.377056121826,41552,10335,31217,31217,0,23,10172000.0
10172,10172999,20.65047852524627,37.5855418557759,0.07555814301656938,3888.2646777629852,789.8807544708252,2976.0257835388184,41563,10336,31227,31227,0,23,10173000.0
10173,10173999,20.651028565854514,37.58603974340153,0.07556835262070394,3888.55610871315,789.9453356266022,2976.434726715088,41563,10336,31227,31227,0,23,10174000.0
10174,10174999,20.651504821115473,37.586285812837815,0.07557670430637364,3888.875931739807,790.0090262889862,2976.7093544006348,41563,10336,31227,31227,0,23,10175000.0
10175,10175999,20.651951485173893,37.586446740817536,0.07557727602603637,3889.1266407966614,790.0719470977783,2977.2386894226074,41563,10336,31227,31227,0,23,10176000.0
10176,10176999,20.652157492645284,37.586016796515196,0.07557240008786592,3889.6709411144257,790.1362340450287,2977.0253944396973,41565,10337,31228,31228,0,23,10177000.0
10177,10177999,20.652163602452266,37.585408327601414,0.07555181251733367,3890.233946800232,790.2027604579926,2977.503818511963,41571,10340,31231,31231,0,23,10178000.0
10178,10178999,20.65207049061664,37.585128230181496,0.07554398504221771,3890.5796904563904,790.2671992778778,2978.075366973877,41571,10340,31231,31231,0,23,10179000.0
10179,10179999,20.651877110123248,37.58435294672798,0.0755323668743908,3891.4152302742004,790.331796169281,2977.601100921631,41588,10345,31243,31243,0,23,10180000.0
10180,10180999,20.651566012689774,37.58335853540894,0.07552626724590805,3891.705850124359,790.3985087871552,2978.2271842956543,41588,10345,31243,31243,0,23,10181000.0
10181,10181999,20.651319942252144,37.58271864912032,0.07552034664516227,3907.2207424640656,790.4661419391632,2978.17777633667,41593,10347,31246,31246,0,23,10182000.0
10182,10182999,20.65130838035827,37.582445804005744,0.07550417893185513,3907.6096205711365,790.5316591262817,2978.7977409362793,41597,10349,31248,31248,0,23,10183000.0
10183,10183999,20.65128029855514,37.58235483944068,0.07549067972377121,3908.0805447101593,790.5959784984589,2979.032772064209,41601,10351,31250,31250,0,23,10184000.0
10184,10184999,20.651815037575428,37.583944458070086,0.07546676669541996,3908.634519815445,790.6641471385956,2978.9928855895996,41605,10353,31252,31252,0,23,10185000.0
10185,10185999,20.652496737727127,37.585439276933116,0.075446274924728,3909.0023953914642,790.7315413951874,2979.346035003662,41607,10354,31253,31253,0,23,10186000.0
10186,10186999,20.65332526176051,37.58714830443949,0.07542574027267046,3909.334959745407,790.7976264953613,2979.7174949645996,41607,10354,31253,31253,0,23,10187000.0
10187,10187999,20.65429083732981,37.58942838035919,0.0754066131486022,3909.8336942195892,790.8637797832489,2979.5441093444824,41609,10355,31254,31254,0,23,10188000.0
10188,10188999,20.65546598300352,37.59201708422483,0.07539291037437534,3910.270941734314,790.9296667575836,2979.980068206787,41613,10357,31256,31256,0,23,10189000.0
10189,10189999,20.656525612792677,37.59421687945937,0.0753781828232255,3910.807141304016,790.995317697525,2979.968318939209,41617,10359,31258,31258,0,23,10190000.0
10190,10190999,20.657834781522947,37.596998562205854,0.07536545061239575,3911.0972695350647,791.0598549842834,2980.460910797119,41617,10359,31258,31258,0,23,10191000.0
10191,10191999,20.658963319181044,37.59887158700875,0.07535449719136333,3911.6726303100586,791.1251494884491,2980.073703765869,41619,10360,31259,31259,0,23,10192000.0
10192,10192999,20.659838017105336,37.60032360083302,0.07534832788055046,3912.0359361171722,791.1923491954803,2980.5270500183105,41621,10361,31260,31260,0,23,10193000.0
10193,10193999,20.66002313864424,37.60094547789716,0.075341899791878,3912.349559545517,791.2571632862091,2981.5176124572754,41629,10362,31267,31267,0,23,10194000.0
10194,10194999,20.659542043931587,37.599971538143365,0.07533772491605517,3912.721744298935,791.3210334777832,2982.5323753356934,41634,10364,31270,31270,0,23,10195000.0
10195,10195999,20.658989861892326,37.59886752402021,0.07533621853018391,3913.0875804424286,791.3854711055756,2983.1443824768066,41636,10365,31271,31271,0,23,10196000.0
10196,10196999,20.658608679241933,37.59867174556246,0.07532849931319696,3913.5255019664764,791.4496467113495,2983.438648223877,41641,10367,31274,31274,0,23,10197000.0
10197,10197999,20.658110013237888,37.59768385204189,0.07532629262113122,3913.8605053424835,791.5147984027863,2983.773464202881,41641,10367,31274,31274,0,23,10198000.0
10198,10198999,20.657701847491765,37.59674423089334,0.07532093057783862,3914.2304170131683,791.5794012546539,2984.216396331787,41644,10368,31276,31276,0,23,10199000.0
10199,10199999,20.657121940203538,37.59566931753319,0.07531989623827084,3914.7304170131683,791.6433944702148,2984.0246238708496,41646,10369,31277,31277,0,23,10200000.0
10200,10200999,20.656780781173612,37.59507283579304,0.07531416395364787,3915.0319647789,791.7079641819,2984.7333183288574,41649,10370,31279,31279,0,23,10201000.0
10201,10201999,20.656324015024996,37.594193733034004,0.07530941627082055,3915.728618144989,791.7728562355042,2984.3245124816895,41659,10374,31285,31285,0,23,10202000.0
10202,10202999,20.655991653638576,37.59387584099676,0.07530521377027477,3915.9996457099915,791.8381445407867,2984.882266998291,41660,10374,31286,31286,0,23,10203000.0
10203,10203999,20.65557645032558,37.59290330968526,0.07530096836411826,3916.2764043807983,791.9024856090546,2985.3244590759277,41661,10374,31287,31287,0,23,10204000.0
10204,10204999,20.655436413828063,37.59266010349037,0.07529467171824789,3916.581784248352,791.9671890735626,2985.720027923584,41661,10374,31287,31287,0,23,10205000.0
10205,10205999,20.65530413758417,37.592348002501815,0.07528673825080245,3917.0581517219543,792.0313808917999,2985.5205726623535,41664,10375,31289,31289,0,23,10206000.0
10206,10206999,20.655223255697106,37.59217829893211,0.0752804838633353,3917.402302980423,792.0954349040985,2985.7722816467285,41664,10375,31289,31289,0,23,10207000.0
10207,10207999,20.655546363152823,37.59261499545328,0.07527443138912637,3917.784950017929,792.1602513790131,2986.2169075012207,41668,10377,31291,31291,0,23,10208000.0
10208,10208999,20.65580034192245,37.59367710252731,0.07526489097357081,3918.0090038776398,792.226069688797,2986.93208694458,41668,10377,31291,31291,0,23,10209000.0
10209,10209999,20.655987681166472,37.59368985308668,0.07525680829792081,3918.472528219223,792.2913494110107,2987.0320320129395,41672,10379,31293,31293,0,23,10210000.0
10210,10210999,20.65597519592836,37.59334953779057,0.07524731215226077,3918.864678621292,792.3569684028625,2987.0534477233887,41672,10379,31293,31293,0,23,10211000.0
10211,10211999,20.655971601084847,37.59288780238691,0.0752417978296176,3919.238859653473,792.4211311340332,2987.309253692627,41674,10380,31294,31294,0,23,10212000.0
10212,10212999,20.65572446261939,37.592003357794766,0.07523741736120071,3919.737100124359,792.48575091362,2987.0343437194824,41677,10381,31296,31296,0,23,10213000.0
10213,10213999,20.655206037711576,37.59120431936228,0.0752360940585296,3919.9990878105164,792.5514600276947,2988.6373329162598,41690,10382,31308,31308,0,23,10214000.0
10214,10214999,20.654527497333614,37.59023636210061,0.0752362266100789,3920.473153114319,792.6158716678619,2989.119052886963,41695,10384,31311,31311,0,23,10215000.0
10215,10215999,20.65388437689617,37.58902853834392,0.07523612359697718,3920.6712625026703,792.6815874576569,2990.2723426818848,41696,10384,31312,31312,0,23,10216000.0
10216,10216999,20.65335815007483,37.588179430682914,0.07523106284368009,3921.162952899933,792.7461409568787,2990.489101409912,41700,10386,31314,31314,0,23,10217000.0
10217,10217999,20.652843933051084,37.58705029472617,0.07522975449464586,3921.447362422943,792.8115808963776,2991.0444374084473,41700,10386,31314,31314,0,23,10218000.0
10218,10218999,20.652266435294543,37.58580292447706,0.0752286384630636,3921.829685688019,792.877198934555,2991.3586387634277,41702,10387,31315,31315,0,23,10219000.0
10219,10219999,20.65174345585348,37.584819544147734,0.07523117471713903,3922.2131350040436,792.9423131942749,2991.913730621338,41706,10389,31317,31317,0,23,10220000.0
10220,10220999,20.65119542119121,37.58386517765814,0.07523172372889231,3922.750566005707,793.0083086490631,2991.696880340576,41709,10390,31319,31319,0,23,10221000.0
10221,10221999,20.650574115284687,37.582702164300194,0.07523239234677459,3923.145573616028,793.0747168064117,2992.464687347412,41713,10392,31321,31321,0,23,10222000.0
10222,10222999,20.649975905862615,37.5816470742157,0.07523404903736586,3923.537536382675,793.1402056217194,2992.7210807800293,41715,10393,31322,31322,0,23,10223000.0
10223,10223999,20.649542342264947,37.58219313890359,0.07522685725935319,3923.930715560913,793.2049345970154,2992.989315032959,41717,10394,31323,31323,0,23,10224000.0
10224,10224999,20.64899170454931,37.581104733619036,0.0752307238047697,3924.5005950927734,793.2707931995392,2992.8634910583496,41721,10396,31325,31325,0,23,10225000.0
10225,10225999,20.64842212448467,37.580036560290516,0.0752319702837988,3924.7874054908752,793.3373003005981,2993.387134552002,41721,10396,31325,31325,0,23,10226000.0
10226,10226999,20.64788726451542,37.579194630964906,0.07523266214837232,3925.1894094944,793.404611825943,2993.611919403076,41724,10397,31327,31327,0,23,10227000.0
10227,10227999,20.64747031942646,37.57972599163561,0.0752271418139806,3925.5476241111755,793.4697172641754,2994.0607261657715,41726,10398,31328,31328,0,23,10228000.0
10228,10228999,20.64692979701253,37.57865509040013,0.07522829175096513,3925.930809020996,793.5369584560394,2994.332431793213,41728,10399,31329,31329,0,23,10229000.0
10229,10229999,20.646454356995605,37.577774896079276,0.07522930798744665,3926.2019345760345,793.6018273830414,2994.8266258239746,41728,10399,31329,31329,0,23,10230000.0
10230,10230999,20.645976275441143,37.57670239870412,0.07523138130489426,3926.5578894615173,793.6690361499786,2994.9845008850098,41728,10399,31329,31329,0,23,10231000.0
10231,10231999,20.645405521233474,37.57561968217456,0.07523378304004036,3926.9049940109253,793.7349636554718,2995.461353302002,41730,10400,31330,31330,0,23,10232000.0
10232,10232999,20.644879168011315,37.57460995856257,0.07523392000764151,3927.387566804886,793.8068931102753,2995.5002937316895,41732,10401,31331,31331,0,23,10233000.0
10233,10233999,20.644547419313792,37.574086640288385,0.07522433525283667,3927.8061153888702,793.8707120418549,2996.2437019348145,41748,10402,31346,31346,0,23,10234000.0
10234,10234999,20.644074139470654,37.57320273834486,0.07521474935098471,3928.0311353206635,793.9331080913544,2997.3793754577637,41749,10402,31347,31347,0,23,10235000.0
10235,10235999,20.643600975323203,37.57264519531662,0.07520645656487901,3928.5245118141174,793.9964158535004,2998.0030555725098,41756,10405,31351,31351,0,23,10236000.0
10236,10236999,20.643167961188556,37.571552798658665,0.07520362336392483,3928.9196133613586,794.0596470832825,2998.402072906494,41759,10406,31353,31353,0,23,10237000.0
10237,10237999,20.642734424627182,37.57068195609822,0.07520043909064567,3929.6247053146362,794.1222703456879,2998.0266609191895,41768,10410,31358,31358,0,23,10238000.0
10238,10238999,20.642336626959718,37.569894984221136,0.07519888871368341,3930.119247674942,794.1864819526672,2998.259624481201,41773,10412,31361,31361,0,23,10239000.0
10239,10239999,20.642023992754638,37.56917950494228,0.07519953021101056,3930.553282022476,794.2500650882721,2998.771213531494,41777,10414,31363,31363,0,23,10240000.0
10240,10240999,20.64178873467443,37.56897089902697,0.07520072337745931,3930.9181389808655,794.314207315445,2999.1758995056152,41780,10415,31365,31365,0,23,10241000.0
10241,10241999,20.64171939037665,37.56895369384649,0.07520235929042318,3931.391504764557,794.3790004253387,2999.0672645568848,41782,10416,31366,31366,0,23,10242000.0
10242,10242999,20.641863963609843,37.56914448084447,0.07521088984229973,3931.8182685375214,794.4415261745453,2999.2475242614746,41784,10417,31367,31367,0,23,10243000.0
10243,10243999,20.64221623451087,37.56938906634706,0.07522619264941077,3932.2082056999207,794.5041851997375,2999.573513031006,41786,10418,31368,31368,0,23,10244000.0
10244,10244999,20.642676594582333,37.56995146642693,0.07524079135278272,3932.7754290103912,794.5686874389648,2999.6576957702637,41793,10421,31372,31372,0,23,10245000.0
10245,10245999,20.64291915182735,37.569879084205866,0.07524943186561506,3933.0670256614685,794.6326079368591,3000.2086143493652,41793,10421,31372,31372,0,23,10246000.0
10246,10246999,20.64328262429422,37.5700077324609,0.07525869843700506,3933.342040538788,794.6961390972137,3000.801769256592,41793,10421,31372,31372,0,23,10247000.0
10247,10247999,20.643863279284297,37.57056172064403,0.07526983446852253,3933.743852376938,794.7615184783936,3000.969425201416,41795,10422,31373,31373,0,23,10248000.0
10248,10248999,20.64440367663964,37.57098985837547,0.07528233611248614,3934.248555660248,794.8262865543365,3001.0551414489746,41799,10424,31375,31375,0,23,10249000.0
10249,10249999,20.6448758207622,37.571349733142064,0.07529847052778449,3934.7866928577423,794.8905644416809,3000.635913848877,41801,10425,31376,31376,0,23,10250000.0
10250,10250999,20.645537723155243,37.572187233561834,0.07531310040585049,3935.1720776557922,794.9552528858185,3001.002643585205,41803,10426,31377,31377,0,23,10251000.0
10251,10251999,20.64597833018509,37.57241495059978,0.0753244364186394,3935.6734545230865,795.0203397274017,3001.2327003479004,41807,10428,31379,31379,0,23,10252000.0
10252,10252999,20.64631137014559,37.57333690146221,0.07532592513204717,3935.96258354187,795.0843296051025,3001.7209510803223,41807,10428,31379,31379,0,23,10253000.0
10253,10253999,20.645978799191347,37.572821155918234,0.07531436913769995,3936.2076518535614,795.1493153572083,3003.025905609131,41823,10428,31395,31395,0,23,10254000.0
10254,10254999,20.64544139087043,37.57202132662776,0.07531334076155405,3936.5265774726868,795.2155487537384,3003.7049522399902,41823,10428,31395,31395,0,23,10255000.0
10255,10255999,20.644947808007274,37.570965987017,0.07531240799153094,3936.73846077919,795.2795352935791,3004.726306915283,41823,10428,31395,31395,0,23,10256000.0
10256,10256999,20.644648498104203,37.570475646180974,0.07530668703211874,3937.2065563201904,795.3442649841309,3004.803035736084,41828,10429,31399,31399,0,23,10257000.0
10257,10257999,20.644400599989943,37.570583451974215,0.07530068369392096,3937.499925136566,795.4088711738586,3005.5329093933105,41830,10430,31400,31400,0,23,10258000.0
10258,10258999,20.64393405270305,37.56946879780342,0.07530077679223024,3937.8649668693542,795.4730536937714,3005.951244354248,41832,10431,31401,31401,0,23,10259000.0
10259,10259999,20.64360673249129,37.56868923627177,0.07529925410071359,3938.4897804260254,795.5396401882172,3005.755084991455,41838,10434,31404,31404,0,23,10260000.0
10260,10260999,20.643394978840302,37.56805185586933,0.07529798600614634,3938.8645129203796,795.603805065155,3006.3848915100098,41842,10436,31406,31406,0,23,10261000.0
10261,10261999,20.643261013485542,37.56751931721936,0.07529538286372406,3939.3956246376038,795.6691973209381,3006.3804817199707,41846,10438,31408,31408,0,23,10262000.0
10262,10262999,20.643304763460012,37.5671293758252,0.07530033863801033,3939.896330356598,795.735916852951,3006.500804901123,41850,10440,31410,31410,0,23,10263000.0
10263,10263999,20.643724938191106,37.56757516096252,0.07531013431435885,3940.2232642173767,795.8002486228943,3006.7956199645996,41850,10440,31410,31410,0,23,10264000.0
10264,10264999,20.64474868031679,37.57001418448765,0.07531825093567113,3940.753571987152,795.8688266277313,3006.8206062316895,41854,10442,31412,31412,0,23,10265000.0
10265,10265999,20.64589828299365,37.5724121706235,0.0753247049738891,3941.1322026252747,795.9335577487946,3007.4897117614746,41870,10444,31426,31426,0,23,10266000.0
10266,10266999,20.64718936047194,37.57525573001775,0.07533202239347181,3941.410455942154,795.9980988502502,3008.1668434143066,41870,10444,31426,31426,0,23,10267000.0
10267,10267999,20.648928388496508,37.57885994490722,0.075355534549994,3941.812641143799,796.0663805007935,3008.3418006896973,41873,10445,31428,31428,0,23,10268000.0
10268,10268999,20.65104534124738,37.58398590505743,0.07537581048908348,3942.199615955353,796.1306772232056,3008.4261741638184,41873,10445,31428,31428,0,23,10269000.0
10269,10269999,20.653094230760487,37.58858782691036,0.07539386799722392,3942.598668575287,796.1968507766724,3008.658702850342,41875,10446,31429,31429,0,23,10270000.0
10270,10270999,20.65517776471451,37.593401342834625,0.07542670487136316,3942.952549934387,796.2643332481384,3008.8972969055176,41875,10446,31429,31429,0,23,10271000.0
10271,10271999,20.657251798221456,37.5969348384299,0.0754594091375671,3943.5492839813232,796.3300821781158,3008.8291206359863,41881,10449,31432,31432,0,23,10272000.0
10272,10272999,20.658710971040634,37.599159162813834,0.07548477411736265,3943.931427717209,796.395608663559,3009.135753631592,41881,10449,31432,31432,0,23,10273000.0
10273,10273999,20.658459344699345,37.59902428168542,0.07547633101092666,3944.240114212036,796.466789484024,3010.409336090088,41892,10450,31442,31442,0,23,10274000.0
10274,10274999,20.658025395749434,37.59835904967095,0.07547148397293268,3944.4649188518524,796.5347266197205,3011.437397003174,41892,10450,31442,31442,0,23,10275000.0
10275,10275999,20.65776364200917,37.598137702750144,0.07546563801335637,3944.781913280487,796.6031918525696,3011.8747901916504,41892,10450,31442,31442,0,23,10276000.0
10276,10276999,20.65767051013976,37.59839636867401,0.07545734124351611,3945.3504135608673,796.6741938591003,3011.9651222229004,41900,10453,31447,31447,0,23,10277000.0
10277,10277999,20.657393940024203,37.59778252451066,0.0754542413268231,3945.7757198810577,796.748733997345,3012.1105995178223,41902,10454,31448,31448,0,23,10278000.0
10278,10278999,20.657045174446395,37.59702634522447,0.07545213625015701,3946.1989624500275,796.8197636604309,3013.072780609131,41932,10456,31476,31476,0,23,10279000.0
10279,10279999,20.6567896906012,37.59610261943391,0.07545132985602332,3946.5600707530975,796.8894233703613,3013.7826805114746,41935,10457,31478,31478,0,23,10280000.0
10280,10280999,20.656639772127647,37.595684090080084,0.07544856587204352,3946.8649072647095,796.9598376750946,3014.5723762512207,41937,10458,31479,31479,0,23,10281000.0
10281,10281999,20.65654101585851,37.59520242765413,0.07544576347161569,3947.254335165024,797.0301768779755,3015.1817741394043,41943,10460,31483,31483,0,23,10282000.0
10282,10282999,20.656558415381635,37.59488990769122,0.0754438943652388,3947.563107728958,797.1000154018402,3015.609951019287,41943,10460,31483,31483,0,23,10283000.0
10283,10283999,20.656649502079713,37.594821002406015,0.07544617582705648,3948.131016254425,797.1725378036499,3015.4306983947754,41947,10462,31485,31485,0,23,10284000.0
10284,10284999,20.656956316746708,37.59500873567173,0.07545011246912026,3948.415855884552,797.2415585517883,3016.1153297424316,41947,10462,31485,31485,0,23,10285000.0
10285,10285999,20.657255174425845,37.59552482231337,0.07545354957940797,3948.574646472931,797.3097937107086,3017.132671356201,41947,10462,31485,31485,0,23,10286000.0
10286,10286999,20.65773136612982,37.596098027277954,0.07545652574723882,3949.0057621002197,797.382007598877,3017.1777305603027,41949,10463,31486,31486,0,23,10287000.0
10287,10287999,20.65866944631145,37.598194840419474,0.07545604172683373,3949.509136199951,797.4525346755981,3016.9465522766113,41952,10464,31488,31488,0,23,10288000.0
10288,10288999,20.659571900359776,37.59940667878062,0.07546749857448476,3949.8393771648407,797.5216615200043,3017.251697540283,41952,10464,31488,31488,0,23,10289000.0
10289,10289999,20.66034118229113,37.60015206594986,0.07548274504434804,3950.1486263275146,797.5928382873535,3017.6855812072754,41952,10464,31488,31488,0,23,10290000.0
10290,10290999,20.661292627401195,37.600912010367,0.07549957974988086,3950.485908985138,797.6644117832184,3017.915714263916,41952,10464,31488,31488,0,23,10291000.0
10291,10291999,20.6623113912236,37.602887293551,0.0755017882225898,3950.9474527835846,797.7446746826172,3017.651065826416,41952,10464,31488,31488,0,23,10292000.0
10292,10292999,20.663503486342723,37.604714685417036,0.07550595136137261,3951.2264544963837,797.8148407936096,3018.2296028137207,41952,10464,31488,31488,0,23,10293000.0
10293,10293999,20.663516940364808,37.60512210970642,0.07550282245790374,3951.619326353073,797.8780510425568,3018.5810890197754,41958,10464,31494,31494,0,23,10294000.0
10294,10294999,20.662928058569214,37.60442876007079,0.07549776345085546,3951.8704483509064,797.9397711753845,3019.3851280212402,41961,10464,31497,31497,0,23,10295000.0
10295,10295999,20.662336553454793,37.60335197382288,0.07549548648733617,3952.4048607349396,798.0041754245758,3019.491222381592,41968,10466,31502,31502,0,23,10296000.0
10296,10296999,20.66194108527352,37.602726529821275,0.07549012386516196,3952.801910877228,798.0658864974976,3019.662395477295,41968,10466,31502,31502,0,23,10297000.0
10297,10297999,20.661580069147885,37.601879397237084,0.07548440379528187,3953.145501613617,798.1280741691589,3020.374858856201,41970,10467,31503,31503,0,23,10298000.0
10298,10298999,20.66120072629258,37.60106333489838,0.07548134928443373,3953.4871180057526,798.1969056129456,3021.085247039795,41973,10468,31505,31505,0,23,10299000.0
10299,10299999,20.66089485661239,37.600262175100376,0.07547586277967266,3953.919890165329,798.2624499797821,3021.4568824768066,41978,10470,31508,31508,0,23,10300000.0
10300,10300999,20.660609363705156,37.59938106577228,0.07547164932699146,3954.2128415107727,798.3259165287018,3021.9419288635254,41978,10470,31508,31508,0,23,10301000.0
10301,10301999,20.660500682736703,37.59880322150586,0.07547103028261881,3954.5319998264313,798.3915438652039,3022.500087738037,41983,10471,31512,31512,0,23,10302000.0
10302,10302999,20.66078673967057,37.59949145706138,0.0754688505273281,3955.1125922203064,798.4597709178925,3022.33353805542,41989,10473,31516,31516,0,23,10303000.0
10303,10303999,20.66151702625866,37.601006781195075,0.07547999394118554,3955.6640791893005,798.5250301361084,3022.2737159729004,41993,10475,31518,31518,0,23,10304000.0
10304,10304999,20.662597345903425,37.60353678572872,0.07550066076504125,3956.015836954117,798.588803768158,3022.7216835021973,41996,10476,31520,31520,0,23,10305000.0
10305,10305999,20.663397405502607,37.60487419316664,0.07551344296272255,3956.421064376831,798.6546986103058,3022.8409538269043,41999,10477,31522,31522,0,23,10306000.0
10306,10306999,20.66440846526285,37.60683724683055,0.0755229865041489,3956.9016304016113,798.7248165607452,3023.0850944519043,42004,10479,31525,31525,0,23,10307000.0
10307,10307999,20.665443137943633,37.608764837514485,0.075539902379816,3957.2866899967194,798.7895591259003,3023.1521034240723,42004,10479,31525,31525,0,23,10308000.0
10308,10308999,20.666506185500054,37.610642152705445,0.07556436081866336,3957.655497312546,798.8546984195709,3023.5620613098145,42007,10480,31527,31527,0,23,10309000.0
10309,10309999,20.667486567884765,37.61242689261383,0.07558787508952503,3957.8978910446167,798.9183444976807,3024.1341133117676,42007,10480,31527,31527,0,23,10310000.0
10310,10310999,20.668534813360914,37.614158106413,0.0756010629196382,3958.4897158145905,798.9827063083649,3024.022792816162,42015,10483,31532,31532,0,23,10311000.0
10311,10311999,20.669395876950883,37.61520837377017,0.07562308689859298,3958.949593067169,799.0467112064362,3024.103862762451,42017,10484,31533,31533,0,23,10312000.0
10312,10312999,20.67009380368971,37.61684148549009,0.07563597498903307,3959.4209322929382,799.110057592392,3024.2803840637207,42026,10486,31540,31540,0,23,10313000.0
10313,10313999,20.670150379188893,37.616587703049916,0.07563754248500121,3959.751846075058,799.1752271652222,3024.8834190368652,42028,10486,31542,31542,0,23,10314000.0
10314,10314999,20.669664036247983,37.615787258516036,0.07563801408388149,3960.101833343506,799.2415342330933,3025.6352729797363,42030,10487,31543,31543,0,23,10315000.0
10315,10315999,20.669231461203793,37.6154783734137,0.07563293061179233,3960.391767501831,799.3081188201904,3026.279125213623,42030,10487,31543,31543,0,23,10316000.0
10316,10316999,20.66904043459992,37.61578104447083,0.07562531705415498,3960.742376804352,799.3742260932922,3026.5977210998535,42030,10487,31543,31543,0,23,10317000.0
10317,10317999,20.668935223778494,37.616102797426095,0.07562006344892014,3961.0382239818573,799.4401278495789,3027.065502166748,42030,10487,31543,31543,0,23,10318000.0
10318,10318999,20.668796368273103,37.61614147531012,0.0756134126204061,3961.540887594223,799.5104916095734,3027.871349334717,42050,10490,31560,31560,0,23,10319000.0
10319,10319999,20.66876379753042,37.616088896149094,0.07560778997148954,3961.8600301742554,799.5773985385895,3028.633068084717,42053,10491,31562,31562,0,23,10320000.0
10320,10320999,20.668701532539163,37.615715445981884,0.07560760802895616,3962.1564087867737,799.6453204154968,3029.0795860290527,42054,10491,31563,31563,0,23,10321000.0
10321,10321999,20.668537454251624,37.615065621036244,0.07560867383710324,3962.563348054886,799.7141718864441,3029.0074501037598,42054,10491,31563,31563,0,23,10322000.0
10322,10322999,20.668537520146604,37.61464134441379,0.07560646736329213,3963.153549194336,799.7835762500763,3028.7373085021973,42069,10493,31576,31576,0,23,10323000.0
10323,10323999,20.668677097515328,37.61580476593299,0.07559992623955591,3963.4331645965576,799.8516411781311,3029.2892265319824,42069,10493,31576,31576,0,23,10324000.0
10324,10324999,20.66862901290546,37.61533427776333,0.07560022538694255,3963.9894626140594,799.9200947284698,3029.0222511291504,42073,10495,31578,31578,0,23,10325000.0
10325,10325999,20.66861093216555,37.61490337404898,0.07560083155459418,3964.3100254535675,799.9868907928467,3029.683681488037,42075,10496,31579,31579,0,23,10326000.0
10326,10326999,20.668912837978805,37.61666700309626,0.07559603985899754,3964.7995727062225,800.0557796955109,3029.5186195373535,42077,10497,31580,31580,0,23,10327000.0
10327,10327999,20.669234650892136,37.6169305184106,0.07559863008667356,3965.2090232372284,800.1234381198883,3029.4072074890137,42077,10497,31580,31580,0,23,10328000.0
10328,10328999,20.66950867487246,37.61677746338716,0.07559656436684437,3965.614480495453,800.1918473243713,3029.4482460021973,42077,10497,31580,31580,0,23,10329000.0
10329,10329999,20.67027827803609,37.61784939944801,0.07560005240855883,3965.926891565323,800.2582759857178,3030.109790802002,42079,10498,31581,31581,0,23,10330000.0
10330,10330999,20.670438678830738,37.6176297127029,0.07560360665042687,3966.2480092048645,800.3257555961609,3030.4104804992676,42079,10498,31581,31581,0,23,10331000.0
10331,10331999,20.67060947634469,37.61896254230041,0.07558286496959199,3966.7319984436035,800.3903908729553,3030.921443939209,42095,10499,31596,31596,0,23,10332000.0
10332,10332999,20.67042831627189,37.61847297538043,0.07557130422598668,3967.155216217041,800.4560647010803,3031.8840675354004,42101,10501,31600,31600,0,23,10333000.0
10333,10333999,20.670349620767563,37.61902173193108,0.07555623444441917,3967.3353469371796,800.5184638500214,3033.0345497131348,42101,10501,31600,31600,0,23,10334000.0
10334,10334999,20.67021059214839,37.61863732003984,0.07554572479923072,3967.7314870357513,800.5827660560608,3033.348300933838,42104,10502,31602,31602,0,23,10335000.0
10335,10335999,20.66998918162832,37.61828796964946,0.07553849560329451,3968.1681303977966,800.6474416255951,3033.547504425049,42116,10503,31613,31613,0,23,10336000.0
10336,10336999,20.67000090564677,37.618448993058394,0.07553182238228939,3968.5937135219574,800.7109258174896,3033.879581451416,42121,10505,31616,31616,0,23,10337000.0
10337,10337999,20.669997279641837,37.61845818502573,0.07552504341462596,3968.888736963272,800.7745337486267,3034.1859092712402,42121,10505,31616,31616,0,23,10338000.0
10338,10338999,20.67080245555458,37.621213767543715,0.07551969194238695,3969.399580717087,800.8404998779297,3034.1559562683105,42125,10507,31618,31618,0,23,10339000.0
10339,10339999,20.671540831882528,37.62348792959008,0.07552686964586242,3969.973799467087,800.9054448604584,3034.132137298584,42129,10509,31620,31620,0,23,10340000.0
10340,10340999,20.67292027864623,37.627446383794606,0.07552746783776598,3970.2754311561584,800.9713885784149,3034.5813179016113,42129,10509,31620,31620,0,23,10341000.0
10341,10341999,20.674292214864177,37.63187370619749,0.07553988216986329,3970.6371836662292,801.036200761795,3034.905590057373,42131,10510,31621,31621,0,23,10342000.0
10342,10342999,20.675085913941654,37.63480733743913,0.0755338167882178,3971.4610464572906,801.1022102832794,3034.315029144287,42142,10515,31627,31627,0,23,10343000.0
10343,10343999,20.6761201326657,37.63729008779741,0.07554598834230974,3971.8356671333313,801.1690535545349,3034.7672386169434,42144,10516,31628,31628,0,23,10344000.0
10344,10344999,20.677899746087512,37.64151942142853,0.07555957089800747,3972.5241911411285,801.2382550239563,3034.7239418029785,42162,10520,31642,31642,0,23,10345000.0
10345,10345999,20.679543987063216,37.64584142934552,0.07559008318613503,3973.1462168693542,801.3058114051819,3034.65238571167,42169,10523,31646,31646,0,23,10346000.0
10346,10346999,20.681472322988274,37.65212742508886,0.0755879921436472,3973.474354505539,801.370269536972,3035.0794792175293,42169,10523,31646,31646,0,23,10347000.0
10347,10347999,20.683650761662104,37.65754455028342,0.07561202033102443,3974.2029774188995,801.4357175827026,3034.442813873291,42175,10526,31649,31649,0,23,10348000.0
10348,10348999,20.685704884114525,37.66222711259214,0.07563691760877644,3974.535070180893,801.5009269714355,3035.087345123291,42176,10527,31649,31649,0,23,10349000.0
10349,10349999,20.687260976075816,37.66576873320607,0.07564950362633482,3974.726804494858,801.5651533603668,3036.038585662842,42176,10527,31649,31649,0,23,10350000.0
10350,10350999,20.687393081818012,37.665762620791995,0.07563954965748987,3974.964373588562,801.6305849552155,3037.2774238586426,42185,10527,31658,31658,0,23,10351000.0
10351,10351999,20.687238792349238,37.666028857648385,0.07562888971107806,3975.327338218689,801.696350812912,3037.869213104248,42188,10528,31660,31660,0,23,10352000.0
10352,10352999,20.68697228328184,37.66546174624337,0.07562232109373712,3975.79532790184,801.760192155838,3038.181011199951,42194,10530,31664,31664,0,23,10353000.0
10353,10353999,20.68706113453556,37.66544436414212,0.07561254707614129,3976.3541293144226,801.8275647163391,3038.272060394287,42201,10533,31668,31668,0,23,10354000.0
10354,10354999,20.686938324217664,37.66510593031379,0.07560620149944097,3976.7531414031982,801.8923046588898,3038.8410453796387,42205,10535,31670,31670,0,23,10355000.0
10355,10355999,20.68669476088246,37.664467869698825,0.07560154224628457,3977.339350938797,801.9580581188202,3038.5267372131348,42209,10537,31672,31672,0,23,10356000.0
10356,10356999,20.686522950095,37.664068836433216,0.07559759520798592,3977.917855978012,802.0229995250702,3038.6301612854004,42215,10540,31675,31675,0,23,10357000.0
10357,10357999,20.68642567823694,37.66412608320364,0.07559336046104592,3978.263158082962,802.0956678390503,3038.911220550537,42216,10540,31676,31676,0,23,10358000.0
10358,10358999,20.686402864604947,37.66399971022091,0.07559014946269171,3978.6145417690277,802.1610579490662,3039.3998832702637,42219,10541,31678,31678,0,23,10359000.0
10359,10359999,20.686370714577496,37.66382715566807,0.07558699209407482,3979.0257976055145,802.2266807556152,3039.5038719177246,42221,10542,31679,31679,0,23,10360000.0
10360,10360999,20.686527468641966,37.663940341148795,0.07559014059918945,3979.472985267639,802.2917995452881,3039.5635871887207,42223,10543,31680,31680,0,23,10361000.0
10361,10361999,20.687047952551552,37.66440614232496,0.07559510200736574,3979.8556654453278,802.3593459129333,3039.942440032959,42235,10544,31691,31691,0,23,10362000.0
10362,10362999,20.687824444979185,37.66764371030576,0.07559533642122285,3980.4761834144592,802.4256930351257,3039.590099334717,42239,10546,31693,31693,0,23,10363000.0
10363,10363999,20.688768333118905,37.66973790586963,0.07559864654645021,3980.7950377464294,802.492084980011,3039.9561042785645,42239,10546,31693,31693,0,23,10364000.0
10364,10364999,20.68959896232342,37.670873904258876,0.07561502357417571,3981.114459991455,802.5580031871796,3040.557918548584,42241,10547,31694,31694,0,23,10365000.0
10365,10365999,20.690583490022576,37.67213530314223,0.07563850472980316,3981.59778547287,802.6241405010223,3040.372287750244,42243,10548,31695,31695,0,23,10366000.0
10366,10366999,20.69155643516999,37.67293782295062,0.07565817237489902,3982.256705760956,802.6956434249878,3040.2999305725098,42249,10551,31698,31698,0,23,10367000.0
10367,10367999,20.69278459696797,37.67510920078356,0.07568033856243783,3982.500824689865,802.7635130882263,3041.003276824951,42249,10551,31698,31698,0,23,10368000.0
10368,10368999,20.69365578057814,37.67565344973154,0.07569964102552629,3982.9154176712036,802.8307209014893,3040.962245941162,42249,10551,31698,31698,0,23,10369000.0
10369,10369999,20.69470216229665,37.67646899288869,0.07571295843002357,3983.2341985702515,802.8985736370087,3041.304531097412,42249,10551,31698,31698,0,23,10370000.0
10370,10370999,20.69477972317829,37.67586545834562,0.07570677621925614,3983.472836971283,802.9633255004883,3042.6336631774902,42262,10551,31711,31711,0,23,10371000.0
10371,10371999,20.69427504563015,37.67480359568212,0.07570088139715414,3983.6620874404907,803.025869846344,3043.8591270446777,42262,10551,31711,31711,0,23,10372000.0
10372,10372999,20.69414412310855,37.674644394443206,0.07569313296191493,3984.3678731918335,803.0925641059875,3043.6253395080566,42272,10555,31717,31717,0,23,10373000.0
10373,10373999,20.69381771550344,37.673886032587646,0.07568780889304705,3984.751745700836,803.1624011993408,3044.482707977295,42278,10557,31721,31721,0,23,10374000.0
10374,10374999,20.693717288861993,37.67346434957489,0.07568158204927611,3985.243372440338,803.2255895137787,3044.739818572998,42283,10559,31724,31724,0,23,10375000.0
10375,10375999,20.69351573139759,37.673193906608205,0.0756767401863413,3985.785338640213,803.2888278961182,3044.6672706604004,42288,10561,31727,31727,0,23,10376000.0
10376,10376999,20.693243584803344,37.672470243369695,0.07567356904528322,3986.056309700012,803.3525805473328,3045.178440093994,42289,10561,31728,31728,0,23,10377000.0
10377,10377999,20.693008953335816,37.67166363855014,0.07567254395104517,3986.427803516388,803.4158337116241,3045.5581245422363,42291,10562,31729,31729,0,23,10378000.0
10378,10378999,20.692779872144904,37.67085267981618,0.0756732152360109,3987.062400817871,803.4804751873016,3045.203197479248,42298,10565,31733,31733,0,23,10379000.0
10379,10379999,20.69278123297112,37.67067310622967,0.07566950955698937,3987.2922904491425,803.5438349246979,3046.003314971924,42300,10565,31735,31735,0,23,10380000.0
10380,10380999,20.692809460120568,37.67056044490153,0.0756639768448808,3987.8304414749146,803.6090273857117,3046.1170539855957,42316,10568,31748,31748,0,23,10381000.0
10381,10381999,20.692921646683924,37.67060083229351,0.07565634411069933,3988.0992460250854,803.6743459701538,3046.651554107666,42316,10568,31748,31748,0,23,10382000.0
10382,10382999,20.69320313707184,37.67109247950477,0.0756474581797979,3988.792906522751,803.7378625869751,3046.1906242370605,42323,10571,31752,31752,0,23,10383000.0
10383,10383999,20.693780614606876,37.67261263917494,0.07563919156258192,3989.352123975754,803.8010838031769,3046.033588409424,42327,10573,31754,31754,0,23,10384000.0
10384,10384999,20.694981316153964,37.67594437719744,0.07563103839860597,3989.583860874176,803.8643691539764,3046.7672691345215,42327,10573,31754,31754,0,23,10385000.0
10385,10385999,20.696708562215807,37.680838100569204,0.07562745992079689,3989.898908853531,803.9287238121033,3047.084217071533,42327,10573,31754,31754,0,23,10386000.0
10386,10386999,20.698442109044663,37.68538314429107,0.07563006875732448,3990.3006503582,803.9915654659271,3046.941333770752,42327,10573,31754,31754,0,23,10387000.0
10387,10387999,20.70004112362885,37.68877998064398,0.07563505045507302,3990.588031768799,804.056227684021,3047.454936981201,42327,10573,31754,31754,0,23,10388000.0
10388,10388999,20.701848993494657,37.693430746531654,0.07564995492720905,3990.828966856003,804.1211111545563,3048.006519317627,42327,10573,31754,31754,0,23,10389000.0
10389,10389999,20.70329006750222,37.69622721654633,0.07566065127890187,3991.186645746231,804.1837632656097,3048.1886558532715,42327,10573,31754,31754,0,23,10390000.0
10390,10390999,20.70354338111449,37.69614224578239,0.0756501897391918,3991.425622701645,804.2491517066956,3049.629970550537,42344,10573,31771,31771,0,23,10391000.0
10391,10391999,20.70315796389294,37.69515598067817,0.07564225946974523,3991.6764810085297,804.3128337860107,3050.8724250793457,42346,10574,31772,31772,0,23,10392000.0
10392,10392999,20.702934009607755,37.69490936295391,0.07563174539962703,3991.858048439026,804.3775341510773,3051.878070831299,42346,10574,31772,31772,0,23,10393000.0
10393,10393999,20.702876540580192,37.69455750318489,0.07561726554413772,3992.1687121391296,804.4416968822479,3052.548885345459,42348,10575,31773,31773,0,23,10394000.0
10394,10394999,20.70270919631759,37.69396743691213,0.07560667173143354,3992.902384519577,804.5062685012817,3052.0124549865723,42359,10579,31780,31780,0,23,10395000.0
10395,10395999,20.702379260363532,37.693223563042906,0.07560006203356939,3993.4781975746155,804.5724740028381,3052.0397911071777,42366,10582,31784,31784,0,23,10396000.0
10396,10396999,20.7020363542874,37.692302383784025,0.07559389874497124,3993.7710802555084,804.644035577774,3052.5663566589355,42367,10582,31785,31785,0,23,10397000.0
10397,10397999,20.70182716515765,37.6919243979567,0.07558486102092377,3994.1115555763245,804.7083904743195,3053.0513496398926,42369,10583,31786,31786,0,23,10398000.0
10398,10398999,20.7015437431843,37.69099516596145,0.07557950558220161,3994.412031888962,804.7732670307159,3053.6553535461426,42371,10584,31787,31787,0,23,10399000.0
10399,10399999,20.701366908641784,37.69039053069459,0.07557223228818544,3994.966630935669,804.8385617733002,3053.422260284424,42375,10586,31789,31789,0,23,10400000.0
10400,10400999,20.701086549286874,37.68950003933051,0.07556612389140482,3995.5702319145203,804.9057953357697,3052.951648712158,42379,10588,31791,31791,0,23,10401000.0
10401,10401999,20.700839421856564,37.68874064288196,0.07556169766974197,3995.967294692993,804.9732208251953,3053.306339263916,42382,10589,31793,31793,0,23,10402000.0
10402,10402999,20.70065778633025,37.68816464826326,0.07555821191587919,3996.3571095466614,805.0399177074432,3053.6681938171387,42384,10590,31794,31794,0,23,10403000.0
10403,10403999,20.70064274487739,37.68762902383105,0.07555370480742174,3996.871624469757,805.1067700386047,3053.7198600769043,42389,10592,31797,31797,0,23,10404000.0
10404,10404999,20.700983748530355,37.68797443681655,0.0755442587086681,3997.2566652297974,805.1716673374176,3053.996929168701,42392,10593,31799,31799,0,23,10405000.0
10405,10405999,20.70149516920396,37.68847257243546,0.07554392839644031,3997.632479906082,805.2380528450012,3054.060977935791,42392,10593,31799,31799,0,23,10406000.0
10406,10406999,20.70231820389572,37.69037901521628,0.075534075764359,3997.9752247333527,805.3044881820679,3054.2652168273926,42392,10593,31799,31799,0,23,10407000.0
10407,10407999,20.702749894710823,37.69045388971743,0.0755385710665134,3998.26158618927,805.3714461326599,3054.7275886535645,42392,10593,31799,31799,0,23,10408000.0
10408,10408999,20.703429744105033,37.69119259757516,0.07554330668574916,3998.6904871463776,805.4387702941895,3054.602321624756,42392,10593,31799,31799,0,23,10409000.0
10409,10409999,20.70388708516228,37.691446323902674,0.07554934860961382,3999.2547883987427,805.5052056312561,3054.32661819458,42397,10595,31802,31802,0,23,10410000.0
10410,10410999,20.704707748550284,37.69241588867375,0.07554620017176195,3999.668738603592,805.5701968669891,3054.9043617248535,42413,10596,31817,31817,0,23,10411000.0
10411,10411999,20.70452920302921,37.69270215118573,0.07553007999859906,3999.9153282642365,805.640652179718,3056.1329307556152,42416,10596,31820,31820,0,23,10412000.0
10412,10412999,20.70421008075857,37.692218767439805,0.07551864028068322,4000.3981835842133,805.7062571048737,3056.625919342041,42422,10598,31824,31824,0,23,10413000.0
10413,10413999,20.703804034871638,37.69133494330501,0.0755079897114872,4000.673466205597,805.7729897499084,3057.7765922546387,42424,10599,31825,31825,0,23,10414000.0
10414,10414999,20.70344946086072,37.69054693399012,0.07549495890826285,4000.898370742798,805.8380079269409,3058.617893218994,42424,10599,31825,31825,0,23,10415000.0
10415,10415999,20.703111180641034,37.68998556813602,0.07548745371499876,4001.2046592235565,805.9042551517487,3059.237049102783,42426,10600,31826,31826,0,23,10416000.0
10416,10416999,20.702724057927746,37.68898572074108,0.07547867003214603,4002.2142248153687,805.973061800003,3058.2234535217285,42440,10606,31834,31834,0,23,10417000.0
10417,10417999,20.70230244340404,37.68804713382431,0.07547422870390497,4002.5215163230896,806.0405344963074,3058.9355125427246,42442,10607,31835,31835,0,23,10418000.0
10418,10418999,20.702077120145816,37.6875243639554,0.0754611772183661,4002.9183757305145,806.1082491874695,3059.334529876709,42444,10608,31836,31836,0,23,10419000.0
10419,10419999,20.701876613716088,37.68715080769055,0.07544677722834547,4003.247089624405,806.174587726593,3059.5947608947754,42444,10608,31836,31836,0,23,10420000.0
10420,10420999,20.701788264371462,37.686601212335276,0.07543081156545428,4003.640436410904,806.2424366474152,3060.1452445983887,42448,10610,31838,31838,0,23,10421000.0
10421,10421999,20.701684485088823,37.68625269006061,0.0754169673233197,4004.0772652626038,806.3117678165436,3060.1938133239746,42450,10611,31839,31839,0,23,10422000.0
10422,10422999,20.701776893108416,37.68584828469137,0.07540341253586924,4004.431533575058,806.3802201747894,3060.571765899658,42452,10612,31840,31840,0,23,10423000.0
10423,10423999,20.70187280301865,37.685633211575215,0.07539025933418764,4005.0446178913116,806.449166059494,3060.1288871765137,42456,10614,31842,31842,0,23,10424000.0
10424,10424999,20.70194278241335,37.68544314274981,0.07538362137554755,4005.28839969635,806.5180978775024,3060.878086090088,42456,10614,31842,31842,0,23,10425000.0
10425,10425999,20.702073201127305,37.68534720469466,0.07537441717913818,4005.7262456417084,806.5864660739899,3060.549388885498,42456,10614,31842,31842,0,23,10426000.0
10426,10426999,20.70240929710104,37.68551739257166,0.07536725898626284,4006.1595907211304,806.653401851654,3060.730136871338,42458,10615,31843,31843,0,23,10427000.0
10427,10427999,20.702653821881146,37.68540620769779,0.07536848688401543,4006.518551826477,806.7217392921448,3060.9738807678223,42458,10615,31843,31843,0,23,10428000.0
10428,10428999,20.70317265880871,37.68574104968362,0.07536484579158986,4006.6776320934296,806.7898018360138,3062.081027984619,42458,10615,31843,31843,0,23,10429000.0
10429,10429999,20.703915382573882,37.68634231483341,0.07535932056146488,4007.116534471512,806.8571848869324,3061.9949913024902,42460,10616,31844,31844,0,23,10430000.0
10430,10430999,20.7042580050676,37.686354813886965,0.0753531509960802,4007.4311826229095,806.9242165088654,3062.6745567321777,42462,10617,31845,31845,0,23,10431000.0
10431,10431999,20.70406780454025,37.685895770045974,0.07534794296460723,4007.800106525421,806.9868900775909,3063.4411125183105,42473,10618,31855,31855,0,23,10432000.0
10432,10432999,20.703423230663354,37.685172058064275,0.07534612016968545,4008.081000328064,807.0479454994202,3064.4700965881348,42475,10619,31856,31856,0,23,10433000.0
10433,10433999,20.7030204089608,37.68442707395458,0.07534190540442942,4008.2619762420654,807.1101493835449,3065.674289703369,42478,10619,31859,31859,0,23,10434000.0
10434,10434999,20.70267413328908,37.68359529486445,0.07533750233544656,4008.607254743576,807.1718709468842,3066.3491554260254,42481,10620,31861,31861,0,23,10435000.0
10435,10435999,20.70254606142478,37.683066698685735,0.07533221736921447,4008.834937810898,807.2346518039703,3067.2472190856934,42481,10620,31861,31861,0,23,10436000.0
10436,10436999,20.702634282807505,37.68265899171736,0.07532281919565531,4009.4155592918396,807.298374414444,3067.4017295837402,42488,10623,31865,31865,0,23,10437000.0
10437,10437999,20.702549910227244,37.68218176598539,0.07531536064766797,4009.7696192264557,807.3617265224457,3067.937068939209,42490,10624,31866,31866,0,23,10438000.0
10438,10438999,20.702550024534027,37.68166648582487,0.07530315913583485,4010.369039773941,807.4281210899353,3067.759494781494,42498,10627,31871,31871,0,23,10439000.0
10439,10439999,20.702588400227665,37.681318523048226,0.07529349011324482,4010.6427161693573,807.4922263622284,3068.3677253723145,42498,10627,31871,31871,0,23,10440000.0
10440,10440999,20.70302555547739,37.683355321511456,0.07527676925794591,4011.056154727936,807.5588388442993,3068.5002403259277,42501,10628,31873,31873,0,23,10441000.0
10441,10441999,20.703421459664163,37.683525287023784,0.07527370926547616,4011.7230036258698,807.6247806549072,3068.2547492980957,42508,10631,31877,31877,0,23,10442000.0
10442,10442999,20.704466168900815,37.68686547850866,0.07526168000824318,4012.0523891448975,807.6928572654724,3068.753520965576,42508,10631,31877,31877,0,23,10443000.0
10443,10443999,20.705153592097023,37.68817626493039,0.07525286819524213,4012.6268842220306,807.7593972682953,3068.567455291748,42512,10633,31879,31879,0,23,10444000.0
10444,10444999,20.70592821216972,37.68887667156197,0.0752597851145409,4013.041656255722,807.8250451087952,3068.9021034240723,42514,10634,31880,31880,0,23,10445000.0
10445,10445999,20.707045294940645,37.6904458416558,0.07526052991329757,4013.42169713974,807.8918046951294,3069.454776763916,42516,10635,31881,31881,0,23,10446000.0
10446,10446999,20.708079672420656,37.691859215979015,0.0752676838440125,4013.6856360435486,807.960825920105,3070.032283782959,42516,10635,31881,31881,0,23,10447000.0
10447,10447999,20.709025028469448,37.69336073069433,0.07527840034284217,4014.1195793151855,808.0257124900818,3070.389148712158,42530,10637,31893,31893,0,23,10448000.0
10448,10448999,20.71001928148068,37.694668745644435,0.0752834048847415,4014.790662050247,808.0951611995697,3070.2227821350098,42538,10640,31898,31898,0,23,10449000.0
10449,10449999,20.711057428338332,37.69641135321354,0.07529762067273338,4015.2803766727448,808.160897731781,3070.485637664795,42542,10642,31900,31900,0,23,10450000.0
10450,10450999,20.712138695420375,37.697683624810175,0.07530705557313266,4015.820391893387,808.2344167232513,3070.068103790283,42542,10642,31900,31900,0,23,10451000.0
10451,10451999,20.712511722299652,37.697571646595044,0.0753047797717109,4016.3569555282593,808.3001737594604,3070.4148597717285,42563,10644,31919,31919,0,23,10452000.0
10452,10452999,20.712059284802702,37.697395711415986,0.07530212712258655,4016.7107107639313,808.3686964511871,3071.3571739196777,42567,10645,31922,31922,0,23,10453000.0
10453,10453999,20.711383818020646,37.69638543558301,0.07530259130069594,4017.0413646698,808.4367322921753,3071.8482627868652,42567,10645,31922,31922,0,23,10454000.0
10454,10454999,20.710701884928582,37.69537231395232,0.07530435874216002,4017.3964488506317,808.5052199363708,3072.193691253662,42567,10645,31922,31922,0,23,10455000.0
10455,10455999,20.710164313470102,37.69463960069295,0.07530283619520484,4017.691932439804,808.5754702091217,3072.8004188537598,42568,10645,31923,31923,0,23,10456000.0
10456,10456999,20.709492115101835,37.693349718774165,0.07530459445474191,4018.1942694187164,808.6453368663788,3072.8790016174316,42572,10647,31925,31925,0,23,10457000.0
10457,10457999,20.708922560847352,37.69233692147496,0.0753032669186725,4018.643753051758,808.713306427002,3073.0225868225098,42574,10648,31926,31926,0,23,10458000.0
10458,10458999,20.70837373078403,37.69132901855008,0.07530235903026439,4019.1777119636536,808.7822012901306,3073.065013885498,42578,10650,31928,31928,0,23,10459000.0
10459,10459999,20.707968565720304,37.69039633665499,0.07529900389869892,4019.5109753608704,808.8491554260254,3073.434154510498,42578,10650,31928,31928,0,23,10460000.0
10460,10460999,20.70767527141685,37.68981985564627,0.07529375279236195,4019.972729921341,808.9184772968292,3073.4539680480957,42580,10651,31929,31929,0,23,10461000.0
10461,10461999,20.707808763719278,37.69004498196669,0.07528408334071701,4020.6383390426636,808.9895489215851,3073.315288543701,42587,10655,31932,31932,0,23,10462000.0
10462,10462999,20.708215432637502,37.69073276602634,0.07527576052013563,4020.9335598945618,809.0611209869385,3073.8519859313965,42587,10655,31932,31932,0,23,10463000.0
10463,10463999,20.708653564331595,37.691267220121794,0.07527093925991757,4021.3959455490112,809.1302256584167,3073.870693206787,42589,10656,31933,31933,0,23,10464000.0
10464,10464999,20.70963626524678,37.694063320544714,0.0752578233551412,4021.7993264198303,809.1998698711395,3074.119411468506,42591,10657,31934,31934,0,23,10465000.0
10465,10465999,20.711276951447804,37.70031215458498,0.07524684214316957,4022.3089163303375,809.2691433429718,3074.7004432678223,42609,10659,31950,31950,0,23,10466000.0
10466,10466999,20.71255044651176,37.70387215430118,0.07524150572558563,4022.6000883579254,809.3402788639069,3075.3997230529785,42609,10659,31950,31950,0,23,10467000.0
10467,10467999,20.714037856762328,37.70771590099687,0.07523720482989538,4022.8447687625885,809.4109299182892,3076.2225303649902,42609,10659,31950,31950,0,23,10468000.0
10468,10468999,20.715532159440972,37.712038274176045,0.07522344465910802,4023.0832629203796,809.4805221557617,3076.9193534851074,42609,10659,31950,31950,0,23,10469000.0
10469,10469999,20.71626812543459,37.713749066954804,0.07521110624100547,4023.414546728134,809.5463271141052,3077.6457023620605,42619,10659,31960,31960,0,23,10470000.0
10470,10470999,20.716138640318743,37.71364055232986,0.07520002779317614,4023.637418985367,809.6138174533844,3078.8410987854004,42621,10659,31962,31962,0,23,10471000.0
10471,10471999,20.71602877462395,37.71302180735734,0.07519423488515653,4024.0283613204956,809.680554151535,3079.4975242614746,42633,10660,31973,31973,0,23,10472000.0
10472,10472999,20.71656060502303,37.713830695635316,0.07517999613172766,4024.500743150711,809.7468647956848,3079.789539337158,42637,10662,31975,31975,0,23,10473000.0
10473,10473999,20.716856424784748,37.71384403283315,0.07517554293873308,4024.8268694877625,809.8156068325043,3080.4244804382324,42639,10663,31976,31976,0,23,10474000.0
10474,10474999,20.71717224049453,37.71381768252677,0.07516874170200849,4025.1136071681976,809.8809051513672,3080.8981590270996,42639,10663,31976,31976,0,23,10475000.0
10475,10475999,20.71746469950954,37.71386613474063,0.0751625875052292,4025.703979730606,809.9461674690247,3080.8207969665527,42646,10666,31980,31980,0,23,10476000.0
10476,10476999,20.717798488331866,37.7141789428345,0.07515828450869078,4026.2876114845276,810.0134406089783,3080.828830718994,42653,10669,31984,31984,0,23,10477000.0
10477,10477999,20.718117320550096,37.71433657357167,0.0751514642589689,4026.540802717209,810.0791923999786,3081.5817909240723,42653,10669,31984,31984,0,23,10478000.0
10478,10478999,20.718692274007502,37.71537810609683,0.07514852557041052,4026.920069694519,810.1450204849243,3081.8098106384277,42653,10669,31984,31984,0,23,10479000.0
10479,10479999,20.719146108572474,37.71587406344163,0.07514796060125895,4027.4130153656006,810.2105672359467,3082.1501274108887,42657,10671,31986,31986,0,23,10480000.0
10480,10480999,20.71969264044121,37.71675602900045,0.07515067366578032,4027.898595094681,810.2772812843323,3081.9992713928223,42659,10672,31987,31987,0,23,10481000.0
10481,10481999,20.7204075061021,37.71913795110839,0.07514469431468651,4028.277129173279,810.3450739383698,3082.5368461608887,42662,10673,31989,31989,0,23,10482000.0
10482,10482999,20.721037332612283,37.719772301295784,0.07514875432863333,4028.739704847336,810.4108271598816,3082.506336212158,42665,10674,31991,31991,0,23,10483000.0
10483,10483999,20.722052112916433,37.721283296954574,0.07515946829487619,4029.345766067505,810.4774069786072,3081.830738067627,42667,10675,31992,31992,0,23,10484000.0
10484,10484999,20.722951506842843,37.72229632203885,0.07516751936772259,4029.753536462784,810.5474696159363,3082.167263031006,42669,10676,31993,31993,0,23,10485000.0
10485,10485999,20.72368240299272,37.72304816547638,0.07517735893208966,4029.9970703125,810.6148808002472,3082.897602081299,42669,10676,31993,31993,0,23,10486000.0
10486,10486999,20.724684815136268,37.72466415732792,0.07519531745116259,4030.4562418460846,810.6878299713135,3083.1857566833496,42672,10678,31994,31994,0,23,10487000.0
10487,10487999,20.725577116445187,37.72590171630632,0.07521024236707852,4031.0232644081116,810.7546215057373,3083.077335357666,42677,10680,31997,31997,0,23,10488000.0
10488,10488999,20.725996042707283,37.72570569129925,0.07521045852534092,4031.2204065322876,810.8215093612671,3084.0976219177246,42677,10680,31997,31997,0,23,10489000.0
10489,10489999,20.726082096706133,37.72629502642171,0.07518445281022057,4031.48779463768,810.8879370689392,3085.2730751037598,42686,10680,32006,32006,0,23,10490000.0
10490,10490999,20.725632893781913,37.72560024221856,0.07517897536310958,4031.7493090629578,810.952648639679,3086.131031036377,42687,10680,32007,32007,0,23,10491000.0
10491,10491999,20.72543218702019,37.726920287457965,0.07516539933278976,4032.2162425518036,811.0199065208435,3086.442897796631,42691,10682,32009,32009,0,23,10492000.0
10492,10492999,20.725147511247975,37.72608106700858,0.07516060731360641,4032.5277791023254,811.0856084823608,3087.081958770752,42693,10683,32010,32010,0,23,10493000.0
10493,10493999,20.72494558232462,37.72565858873718,0.07515552927422953,4033.142329454422,811.1528384685516,3086.9129066467285,42700,10686,32014,32014,0,23,10494000.0
10494,10494999,20.72474762424326,37.72490394418066,0.07514873374452558,4033.581216573715,811.2210690975189,3087.150661468506,42705,10688,32017,32017,0,23,10495000.0
10495,10495999,20.724610900859695,37.724323275853514,0.07514501407719731,4033.938507080078,811.2869827747345,3087.559803009033,42707,10689,32018,32018,0,23,10496000.0
10496,10496999,20.72456078811086,37.72412506225496,0.07514359946861282,4034.3306279182434,811.3534133434296,3087.8965492248535,42709,10690,32019,32019,0,23,10497000.0
10497,10497999,20.72480650069958,37.72450263129987,0.07513935015545858,4034.8094260692596,811.4194495677948,3087.7234077453613,42712,10691,32021,32021,0,23,10498000.0
10498,10498999,20.725140769050242,37.72504648850894,0.07513579406246074,4035.1419911384583,811.4861996173859,3088.336772918701,42714,10692,32022,32022,0,23,10499000.0
10499,10499999,20.725865027652404,37.72901902695055,0.0751292149366809,4035.556441307068,811.5520584583282,3088.1819648742676,42714,10692,32022,32022,0,23,10500000.0
10500,10500999,20.727208549228454,37.735807024464215,0.0751284995146495,4036.0250170230865,811.6180682182312,3087.9677085876465,42716,10693,32023,32023,0,23,10501000.0
10501,10501999,20.728437392740833,37.739279877696006,0.07514416387342371,4036.474444627762,811.6856491565704,3087.9165992736816,42719,10694,32025,32025,0,23,10502000.0
10502,10502999,20.729773307077426,37.74286775003643,0.07515552440378392,4036.820857524872,811.7518882751465,3088.6016960144043,42734,10695,32039,32039,0,23,10503000.0
10503,10503999,20.731246726358346,37.74618801570263,0.07518403469263468,4037.124310731888,811.8183996677399,3089.07230758667,42735,10695,32040,32040,0,23,10504000.0
10504,10504999,20.733161473133634,37.750510728165516,0.07521796937177072,4037.4401485919952,811.8854179382324,3089.433177947998,42735,10695,32040,32040,0,23,10505000.0
10505,10505999,20.73487325635,37.75375203582356,0.07525885323853854,4037.7442278862,811.9532649517059,3089.8591270446777,42735,10695,32040,32040,0,23,10506000.0
10506,10506999,20.736444775470574,37.756922405754615,0.07527687683787987,4038.0495643615723,812.0208828449249,3090.268009185791,42735,10695,32040,32040,0,23,10507000.0
10507,10507999,20.73800366738304,37.759416068932886,0.07531143431180676,4038.366767644882,812.0867822170258,3090.5493812561035,42735,10695,32040,32040,0,23,10508000.0
10508,10508999,20.739281792427946,37.76233899107915,0.07531454249103964,4038.6778728961945,812.1542522907257,3090.9063301086426,42735,10695,32040,32040,0,23,10509000.0
10509,10509999,20.73928126179056,37.762293951229644,0.07530640271460132,4038.8910217285156,812.2172496318817,3092.422939300537,42748,10695,32053,32053,0,23,10510000.0
10510,10510999,20.738782725818385,37.761406683764534,0.07530016009809481,4039.0310854911804,812.2786130905151,3093.782367706299,42748,10695,32053,32053,0,23,10511000.0
10511,10511999,20.738422980836685,37.76089423211719,0.07529309749991242,4039.3346314430237,812.3404140472412,3094.456157684326,42751,10696,32055,32055,0,23,10512000.0
10512,10512999,20.73798846763482,37.76027549402831,0.07528797819501354,4040.0768644809723,812.405282497406,3094.186046600342,42762,10700,32062,32062,0,23,10513000.0
10513,10513999,20.737524562141193,37.759339046644286,0.07528403845332243,4040.380345582962,812.4674961566925,3095.077419281006,42765,10701,32064,32064,0,23,10514000.0
10514,10514999,20.73701744773567,37.75842382592002,0.0752810542719381,4040.698317050934,812.5304811000824,3095.6164741516113,42767,10702,32065,32065,0,23,10515000.0
10515,10515999,20.736655320667985,37.75782386929709,0.07527443574957826,4041.279448032379,812.5948543548584,3095.359462738037,42772,10704,32068,32068,0,23,10516000.0
10516,10516999,20.736566366113976,37.75779740370134,0.07526873115284372,4041.498691558838,812.6577272415161,3096.2357597351074,42772,10704,32068,32068,0,23,10517000.0
10517,10517999,20.736611004609507,37.757813230343714,0.0752627102762431,4041.7276713848114,812.7214713096619,3096.90962600708,42772,10704,32068,32068,0,23,10518000.0
10518,10518999,20.736518535794346,37.75733308588681,0.07525802394371162,4042.2378063201904,812.7848405838013,3096.927745819092,42776,10706,32070,32070,0,23,10519000.0
10519,10519999,20.7365048859321,37.757016761596795,0.07525683491056845,4042.6029279232025,812.8486518859863,3097.3408241271973,42778,10707,32071,32071,0,23,10520000.0
10520,10520999,20.736542987570587,37.756547782428314,0.07525781238125373,4043.1809763908386,812.9131193161011,3096.9619483947754,42783,10709,32074,32074,0,23,10521000.0
10521,10521999,20.736657946042538,37.75629160700081,0.07526094081335843,4043.6105151176453,812.9776108264923,3097.4272117614746,42787,10711,32076,32076,0,23,10522000.0
10522,10522999,20.736926527088066,37.75631957817649,0.075265834826726,4043.8801674842834,813.0469024181366,3098.1008338928223,42787,10711,32076,32076,0,23,10523000.0
10523,10523999,20.73722003501158,37.75646711465656,0.07527047707065504,4044.460261821747,813.1163740158081,3097.950054168701,42792,10713,32079,32079,0,23,10524000.0
10524,10524999,20.73744627109331,37.756335547961164,0.07527749553855823,4044.8038799762726,813.1819005012512,3098.398525238037,42794,10714,32080,32080,0,23,10525000.0
10525,10525999,20.73781766786543,37.756305238051716,0.07528216460312531,4045.2806420326233,813.2473676204681,3098.2894859313965,42796,10715,32081,32081,0,23,10526000.0
10526,10526999,20.7381520163604,37.75605376310705,0.07528605599007998,4045.6428780555725,813.312890291214,3098.37056350708,42796,10715,32081,32081,0,23,10527000.0
10527,10527999,20.738312055512743,37.75562636674023,0.07528626662687787,4045.9407999515533,813.3786351680756,3098.7825660705566,42796,10715,32081,32081,0,23,10528000.0
10528,10528999,20.738341077106316,37.75506946240893,0.07528816946393835,4046.253813266754,813.4415557384491,3099.050121307373,42796,10715,32081,32081,0,23,10529000.0
10529,10529999,20.738119758875982,37.754122106377324,0.07528447164058638,4046.5006947517395,813.5055668354034,3100.1880989074707,42805,10715,32090,32090,0,23,10530000.0
10530,10530999,20.73767183606074,37.7530623857956,0.07527716990380573,4046.905298233032,813.5694446563721,3100.7019996643066,42807,10716,32091,32091,0,23,10531000.0
10531,10531999,20.73739645014276,37.752306195976146,0.07526793392670805,4047.1817259788513,813.6341125965118,3101.6671409606934,42811,10717,32094,32094,0,23,10532000.0
10532,10532999,20.736892393445476,37.751186931644064,0.07526111520149781,4047.7377610206604,813.6988558769226,3101.5335655212402,42816,10719,32097,32097,0,23,10533000.0
10533,10533999,20.736492950246067,37.750504126496764,0.07525535229461111,4048.345836877823,813.764829158783,3101.3883094787598,42822,10722,32100,32100,0,23,10534000.0
10534,10534999,20.735981190263683,37.74946574142049,0.0752479996997768,4048.775232076645,813.8301525115967,3101.742130279541,42827,10724,32103,32103,0,23,10535000.0
10535,10535999,20.73558113460402,37.749279556220685,0.0752434927020934,4049.3179426193237,813.8963210582733,3102.0152168273926,42834,10727,32107,32107,0,23,10536000.0
10536,10536999,20.735066080513636,37.74819697394304,0.0752394865716205,4049.923035621643,813.9632215499878,3101.6904792785645,42839,10729,32110,32110,0,23,10537000.0
10537,10537999,20.734826123796996,37.74966433666575,0.07522777501633249,4050.3238406181335,814.0281057357788,3102.0731086730957,42842,10730,32112,32112,0,23,10538000.0
10538,10538999,20.73443592399899,37.75049662171136,0.0752190303236081,4050.786516904831,814.1022324562073,3102.1220893859863,42844,10731,32113,32113,0,23,10539000.0
10539,10539999,20.734234443222338,37.750317266693514,0.07521210443811477,4051.076319694519,814.1697311401367,3102.578998565674,42844,10731,32113,32113,0,23,10540000.0
10540,10540999,20.733915554515512,37.749682058692414,0.0752084167209599,4051.3918068408966,814.2355420589447,3103.228229522705,42846,10732,32114,32114,0,23,10541000.0
10541,10541999,20.733825198415314,37.74990063906399,0.07520604549599363,4051.7984323501587,814.3036828041077,3103.443462371826,42848,10733,32115,32115,0,23,10542000.0
10542,10542999,20.734109879105723,37.751088971179314,0.07520501437152316,4052.4757018089294,814.3723921775818,3103.0937309265137,42854,10736,32118,32118,0,23,10543000.0
10543,10543999,20.734454927315706,37.75189820265975,0.07521226273203452,4053.1336793899536,814.4400188922882,3102.7148628234863,42862,10739,32123,32123,0,23,10544000.0
10544,10544999,20.735203893890557,37.75462764298918,0.07523564280205941,4053.447877883911,814.507482290268,3103.5213737487793,42865,10740,32125,32125,0,23,10545000.0
10545,10545999,20.735886712989107,37.75576305280643,0.0752495230559177,4053.768788099289,814.5746252536774,3103.8508644104004,42865,10740,32125,32125,0,23,10546000.0
10546,10546999,20.73659952467949,37.757041298213736,0.07525380745434995,4053.978368282318,814.6408343315125,3104.6070671081543,42865,10740,32125,32125,0,23,10547000.0
10547,10547999,20.737028508091313,37.757581357335084,0.07526367125628419,4054.4908459186554,814.7076370716095,3104.4098625183105,42867,10741,32126,32126,0,23,10548000.0
10548,10548999,20.73769617263109,37.75940384986954,0.07527727789118088,4055.0173013210297,814.7752511501312,3104.3310890197754,42871,10743,32128,32128,0,23,10549000.0
10549,10549999,20.737930744920035,37.75919058546402,0.07527737284808789,4055.184414625168,814.843254327774,3105.5324211120605,42875,10743,32132,32132,0,23,10550000.0
10550,10550999,20.738437145100697,37.75966302286525,0.075245692794639,4055.332658290863,814.9087359905243,3107.2371788024902,42883,10743,32140,32140,0,23,10551000.0
10551,10551999,20.738982371669227,37.76016268079411,0.07522879142559546,4055.4881262779236,814.9750928878784,3108.4965171813965,42883,10743,32140,32140,0,23,10552000.0
10552,10552999,20.739629589245343,37.760818507386816,0.07521420440071458,4055.88595867157,815.0429830551147,3109.0551261901855,42888,10745,32143,32143,0,23,10553000.0
10553,10553999,20.740019927788932,37.761314459229965,0.07519684816037697,4056.3624382019043,815.1088953018188,3109.169292449951,42892,10747,32145,32145,0,23,10554000.0
10554,10554999,20.74042585943915,37.76181907676444,0.07518542385815852,4056.9077978134155,815.1755120754242,3109.378559112549,42909,10750,32159,32159,0,23,10555000.0
10555,10555999,20.740731980484686,37.76201724507113,0.07517371743253098,4057.654056787491,815.242838382721,3108.891040802002,42920,10754,32166,32166,0,23,10556000.0
10556,10556999,20.741011205049144,37.76214830855734,0.07516461010054076,4058.3640265464783,815.3125872612,3108.7241859436035,42930,10758,32172,32172,0,23,10557000.0
10557,10557999,20.741192883894588,37.761937857783565,0.07515825824733957,4058.847862482071,815.380378484726,3108.9464683532715,42934,10760,32174,32174,0,23,10558000.0
10558,10558999,20.74153365861141,37.76222835438894,0.07515242647720222,4059.2261159420013,815.4490776062012,3109.4297676086426,42936,10761,32175,32175,0,23,10559000.0
10559,10559999,20.74175320276114,37.76221243301488,0.07515047570426026,4059.7305335998535,815.5178718566895,3109.6095695495605,42942,10763,32179,32179,0,23,10560000.0
10560,10560999,20.742151437364733,37.7626912639441,0.07514617812646596,4060.100873708725,815.5859229564667,3110.0896492004395,42944,10764,32180,32180,0,23,10561000.0
10561,10561999,20.74258878053597,37.7628123867905,0.07514286312785456,4060.460379600525,815.6531410217285,3110.453998565674,42946,10765,32181,32181,0,23,10562000.0
10562,10562999,20.74305142695188,37.76324813951119,0.07514281888242702,4060.8597481250763,815.7212824821472,3110.754306793213,42948,10766,32182,32182,0,23,10563000.0
10563,10563999,20.743817994260336,37.76406825511229,0.07514885767497348,4061.364193677902,815.790057182312,3110.924114227295,42953,10768,32185,32185,0,23,10564000.0
10564,10564999,20.74447796878584,37.764725838113364,0.07515863782202903,4061.6099231243134,815.857301235199,3111.569164276123,42953,10768,32185,32185,0,23,10565000.0
10565,10565999,20.74517794323005,37.765372034958766,0.07516841978509159,4062.265733718872,815.9249885082245,3110.844829559326,42959,10770,32189,32189,0,23,10566000.0
10566,10566999,20.745923209444292,37.766258890835275,0.07517615220345686,4062.7048346996307,815.9931762218475,3110.9545097351074,42962,10771,32191,32191,0,23,10567000.0
10567,10567999,20.74657159747361,37.76673213075134,0.07518281673152083,4063.357138156891,816.0616014003754,3110.658634185791,42969,10774,32195,32195,0,23,10568000.0
10568,10568999,20.746991090563466,37.7667503997409,0.07519407159544245,4063.8088121414185,816.1296195983887,3110.7091102600098,42971,10775,32196,32196,0,23,10569000.0
10569,10569999,20.7473593931618,37.76661815097813,0.07520475992473685,4064.21546626091,816.198792219162,3110.9925575256348,42974,10776,32198,32198,0,23,10570000.0
10570,10570999,20.74709110106416,37.76579529802838,0.07520943353597975,4064.656309366226,816.2628989219666,3111.845470428467,42981,10778,32203,32203,0,23,10571000.0
10571,10571999,20.746308034572365,37.765121347658955,0.07521044093628448,4065.2283747196198,816.3254487514496,3112.0997886657715,42989,10781,32208,32208,0,23,10572000.0
10572,10572999,20.745619825226235,37.76389873271047,0.07521273147036223,4065.631602048874,816.3881907463074,3112.5325050354004,42995,10782,32213,32213,0,23,10573000.0
10573,10573999,20.744939262640422,37.76262965784201,0.07521463989831456,4066.017763376236,816.4505608081818,3112.752208709717,42996,10782,32214,32214,0,23,10574000.0
10574,10574999,20.74445636005042,37.76175111727247,0.07521293857132572,4066.3814146518707,816.5152173042297,3113.461597442627,43000,10783,32217,32217,0,23,10575000.0
10575,10575999,20.74388978950836,37.760842933136,0.07521218609034774,4066.647803544998,816.5794541835785,3114.504238128662,43003,10784,32219,32219,0,23,10576000.0
10576,10576999,20.743350174442085,37.760174879189236,0.07521209724538536,4067.1899740695953,816.6452486515045,3114.361873626709,43009,10786,32223,32223,0,23,10577000.0
10577,10577999,20.742919308012777,37.75959905586869,0.07520811854578247,4067.537840604782,816.7129735946655,3114.9634132385254,43012,10787,32225,32225,0,23,10578000.0
10578,10578999,20.742382628311688,37.75854215207852,0.07520670972539623,4068.0532970428467,816.7769091129303,3115.031482696533,43018,10789,32229,32229,0,23,10579000.0
10579,10579999,20.741999935739216,37.75786351785278,0.07520402433830997,4068.7190403938293,816.841837644577,3114.6388206481934,43025,10792,32233,32233,0,23,10580000.0
10580,10580999,20.741671977466773,37.75849965970041,0.07519586998158401,4068.9948711395264,816.9055769443512,3115.3335304260254,43025,10792,32233,32233,0,23,10581000.0
10581,10581999,20.7414410371647,37.75790732669006,0.07519330624535014,4069.5137856006622,816.9702472686768,3115.467182159424,43030,10794,32236,32236,0,23,10582000.0
10582,10582999,20.741292543273374,37.75741951236566,0.07518860373228009,4069.842534303665,817.0339348316193,3115.7100868225098,43030,10794,32236,32236,0,23,10583000.0
10583,10583999,20.74121308144546,37.757051343826824,0.07518412468414115,4070.277953863144,817.0989723205566,3116.2333946228027,43034,10796,32238,32238,0,23,10584000.0
10584,10584999,20.74134624578842,37.75776969776904,0.0751744573108104,4070.484755754471,817.162061214447,3117.0025672912598,43034,10796,32238,32238,0,23,10585000.0
10585,10585999,20.741781032437327,37.76141262331532,0.07515764857954221,4070.9204318523407,817.225818157196,3117.0194206237793,43037,10797,32240,32240,0,23,10586000.0
10586,10586999,20.742208515653477,37.76186453696739,0.07515416651118267,4071.2933299541473,817.2900357246399,3117.1591453552246,43037,10797,32240,32240,0,23,10587000.0
10587,10587999,20.742645597163566,37.76202037892203,0.0751503587797272,4071.7443046569824,817.3557674884796,3116.9769859313965,43037,10797,32240,32240,0,23,10588000.0
10588,10588999,20.74286849225278,37.761929228389526,0.07514959241587249,4072.0544049739838,817.4186434745789,3117.6166191101074,43040,10798,32242,32242,0,23,10589000.0
10589,10589999,20.743109992560562,37.7617108832277,0.07514879809211239,4072.520770549774,817.4824640750885,3117.8267936706543,43045,10800,32245,32245,0,23,10590000.0
10590,10590999,20.743379964179063,37.762280753840045,0.07514345054977745,4072.9113063812256,817.5464704036713,3118.2207527160645,43047,10801,32246,32246,0,23,10591000.0
10591,10591999,20.74271272877603,37.761104903706496,0.07514621540057953,4073.3932905197144,817.6123960018158,3118.586772918701,43053,10802,32251,32251,0,23,10592000.0
10592,10592999,20.742037138272273,37.760336327337654,0.07514645343737925,4073.652960538864,817.6801297664642,3119.526210784912,43053,10802,32251,32251,0,23,10593000.0
10593,10593999,20.74127808499977,37.75944982486526,0.07514790545255634,4073.976809978485,817.7482438087463,3120.1671028137207,43053,10802,32251,32251,0,23,10594000.0
10594,10594999,20.740632424266302,37.75840872227525,0.07514928731486759,4074.2705199718475,817.8141343593597,3120.6673316955566,43054,10802,32252,32252,0,23,10595000.0
10595,10595999,20.73991867919152,37.75736991032429,0.07514986264063162,4074.730972290039,817.8813321590424,3120.4951667785645,43055,10802,32253,32253,0,23,10596000.0
10596,10596999,20.739160142972917,37.75611643106684,0.07515156366604625,4075.07377576828,817.9492509365082,3120.8425254821777,43055,10802,32253,32253,0,23,10597000.0
10597,10597999,20.738661771313065,37.756003974503244,0.07514580188955622,4075.5292682647705,818.0154273509979,3120.847400665283,43058,10803,32255,32255,0,23,10598000.0
10598,10598999,20.73848868086183,37.75642083583971,0.07513819960263945,4075.8259811401367,818.0835094451904,3121.392017364502,43059,10803,32256,32256,0,23,10599000.0
10599,10599999,20.738361084091018,37.75631713937023,0.07512933610498895,4076.3433949947357,818.1521553993225,3121.7074699401855,43063,10806,32257,32257,0,23,10600000.0
10600,10600999,20.73842218306766,37.75636895964907,0.07512112147691896,4076.6734161376953,818.2204298973083,3122.1861534118652,43063,10806,32257,32257,0,23,10601000.0
10601,10601999,20.738692612294873,37.75688145051825,0.07511151177334985,4076.928411245346,818.2885072231293,3122.8758277893066,43063,10806,32257,32257,0,23,10602000.0
10602,10602999,20.73902670913645,37.757225529853066,0.07510214911711588,4077.314246416092,818.3574151992798,3122.892719268799,43063,10806,32257,32257,0,23,10603000.0
10603,10603999,20.73937068933123,37.75771921530917,0.07509576445436372,4077.718361854553,818.4274938106537,3122.864513397217,43063,10806,32257,32257,0,23,10604000.0
10604,10604999,20.73976397372442,37.75778264132235,0.07508914515997966,4078.1037950515747,818.496262550354,3123.159969329834,43078,10807,32271,32271,0,23,10605000.0
10605,10605999,20.740375520183356,37.758193586964474,0.07508305523388537,4078.681167602539,818.5666513442993,3123.443820953369,43082,10809,32273,32273,0,23,10606000.0
10606,10606999,20.7410558537528,37.758785474563275,0.07508121486817654,4078.840978860855,818.6367065906525,3124.714023590088,43082,10809,32273,32273,0,23,10607000.0
10607,10607999,20.741302447182086,37.75859024569152,0.07507800727449698,4079.295102119446,818.7071192264557,3124.7057151794434,43084,10810,32274,32274,0,23,10608000.0
10608,10608999,20.741214956634366,37.75795864572383,0.07507731063303069,4079.7909240722656,818.7768914699554,3124.5904426574707,43087,10811,32276,32276,0,23,10609000.0
10609,10609999,20.740648699386327,37.757168192422846,0.07507898629682352,4079.9855966567993,818.8407793045044,3125.9289207458496,43094,10811,32283,32283,0,23,10610000.0
10610,10610999,20.739943833701403,37.75640590222881,0.07508172279166503,4080.5434165000916,818.9071040153503,3125.9845542907715,43098,10813,32285,32285,0,23,10611000.0
10611,10611999,20.73923892898471,37.75537305525098,0.0750841547158011,4080.9893991947174,818.9713227748871,3126.590419769287,43103,10815,32288,32288,0,23,10612000.0
10612,10612999,20.73852982433117,37.75437552767336,0.07508506948085636,4081.3083930015564,819.0359709262848,3126.911777496338,43103,10815,32288,32288,0,23,10613000.0
10613,10613999,20.7379059400163,37.75348103114422,0.07508462047574216,4081.7018859386444,819.1025893688202,3127.2251625061035,43105,10816,32289,32289,0,23,10614000.0
10614,10614999,20.73725330183825,37.75251244035797,0.07508436041940214,4081.9683814048767,819.1746783256531,3127.939105987549,43105,10816,32289,32289,0,23,10615000.0
10615,10615999,20.736860221707037,37.7520490269071,0.07508043519940122,4082.541773080826,819.2401676177979,3127.6618843078613,43109,10818,32291,32291,0,23,10616000.0
10616,10616999,20.736694074066772,37.752385548440365,0.07507216734873334,4082.841112613678,819.3051857948303,3128.045269012451,43109,10818,32291,32291,0,23,10617000.0
10617,10617999,20.736895277663923,37.75367703587009,0.07505762546356642,4083.3545339107513,819.3714158535004,3128.1890754699707,43114,10820,32294,32294,0,23,10618000.0
10618,10618999,20.737825040479056,37.7565510024837,0.07504730201829357,4083.9535596370697,819.4370067119598,3128.029941558838,43118,10822,32296,32296,0,23,10619000.0
10619,10619999,20.738742617633285,37.75897570695363,0.07503396205274582,4084.4161174297333,819.5043807029724,3127.9522972106934,43118,10822,32296,32296,0,23,10620000.0
10620,10620999,20.740078176363532,37.76217719043741,0.07501643816277492,4084.6546607017517,819.5688347816467,3128.594738006592,43118,10822,32296,32296,0,23,10621000.0
10621,10621999,20.741583451683677,37.765220358217896,0.07500365779577844,4085.021482229233,819.6373689174652,3129.052318572998,43130,10823,32307,32307,0,23,10622000.0
10622,10622999,20.742981895766526,37.76808960255866,0.07499489633401524,4085.4198520183563,819.7044515609741,3129.318256378174,43132,10824,32308,32308,0,23,10623000.0
10623,10623999,20.744800718729845,37.771375101176304,0.07499869450926067,4085.8702697753906,819.7709980010986,3129.3782920837402,43134,10825,32309,32309,0,23,10624000.0
10624,10624999,20.74673702148506,37.77473477033946,0.07499888491072271,4086.522878408432,819.8375551700592,3129.1871604919434,43141,10828,32313,32313,0,23,10625000.0
10625,10625999,20.74857799441745,37.777679604498005,0.07499822170352466,4087.020391702652,819.9059846401215,3129.105655670166,43144,10829,32315,32315,0,23,10626000.0
10626,10626999,20.7506947760169,37.78132986519669,0.07500601251926342,4087.3072204589844,819.9742329120636,3129.5706748962402,43144,10829,32315,32315,0,23,10627000.0
10627,10627999,20.75226465275321,37.783638223803976,0.07501637319423815,4087.828917503357,820.0439734458923,3129.4047508239746,43146,10830,32316,32316,0,23,10628000.0
10628,10628999,20.753249790881608,37.784854837294354,0.07501388319575353,4088.187917470932,820.1105754375458,3130.2955284118652,43162,10831,32331,32331,0,23,10629000.0
10629,10629999,20.752585819125663,37.783904412641846,0.07501285777585232,4088.335179567337,820.1763455867767,3131.935764312744,43164,10831,32333,32333,0,23,10630000.0
10630,10630999,20.75198844045234,37.78313612778411,0.07501212880990982,4088.6465837955475,820.2426791191101,3132.7903633117676,43166,10832,32334,32334,0,23,10631000.0
10631,10631999,20.751536493714408,37.78297996069594,0.07500805310670944,4089.1547667980194,820.3089866638184,3133.1514167785645,43174,10835,32339,32339,0,23,10632000.0
10632,10632999,20.751116607625786,37.782168808709855,0.07500519162170982,4089.481543779373,820.3765029907227,3133.8523445129395,43176,10836,32340,32340,0,23,10633000.0
10633,10633999,20.750875849562963,37.781955574264046,0.07500229555480353,4090.170062303543,820.4431457519531,3133.5950508117676,43184,10840,32344,32344,0,23,10634000.0
10634,10634999,20.750465622619572,37.78107776897311,0.07500185260458214,4090.555063724518,820.5100648403168,3134.1013374328613,43187,10841,32346,32346,0,23,10635000.0
10635,10635999,20.750307657907175,37.781067192746214,0.07499758201050155,4091.093677520752,820.5782265663147,3134.1882972717285,43191,10843,32348,32348,0,23,10636000.0
10636,10636999,20.750180943796657,37.780930768686524,0.07499488557488487,4091.4621012210846,820.647693157196,3134.525218963623,43193,10844,32349,32349,0,23,10637000.0
10637,10637999,20.75037258305704,37.781473081112786,0.07499379516809634,4091.942539215088,820.7142567634583,3134.7736015319824,43197,10846,32351,32351,0,23,10638000.0
10638,10638999,20.750488908812503,37.781514005773126,0.07499670273357628,4092.627418279648,820.7844562530518,3134.3587226867676,43203,10849,32354,32354,0,23,10639000.0
10639,10639999,20.7509551949656,37.78216411812792,0.07500589903888577,4092.8305118083954,820.8514432907104,3135.2573890686035,43203,10849,32354,32354,0,23,10640000.0
10640,10640999,20.751538903521155,37.784465543369045,0.07501178400971242,4093.159380197525,820.9256029129028,3135.7380409240723,43203,10849,32354,32354,0,23,10641000.0
10641,10641999,20.75242152700726,37.78568940539352,0.07501085381666617,4093.6820209026337,820.9944927692413,3135.7207984924316,43207,10851,32356,32356,0,23,10642000.0
10642,10642999,20.75329935809986,37.78688920037802,0.0750224741571317,4094.0304687023163,821.0632283687592,3135.8602256774902,43207,10851,32356,32356,0,23,10643000.0
10643,10643999,20.754198928846392,37.78813536127131,0.07503517912174151,4094.6933538913727,821.1320729255676,3135.37398147583,43211,10853,32358,32358,0,23,10644000.0
10644,10644999,20.75519127913809,37.78985698869633,0.07504162209155363,4095.0582814216614,821.2001001834869,3135.812717437744,43213,10854,32359,32359,0,23,10645000.0
10645,10645999,20.75628376116209,37.79124855946508,0.07505893958068754,4095.5875391960144,821.2705931663513,3135.859935760498,43218,10856,32362,32362,0,23,10646000.0
10646,10646999,20.757120050870785,37.79205496478713,0.07507430342711596,4095.9246900081635,821.338018655777,3136.0633430480957,43218,10856,32362,32362,0,23,10647000.0
10647,10647999,20.757984001101526,37.792764081313805,0.07508246145545094,4096.291127443314,821.4077415466309,3136.465892791748,43220,10857,32363,32363,0,23,10648000.0
10648,10648999,20.758588467560084,37.79300753163798,0.07509076840083784,4096.781893253326,821.4755966663361,3136.3175086975098,43222,10858,32364,32364,0,23,10649000.0
10649,10649999,20.758180348403474,37.79229276448954,0.07509094426360341,4096.931620121002,821.5391056537628,3137.9661979675293,43231,10858,32373,32373,0,23,10650000.0
10650,10650999,20.75737431546008,37.791080737725345,0.07509344330442036,4097.388431787491,821.6021068096161,3138.4589195251465,43236,10860,32376,32376,0,23,10651000.0
10651,10651999,20.756732497793607,37.79004001172006,0.07509381121388492,4097.81146979332,821.6667196750641,3138.6754570007324,43239,10861,32378,32378,0,23,10652000.0
10652,10652999,20.756144307320813,37.789061871361874,0.07509350019153138,4098.091215372086,821.7292788028717,3139.339099884033,43240,10861,32379,32379,0,23,10653000.0
10653,10653999,20.755608986073856,37.78833795872827,0.07509107745222288,4098.446176290512,821.7943556308746,3139.8150672912598,43242,10862,32380,32380,0,23,10654000.0
10654,10654999,20.75496346134765,37.78713870696647,0.07509393751742977,4099.098335266113,821.8580276966095,3139.482120513916,43250,10865,32385,32385,0,23,10655000.0
10655,10655999,20.754468657329205,37.78618257749394,0.07509412397275306,4099.615005493164,821.922046661377,3139.5305137634277,43265,10867,32398,32398,0,23,10656000.0
10656,10656999,20.754181910665174,37.78568528184541,0.0750912119295547,4099.88151717186,821.9856877326965,3140.4264488220215,43267,10868,32399,32399,0,23,10657000.0
10657,10657999,20.753948753973066,37.7851047683859,0.0750875138528585,4100.535980224609,822.0507752895355,3140.070659637451,43274,10871,32403,32403,0,23,10658000.0
10658,10658999,20.75373305422544,37.784730896317264,0.07508394410875863,4101.112387180328,822.1167502403259,3140.087688446045,43279,10873,32406,32406,0,23,10659000.0
10659,10659999,20.753774022627784,37.78493175109049,0.07507718918995943,4101.551638841629,822.1833963394165,3140.3491859436035,43281,10874,32407,32407,0,23,10660000.0
10660,10660999,20.753886727877624,37.78486283883474,0.07507088163356057,4101.702645540237,822.2460153102875,3141.4222373962402,43281,10874,32407,32407,0,23,10661000.0
10661,10661999,20.75392315061877,37.784667413610435,0.0750661352861709,4102.519654750824,822.311949968338,3140.2641944885254,43288,10877,32411,32411,0,23,10662000.0
10662,10662999,20.753953337403313,37.784315236685615,0.07506630410640003,4102.730454683304,822.3780925273895,3141.169376373291,43288,10877,32411,32411,0,23,10663000.0
10663,10663999,20.754025445995058,37.784078402466974,0.07506421478412739,4103.22105050087,822.4425008296967,3141.0111045837402,43290,10878,32412,32412,0,23,10664000.0
10664,10664999,20.75427209814227,37.784021507189344,0.07506263399956792,4103.468181610107,822.5069713592529,3141.6464805603027,43290,10878,32412,32412,0,23,10665000.0
10665,10665999,20.754378099967088,37.78370332046784,0.07505957288543497,4103.874955415726,822.5732088088989,3141.61812210083,43290,10878,32412,32412,0,23,10666000.0
10666,10666999,20.754458059429222,37.78328266178712,0.07505682027875848,4104.207859039307,822.6363561153412,3141.8060874938965,43290,10878,32412,32412,0,23,10667000.0
10667,10667999,20.754522945423403,37.78299247589642,0.07505239622984494,4104.486384153366,822.7002000808716,3142.2779121398926,43290,10878,32412,32412,0,23,10668000.0
10668,10668999,20.754428274074105,37.78238699166726,0.07505094200021056,4105.054983854294,822.7653939723969,3141.8272743225098,43293,10879,32414,32414,0,23,10669000.0
10669,10669999,20.75406565084043,37.781545519094756,0.07504976950849107,4105.317019939423,822.8288466930389,3142.9504890441895,43304,10879,32425,32425,0,23,10670000.0
10670,10670999,20.75331942641161,37.78062272733015,0.07505043827811719,4105.600608348846,822.8937165737152,3144.126964569092,43307,10880,32427,32427,0,23,10671000.0
10671,10671999,20.752572690703673,37.779752514766706,0.07505058463222536,4105.818323135376,822.9583067893982,3145.033908843994,43307,10880,32427,32427,0,23,10672000.0
10672,10672999,20.751990483361375,37.77907220223977,0.07504736638203946,4106.164833307266,823.0233969688416,3145.552532196045,43309,10881,32428,32428,0,23,10673000.0
10673,10673999,20.75134597507741,37.77802821741198,0.07504744426560528,4106.436136960983,823.0883655548096,3145.959789276123,43309,10881,32428,32428,0,23,10674000.0
10674,10674999,20.750846349848263,37.77730668902088,0.07504358883002504,4106.756645202637,823.1554763317108,3146.217311859131,43309,10881,32428,32428,0,23,10675000.0
10675,10675999,20.750258178306492,37.7763321264796,0.075042010646579,4107.251780509949,823.222489118576,3146.356014251709,43313,10883,32430,32430,0,23,10676000.0
10676,10676999,20.749641416438237,37.775233660900106,0.07504277032883788,4107.724000692368,823.2892470359802,3146.2833213806152,43315,10884,32431,32431,0,23,10677000.0
10677,10677999,20.74914647340584,37.77446145779783,0.07503418799847872,4108.0192766189575,823.3567004203796,3146.622760772705,43315,10884,32431,32431,0,23,10678000.0
10678,10678999,20.748578234926967,37.77334027862372,0.07503233823401323,4108.294556617737,823.4234819412231,3147.039348602295,43315,10884,32431,32431,0,23,10679000.0
10679,10679999,20.748259055430836,37.772557547985365,0.07502315966160022,4108.817164897919,823.4898636341095,3146.937000274658,43320,10886,32434,32434,0,23,10680000.0
10680,10680999,20.748133141011454,37.77216603594783,0.07501131574194597,4109.30722117424,823.5584330558777,3146.7196083068848,43322,10887,32435,32435,0,23,10681000.0
10681,10681999,20.74834135540983,37.77335792767466,0.07499084253142185,4109.806551218033,823.6261296272278,3147.04349899292,43339,10889,32450,32450,0,23,10682000.0
10682,10682999,20.7484933749851,37.77326527709241,0.07497346379305503,4110.062678575516,823.694818019867,3147.8693351745605,43339,10889,32450,32450,0,23,10683000.0
10683,10683999,20.749069564876237,37.7740379294143,0.07495495540941055,4110.431357622147,823.7637574672699,3148.4903831481934,43341,10890,32451,32451,0,23,10684000.0
10684,10684999,20.749811585492022,37.774564744638454,0.07493331947425552,4110.7102200984955,823.8304708003998,3149.0169944763184,43342,10890,32452,32452,0,23,10685000.0
10685,10685999,20.75047209949085,37.77521983984037,0.07491897646706092,4110.998032808304,823.8983643054962,3149.3681297302246,43342,10890,32452,32452,0,23,10686000.0
10686,10686999,20.751103772374844,37.775775262893376,0.07491402518234902,4111.9960350990295,824.0424880981445,3149.309597015381,43344,10891,32453,32453,0,23,10687000.0
10687,10687999,20.75167024843488,37.776406495021426,0.07490631550428262,4112.783792734146,824.2074027061462,3149.820697784424,43346,10892,32454,32454,0,23,10688000.0
10688,10688999,20.75241952711707,37.77731496818973,0.07490485733499086,4113.624315738678,824.3472948074341,3149.613582611084,43346,10892,32454,32454,0,23,10689000.0
10689,10689999,20.752958732767087,37.77805915249071,0.07489992455358918,4115.238976478577,824.7313401699066,3149.9216270446777,43346,10892,32454,32454,0,23,10690000.0
10690,10690999,20.75274650445598,37.77749192777355,0.07488970314726762,4116.724920749664,824.9007797241211,3150.2500801086426,43349,10892,32457,32457,0,23,10691000.0
10691,10691999,20.75235554527898,37.77743384929901,0.07487529013603356,4119.381927490234,825.179705619812,3150.3772315979004,43369,10896,32473,32473,0,23,10692000.0
10692,10692999,20.751984034506012,37.777090769499765,0.07486320861081686,4119.673830747604,825.2614555358887,3151.318462371826,43369,10896,32473,32473,0,23,10693000.0
10693,10693999,20.751780454644468,37.77663471459428,0.0748477447196646,4120.033221244812,825.3361592292786,3151.6991233825684,43369,10896,32473,32473,0,23,10694000.0
10694,10694999,20.75130705118232,37.77562468836753,0.07483967683388038,4120.355787038803,825.4092774391174,3152.142436981201,43369,10896,32473,32473,0,23,10695000.0
10695,10695999,20.7510508686523,37.775130054804045,0.07482917887979568,4120.8512144088745,825.4838764667511,3152.064838409424,43372,10897,32475,32475,0,23,10696000.0
10696,10696999,20.7508767812185,37.77468026064786,0.07481658859384599,4121.650777578354,825.558545589447,3151.452381134033,43381,10900,32481,32481,0,23,10697000.0
10697,10697999,20.750753792334432,37.77474254695183,0.07480585622390457,4121.924591064453,825.6327328681946,3152.2008476257324,43381,10900,32481,32481,0,23,10698000.0
10698,10698999,20.750821306323715,37.77516764291387,0.07480346274650329,4122.326790571213,825.7069697380066,3152.5937156677246,43382,10901,32481,32481,0,23,10699000.0
10699,10699999,20.751099280359988,37.775740390016686,0.0747949834965893,4122.840476989746,825.782692193985,3152.8740272521973,43396,10903,32493,32493,0,23,10700000.0
10700,10700999,20.75169083405017,37.776896294767795,0.07481156856327931,4123.140597581863,825.8602356910706,3154.0537071228027,43398,10904,32494,32494,0,23,10701000.0
10701,10701999,20.752703571969022,37.778799827199954,0.07482881503160421,4123.57731461525,825.9373230934143,3154.4627265930176,43400,10905,32495,32495,0,23,10702000.0
10702,10702999,20.753480771548183,37.779763987947454,0.07484999576297757,4124.150896072388,826.0159275531769,3154.5262870788574,43406,10907,32499,32499,0,23,10703000.0
10703,10703999,20.75478855291717,37.78194715191448,0.07488023723554571,4124.60532784462,826.0936584472656,3154.8499183654785,43408,10908,32500,32500,0,23,10704000.0
10704,10704999,20.756123253856092,37.78381917027296,0.0749193655246152,4124.85972237587,826.1699714660645,3155.622814178467,43408,10908,32500,32500,0,23,10705000.0
10705,10705999,20.75750379380664,37.78547914153235,0.07495549820848446,4125.246304273605,826.2459247112274,3156.027889251709,43410,10909,32501,32501,0,23,10706000.0
10706,10706999,20.75922234542477,37.78807203203306,0.0750023777993506,4125.93484377861,826.3238625526428,3155.6173133850098,43415,10911,32504,32504,0,23,10707000.0
10707,10707999,20.76090972460658,37.79078938651369,0.07505294765364046,4126.422923564911,826.4005696773529,3155.717632293701,43418,10912,32506,32506,0,23,10708000.0
10708,10708999,20.762475529461682,37.792626619887145,0.07508623377880297,4126.746663570404,826.4793803691864,3156.168109893799,43418,10912,32506,32506,0,23,10709000.0
10709,10709999,20.763786303751175,37.79392707194756,0.07512071698846723,4127.090786218643,826.5574972629547,3156.7183876037598,43420,10913,32507,32507,0,23,10710000.0
10710,10710999,20.76462630067754,37.79508437896776,0.07512532555833118,4127.690320491791,826.6306486129761,3157.1548347473145,43433,10915,32518,32518,0,23,10711000.0
10711,10711999,20.764203613676305,37.794212564683235,0.07511429912561518,4128.100874423981,826.6983771324158,3157.7500648498535,43437,10916,32521,32521,0,23,10712000.0
10712,10712999,20.763902201525724,37.793383581133575,0.07510050311612515,4128.52091217041,826.7672898769379,3158.683032989502,43454,10917,32537,32537,0,23,10713000.0
10713,10713999,20.7639229256953,37.793177925672516,0.07508170005119574,4128.896790742874,826.8352000713348,3159.523693084717,43456,10918,32538,32538,0,23,10714000.0
10714,10714999,20.763918599407628,37.79274979804736,0.07506347249397904,4129.22159075737,826.9038593769073,3160.55082321167,43460,10919,32541,32541,0,23,10715000.0
10715,10715999,20.76387158068825,37.79209443033564,0.07504711929819607,4129.694217681885,826.9725487232208,3161.08695602417,43465,10921,32544,32544,0,23,10716000.0
10716,10716999,20.763943112170935,37.79149878818084,0.07502527693334116,4130.112397432327,827.0413239002228,3161.7308464050293,43469,10923,32546,32546,0,23,10717000.0
10717,10717999,20.7639399772657,37.79077351577409,0.07501090663802057,4130.542783737183,827.1098856925964,3162.2624549865723,43473,10925,32548,32548,0,23,10718000.0
10718,10718999,20.763885670685383,37.790030818206645,0.07499879107363316,4131.13214468956,827.1787812709808,3162.4378395080566,43480,10928,32552,32552,0,23,10719000.0
10719,10719999,20.763965648841758,37.789899199172,0.07499096729387988,4131.726070165634,827.2549498081207,3162.549571990967,43487,10931,32556,32556,0,23,10720000.0
10720,10720999,20.76401270228044,37.78935846236369,0.07498202047667835,4132.290329217911,827.3255686759949,3162.644687652588,43491,10933,32558,32558,0,23,10721000.0
10721,10721999,20.764175322070553,37.78925467694567,0.07497219748083983,4132.919312000275,827.3976905345917,3162.576160430908,43495,10935,32560,32560,0,23,10722000.0
10722,10722999,20.76470763124319,37.78958641650553,0.07496766439646796,4133.937364816666,827.6107609272003,3163.0280723571777,43500,10937,32563,32563,0,23,10723000.0
10723,10723999,20.76540147898542,37.79054691361692,0.07496594513950794,4134.852994680405,827.8249313831329,3163.607967376709,43500,10937,32563,32563,0,23,10724000.0
10724,10724999,20.766403411340512,37.79199604506329,0.07498209711398707,4135.177143573761,827.8903198242188,3164.221279144287,43502,10938,32564,32564,0,23,10725000.0
10725,10725999,20.767542664027882,37.7935515482172,0.07500217579278501,4135.549044370651,827.9560091495514,3164.4867057800293,43504,10939,32565,32565,0,23,10726000.0
10726,10726999,20.768823195320373,37.79539615522641,0.07502556210759004,4136.121494293213,828.0234804153442,3164.3190116882324,43509,10941,32568,32568,0,23,10727000.0
10727,10727999,20.770265882071556,37.798272243021934,0.07504324310973509,4136.491522550583,828.0918655395508,3164.5834159851074,43509,10941,32568,32568,0,23,10728000.0
10728,10728999,20.77137850858714,37.799361696486784,0.07506352428154373,4136.8375079631805,828.1612133979797,3164.8804969787598,43509,10941,32568,32568,0,23,10729000.0
10729,10729999,20.772525884632522,37.80050131581074,0.07508681094696301,4137.287946939468,828.2269804477692,3165.0047645568848,43511,10942,32569,32569,0,23,10730000.0
10730,10730999,20.773500715229407,37.80229650200752,0.07508951095753447,4137.703781366348,828.2922759056091,3164.9336280822754,43511,10942,32569,32569,0,23,10731000.0
10731,10731999,20.773204120516187,37.801514230095336,0.07508466732121588,4138.1325125694275,828.3570992946625,3165.8052940368652,43521,10944,32577,32577,0,23,10732000.0
10732,10732999,20.77275388913737,37.801243337592354,0.0750759877922691,4138.521364450455,828.4233613014221,3166.8305320739746,43526,10946,32580,32580,0,23,10733000.0
10733,10733999,20.77231820283555,37.80058362009063,0.0750721851770545,4139.075578927994,828.4906420707703,3167.169086456299,43535,10949,32586,32586,0,23,10734000.0
10734,10734999,20.771896793780385,37.799863084508495,0.07506961212067897,4139.513851642609,828.5565783977509,3167.6485328674316,43541,10951,32590,32590,0,23,10735000.0
10735,10735999,20.77157762807526,37.799174760039655,0.07506549430130915,4139.961074352264,828.6230535507202,3168.0352363586426,43547,10953,32594,32594,0,23,10736000.0
10736,10736999,20.771241240771094,37.7985450668201,0.07505981388263361,4140.8353617191315,828.6916627883911,3167.2761268615723,43557,10957,32600,32600,0,23,10737000.0
10737,10737999,20.77103094461227,37.7980029785869,0.07505048909166889,4141.17186498642,828.7593343257904,3167.9930152893066,43560,10958,32602,32602,0,23,10738000.0
10738,10738999,20.770762647995042,37.797336851836704,0.0750429081811238,4141.5738661289215,828.8264248371124,3168.2281074523926,43563,10959,32604,32604,0,23,10739000.0
10739,10739999,20.770583239656634,37.79693750892318,0.0750370048304041,4141.936223983765,828.8945286273956,3168.7390327453613,43566,10960,32606,32606,0,23,10740000.0
10740,10740999,20.770764627506093,37.79733469210399,0.07503024446966278,4142.414280414581,828.9607565402985,3168.3629417419434,43566,10960,32606,32606,0,23,10741000.0
10741,10741999,20.77084870139098,37.797243849032036,0.07502711758439584,4142.785794496536,829.0279059410095,3168.8718223571777,43568,10961,32607,32607,0,23,10742000.0
10742,10742999,20.771065869728073,37.79731422116826,0.07502152721210298,4143.467622280121,829.0961294174194,3168.4523582458496,43575,10964,32611,32611,0,23,10743000.0
10743,10743999,20.771662575049195,37.799092647488145,0.07501104497448496,4143.948213815689,829.1635897159576,3168.7744483947754,43579,10966,32613,32613,0,23,10744000.0
10744,10744999,20.772481040249556,37.80042752690617,0.07500465720574512,4144.3018391132355,829.232604265213,3169.291492462158,43582,10967,32615,32615,0,23,10745000.0
10745,10745999,20.773768282054537,37.80349878384963,0.07499812197666333,4144.840454816818,829.301171541214,3169.266788482666,43586,10969,32617,32617,0,23,10746000.0
10746,10746999,20.775074667203093,37.80500466724369,0.0750012017932512,4145.180109500885,829.3680107593536,3169.66117477417,43586,10969,32617,32617,0,23,10747000.0
10747,10747999,20.776312318045214,37.80672638795216,0.0750034137665212,4145.455756664276,829.4353876113892,3170.1398963928223,43586,10969,32617,32617,0,23,10748000.0
10748,10748999,20.777200177876225,37.80756617965277,0.07500596312336127,4145.832242488861,829.5015723705292,3170.2305793762207,43586,10969,32617,32617,0,23,10749000.0
10749,10749999,20.777127191641412,37.807332401521855,0.07499101027887978,4146.056814670563,829.5663957595825,3171.406391143799,43588,10969,32619,32619,0,23,10750000.0
10750,10750999,20.777242195068702,37.80748755678144,0.07496972871727148,4146.465255975723,829.6312763690948,3171.758701324463,43591,10970,32621,32621,0,23,10751000.0
10751,10751999,20.77750415869052,37.80743055050619,0.07494845346146406,4146.886293172836,829.703125,3172.1138801574707,43593,10971,32622,32622,0,23,10752000.0
10752,10752999,20.777506788147903,37.80708891554044,0.07493550105279811,4147.508620262146,829.771458864212,3172.1313514709473,43599,10974,32625,32625,0,23,10753000.0
10753,10753999,20.777142359238525,37.80630703804056,0.07493155086585457,4147.738362789154,829.8361859321594,3172.8736457824707,43599,10974,32625,32625,0,23,10754000.0
10754,10754999,20.776922603660815,37.8060466853077,0.0749240866614167,4148.1073660850525,829.902494430542,3172.9840660095215,43600,10974,32626,32626,0,23,10755000.0
10755,10755999,20.776919370515568,37.80608485442892,0.07491576029843372,4148.4734897613525,829.9674963951111,3173.0285682678223,43600,10974,32626,32626,0,23,10756000.0
10756,10756999,20.776924917983372,37.80593152905344,0.07490880153545854,4148.871376752853,830.0349576473236,3173.3528633117676,43603,10975,32628,32628,0,23,10757000.0
10757,10757999,20.77705109390715,37.806150578950316,0.07489920604136091,4149.2779276371,830.1009519100189,3173.5921363830566,43605,10976,32629,32629,0,23,10758000.0
10758,10758999,20.77736142850662,37.80668191457183,0.07489471333778841,4149.921667575836,830.1682646274567,3173.0982933044434,43609,10978,32631,32631,0,23,10759000.0
10759,10759999,20.77821021810768,37.80838550027544,0.07486519556396898,4150.253813743591,830.2365741729736,3173.771022796631,43610,10979,32631,32631,0,23,10760000.0
10760,10760999,20.778976343173287,37.80983330699521,0.0748586062377673,4150.618008852005,830.3039662837982,3173.9985160827637,43610,10979,32631,32631,0,23,10761000.0
10761,10761999,20.78034753884651,37.81219345406132,0.07486118578641132,4151.066869735718,830.3711414337158,3173.93705368042,43611,10980,32631,32631,0,23,10762000.0
10762,10762999,20.78219289624524,37.81536864995043,0.07488135778653016,4151.48063993454,830.440913438797,3174.212589263916,43613,10981,32632,32632,0,23,10763000.0
10763,10763999,20.784319611054485,37.819039922424025,0.0749169999387197,4151.910078525543,830.508543252945,3174.056095123291,43613,10981,32632,32632,0,23,10764000.0
10764,10764999,20.786566106093627,37.823331529258326,0.07494752903311386,4152.152977705002,830.5746164321899,3174.7161903381348,43613,10981,32632,32632,0,23,10765000.0
10765,10765999,20.788802657605842,37.82742073600677,0.07497742983322453,4152.663962841034,830.642678976059,3174.3631477355957,43614,10982,32632,32632,0,23,10766000.0
10766,10766999,20.79071399600248,37.82973713734453,0.07501071546433247,4153.121204853058,830.7128081321716,3174.290126800537,43616,10983,32633,32633,0,23,10767000.0
10767,10767999,20.79235502457896,37.83142580496502,0.07502809551607947,4153.572932720184,830.7806024551392,3174.339267730713,43617,10984,32633,32633,0,23,10768000.0
10768,10768999,20.79278177710609,37.83186785623871,0.07501820324835862,4153.853118658066,830.8471331596375,3175.328395843506,43626,10984,32642,32642,0,23,10769000.0
10769,10769999,20.79262716989966,37.83137658166759,0.0750117996282228,4154.124614477158,830.9118235111237,3176.0032234191895,43627,10984,32643,32643,0,23,10770000.0
10770,10770999,20.792603926379815,37.830836546056844,0.07500518344954687,4154.881910085678,830.9781715869904,3175.8863105773926,43641,10989,32652,32652,0,23,10771000.0
10771,10771999,20.79248240719982,37.83053848672886,0.0749991438845774,4155.428851604462,831.0455121994019,3176.1586875915527,43650,10992,32658,32658,0,23,10772000.0
10772,10772999,20.792290451098093,37.830317128338166,0.07499539624464724,4155.58293223381,831.1121635437012,3177.3135108947754,43650,10992,32658,32658,0,23,10773000.0
10773,10773999,20.7920198472333,37.82991163284662,0.07499104328415207,4155.815927505493,831.1772654056549,3177.902561187744,43650,10992,32658,32658,0,23,10774000.0
10774,10774999,20.79179159192611,37.829652276991325,0.0749865518007149,4156.292644739151,831.2452127933502,3178.1087608337402,43656,10994,32662,32662,0,23,10775000.0
10775,10775999,20.791482891836583,37.828752134979595,0.07498346231827047,4156.868931293488,831.3109405040741,3177.8339347839355,43660,10996,32664,32664,0,23,10776000.0
10776,10776999,20.79122955509888,37.828173348310685,0.07497960325178599,4157.301842689514,831.3776421546936,3177.90189743042,43663,10997,32666,32666,0,23,10777000.0
10777,10777999,20.791169949941825,37.82800118475862,0.0749740943935705,4157.696980953217,831.4447045326233,3178.093448638916,43665,10998,32667,32667,0,23,10778000.0
10778,10778999,20.79098262714731,37.827490116639474,0.07497066506842898,4158.093787431717,831.5133368968964,3178.4292640686035,43667,10999,32668,32668,0,23,10779000.0
10779,10779999,20.790648128719127,37.826653302495515,0.07496898661626938,4158.4416427612305,831.5784494876862,3178.8867683410645,43670,11000,32670,32670,0,23,10780000.0
10780,10780999,20.790426631218285,37.82595287668692,0.07496631664951203,4158.96494102478,831.6446948051453,3178.3394203186035,43672,11001,32671,32671,0,23,10781000.0
10781,10781999,20.790377224270387,37.82572978529771,0.0749631840141739,4159.527538061142,831.7130196094513,3178.1912269592285,43676,11003,32673,32673,0,23,10782000.0
10782,10782999,20.790114636575858,37.82492553444088,0.07496225235724074,4160.077253580093,831.7830994129181,3177.8251762390137,43679,11004,32675,32675,0,23,10783000.0
10783,10783999,20.789870254934808,37.82416514891457,0.07496082174512264,4160.390052556992,831.8509261608124,3178.252613067627,43679,11004,32675,32675,0,23,10784000.0
10784,10784999,20.789846572004617,37.823715773824354,0.0749574621472523,4160.677364110947,831.9181005954742,3178.6421852111816,43679,11004,32675,32675,0,23,10785000.0
10785,10785999,20.78967155158642,37.82309801270498,0.07495628628445217,4160.913384914398,831.9853551387787,3179.2352714538574,43679,11004,32675,32675,0,23,10786000.0
10786,10786999,20.789414280749153,37.82237294619163,0.07495610552545118,4161.3097405433655,832.0528726577759,3179.4182472229004,43681,11005,32676,32676,0,23,10787000.0
10787,10787999,20.789190510874885,37.82157994667129,0.07495257525449572,4161.874709844589,832.1217665672302,3178.8561210632324,43688,11006,32682,32682,0,23,10788000.0
10788,10788999,20.78878904334887,37.82059019965419,0.07495143121591086,4162.397077083588,832.1897721290588,3178.8758506774902,43693,11008,32685,32685,0,23,10789000.0
10789,10789999,20.788258002670254,37.819717889383654,0.07494737131092932,4162.732280015945,832.2537484169006,3180.2827491760254,43716,11009,32707,32707,0,23,10790000.0
10790,10790999,20.787897968315132,37.819789891383834,0.07490811504563699,4163.122228860855,832.3183012008667,3181.2084770202637,43722,11011,32711,32711,0,23,10791000.0
10791,10791999,20.78724060996954,37.81865959511126,0.07490291857473352,4163.281977415085,832.3836562633514,3182.4394874572754,43722,11011,32711,32711,0,23,10792000.0
10792,10792999,20.78657671216843,37.817509407080074,0.0749030214181362,4163.806550979614,832.4472279548645,3182.6574211120605,43728,11013,32715,32715,0,23,10793000.0
10793,10793999,20.786025673909734,37.816578743407526,0.07489914770070771,4164.349098205566,832.5139462947845,3183.044101715088,43736,11016,32720,32720,0,23,10794000.0
10794,10794999,20.7855143478475,37.815722917791476,0.07489379692535336,4164.765685081482,832.5775566101074,3183.461124420166,43738,11017,32721,32721,0,23,10795000.0
10795,10795999,20.784981639890468,37.81468281806993,0.07488779817787317,4165.042493104935,832.6391985416412,3184.286434173584,43740,11018,32722,32722,0,23,10796000.0
10796,10796999,20.78446675908649,37.813777769649455,0.07488205467197584,4165.72007226944,832.7028024196625,3184.2070808410645,43750,11022,32728,32728,0,23,10797000.0
10797,10797999,20.784141475983848,37.813128557578324,0.07487153176375028,4166.303034067154,832.766485452652,3184.0253257751465,43756,11024,32732,32732,0,23,10798000.0
10798,10798999,20.783884645464052,37.812428087585005,0.07485935132690447,4166.67125082016,832.8336126804352,3184.5738258361816,43759,11025,32734,32734,0,23,10799000.0
10799,10799999,20.783613166632996,37.81178475469318,0.07485017381276005,4167.332864999771,832.8992223739624,3184.316905975342,43765,11028,32737,32737,0,23,10800000.0
10800,10800999,20.7832321647199,37.81100463229667,0.07484461126433484,4167.829368591309,832.9666185379028,3184.673816680908,43769,11030,32739,32739,0,23,10801000.0
10801,10801999,20.78277441914135,37.8100797631643,0.07484030295046773,4168.109886407852,833.0308091640472,3185.4890632629395,43771,11031,32740,32740,0,23,10802000.0
10802,10802999,20.782500109827485,37.80941170045048,0.07483417834699635,4168.620654344559,833.0971760749817,3185.256809234619,43775,11032,32743,32743,0,23,10803000.0
10803,10803999,20.782234724120393,37.80875040257107,0.07482956220014747,4168.945249795914,833.1610441207886,3185.5019493103027,43775,11032,32743,32743,0,23,10804000.0
10804,10804999,20.782243253069247,37.80848504891096,0.07482098731111897,4169.315080881119,833.2259707450867,3185.9091300964355,43777,11033,32744,32744,0,23,10805000.0
10805,10805999,20.782055179071005,37.80781070418388,0.0748162380550379,4170.055634975433,833.2935755252838,3185.5676231384277,43789,11037,32752,32752,0,23,10806000.0
10806,10806999,20.78183857622379,37.80715231078787,0.07481369693256512,4170.615030527115,833.3606896400452,3185.1816749572754,43791,11038,32753,32753,0,23,10807000.0
10807,10807999,20.78162099944382,37.80643162924316,0.0748093860492598,4171.099525213242,833.4264492988586,3185.435459136963,43797,11040,32757,32757,0,23,10808000.0
10808,10808999,20.781213240195264,37.80547969965195,0.07480723592544547,4171.452656030655,833.4930856227875,3186.0377235412598,43800,11041,32759,32759,0,23,10809000.0
10809,10809999,20.780556534217148,37.80512699016268,0.0748083282200458,4171.699757575989,833.5595223903656,3187.2008171081543,43811,11041,32770,32770,0,23,10810000.0
10810,10810999,20.779658915414362,37.803920378107144,0.07481549896387962,4172.249494552612,833.6269404888153,3187.7837867736816,43827,11044,32783,32783,0,23,10811000.0
10811,10811999,20.77870939474884,37.80250440305922,0.07482261798622125,4172.638630151749,833.6932048797607,3188.336925506592,43832,11045,32787,32787,0,23,10812000.0
10812,10812999,20.777800817444824,37.801152103262474,0.07482978255632211,4172.879616498947,833.7601323127747,3189.171787261963,43832,11045,32787,32787,0,23,10813000.0
10813,10813999,20.777036608552898,37.80014291264724,0.0748346361267318,4173.279173612595,833.8249654769897,3189.444438934326,43835,11046,32789,32789,0,23,10814000.0
10814,10814999,20.77620550041301,37.79907538599077,0.07483817485778865,4173.547851324081,833.8921177387238,3190.0159492492676,43835,11046,32789,32789,0,23,10815000.0
10815,10815999,20.77537355248921,37.79776880350909,0.07484380578767802,4173.980681180954,833.9588356018066,3190.1010704040527,43837,11047,32790,32790,0,23,10816000.0
10816,10816999,20.774679893526958,37.79671309267608,0.07484631109985529,4174.246732473373,834.0250589847565,3190.6239891052246,43838,11047,32791,32791,0,23,10817000.0
10817,10817999,20.77389156917985,37.795437952223445,0.07484982368181192,4175.071562767029,850.094753742218,3189.980640411377,43846,11051,32795,32795,0,23,10818000.0
10818,10818999,20.77334723720374,37.794651073282004,0.07484920471874013,4175.59525346756,850.1628456115723,3190.376651763916,43862,11053,32809,32809,0,23,10819000.0
10819,10819999,20.772998122721088,37.794049821499875,0.07484575170970409,4175.868388414383,850.2293856143951,3191.469585418701,43864,11054,32810,32810,0,23,10820000.0
10820,10820999,20.77262363119029,37.79340473323789,0.07484390313255163,4176.134753704071,850.3045761585236,3192.396511077881,43864,11054,32810,32810,0,23,10821000.0
10821,10821999,20.772720622797884,37.79365963465635,0.0748359295362232,4176.373333454132,850.3724942207336,3193.1536598205566,43865,11054,32811,32811,0,23,10822000.0
10822,10822999,20.772954806678733,37.794213720905944,0.07482775827404975,4176.7387228012085,850.4418427944183,3193.498508453369,43868,11055,32813,32813,0,23,10823000.0
10823,10823999,20.77350853037982,37.79643766825095,0.07481200131179166,4177.231256246567,850.5120007991791,3193.2653770446777,43870,11056,32814,32814,0,23,10824000.0
10824,10824999,20.773915393787547,37.79736674508854,0.07480392369131161,4177.74693775177,850.5813555717468,3193.070240020752,43872,11057,32815,32815,0,23,10825000.0
10825,10825999,20.774781849182872,37.79995013346125,0.07479439323021242,4178.015002012253,850.6500027179718,3193.675235748291,43872,11057,32815,32815,0,23,10826000.0
10826,10826999,20.775887478244602,37.80372566549063,0.07477975437030893,4178.420187950134,850.7183899879456,3193.8920402526855,43874,11058,32816,32816,0,23,10827000.0
10827,10827999,20.777468210880574,37.808903042115304,0.0747663272788821,4178.705205917358,850.7864594459534,3194.4279441833496,43874,11058,32816,32816,0,23,10828000.0
10828,10828999,20.7784206638584,37.811137451205425,0.07476408444620786,4178.98886013031,850.8555974960327,3194.8995933532715,43874,11058,32816,32816,0,23,10829000.0
10829,10829999,20.779390444321436,37.81306275843025,0.0747548301450045,4179.690944910049,850.9229748249054,3194.360050201416,43880,11061,32819,32819,0,23,10830000.0
10830,10830999,20.778756286447106,37.81196381125163,0.07475524354497554,4180.273171901703,850.9906985759735,3195.182788848877,43904,11064,32840,32840,0,23,10831000.0
10831,10831999,20.77810129061245,37.81151329811524,0.07475409612633865,4180.512668132782,851.0591051578522,3196.388042449951,43906,11064,32842,32842,0,23,10832000.0
10832,10832999,20.777448065581112,37.81052332884693,0.07475540459140395,4180.703860998154,851.1268327236176,3197.522846221924,43906,11064,32842,32842,0,23,10833000.0
10833,10833999,20.776929912733976,37.80957278862425,0.07475717020732542,4180.902478456497,851.1938593387604,3198.578830718994,43907,11064,32843,32843,0,23,10834000.0
10834,10834999,20.7763344515358,37.80845823973302,0.07475777971549702,4181.184189081192,851.2609548568726,3199.0928840637207,43907,11064,32843,32843,0,23,10835000.0
10835,10835999,20.77587211992978,37.80784507367677,0.07475540794995827,4181.727055072784,851.3300166130066,3199.446147918701,43923,11067,32856,32856,0,23,10836000.0
10836,10836999,20.775436171715988,37.80691196973645,0.07475536998792287,4182.298251152039,851.3971130847931,3199.3054161071777,43927,11069,32858,32858,0,23,10837000.0
10837,10837999,20.774992811841248,37.80601019338666,0.07475381832032824,4182.732283115387,851.4655497074127,3199.784366607666,43931,11071,32860,32860,0,23,10838000.0
10838,10838999,20.774492470598087,37.80492100156997,0.07475308432646321,4183.205611944199,851.5342826843262,3200.2071113586426,43935,11073,32862,32862,0,23,10839000.0
10839,10839999,20.774128139733058,37.804134986110704,0.0747490064884605,4183.452118873596,851.6028289794922,3200.9541511535645,43935,11073,32862,32862,0,23,10840000.0
10840,10840999,20.77377976793068,37.80350240020498,0.07474591404411801,4183.84264087677,851.6711192131042,3201.0441932678223,43935,11073,32862,32862,0,23,10841000.0
10841,10841999,20.773461735231102,37.80272625758396,0.07474329544654179,4184.318007946014,851.7409296035767,3201.038272857666,43937,11074,32863,32863,0,23,10842000.0
10842,10842999,20.77320175639795,37.80230734689649,0.07473903539134064,4184.853280067444,851.8096420764923,3200.9955406188965,43940,11076,32864,32864,0,23,10843000.0
10843,10843999,20.77293933213738,37.80176513744859,0.07473639818409084,4185.185518503189,851.8795809745789,3201.687717437744,43941,11077,32864,32864,0,23,10844000.0
10844,10844999,20.77276395116863,37.80133385595166,0.0747315246636513,4185.582660198212,851.9500403404236,3202.044574737549,43943,11078,32865,32865,0,23,10845000.0
10845,10845999,20.77271696186036,37.80089900885658,0.07472871230112899,4186.111041069031,852.020955324173,3202.034336090088,43948,11080,32868,32868,0,23,10846000.0
10846,10846999,20.77238504467798,37.79996323492207,0.0747302221784697,4186.490451812744,852.0908164978027,3202.4733695983887,43950,11081,32869,32869,0,23,10847000.0
10847,10847999,20.77226331829482,37.799508517632,0.07472564842456897,4186.826015472412,852.1600978374481,3202.7379112243652,43950,11081,32869,32869,0,23,10848000.0
10848,10848999,20.772254148264484,37.799182957422104,0.07472201638249398,4187.2341520786285,852.2312834262848,3202.8105964660645,43950,11081,32869,32869,0,23,10849000.0
10849,10849999,20.77200495403748,37.798545857374286,0.0747208292959134,4187.438126325607,852.3005313873291,3203.6571922302246,43950,11081,32869,32869,0,23,10850000.0
10850,10850999,20.771565918851316,37.797483568788635,0.07471885149314905,4187.736299276352,852.3693764209747,3204.3457679748535,43955,11081,32874,32874,0,23,10851000.0
10851,10851999,20.77140415296865,37.79682880680352,0.07471107658294984,4188.255779743195,852.4338657855988,3204.7393531799316,43967,11083,32884,32884,0,23,10852000.0
10852,10852999,20.770783147718916,37.795638941473804,0.07471460492701143,4188.792132616043,852.4998645782471,3205.391124725342,43980,11086,32894,32894,0,23,10853000.0
10853,10853999,20.7702349624079,37.794493276525664,0.07471251265948087,4189.130174398422,852.5726199150085,3206.2593116760254,43987,11087,32900,32900,0,23,10854000.0
10854,10854999,20.769867685392732,37.793583209012944,0.07470464143004163,4189.369827032089,852.6463994979858,3207.364475250244,43989,11087,32902,32902,0,23,10855000.0
10855,10855999,20.76969901762685,37.79372436461116,0.07469274055693687,4189.831574440002,852.7107489109039,3207.719455718994,43996,11089,32907,32907,0,23,10856000.0
10856,10856999,20.769331987030863,37.79277785544079,0.07469090903835562,4190.491691112518,852.776447057724,3207.3802223205566,44006,11092,32914,32914,0,23,10857000.0
10857,10857999,20.768927188714713,37.79194561200017,0.07468807958643608,4191.301207065582,852.84113240242,3207.245029449463,44017,11097,32920,32920,0,23,10858000.0
10858,10858999,20.7685405376847,37.791361581741185,0.07468430824189254,4191.874279499054,852.9058315753937,3207.573513031006,44025,11100,32925,32925,0,23,10859000.0
10859,10859999,20.768192065829727,37.79204410422322,0.07467688042561815,4192.0538074970245,852.9745700359344,3208.8260917663574,44025,11100,32925,32925,0,23,10860000.0
10860,10860999,20.767884465285654,37.79131121610937,0.07467435103323594,4192.551115036011,853.0395588874817,3209.0946617126465,44031,11102,32929,32929,0,23,10861000.0
10861,10861999,20.767456654020894,37.79042005220652,0.07467616442020186,4193.12859249115,853.1051144599915,3209.343029022217,44038,11105,32933,32933,0,23,10862000.0
10862,10862999,20.767000372312285,37.789353593756324,0.07467782428953518,4193.507514953613,853.1717929840088,3209.8915519714355,44040,11106,32934,32934,0,23,10863000.0
10863,10863999,20.7667360224816,37.78857191706641,0.07467817238510743,4193.987216949463,853.2395355701447,3210.0054054260254,44042,11107,32935,32935,0,23,10864000.0
10864,10864999,20.766576844250487,37.78783314002025,0.0746804973825429,4194.390383005142,853.3044812679291,3210.3625144958496,44044,11108,32936,32936,0,23,10865000.0
10865,10865999,20.766323624684738,37.78724673415596,0.07468457280906748,4194.596420288086,853.3697044849396,3211.341823577881,44044,11108,32936,32936,0,23,10866000.0
10866,10866999,20.765932544966574,37.7862769239246,0.07468835408999996,4195.3825070858,853.4368119239807,3211.2692222595215,44071,11112,32959,32959,0,23,10867000.0
10867,10867999,20.765220691103995,37.78533574137701,0.07469067951926556,4195.708948612213,853.5057537555695,3212.4487113952637,44078,11113,32965,32965,0,23,10868000.0
10868,10868999,20.764448331294542,37.78415404845809,0.07469824360942123,4195.878288507462,853.5737352371216,3213.818500518799,44078,11113,32965,32965,0,23,10869000.0
10869,10869999,20.763654477089347,37.78282780226626,0.07470761763130795,4196.231405735016,853.6421194076538,3214.5431632995605,44080,11114,32966,32966,0,23,10870000.0
10870,10870999,20.7629932209816,37.781972306079325,0.0747121873292661,4196.532351493835,853.7118666172028,3215.352870941162,44082,11115,32967,32967,0,23,10871000.0
10871,10871999,20.76226831564381,37.78078763474824,0.07471891778447415,4197.373381614685,853.7834148406982,3215.002498626709,44094,11120,32974,32974,0,23,10872000.0
10872,10872999,20.761593979642043,37.77978383903796,0.07472385763670297,4198.172733783722,853.8562209606171,3214.9463844299316,44107,11125,32982,32982,0,23,10873000.0
10873,10873999,20.761009231837637,37.77911994800996,0.07472542757847456,4198.534992933273,853.9281942844391,3215.647472381592,44109,11126,32983,32983,0,23,10874000.0
10874,10874999,20.760787146152293,37.77910614274749,0.07472092369484007,4198.813359260559,853.9979832172394,3216.371898651123,44109,11126,32983,32983,0,23,10875000.0
10875,10875999,20.760434780091998,37.778466557885295,0.07471995219134286,4199.187211751938,854.0703358650208,3216.917308807373,44111,11127,32984,32984,0,23,10876000.0
10876,10876999,20.76003111402393,37.77786687268799,0.07472028281575238,4199.489324808121,854.140031337738,3217.293972015381,44111,11127,32984,32984,0,23,10877000.0
10877,10877999,20.759846461307298,37.777435817599184,0.07471836234201601,4199.876186609268,854.2094249725342,3217.551471710205,44113,11128,32985,32985,0,23,10878000.0
10878,10878999,20.759746003798906,37.77714029533468,0.07471755923168599,4200.491690158844,854.2785911560059,3217.3617973327637,44118,11130,32988,32988,0,23,10879000.0
10879,10879999,20.75959252903268,37.77663154441743,0.07471777980513283,4201.293371677399,854.3529314994812,3216.531841278076,44124,11133,32991,32991,0,23,10880000.0
10880,10880999,20.759494262869808,37.77608249103291,0.07471674633196368,4201.558760643005,854.4236876964569,3217.273754119873,44124,11133,32991,32991,0,23,10881000.0
10881,10881999,20.759170591666837,37.77516124930931,0.07471755787492373,4201.989439725876,854.4951121807098,3217.574619293213,44128,11134,32994,32994,0,23,10882000.0
10882,10882999,20.758882659168993,37.77433814452399,0.07471884842067411,4202.449289321899,854.5647118091583,3217.611301422119,44132,11135,32997,32997,0,23,10883000.0
10883,10883999,20.758539697624332,37.774249875789586,0.07471393684049965,4202.775943279266,854.637631893158,3217.989513397217,44132,11135,32997,32997,0,23,10884000.0
10884,10884999,20.75791097834212,37.77313867232255,0.07471312503736294,4203.125772714615,854.701699256897,3219.2680854797363,44154,11136,33018,33018,0,23,10885000.0
10885,10885999,20.757235687474193,37.772762111580086,0.07471245924781933,4203.527551651001,854.7668445110321,3220.0168647766113,44157,11137,33020,33020,0,23,10886000.0
10886,10886999,20.756395642644495,37.77141096199186,0.07471821849154103,4203.810727596283,854.8323938846588,3220.8374214172363,44157,11137,33020,33020,0,23,10887000.0
10887,10887999,20.755630926602812,37.77014364231655,0.07472494859331402,4204.133402585983,854.8980059623718,3221.583354949951,44159,11138,33021,33021,0,23,10888000.0
10888,10888999,20.754978857913848,37.7692388328091,0.07472659026046702,4204.318375825882,854.962703704834,3222.503978729248,44159,11138,33021,33021,0,23,10889000.0
10889,10889999,20.754303293690086,37.76813111567286,0.07472888898789287,4204.907513856888,855.0281012058258,3222.4325981140137,44167,11141,33026,33026,0,23,10890000.0
10890,10890999,20.75357379547242,37.766981020201584,0.07473074767188437,4205.128771305084,855.0920286178589,3223.289539337158,44167,11141,33026,33026,0,23,10891000.0
10891,10891999,20.75315536864218,37.76639621909702,0.07473030126310198,4205.647353410721,855.1591310501099,3223.3593711853027,44173,11143,33030,33030,0,23,10892000.0
10892,10892999,20.75313384607725,37.767514013216875,0.0747205129401205,4205.844819784164,855.2243926525116,3224.2990074157715,44173,11143,33030,33030,0,23,10893000.0
10893,10893999,20.753534355308933,37.7687979182163,0.07471069592735224,4206.39676451683,855.2904212474823,3224.2073707580566,44187,11145,33042,33042,0,23,10894000.0
10894,10894999,20.754544832964974,37.77251854113483,0.07470101442444721,4207.043694496155,855.3571810722351,3224.0265007019043,44193,11148,33045,33045,0,23,10895000.0
10895,10895999,20.755701340149255,37.775091444310675,0.07471053790056947,4207.494431734085,855.4221935272217,3224.1216621398926,44195,11149,33046,33046,0,23,10896000.0
10896,10896999,20.757156298235657,37.778451405025066,0.0747100048384095,4208.2240858078,855.4895324707031,3223.9053993225098,44203,11153,33050,33050,0,23,10897000.0
10897,10897999,20.758744569808293,37.781643477868016,0.07473558700389515,4208.872872829437,855.5586421489716,3223.8858909606934,44209,11156,33053,33053,0,23,10898000.0
10898,10898999,20.760329171636226,37.78483851678833,0.07476956519183786,4209.500048398972,855.6261026859283,3224.0862922668457,44217,11160,33057,33057,0,23,10899000.0
10899,10899999,20.76191497080231,37.78763854089773,0.0747913178065609,4209.821347951889,855.6922564506531,3224.808994293213,44219,11161,33058,33058,0,23,10900000.0
10900,10900999,20.76348832683956,37.79057970602705,0.07482700972506395,4210.141570568085,855.7592053413391,3225.234043121338,44219,11161,33058,33058,0,23,10901000.0
10901,10901999,20.764876754797058,37.79250189948737,0.07483626482459838,4210.664564609528,855.8272581100464,3225.199146270752,44222,11163,33059,33059,0,23,10902000.0
10902,10902999,20.766504164403386,37.795103209850616,0.074859812887492,4211.2298703193665,855.8959445953369,3224.732578277588,44224,11164,33060,33060,0,23,10903000.0
10903,10903999,20.7675882867944,37.796868851083765,0.07486290730049738,4211.565885305405,855.9625070095062,3225.2940635681152,44225,11164,33061,33061,0,23,10904000.0
10904,10904999,20.76703388241024,37.79668770015675,0.07485589436937634,4211.924633264542,856.0293211936951,3226.42427444458,44245,11165,33080,33080,0,23,10905000.0
10905,10905999,20.766424785770294,37.79643118497145,0.0748532549733325,4212.27916097641,856.0948038101196,3227.217571258545,44247,11166,33081,33081,0,23,10906000.0
10906,10906999,20.766000256897886,37.795597425829044,0.07485284804256687,4212.540846824646,856.1605353355408,3227.9950675964355,44247,11166,33081,33081,0,23,10907000.0
10907,10907999,20.765843505985863,37.79566323049807,0.07484666115945027,4212.837745189667,856.2269768714905,3228.4566230773926,44247,11166,33081,33081,0,23,10908000.0
10908,10908999,20.76553282549239,37.79483811226051,0.0748447992819068,4213.28179359436,856.2957165241241,3228.9739723205566,44312,11168,33144,33144,0,23,10909000.0
10909,10909999,20.765411216952685,37.79473950991324,0.07484179306791561,4213.998962879181,856.3629622459412,3229.099826812744,44320,11172,33148,33148,0,23,10910000.0
10910,10910999,20.765296866295987,37.79432399416048,0.07484321301377928,4214.353063821793,856.4292602539062,3229.734706878662,44322,11173,33149,33149,0,23,10911000.0
10911,10911999,20.765311981350298,37.79416696949565,0.07484187361607819,4214.594882488251,856.4970633983612,3230.4586067199707,44322,11173,33149,33149,0,23,10912000.0
10912,10912999,20.765599553058767,37.794626229781834,0.07483626672375876,4215.049446105957,856.5653810501099,3230.455066680908,44324,11174,33150,33150,0,23,10913000.0
10913,10913999,20.765795040150287,37.79459693603834,0.0748334862366703,4215.534803390503,856.6326770782471,3230.485752105713,44326,11175,33151,33151,0,23,10914000.0
10914,10914999,20.76616669831925,37.794821094396426,0.0748286303860638,4216.108190774918,856.7032973766327,3230.633556365967,44332,11178,33154,33154,0,23,10915000.0
10915,10915999,20.76680134963807,37.79564555894184,0.07483196734870667,4216.267048835754,856.770646572113,3231.741512298584,44332,11178,33154,33154,0,23,10916000.0
10916,10916999,20.76723698321416,37.79602943642919,0.07483426614060795,4216.801666021347,856.8384544849396,3231.4960136413574,44334,11179,33155,33155,0,23,10917000.0
10917,10917999,20.767841164836444,37.79671972139229,0.07483682860792429,4217.157743692398,856.9166903495789,3231.9028358459473,44334,11179,33155,33155,0,23,10918000.0
10918,10918999,20.76850394307312,37.798026499945436,0.07483222952338475,4217.577482700348,856.9875392913818,3232.2468757629395,44336,11180,33156,33156,0,23,10919000.0
10919,10919999,20.769234174531178,37.79884752330517,0.07483385217272487,4218.135101318359,857.0586726665497,3231.9594383239746,44338,11181,33157,33157,0,23,10920000.0
10920,10920999,20.77010370791536,37.801343806223855,0.07483304690044945,4218.471239328384,857.1275470256805,3232.3351097106934,44338,11181,33157,33157,0,23,10921000.0
10921,10921999,20.77087605917211,37.802356782369536,0.07483076993729398,4218.638303995132,857.1959443092346,3233.340663909912,44338,11181,33157,33157,0,23,10922000.0
10922,10922999,20.771477106463742,37.80306772613865,0.07483284837133908,4219.0102570056915,857.2645673751831,3233.4349937438965,44338,11181,33157,33157,0,23,10923000.0
10923,10923999,20.771960924079437,37.803133922126236,0.07483577702150745,4219.366007804871,857.3372015953064,3233.8166465759277,44338,11181,33157,33157,0,23,10924000.0
10924,10924999,20.77221097854529,37.80344055815399,0.07481889893166804,4219.764285326004,857.4049484729767,3234.673496246338,44356,11182,33174,33174,0,23,10925000.0
10925,10925999,20.771684209479382,37.803257449879524,0.07481477851312757,4219.967768907547,857.4757187366486,3236.072078704834,44357,11182,33175,33175,0,23,10926000.0
10926,10926999,20.771035751016143,37.802994961148215,0.07481431760283086,4220.405041217804,857.5390162467957,3236.4057273864746,44361,11183,33178,33178,0,23,10927000.0
10927,10927999,20.770426921122866,37.801958180520444,0.07481638775276722,4220.723955869675,857.6018531322479,3237.0660362243652,44363,11184,33179,33179,0,23,10928000.0
10928,10928999,20.769897216255288,37.80133687254099,0.07481465706916612,4221.174644231796,857.6650035381317,3237.548313140869,44367,11186,33181,33181,0,23,10929000.0
10929,10929999,20.769212813595765,37.80010014995726,0.0748177963890595,4221.573526620865,857.7286849021912,3238.010395050049,44371,11188,33183,33183,0,23,10930000.0
10930,10930999,20.768630023674636,37.79901687687834,0.07481804469409803,4222.227974176407,857.7926695346832,3238.0188179016113,44387,11191,33196,33196,0,23,10931000.0
10931,10931999,20.76803772638828,37.79804017880909,0.07481729774321444,4222.639079332352,857.8561027050018,3238.249256134033,44389,11192,33197,33197,0,23,10932000.0
10932,10932999,20.767634432632544,37.797256683540276,0.07481471643121962,4222.993161678314,857.9194781780243,3238.8063163757324,44391,11193,33198,33198,0,23,10933000.0
10933,10933999,20.76721415047985,37.79653606382903,0.07481169978146718,4223.310478448868,857.9820733070374,3239.5049324035645,44393,11194,33199,33199,0,23,10934000.0
10934,10934999,20.766981031932055,37.796145914043336,0.07480414992845774,4223.556915521622,858.0450823307037,3240.110507965088,44393,11194,33199,33199,0,23,10935000.0
10935,10935999,20.76711731386594,37.796303690934714,0.07479423125320728,4224.030755519867,858.1078262329102,3240.0480308532715,44395,11195,33200,33200,0,23,10936000.0
10936,10936999,20.76779939220969,37.79726312615715,0.07478299216024764,4224.531692028046,858.1711587905884,3239.970615386963,44397,11196,33201,33201,0,23,10937000.0
10937,10937999,20.769020393192058,37.79973209315903,0.07476359567369462,4225.055135011673,858.2350780963898,3240.1074714660645,44403,11198,33205,33205,0,23,10938000.0
10938,10938999,20.770516535485985,37.80231446808443,0.07475478983775474,4225.455165863037,858.3030841350555,3240.524959564209,44406,11199,33207,33207,0,23,10939000.0
10939,10939999,20.772194362366918,37.80522422029818,0.07474528950519532,4225.776119709015,858.3690659999847,3240.8154792785645,44406,11199,33207,33207,0,23,10940000.0
10940,10940999,20.774402370530588,37.80944667156717,0.07473687871860268,4226.550629854202,858.4349448680878,3240.0663719177246,44413,11202,33211,33211,0,23,10941000.0
10941,10941999,20.776261085623094,37.81214330127471,0.07474151580947164,4226.977952241898,858.4985320568085,3240.353282928467,44415,11203,33212,33212,0,23,10942000.0
10942,10942999,20.778426987355623,37.81545119699989,0.07475543192106548,4227.265075683594,858.5643417835236,3240.9443168640137,44415,11203,33212,33212,0,23,10943000.0
10943,10943999,20.780220685286668,37.81772694074858,0.07476529246815677,4227.676438808441,858.6288592815399,3241.457904815674,44420,11205,33215,33215,0,23,10944000.0
10944,10944999,20.780747622387747,37.817997436536814,0.07476695968547808,4227.869820356369,858.6913690567017,3242.7927436828613,44430,11205,33225,33225,0,23,10945000.0
10945,10945999,20.78004575639344,37.81707862880323,0.07476913276051855,4228.024867296219,858.7568776607513,3244.058925628662,44431,11205,33226,33226,0,23,10946000.0
10946,10946999,20.77947249225917,37.81616821920931,0.07476963346918242,4228.64230632782,858.8239367008209,3244.0981636047363,44439,11208,33231,33231,0,23,10947000.0
10947,10947999,20.77891286002048,37.815223026675774,0.0747700757339762,4229.167065143585,858.8900382518768,3244.3904304504395,44447,11210,33237,33237,0,23,10948000.0
10948,10948999,20.77838327946686,37.814334742300865,0.07476936335128337,4229.6637840271,858.9564523696899,3244.131488800049,44449,11211,33238,33238,0,23,10949000.0
10949,10949999,20.77769132311297,37.81328047064602,0.0747714322440759,4230.233561038971,859.0218074321747,3244.244930267334,44458,11214,33244,33244,0,23,10950000.0
10950,10950999,20.777041434962904,37.81226238505289,0.07477209724928013,4230.59717297554,859.0877647399902,3244.752826690674,44460,11215,33245,33245,0,23,10951000.0
10951,10951999,20.77644689489024,37.81120237822831,0.07477359579520193,4230.987727403641,859.154111623764,3244.9361152648926,44462,11216,33246,33246,0,23,10952000.0
10952,10952999,20.776166354381814,37.810782325397334,0.07476926304135223,4231.38973903656,859.2195599079132,3245.036708831787,44463,11216,33247,33247,0,23,10953000.0
10953,10953999,20.775890771663757,37.8103236315638,0.07476850397969503,4231.922307252884,859.2882809638977,3245.2040672302246,44469,11218,33251,33251,0,23,10954000.0
10954,10954999,20.77575208681043,37.810220911145244,0.07476632819639129,4232.359082937241,859.3546762466431,3245.4106483459473,44471,11219,33252,33252,0,23,10955000.0
10955,10955999,20.775876041540855,37.81047949702334,0.07476120913494033,4232.843022584915,859.4235365390778,3245.7189979553223,44475,11221,33254,33254,0,23,10956000.0
10956,10956999,20.776195970763432,37.810926913690366,0.07475395750673386,4233.008563280106,859.4901313781738,3246.7610206604004,44475,11221,33254,33254,0,23,10957000.0
10957,10957999,20.776919116856416,37.81210451391282,0.0747475418196405,4233.57394695282,859.5563161373138,3246.575885772705,44480,11223,33257,33257,0,23,10958000.0
10958,10958999,20.7778948515537,37.81371489347689,0.0747441645383844,4233.943923711777,859.6248986721039,3246.6959648132324,44480,11223,33257,33257,0,23,10959000.0
10959,10959999,20.779459355022556,37.81646365973938,0.07474503449362568,4234.322025060654,859.6916038990021,3247.184558868408,44482,11224,33258,33258,0,23,10960000.0
10960,10960999,20.780471745112855,37.81759291535561,0.07474490309699078,4234.860634803772,859.7594799995422,3247.110050201416,44490,11226,33264,33264,0,23,10961000.0
10961,10961999,20.78179498141861,37.81996157610382,0.074741162444254,4235.3968024253845,859.8301155567169,3247.2152824401855,44494,11228,33266,33266,0,23,10962000.0
10962,10962999,20.783198973691142,37.82172261082834,0.07473756920700347,4235.7719802856445,859.8967664241791,3247.658489227295,44498,11229,33269,33269,0,23,10963000.0
10963,10963999,20.784131160968265,37.82266986921073,0.07472345377252942,4236.239693880081,859.9630234241486,3248.1174812316895,44510,11230,33280,33280,0,23,10964000.0
10964,10964999,20.783647078421538,37.822022581726685,0.0747126834802454,4236.673117160797,860.0331680774689,3248.873302459717,44516,11232,33284,33284,0,23,10965000.0
10965,10965999,20.782992274020753,37.82086620358415,0.07470974968008615,4237.046897411346,860.1014454364777,3249.19633102417,44517,11232,33285,33285,0,23,10966000.0
10966,10966999,20.782378275617692,37.81986247871079,0.07470775380949268,4237.324206352234,860.1707091331482,3250.479465484619,44532,11233,33299,33299,0,23,10967000.0
10967,10967999,20.78178568007321,37.81887995615834,0.07470523784650618,4237.77148270607,860.2407600879669,3251.0856132507324,44536,11235,33301,33301,0,23,10968000.0
10968,10968999,20.7811639728892,37.817820673463764,0.07470618352372416,4238.041265010834,860.3129403591156,3251.843173980713,44537,11235,33302,33302,0,23,10969000.0
10969,10969999,20.780502100641375,37.81678057816443,0.0747049780976331,4238.429751634598,860.3846487998962,3252.325481414795,44539,11236,33303,33303,0,23,10970000.0
10970,10970999,20.77991306941718,37.81604981624392,0.07470084083733619,4238.735701084137,860.4543669223785,3252.7884483337402,44539,11236,33303,33303,0,23,10971000.0
10971,10971999,20.779353551142627,37.81502907741988,0.07470151326588781,4239.057316541672,860.5262780189514,3253.3654136657715,44541,11237,33304,33304,0,23,10972000.0
10972,10972999,20.779106937941766,37.81485834659985,0.0746970050677942,4239.412835121155,860.5957765579224,3253.472194671631,44541,11237,33304,33304,0,23,10973000.0
10973,10973999,20.77921941246248,37.81512932904493,0.07469306036263601,4239.889634847641,860.6671588420868,3253.849018096924,44545,11239,33306,33306,0,23,10974000.0
10974,10974999,20.779895483069758,37.81692425131353,0.0746926233242885,4240.228499174118,860.7372057437897,3254.05668258667,44545,11239,33306,33306,0,23,10975000.0
10975,10975999,20.78084097557833,37.81931721811544,0.07469752370472327,4240.571467638016,860.8110947608948,3254.4291648864746,44545,11239,33306,33306,0,23,10976000.0
10976,10976999,20.781662331947548,37.82118831675659,0.07470595240977951,4240.820873498917,860.8813781738281,3255.0676765441895,44545,11239,33306,33306,0,23,10977000.0
10977,10977999,20.78289187822861,37.82402998970353,0.07472031383677014,4241.477699279785,860.9523546695709,3254.5822563171387,44549,11241,33308,33308,0,23,10978000.0
10978,10978999,20.784483328856197,37.82899466744081,0.07473072410766401,4241.904229640961,861.0247664451599,3254.772319793701,44551,11242,33309,33309,0,23,10979000.0
10979,10979999,20.78640768149623,37.83414768226312,0.0747593157407439,4242.4048182964325,861.0952920913696,3254.5719032287598,44553,11243,33310,33310,0,23,10980000.0
10980,10980999,20.788735836370673,37.84089391046392,0.07479274021675408,4242.8944301605225,861.1665403842926,3254.8267555236816,44557,11245,33312,33312,0,23,10981000.0
10981,10981999,20.79077804802982,37.84525090437176,0.07482844286064483,4243.437932014465,861.2375729084015,3254.976848602295,44561,11247,33314,33314,0,23,10982000.0
10982,10982999,20.793528445055383,37.85148736494818,0.07487722854982015,4244.078761339188,861.3153109550476,3255.102695465088,44567,11250,33317,33317,0,23,10983000.0
10983,10983999,20.795453908618242,37.85501964974208,0.074909381601586,4244.496387481689,861.3896906375885,3255.55171585083,44569,11251,33318,33318,0,23,10984000.0
10984,10984999,20.795587018594016,37.85518840519485,0.07490105559992777,4244.961763143539,861.4606845378876,3256.0696907043457,44581,11252,33329,33329,0,23,10985000.0
10985,10985999,20.795128752770168,37.85428482428823,0.07489576210730142,4245.512063026428,861.5245985984802,3256.6261558532715,44605,11255,33350,33350,0,23,10986000.0
10986,10986999,20.795012840019037,37.85446718761588,0.07488660171083616,4245.778967618942,861.5876884460449,3258.0590858459473,44611,11256,33355,33355,0,23,10987000.0
10987,10987999,20.794924980145066,37.85396394736701,0.0748725184788761,4245.973728179932,861.6516468524933,3259.2495460510254,44613,11256,33357,33357,0,23,10988000.0
10988,10988999,20.794809104215652,37.8534275094457,0.07485911180784544,4246.151661634445,861.7157371044159,3260.389263153076,44617,11256,33361,33361,0,23,10989000.0
10989,10989999,20.794600656772793,37.85271151268564,0.07485257332200401,4246.632236242294,861.7800192832947,3260.608860015869,44625,11258,33367,33367,0,23,10990000.0
10990,10990999,20.794312134976522,37.85191541070461,0.07484445185817179,4247.417197465897,861.844051361084,3260.0175437927246,44636,11262,33374,33374,0,23,10991000.0
10991,10991999,20.794096570414847,37.851500268386275,0.07483790886146635,4247.982246398926,861.9110872745514,3260.347599029541,44642,11265,33377,33377,0,23,10992000.0
10992,10992999,20.793954837168585,37.850910958184116,0.07482839279626008,4248.301830768585,861.9747841358185,3261.0844078063965,44646,11266,33380,33380,0,23,10993000.0
10993,10993999,20.79388201946071,37.85048595013836,0.07481643265962523,4248.630505561829,862.0391621589661,3261.5934410095215,44648,11267,33381,33381,0,23,10994000.0
10994,10994999,20.793782586043708,37.84982870705502,0.07480792079149134,4249.024052858353,862.1035323143005,3261.937961578369,44651,11268,33383,33383,0,23,10995000.0
10995,10995999,20.793896973532092,37.84972957782881,0.0747925712406331,4249.503354072571,862.172060251236,3261.98140335083,44653,11269,33384,33384,0,23,10996000.0
10996,10996999,20.793824624518486,37.84916016196968,0.07478842360529125,4250.353010892868,862.2378680706024,3261.415599822998,44666,11274,33392,33392,0,23,10997000.0
10997,10997999,20.79393631115219,37.848962374769286,0.07478046114309778,4251.082753419876,862.305299282074,3261.307430267334,44676,11278,33398,33398,0,23,10998000.0
10998,10998999,20.794017405692294,37.84861540794699,0.07477229222173543,4251.531024456024,862.3708391189575,3261.5319328308105,44678,11279,33399,33399,0,23,10999000.0
10999,10999999,20.794243232159747,37.8483177675048,0.07475811411006639,4251.770724534988,862.4369504451752,3262.269863128662,44678,11279,33399,33399,0,23,11000000.0
11000,11000999,20.794234094691408,37.84769832487995,0.07475110694524001,4252.183509588242,862.5007555484772,3262.4192390441895,44680,11280,33400,33400,0,23,11001000.0
11001,11001999,20.79440123179818,37.84749274373385,0.0747423019622866,4252.582439184189,862.5764274597168,3262.724826812744,44682,11281,33401,33401,0,23,11002000.0
11002,11002999,20.794626207959098,37.848002216931995,0.0747331936222222,4253.2394189834595,862.6454203128815,3262.5480766296387,44689,11284,33405,33405,0,23,11003000.0
11003,11003999,20.794591583119285,37.84738274711959,0.0747243162732425,4253.648530721664,862.710410118103,3262.9151649475098,44692,11285,33407,33407,0,23,11004000.0
11004,11004999,20.794471135686322,37.84663741992719,0.07472031825627923,4254.2889013290405,862.7814013957977,3263.0160331726074,44705,11288,33417,33417,0,23,11005000.0
11005,11005999,20.7944613311649,37.846744492866925,0.07471371936896387,4254.482616424561,862.8491942882538,3264.662624359131,44723,11288,33435,33435,0,23,11006000.0
11006,11006999,20.79417238053119,37.84626208850282,0.07471332835921907,4254.6998455524445,862.9171607494354,3265.7858543395996,44723,11288,33435,33435,0,23,11007000.0
11007,11007999,20.793950323778358,37.84566159670994,0.07471188161020792,4255.190340995789,862.9920198917389,3266.1910362243652,44727,11290,33437,33437,0,23,11008000.0
11008,11008999,20.793537241586982,37.844693194301435,0.07471172016638739,4255.8369126319885,863.0617172718048,3266.4306144714355,44736,11294,33442,33442,0,23,11009000.0
11009,11009999,20.793232202541724,37.84392784263514,0.07471179659668414,4256.382705211639,863.133306980133,3266.845600128174,44745,11297,33448,33448,0,23,11010000.0
11010,11010999,20.793138628181797,37.84342516838206,0.07471062081208146,4256.872493982315,863.2052190303802,3267.253673553467,44749,11299,33450,33450,0,23,11011000.0
11011,11011999,20.793072022629868,37.842897339547235,0.07470607492395209,4257.395143270493,863.2764897346497,3267.487392425537,44755,11301,33454,33454,0,23,11012000.0
11012,11012999,20.792907214581273,37.84246227750334,0.07470455873245685,4257.8599100112915,863.3453714847565,3268.0328788757324,44760,11303,33457,33457,0,23,11013000.0
11013,11013999,20.792954992381336,37.842222799928905,0.07469826997269413,4258.221993923187,863.4146733283997,3268.7337226867676,44762,11304,33458,33458,0,23,11014000.0
11014,11014999,20.792994271864377,37.84185685109497,0.07469265967048078,4258.760547876358,863.4841072559357,3268.8157691955566,44767,11306,33461,33461,0,23,11015000.0
11015,11015999,20.793101355655722,37.841684535508094,0.07468628580504533,4259.208881616592,863.5533142089844,3269.102794647217,44769,11307,33462,33462,0,23,11016000.0
11016,11016999,20.793074514640892,37.841093611494266,0.07468170874291213,4259.540509700775,863.6290347576141,3269.5914573669434,44769,11307,33462,33462,0,23,11017000.0
11017,11017999,20.79330881658688,37.840957650946,0.07467442651210088,4259.78729057312,863.6999886035919,3270.2285804748535,44769,11307,33462,33462,0,23,11018000.0
11018,11018999,20.793464653107492,37.840697040188466,0.07466635445744452,4260.105001926422,863.7702560424805,3270.7292137145996,44769,11307,33462,33462,0,23,11019000.0
11019,11019999,20.79350059757293,37.84018571198114,0.07465999012481372,4260.600724697113,863.8470258712769,3270.731876373291,44771,11308,33463,33463,0,23,11020000.0
11020,11020999,20.793535345322233,37.839794667632546,0.07465407645775446,4260.961189985275,863.9155247211456,3270.9143409729004,44771,11308,33463,33463,0,23,11021000.0
11021,11021999,20.793458210478143,37.83904664377133,0.07465003346698718,4261.342489957809,863.9863851070404,3271.0845069885254,44771,11308,33463,33463,0,23,11022000.0
11022,11022999,20.79327749372892,37.83924750615007,0.07464677646832574,4261.785199642181,864.0540654659271,3271.5273475646973,44776,11309,33467,33467,0,23,11023000.0
11023,11023999,20.79246322008889,37.83819312538567,0.0746533769926474,4262.162543773651,864.1189963817596,3272.5936317443848,44787,11311,33476,33476,0,23,11024000.0
11024,11024999,20.7916009184884,37.83684079969917,0.07466065835051305,4262.4472024440765,864.1860253810883,3273.383617401123,44789,11311,33478,33478,0,23,11025000.0
11025,11025999,20.790771966646684,37.835525036893,0.0746676608135195,4263.031802415848,864.2591545581818,3273.3823738098145,44804,11313,33491,33491,0,23,11026000.0
11026,11026999,20.79017944106185,37.834725664310646,0.07466762279830019,4263.31763958931,864.3344798088074,3274.010066986084,44804,11313,33491,33491,0,23,11027000.0
11027,11027999,20.789850123968776,37.835558711830224,0.07466209325069717,4263.64489364624,864.3988163471222,3274.5367393493652,44806,11314,33492,33492,0,23,11028000.0
11028,11028999,20.790245977905343,37.83777918109546,0.07466804583138109,4263.864185333252,864.4637868404388,3275.387981414795,44807,11314,33493,33493,0,23,11029000.0
11029,11029999,20.791200118656903,37.84185058603467,0.07468831675148524,4264.218827009201,864.5290780067444,3275.744457244873,44809,11315,33494,33494,0,23,11030000.0
11030,11030999,20.792496312338066,37.84738846075848,0.07474208401552374,4265.120544672012,864.6012833118439,3275.047565460205,44817,11319,33498,33498,0,23,11031000.0
11031,11031999,20.79336897094889,37.85069630788834,0.07479516642228023,4265.535635232925,864.6668229103088,3275.4757041931152,44820,11320,33500,33500,0,23,11032000.0
11032,11032999,20.79458643060063,37.85494568002886,0.0748315030995157,4265.965530157089,864.7324297428131,3275.498622894287,44820,11320,33500,33500,0,23,11033000.0
11033,11033999,20.79634587824257,37.86074854232709,0.07488566242050487,4266.213203191757,864.7991530895233,3276.2783164978027,44820,11320,33500,33500,0,23,11034000.0
11034,11034999,20.798331778504206,37.86715438998636,0.07490528377660877,4266.615685939789,864.8659465312958,3276.5675086975098,44822,11321,33501,33501,0,23,11035000.0
11035,11035999,20.800760197008078,37.87452104004673,0.07492234640476692,4266.899765253067,864.9320070743561,3277.0929374694824,44822,11321,33501,33501,0,23,11036000.0
11036,11036999,20.803356397884087,37.881424114746196,0.07494209813684372,4267.347237110138,864.9977922439575,3277.1581993103027,44824,11322,33502,33502,0,23,11037000.0
11037,11037999,20.806353552491874,37.88926961953864,0.07499266562006768,4267.845583677292,865.0677292346954,3277.260829925537,44830,11324,33506,33506,0,23,11038000.0
11038,11038999,20.809104520087395,37.89572170121361,0.07503775727904438,4268.3520250320435,865.1336364746094,3277.450428009033,44834,11326,33508,33508,0,23,11039000.0
11039,11039999,20.811680870551257,37.90171371627745,0.07508150626072774,4268.882854223251,865.2016696929932,3277.4549827575684,44839,11328,33511,33511,0,23,11040000.0
11040,11040999,20.814346493948428,37.90707390877607,0.07510920022210665,4269.167660713196,865.2686078548431,3277.9358406066895,44839,11328,33511,33511,0,23,11041000.0
11041,11041999,20.816600290505054,37.91141835926395,0.07513253148400323,4269.734605789185,865.3361117839813,3277.717601776123,44843,11330,33513,33513,0,23,11042000.0
11042,11042999,20.816362684405714,37.911801476383445,0.07512561760329539,4270.081465482712,865.403727054596,3278.599193572998,44849,11331,33518,33518,0,23,11043000.0
11043,11043999,20.815905414735763,37.91201755051925,0.07512339056573791,4270.353751659393,865.471485376358,3279.2401161193848,44849,11331,33518,33518,0,23,11044000.0
11044,11044999,20.815845621874182,37.91275656604608,0.07511501685228228,4270.727537155151,865.5400466918945,3279.7411460876465,44852,11332,33520,33520,0,23,11045000.0
11045,11045999,20.815715514580987,37.91264375483002,0.07511101364264483,4271.2323043346405,865.6096470355988,3279.563617706299,44857,11333,33524,33524,0,23,11046000.0
11046,11046999,20.815489077235878,37.91223179253106,0.07510753020942518,4271.722704648972,865.6790595054626,3279.6214561462402,44869,11334,33535,33535,0,23,11047000.0
11047,11047999,20.81524459381715,37.91191213457877,0.07510423897500418,4272.1145277023315,865.749977350235,3279.604793548584,44869,11334,33535,33535,0,23,11048000.0
11048,11048999,20.81491310487597,37.91105805300131,0.075103459438838,4272.585787057877,865.8272404670715,3279.673038482666,44870,11335,33535,33535,0,23,11049000.0
11049,11049999,20.814779042430935,37.910735560811816,0.07509997085935927,4272.998312473297,865.8989055156708,3279.9802894592285,44872,11336,33536,33536,0,23,11050000.0
11050,11050999,20.814639168479616,37.91033179084903,0.07509728315479125,4273.4712653160095,865.9690976142883,3280.0174446105957,44874,11337,33537,33537,0,23,11051000.0
11051,11051999,20.814386544119653,37.909624238825735,0.0750960187363694,4273.970988750458,866.0497803688049,3280.421733856201,44877,11339,33538,33538,0,23,11052000.0
11052,11052999,20.814276726798536,37.90911120456194,0.07509425731014718,4274.432439804077,866.1215636730194,3280.4835472106934,44881,11340,33541,33541,0,23,11053000.0
11053,11053999,20.814160987631087,37.908487892947164,0.07509300466841529,4274.9643638134,866.2011952400208,3280.8952293395996,44896,11342,33554,33554,0,23,11054000.0
11054,11054999,20.814183549383614,37.90834009709812,0.07509078808806946,4275.171901464462,866.2723209857941,3281.9508323669434,44897,11342,33555,33555,0,23,11055000.0
11055,11055999,20.814277262360847,37.908002231170414,0.07508745963795171,4275.57178735733,866.3437392711639,3281.9241523742676,44897,11342,33555,33555,0,23,11056000.0
11056,11056999,20.814390406173803,37.90859566917314,0.0750825433114305,4275.812796831131,866.4163153171539,3282.6738777160645,44897,11342,33555,33555,0,23,11057000.0
11057,11057999,20.814477395092272,37.908170815159195,0.07508077182655903,4276.102344274521,866.4870574474335,3283.087390899658,44897,11342,33555,33555,0,23,11058000.0
11058,11058999,20.814616062335514,37.90782367095611,0.07507837418413932,4276.512834310532,866.5589826107025,3282.9261894226074,44897,11342,33555,33555,0,23,11059000.0
11059,11059999,20.814588940137092,37.907152561828,0.07507808594340937,4277.029030561447,866.6313681602478,3282.6558799743652,44899,11343,33556,33556,0,23,11060000.0
11060,11060999,20.814606825363622,37.90659751800815,0.07507623463608315,4277.309450149536,866.7044079303741,3283.0860710144043,44899,11343,33556,33556,0,23,11061000.0
11061,11061999,20.81453506051622,37.905951028879045,0.07507310750852214,4277.76599407196,866.7768473625183,3282.799533843994,44899,11343,33556,33556,0,23,11062000.0
11062,11062999,20.814239796433377,37.90493915535418,0.07507396707874714,4278.097432374954,866.8454186916351,3283.7955360412598,44913,11344,33569,33569,0,23,11063000.0
11063,11063999,20.8134965164931,37.90395690522765,0.07507554260559202,4278.4252145290375,866.9094648361206,3284.3225135803223,44917,11344,33573,33573,0,23,11064000.0
11064,11064999,20.8127285245709,37.90288984925276,0.07507870089105284,4278.701691150665,866.9720802307129,3285.2526664733887,44920,11345,33575,33575,0,23,11065000.0
11065,11065999,20.812214409870155,37.90270296011483,0.07507679898710429,4279.354721546173,867.0395448207855,3284.463924407959,44924,11346,33578,33578,0,23,11066000.0
11066,11066999,20.811694696284704,37.90167708672375,0.075076073153165,4279.55398607254,867.1035342216492,3285.3914375305176,44924,11346,33578,33578,0,23,11067000.0
11067,11067999,20.811120253855997,37.900597066871484,0.07507864979687284,4280.034754514694,867.1665687561035,3285.5313453674316,44929,11348,33581,33581,0,23,11068000.0
11068,11068999,20.810644301298286,37.899721542075255,0.0750820885226754,4280.7400143146515,867.2298829555511,3285.4098777770996,44937,11352,33585,33585,0,23,11069000.0
11069,11069999,20.81027452923102,37.899225418050676,0.07508216905187992,4280.940802574158,867.2934572696686,3286.3808555603027,44938,11352,33586,33586,0,23,11070000.0
11070,11070999,20.809921955823047,37.898678105022775,0.07508080287196872,4281.174258708954,867.3578598499298,3287.111095428467,44938,11352,33586,33586,0,23,11071000.0
11071,11071999,20.80958813234014,37.89815121735086,0.07508127702887735,4281.568415403366,867.420880317688,3287.3767127990723,44940,11353,33587,33587,0,23,11072000.0
11072,11072999,20.8093625883616,37.89783034452098,0.07507735142047123,4282.066306114197,867.4869065284729,3287.690158843994,44946,11355,33591,33591,0,23,11073000.0
11073,11073999,20.80922649223943,37.89766875430294,0.07507552698011,4282.603314638138,867.5534870624542,3287.4827308654785,44948,11356,33592,33592,0,23,11074000.0
11074,11074999,20.808877487549942,37.89691408812678,0.07507484453648405,4282.830278158188,867.6182513237,3288.2618293762207,44948,11356,33592,33592,0,23,11075000.0
11075,11075999,20.80853191155464,37.89607635584296,0.07507403927170175,4283.345685243607,867.6834602355957,3288.0562629699707,44951,11357,33594,33594,0,23,11076000.0
11076,11076999,20.808345169733755,37.895533850925716,0.07507105842357409,4283.594081163406,867.7488622665405,3288.6280479431152,44951,11357,33594,33594,0,23,11077000.0
11077,11077999,20.8082890049773,37.89620754205727,0.07506336302899219,4283.928570985794,867.8119974136353,3288.728504180908,44951,11357,33594,33594,0,23,11078000.0
11078,11078999,20.80829370772431,37.89581997227505,0.0750625782676353,4284.50919508934,867.8785908222198,3288.493938446045,44955,11359,33596,33596,0,23,11079000.0
11079,11079999,20.808396975640463,37.89553651543691,0.07505709983170983,4284.924382209778,867.9439363479614,3288.696002960205,44957,11360,33597,33597,0,23,11080000.0
11080,11080999,20.80853268865003,37.89534397240248,0.07505304278945157,4285.230064153671,868.0101602077484,3289.0235328674316,44957,11360,33597,33597,0,23,11081000.0
11081,11081999,20.808533378619472,37.89482591173788,0.07505306526092992,4285.74821138382,868.0749850273132,3288.8722953796387,44959,11361,33598,33598,0,23,11082000.0
11082,11082999,20.808375298144583,37.89418997634216,0.07505117876676826,4285.990917682648,868.1410629749298,3289.5557594299316,44959,11361,33598,33598,0,23,11083000.0
11083,11083999,20.80795123960107,37.894133149611605,0.07505039251557044,4286.427528858185,868.206344127655,3290.5201530456543,44983,11363,33620,33620,0,23,11084000.0
11084,11084999,20.807212297188787,37.893864636512575,0.07504962780748625,4286.776971101761,868.2730438709259,3291.209445953369,44985,11364,33621,33621,0,23,11085000.0
11085,11085999,20.806745174274784,37.89605372252673,0.07503910933617419,4287.120841741562,868.3393678665161,3291.891025543213,44987,11365,33622,33622,0,23,11086000.0
11086,11086999,20.806075488200435,37.894944447887454,0.07504193832935802,4287.5847799777985,868.4050395488739,3292.110782623291,44991,11367,33624,33624,0,23,11087000.0
11087,11087999,20.805534943250464,37.89404908598989,0.0750420285416159,4287.986094236374,868.4707489013672,3292.1134300231934,44991,11367,33624,33624,0,23,11088000.0
11088,11088999,20.80504259287652,37.893378414595404,0.07504073962203461,4288.232070446014,868.5375957489014,3292.6222801208496,44991,11367,33624,33624,0,23,11089000.0
11089,11089999,20.804475715689797,37.89257164644948,0.07504047005536862,4288.744011878967,868.6053032875061,3292.6562995910645,45003,11369,33634,33634,0,23,11090000.0
11090,11090999,20.80393115326951,37.891660430828466,0.07504149195524756,4289.526425600052,868.6735413074493,3292.130100250244,45011,11373,33638,33638,0,23,11091000.0
11091,11091999,20.803433659581657,37.89066091517429,0.07504233184932518,4289.941104888916,868.7422783374786,3292.5634269714355,45013,11374,33639,33639,0,23,11092000.0
11092,11092999,20.802911218696355,37.889573517675984,0.07504348688900764,4290.185984373093,868.8107573986053,3293.276538848877,45013,11374,33639,33639,0,23,11093000.0
11093,11093999,20.802486221595167,37.88882568912442,0.07504014538410508,4290.694301366806,868.8778178691864,3293.3338890075684,45016,11376,33640,33640,0,23,11094000.0
11094,11094999,20.802093888048823,37.88803988137162,0.07503690845409539,4291.115255355835,868.945963382721,3293.5832023620605,45018,11377,33641,33641,0,23,11095000.0
11095,11095999,20.80166215493452,37.88721842519014,0.0750360646152124,4291.437664270401,869.0141632556915,3293.8269538879395,45018,11377,33641,33641,0,23,11096000.0
11096,11096999,20.801234244504844,37.88626967618659,0.07503493777079129,4291.834849119186,869.0825724601746,3293.983097076416,45022,11378,33644,33644,0,23,11097000.0
11097,11097999,20.80093592631618,37.88571529444299,0.07503063066621385,4292.077258110046,869.1508405208588,3294.588535308838,45022,11378,33644,33644,0,23,11098000.0
11098,11098999,20.800653768853188,37.88490674642395,0.07502854900032752,4292.529275417328,869.2194535732269,3294.7353858947754,45038,11379,33659,33659,0,23,11099000.0
11099,11099999,20.800482402206203,37.88425339706431,0.07502631765405854,4293.03112745285,869.3769500255585,3295.8303871154785,45038,11379,33659,33659,0,23,11100000.0
11100,11100999,20.800314196140715,37.883657897985096,0.0750212037181911,4294.125447511673,869.5195846557617,3295.647075653076,45044,11381,33663,33663,0,23,11101000.0
11101,11101999,20.800004031604885,37.88282412929141,0.07501911118207893,4294.610245704651,869.6595528125763,3296.346363067627,45044,11381,33663,33663,0,23,11102000.0
11102,11102999,20.79979912384227,37.88204253700401,0.0750140837307326,4295.085386753082,869.806756734848,3297.0670051574707,45044,11381,33663,33663,0,23,11103000.0
11103,11103999,20.799516954418365,37.88116726166059,0.07501152153222779,4295.81450343132,869.932778596878,3297.121364593506,45044,11381,33663,33663,0,23,11104000.0
11104,11104999,20.798580631900656,37.88030988247069,0.07501651174348589,4296.539171218872,870.0467646121979,3298.0465507507324,45061,11383,33678,33678,0,23,11105000.0
11105,11105999,20.797694746965885,37.87916060223972,0.07502187322449927,4297.280396938324,870.1433050632477,3298.390613555908,45071,11385,33686,33686,0,23,11106000.0
11106,11106999,20.79680457129271,37.87780231310565,0.07502856671127156,4297.694047927856,870.2428123950958,3299.0646018981934,45073,11385,33688,33688,0,23,11107000.0
11107,11107999,20.79613526233272,37.87675888177706,0.07503268773188743,4298.465665340424,870.4900469779968,3299.9766807556152,45075,11385,33690,33690,0,23,11108000.0
11108,11108999,20.795445044522687,37.87579213481192,0.07503392551879429,4298.975434303284,870.6020176410675,3300.6085090637207,45075,11385,33690,33690,0,23,11109000.0
11109,11109999,20.794734433697485,37.874546857224864,0.07503768207948625,4299.786617279053,870.7098724842072,3301.0179328918457,45081,11388,33693,33693,0,23,11110000.0
11110,11110999,20.794048544137212,37.87334421489879,0.07503775337349361,4300.138575553894,870.8203699588776,3301.822727203369,45081,11388,33693,33693,0,23,11111000.0
11111,11111999,20.793540500477175,37.87249180667904,0.075037170379058,4300.7284326553345,870.9379861354828,3302.1717491149902,45083,11389,33694,33694,0,23,11112000.0
11112,11112999,20.793024863768462,37.87149212524896,0.0750370902988482,4302.0112199783325,871.056325674057,3301.9373512268066,45093,11394,33699,33699,0,23,11113000.0
11113,11113999,20.79258112519257,37.87056377567743,0.07503457342184883,4303.149317979813,871.1716825962067,3301.8471031188965,45103,11398,33705,33705,0,23,11114000.0
11114,11114999,20.792278621653505,37.87015883442067,0.07502929080708032,4303.893317937851,871.2918703556061,3302.1446418762207,45105,11399,33706,33706,0,23,11115000.0
11115,11115999,20.791985048784767,37.86964275284751,0.07502493943788935,4304.409659385681,871.3861334323883,3302.696430206299,45107,11400,33707,33707,0,23,11116000.0
11116,11116999,20.791787194312057,37.86997003590822,0.0750149480078054,4304.840403556824,871.5091116428375,3303.3617515563965,45107,11400,33707,33707,0,23,11117000.0
11117,11117999,20.791633779172496,37.869673619173504,0.07500952538462324,4305.4791622161865,871.6012985706329,3303.378932952881,45111,11401,33710,33710,0,23,11118000.0
11118,11118999,20.791648420424302,37.869850432167766,0.07500632729175538,4306.258938550949,871.7057139873505,3303.1807975769043,45115,11403,33712,33712,0,23,11119000.0
11119,11119999,20.79177747561996,37.87015504925627,0.07500308058352534,4306.706688404083,871.8181614875793,3303.796314239502,45115,11403,33712,33712,0,23,11120000.0
11120,11120999,20.79196059113744,37.87020798313213,0.07500149302646386,4307.2493278980255,871.9385125637054,3304.2936515808105,45115,11403,33712,33712,0,23,11121000.0
11121,11121999,20.792036325734163,37.870030645021146,0.07499850603986724,4307.7125952243805,872.0335285663605,3304.5290184020996,45115,11403,33712,33712,0,23,11122000.0
11122,11122999,20.792109432889365,37.86993784331593,0.07499738954119084,4308.0286383628845,872.1348927021027,3305.2209510803223,45115,11403,33712,33712,0,23,11123000.0
11123,11123999,20.792341108399583,37.869909337257965,0.07499253989747756,4308.720077753067,872.2463233470917,3305.124614715576,45115,11403,33712,33712,0,23,11124000.0
11124,11124999,20.792166315785163,37.869147573636745,0.07498936532562162,4309.291857242584,872.3422105312347,3305.5970726013184,45121,11404,33717,33717,0,23,11125000.0
11125,11125999,20.791523976458343,37.868437635720355,0.07499043211945866,4310.078412532806,872.4497883319855,3306.121593475342,45130,11406,33724,33724,0,23,11126000.0
11126,11126999,20.790818578486096,37.867334734155804,0.07499238220245019,4310.528022766113,872.5436971187592,3306.6111946105957,45136,11406,33730,33730,0,23,11127000.0
11127,11127999,20.790196079527778,37.86615328830398,0.07499259282828397,4311.04642033577,872.6204047203064,3307.227138519287,45144,11408,33736,33736,0,23,11128000.0
11128,11128999,20.789744260953974,37.86528111193345,0.07498852272124179,4311.537675619125,872.7093436717987,3307.6464653015137,45145,11408,33737,33737,0,23,11129000.0
11129,11129999,20.789221159130367,37.86416966510929,0.07498809357044678,4312.418758869171,872.7992124557495,3307.603015899658,45156,11412,33744,33744,0,23,11130000.0
11130,11130999,20.788752739848352,37.863424205406915,0.07498667713435336,4312.786531686783,872.8868041038513,3308.3901710510254,45160,11413,33747,33747,0,23,11131000.0
11131,11131999,20.78826725273671,37.862459978226646,0.07498523187764639,4313.481448888779,872.9872300624847,3308.445301055908,45163,11414,33749,33749,0,23,11132000.0
11132,11132999,20.787871070581808,37.86172745663942,0.07498251151794777,4313.974086999893,873.0703563690186,3308.8137855529785,45167,11415,33752,33752,0,23,11133000.0
11133,11133999,20.787538152586297,37.86101238712401,0.0749775537529439,4315.037391424179,873.1847381591797,3308.43900680542,45173,11417,33756,33756,0,23,11134000.0
11134,11134999,20.787198600558494,37.86029412931674,0.07497425743822228,4315.430020809174,873.2951576709747,3308.9970512390137,45173,11417,33756,33756,0,23,11135000.0
11135,11135999,20.787136537156293,37.85997049906267,0.07497109188548068,4316.089781284332,873.3869593143463,3309.0652656555176,45175,11418,33757,33757,0,23,11136000.0
11136,11136999,20.787151638869826,37.85998439999151,0.07496868035735227,4316.52192568779,873.4958341121674,3309.648052215576,45175,11418,33757,33757,0,23,11137000.0
11137,11137999,20.78718003567962,37.859766885902125,0.07496571015253362,4317.126666307449,873.6065874099731,3309.870616912842,45179,11419,33760,33760,0,23,11138000.0
11138,11138999,20.78729966876645,37.8595379507631,0.07496297998659407,4318.05202960968,873.7061626911163,3309.8996925354004,45185,11422,33763,33763,0,23,11139000.0
11139,11139999,20.78770301434682,37.85999774204455,0.07496161128957113,4318.8445036411285,873.819552898407,3309.9215507507324,45187,11423,33764,33764,0,23,11140000.0
11140,11140999,20.78801118162572,37.8603647115028,0.07496230527638659,4319.250576019287,873.9177174568176,3310.42631149292,45187,11423,33764,33764,0,23,11141000.0
11141,11141999,20.788377781322918,37.8606476179258,0.07497032837789241,4320.28572177887,874.0263142585754,3310.2506141662598,45208,11427,33781,33781,0,23,11142000.0
11142,11142999,20.788776227841787,37.86108238978501,0.07497573629509457,4321.136479377747,874.1245510578156,3309.7774543762207,45213,11429,33784,33784,0,23,11143000.0
11143,11143999,20.78939239847108,37.861800346307675,0.07497507701275663,4321.660864830017,874.2358129024506,3310.2870292663574,45213,11429,33784,33784,0,23,11144000.0
11144,11144999,20.78975971557775,37.86193127368302,0.07497585969430032,4322.470196485519,874.3488593101501,3310.4787254333496,45217,11431,33786,33786,0,23,11145000.0
11145,11145999,20.789786919987115,37.86144033880714,0.07496512843132075,4323.023808717728,874.4333674907684,3311.2247428894043,45228,11432,33796,33796,0,23,11146000.0
11146,11146999,20.789481393915,37.861144130449745,0.07495106667654483,4323.488749265671,874.5467257499695,3312.3984184265137,45232,11433,33799,33799,0,23,11147000.0
11147,11147999,20.789125220182836,37.86052600955498,0.07494366146210218,4323.951326608658,874.6397216320038,3313.1180000305176,45244,11434,33810,33810,0,23,11148000.0
11148,11148999,20.78888017137008,37.8602419581513,0.0749360133681275,4324.366874217987,874.7341375350952,3313.673351287842,45244,11434,33810,33810,0,23,11149000.0
11149,11149999,20.78847103512169,37.85928119792019,0.07493350900431528,4324.801706790924,874.8258249759674,3314.068920135498,45245,11434,33811,33811,0,23,11150000.0
11150,11150999,20.788108817120772,37.858533726198836,0.07493135925410199,4325.430862188339,874.9185135364532,3314.139804840088,45247,11435,33812,33812,0,23,11151000.0
11151,11151999,20.787950805098877,37.85810065426989,0.07492399740871558,4326.234082221985,875.0364718437195,3314.4115562438965,45251,11437,33814,33814,0,23,11152000.0
11152,11152999,20.787581080035277,37.857211247413254,0.07492200929208892,4326.7798371315,875.132740020752,3314.664752960205,45251,11437,33814,33814,0,23,11153000.0
11153,11153999,20.78728151057746,37.85648060041932,0.07491759010109045,4327.227297067642,875.2079839706421,3315.0971717834473,45252,11438,33814,33814,0,23,11154000.0
11154,11154999,20.787018567021253,37.85571283651139,0.07491271438975833,4327.949904918671,875.3310544490814,3315.341449737549,45254,11439,33815,33815,0,23,11155000.0
11155,11155999,20.786935760403736,37.85509538619967,0.07490628985069647,4328.485908985138,875.423553943634,3315.6099891662598,45256,11440,33816,33816,0,23,11156000.0
11156,11156999,20.78704020602714,37.854950665677954,0.0748996083199216,4328.884641647339,875.5138318538666,3316.0438957214355,45256,11440,33816,33816,0,23,11157000.0
11157,11157999,20.786960950138553,37.85431958552104,0.07489731994265825,4329.4924902915955,875.608633518219,3316.012409210205,45258,11441,33817,33817,0,23,11158000.0
11158,11158999,20.787175537670084,37.85429091274638,0.07489215165027596,4330.373783826828,875.718652009964,3315.529193878174,45259,11442,33817,33817,0,23,11159000.0
11159,11159999,20.787351348513127,37.8539243841161,0.07488914582484696,4331.067217826843,875.8445248603821,3315.6721229553223,45259,11442,33817,33817,0,23,11160000.0
11160,11160999,20.787532097655134,37.85353731935141,0.0748858972483537,4331.6040370464325,875.9397504329681,3315.872714996338,45260,11443,33817,33817,0,23,11161000.0
11161,11161999,20.78766878805916,37.85321578554648,0.07487970170259117,4332.183812379837,876.0309503078461,3315.96382522583,45269,11444,33825,33825,0,23,11162000.0
11162,11162999,20.787794361632546,37.852765314429945,0.07487774659849489,4333.580868005753,876.2570793628693,3316.0503883361816,45269,11444,33825,33825,0,23,11163000.0
11163,11163999,20.787673304706914,37.852328675357604,0.07487135832929726,4334.03604722023,876.3805780410767,3316.995029449463,45278,11444,33834,33834,0,23,11164000.0
11164,11164999,20.787149681298207,37.852943154130216,0.0748679608070707,4334.436842441559,876.4617774486542,3318.0176582336426,45286,11445,33841,33841,0,23,11165000.0
11165,11165999,20.786509923438416,37.851847948860524,0.07486891349421732,4334.79043674469,876.5368175506592,3318.8640174865723,45286,11445,33841,33841,0,23,11166000.0
11166,11166999,20.785977339468214,37.85095270429025,0.07486932163848847,4335.290707826614,876.6199295520782,3319.236072540283,45290,11446,33844,33844,0,23,11167000.0
11167,11167999,20.78552550668835,37.85041157643037,0.07486631339636962,4335.8697078228,876.7170917987823,3319.5418281555176,45298,11448,33850,33850,0,23,11168000.0
11168,11168999,20.785052445617204,37.849800484737955,0.07486531210749259,4336.497866153717,876.7956101894379,3319.5237770080566,45304,11450,33854,33854,0,23,11169000.0
11169,11169999,20.784634709183404,37.84904723625518,0.07486471205237699,4337.262295007706,876.8963203430176,3319.1501426696777,45306,11451,33855,33855,0,23,11170000.0
11170,11170999,20.784285469028337,37.84854453054706,0.0748629488678868,4337.664834022522,876.9723904132843,3319.7576637268066,45308,11452,33856,33856,0,23,11171000.0
11171,11171999,20.783969219840174,37.847792333615544,0.07486082115831283,4338.531893491745,877.0868699550629,3319.810474395752,45314,11454,33860,33860,0,23,11172000.0
11172,11172999,20.783859869348476,37.84740738692357,0.07485531678686541,4338.716473817825,877.1648640632629,3320.8644065856934,45314,11454,33860,33860,0,23,11173000.0
11173,11173999,20.783937246001184,37.84747018667244,0.07484959062096763,4339.683024406433,877.2798273563385,3320.769947052002,45318,11456,33862,33862,0,23,11174000.0
11174,11174999,20.78428985779813,37.848120095896824,0.07484361144697671,4340.19858455658,877.3581557273865,3320.8468437194824,45320,11457,33863,33863,0,23,11175000.0
11175,11175999,20.784535793376726,37.8484296310096,0.07483726949513447,4340.609158039093,877.4550814628601,3321.557460784912,45322,11458,33864,33864,0,23,11176000.0
11176,11176999,20.785052075002625,37.84935367902145,0.07482904990535,4341.415661096573,877.5370435714722,3321.090129852295,45326,11460,33866,33866,0,23,11177000.0
11177,11177999,20.7855749947953,37.85032003742921,0.0748274710429353,4341.767269611359,877.6162579059601,3321.4894828796387,45326,11460,33866,33866,0,23,11178000.0
11178,11178999,20.78631744753854,37.85173684288447,0.0748308168738987,4342.983584165573,877.7368566989899,3320.7010383605957,45334,11462,33872,33872,0,23,11179000.0
11179,11179999,20.78764376020708,37.85564299335419,0.07482308255043568,4343.250529766083,877.8504791259766,3321.7454948425293,45334,11462,33872,33872,0,23,11180000.0
11180,11180999,20.788467336936343,37.8572301336271,0.07482428676976283,4343.616544485092,877.9371123313904,3322.285961151123,45334,11462,33872,33872,0,23,11181000.0
11181,11181999,20.789878976263232,37.859819953198325,0.07483135948128705,4344.0893585681915,878.0157215595245,3322.2493934631348,45334,11462,33872,33872,0,23,11182000.0
11182,11182999,20.791273782134308,37.862828217064276,0.07484130735773653,4344.6476356983185,878.1009659767151,3322.2751960754395,45337,11463,33874,33874,0,23,11183000.0
11183,11183999,20.79162255224288,37.86322944968376,0.07484510185670923,4345.480282306671,878.2142932415009,3322.9320182800293,45352,11465,33887,33887,0,23,11184000.0
11184,11184999,20.79071104796463,37.86207743050929,0.07484911327372812,4345.8772695064545,878.3282918930054,3324.1443672180176,45358,11465,33893,33893,0,23,11185000.0
11185,11185999,20.790020551188203,37.86162300799704,0.07484865282765063,4346.290235757828,878.4409646987915,3325.0832023620605,45360,11465,33895,33895,0,23,11186000.0
11186,11186999,20.789402151243692,37.860735052149685,0.07484867601429013,4346.612074136734,878.5111727714539,3325.7019386291504,45360,11465,33895,33895,0,23,11187000.0
11187,11187999,20.789073941577648,37.86060687508049,0.07484310719466503,4347.1379935741425,878.6254153251648,3326.4538078308105,45364,11466,33898,33898,0,23,11188000.0
11188,11188999,20.7886502172015,37.859790888285836,0.0748407265114347,4347.745776414871,878.7036244869232,3326.6396980285645,45368,11468,33900,33900,0,23,11189000.0
11189,11189999,20.788266739848037,37.85900765244692,0.07483991614201202,4348.076952934265,878.7816348075867,3327.7216987609863,45370,11469,33901,33901,0,23,11190000.0
11190,11190999,20.788029943822877,37.8585100735652,0.07483727201405088,4348.727975606918,878.8623054027557,3327.937686920166,45376,11472,33904,33904,0,23,11191000.0
11191,11191999,20.787728321188876,37.857871150639106,0.07484012888861014,4349.204281330109,878.9417471885681,3328.3461875915527,45378,11473,33905,33905,0,23,11192000.0
11192,11192999,20.7874349704834,37.8572607321318,0.07484799932947517,4350.160023212433,879.0565841197968,3328.507068634033,45395,11476,33919,33919,0,23,11193000.0
11193,11193999,20.787328401517378,37.85727720859242,0.07484219746842413,4350.61625790596,879.1446299552917,3328.9515495300293,45397,11477,33920,33920,0,23,11194000.0
11194,11194999,20.787247366465976,37.85702313328729,0.07484363457519116,4351.247766494751,879.2151837348938,3328.779453277588,45403,11479,33924,33924,0,23,11195000.0
11195,11195999,20.787185452534267,37.85671477395179,0.07484349350247377,4352.076130628586,879.3308093547821,3328.9343070983887,45407,11481,33926,33926,0,23,11196000.0
11196,11196999,20.787135208024015,37.85672631353291,0.0748412604363079,4352.688132762909,879.4229052066803,3328.862575531006,45409,11482,33927,33927,0,23,11197000.0
11197,11197999,20.787200000972504,37.856705779570625,0.07483616181805797,4353.128867864609,879.4995720386505,3329.354419708252,45411,11483,33928,33928,0,23,11198000.0
11198,11198999,20.787244974377217,37.85642656791285,0.07483437092135581,4353.476068735123,879.5805411338806,3329.8878746032715,45411,11483,33928,33928,0,23,11199000.0
11199,11199999,20.787276824007552,37.856076302645434,0.07483287225620239,4353.841211080551,879.657369852066,3330.3673820495605,45413,11484,33929,33929,0,23,11200000.0
11200,11200999,20.78748243442529,37.85594852825609,0.07483085999441264,4354.417802333832,879.7638597488403,3330.690273284912,45415,11485,33930,33930,0,23,11201000.0
11201,11201999,20.787502705171065,37.855508455849,0.07482951303533303,4355.084599494934,879.8441319465637,3329.9968910217285,45415,11485,33930,33930,0,23,11202000.0
11202,11202999,20.787726177312475,37.85538140611631,0.07482235111988034,4355.643389940262,879.941912651062,3330.4172172546387,45415,11485,33930,33930,0,23,11203000.0
11203,11203999,20.78782569210845,37.85512559117791,0.07481987646661925,4356.251121520996,880.062784910202,3330.696346282959,45415,11485,33930,33930,0,23,11204000.0
11204,11204999,20.787513839568604,37.85521109153747,0.07481033989078534,4356.610877990723,880.163393497467,3332.2777824401855,45436,11485,33951,33951,0,23,11205000.0
11205,11205999,20.786832397916264,37.85466578957322,0.07479994730172268,4356.814361572266,880.2390916347504,3333.5534172058105,45437,11485,33952,33952,0,23,11206000.0
11206,11206999,20.786146134694782,37.85356364144662,0.07480139787453055,4357.224969387054,880.3167788982391,3334.161075592041,45439,11486,33953,33953,0,23,11207000.0
11207,11207999,20.785494773131017,37.852646867118,0.07480126304394086,4358.031562805176,880.408938407898,3334.263256072998,45444,11488,33956,33956,0,23,11208000.0
11208,11208999,20.784959095822256,37.851881097552365,0.074800775510658,4358.2616810798645,880.4827408790588,3335.1957969665527,45445,11488,33957,33957,0,23,11209000.0
11209,11209999,20.784483204870924,37.85144185594861,0.07479768778031537,4358.954868793488,880.5573997497559,3335.3148078918457,45455,11492,33963,33963,0,23,11210000.0
11210,11210999,20.783977981435577,37.850470772477955,0.07479567448467339,4359.5253665447235,880.6316154003143,3335.8277320861816,45459,11494,33965,33965,0,23,11211000.0
11211,11211999,20.783457539020933,37.8495467131295,0.07479487062952173,4360.078449010849,880.7040612697601,3336.199718475342,45471,11496,33975,33975,0,23,11212000.0
11212,11212999,20.78308184555389,37.84867996538709,0.07479204232067083,4360.527978897095,880.7845847606659,3336.6761360168457,45473,11497,33976,33976,0,23,11213000.0
11213,11213999,20.782759193134726,37.84809451878473,0.07478910654360016,4360.897744178772,880.8590612411499,3337.2672233581543,45475,11498,33977,33977,0,23,11214000.0
11214,11214999,20.782350974070354,37.847171302518625,0.07478752001212363,4361.495198965073,880.9696612358093,3337.7008628845215,45477,11499,33978,33978,0,23,11215000.0
11215,11215999,20.78215017164594,37.84686880496209,0.07478393420692786,4362.047645807266,881.0416798591614,3337.5617866516113,45479,11500,33979,33979,0,23,11216000.0
11216,11216999,20.781986879455694,37.84642834052386,0.07477977783532974,4362.907674074173,881.1525528430939,3337.384578704834,45481,11501,33980,33980,0,23,11217000.0
11217,11217999,20.782159385508784,37.84696783280068,0.07477405874487564,4363.663333892822,881.2651634216309,3337.5243644714355,45483,11502,33981,33981,0,23,11218000.0
11218,11218999,20.782772102755015,37.84833862230654,0.07477067562530348,4364.283957958221,881.3369822502136,3337.2558631896973,45485,11503,33982,33982,0,23,11219000.0
11219,11219999,20.783748608652186,37.85023864466762,0.07476867343591109,4364.696939229965,881.4142520427704,3337.764263153076,45487,11504,33983,33983,0,23,11220000.0
11220,11220999,20.78468249564159,37.85187659509048,0.07476842300049547,4365.459035396576,881.4897565841675,3337.5100898742676,45495,11507,33988,33988,0,23,11221000.0
11221,11221999,20.78559111567989,37.85340142479054,0.07477114267957441,4365.979409456253,881.5891156196594,3338.130641937256,45497,11508,33989,33989,0,23,11222000.0
11222,11222999,20.78713369634524,37.856683734825666,0.07477239668727409,4366.658583879471,881.6635818481445,3337.835720062256,45503,11510,33993,33993,0,23,11223000.0
11223,11223999,20.788198900523962,37.85861633165178,0.07477379537761408,4367.14955496788,881.7393853664398,3337.7859992980957,45503,11510,33993,33993,0,23,11224000.0
11224,11224999,20.78898421924106,37.860228270401976,0.07476566540526719,4367.564460277557,881.8507492542267,3339.1873207092285,45520,11510,34010,34010,0,23,11225000.0
11225,11225999,20.788364083975903,37.859166613586886,0.07476279260677299,4367.942060709,881.9206993579865,3340.149631500244,45525,11511,34014,34014,0,23,11226000.0
11226,11226999,20.78792256360936,37.858365275072586,0.07475939210883076,4368.53210067749,881.99445271492,3340.8727226257324,45535,11514,34021,34021,0,23,11227000.0
11227,11227999,20.787610028124856,37.8580333558689,0.07475383110114653,4368.937276363373,882.0745897293091,3341.562557220459,45537,11515,34022,34022,0,23,11228000.0
11228,11228999,20.787198535427695,37.85714326357907,0.07475221518929842,4370.36717581749,882.2541551589966,3341.6888847351074,45543,11517,34026,34026,0,23,11229000.0
11229,11229999,20.786787560443937,37.85630667537154,0.0747499922613124,4370.992136716843,882.3272938728333,3341.9165687561035,45551,11520,34031,34031,0,23,11230000.0
11230,11230999,20.786381108492368,37.85544842869287,0.07474666640976091,4371.783562660217,882.4121429920197,3341.6917610168457,45555,11522,34033,34033,0,23,11231000.0
11231,11231999,20.78611777732565,37.85514198379807,0.0747416493217089,4372.068195343018,882.4904263019562,3342.3225746154785,45555,11522,34033,34033,0,23,11232000.0
11232,11232999,20.785933768316536,37.85508157216633,0.07473531103389974,4372.535627126694,882.5717031955719,3342.9357109069824,45566,11523,34043,34043,0,23,11233000.0
11233,11233999,20.78590965250496,37.85517020157557,0.07473003568578573,4373.206127882004,882.6541047096252,3342.767375946045,45568,11524,34044,34044,0,23,11234000.0
11234,11234999,20.786158667510275,37.85689249514991,0.07471831230487513,4373.921836853027,882.7730128765106,3343.059299468994,45570,11525,34045,34045,0,23,11235000.0
11235,11235999,20.786627801947184,37.85858604358698,0.07470830614895385,4374.461448431015,882.8457896709442,3343.218776702881,45574,11527,34047,34047,0,23,11236000.0
11236,11236999,20.787800574187692,37.862809797805454,0.07469066677850655,4375.011034727097,882.9262256622314,3343.550319671631,45578,11529,34049,34049,0,23,11237000.0
11237,11237999,20.789203149601533,37.86713090245744,0.07467970263493229,4375.552205324173,883.0130360126495,3343.8408012390137,45580,11530,34050,34050,0,23,11238000.0
11238,11238999,20.790918703287357,37.872918260241384,0.07467310261780291,4375.924567699432,883.0902919769287,3344.614345550537,45582,11531,34051,34051,0,23,11239000.0
11239,11239999,20.793374799756283,37.882416041984335,0.07466634098053537,4376.315816640854,883.1622657775879,3344.714672088623,45582,11531,34051,34051,0,23,11240000.0
11240,11240999,20.796337480245892,37.894785515557366,0.07468158440295203,4376.744877338409,883.2665636539459,3345.119655609131,45582,11531,34051,34051,0,23,11241000.0
11241,11241999,20.79878943554837,37.90164366592836,0.07470320955616183,4377.248544692993,883.3386471271515,3345.2646522521973,45586,11533,34053,34053,0,23,11242000.0
11242,11242999,20.80148850233378,37.90923765036235,0.07475504631919916,4377.868425607681,883.4209685325623,3344.9911308288574,45588,11534,34054,34054,0,23,11243000.0
11243,11243999,20.8035554482701,37.91463763377084,0.0747615843539563,4378.311287641525,883.4957275390625,3345.0656394958496,45588,11534,34054,34054,0,23,11244000.0
11244,11244999,20.803495059923325,37.915118757651044,0.07475525459306465,4379.091580152512,883.6071996688843,3345.9110069274902,45601,11536,34065,34065,0,23,11245000.0
11245,11245999,20.803160524008682,37.914800460234716,0.07474952616513875,4379.554223060608,883.7271857261658,3347.3227577209473,45616,11537,34079,34079,0,23,11246000.0
11246,11246999,20.803084440198468,37.91470786487436,0.07474507546318598,4380.003352165222,883.8519961833954,3348.257640838623,45616,11537,34079,34079,0,23,11247000.0
11247,11247999,20.80325862072828,37.91540900181945,0.07474035752274943,4380.317252397537,883.9415130615234,3348.9580116271973,45616,11537,34079,34079,0,23,11248000.0
11248,11248999,20.803309927236064,37.91527096432869,0.07473861426132489,4380.766429424286,884.0199513435364,3349.1877479553223,45619,11538,34081,34081,0,23,11249000.0
11249,11249999,20.803156351069582,37.914669001854946,0.0747392759697485,4381.61772274971,884.1414203643799,3349.2089805603027,45621,11539,34082,34082,0,23,11250000.0
11250,11250999,20.8033771257968,37.915035745890535,0.0747336809379473,4382.032177448273,884.219648361206,3349.735637664795,45623,11540,34083,34083,0,23,11251000.0
11251,11251999,20.803738179835833,37.91548651585512,0.07473338590663103,4382.48876619339,884.2951235771179,3349.7352180480957,45623,11540,34083,34083,0,23,11252000.0
11252,11252999,20.804072338144184,37.916065760731065,0.07473722595328203,4382.802977800369,884.3884091377258,3350.434825897217,45623,11540,34083,34083,0,23,11253000.0
11253,11253999,20.80454974077992,37.91667886880794,0.07474287936993129,4383.412937641144,884.4765276908875,3350.5701026916504,45627,11542,34085,34085,0,23,11254000.0
11254,11254999,20.804969311780066,37.917069958647474,0.07474824945715974,4384.702467918396,884.7075521945953,3350.5677757263184,45630,11544,34086,34086,0,23,11255000.0
11255,11255999,20.805729683978832,37.91822533177436,0.07475593985418472,4385.3335473537445,884.7860019207001,3350.642230987549,45646,11546,34100,34100,0,23,11256000.0
11256,11256999,20.8064665879926,37.91939695061568,0.07477289127830189,4385.512941360474,884.8626248836517,3351.9969520568848,45647,11546,34101,34101,0,23,11257000.0
11257,11257999,20.80726000059361,37.92045220652094,0.07479014459219091,4385.984092473984,884.9388492107391,3352.166919708252,45651,11547,34104,34104,0,23,11258000.0
11258,11258999,20.80814542598097,37.92141181674762,0.07481676166812534,4386.418636083603,885.0148417949677,3352.4103813171387,45655,11548,34107,34107,0,23,11259000.0
11259,11259999,20.808955253423658,37.92247112728391,0.07484499235388664,4386.723263025284,885.0925121307373,3352.898181915283,45655,11548,34107,34107,0,23,11260000.0
11260,11260999,20.80992805838222,37.92426059262751,0.0748694404009893,4387.341112375259,885.1694114208221,3352.698398590088,45661,11550,34111,34111,0,23,11261000.0
11261,11261999,20.810743393172096,37.924975855017955,0.07490023254831368,4387.781716108322,885.2502913475037,3352.7753868103027,45661,11550,34111,34111,0,23,11262000.0
11262,11262999,20.811324475683737,37.9252622128466,0.07491426720043848,4388.044468641281,885.3272888660431,3353.4348640441895,45661,11550,34111,34111,0,23,11263000.0
11263,11263999,20.81156540840078,37.92559763881036,0.07493137215708567,4388.603539466858,885.4057898521423,3353.442844390869,45665,11552,34113,34113,0,23,11264000.0
11264,11264999,20.8113920061424,37.92499352792152,0.07492532311879496,4388.800851583481,885.4751100540161,3354.851276397705,45677,11552,34125,34125,0,23,11265000.0
11265,11265999,20.810897246895458,37.924395471138446,0.07492383173745454,4389.178826570511,885.5412058830261,3355.544818878174,45683,11553,34130,34130,0,23,11266000.0
11266,11266999,20.810581530470355,37.92412972701702,0.07491915630799761,4389.501883268356,885.6087889671326,3356.5338096618652,45690,11554,34136,34136,0,23,11267000.0
11267,11267999,20.81026049671431,37.92393578099403,0.07491771544405024,4389.927576303482,885.6760959625244,3356.9843788146973,45693,11555,34138,34138,0,23,11268000.0
11268,11268999,20.809996621304805,37.92348500223198,0.07491174595860817,4390.276110649109,885.7428352832794,3357.6090660095215,45696,11556,34140,34140,0,23,11269000.0
11269,11269999,20.80979451999984,37.92292575791106,0.07490192298277887,4390.922696828842,885.8128819465637,3357.7391777038574,45702,11559,34143,34143,0,23,11270000.0
11270,11270999,20.809483417684298,37.9221769477328,0.07489480258479753,4391.3840453624725,885.8827519416809,3358.232219696045,45708,11561,34147,34147,0,23,11271000.0
11271,11271999,20.809281134655052,37.922147450487465,0.07488713881462117,4392.022620201111,885.9531652927399,3358.190830230713,45714,11564,34150,34150,0,23,11272000.0
11272,11272999,20.80891992995265,37.92172875893628,0.07488338940126837,4392.750092983246,886.0219314098358,3358.1198921203613,45725,11568,34157,34157,0,23,11273000.0
11273,11273999,20.808613778283913,37.92109591662497,0.07488052401329426,4393.304917812347,886.0906801223755,3358.6318550109863,45731,11571,34160,34160,0,23,11274000.0
11274,11274999,20.80826716426063,37.920461304837325,0.07487789276031676,4393.846136569977,886.1628351211548,3358.86039352417,45737,11573,34164,34164,0,23,11275000.0
11275,11275999,20.807992383404795,37.919794883056056,0.0748746722593624,4394.267086029053,886.2328639030457,3359.268321990967,45739,11574,34165,34165,0,23,11276000.0
11276,11276999,20.80796940818555,37.919673911334506,0.07486703507357695,4394.597151041031,886.3010487556458,3359.6631965637207,45739,11574,34165,34165,0,23,11277000.0
11277,11277999,20.808092871624556,37.920910736306645,0.07485717141151393,4395.080510854721,886.3692939281464,3359.594738006592,45743,11575,34168,34168,0,23,11278000.0
11278,11278999,20.80810815071851,37.9206926678807,0.07485107616816888,4395.488225698471,886.4402582645416,3359.978733062744,45745,11576,34169,34169,0,23,11279000.0
11279,11279999,20.808105390351887,37.92026077847851,0.07484647369808572,4395.751657247543,886.5092446804047,3360.6813316345215,45745,11576,34169,34169,0,23,11280000.0
11280,11280999,20.808256290844888,37.920087591176305,0.07484033571750137,4396.143686771393,886.579183101654,3360.9841499328613,45747,11577,34170,34170,0,23,11281000.0
11281,11281999,20.80843092726348,37.92008704263925,0.07483491095303185,4396.493999004364,886.6500117778778,3361.3043174743652,45747,11577,34170,34170,0,23,11282000.0
11282,11282999,20.808662090136824,37.91994942657213,0.07482741789562519,4397.309093475342,886.7196021080017,3360.8677558898926,45755,11581,34174,34174,0,23,11283000.0
11283,11283999,20.808793248612805,37.91962008300709,0.0748203629506865,4397.7493777275085,886.7895832061768,3361.1444206237793,45757,11582,34175,34175,0,23,11284000.0
11284,11284999,20.808728373179886,37.91895201999042,0.07481500397004703,4398.563406944275,886.8612594604492,3360.4343070983887,45763,11585,34178,34178,0,23,11285000.0
11285,11285999,20.80811589795121,37.91780222403201,0.0748164812980382,4398.817616701126,886.93124127388,3361.6680488586426,45769,11585,34184,34184,0,23,11286000.0
11286,11286999,20.807411832028823,37.91664991464337,0.07482169810841477,4399.118316411972,887.0030534267426,3362.4118156433105,45770,11585,34185,34185,0,23,11287000.0
11287,11287999,20.806706041783332,37.91554155378158,0.07482635627770118,4399.584190130234,887.0780265331268,3362.680362701416,45772,11586,34186,34186,0,23,11288000.0
11288,11288999,20.8061589912149,37.914713738808615,0.07482784091843586,4399.853091239929,887.1490151882172,3363.389720916748,45773,11586,34187,34187,0,23,11289000.0
11289,11289999,20.805625372030995,37.91374225856388,0.07482807376423739,4400.306898832321,887.2213807106018,3363.6163902282715,45775,11587,34188,34188,0,23,11290000.0
11290,11290999,20.805007796390836,37.91262773388341,0.07483094991666805,4400.678117513657,887.2956006526947,3363.954113006592,45775,11587,34188,34188,0,23,11291000.0
11291,11291999,20.804515810157287,37.91174344456459,0.07483075696943187,4401.183784246445,887.3675491809845,3363.974750518799,45777,11588,34189,34189,0,23,11292000.0
11292,11292999,20.80404628910325,37.91093387716004,0.07482901106612283,4401.655398130417,887.4399299621582,3364.028064727783,45778,11589,34189,34189,0,23,11293000.0
11293,11293999,20.803720859363022,37.91031319423213,0.07482449183385287,4402.105038404465,887.512823343277,3364.4027671813965,45780,11590,34190,34190,0,23,11294000.0
11294,11294999,20.80352657957979,37.90964595856323,0.07482162297313089,4402.518535375595,887.5879533290863,3364.808490753174,45784,11591,34193,34193,0,23,11295000.0
11295,11295999,20.803422125341573,37.9101203816904,0.07481424166226713,4402.820507526398,887.6619424819946,3365.987865447998,45797,11592,34205,34205,0,23,11296000.0
11296,11296999,20.803201223565594,37.90949371915425,0.07481173107977857,4403.13823223114,887.7356185913086,3366.587619781494,45799,11592,34207,34207,0,23,11297000.0
11297,11297999,20.803088662330396,37.908954986568865,0.07480929041399298,4403.591748476028,887.8135716915131,3366.8330116271973,45801,11593,34208,34208,0,23,11298000.0
11298,11298999,20.803141568435088,37.908947802206335,0.07480441178113184,4403.8864839077,887.895391702652,3367.462116241455,45801,11593,34208,34208,0,23,11299000.0
11299,11299999,20.80322918852557,37.90865089608487,0.07479972583995109,4404.790029764175,887.9711666107178,3366.7857627868652,45809,11597,34212,34212,0,23,11300000.0
11300,11300999,20.80322687061482,37.90823063822689,0.07479865713879896,4405.107846260071,888.0452735424042,3367.308452606201,45809,11597,34212,34212,0,23,11301000.0
11301,11301999,20.803198267173837,37.90775955441207,0.07479712167630681,4405.5038294792175,888.1228411197662,3367.568256378174,45810,11597,34213,34213,0,23,11302000.0
11302,11302999,20.803161696743942,37.90725698217748,0.07479673958524458,4405.775285243988,888.1969764232635,3368.2408180236816,45810,11597,34213,34213,0,23,11303000.0
11303,11303999,20.80285472312882,37.906602078252114,0.07479132692004731,4406.155976057053,888.2660346031189,3369.2559089660645,45825,11598,34227,34227,0,23,11304000.0
11304,11304999,20.802633396071972,37.90635000280607,0.07478141404505734,4406.858832120895,888.3383235931396,3369.4210090637207,45839,11601,34238,34238,0,23,11305000.0
11305,11305999,20.802425253329105,37.90624872862698,0.07478002928766758,4407.220436811447,888.4055876731873,3370.0699882507324,45843,11602,34241,34241,0,23,11306000.0
11306,11306999,20.802112771006133,37.905748216232354,0.07477401064354317,4407.5481498241425,888.4709975719452,3370.7381019592285,45846,11603,34243,34243,0,23,11307000.0
11307,11307999,20.80179255159964,37.905310953972105,0.07476887023339363,4408.039905786514,888.5370223522186,3370.935703277588,45851,11605,34246,34246,0,23,11308000.0
11308,11308999,20.801672730330065,37.90534725922132,0.07476158451084669,4408.490578651428,888.6035330295563,3370.965717315674,45853,11606,34247,34247,0,23,11309000.0
11309,11309999,20.801658194469137,37.90589244566848,0.0747525869298653,4408.806945323944,888.6700310707092,3371.6438941955566,45855,11607,34248,34248,0,23,11310000.0
11310,11310999,20.802813716965048,37.9112172077351,0.07475591047091723,4409.220824956894,888.7374830245972,3371.8307456970215,45857,11608,34249,34249,0,23,11311000.0
11311,11311999,20.80453944913745,37.91754481786491,0.07475357240142,4409.979663848877,888.8038849830627,3371.4643363952637,45867,11612,34255,34255,0,23,11312000.0
11312,11312999,20.806297444122723,37.92344830818829,0.07476848296445604,4410.38659620285,888.8686790466309,3371.7350578308105,45869,11613,34256,34256,0,23,11313000.0
11313,11313999,20.80787614809914,37.92842408055977,0.0747917716303319,4410.989109039307,889.0078241825104,3372.4629249572754,45871,11614,34257,34257,0,23,11314000.0
11314,11314999,20.809564956734377,37.93353433327621,0.07481280622568054,4412.4709622859955,889.1405916213989,3371.7702293395996,45879,11618,34261,34261,0,23,11315000.0
11315,11315999,20.81109634844968,37.9374936988941,0.07483636430216811,4413.575713634491,889.2887554168701,3371.8849449157715,45879,11618,34261,34261,0,23,11316000.0
11316,11316999,20.812737502087522,37.941419983253034,0.07483787618467164,4414.386857032776,889.5198469161987,3372.6780128479004,45879,11618,34261,34261,0,23,11317000.0
11317,11317999,20.814374276335798,37.9450394041661,0.07485196685267492,4415.096364736557,889.6995460987091,3373.3171730041504,45880,11618,34262,34262,0,23,11318000.0
11318,11318999,20.816207902536373,37.94878233676053,0.07487615193804453,4415.685653448105,889.7672564983368,3373.0237464904785,45886,11620,34266,34266,0,23,11319000.0
11319,11319999,20.8178608804027,37.952925113032215,0.07489603398551858,4416.268501520157,889.8349049091339,3373.038631439209,45892,11623,34269,34269,0,23,11320000.0
11320,11320999,20.819620753790858,37.95589079578924,0.07491816333186274,4416.691699981689,889.9030575752258,3373.0000648498535,45892,11623,34269,34269,0,23,11321000.0
11321,11321999,20.820866342796688,37.958012382270525,0.07492795776243433,4416.963700532913,889.9703934192657,3373.5133628845215,45892,11623,34269,34269,0,23,11322000.0
11322,11322999,20.821270513681803,37.95867309016726,0.07489465969527709,4417.388567209244,890.0403470993042,3374.424663543701,45910,11624,34286,34286,0,23,11323000.0
11323,11323999,20.820989915829436,37.95849508446198,0.07489253770726068,4417.563144207001,890.1072173118591,3375.7483863830566,45911,11624,34287,34287,0,23,11324000.0
11324,11324999,20.82096984574892,37.958851959289696,0.07486879950122749,4418.004406929016,890.1850874423981,3376.1411781311035,45913,11625,34288,34288,0,23,11325000.0
11325,11325999,20.82071779990121,37.95826999154485,0.07485725761903272,4418.391070127487,890.2540583610535,3376.5976600646973,45915,11626,34289,34289,0,23,11326000.0
11326,11326999,20.82054715750623,37.957847277111405,0.07484593629354463,4418.697607278824,890.3234810829163,3377.3796577453613,45917,11627,34290,34290,0,23,11327000.0
11327,11327999,20.82035408660646,37.9573248666257,0.07483647871351484,4419.058220624924,890.3947887420654,3377.59330368042,45917,11627,34290,34290,0,23,11328000.0
11328,11328999,20.820185189901967,37.956570963872714,0.07482836901720336,4419.5050938129425,890.4626767635345,3377.9663734436035,45921,11629,34292,34292,0,23,11329000.0
11329,11329999,20.820318458272414,37.956681739789026,0.07481918595402481,4419.961749792099,890.5346920490265,3378.0017890930176,45923,11630,34293,34293,0,23,11330000.0
11330,11330999,20.820342838042436,37.95665164173301,0.07480887078748,4420.654448747635,890.6044380664825,3377.8927116394043,45932,11634,34298,34298,0,23,11331000.0
11331,11331999,20.820169311593666,37.95600275941076,0.07480473022630851,4421.158199310303,890.675882101059,3378.179340362549,45936,11636,34300,34300,0,23,11332000.0
11332,11332999,20.82015756546725,37.955663509297025,0.07480181681969111,4421.590573310852,890.7452030181885,3378.3640327453613,45938,11637,34301,34301,0,23,11333000.0
11333,11333999,20.820167254248897,37.955387396961896,0.07479597757958323,4421.909747838974,890.8139224052429,3379.0592155456543,45940,11638,34302,34302,0,23,11334000.0
11334,11334999,20.82019067073031,37.955039501375836,0.07479415941656364,4422.435779094696,890.8846733570099,3379.1458854675293,45945,11640,34305,34305,0,23,11335000.0
11335,11335999,20.820088217990726,37.95441131627439,0.07478813890083313,4422.970842599869,890.9535462856293,3379.1400032043457,45951,11642,34309,34309,0,23,11336000.0
11336,11336999,20.82005006626712,37.953941427812524,0.07478625098464198,4423.37566447258,891.0237007141113,3379.130199432373,45951,11642,34309,34309,0,23,11337000.0
11337,11337999,20.820080323491677,37.953541421315954,0.07478276509844595,4423.975599527359,891.0996806621552,3379.0912742614746,45956,11644,34312,34312,0,23,11338000.0
11338,11338999,20.820226830135795,37.95337180668725,0.0747794016255614,4424.269000530243,891.1701457500458,3379.8508796691895,45968,11645,34323,34323,0,23,11339000.0
11339,11339999,20.82029604289637,37.952972168383475,0.07477670259678226,4424.685227870941,891.2407670021057,3379.9681663513184,45970,11646,34324,34324,0,23,11340000.0
11340,11340999,20.82030224417225,37.9525588433494,0.07477442333975426,4425.132309675217,891.3115363121033,3379.865337371826,45972,11647,34325,34325,0,23,11341000.0
11341,11341999,20.820352665368574,37.95232259527583,0.07477077272174182,4425.683366775513,891.38365483284,3379.511302947998,45976,11648,34328,34328,0,23,11342000.0
11342,11342999,20.82026937163575,37.95167831799187,0.0747657724141767,4426.166163682938,891.4531021118164,3380.2019996643066,46002,11650,34352,34352,0,23,11343000.0
11343,11343999,20.81976500847852,37.950766967062584,0.07475804489853244,4426.316559791565,891.5183455944061,3382.0142860412598,46014,11650,34364,34364,0,23,11344000.0
11344,11344999,20.819235140679833,37.95006596084406,0.07475049593784067,4426.631437063217,891.5813946723938,3382.8924446105957,46018,11651,34367,34367,0,23,11345000.0
11345,11345999,20.818635459677505,37.94949750453068,0.0747442785380028,4427.690748214722,891.744820356369,3383.541118621826,46026,11653,34373,34373,0,23,11346000.0
11346,11346999,20.81824726206602,37.949035058802814,0.0747346894089499,4428.095670223236,891.808263540268,3383.9469261169434,46029,11654,34375,34375,0,23,11347000.0
11347,11347999,20.817826933926057,37.95031905325942,0.07472157127451029,4428.444108963013,891.8719213008881,3384.5482215881348,46031,11655,34376,34376,0,23,11348000.0
11348,11348999,20.81737459448448,37.949585546098376,0.07471259367344474,4428.949957609177,891.9402272701263,3384.8609352111816,46035,11657,34378,34378,0,23,11349000.0
11349,11349999,20.816969394739758,37.94888206821081,0.07470160938839276,4429.148830413818,892.0100374221802,3385.7941551208496,46035,11657,34378,34378,0,23,11350000.0
11350,11350999,20.816655867820792,37.948366823194284,0.074687810676906,4429.535440683365,892.0764708518982,3386.0809745788574,46037,11658,34379,34379,0,23,11351000.0
11351,11351999,20.816302495648817,37.94769522240977,0.07467781370821736,4429.726204156876,892.1398355960846,3386.9422340393066,46037,11658,34379,34379,0,23,11352000.0
11352,11352999,20.815908166404174,37.94699225542283,0.07466891799625919,4430.460527896881,892.2051010131836,3386.5444679260254,46045,11662,34383,34383,0,23,11353000.0
11353,11353999,20.81545745871296,37.94614890107281,0.07466668262835774,4430.970158100128,892.2687222957611,3386.3853492736816,46047,11663,34384,34384,0,23,11354000.0
11354,11354999,20.815216248426697,37.946111048596016,0.07466132749355558,4431.379624843597,892.3343801498413,3386.757984161377,46049,11664,34385,34385,0,23,11355000.0
11355,11355999,20.814979131537534,37.945815490874715,0.07465580844350383,4431.631920814514,892.3996939659119,3387.434413909912,46049,11664,34385,34385,0,23,11356000.0
11356,11356999,20.814871228098454,37.94547407325853,0.07465285019209944,4432.07820057869,892.46337723732,3387.7749671936035,46054,11666,34388,34388,0,23,11357000.0
11357,11357999,20.815326740389114,37.94614717578061,0.07464269528786449,4432.477976799011,892.5297546386719,3387.810245513916,46054,11666,34388,34388,0,23,11358000.0
11358,11358999,20.81589150491015,37.94685720777686,0.07463078836854409,4432.854714393616,892.5929424762726,3388.151958465576,46056,11667,34389,34389,0,23,11359000.0
11359,11359999,20.81631451248852,37.94720226338901,0.0746243503714974,4433.261887073517,892.6569874286652,3388.121524810791,46056,11667,34389,34389,0,23,11360000.0
11360,11360999,20.816791571560344,37.94763994532804,0.07462120905176717,4433.580604791641,892.7214095592499,3388.50093460083,46056,11667,34389,34389,0,23,11361000.0
11361,11361999,20.81750763328532,37.948610125278314,0.07461261392149188,4434.166340351105,892.7876439094543,3388.2144203186035,46060,11669,34391,34391,0,23,11362000.0
11362,11362999,20.818180254172585,37.94934357710621,0.07460436103954193,4434.734336137772,892.8530323505402,3388.0153999328613,46064,11671,34393,34393,0,23,11363000.0
11363,11363999,20.8180630453741,37.94938760175816,0.07459117294256878,4434.967758655548,892.917028427124,3389.3430137634277,46081,11671,34410,34410,0,23,11364000.0
11364,11364999,20.817398239152155,37.94907427084656,0.07458689348940895,4435.446727514267,892.9817032814026,3389.9709434509277,46087,11673,34414,34414,0,23,11365000.0
11365,11365999,20.816906267971362,37.94874696141434,0.07458478865246199,4435.714642524719,893.0484869480133,3390.724277496338,46089,11673,34416,34416,0,23,11366000.0
11366,11366999,20.81647900233733,37.94799923976134,0.07458233775893208,4436.002774715424,893.1140353679657,3391.7742195129395,46091,11674,34417,34417,0,23,11367000.0
11367,11367999,20.81601908098498,37.9472276757069,0.07458265478336923,4436.157809257507,893.1785078048706,3392.852809906006,46091,11674,34417,34417,0,23,11368000.0
11368,11368999,20.815344377760976,37.94605244399867,0.07458558263266035,4436.667413473129,893.2432565689087,3393.035877227783,46095,11676,34419,34419,0,23,11369000.0
11369,11369999,20.814851456255756,37.94524879151685,0.07458535832408353,4437.0010941028595,893.3097879886627,3393.6988105773926,46097,11677,34420,34420,0,23,11370000.0
11370,11370999,20.814326438403224,37.944260726028915,0.0745862418886385,4437.409616470337,893.375599861145,3393.8103981018066,46099,11678,34421,34421,0,23,11371000.0
11371,11371999,20.81387150698009,37.94488280594938,0.07458252917815666,4437.676989078522,893.4426493644714,3394.3525428771973,46099,11678,34421,34421,0,23,11372000.0
11372,11372999,20.813532584490055,37.94466437396434,0.07458009225431994,4438.166608333588,893.509067773819,3394.104404449463,46101,11679,34422,34422,0,23,11373000.0
11373,11373999,20.813090044123683,37.94389515817165,0.07457971155227483,4438.670729398727,893.5775136947632,3394.305591583252,46105,11681,34424,34424,0,23,11374000.0
11374,11374999,20.812991988569312,37.94418294962801,0.07457177725232522,4439.206196069717,893.6444029808044,3394.2819328308105,46109,11683,34426,34426,0,23,11375000.0
11375,11375999,20.812841549716314,37.94568211202593,0.0745600039943306,4439.732335567474,893.7130670547485,3394.4329414367676,46124,11685,34439,34439,0,23,11376000.0
11376,11376999,20.812654439341483,37.945292510393905,0.07455622897099856,4440.0096073150635,893.7795107364655,3394.998790740967,46124,11685,34439,34439,0,23,11377000.0
11377,11377999,20.812494764185242,37.94478812067783,0.07455288557710293,4440.439606666565,893.8468821048737,3395.29496383667,46127,11686,34441,34441,0,23,11378000.0
11378,11378999,20.812512507486638,37.94473953092992,0.07454924748873004,4441.166421175003,893.9168865680695,3395.1515617370605,46142,11690,34452,34452,0,23,11379000.0
11379,11379999,20.81287526023501,37.94641207622965,0.07454048854875384,4441.512183904648,893.9921944141388,3395.7567100524902,46144,11691,34453,34453,0,23,11380000.0
11380,11380999,20.813007751157098,37.94631690637577,0.0745403725400815,4441.947871685028,894.0590500831604,3395.904468536377,46146,11692,34454,34454,0,23,11381000.0
11381,11381999,20.813141427293694,37.94624228224655,0.0745422202577013,4442.243718624115,894.1261491775513,3396.3999977111816,46146,11692,34454,34454,0,23,11382000.0
11382,11382999,20.81329839127479,37.9462244290777,0.07453885921064984,4442.81817984581,894.193578004837,3395.8372535705566,46148,11693,34455,34455,0,23,11383000.0
11383,11383999,20.81324948744744,37.9459270756535,0.07453639032973713,4443.275099515915,894.2585861682892,3396.309741973877,46153,11695,34458,34458,0,23,11384000.0
11384,11384999,20.81306221868361,37.94648992618824,0.07451909368829046,4443.588072776794,894.3236026763916,3397.4571418762207,46158,11696,34462,34462,0,23,11385000.0
11385,11385999,20.812574855133278,37.945688584817674,0.07451315830080951,4443.863834142685,894.3904702663422,3398.1027870178223,46158,11696,34462,34462,0,23,11386000.0
11386,11386999,20.81227732445303,37.945327343131154,0.07450463029676946,4444.333204746246,894.4583730697632,3398.0635566711426,46160,11697,34463,34463,0,23,11387000.0
11387,11387999,20.812164164002393,37.94522049270353,0.0744974656989118,4444.902947187424,894.5265159606934,3397.9060554504395,46165,11699,34466,34466,0,23,11388000.0
11388,11388999,20.811936799181414,37.94443934595589,0.07448770357830614,4445.436904907227,894.5935063362122,3397.926700592041,46170,11701,34469,34469,0,23,11389000.0
11389,11389999,20.81163928379516,37.94355805556241,0.07448018695692205,4446.168283224106,894.6638722419739,3397.434482574463,46181,11704,34477,34477,0,23,11390000.0
11390,11390999,20.811439333564323,37.94284512517243,0.074470449676033,4446.374359369278,894.7319021224976,3398.288158416748,46181,11704,34477,34477,0,23,11391000.0
11391,11391999,20.811174423303196,37.94209332370316,0.07446433178490752,4447.072541952133,894.799859046936,3397.780864715576,46189,11707,34482,34482,0,23,11392000.0
11392,11392999,20.811155384976953,37.94224647454664,0.07445533878933241,4447.565743684769,894.8677449226379,3397.946788787842,46194,11709,34485,34485,0,23,11393000.0
11393,11393999,20.811359622459932,37.94267929867808,0.07445482281849669,4448.194051504135,894.9372804164886,3397.5685539245605,46198,11711,34487,34487,0,23,11394000.0
11394,11394999,20.81163893899146,37.9430911736115,0.07445864579620809,4448.809570074081,895.0070207118988,3397.5176124572754,46205,11714,34491,34491,0,23,11395000.0
11395,11395999,20.81258488695574,37.944663019406846,0.07445809159256456,4449.302984952927,895.0753607749939,3397.7983055114746,46209,11716,34493,34493,0,23,11396000.0
11396,11396999,20.813787054463926,37.94798276956433,0.0744534052459872,4449.827096700668,895.1429123878479,3397.927677154541,46212,11718,34494,34494,0,23,11397000.0
11397,11397999,20.815686516347704,37.95178862114989,0.07446331392574312,4450.0666353702545,895.2124783992767,3398.710247039795,46212,11718,34494,34494,0,23,11398000.0
11398,11398999,20.817432859171934,37.95507671671679,0.0744888343391269,4450.3915231227875,895.2818269729614,3399.00101852417,46212,11718,34494,34494,0,23,11399000.0
11399,11399999,20.819420203164274,37.959209502045994,0.07450924406259063,4450.817343473434,895.3499872684479,3399.1236152648926,46214,11719,34495,34495,0,23,11400000.0
11400,11400999,20.821563744783756,37.96316653142918,0.07453040214208384,4451.146568775177,895.4191088676453,3399.466709136963,46214,11719,34495,34495,0,23,11401000.0
11401,11401999,20.8234877403399,37.96701525596069,0.07453463899020418,4451.649803638458,895.487272977829,3399.2517890930176,46217,11720,34497,34497,0,23,11402000.0
11402,11402999,20.825269630290254,37.9701967222745,0.0745395453887111,4451.9577379226685,895.56325507164,3399.639736175537,46217,11720,34497,34497,0,23,11403000.0
11403,11403999,20.826941867950982,37.97298270778471,0.07455000610158868,4452.534481525421,895.634526014328,3399.289806365967,46221,11722,34499,34499,0,23,11404000.0
11404,11404999,20.82768772950526,37.97381088141337,0.07454844532904659,4452.824325084686,895.7067170143127,3400.4305000305176,46225,11723,34502,34502,0,23,11405000.0
11405,11405999,20.827790318531537,37.974253786349834,0.07453040752020845,4453.16841673851,895.7677466869354,3400.8691749572754,46229,11723,34506,34506,0,23,11406000.0
11406,11406999,20.828006511542142,37.97418082401929,0.07450836547554163,4453.450850009918,895.8298370838165,3401.4993476867676,46229,11723,34506,34506,0,23,11407000.0
11407,11407999,20.828199404933848,37.9741334328493,0.07449152507488721,4453.851855516434,895.8919777870178,3401.9106407165527,46233,11724,34509,34509,0,23,11408000.0
11408,11408999,20.82838310441203,37.97378455255843,0.07447440834837049,4454.404013156891,895.9543652534485,3402.0529594421387,46238,11726,34512,34512,0,23,11409000.0
11409,11409999,20.82846848546419,37.97336406107139,0.07445729303401105,4454.830454587936,896.0220417976379,3402.91450881958,46243,11728,34515,34515,0,23,11410000.0
11410,11410999,20.828641344034576,37.97328607956597,0.074439737922813,4455.542804956436,896.0850961208344,3402.755268096924,46253,11732,34521,34521,0,23,11411000.0
11411,11411999,20.828668156769233,37.97278994323347,0.07442628123626649,4455.990431547165,896.1517839431763,3402.929172515869,46256,11733,34523,34523,0,23,11412000.0
11412,11412999,20.828824784565615,37.97282074521122,0.07441208879785688,4456.191068410873,896.2159729003906,3403.8113899230957,46256,11733,34523,34523,0,23,11413000.0
11413,11413999,20.82894082249362,37.972679082321775,0.07439822382664285,4456.884152650833,896.2791821956635,3403.3119926452637,46262,11736,34526,34526,0,23,11414000.0
11414,11414999,20.828992633826726,37.97236400348146,0.07439002461208222,4457.18788599968,896.341762304306,3403.895221710205,46263,11736,34527,34527,0,23,11415000.0
11415,11415999,20.82903375945196,37.97201591448048,0.07438178364196601,4457.85205578804,896.407386302948,3403.723217010498,46271,11739,34532,34532,0,23,11416000.0
11416,11416999,20.829138729902592,37.97199262015915,0.07437640983365101,4458.136756896973,896.4724111557007,3404.2054405212402,46271,11739,34532,34532,0,23,11417000.0
11417,11417999,20.82929001984544,37.9717502792951,0.07437106277704919,4458.633527040482,896.5386950969696,3404.330348968506,46276,11741,34535,34535,0,23,11418000.0
11418,11418999,20.82946142796843,37.97181285440546,0.0743645967511476,4458.970375061035,896.6035664081573,3404.5410499572754,46276,11741,34535,34535,0,23,11419000.0
11419,11419999,20.829710764528095,37.971674943253426,0.07436119655746876,4459.357413768768,896.670574426651,3404.9933433532715,46278,11742,34536,34536,0,23,11420000.0
11420,11420999,20.82994735557858,37.97148350694667,0.07435821131298037,4459.8813672065735,896.7346646785736,3405.016757965088,46292,11744,34548,34548,0,23,11421000.0
11421,11421999,20.83011201244494,37.971106117248794,0.07435298574604743,4460.403875112534,896.8001306056976,3405.0733222961426,46296,11746,34550,34550,0,23,11422000.0
11422,11422999,20.830388656803084,37.97082025164035,0.07435060475325816,4460.695912837982,896.8645293712616,3405.4614295959473,46296,11746,34550,34550,0,23,11423000.0
11423,11423999,20.83069551275019,37.97055128048073,0.0743438940737221,4461.140753269196,896.9302377700806,3405.5138816833496,46298,11747,34551,34551,0,23,11424000.0
11424,11424999,20.83084269695941,37.97016023832722,0.07433855755786778,4461.666232347488,896.996328830719,3405.336124420166,46301,11748,34553,34553,0,23,11425000.0
11425,11425999,20.83028568985131,37.96929095574115,0.07433802968072567,4462.0677626132965,897.0632379055023,3406.312442779541,46307,11750,34557,34557,0,23,11426000.0
11426,11426999,20.829753421349018,37.96853702368678,0.07433806703942114,4462.460824251175,897.1292617321014,3406.5115394592285,46307,11750,34557,34557,0,23,11427000.0
11427,11427999,20.82929311338024,37.96862527916113,0.07433438156228778,4462.872510671616,897.1956722736359,3406.9382667541504,46309,11751,34558,34558,0,23,11428000.0
11428,11428999,20.828819843003792,37.96770460110815,0.07433481351488558,4463.231952190399,897.263751745224,3407.2263679504395,46309,11751,34558,34558,0,23,11429000.0
11429,11429999,20.82868669069894,37.96769306014663,0.07433559536160661,4463.663552045822,897.3329212665558,3407.500011444092,46312,11752,34560,34560,0,23,11430000.0
11430,11430999,20.828533033118326,37.96798795918772,0.07433386419050869,4463.947025775909,897.4015891551971,3408.1003608703613,46312,11752,34560,34560,0,23,11431000.0
11431,11431999,20.82901131220681,37.970183369587104,0.07434100833754687,4464.293359994888,897.4699220657349,3408.3331031799316,46312,11752,34560,34560,0,23,11432000.0
11432,11432999,20.82988700864827,37.97389274047779,0.0743338541292502,4464.659793376923,897.5374228954315,3408.5069160461426,46313,11752,34561,34561,0,23,11433000.0
11433,11433999,20.83069742604649,37.97669017769436,0.07433105604965384,4465.271804332733,897.6082317829132,3408.6031455993652,46319,11755,34564,34564,0,23,11434000.0
11434,11434999,20.831597548478147,37.979473218510336,0.07433634398029221,4465.709208726883,897.6771831512451,3408.9216957092285,46331,11756,34575,34575,0,23,11435000.0
11435,11435999,20.832375057724803,37.98149820902467,0.0743417988567705,4465.958129644394,897.7459561824799,3409.5546836853027,46331,11756,34575,34575,0,23,11436000.0
11436,11436999,20.83316552058833,37.9835467775518,0.07434341167936476,4466.590190649033,897.8143322467804,3409.16402053833,46348,11758,34590,34590,0,23,11437000.0
11437,11437999,20.834053909384302,37.98556191650447,0.07434028150687655,4467.093267917633,897.8842902183533,3409.3604164123535,46351,11760,34591,34591,0,23,11438000.0
11438,11438999,20.835164294239473,37.987990908995705,0.07434121693880436,4467.603095293045,897.9557242393494,3409.341526031494,46354,11761,34593,34593,0,23,11439000.0
11439,11439999,20.836158010208578,37.989395133780356,0.07434412377103639,4467.845976829529,898.0268669128418,3410.22025680542,46354,11761,34593,34593,0,23,11440000.0
11440,11440999,20.83722085711288,37.99078751151355,0.07434607578093266,4468.180595159531,898.0949976444244,3410.5484657287598,46354,11761,34593,34593,0,23,11441000.0
11441,11441999,20.83825416515579,37.99208550929024,0.07433753878682414,4468.673967123032,898.1648554801941,3410.6357231140137,46357,11763,34594,34594,0,23,11442000.0
11442,11442999,20.83913474407015,37.99278740166821,0.07432436184861646,4469.0411467552185,898.2325060367584,3411.4788246154785,46371,11764,34607,34607,0,23,11443000.0
11443,11443999,20.839131443884625,37.99216930446153,0.07430514917857689,4469.271959543228,898.2967174053192,3412.6849632263184,46375,11764,34611,34611,0,23,11444000.0
11444,11444999,20.839141621006974,37.991683431848124,0.07429294253815966,4469.478520870209,898.3592376708984,3413.9205589294434,46376,11764,34612,34612,0,23,11445000.0
11445,11445999,20.839131741379063,37.9910618799438,0.07428075971956027,4469.847915649414,898.4238722324371,3414.462978363037,46378,11765,34613,34613,0,23,11446000.0
11446,11446999,20.838865912050476,37.99019508304232,0.07427365398934649,4470.179034471512,898.4881155490875,3415.0740928649902,46381,11766,34615,34615,0,23,11447000.0
11447,11447999,20.838576029909834,37.98941183292621,0.07427073994395939,4470.708197593689,898.5526177883148,3415.071018218994,46385,11768,34617,34617,0,23,11448000.0
11448,11448999,20.838415895574414,37.989288007620914,0.07425970102094359,4470.991388559341,898.6178390979767,3415.838291168213,46388,11769,34619,34619,0,23,11449000.0
11449,11449999,20.838254140592177,37.98877843168828,0.07425196625413544,4471.437395811081,898.6817591190338,3415.8484382629395,46390,11770,34620,34620,0,23,11450000.0
11450,11450999,20.83820939050645,37.98886551345468,0.07424251649597424,4471.734623432159,898.7474117279053,3416.5988807678223,46392,11771,34621,34621,0,23,11451000.0
11451,11451999,20.838096215383057,37.98861381921012,0.0742350661778094,4472.458283424377,898.8116450309753,3416.426959991455,46400,11775,34625,34625,0,23,11452000.0
11452,11452999,20.83799201574629,37.98821428849838,0.07422901110750046,4473.1130194664,898.8781747817993,3416.225872039795,46407,11778,34629,34629,0,23,11453000.0
11453,11453999,20.838090196968338,37.98876834820189,0.07421717546281226,4473.557992935181,898.9435276985168,3416.732006072998,46411,11780,34631,34631,0,23,11454000.0
11454,11454999,20.838354246155838,37.98885945614051,0.07421244186456744,4474.292168855667,899.0090517997742,3416.389904022217,46420,11784,34636,34636,0,23,11455000.0
11455,11455999,20.83861816799623,37.98882435168655,0.07420730312636503,4474.657855987549,899.0740616321564,3416.8900260925293,46423,11785,34638,34638,0,23,11456000.0
11456,11456999,20.838882005731197,37.98862794765115,0.07419970858617508,4475.166438579559,899.1407532691956,3416.6971015930176,46427,11786,34641,34641,0,23,11457000.0
11457,11457999,20.83914988564114,37.98876932399423,0.07419624223428734,4475.77277636528,899.2064533233643,3416.7735557556152,46434,11789,34645,34645,0,23,11458000.0
11458,11458999,20.839482686320338,37.98886644386914,0.07419063078477195,4476.034630060196,899.2728977203369,3417.5316200256348,46434,11789,34645,34645,0,23,11459000.0
11459,11459999,20.84003587635406,37.98917452068601,0.0741841802488088,4476.661599397659,899.3396692276001,3417.1859092712402,46439,11791,34648,34648,0,23,11460000.0
11460,11460999,20.840224543169096,37.98894128270728,0.07417920535706135,4476.98096370697,899.4062860012054,3417.519733428955,46439,11791,34648,34648,0,23,11461000.0
11461,11461999,20.8402660217223,37.98880353311005,0.07417333347756105,4477.403962135315,899.4734897613525,3417.6922340393066,46441,11792,34649,34649,0,23,11462000.0
11462,11462999,20.84054074385587,37.98875387255923,0.07415574632212829,4477.605112314224,899.5399839878082,3419.01615524292,46449,11792,34657,34657,0,23,11463000.0
11463,11463999,20.840871395961084,37.98889564357014,0.07414370734878661,4478.275025844574,899.607827425003,3418.859592437744,46458,11795,34663,34663,0,23,11464000.0
11464,11464999,20.841252601073077,37.98907976948592,0.07414166213577877,4478.5542986392975,899.6764190196991,3419.835636138916,46460,11796,34664,34664,0,23,11465000.0
11465,11465999,20.841818697588135,37.98980834407866,0.07415659842580791,4479.054850578308,899.7435674667358,3419.995891571045,46466,11798,34668,34668,0,23,11466000.0
11466,11466999,20.842342349407648,37.99097481067644,0.07418537109162249,4479.829351186752,899.8115482330322,3419.858226776123,46478,11803,34675,34675,0,23,11467000.0
11467,11467999,20.842754780722366,37.99171562420454,0.07422888175851894,4480.474978685379,899.881186246872,3419.795566558838,46485,11806,34679,34679,0,23,11468000.0
11468,11468999,20.843383307475253,37.99300514895509,0.07427890266538661,4481.124812841415,899.9511308670044,3419.696689605713,46492,11809,34683,34683,0,23,11469000.0
11469,11469999,20.84366701324715,37.99349589660568,0.07431725998658134,4481.36731672287,900.019453048706,3420.433582305908,46492,11809,34683,34683,0,23,11470000.0
11470,11470999,20.844149947024498,37.99431211071583,0.07436324710145192,4481.974035739899,900.0897958278656,3420.404727935791,46500,11812,34688,34688,0,23,11471000.0
11471,11471999,20.84446532045873,37.99492327635966,0.07439364991055342,4482.342282772064,900.1604301929474,3420.533908843994,46500,11812,34688,34688,0,23,11472000.0
11472,11472999,20.845012753510304,37.996047744010866,0.07444732297140377,4482.745717525482,900.2316117286682,3420.8340797424316,46502,11813,34689,34689,0,23,11473000.0
11473,11473999,20.84531118923167,37.9961267884261,0.0744764335052126,4483.052171945572,900.3017544746399,3421.180751800537,46502,11813,34689,34689,0,23,11474000.0
11474,11474999,20.845717245711732,37.997674275223766,0.07450225534211086,4483.574214458466,900.3731617927551,3420.990520477295,46505,11814,34691,34691,0,23,11475000.0
11475,11475999,20.846205258961614,37.99865448409943,0.07450500484737088,4483.859951734543,900.4416761398315,3421.5047492980957,46505,11814,34691,34691,0,23,11476000.0
11476,11476999,20.846729594657422,37.99960122937162,0.0745118353281834,4484.3121564388275,900.5110545158386,3421.4830589294434,46507,11815,34692,34692,0,23,11477000.0
11477,11477999,20.847429565821557,38.00102143140839,0.07453457224584814,4484.758372068405,900.580738067627,3421.5191917419434,46509,11816,34693,34693,0,23,11478000.0
11478,11478999,20.847903546045828,38.001562502411865,0.07455388593889734,4484.991549015045,900.6487095355988,3422.185161590576,46509,11816,34693,34693,0,23,11479000.0
11479,11479999,20.848610611555415,38.00366164619612,0.07459417690851788,4485.523759841919,900.7175362110138,3421.7310752868652,46511,11817,34694,34694,0,23,11480000.0
11480,11480999,20.84946321597021,38.00600960676753,0.07466075473512179,4485.9266810417175,900.7860877513885,3422.0112953186035,46513,11818,34695,34695,0,23,11481000.0
11481,11481999,20.849951377239005,38.006803201179295,0.07470205091219018,4486.191297292709,900.8575377464294,3422.637592315674,46513,11818,34695,34695,0,23,11482000.0
11482,11482999,20.85046444113001,38.008904949300465,0.07468038415053746,4486.597536563873,900.9200570583344,3423.7159309387207,46528,11820,34708,34708,0,23,11483000.0
11483,11483999,20.851007431246213,38.01050563086673,0.07465900693495886,4486.882472991943,900.9819185733795,3424.4339027404785,46529,11820,34709,34709,0,23,11484000.0
11484,11484999,20.85137237616419,38.01110791780535,0.07464905711631586,4487.449095010757,901.0437939167023,3424.703227996826,46533,11822,34711,34711,0,23,11485000.0
11485,11485999,20.851826035671213,38.01218529839217,0.0746384746227885,4487.819738149643,901.1056942939758,3425.299961090088,46545,11823,34722,34722,0,23,11486000.0
11486,11486999,20.852247407149893,38.01335041111066,0.0746277873219483,4488.144217252731,901.1683056354523,3425.926959991455,46548,11824,34724,34724,0,23,11487000.0
11487,11487999,20.852362214526504,38.0129534552932,0.07462119398332479,4488.646190881729,901.2315449714661,3425.8394203186035,46550,11825,34725,34725,0,23,11488000.0
11488,11488999,20.852588684406008,38.012887803348946,0.07461534375387469,4489.314624547958,901.2957465648651,3425.845012664795,46559,11829,34730,34730,0,23,11489000.0
11489,11489999,20.852589011728,38.01247605202408,0.0746125971434366,4489.88693189621,901.3590347766876,3425.9060554504395,46566,11832,34734,34734,0,23,11490000.0
11490,11490999,20.852569927155486,38.011898184528405,0.07460827693117578,4490.37678527832,901.4222269058228,3426.1950492858887,46570,11834,34736,34736,0,23,11491000.0
11491,11491999,20.85269917414039,38.01184786100774,0.07460057804667186,4490.825679302216,901.486189365387,3426.378620147705,46572,11835,34737,34737,0,23,11492000.0
11492,11492999,20.85268109662967,38.0113230192342,0.07459909545655152,4491.350829601288,901.5493657588959,3426.4829750061035,46577,11837,34740,34740,0,23,11493000.0
11493,11493999,20.852839203567274,38.01111595810876,0.07459570044748753,4491.588952064514,901.6129457950592,3427.1385383605957,46577,11837,34740,34740,0,23,11494000.0
11494,11494999,20.85306497219757,38.01100937418292,0.07458992110601326,4492.105095863342,901.6779818534851,3427.2514686584473,46582,11839,34743,34743,0,23,11495000.0
11495,11495999,20.853274461989503,38.01082362874724,0.07458581651181984,4492.530830621719,901.7406849861145,3427.14457321167,46582,11839,34743,34743,0,23,11496000.0
11496,11496999,20.85349436899113,38.01082611711615,0.07457932660946687,4492.936982154846,901.8055880069733,3427.3453483581543,46585,11840,34745,34745,0,23,11497000.0
11497,11497999,20.853728876087818,38.010645069689595,0.07457385654308668,4493.305378913879,901.8691022396088,3427.3837547302246,46585,11840,34745,34745,0,23,11498000.0
11498,11498999,20.853912248250413,38.01121846826953,0.07456587024696004,4493.713803529739,901.9327776432037,3427.579448699951,46588,11841,34747,34747,0,23,11499000.0
11499,11499999,20.85410761071869,38.01091109777841,0.07456221945582464,4494.082521915436,901.9955539703369,3428.0138664245605,46590,11842,34748,34748,0,23,11500000.0
11500,11500999,20.8542802470944,38.01046098161543,0.07455654855006733,4494.440989971161,902.0600452423096,3428.067523956299,46590,11842,34748,34748,0,23,11501000.0
11501,11501999,20.854555172482264,38.01033286028865,0.07455279647515489,4495.0864408016205,902.1250824928284,3427.8796043395996,46598,11845,34753,34753,0,23,11502000.0
11502,11502999,20.85433227365318,38.009415201101916,0.07454188109061644,4512.390152692795,902.1898334026337,3428.5162239074707,46608,11846,34762,34762,0,23,11503000.0
11503,11503999,20.854010211684496,38.008474640672084,0.07453700436059907,4512.89226436615,902.2550411224365,3428.6711387634277,46612,11848,34764,34764,0,23,11504000.0
11504,11504999,20.85346932961877,38.007492787790035,0.07453582835292794,4513.477944612503,902.3222320079803,3428.9665336608887,46619,11851,34768,34768,0,23,11505000.0
11505,11505999,20.852950259096698,38.00639077932702,0.07453538504767265,4513.839210033417,902.3889863491058,3429.5083808898926,46621,11852,34769,34769,0,23,11506000.0
11506,11506999,20.85251141968167,38.00553706429421,0.07453262210766665,4514.073661327362,902.4526855945587,3430.129596710205,46621,11852,34769,34769,0,23,11507000.0
11507,11507999,20.85194574870634,38.004386332888465,0.0745333683665067,4514.46931385994,902.5182557106018,3430.308261871338,46623,11853,34770,34770,0,23,11508000.0
11508,11508999,20.851617005742003,38.004072023812355,0.074527770972307,4514.899312496185,902.584620475769,3430.47367477417,46625,11854,34771,34771,0,23,11509000.0
11509,11509999,20.85111119534587,38.00299362823396,0.07452717693741773,4515.168528079987,902.649626493454,3430.9333992004395,46625,11854,34771,34771,0,23,11510000.0
11510,11510999,20.850660611084276,38.00201937311651,0.07452664112113105,4516.211004972458,902.7162370681763,3429.8727073669434,46639,11860,34779,34779,0,23,11511000.0
11511,11511999,20.850348480409696,38.001409001869334,0.07452311332376393,4516.612725973129,902.7825434207916,3430.193759918213,46641,11861,34780,34780,0,23,11512000.0
11512,11512999,20.850178181676085,38.00118664512699,0.07452118032496924,4516.936781644821,902.8490946292877,3430.4888038635254,46641,11861,34780,34780,0,23,11513000.0
11513,11513999,20.8500528145579,38.00075170950025,0.074519111884911,4517.559906959534,902.9165720939636,3430.4875144958496,46647,11864,34783,34783,0,23,11514000.0
11514,11514999,20.84997998128883,38.0007257358219,0.07451500948751422,4517.845792531967,902.9818012714386,3430.9834938049316,46647,11864,34783,34783,0,23,11515000.0
11515,11515999,20.849905997730943,38.000603129638726,0.07451252942812903,4518.155228614807,903.0477635860443,3431.3180351257324,46647,11864,34783,34783,0,23,11516000.0
11516,11516999,20.849975879200386,38.00064643561008,0.0745098514260949,4518.528967142105,903.1142735481262,3431.654956817627,46650,11865,34785,34785,0,23,11517000.0
11517,11517999,20.850022416150964,38.00068608282739,0.07450814587451493,4518.979119539261,903.1797609329224,3431.6548194885254,46652,11866,34786,34786,0,23,11518000.0
11518,11518999,20.85011941148301,38.000535400678416,0.07450921532794041,4519.421569824219,903.2462818622589,3431.3425102233887,46652,11866,34786,34786,0,23,11519000.0
11519,11519999,20.85045312126095,38.000880104978094,0.0745074789463307,4519.86635017395,903.3114540576935,3431.475688934326,46655,11867,34788,34788,0,23,11520000.0
11520,11520999,20.85078731797674,38.00118644078748,0.07450665072399176,4520.134979248047,903.3774745464325,3431.9832496643066,46655,11867,34788,34788,0,23,11521000.0
11521,11521999,20.851042434031214,38.0013308849571,0.07451354364806395,4520.549399137497,903.444390296936,3432.201427459717,46657,11868,34789,34789,0,23,11522000.0
11522,11522999,20.850883003647127,38.0007648579098,0.07451083738508701,4520.94485783577,903.5094854831696,3433.1220741271973,46666,11869,34797,34797,0,23,11523000.0
11523,11523999,20.85029376474583,37.999847637218295,0.07451061027058259,4521.263534784317,903.5752010345459,3434.1458854675293,46668,11870,34798,34798,0,23,11524000.0
11524,11524999,20.84977865500569,37.998987063535154,0.07450627603305648,4521.494870424271,903.6410653591156,3435.1187324523926,46668,11870,34798,34798,0,23,11525000.0
11525,11525999,20.849209282385896,37.998181573177845,0.07450580287080555,4522.197168111801,903.7094769477844,3434.7002296447754,46676,11873,34803,34803,0,23,11526000.0
11526,11526999,20.84871707031284,37.99714046694848,0.07450530658408261,4522.441659212112,903.776643037796,3435.3483848571777,46676,11873,34803,34803,0,23,11527000.0
11527,11527999,20.848119642106482,37.99594516168345,0.07450674847761629,4523.042761087418,903.844605922699,3435.0815238952637,46690,11875,34815,34815,0,23,11528000.0
11528,11528999,20.84774865397087,37.99572836646655,0.0745008905367247,4523.357178211212,903.9122717380524,3435.775821685791,46692,11876,34816,34816,0,23,11529000.0
11529,11529999,20.847296682283208,37.99474875984252,0.0744981091964837,4523.887761592865,903.9802448749542,3435.75972366333,46697,11878,34819,34819,0,23,11530000.0
11530,11530999,20.846937208920767,37.99387522727184,0.0744999168825875,4524.331323623657,904.0470952987671,3435.848934173584,46700,11879,34821,34821,0,23,11531000.0
11531,11531999,20.846702122490107,37.993202135829,0.0744935182486649,4524.724340438843,904.1166100502014,3436.2363777160645,46713,11880,34833,34833,0,23,11532000.0
11532,11532999,20.84689032056671,37.99352545159456,0.07448535264829259,4525.124764919281,904.1846921443939,3436.6259422302246,46715,11881,34834,34834,0,23,11533000.0
11533,11533999,20.847344404001845,37.99519218648297,0.07447583909978372,4525.685658216476,904.253002166748,3436.9530448913574,46723,11884,34839,34839,0,23,11534000.0
11534,11534999,20.84808877628108,37.99588381945498,0.0744653248729058,4525.977335453033,904.3212172985077,3437.42769241333,46723,11884,34839,34839,0,23,11535000.0
11535,11535999,20.848675515514554,37.996776500902364,0.07445679307368447,4526.445478916168,904.388213634491,3437.449520111084,46726,11885,34841,34841,0,23,11536000.0
11536,11536999,20.84981328014569,37.99897039777616,0.07445556768864925,4526.859782457352,904.4570043087006,3437.2871742248535,46726,11885,34841,34841,0,23,11537000.0
11537,11537999,20.85069682874029,38.00020828796531,0.07445271065560688,4527.258253335953,904.5240366458893,3437.5155448913574,46729,11886,34843,34843,0,23,11538000.0
11538,11538999,20.852044544189454,38.00236043511625,0.07445690101193359,4527.7096490859985,904.5936458110809,3437.5638313293457,46731,11887,34844,34844,0,23,11539000.0
11539,11539999,20.85314299822728,38.00398018919358,0.0744664148772679,4528.1280605793,904.6616837978363,3437.8930854797363,46733,11888,34845,34845,0,23,11540000.0
11540,11540999,20.854588177471115,38.00683514111368,0.07447644566314782,4528.491005182266,904.7309391498566,3438.380084991455,46735,11889,34846,34846,0,23,11541000.0
11541,11541999,20.856341341521347,38.00973205158566,0.07449584009360555,4528.880664110184,904.7995963096619,3438.684772491455,46738,11890,34848,34848,0,23,11542000.0
11542,11542999,20.85784619831853,38.0120046836708,0.07449769664771977,4529.296161413193,904.86798620224,3438.7383995056152,46738,11890,34848,34848,0,23,11543000.0
11543,11543999,20.857734996366197,38.01194758676844,0.07448927584890619,4529.870043039322,904.930454492569,3439.3211784362793,46762,11893,34869,34869,0,23,11544000.0
11544,11544999,20.857373514507334,38.01125759569957,0.07448230913386622,4530.131954908371,904.9930753707886,3440.7373008728027,46775,11894,34881,34881,0,23,11545000.0
11545,11545999,20.857128699195,38.01064081309835,0.0744751644991497,4530.529793739319,905.0547578334808,3441.3023414611816,46780,11895,34885,34885,0,23,11546000.0
11546,11546999,20.856960034526622,38.01013090150688,0.07446607989800624,4531.120205402374,905.1170172691345,3441.4266471862793,46787,11898,34889,34889,0,23,11547000.0
11547,11547999,20.85684585134611,38.00958399492688,0.07445904260956704,4531.366261482239,905.1794466972351,3442.259433746338,46787,11898,34889,34889,0,23,11548000.0
11548,11548999,20.856748093367216,38.00886628342794,0.07445190862512552,4531.663332939148,905.2446415424347,3442.7387504577637,46788,11898,34890,34890,0,23,11549000.0
11549,11549999,20.856680326776985,38.00834547561602,0.07444339520990884,4532.117453575134,905.3084888458252,3442.850917816162,46791,11899,34892,34892,0,23,11550000.0
11550,11550999,20.856585778900204,38.00775383730603,0.07443772747225208,4532.629136800766,905.3738374710083,3442.7266578674316,46793,11900,34893,34893,0,23,11551000.0
11551,11551999,20.85668757685489,38.00753620136307,0.07443038574031391,4532.953187942505,905.4398150444031,3443.1321144104004,46793,11900,34893,34893,0,23,11552000.0
11552,11552999,20.85676949121472,38.00751901802592,0.07442549901203577,4533.358715057373,905.504088640213,3443.4174995422363,46795,11901,34894,34894,0,23,11553000.0
11553,11553999,20.85711725897654,38.00778127297887,0.07441888008312669,4533.766813516617,905.5683214664459,3443.6819496154785,46797,11902,34895,34895,0,23,11554000.0
11554,11554999,20.857771098858226,38.00892399609033,0.07441290151718416,4534.094349145889,905.6321866512299,3444.3258781433105,46799,11903,34896,34896,0,23,11555000.0
11555,11555999,20.858285199974798,38.00922655879408,0.07441103515560499,4534.512197494507,905.6957106590271,3444.512348175049,46801,11904,34897,34897,0,23,11556000.0
11556,11556999,20.85893912461609,38.01018489384967,0.0744075251351426,4534.670525074005,905.7591700553894,3445.564266204834,46801,11904,34897,34897,0,23,11557000.0
11557,11557999,20.85950377946356,38.01080684171602,0.07440978313182955,4535.251506328583,905.8245213031769,3444.930561065674,46805,11905,34900,34900,0,23,11558000.0
11558,11558999,20.860067918698928,38.01098992166676,0.07441517358867589,4535.611629724503,905.8887631893158,3445.1235160827637,46805,11905,34900,34900,0,23,11559000.0
11559,11559999,20.860724637456215,38.01209178848616,0.07442373640313116,4536.113965511322,905.9528434276581,3445.265895843506,46810,11907,34903,34903,0,23,11560000.0
11560,11560999,20.861360676774783,38.01237003535484,0.07442192867680042,4536.54025053978,906.0176978111267,3445.3364295959473,46812,11908,34904,34904,0,23,11561000.0
11561,11561999,20.861878137271095,38.0124204052466,0.0744220209092129,4537.1515300273895,906.0829699039459,3445.022533416748,46816,11910,34906,34906,0,23,11562000.0
11562,11562999,20.862449403629302,38.01275188014505,0.07442478400620312,4537.443002462387,906.1472685337067,3445.53950881958,46816,11910,34906,34906,0,23,11563000.0
11563,11563999,20.862368522287387,38.01198581687356,0.07442221764112755,4537.77831697464,906.210723400116,3446.1785469055176,46825,11910,34915,34915,0,23,11564000.0
11564,11564999,20.86179834340528,38.010927912593175,0.07442212228098888,4538.150130987167,906.2765140533447,3446.883861541748,46827,11911,34916,34916,0,23,11565000.0
11565,11565999,20.86117854372094,38.010005791457274,0.0744240593804516,4538.436802625656,906.3413727283478,3447.603260040283,46827,11911,34916,34916,0,23,11566000.0
11566,11566999,20.86049428215451,38.00883971332154,0.07442642118803,4538.633752584457,906.406806230545,3448.5899772644043,46827,11911,34916,34916,0,23,11567000.0
11567,11567999,20.85996158143209,38.00814974214464,0.07442757120253929,4539.100178718567,906.4725127220154,3448.5819129943848,46830,11912,34918,34918,0,23,11568000.0
11568,11568999,20.859380111054456,38.007073362244626,0.07442910832685778,4539.494458913803,906.5385730266571,3448.997127532959,46833,11913,34920,34920,0,23,11569000.0
11569,11569999,20.85881213584782,38.00603463998095,0.07442961180674934,4539.869024753571,906.6115462779999,3449.4085578918457,46835,11914,34921,34921,0,23,11570000.0
11570,11570999,20.858366534575072,38.00522089000329,0.07442856861224967,4540.436477661133,906.6836121082306,3449.3687705993652,46840,11916,34924,34924,0,23,11571000.0
11571,11571999,20.85806098038877,38.00500511111406,0.07442358465441679,4540.721784114838,906.7493553161621,3449.9230918884277,46840,11916,34924,34924,0,23,11572000.0
11572,11572999,20.85781227605421,38.0047470872518,0.07441944806092671,4541.569640159607,906.817812204361,3449.1017875671387,46848,11920,34928,34928,0,23,11573000.0
11573,11573999,20.857667747018755,38.00447699673874,0.07441516412935156,4541.963770151138,906.8896503448486,3449.4330101013184,46848,11920,34928,34928,0,23,11574000.0
11574,11574999,20.857538474800943,38.00526225508695,0.07440707530000268,4542.167713880539,906.9554963111877,3450.322612762451,46848,11920,34928,34928,0,23,11575000.0
11575,11575999,20.8575154497783,38.00491701931114,0.07440248453079201,4542.67654967308,907.0213704109192,3450.2610816955566,46852,11922,34930,34930,0,23,11576000.0
11576,11576999,20.85763249391691,38.0047877624266,0.0743976857411216,4543.454016208649,907.0906484127045,3449.8320274353027,46862,11926,34936,34936,0,23,11577000.0
11577,11577999,20.85769926493806,38.00440045747917,0.0743937777189494,4544.112778186798,907.1579620838165,3449.412654876709,46866,11928,34938,34938,0,23,11578000.0
11578,11578999,20.857722988215855,38.00397869036067,0.07438930970357671,4544.482616424561,907.2245237827301,3449.5862159729004,46866,11928,34938,34938,0,23,11579000.0
11579,11579999,20.8577577346804,38.00369034467151,0.07438554761110272,4544.7499923706055,907.2926678657532,3450.270610809326,46866,11928,34938,34938,0,23,11580000.0
11580,11580999,20.857523871716136,38.00284471772909,0.07438387786553036,4545.0374484062195,907.3592989444733,3450.6679344177246,46866,11928,34938,34938,0,23,11581000.0
11581,11581999,20.85714792761194,38.001872897546384,0.07438384863031977,4545.373575210571,907.4267771244049,3451.2477073669434,46869,11928,34941,34941,0,23,11582000.0
11582,11582999,20.85655274977014,38.00073951390766,0.07438464675194001,4545.6821937561035,907.4895401000977,3451.832607269287,46870,11928,34942,34942,0,23,11583000.0
11583,11583999,20.856214440594048,38.00002924110619,0.07438322984157064,4546.039384126663,907.5542614459991,3452.4285774230957,46874,11929,34945,34945,0,23,11584000.0
11584,11584999,20.855706626327798,37.99884826894263,0.07438443651493032,4546.492780447006,907.61913895607,3452.7767448425293,46879,11931,34948,34948,0,23,11585000.0
11585,11585999,20.855288186649577,37.99789796915479,0.07438337257069172,4546.817172050476,907.6839454174042,3453.344928741455,46881,11932,34949,34949,0,23,11586000.0
11586,11586999,20.85478382125668,37.99679684181793,0.07438399570984255,4547.263892173767,907.7503921985626,3453.709369659424,46885,11934,34951,34951,0,23,11587000.0
11587,11587999,20.854396712830084,37.99649087187086,0.07438275367051828,4547.914769649506,907.8165752887726,3453.397876739502,46894,11937,34957,34957,0,23,11588000.0
11588,11588999,20.854439196353457,37.997585341372485,0.07437550165047813,4548.227338552475,907.8818867206573,3453.775287628174,46894,11937,34957,34957,0,23,11589000.0
11589,11589999,20.85468426386384,38.00012373523417,0.07437066298914308,4548.628580570221,907.9470176696777,3454.0483741760254,46897,11938,34959,34959,0,23,11590000.0
11590,11590999,20.855338328923082,38.00336380259104,0.0743627802871688,4549.234796762466,908.0122971534729,3454.07719039917,46909,11941,34968,34968,0,23,11591000.0
11591,11591999,20.856277631412564,38.00861165024548,0.07435360135946711,4549.9414620399475,908.0778834819794,3453.787738800049,46918,11945,34973,34973,0,23,11592000.0
11592,11592999,20.85725187629978,38.01190751892296,0.07434536339632958,4550.46254658699,908.1449544429779,3453.669330596924,46920,11946,34974,34974,0,23,11593000.0
11593,11593999,20.858535048404246,38.01597244656561,0.07434215627943719,4550.795075416565,908.2106862068176,3453.954288482666,46920,11946,34974,34974,0,23,11594000.0
11594,11594999,20.859910908953214,38.0198406946807,0.07433830502630179,4551.204973697662,908.2777218818665,3454.1149559020996,46922,11947,34975,34975,0,23,11595000.0
11595,11595999,20.86101675550583,38.02231400312739,0.07435680160972424,4551.73095202446,908.3454070091248,3454.2560691833496,46938,11949,34989,34989,0,23,11596000.0
11596,11596999,20.862824650260688,38.02759021911997,0.07436668832317506,4552.236479282379,908.4122657775879,3454.2589149475098,46940,11950,34990,34990,0,23,11597000.0
11597,11597999,20.864198188877094,38.03085669083152,0.07438159547504841,4552.523574829102,908.478481054306,3454.749828338623,46940,11950,34990,34990,0,23,11598000.0
11598,11598999,20.86575466950346,38.034710993572645,0.07438287425429202,4552.715204954147,908.5446076393127,3455.6042137145996,46940,11950,34990,34990,0,23,11599000.0
11599,11599999,20.867074805703,38.037930492361724,0.07440385258543514,4553.434855461121,908.6125566959381,3455.021884918213,46947,11953,34994,34994,0,23,11600000.0
11600,11600999,20.86790876526098,38.039313517562285,0.07440071863715991,4553.804130792618,908.6797304153442,3455.8355827331543,46956,11954,35002,35002,0,23,11601000.0
11601,11601999,20.86769417687494,38.03894851259052,0.07438377124064655,4554.100316524506,908.7482290267944,3456.6519508361816,46960,11954,35006,35006,0,23,11602000.0
11602,11602999,20.867456943244797,38.038660548483136,0.07437424935646675,4554.461847782135,908.8159422874451,3456.946979522705,46960,11954,35006,35006,0,23,11603000.0
11603,11603999,20.86728534413555,38.03843358764751,0.07436796755813546,4554.754083633423,908.8847041130066,3457.8705863952637,46963,11955,35008,35008,0,23,11604000.0
11604,11604999,20.86732298106501,38.039496445317724,0.07435968120248981,4555.298176765442,908.9539964199066,3458.127788543701,46971,11958,35013,35013,0,23,11605000.0
11605,11605999,20.867504124394586,38.04060950185,0.07435550257869972,4556.107285261154,909.0222201347351,3457.564121246338,46981,11962,35019,35019,0,23,11606000.0
11606,11606999,20.86788370912438,38.04253254141368,0.0743598803380977,4556.380548000336,909.0933496952057,3458.254451751709,46981,11962,35019,35019,0,23,11607000.0
11607,11607999,20.868710555580005,38.04592108367805,0.07436909662626079,4556.711733579636,909.1626396179199,3458.7816276550293,46983,11963,35020,35020,0,23,11608000.0
11608,11608999,20.8696712589068,38.04966657825966,0.07438406843604783,4557.268266439438,909.231062412262,3458.90092086792,46987,11965,35022,35022,0,23,11609000.0
11609,11609999,20.870567290234842,38.05273213869179,0.07441400487721561,4557.786148309708,909.301183462143,3459.0660285949707,46991,11967,35024,35024,0,23,11610000.0
11610,11610999,20.871584932052045,38.055732628090894,0.07444058313819879,4558.145751714706,909.3696160316467,3459.1870613098145,46991,11967,35024,35024,0,23,11611000.0
11611,11611999,20.872318595472628,38.057587795468024,0.07447325838497831,4558.6259179115295,909.4391326904297,3459.1988105773926,46993,11968,35025,35025,0,23,11612000.0
11612,11612999,20.873124765973113,38.059485500140944,0.07451443740104347,4559.026379108429,909.5112149715424,3459.6618843078613,46995,11969,35026,35026,0,23,11613000.0
11613,11613999,20.873993495866607,38.061459380635526,0.0745240295912869,4559.699398994446,909.5804176330566,3459.2913856506348,47001,11972,35029,35029,0,23,11614000.0
11614,11614999,20.874667893882716,38.06263827937189,0.07454130408076265,4559.989242076874,909.6487700939178,3460.1242713928223,47003,11973,35030,35030,0,23,11615000.0
11615,11615999,20.87543538712829,38.063692451854166,0.07455808339317915,4560.524077177048,909.7174863815308,3459.793056488037,47005,11974,35031,35031,0,23,11616000.0
11616,11616999,20.876292672036044,38.06496723781621,0.0745730808179933,4560.964349985123,909.7860772609711,3459.740879058838,47005,11974,35031,35031,0,23,11617000.0
11617,11617999,20.877011654357794,38.0665181805881,0.07458617636479592,4561.397716522217,909.8594844341278,3460.031482696533,47007,11975,35032,35032,0,23,11618000.0
11618,11618999,20.877623144548366,38.067131193446315,0.07459845618680727,4561.745288133621,909.9343197345734,3460.5132331848145,47009,11976,35033,35033,0,23,11619000.0
11619,11619999,20.878111404296035,38.06757484330324,0.0746069009917737,4562.237739801407,910.0039381980896,3460.084156036377,47009,11976,35033,35033,0,23,11620000.0
11620,11620999,20.878562617807788,38.067828200509695,0.07458767545327594,4562.568170785904,910.0717256069183,3460.614154815674,47016,11976,35040,35040,0,23,11621000.0
11621,11621999,20.878514319554576,38.06742150722993,0.07457141372045806,4562.9061534404755,910.1330151557922,3461.5990028381348,47024,11977,35047,35047,0,23,11622000.0
11622,11622999,20.878326304652962,38.06670567497873,0.07455820851563166,4563.178918838501,910.1956055164337,3462.6606636047363,47027,11978,35049,35049,0,23,11623000.0
11623,11623999,20.878259398751315,38.06618215038002,0.07453782018397592,4563.487671136856,910.2598297595978,3463.1601371765137,47027,11978,35049,35049,0,23,11624000.0
11624,11624999,20.878297937888174,38.066110679568716,0.07451644894533616,4563.942865848541,910.3242430686951,3463.4981269836426,47032,11980,35052,35052,0,23,11625000.0
11625,11625999,20.878222947935914,38.065608130208616,0.07449826409646165,4564.3101925849915,910.3877654075623,3463.5675086975098,47032,11980,35052,35052,0,23,11626000.0
11626,11626999,20.87821829695837,38.06516459200389,0.07447792115571317,4564.737674236298,910.4559540748596,3463.8671836853027,47035,11981,35054,35054,0,23,11627000.0
11627,11627999,20.878094221791773,38.06458588480025,0.0744623588549469,4565.214451313019,910.5206761360168,3464.05073928833,47040,11983,35057,35057,0,23,11628000.0
11628,11628999,20.877976997798743,38.06414954833051,0.07444859114551317,4565.782072305679,910.5885169506073,3464.095241546631,47044,11985,35059,35059,0,23,11629000.0
11629,11629999,20.877867433450117,38.06358374711814,0.07443902879463826,4566.25209403038,910.6558780670166,3464.051067352295,47047,11986,35061,35061,0,23,11630000.0
11630,11630999,20.877885520811887,38.06345504914279,0.07442750161764522,4566.752228498459,910.7198166847229,3464.178653717041,47051,11988,35063,35063,0,23,11631000.0
11631,11631999,20.877997951055043,38.06348367899164,0.07441038809411893,4567.450764417648,910.7834475040436,3463.8998985290527,47057,11991,35066,35066,0,23,11632000.0
11632,11632999,20.878005519691126,38.06320047142275,0.07439811329526991,4567.767807722092,910.8477864265442,3464.6940956115723,47059,11992,35067,35067,0,23,11633000.0
11633,11633999,20.87798007568908,38.06274598870165,0.07438728308025633,4568.142264127731,910.9118554592133,3465.0239219665527,47062,11993,35069,35069,0,23,11634000.0
11634,11634999,20.878125966261386,38.062701118823924,0.07437658969479843,4568.51365852356,910.9799911975861,3465.091899871826,47062,11993,35069,35069,0,23,11635000.0
11635,11635999,20.878208885378783,38.06254638146789,0.07436823418877525,4568.943982601166,911.044275522232,3465.2393531799316,47069,11994,35075,35075,0,23,11636000.0
11636,11636999,20.878269138380475,38.062124139516584,0.07436006810828355,4569.496277332306,911.1093783378601,3465.013111114502,47073,11996,35077,35077,0,23,11637000.0
11637,11637999,20.878595135448723,38.06248669059244,0.07434290737127569,4569.731741189957,911.1739981174469,3465.676990509033,47073,11996,35077,35077,0,23,11638000.0
11638,11638999,20.87874672994913,38.0627239019891,0.07433219984497719,4570.141828536987,911.2400546073914,3465.8104972839355,47075,11997,35078,35078,0,23,11639000.0
11639,11639999,20.87885991737361,38.06239993056832,0.07432257137391562,4570.512485265732,911.3064124584198,3465.8042945861816,47075,11997,35078,35078,0,23,11640000.0
11640,11640999,20.87872270436393,38.06166106888426,0.07431785042509675,4570.962393522263,911.3712632656097,3465.84525680542,47077,11998,35079,35079,0,23,11641000.0
11641,11641999,20.878758208822028,38.060916085486255,0.07430128003542902,4571.466313838959,911.4364955425262,3466.1284141540527,47083,11999,35084,35084,0,23,11642000.0
11642,11642999,20.878628611180936,38.06024307924015,0.07428553336130406,4571.804584741592,911.5017549991608,3466.854503631592,47086,12000,35086,35086,0,23,11643000.0
11643,11643999,20.878679882796618,38.059652436267434,0.07426413061334058,4572.092339754105,911.5657966136932,3467.362003326416,47086,12000,35086,35086,0,23,11644000.0
11644,11644999,20.878569681158922,38.05904860641875,0.07424763038541948,4572.697870731354,911.6317238807678,3467.181125640869,47091,12002,35089,35089,0,23,11645000.0
11645,11645999,20.878253644913105,38.05812921695867,0.07423950054594441,4573.315366029739,911.6970934867859,3467.046573638916,47099,12005,35094,35094,0,23,11646000.0
11646,11646999,20.8779287442337,38.05723979038731,0.07423359437503829,4573.79373717308,911.764436006546,3467.4259910583496,47113,12007,35106,35106,0,23,11647000.0
11647,11647999,20.87773387368169,38.056904147234214,0.07422350783782328,4574.161106586456,911.8304421901703,3467.5866661071777,47113,12007,35106,35106,0,23,11648000.0
11648,11648999,20.877564875884712,38.05660151701061,0.0742156187647307,4574.358927488327,911.8968434333801,3468.342082977295,47113,12007,35106,35106,0,23,11649000.0
11649,11649999,20.87736641720065,38.05616670243155,0.07420773194335462,4575.250695466995,911.9628541469574,3467.1607398986816,47124,12011,35113,35113,0,23,11650000.0
11650,11650999,20.87707964982281,38.0554360513615,0.07420263389146808,4575.7172684669495,912.0306444168091,3467.1621055603027,47127,12012,35115,35115,0,23,11651000.0
11651,11651999,20.876790361425783,38.05483912392276,0.07419759362929135,4576.034185886383,912.097090959549,3467.5024909973145,47127,12012,35115,35115,0,23,11652000.0
11652,11652999,20.876660277616324,38.05431304566631,0.07418903524912879,4576.419824361801,912.1655106544495,3467.8748512268066,47129,12013,35116,35116,0,23,11653000.0
11653,11653999,20.876607534113017,38.05425604107626,0.07417960938169288,4576.9159417152405,912.2318086624146,3467.997699737549,47134,12015,35119,35119,0,23,11654000.0
11654,11654999,20.876460477148907,38.05375236307515,0.07417223842620035,4577.547101736069,912.2997539043427,3467.448642730713,47140,12017,35123,35123,0,23,11655000.0
11655,11655999,20.876529932215796,38.05385749385752,0.07416533001055903,4578.084065914154,912.3669962882996,3467.1742362976074,47142,12018,35124,35124,0,23,11656000.0
11656,11656999,20.87659492735211,38.05376402581762,0.07416049149942894,4578.323682308197,912.432256937027,3467.850009918213,47142,12018,35124,35124,0,23,11657000.0
11657,11657999,20.8766646212683,38.0534902175521,0.07415581979039165,4578.741545915604,912.498831987381,3467.9773750305176,47145,12019,35126,35126,0,23,11658000.0
11658,11658999,20.876664938965384,38.053140531098286,0.0741523592531349,4579.069041013718,912.5648338794708,3468.1599311828613,47145,12019,35126,35126,0,23,11659000.0
11659,11659999,20.87643357922101,38.05247689917263,0.07415559245862913,4579.52233338356,912.6324467658997,3468.125759124756,47147,12020,35127,35127,0,23,11660000.0
11660,11660999,20.87617661742184,38.05193614979192,0.07415253965178836,4579.976083040237,912.7000799179077,3468.4808082580566,47162,12022,35140,35140,0,23,11661000.0
11661,11661999,20.87595531816789,38.05125954068354,0.0741488928489421,4580.355371713638,912.7683615684509,3469.2778511047363,47170,12023,35147,35147,0,23,11662000.0
11662,11662999,20.875387052784582,38.050536923838514,0.07414710353890286,4580.737702846527,912.8441941738129,3470.047336578369,47173,12024,35149,35149,0,23,11663000.0
11663,11663999,20.874811716213213,38.04977487530912,0.07414848904166227,4580.998754262924,912.9101955890656,3470.7712059020996,47173,12024,35149,35149,0,23,11664000.0
11664,11664999,20.874198662461616,38.04873162772326,0.07415109606687531,4581.3304851055145,912.9783909320831,3471.131290435791,47173,12024,35149,35149,0,23,11665000.0
11665,11665999,20.87369371035956,38.04809288142027,0.07415007202591639,4581.704745054245,913.0450794696808,3471.1462364196777,47173,12024,35149,35149,0,23,11666000.0
11666,11666999,20.873216176406242,38.0472779623532,0.07415021818431056,4582.062045574188,913.1135585308075,3471.7075386047363,47185,12025,35160,35160,0,23,11667000.0
11667,11667999,20.872695243314535,38.0462818940638,0.0741513031122717,4582.94432425499,913.1807429790497,3470.953311920166,47197,12030,35167,35167,0,23,11668000.0
11668,11668999,20.87218094404715,38.04536882191721,0.07415265286800066,4583.447275876999,913.2484772205353,3470.9463386535645,47200,12031,35169,35169,0,23,11669000.0
11669,11669999,20.87175270668708,38.04461075315786,0.0741523381231981,4583.8031623363495,913.3160257339478,3471.1327171325684,47200,12031,35169,35169,0,23,11670000.0
11670,11670999,20.87136587387167,38.04385694867729,0.07415257893637972,4584.222494840622,913.3862285614014,3471.3572273254395,47202,12032,35170,35170,0,23,11671000.0
11671,11671999,20.871137446212373,38.04528671739818,0.07414298571259481,4584.957453489304,913.4569237232208,3471.089084625244,47211,12036,35175,35175,0,23,11672000.0
11672,11672999,20.870964979631957,38.0452083113904,0.07413945548735579,4585.289685487747,913.5284576416016,3471.7978553771973,47212,12037,35175,35175,0,23,11673000.0
11673,11673999,20.870851259385258,38.04547703979501,0.07413897899018096,4585.622289657593,913.5977435112,3472.072010040283,47212,12037,35175,35175,0,23,11674000.0
11674,11674999,20.8713633080944,38.048290620025064,0.07413593550802822,4586.2627918720245,913.6681151390076,3471.526798248291,47216,12039,35177,35177,0,23,11675000.0
11675,11675999,20.87238854295219,38.05115121282664,0.07414736459013649,4586.8534643650055,913.7378718852997,3471.3509101867676,47220,12041,35179,35179,0,23,11676000.0
11676,11676999,20.87361396332487,38.056884482337075,0.07416173867908937,4587.182737112045,913.8102276325226,3472.271213531494,47234,12042,35192,35192,0,23,11677000.0
11677,11677999,20.875041345299277,38.06114200796261,0.07416926113038358,4587.573733091354,913.8820736408234,3472.9178352355957,47241,12043,35198,35198,0,23,11678000.0
11678,11678999,20.87648174994079,38.06455678203588,0.0741761928754725,4588.021027565002,913.9515435695648,3473.399066925049,47245,12045,35200,35200,0,23,11679000.0
11679,11679999,20.878104760651283,38.06917487001989,0.07418341624467362,4588.353323936462,914.0226566791534,3474.0466270446777,47248,12046,35202,35202,0,23,11680000.0
11680,11680999,20.879835281985343,38.0729031567632,0.07419806278817365,4588.752566099167,914.0923445224762,3474.350902557373,47251,12047,35204,35204,0,23,11681000.0
11681,11681999,20.880776639951296,38.074338324535255,0.0742042769239104,4589.208014011383,914.1642200946808,3474.4844856262207,47253,12048,35205,35205,0,23,11682000.0
11682,11682999,20.880736038648816,38.0755411874373,0.07420864143536499,4589.634759426117,914.2272143363953,3474.8088722229004,47256,12049,35207,35207,0,23,11683000.0
11683,11683999,20.880211549386804,38.07498721126472,0.07420809241276527,4590.029087781906,914.288017988205,3475.201892852783,47262,12050,35212,35212,0,23,11684000.0
11684,11684999,20.8800094497204,38.074416858238216,0.07420599161499042,4590.487656116486,914.3504481315613,3475.3708992004395,47264,12051,35213,35213,0,23,11685000.0
11685,11685999,20.880032487734073,38.0742762050209,0.07420250728425581,4591.107974767685,914.4138040542603,3475.460475921631,47273,12054,35219,35219,0,23,11686000.0
11686,11686999,20.8800856684668,38.074023430765536,0.07420108182550111,4591.448975563049,914.4768204689026,3475.7818717956543,47275,12054,35221,35221,0,23,11687000.0
11687,11687999,20.880199149776832,38.07390615578127,0.0741994993924916,4591.818831682205,914.54123711586,3476.327610015869,47277,12055,35222,35222,0,23,11688000.0
11688,11688999,20.88029711322659,38.073715817804015,0.07419844289964339,4592.425367355347,914.605366230011,3476.0149269104004,47281,12057,35224,35224,0,23,11689000.0
11689,11689999,20.88043225760045,38.07382297923521,0.07419554167878428,4592.876131534576,914.668616771698,3476.3718452453613,47286,12059,35227,35227,0,23,11690000.0
11690,11690999,20.880925046415346,38.07471928934413,0.07419223949828102,4593.10485959053,914.7318072319031,3477.1635780334473,47287,12059,35228,35228,0,23,11691000.0
11691,11691999,20.88118087291632,38.074904429085294,0.07419524245263565,4593.68435549736,914.7954015731812,3477.323818206787,47294,12062,35232,35232,0,23,11692000.0
11692,11692999,20.88158319078089,38.07533086348084,0.07420022235179435,4594.138561248779,914.8584425449371,3477.355236053467,47297,12063,35234,35234,0,23,11693000.0
11693,11693999,20.882558982064644,38.07742738106248,0.07420704759327112,4594.813905954361,914.9234764575958,3477.081958770752,47304,12066,35238,35238,0,23,11694000.0
11694,11694999,20.883536850977507,38.07955894150018,0.07421470923649354,4595.372480392456,914.9892365932465,3477.4403038024902,47312,12069,35243,35243,0,23,11695000.0
11695,11695999,20.884439200954148,38.08122086531123,0.07422659542870913,4596.222270965576,915.053258895874,3476.7660026550293,47322,12073,35249,35249,0,23,11696000.0
11696,11696999,20.885663686420155,38.08441644590482,0.07423278715711745,4596.648964643478,915.116560459137,3476.8961601257324,47325,12074,35251,35251,0,23,11697000.0
11697,11697999,20.886968775215855,38.08808309586033,0.07425304624162277,4596.921420812607,915.180538892746,3477.4790687561035,47325,12074,35251,35251,0,23,11698000.0
11698,11698999,20.888324103012554,38.09111386484282,0.07426502509687993,4597.415051698685,915.246365070343,3477.7861289978027,47330,12076,35254,35254,0,23,11699000.0
11699,11699999,20.889531171041256,38.094010510355254,0.07428598886994908,4597.775428056717,915.3103187084198,3478.2777137756348,47332,12077,35255,35255,0,23,11700000.0
11700,11700999,20.89047375076184,38.09535110163796,0.07430183006948698,4598.6455228328705,915.4285113811493,3478.2883338928223,47334,12078,35256,35256,0,23,11701000.0
11701,11701999,20.89119286498703,38.09663171313243,0.07431206810329372,4599.6662838459015,915.5598795413971,3477.9017372131348,47336,12079,35257,35257,0,23,11702000.0
11702,11702999,20.891534041056318,38.09681810698733,0.07429844917447381,4600.132233142853,915.698826789856,3479.1579093933105,47344,12079,35265,35265,0,23,11703000.0
11703,11703999,20.891496659505897,38.096542273438075,0.0742826726796465,4601.048455476761,915.8383409976959,3479.5698204040527,47349,12081,35268,35268,0,23,11704000.0
11704,11704999,20.891468165764653,38.09707022510597,0.07426607193898949,4601.680714607239,915.9597821235657,3480.019313812256,47350,12081,35269,35269,0,23,11705000.0
11705,11705999,20.89119709489716,38.0963246978639,0.07425884546707728,4602.077658414841,916.0666041374207,3480.803409576416,47350,12081,35269,35269,0,23,11706000.0
11706,11706999,20.89094358538381,38.09553112708711,0.07425005158919917,4603.164061307907,916.1927654743195,3480.509120941162,47355,12083,35272,35272,0,23,11707000.0
11707,11707999,20.89085336222818,38.095679903176084,0.07423726125845687,4603.877638339996,916.3051109313965,3480.7573738098145,47360,12085,35275,35275,0,23,11708000.0
