,n_samples,MAE,RMSE,R2,time_learning,time_predicting,memory,n_nodes,n_branches,n_leaves,n_active_leaves,n_inactive_leaves,height,total_observed_weight
0,999,20.401038822654076,37.91708190971309,-0.013148671472235529,0.14763665199279785,0.06559371948242188,0.2982368469238281,3,1,2,2,0,2,1000.0
1,1999,21.362123666901432,42.908940440897815,-0.006030575683125816,0.30725669860839844,0.13360023498535156,0.3704261779785156,3,1,2,2,0,2,2000.0
2,2999,20.565912759444476,39.68833923722097,-0.005052775094398054,0.44112324714660645,0.18448400497436523,0.4081077575683594,3,1,2,2,0,2,3000.0
3,3999,20.809965887791222,44.73486800596238,-0.0033250874353638604,0.5790212154388428,0.23610711097717285,0.5408287048339844,16,2,14,14,0,3,4000.0
4,4999,20.30473815206262,42.22911378063944,-0.003520668526062254,0.7120082378387451,0.28885650634765625,0.7598419189453125,17,3,14,14,0,3,5000.0
5,5999,19.916538181665054,40.750805559673566,-0.002335958346498135,0.8243997097015381,0.34281373023986816,0.9483299255371094,18,4,14,14,0,4,6000.0
6,6999,19.87034790860904,39.65508135448547,-0.0011791846919326776,0.9549098014831543,0.39603304862976074,1.0945358276367188,18,4,14,14,0,4,7000.0
7,7999,20.03630750880322,39.08785081767348,0.0014243477781695768,1.0856235027313232,0.450268030166626,1.5214347839355469,36,5,31,31,0,5,8000.0
8,8999,20.337549909779426,39.24581149761591,0.005165182205921548,1.1831116676330566,0.5051167011260986,1.9682540893554688,36,5,31,31,0,5,9000.0
9,9999,20.837433907334752,39.841924358730125,0.011415210241408347,1.287116527557373,0.5597100257873535,2.2159156799316406,36,5,31,31,0,5,10000.0
10,10999,21.011141606988666,39.52124482963474,0.016203475947536905,1.3952116966247559,0.614016056060791,2.319782257080078,40,7,33,33,0,6,11000.0
11,11999,21.07009438416727,39.060571860495855,0.02776363306597074,1.4988653659820557,0.667609453201294,2.501659393310547,40,7,33,33,0,6,12000.0
12,12999,21.523735873657113,40.2696733290314,0.035622321565523474,1.6165812015533447,0.7213010787963867,2.5897560119628906,42,8,34,34,0,6,13000.0
13,13999,21.97530398796855,40.58655997270402,0.050977543697987016,1.745060920715332,0.7754461765289307,2.619152069091797,46,10,36,36,0,7,14000.0
14,14999,22.351624666534253,40.85744051142216,0.06259541838966942,1.8476834297180176,0.8293309211730957,2.7537612915039062,48,11,37,37,0,7,15000.0
15,15999,22.475383607602136,40.619792605182816,0.07211430758343995,1.9662423133850098,0.8828628063201904,2.8982772827148438,48,11,37,37,0,7,16000.0
16,16999,22.739945796719525,40.90896577488548,0.08193684668692847,2.0739541053771973,0.9367437362670898,2.9935684204101562,48,11,37,37,0,7,17000.0
17,17999,22.959404229391055,40.81053467168529,0.08475309455524516,2.1896965503692627,0.9906437397003174,3.076976776123047,48,11,37,37,0,7,18000.0
18,18999,22.944175142978935,40.47560103431266,0.08507116730694686,2.3202664852142334,1.0452001094818115,3.206127166748047,48,11,37,37,0,7,19000.0
19,19999,23.024846729975533,40.333460688290806,0.07422522816051047,2.4213645458221436,1.0998940467834473,3.508838653564453,48,11,37,37,0,7,20000.0
20,20999,23.09586884523783,40.39742023228946,0.05486049094054435,2.5991580486297607,1.154942512512207,3.6437950134277344,48,11,37,37,0,7,21000.0
21,21999,23.004355937441858,40.017348411472106,0.04886154890252581,2.7038073539733887,1.2087299823760986,3.72894287109375,48,11,37,37,0,7,22000.0
22,22999,22.92652023184168,39.85437283873639,0.043460818143616686,2.836345672607422,1.2640295028686523,3.8167076110839844,48,11,37,37,0,7,23000.0
23,23999,22.83912064053659,39.468935126567004,0.03840687477681681,2.9489595890045166,1.3190345764160156,3.8989105224609375,48,11,37,37,0,7,24000.0
24,24999,22.74218852528956,39.132375552319154,0.03387466152798768,3.069236993789673,1.3736693859100342,3.9439239501953125,48,11,37,37,0,7,25000.0
25,25999,22.645879315140025,38.878551468996676,0.029738893364398944,3.1934313774108887,1.4279451370239258,4.004924774169922,48,11,37,37,0,7,26000.0
26,26999,22.588013946477613,38.60356932645282,0.025529774288311158,3.326688289642334,1.4830718040466309,4.07794189453125,48,11,37,37,0,7,27000.0
27,27999,22.49126399086213,38.35047762498509,0.02307359153411348,3.457742691040039,1.537524938583374,4.107135772705078,48,11,37,37,0,7,28000.0
28,28999,22.4123843883052,38.253357031788994,0.020623071539723092,3.5676321983337402,1.5922620296478271,4.159320831298828,48,11,37,37,0,7,29000.0
29,29999,22.324611858517653,37.973526804701,0.020327844772870196,3.6957147121429443,1.647127628326416,4.210422515869141,48,11,37,37,0,7,30000.0
30,30999,22.250073160940577,38.09208387982043,0.020652663173571395,3.8258657455444336,1.7019717693328857,4.222572326660156,48,11,37,37,0,7,31000.0
31,31999,22.161973744625886,37.83653871586119,0.020386424326806485,3.9448587894439697,1.756958246231079,4.257106781005859,48,11,37,37,0,7,32000.0
32,32999,22.095153039713747,37.69047434092921,0.02128945875409105,4.062700510025024,1.8118932247161865,4.281898498535156,48,11,37,37,0,7,33000.0
33,33999,22.03330239236898,37.49824707793559,0.022086460005541708,4.187744855880737,1.8667628765106201,4.3015289306640625,48,11,37,37,0,7,34000.0
34,34999,21.973488758481874,37.340769603447306,0.023331553866817845,4.301671504974365,1.921950101852417,4.33984375,48,11,37,37,0,7,35000.0
35,35999,21.9655752896787,37.205486036029924,0.023513346298188353,4.425356388092041,1.976672887802124,4.274631500244141,50,12,38,38,0,7,36000.0
36,36999,21.909158273156113,37.02842372782987,0.024162234248825798,4.562392473220825,2.032013416290283,4.328369140625,50,12,38,38,0,7,37000.0
37,37999,21.859191158792765,36.82221023359094,0.024753160819849573,4.686585426330566,2.087160348892212,4.342979431152344,50,12,38,38,0,7,38000.0
38,38999,21.79033378510167,36.64017904321063,0.02514448135820546,4.815269231796265,2.1409738063812256,4.352546691894531,50,12,38,38,0,7,39000.0
39,39999,21.70227578742239,36.44233171358414,0.02560023169408876,4.932345151901245,2.1953835487365723,4.374546051025391,50,12,38,38,0,7,40000.0
40,40999,21.671022594132197,36.33366372337858,0.02370598966735571,5.056931257247925,2.249584674835205,4.463642120361328,51,12,39,39,0,7,41000.0
41,41999,21.608250229821994,36.145703329657806,0.02012535336553245,5.178776264190674,2.3038880825042725,4.5023193359375,51,12,39,39,0,7,42000.0
42,42999,21.50587449165061,35.93016949666103,0.0198627991907242,5.289557218551636,2.3590142726898193,4.539146423339844,53,13,40,40,0,7,43000.0
43,43999,21.402678232468226,35.69895125804839,0.019051383780053444,5.4174721240997314,2.41389536857605,4.572261810302734,53,13,40,40,0,7,44000.0
44,44999,21.32471620084176,35.52155102635584,0.018037088433499382,5.548002481460571,2.4689104557037354,4.584388732910156,53,13,40,40,0,7,45000.0
45,45999,21.23019755047091,35.29179293410663,0.017211678090528593,5.6602864265441895,2.524092197418213,4.600120544433594,53,13,40,40,0,7,46000.0
46,46999,21.14349732098169,35.09477224195833,0.016120011889139696,5.7938432693481445,2.5793697834014893,4.612316131591797,53,13,40,40,0,7,47000.0
47,47999,21.07670931805889,34.99518803895538,0.014788695278101005,5.91696572303772,2.634819269180298,4.624702453613281,53,13,40,40,0,7,48000.0
48,48999,21.034092644216056,34.98190432631506,0.014208109065248165,6.031912326812744,2.6898412704467773,4.63055419921875,53,13,40,40,0,7,49000.0
49,49999,20.976062384007314,34.95118898994429,0.013566545035542665,6.168342113494873,2.745192050933838,4.508312225341797,56,14,42,42,0,7,50000.0
50,50999,20.92301151469325,34.87310572631836,0.01528779170774297,6.279855251312256,2.8013808727264404,4.552001953125,56,14,42,42,0,7,51000.0
51,51999,20.888813455931512,34.77256273647858,0.015942212982693826,6.418797016143799,2.855879068374634,4.419963836669922,59,15,44,44,0,7,52000.0
52,52999,20.828689392756377,34.64550156474451,0.016414153987625024,6.531497240066528,2.9114127159118652,4.504421234130859,59,15,44,44,0,7,53000.0
53,53999,20.793029008400158,34.59894668328392,0.01657928012895249,6.658147573471069,2.9662675857543945,4.494884490966797,61,16,45,45,0,8,54000.0
54,54999,20.764471228431237,34.516191129941355,0.0184998683088623,6.776758432388306,3.021536111831665,4.548103332519531,61,16,45,45,0,8,55000.0
55,55999,20.754096728832565,34.46883616647165,0.019648565989963118,6.9037861824035645,3.077441692352295,4.577388763427734,61,16,45,45,0,8,56000.0
56,56999,20.737282633899984,34.41133539254518,0.02028190994871837,7.02374529838562,3.1322622299194336,4.603473663330078,61,16,45,45,0,8,57000.0
57,57999,20.730786378215342,34.36057105829307,0.020723309395357492,7.155868768692017,3.1875693798065186,4.622264862060547,61,16,45,45,0,8,58000.0
58,58999,20.710309237042853,34.280939858280895,0.0214176985354545,7.2777464389801025,3.2428793907165527,4.6366424560546875,61,16,45,45,0,8,59000.0
59,59999,20.704384212612712,34.21762575768777,0.022031585658886854,7.390055418014526,3.298400402069092,4.6542510986328125,61,16,45,45,0,8,60000.0
60,60999,20.71545860946967,34.3352531393913,0.021893046218235623,7.535734176635742,3.35273814201355,4.6041107177734375,65,17,48,48,0,8,61000.0
61,61999,20.66769810105738,34.23548367446665,0.021085402023709898,7.638869047164917,3.4085445404052734,4.867668151855469,68,17,51,51,0,8,62000.0
62,62999,20.612205486313744,34.169757739648404,0.019728678625261065,7.767520904541016,3.463756799697876,4.959999084472656,68,17,51,51,0,8,63000.0
63,63999,20.547805874293356,34.11518521955162,0.019236280457516686,7.910762310028076,3.5197486877441406,4.9865570068359375,72,19,53,53,0,8,64000.0
64,64999,20.47477241966312,33.98024948775324,0.01862128983806355,8.03557014465332,3.575831413269043,5.032478332519531,74,20,54,54,0,8,65000.0
65,65999,20.44716687078391,33.96807895354646,0.018020704225032325,8.129369735717773,3.631129026412964,5.095722198486328,74,20,54,54,0,8,66000.0
66,66999,20.430851571092184,34.02094990112868,0.017095360964498707,8.267044067382812,3.68689227104187,5.079811096191406,76,21,55,55,0,8,67000.0
67,67999,20.414432354879146,33.987335192444064,0.015908390742231715,8.3744535446167,3.7427310943603516,5.143375396728516,76,21,55,55,0,8,68000.0
68,68999,20.450008259977587,34.07000524444045,0.01584940635218579,8.509795188903809,3.798462390899658,5.192409515380859,76,21,55,55,0,8,69000.0
69,69999,20.495884826911787,34.407303973597855,0.01585294242505142,8.644976139068604,3.8541343212127686,5.172645568847656,78,22,56,56,0,8,70000.0
70,70999,20.568958501470817,34.62998601016418,0.01784938098456923,8.769450664520264,3.9100894927978516,5.180522918701172,80,23,57,57,0,8,71000.0
71,71999,20.66019987272052,34.832311230538785,0.020831657711356644,8.88965630531311,3.966710329055786,5.175235748291016,84,24,60,60,0,8,72000.0
72,72999,20.728940472533765,35.20412732839424,0.021568856728490182,9.023826599121094,4.02344274520874,5.142814636230469,88,25,63,63,0,8,73000.0
73,73999,20.79750467214184,35.44620560342405,0.0263106973654198,9.125776290893555,4.079624891281128,5.222408294677734,88,25,63,63,0,8,74000.0
74,74999,20.874910539540803,35.58585068698724,0.02774402233793194,9.25130844116211,4.135732173919678,5.217296600341797,96,26,70,70,0,8,75000.0
75,75999,20.954882167438345,35.71715121000044,0.029461074181324598,9.403696298599243,4.1916420459747314,5.29180908203125,96,26,70,70,0,8,76000.0
76,76999,21.07415582185063,36.120579906533656,0.03275041507926879,9.512564182281494,4.246891975402832,5.359073638916016,96,26,70,70,0,8,77000.0
77,77999,21.200141250844524,36.32068607598747,0.03366550236238386,9.621277093887329,4.302624464035034,5.433597564697266,96,26,70,70,0,8,78000.0
78,78999,21.30238140199896,36.459513174132326,0.03497561112463676,9.742664337158203,4.3583948612213135,5.474086761474609,96,26,70,70,0,8,79000.0
79,79999,21.412977708095795,36.58308180751546,0.035544592760112126,9.874958992004395,4.414124011993408,5.362922668457031,100,27,73,73,0,8,80000.0
80,80999,21.49834121383272,36.65420875023625,0.035767940524451314,10.012153387069702,4.4696056842803955,5.440013885498047,100,27,73,73,0,8,81000.0
81,81999,21.501300103955124,36.646281588999614,0.034857619754395275,10.119700193405151,4.526494979858398,5.828884124755859,107,27,80,80,0,8,82000.0
82,82999,21.48475352609524,36.637134160012955,0.03414504326639234,10.233535528182983,4.5821027755737305,6.0167694091796875,107,27,80,80,0,8,83000.0
83,83999,21.439790209772088,36.52883232677966,0.03404332687506029,10.351069927215576,4.6373817920684814,6.03509521484375,114,29,85,85,0,8,84000.0
84,84999,21.41013344385694,36.4512128875133,0.03377639540003896,10.475491762161255,4.693196773529053,6.088489532470703,120,32,88,88,0,8,85000.0
85,85999,21.423910741252705,36.5015372372338,0.03329438729209977,10.592644453048706,4.749685287475586,6.141792297363281,124,34,90,90,0,8,86000.0
86,86999,21.4050380730462,36.446856948549446,0.03307129346959248,10.730182886123657,4.805846929550171,6.17626953125,129,35,94,94,0,8,87000.0
87,87999,21.457802801719858,36.51803737608571,0.0325653538720847,10.843347072601318,4.862605810165405,6.275478363037109,131,36,95,95,0,8,88000.0
88,88999,21.508731267278264,36.59018287070729,0.03194968046370639,10.967177391052246,4.918862342834473,6.3110198974609375,136,37,99,99,0,8,89000.0
89,89999,21.564406516225574,36.650409949460766,0.031872418208094944,11.091618299484253,4.97559666633606,6.358013153076172,138,38,100,100,0,9,90000.0
90,90999,21.632245876130046,36.73234051154111,0.03170774515436614,11.207574605941772,5.032418251037598,6.448020935058594,138,38,100,100,0,9,91000.0
91,91999,21.71447543886308,36.85494591507327,0.03258072168919712,11.345046043395996,5.088140249252319,6.508953094482422,138,38,100,100,0,9,92000.0
92,92999,21.826983217933428,37.09256137584925,0.03332641596753294,11.451277256011963,5.1434807777404785,6.567859649658203,138,38,100,100,0,9,93000.0
93,93999,21.91103074911942,37.22616399278605,0.03376612023206371,11.580953359603882,5.199988126754761,6.5223541259765625,140,39,101,101,0,9,94000.0
94,94999,21.98274711322444,37.302371803892974,0.034611395124086286,11.698950052261353,5.255629539489746,6.6253662109375,140,39,101,101,0,9,95000.0
95,95999,22.08184558969956,37.459827147152374,0.03593455609143703,11.817193508148193,5.3117897510528564,6.6157379150390625,142,40,102,102,0,9,96000.0
96,96999,22.189790142003453,37.60716472297365,0.03723487527600933,11.93973445892334,5.367394685745239,6.714488983154297,142,40,102,102,0,9,97000.0
97,97999,22.312422607384374,37.91820624122231,0.03781234871446959,12.131754398345947,5.443841218948364,6.7266082763671875,144,41,103,103,0,9,98000.0
98,98999,22.417432307500945,38.064571481549784,0.03920067393604498,12.245425939559937,5.502734899520874,6.777530670166016,146,42,104,104,0,9,99000.0
99,99999,22.52840416174358,38.23422561450126,0.040711307779485395,12.390535831451416,5.567615032196045,6.751369476318359,148,43,105,105,0,9,100000.0
100,100999,22.612246462117035,38.3164347798756,0.04185011977720199,12.503079652786255,5.624598026275635,6.851959228515625,148,43,105,105,0,9,101000.0
101,101999,22.654332044668124,38.34483656649811,0.04139261539395156,12.645678520202637,5.683166027069092,7.298580169677734,157,43,114,114,0,9,102000.0
102,102999,22.63138697753345,38.28341258519745,0.04094259501708153,12.758776426315308,5.741821050643921,7.589359283447266,158,43,115,115,0,9,103000.0
103,103999,22.617362451604144,38.27984948844346,0.04055985601169232,12.869820833206177,5.799798011779785,7.687099456787109,161,44,117,117,0,9,104000.0
104,104999,22.578934317095758,38.23689345155928,0.0405447623984857,13.007351636886597,5.856014728546143,7.526420593261719,177,48,129,129,0,9,105000.0
105,105999,22.54459682220799,38.17014388453477,0.04062341830413141,13.113885641098022,5.912817478179932,7.594814300537109,183,49,134,134,0,9,106000.0
106,106999,22.499338153081197,38.092297168975854,0.040473873118789805,13.255432844161987,5.970299959182739,7.552104949951172,193,54,139,139,0,9,107000.0
107,107999,22.446728016330976,37.987296396900526,0.040522443943774134,13.357142210006714,6.027160167694092,7.801033020019531,193,54,139,139,0,9,108000.0
108,108999,22.41530489407878,38.065568233620255,0.040022592083448716,13.485036611557007,6.083568096160889,7.852756500244141,200,55,145,145,0,9,109000.0
109,109999,22.371636888035294,37.99504747460287,0.04001130968023636,13.620303630828857,6.140164613723755,8.026168823242188,200,55,145,145,0,9,110000.0
110,110999,22.340766473322887,37.9196504802056,0.04000694801556226,13.723047018051147,6.271996736526489,8.15499496459961,200,55,145,145,0,9,111000.0
111,111999,22.309585539641176,37.97050840866003,0.04029740946247595,13.88916563987732,6.3300042152404785,8.092826843261719,218,58,160,160,0,9,112000.0
112,112999,22.275950064399158,37.89482078514202,0.040367759559832295,13.99205756187439,6.387104511260986,8.293510437011719,218,58,160,160,0,9,113000.0
113,113999,22.24922313585051,37.84064397306985,0.04031802358988523,14.106754541397095,6.444516181945801,8.411346435546875,220,59,161,161,0,9,114000.0
114,114999,22.22546735013664,37.79228106388836,0.04063429484194547,14.229722261428833,6.5017876625061035,8.523357391357422,220,59,161,161,0,9,115000.0
115,115999,22.199994293037527,37.72547972712668,0.040728092946104355,14.349688529968262,6.559343338012695,8.626388549804688,220,59,161,161,0,9,116000.0
116,116999,22.171074859709904,37.65173194135836,0.0409068058207418,14.487368106842041,6.616997480392456,8.730670928955078,220,59,161,161,0,9,117000.0
117,117999,22.146187884318877,37.62961095096395,0.04106941491305871,14.613272190093994,6.673707485198975,8.738964080810547,222,60,162,162,0,9,118000.0
118,118999,22.110983300845415,37.56347343115785,0.04097745429427735,14.73949384689331,6.7311341762542725,8.865921020507812,222,60,162,162,0,9,119000.0
119,119999,22.073881205636816,37.49898399215811,0.04078719525631824,14.848607301712036,6.7885119915008545,9.607234954833984,236,60,176,176,0,9,120000.0
120,120999,22.028953727769665,37.41472773823476,0.040948157684560504,14.95817518234253,6.845600366592407,9.908294677734375,236,60,176,176,0,9,121000.0
121,121999,21.971340062075072,37.318230826020226,0.04102889743624549,15.091042041778564,6.90234899520874,9.908920288085938,245,62,183,183,0,9,122000.0
122,122999,21.922299410401582,37.24720566168975,0.041090642601702254,15.194400787353516,6.959403038024902,10.143928527832031,245,62,183,183,0,9,123000.0
123,123999,21.870728944517403,37.16257020173509,0.04127872390149934,15.318774700164795,7.0164244174957275,10.078594207763672,261,65,196,196,0,9,124000.0
124,124999,21.82312076743784,37.14917843281493,0.04110296879614195,15.465195178985596,7.07346773147583,9.791606903076172,280,72,208,208,0,9,125000.0
125,125999,21.782550400006745,37.0850905992749,0.04105816421351505,15.590924739837646,7.130763292312622,9.946067810058594,286,75,211,211,0,9,126000.0
126,126999,21.746405425694533,37.02012620868767,0.04089332025991499,15.700948238372803,7.188112258911133,10.256755828857422,286,75,211,211,0,9,127000.0
127,127999,21.713756648905544,36.95703439484973,0.04049185993703108,15.812154054641724,7.245659112930298,10.432136535644531,286,75,211,211,0,9,128000.0
128,128999,21.68965106881784,36.89570902452524,0.04027362342022267,15.933467388153076,7.303338527679443,10.55990219116211,288,76,212,212,0,9,129000.0
129,129999,21.664938622559845,36.84764173516927,0.039959984524410075,16.07420825958252,7.361266136169434,10.621753692626953,295,77,218,218,0,9,130000.0
130,130999,21.633182978570026,36.791321762944214,0.040407051854826515,16.188411951065063,7.418760299682617,10.740287780761719,295,77,218,218,0,9,131000.0
131,131999,21.627704289763326,36.851159643457265,0.04030113344670272,16.305816173553467,7.476410627365112,10.846874237060547,295,77,218,218,0,9,132000.0
132,132999,21.620205389856476,36.83058547165061,0.03993930986818428,16.43694829940796,7.533217906951904,10.95272445678711,295,77,218,218,0,9,133000.0
133,133999,21.627324283099156,36.844686763270275,0.04002391115175974,16.56244969367981,7.590617418289185,11.022533416748047,295,77,218,218,0,9,134000.0
134,134999,21.647915896494233,36.87180680021297,0.04014327241018312,16.680806875228882,7.648220777511597,11.116924285888672,295,77,218,218,0,9,135000.0
135,135999,21.666265258903668,36.87758144255145,0.040099897127933715,16.808568239212036,7.705525159835815,11.12973403930664,297,78,219,219,0,9,136000.0
136,136999,21.68502214276501,36.891123257745626,0.04026554311704533,16.938005685806274,7.762094020843506,11.088253021240234,348,79,269,269,0,9,137000.0
137,137999,21.709207159866313,36.96301794032504,0.04069378473451524,17.059530019760132,7.819666624069214,11.365398406982422,348,79,269,269,0,9,138000.0
138,138999,21.71759242512839,36.94699230756122,0.040777376914763463,17.186566829681396,7.8770058155059814,12.134445190429688,348,79,269,269,0,9,139000.0
139,139999,21.734711472377246,36.94894231258699,0.03965524600143777,17.28398084640503,7.934079170227051,12.698955535888672,348,79,269,269,0,9,140000.0
140,140999,21.734974040271048,36.89433636373495,0.0387608247825022,17.387181043624878,7.991938352584839,13.060115814208984,348,79,269,269,0,9,141000.0
141,141999,21.733323034861748,36.84191826339021,0.03823082545665735,17.510448932647705,8.049084186553955,13.370685577392578,348,79,269,269,0,9,142000.0
142,142999,21.719470183815066,36.77686802981188,0.03765619050651825,17.620028257369995,8.105675458908081,13.52239990234375,348,79,269,269,0,9,143000.0
143,143999,21.710604353046314,36.74020259618392,0.03722874778831797,17.729565620422363,8.16281008720398,13.78194808959961,348,79,269,269,0,9,144000.0
144,144999,21.692850290283157,36.672465736439136,0.03691471776010846,17.866743803024292,8.219998359680176,13.841876983642578,356,80,276,276,0,9,145000.0
145,145999,21.67750711518153,36.61468637210906,0.03659377107561301,17.978368520736694,8.276419878005981,13.995662689208984,356,80,276,276,0,9,146000.0
146,146999,21.663113679995345,36.56126992316518,0.03642264320998778,18.115426063537598,8.33359146118164,14.02947998046875,364,81,283,283,0,9,147000.0
147,147999,21.644267114758325,36.4956873365877,0.03623761723008956,18.22679114341736,8.389432668685913,14.143497467041016,364,81,283,283,0,9,148000.0
148,148999,21.63333235112579,36.457553076201485,0.03616641655205721,18.35692572593689,8.44641637802124,14.167083740234375,372,82,290,290,0,9,149000.0
149,149999,21.62015126060979,36.40265574078804,0.03595386941479495,18.46737313270569,8.503148794174194,14.255329132080078,372,82,290,290,0,9,150000.0
150,150999,21.61228666941798,36.37470594537315,0.03586543847036783,18.58249258995056,8.559881925582886,14.379154205322266,372,82,290,290,0,9,151000.0
151,151999,21.598501132344875,36.33310707948721,0.035669083195485674,18.722335815429688,8.616849660873413,14.471038818359375,372,82,290,290,0,9,152000.0
152,152999,21.584115180121827,36.28945908237711,0.03562349718411828,18.924005031585693,8.673749923706055,14.529300689697266,372,82,290,290,0,9,153000.0
153,153999,21.57436205049194,36.24280442473603,0.03573745836779729,19.066015243530273,8.729855060577393,14.60784912109375,372,82,290,290,0,9,154000.0
154,154999,21.561663633678652,36.18455968691844,0.03580871350736936,19.187229871749878,8.78699541091919,14.6986083984375,372,82,290,290,0,9,155000.0
155,155999,21.542328122682076,36.11981535406872,0.03600951451220491,19.307859420776367,8.843956232070923,14.77334213256836,372,82,290,290,0,9,156000.0
156,156999,21.526574565904955,36.066532630956786,0.03618001526600367,19.438377857208252,8.900791883468628,14.86761474609375,372,82,290,290,0,9,157000.0
157,157999,21.50923934196913,36.02581946074552,0.03626830478071075,19.57289171218872,8.958667993545532,14.85329818725586,373,83,290,290,0,9,158000.0
158,158999,21.480468723807558,35.96195624269602,0.036322692648571686,19.6905415058136,9.014745712280273,14.940670013427734,373,83,290,290,0,9,159000.0
159,159999,21.4557912624829,35.900429394568455,0.036239557909820475,19.79962730407715,9.072598695755005,15.893749237060547,383,84,299,299,0,9,160000.0
160,160999,21.420205393792255,35.828502647545974,0.036271395871805834,19.908711433410645,9.12984848022461,16.187782287597656,392,85,307,307,0,9,161000.0
161,161999,21.377988374853697,35.75267583289818,0.03641244452908299,20.020315408706665,9.187501430511475,16.458751678466797,392,85,307,307,0,9,162000.0
162,162999,21.339538170610137,35.68379958468673,0.036405546000374156,20.130051851272583,9.2441725730896,16.646343231201172,392,85,307,307,0,9,163000.0
163,163999,21.302607923432575,35.63375552631562,0.036540852234295707,20.2578022480011,9.301370620727539,16.72150421142578,403,87,316,316,0,9,164000.0
164,164999,21.25587466092219,35.552363519971394,0.0368493456115192,20.388529300689697,9.35755181312561,16.906871795654297,403,87,316,316,0,9,165000.0
165,165999,21.222001166601093,35.49223374491062,0.03709450856720942,20.507386922836304,9.413618803024292,17.022010803222656,403,87,316,316,0,9,166000.0
166,166999,21.192615098333615,35.42616252402298,0.037229351026893065,20.64098858833313,9.470661640167236,17.144290924072266,403,87,316,316,0,9,167000.0
167,167999,21.15744168248188,35.37415731446247,0.03744267974448312,20.75423550605774,9.527376651763916,17.2247314453125,403,87,316,316,0,9,168000.0
168,168999,21.1294836593764,35.321918164549565,0.03760006438950991,20.861714601516724,9.584211111068726,17.311416625976562,403,87,316,316,0,9,169000.0
169,169999,21.1150825944952,35.35811138226901,0.03730599657939171,20.99784755706787,9.641145467758179,17.311256408691406,405,88,317,317,0,9,170000.0
170,170999,21.103306473097582,35.353668153276594,0.03724114402465328,21.125856161117554,9.69848895072937,17.34735107421875,414,89,325,325,0,9,171000.0
171,171999,21.095366418247576,35.34707181177693,0.037006623220536605,21.255431175231934,9.755779504776001,17.4036865234375,414,89,325,325,0,9,172000.0
172,172999,21.089951343401403,35.347958798815256,0.03697677852994807,21.374213218688965,9.812575101852417,17.483951568603516,414,89,325,325,0,9,173000.0
173,173999,21.08633019740548,35.33710422982911,0.036966737309648834,21.49895977973938,9.869635820388794,17.511699676513672,416,90,326,326,0,9,174000.0
174,174999,21.088188269693564,35.33605362111256,0.03692756017080323,21.642653226852417,9.92562747001648,17.570789337158203,416,90,326,326,0,9,175000.0
175,175999,21.093211373818214,35.34147155620795,0.03687895649360451,21.760529279708862,9.982664823532104,17.63705825805664,416,90,326,326,0,9,176000.0
176,176999,21.09720070498166,35.34675408604327,0.03682661864700154,21.88032078742981,10.039572477340698,17.69521713256836,416,90,326,326,0,9,177000.0
177,177999,21.093188628242423,35.32942114015629,0.03685985336391884,22.011624336242676,10.096590757369995,17.75045394897461,416,90,326,326,0,9,178000.0
178,178999,21.073188133803583,35.284996796683984,0.03696809464056394,22.127596378326416,10.15324854850769,17.83856201171875,416,90,326,326,0,9,179000.0
179,179999,21.04870912836504,35.252658831957085,0.03707839295841886,22.235496759414673,10.210680484771729,18.791942596435547,422,90,332,332,0,9,180000.0
180,180999,21.013994055180873,35.18883328896851,0.03727676072181285,22.34166693687439,10.267724752426147,18.981548309326172,424,91,333,333,0,9,181000.0
181,181999,20.96952920287061,35.114798882529115,0.03763949507119535,22.45817542076111,10.325013160705566,19.222156524658203,426,92,334,334,0,9,182000.0
182,182999,20.92801400593261,35.052968502930746,0.03779449553707237,22.553622245788574,10.38092303276062,19.44464111328125,426,92,334,334,0,9,183000.0
183,183999,20.89052054807465,34.999982682538764,0.03802523096485899,22.675499200820923,10.43730354309082,19.63418197631836,426,92,334,334,0,9,184000.0
184,184999,20.848424484941223,34.93149158229585,0.0383526350697625,22.798074960708618,10.494489669799805,19.79537582397461,426,92,334,334,0,9,185000.0
185,185999,20.80825410162118,34.863328019331774,0.038726761212597216,22.92452049255371,10.551444053649902,19.855152130126953,428,93,335,335,0,9,186000.0
186,186999,20.765142007199415,34.79345538380905,0.039124669964790804,23.047584056854248,10.609509706497192,19.979984283447266,428,93,335,335,0,9,187000.0
187,187999,20.7217892825191,34.727631167742075,0.03949495375015433,23.178605556488037,10.666404008865356,19.82769775390625,440,95,345,345,0,9,188000.0
188,188999,20.685030991037756,34.67403729561254,0.03978204698287735,23.294657468795776,10.72400975227356,19.975635528564453,440,95,345,345,0,9,189000.0
189,189999,20.644876021337726,34.63734311466919,0.039898077146205635,23.41899538040161,10.780805826187134,19.996051788330078,442,96,346,346,0,9,190000.0
190,190999,20.603093734629322,34.573706709247844,0.040060413389575444,23.56902050971985,10.844584941864014,20.11669158935547,442,96,346,346,0,9,191000.0
191,191999,20.56858621306543,34.53864003831946,0.040079429803986266,23.693241596221924,10.907720565795898,20.17157745361328,442,96,346,346,0,9,192000.0
192,192999,20.53455638647581,34.49480283654286,0.04017844585361141,23.810386896133423,10.966448783874512,20.262435913085938,442,96,346,346,0,9,193000.0
193,193999,20.50782602989035,34.45612160783491,0.04025515445913186,23.943015098571777,11.024037837982178,20.301292419433594,444,97,347,347,0,9,194000.0
194,194999,20.482215212637346,34.41697556271079,0.04024603578973973,24.08537244796753,11.081838130950928,20.355262756347656,444,97,347,347,0,9,195000.0
195,195999,20.472428256485394,34.40222218800351,0.040029711641900834,24.19979453086853,11.139887809753418,20.438453674316406,444,97,347,347,0,9,196000.0
196,196999,20.456132415946257,34.3740048405475,0.039916036782714825,24.329431533813477,11.197205066680908,20.500091552734375,444,97,347,347,0,9,197000.0
197,197999,20.442125658334263,34.35271373571095,0.03979243263598964,24.44925594329834,11.255022764205933,20.55624771118164,444,97,347,347,0,9,198000.0
198,198999,20.419798548920408,34.3178078156167,0.039878458778366044,24.570817708969116,11.312604427337646,20.625232696533203,444,97,347,347,0,9,199000.0
199,199999,20.428447040314182,34.298106514089966,0.03890246527190078,24.69539165496826,11.371755838394165,21.469066619873047,451,97,354,354,0,9,200000.0
200,200999,20.426803006700542,34.27879881790287,0.038359508722615177,24.81131362915039,11.43019962310791,21.62322998046875,455,99,356,356,0,9,201000.0
201,201999,20.409523327520002,34.24203847169991,0.03791294916731802,25.039212703704834,11.490888357162476,21.74075698852539,459,101,358,358,0,9,202000.0
202,202999,20.39972953830993,34.22888154353963,0.037352870039272124,25.156164407730103,11.54904818534851,22.00058364868164,459,101,358,358,0,9,203000.0
203,203999,20.377390703271654,34.18139982996595,0.03739384570625515,25.2857084274292,11.607249975204468,22.09526824951172,461,102,359,359,0,9,204000.0
204,204999,20.35565705999634,34.140595492370984,0.037677216295563754,25.41590189933777,11.667170524597168,22.136314392089844,474,104,370,370,0,9,205000.0
205,205999,20.336564186855895,34.102712276063684,0.03771138572761934,25.548341989517212,11.726285934448242,22.293941497802734,474,104,370,370,0,9,206000.0
206,206999,20.313093562124127,34.06269047009782,0.03815624203226842,25.67110514640808,11.784818410873413,22.400985717773438,476,105,371,371,0,10,207000.0
207,207999,20.294824695313515,34.0418482641443,0.03891487968981944,25.800331354141235,11.84492015838623,22.538013458251953,476,105,371,371,0,10,208000.0
208,208999,20.273658453072567,34.001684363848916,0.03902816745616078,25.922273635864258,11.903845310211182,22.625747680664062,476,105,371,371,0,10,209000.0
209,209999,20.262187686172247,33.97565964463227,0.039957849117992716,26.0546133518219,11.963918209075928,22.569660186767578,480,107,373,373,0,10,210000.0
210,210999,20.252417799855763,33.99385463513565,0.040078125959269295,26.199737787246704,12.029981851577759,22.60733413696289,482,108,374,374,0,10,211000.0
211,211999,20.238163600487123,33.963358081504126,0.040849540638666304,26.324077129364014,12.093406915664673,22.735946655273438,482,108,374,374,0,10,212000.0
212,212999,20.235501316079887,33.969050457842364,0.04109434914550647,26.45548701286316,12.152719497680664,22.846431732177734,482,108,374,374,0,10,213000.0
213,213999,20.23393760905936,33.98186943658362,0.04125855055661387,26.57118248939514,12.210522413253784,22.906848907470703,482,108,374,374,0,10,214000.0
214,214999,20.247433771354643,34.01830426379153,0.04172214544637387,26.710589170455933,12.269084692001343,23.005260467529297,482,108,374,374,0,10,215000.0
215,215999,20.263409479493987,34.05420833765966,0.04172429194599869,26.83936905860901,12.327604293823242,23.079425811767578,482,108,374,374,0,10,216000.0
216,216999,20.27840091340514,34.082440860911646,0.04211612952568078,26.993510723114014,12.389493703842163,23.0242919921875,486,110,376,376,0,10,217000.0
217,217999,20.29006164210319,34.1006403903654,0.04267084513003805,27.123175859451294,12.451082229614258,23.04798126220703,497,111,386,386,0,10,218000.0
218,218999,20.312800395179146,34.1414417356738,0.04267894289774454,27.253481149673462,12.522027015686035,23.142601013183594,497,111,386,386,0,10,219000.0
219,219999,20.31409395350369,34.12631432710665,0.04226927052382934,27.402393102645874,12.5807626247406,23.614723205566406,503,111,392,392,0,10,220000.0
220,220999,20.325213801314504,34.1262767411863,0.04099988800778165,27.51811909675598,12.640551805496216,24.191577911376953,506,111,395,395,0,10,221000.0
221,221999,20.3195789905837,34.10754922303032,0.04018250511961796,27.62806725502014,12.699033498764038,24.425090789794922,508,112,396,396,0,10,222000.0
222,222999,20.319136549800092,34.08280094801959,0.039218197963589385,27.747108697891235,12.757726192474365,24.542678833007812,510,113,397,397,0,10,223000.0
223,223999,20.318707984157374,34.07860629606096,0.038662871613118766,27.86514115333557,12.816359996795654,24.78974151611328,510,113,397,397,0,10,224000.0
224,224999,20.317049962342033,34.061586460994,0.0382618950153123,27.98326325416565,12.875707149505615,24.985950469970703,510,113,397,397,0,10,225000.0
225,225999,20.32284178260701,34.044398078388305,0.037660842067374745,28.110039710998535,12.93383502960205,25.131168365478516,510,113,397,397,0,10,226000.0
226,226999,20.328221801623126,34.042473317740935,0.037235304063514385,28.23416018486023,12.992387771606445,25.25659942626953,510,113,397,397,0,10,227000.0
227,227999,20.339155633937608,34.04489554159348,0.03670078112465802,28.3657705783844,13.051291227340698,25.274028778076172,512,114,398,398,0,10,228000.0
228,228999,20.35380371786838,34.068761129902626,0.0364119856736147,28.484620809555054,13.110235929489136,25.287799835205078,526,116,410,410,0,10,229000.0
229,229999,20.361430971157137,34.08856352233174,0.03639538960515554,28.627379655838013,13.169514894485474,25.209571838378906,530,118,412,412,0,10,230000.0
230,230999,20.38226290879361,34.13369504886971,0.03632070477578031,28.75649619102478,13.229013919830322,25.22696304321289,534,120,414,414,0,10,231000.0
231,231999,20.402547260579656,34.16599833204145,0.03630393786413744,28.877944707870483,13.288413286209106,25.359210968017578,534,120,414,414,0,10,232000.0
232,232999,20.432276101168615,34.23533954980604,0.036223306040888525,29.008213758468628,13.346831798553467,25.438209533691406,534,120,414,414,0,10,233000.0
233,233999,20.470647382649283,34.32435050894717,0.03667308007080439,29.138101816177368,13.411107301712036,25.44727325439453,536,121,415,415,0,10,234000.0
234,234999,20.51496020302844,34.460905244717104,0.0371393813421218,29.271589994430542,13.470210552215576,25.53966522216797,536,121,415,415,0,10,235000.0
235,235999,20.562397567910676,34.606034009972156,0.03752992627488372,29.400525331497192,13.529680013656616,25.634532928466797,536,121,415,415,0,10,236000.0
236,236999,20.619603438279245,34.768166223673845,0.0384445679185198,29.539203643798828,13.58975887298584,25.630970001220703,538,122,416,416,0,10,237000.0
237,237999,20.656737443103196,34.83296313661062,0.039324966388171956,29.665902137756348,13.649020195007324,25.714889526367188,538,122,416,416,0,10,238000.0
238,238999,20.688146264080846,34.88240539821445,0.040300299766638736,29.79321789741516,13.711598634719849,25.786762237548828,538,122,416,416,0,10,239000.0
239,239999,20.69597258690721,34.91066319806953,0.040120922428448114,29.920552730560303,13.771949052810669,26.309032440185547,545,122,423,423,0,10,240000.0
240,240999,20.68161240520738,34.902660710410686,0.04000797607601658,30.038349151611328,13.832146167755127,26.78176498413086,547,122,425,425,0,10,241000.0
241,241999,20.667096127046403,34.87373949322718,0.040059134186383294,30.164432287216187,13.891807079315186,27.05410385131836,548,122,426,426,0,10,242000.0
242,242999,20.65182091034285,34.8644925922178,0.04008115537975876,30.292235851287842,13.95121693611145,27.125988006591797,550,123,427,427,0,10,243000.0
243,243999,20.636924899726047,34.842046166199495,0.040152592650402275,30.422171592712402,14.009716510772705,27.195343017578125,552,124,428,428,0,10,244000.0
244,244999,20.62273523728879,34.81572859900417,0.040074819913623605,30.532607316970825,14.07211709022522,27.317668914794922,552,124,428,428,0,10,245000.0
245,245999,20.607692448064586,34.78823772135191,0.04015218037135393,30.67737603187561,14.13266372680664,27.442745208740234,552,124,428,428,0,10,246000.0
246,246999,20.59527346596573,34.77774254543284,0.040124621883199985,30.82186269760132,14.193040370941162,27.459774017333984,554,125,429,429,0,10,247000.0
247,247999,20.586106504907754,34.75997331203089,0.040069973912243206,30.93827199935913,14.252825021743774,27.58127212524414,554,125,429,429,0,10,248000.0
248,248999,20.579324550505074,34.74698792439259,0.03998412473339319,31.066447734832764,14.31190538406372,27.602066040039062,556,126,430,430,0,10,249000.0
249,249999,20.5700069476518,34.727884598688284,0.040022177245650825,31.211714029312134,14.372817039489746,27.443775177001953,562,129,433,433,0,10,250000.0
250,250999,20.56521169769053,34.714712672292855,0.040073115985922225,31.32597804069519,14.432282209396362,27.584369659423828,562,129,433,433,0,10,251000.0
251,251999,20.557258657699666,34.697012724738336,0.040170475219497126,31.471529245376587,14.493038892745972,27.54395294189453,566,131,435,435,0,10,252000.0
252,252999,20.555721001834176,34.68231248175825,0.040222587035343205,31.623435497283936,14.553704023361206,27.548439025878906,568,132,436,436,0,10,253000.0
253,253999,20.547411399046155,34.660172552990716,0.04041291390234225,31.747127294540405,14.61357069015503,27.687122344970703,568,132,436,436,0,10,254000.0
254,254999,20.542011595448415,34.64443558778245,0.04057792115437764,31.872644186019897,14.674124717712402,27.780200958251953,568,132,436,436,0,10,255000.0
255,255999,20.530393636275143,34.61588076518486,0.04058478186911796,32.00153684616089,14.862848281860352,28.283252716064453,576,132,444,444,0,10,256000.0
256,256999,20.526300506793405,34.617532440906224,0.04034825327308522,32.13765573501587,14.923038721084595,28.50916290283203,591,133,458,458,0,10,257000.0
257,257999,20.531378204452206,34.61952234031116,0.0400551646814693,32.27198266983032,14.982442378997803,28.597076416015625,593,134,459,459,0,10,258000.0
258,258999,20.53243542657557,34.61360883818267,0.039832297720828636,32.38378858566284,15.041393518447876,28.75882339477539,595,135,460,460,0,10,259000.0
259,259999,20.535069913589147,34.60588708292866,0.039557018567131674,32.531275510787964,15.104336500167847,28.78451156616211,597,136,461,461,0,10,260000.0
260,260999,20.547714348261035,34.64608915609177,0.03949707593340823,32.65529179573059,15.164947271347046,28.799114227294922,599,137,462,462,0,10,261000.0
261,261999,20.555206514519057,34.667188588428715,0.03947926799299628,32.78982472419739,15.225815534591675,28.719676971435547,603,139,464,464,0,10,262000.0
262,262999,20.561611372700256,34.679000579920185,0.03954956019840272,32.9282488822937,15.287182092666626,28.753192901611328,605,140,465,465,0,10,263000.0
263,263999,20.57388227426237,34.69650393462525,0.039749314224905796,33.068848609924316,15.348543405532837,28.72309112548828,609,142,467,467,0,10,264000.0
264,264999,20.591948556305624,34.72230219534685,0.040206053541645526,33.19581174850464,15.408984661102295,28.751441955566406,611,143,468,468,0,10,265000.0
265,265999,20.613517538889543,34.788763941267675,0.04042540874458811,33.3365740776062,15.471787691116333,28.756237030029297,613,144,469,469,0,10,266000.0
266,266999,20.62865391127702,34.8065892992471,0.04094660042961795,33.48727583885193,15.544200897216797,28.71904754638672,617,146,471,471,0,10,267000.0
267,267999,20.643617666309154,34.82003140504244,0.04149137978172435,33.62994980812073,15.604410886764526,28.770530700683594,626,147,479,479,0,10,268000.0
268,268999,20.65995064604745,34.83894704352168,0.042188345064266164,33.77275204658508,15.665654182434082,28.83319854736328,628,148,480,480,0,10,269000.0
269,269999,20.67640179634018,34.85523634813736,0.04287152287620133,33.91129803657532,15.737096071243286,28.883563995361328,630,149,481,481,0,10,270000.0
270,270999,20.714016302705566,34.928763953352494,0.04378710987059309,34.04436731338501,15.798188924789429,28.936660766601562,632,150,482,482,0,10,271000.0
271,271999,20.72822959587678,34.93743671268153,0.04451883465752415,34.173813343048096,15.858412742614746,29.051158905029297,632,150,482,482,0,10,272000.0
272,272999,20.742644104533785,34.94078312538426,0.0451510721969155,34.30854368209839,15.91875958442688,29.14657211303711,632,150,482,482,0,10,273000.0
273,273999,20.752349865011478,34.99656978154593,0.04483180513943963,34.430745124816895,15.977973461151123,29.532306671142578,641,150,491,491,0,10,274000.0
274,274999,20.76727986511021,35.057832046381705,0.04461832743386629,34.563847064971924,16.03681993484497,29.500816345214844,647,152,495,495,0,10,275000.0
275,275999,20.776242609066333,35.1273848815743,0.044714240882491874,34.68876099586487,16.096006870269775,29.66922378540039,647,152,495,495,0,10,276000.0
276,276999,20.789229610790716,35.153498584167465,0.04461568257122028,34.821428060531616,16.155147790908813,29.79206085205078,647,152,495,495,0,10,277000.0
277,277999,20.803480617878172,35.18119009860631,0.04457999059438422,34.951653718948364,16.21488332748413,29.789329528808594,649,153,496,496,0,10,278000.0
278,278999,20.823505295848985,35.22394489868929,0.04497539163352826,35.10633850097656,16.274358987808228,29.650386810302734,653,155,498,498,0,10,279000.0
279,279999,20.842492617856706,35.25144491630107,0.04536854599250395,35.230737924575806,16.33850383758545,29.67705535888672,655,156,499,499,0,10,280000.0
280,280999,20.864782120012986,35.28142090163016,0.04615382209523322,35.34972882270813,16.397446632385254,29.834285736083984,655,156,499,499,0,10,281000.0
281,281999,20.89142303558975,35.348701320236074,0.04715341505058379,35.48532223701477,16.46357822418213,29.94396209716797,655,156,499,499,0,10,282000.0
282,282999,20.922374116833748,35.419838009382104,0.04818408550420761,35.62526321411133,16.523690700531006,30.01844024658203,655,156,499,499,0,10,283000.0
283,283999,20.957105047324056,35.48322314760447,0.04985638456742458,35.76902532577515,16.581724643707275,30.047077178955078,657,157,500,500,0,10,284000.0
284,284999,20.99439758693957,35.55074338691507,0.05139976188140971,35.899115800857544,16.644511461257935,30.003765106201172,661,159,502,502,0,10,285000.0
285,285999,21.0263789791829,35.58699644081743,0.05317494454799632,36.0392689704895,16.7128324508667,29.87234878540039,665,161,504,504,0,10,286000.0
286,286999,21.07230134101883,35.67014435594027,0.05529038436550138,36.17462491989136,16.772940158843994,29.934921264648438,667,162,505,505,0,10,287000.0
287,287999,21.110234463449274,35.72501252757934,0.057186298935544166,36.32471513748169,16.835214614868164,29.9449462890625,669,163,506,506,0,10,288000.0
288,288999,21.15412179393786,35.81905682252743,0.05973658842081153,36.4512152671814,16.89718747138977,29.972644805908203,671,164,507,507,0,10,289000.0
289,289999,21.204882905437714,35.902166437841544,0.06315141744047359,36.5801739692688,16.958812952041626,29.946392059326172,675,166,509,509,0,10,290000.0
290,290999,21.255239821515463,35.98815463866337,0.06579634699977921,36.715338945388794,17.018949270248413,29.913101196289062,679,168,511,511,0,10,291000.0
291,291999,21.30183016628911,36.05487019300526,0.06832852387440391,36.85983967781067,17.077539920806885,30.02927017211914,679,168,511,511,0,10,292000.0
292,292999,21.332849064347517,36.106512563262,0.06878985419589134,36.973687171936035,17.13708257675171,30.31757354736328,685,168,517,517,0,10,293000.0
293,293999,21.333865242365686,36.14003633612411,0.06809378108308606,37.12445855140686,17.19939422607422,30.499710083007812,692,169,523,523,0,10,294000.0
294,294999,21.325662681542667,36.14319892277204,0.06779102505485213,37.24419951438904,17.26120352745056,30.676746368408203,695,170,525,525,0,10,295000.0
295,295999,21.321308465325558,36.14245144039021,0.06742687303275963,37.38636136054993,17.320386171340942,30.8170166015625,695,170,525,525,0,10,296000.0
296,296999,21.318928849619137,36.13670917053418,0.06723059561229716,37.52675008773804,17.380094289779663,30.673561096191406,698,172,526,526,0,10,297000.0
297,297999,21.31527172732519,36.123330266258606,0.06727045366984008,37.66118311882019,17.439419984817505,30.806121826171875,698,172,526,526,0,10,298000.0
298,298999,21.31348695955706,36.11777581463971,0.06715849317406897,37.77560210227966,17.49663472175598,30.889842987060547,698,172,526,526,0,10,299000.0
299,299999,21.31038964340789,36.10551954722996,0.06701367551720083,37.89412832260132,17.55386996269226,30.933597564697266,700,173,527,527,0,10,300000.0
300,300999,21.306799930369596,36.08880328209904,0.06676433736482801,38.018418073654175,17.61476421356201,31.047103881835938,700,173,527,527,0,10,301000.0
301,301999,21.305650447518268,36.08000466577597,0.06657632235731248,38.17827391624451,17.67714285850525,30.993148803710938,702,174,528,528,0,10,302000.0
302,302999,21.304402607332758,36.06712091252015,0.06632470491182973,38.31061840057373,17.739781618118286,31.101337432861328,702,174,528,528,0,10,303000.0
303,303999,21.30111909230947,36.05072922352686,0.0661227411716736,38.47650909423828,17.805341958999634,31.093109130859375,704,175,529,529,0,10,304000.0
304,304999,21.301594282212722,36.04367392442845,0.06605773168432916,38.622737407684326,17.872103929519653,31.08203887939453,706,176,530,530,0,10,305000.0
305,305999,21.299758158850366,36.03320415929859,0.06604309154531784,38.728758573532104,17.929686784744263,31.172405242919922,706,176,530,530,0,10,306000.0
306,306999,21.297683801856518,36.01791293241774,0.06619322006089312,38.87392783164978,17.989974975585938,31.072433471679688,710,178,532,532,0,10,307000.0
307,307999,21.29965559490571,36.01311512778392,0.06637086339738363,39.007081031799316,18.04922366142273,31.168678283691406,710,178,532,532,0,10,308000.0
308,308999,21.31004423516717,36.04205059353088,0.06682945963362508,39.13902831077576,18.109252214431763,31.25054168701172,710,178,532,532,0,10,309000.0
309,309999,21.323983592107975,36.09362826468394,0.06729240761378474,39.26613450050354,18.168978929519653,31.25658416748047,712,179,533,533,0,10,310000.0
310,310999,21.326360036550934,36.106464459969814,0.06759170055359287,39.393200635910034,18.228466033935547,31.339008331298828,712,179,533,533,0,10,311000.0
311,311999,21.327278164922404,36.124818371048065,0.06805434952642986,39.534634828567505,18.287312269210815,31.362892150878906,714,180,534,534,0,10,312000.0
312,312999,21.320947465508468,36.16375939896846,0.06777437121363072,39.6678147315979,18.34864902496338,31.987777709960938,729,180,549,549,0,10,313000.0
313,313999,21.309156188526885,36.16959491738924,0.0676417834301487,39.77794885635376,18.408355474472046,32.247230529785156,730,180,550,550,0,10,314000.0
314,314999,21.31420529249084,36.206925497381874,0.06766333215867115,39.914552211761475,18.467577934265137,32.29983139038086,736,183,553,553,0,10,315000.0
315,315999,21.312717026639145,36.231393085150174,0.06770693175359044,40.04756474494934,18.526261568069458,32.481056213378906,738,184,554,554,0,10,316000.0
316,316999,21.310598464141876,36.24537758219241,0.06813727134393854,40.17709493637085,18.74018168449402,32.64055252075195,738,184,554,554,0,10,317000.0
317,317999,21.304670837934808,36.245835035900136,0.06885617378699482,40.30280780792236,18.80006456375122,32.745201110839844,738,184,554,554,0,10,318000.0
318,318999,21.305125768149953,36.264001861036775,0.06909647345713421,40.42272925376892,18.859588623046875,32.86326599121094,738,184,554,554,0,10,319000.0
319,319999,21.30511454291534,36.27561107293698,0.06953208946791911,40.54009985923767,18.919032096862793,32.8055305480957,740,185,555,555,0,10,320000.0
320,320999,21.30431759977681,36.27630767138713,0.06984235839954045,40.67492914199829,18.978837251663208,32.89499282836914,742,186,556,556,0,10,321000.0
321,321999,21.300403600542502,36.262815625604894,0.07008288906434168,40.826661825180054,19.0401451587677,32.92942428588867,744,187,557,557,0,10,322000.0
322,322999,21.302593478949397,36.25859525235968,0.07028103715349154,40.95713210105896,19.102964162826538,32.98810577392578,746,188,558,558,0,10,323000.0
323,323999,21.305409593945537,36.294292481443854,0.07028505322789391,41.091522216796875,19.165411233901978,33.085693359375,746,188,558,558,0,10,324000.0
324,324999,21.301251912787535,36.27775480323631,0.07074420004916804,41.22520089149475,19.22835946083069,33.10132598876953,748,189,559,559,0,10,325000.0
325,325999,21.295552248996774,36.25850470120318,0.07115446818255322,41.35667943954468,19.289154767990112,33.129764556884766,750,190,560,560,0,10,326000.0
326,326999,21.295409175383785,36.25267151280078,0.07167621710090055,41.50620150566101,19.35218381881714,33.22154235839844,750,190,560,560,0,10,327000.0
327,327999,21.294047658432287,36.24259307802878,0.07205585532818592,41.62126684188843,19.4115948677063,33.3116340637207,750,190,560,560,0,10,328000.0
328,328999,21.29015098216807,36.22893692329801,0.07248451929827626,41.77536082267761,19.473888158798218,33.3707160949707,750,190,560,560,0,10,329000.0
329,329999,21.276470822295092,36.19956635107645,0.07315501477924569,41.90214681625366,19.533161163330078,33.42702865600586,750,190,560,560,0,10,330000.0
330,330999,21.263877090219136,36.17180954694202,0.07344860387666707,42.02390694618225,19.591556549072266,33.45987319946289,752,191,561,561,0,10,331000.0
331,331999,21.267379660750603,36.18876780210952,0.0728797914757936,42.14745116233826,19.656012296676636,34.08295440673828,768,191,577,577,0,10,332000.0
332,332999,21.255373666434814,36.167994998573356,0.07271683857150824,42.27595138549805,19.719000101089478,34.34551239013672,769,191,578,578,0,10,333000.0
333,333999,21.24730452411616,36.151087220484904,0.07254873940626938,42.41920495033264,19.78157353401184,34.40521240234375,773,193,580,580,0,10,334000.0
334,334999,21.240841778968754,36.144824987063814,0.07241573235825238,42.57032585144043,19.84100842475891,34.59931945800781,773,193,580,580,0,10,335000.0
335,335999,21.236074282127564,36.13410057910112,0.0722659687711763,42.72890496253967,19.907346487045288,34.635929107666016,777,195,582,582,0,10,336000.0
336,336999,21.238585742532315,36.145451163663246,0.07201195963414786,42.84553360939026,19.970187187194824,34.754913330078125,777,195,582,582,0,10,337000.0
337,337999,21.236790637673632,36.13416821297566,0.0718662391262741,42.96918225288391,20.03036665916443,34.85723114013672,777,195,582,582,0,10,338000.0
338,338999,21.239462918313453,36.13380698601903,0.07169958821252176,43.0919976234436,20.09343957901001,34.87057876586914,779,196,583,583,0,10,339000.0
339,339999,21.239389938463198,36.12378938254593,0.0717534874405985,43.22600483894348,20.156265020370483,34.885292053222656,781,197,584,584,0,10,340000.0
340,340999,21.24435018530761,36.12585336482939,0.07183315497805898,43.41035008430481,20.22189736366272,34.858821868896484,784,198,586,586,0,10,341000.0
341,341999,21.252054446325754,36.13285833066443,0.07207171589713857,43.56127142906189,20.290993690490723,34.912635803222656,786,199,587,587,0,10,342000.0
342,342999,21.274556567258262,36.173735170078956,0.07226221772340113,43.67324256896973,20.35114550590515,35.02798843383789,786,199,587,587,0,10,343000.0
343,343999,21.291651823014334,36.19973536909477,0.07255129226463342,43.81913685798645,20.418007612228394,34.997833251953125,788,200,588,588,0,10,344000.0
344,344999,21.317714217865625,36.236315677360594,0.07329075337231905,43.94076704978943,20.476742029190063,35.001441955566406,791,201,590,590,0,10,345000.0
345,345999,21.343280168270123,36.276795848920806,0.07398970830880891,44.0891535282135,20.53968071937561,35.06509780883789,793,202,591,591,0,10,346000.0
346,346999,21.369885908058208,36.31255792385248,0.07475909420343274,44.21354842185974,20.599064111709595,35.06172561645508,795,203,592,592,0,10,347000.0
347,347999,21.409840962872337,36.38170666083221,0.07594601014245883,44.338297605514526,20.65861678123474,35.15462112426758,795,203,592,592,0,10,348000.0
348,348999,21.43532657906468,36.41360531343787,0.07677062406156576,44.47639775276184,20.71913456916809,35.193599700927734,797,204,593,593,0,10,349000.0
349,349999,21.466950377526405,36.454209426117295,0.07767157201343788,44.60576343536377,20.779841661453247,35.27284622192383,797,204,593,593,0,10,350000.0
350,350999,21.484002458396937,36.47783692877902,0.07819800635838126,44.754945516586304,20.84079647064209,35.122589111328125,803,207,596,596,0,10,351000.0
351,351999,21.484393212230398,36.4703586913293,0.07791033479449971,44.87119460105896,20.900697469711304,35.6965446472168,817,207,610,610,0,10,352000.0
352,352999,21.479566639983176,36.45554294395154,0.07766821198229823,45.00423002243042,20.963010549545288,35.89443588256836,822,208,614,614,0,10,353000.0
353,353999,21.471472462925945,36.43627336255521,0.07750519557432134,45.13110423088074,21.02269697189331,36.0803337097168,823,208,615,615,0,10,354000.0
354,354999,21.46536470880434,36.413941564697915,0.07731170751639649,45.2512423992157,21.082380533218384,36.19712829589844,839,209,630,630,0,10,355000.0
355,355999,21.468458757681326,36.40900354138387,0.07699824319864568,45.40962862968445,21.14331603050232,36.277976989746094,841,210,631,631,0,10,356000.0
356,356999,21.472106186557724,36.400895148589925,0.0769110777128501,45.554343700408936,21.207013845443726,36.23623275756836,848,213,635,635,0,10,357000.0
357,357999,21.472308665070376,36.38821753145392,0.07687952773905549,45.67257499694824,21.270158052444458,36.39508056640625,848,213,635,635,0,10,358000.0
358,358999,21.46987133265871,36.37291536680064,0.0768516243445806,45.79158973693848,21.332294702529907,36.53701400756836,848,213,635,635,0,10,359000.0
359,359999,21.470211347439285,36.36140236339909,0.07680177727246806,45.924529790878296,21.395666122436523,36.40159225463867,852,215,637,637,0,10,360000.0
360,360999,21.47110885476674,36.35491837290712,0.0767999633721006,46.08986234664917,21.46028423309326,36.32034683227539,861,219,642,642,0,11,361000.0
361,361999,21.474159261513257,36.348348375110305,0.07687185418835318,46.232434034347534,21.52260160446167,36.48831558227539,861,219,642,642,0,11,362000.0
362,362999,21.473293852762467,36.33740512558427,0.0768902810980896,46.37152433395386,21.58638620376587,36.62395477294922,861,219,642,642,0,11,363000.0
363,363999,21.47375702193262,36.32815273677879,0.07691728987089885,46.49042224884033,21.648167371749878,36.73724365234375,861,219,642,642,0,11,364000.0
364,364999,21.474852553309375,36.31894765447004,0.07682290241430278,46.624045610427856,21.71232533454895,36.837432861328125,861,219,642,642,0,11,365000.0
365,365999,21.47740668414388,36.31078779625888,0.07685695734607412,46.76823449134827,21.776328802108765,36.89446258544922,863,220,643,643,0,11,366000.0
366,366999,21.483438282082602,36.309839823920626,0.07683348905096743,46.90206003189087,21.839890003204346,36.97700881958008,863,220,643,643,0,11,367000.0
367,367999,21.48885198157884,36.30837526719352,0.0767973537196498,47.03939867019653,21.89976930618286,36.971309661865234,865,221,644,644,0,11,368000.0
368,368999,21.49339650657924,36.30326029785575,0.07672214412885203,47.1806743144989,21.963537454605103,37.00305938720703,867,222,645,645,0,11,369000.0
369,369999,21.495045378337686,36.293084123460645,0.07673689114364013,47.327548027038574,22.02456307411194,37.072418212890625,867,222,645,645,0,11,370000.0
370,370999,21.501537640099183,36.28595444239275,0.07669370540397313,47.43976831436157,22.08590579032898,37.18009567260742,867,222,645,645,0,11,371000.0
371,371999,21.50045073248995,36.27710175933605,0.07642971708388313,47.552573442459106,22.145793437957764,37.678043365478516,881,222,659,659,0,11,372000.0
372,372999,21.48966283475892,36.27753758628377,0.07637810444416404,47.66924262046814,22.207289218902588,38.03537368774414,884,222,662,662,0,11,373000.0
373,373999,21.47136712647766,36.251360743430524,0.07651485214854281,47.785972595214844,22.26728367805481,38.22572708129883,886,222,664,664,0,11,374000.0
374,374999,21.45233139540285,36.21959393730513,0.07660816673567006,47.91996216773987,22.32635760307312,38.35270690917969,886,222,664,664,0,11,375000.0
375,375999,21.434435911103833,36.19296121247904,0.07668461500688706,48.044092893600464,22.38617181777954,38.400230407714844,888,223,665,665,0,11,376000.0
376,376999,21.418939926101284,36.1800683586117,0.07661374878496974,48.178685665130615,22.447684288024902,38.52101516723633,888,223,665,665,0,11,377000.0
377,377999,21.403005394803145,36.16396523191296,0.07664040871010014,48.322346687316895,22.5078444480896,38.64326095581055,888,223,665,665,0,11,378000.0
378,378999,21.38381554182725,36.132575741012715,0.07673266967711301,48.42854046821594,22.567725658416748,38.730289459228516,888,223,665,665,0,11,379000.0
379,379999,21.368036036562188,36.10593949695995,0.07677732616260247,48.56344437599182,22.627599239349365,38.75817108154297,892,225,667,667,0,11,380000.0
380,380999,21.35740777762677,36.09481438113835,0.07678697910614052,48.68774437904358,22.68749165534973,38.86161804199219,892,225,667,667,0,11,381000.0
381,381999,21.341658100775692,36.06971271917256,0.07692002632610562,48.8479266166687,22.748886823654175,38.782039642333984,896,227,669,669,0,11,382000.0
382,382999,21.330729434519483,36.07039265820763,0.0770203039082108,48.9839985370636,22.81209421157837,38.828033447265625,898,228,670,670,0,11,383000.0
383,383999,21.317553883561,36.047622770024894,0.07711400236006105,49.116408824920654,22.87225079536438,38.939971923828125,898,228,670,670,0,11,384000.0
384,384999,21.304820000662637,36.02282268926577,0.077247536502974,49.25697350502014,22.93430471420288,39.01362991333008,898,228,670,670,0,11,385000.0
385,385999,21.29100140627291,35.99582445955952,0.07734249749430844,49.37619638442993,22.99461269378662,39.118595123291016,898,228,670,670,0,11,386000.0
386,386999,21.275650725784665,35.970386027822066,0.07749300571558859,49.51949143409729,23.0555899143219,38.947288513183594,904,230,674,674,0,11,387000.0
387,387999,21.258644143345805,35.942688509629,0.07761528240891724,49.639872550964355,23.115954399108887,39.0654296875,904,230,674,674,0,11,388000.0
388,388999,21.257285404160278,35.97762084621983,0.07740417422501378,49.954381704330444,23.177517414093018,39.83306121826172,925,230,695,695,0,11,389000.0
389,389999,21.25525146523169,35.98350826503316,0.07736266369024547,50.10142230987549,23.245025873184204,40.10429763793945,929,231,698,698,0,11,390000.0
390,390999,21.251907221792347,35.97708196593061,0.07734140218637375,50.227582693099976,23.311081886291504,40.38856506347656,931,231,700,700,0,11,391000.0
391,391999,21.258632405658197,35.99115011449547,0.07734484633312078,50.35041046142578,23.371400356292725,40.52033233642578,937,233,704,704,0,11,392000.0
392,392999,21.272099053860572,36.025070316726776,0.07741003226295173,50.49390888214111,23.43521499633789,40.65325927734375,943,236,707,707,0,11,393000.0
393,393999,21.291244913270365,36.075238208608155,0.07796873235120072,50.61804389953613,23.499826669692993,40.91001510620117,943,236,707,707,0,11,394000.0
394,394999,21.316272370228138,36.1340985323601,0.07854392965292467,50.74012613296509,23.561370611190796,41.11476135253906,943,236,707,707,0,11,395000.0
395,395999,21.33914675037551,36.18727679123631,0.07913286006099784,50.89142322540283,23.623821258544922,41.019065856933594,954,241,713,713,0,11,396000.0
396,396999,21.365707200053926,36.24368762388614,0.08000263614205194,51.017218828201294,23.683677434921265,41.13813781738281,956,242,714,714,0,11,397000.0
397,397999,21.4003717000574,36.32016343218011,0.08148403503907597,51.16232085227966,23.745640993118286,41.07611846923828,965,246,719,719,0,11,398000.0
398,398999,21.430259411638275,36.376189985121215,0.08261683310186918,51.29834842681885,23.807775497436523,41.228904724121094,969,248,721,721,0,11,399000.0
399,399999,21.467061316223322,36.47313009875815,0.08335434838255418,51.42411541938782,23.870505571365356,41.41386795043945,969,248,721,721,0,11,400000.0
400,400999,21.503703695305244,36.53786549317658,0.08427592146970442,51.55412578582764,23.931296348571777,41.460662841796875,972,249,723,723,0,11,401000.0
401,401999,21.540936527234276,36.599550442479355,0.08560563401926502,51.684401988983154,23.9928719997406,41.652488708496094,972,249,723,723,0,11,402000.0
402,402999,21.581168004991333,36.68785483795142,0.0866465515202991,51.82889008522034,24.05549645423889,41.59525680541992,979,252,727,727,0,11,403000.0
403,403999,21.618818237578935,36.74442906790098,0.08855459698064638,51.95755195617676,24.118006229400635,41.76737976074219,979,252,727,727,0,11,404000.0
404,404999,21.656802360184784,36.807857518451314,0.09046171022675764,52.077914237976074,24.17835021018982,41.929630279541016,979,252,727,727,0,11,405000.0
405,405999,21.68508788206171,36.84002230253463,0.09172672874696453,52.214765310287476,24.238656997680664,42.07331085205078,979,252,727,727,0,11,406000.0
406,406999,21.698750267546483,36.85075938916462,0.09237703675123754,52.34473395347595,24.3028085231781,42.80817794799805,999,252,747,747,0,11,407000.0
407,407999,21.69764044329393,36.86460979167248,0.09204392791465954,52.45290780067444,24.36670708656311,43.4813232421875,1005,252,753,753,0,11,408000.0
408,408999,21.697246570849337,36.89174228993283,0.09189589115736618,52.57063603401184,24.429263591766357,43.80928421020508,1008,253,755,755,0,11,409000.0
409,409999,21.69661340284597,36.89772590038643,0.09175474774326597,52.69527530670166,24.488309144973755,43.97250747680664,1012,255,757,757,0,11,410000.0
410,410999,21.69712732626454,36.90220394124437,0.0916592955766703,52.81151843070984,24.551019191741943,44.22344207763672,1012,255,757,757,0,11,411000.0
411,411999,21.696059050130977,36.900303418797805,0.09152179754979217,52.94467735290527,24.61277723312378,44.295440673828125,1016,257,759,759,0,11,412000.0
412,412999,21.693999298583197,36.892757538567636,0.09148106699493064,53.07933044433594,24.67280340194702,44.275028228759766,1024,261,763,763,0,11,413000.0
413,413999,21.692009088894117,36.88141404612581,0.09140951310729317,53.20225143432617,24.73416495323181,44.477298736572266,1026,262,764,764,0,11,414000.0
414,414999,21.692534536919386,36.87045522894275,0.09128953404929818,53.336572885513306,24.794620990753174,44.57593536376953,1032,265,767,767,0,11,415000.0
415,415999,21.69181324680389,36.86123307946774,0.09129133916110999,53.471129417419434,24.8560049533844,44.688575744628906,1036,267,769,769,0,11,416000.0
416,416999,21.68996258496225,36.85551934625235,0.09118951304489475,53.60528588294983,24.923710346221924,44.8713493347168,1038,268,770,770,0,11,417000.0
417,417999,21.687470859694066,36.842475350312704,0.09115013434426766,53.76212239265442,24.98792266845703,44.73044967651367,1047,271,776,776,0,11,418000.0
418,418999,21.685594228691404,36.8277485718001,0.09105754042783565,53.8876678943634,25.049139738082886,44.934085845947266,1047,271,776,776,0,11,419000.0
419,419999,21.685538129871635,36.818174376023805,0.09108356578539933,54.011638164520264,25.110084772109985,45.06364822387695,1047,271,776,776,0,11,420000.0
420,420999,21.686437075261374,36.84854590223305,0.09084347137185189,54.133893966674805,25.171030282974243,45.15906524658203,1049,272,777,777,0,11,421000.0
421,421999,21.689607379344903,36.86613105555585,0.09067766075670824,54.25845289230347,25.239396810531616,45.335567474365234,1049,272,777,777,0,11,422000.0
422,422999,21.690935539178195,36.85825377455771,0.09064753822241656,54.402172565460205,25.299120664596558,45.41762924194336,1051,273,778,778,0,11,423000.0
423,423999,21.686621756492386,36.83983044926477,0.09066087257414979,54.524375677108765,25.359458923339844,45.53853988647461,1051,273,778,778,0,11,424000.0
424,424999,21.684424930336057,36.825707396761096,0.09065666159849106,54.67553091049194,25.42295813560486,45.60078430175781,1053,274,779,779,0,11,425000.0
425,425999,21.681711407455563,36.81093187417169,0.09064172915770663,54.800445795059204,25.4863703250885,45.7493896484375,1053,274,779,779,0,11,426000.0
426,426999,21.672930121972122,36.78651457703586,0.09059770211811968,54.91110706329346,25.547966718673706,45.92756652832031,1053,274,779,779,0,11,427000.0
427,427999,21.65780894967747,36.763626256821475,0.09059253362921671,55.04218912124634,25.610953330993652,46.573463439941406,1073,275,798,798,0,11,428000.0
428,428999,21.638415222809904,36.735069767546754,0.09070121982694546,55.155049562454224,25.671363353729248,46.831390380859375,1074,275,799,799,0,11,429000.0
429,429999,21.621971313557914,36.7129887664886,0.0907535447101111,55.29404020309448,25.733126401901245,46.975128173828125,1078,277,801,801,0,11,430000.0
430,430999,21.60305013890104,36.6850731125453,0.09083449469684757,55.41354322433472,25.792486429214478,47.00598907470703,1083,279,804,804,0,11,431000.0
431,431999,21.585870690571202,36.65660322844233,0.09090959016992717,55.558457374572754,25.85171365737915,46.925411224365234,1088,281,807,807,0,11,432000.0
432,432999,21.56993292125456,36.63783412539537,0.09092143542175712,55.70919466018677,25.914451837539673,46.99168014526367,1092,283,809,809,0,11,433000.0
433,433999,21.550049603964393,36.60787160359418,0.0910276358988732,55.84104776382446,25.97736144065857,47.14323425292969,1094,284,810,810,0,11,434000.0
434,434999,21.532396495118206,36.58007574948401,0.09112277841594174,55.966721296310425,26.03725814819336,47.282066345214844,1094,284,810,810,0,11,435000.0
435,435999,21.51397490017214,36.55135520745194,0.09124740097249107,56.09431433677673,26.100432872772217,47.414268493652344,1094,284,810,810,0,11,436000.0
436,436999,21.495830623770182,36.52370029730078,0.09137960240966148,56.22027921676636,26.163575887680054,47.5252571105957,1094,284,810,810,0,11,437000.0
437,437999,21.478234066069835,36.498085423201886,0.09146104567799707,56.361546993255615,26.226590156555176,47.48625564575195,1099,286,813,813,0,11,438000.0
438,438999,21.46226896081928,36.47513821811244,0.0915257185461974,56.521384716033936,26.28984832763672,47.55511474609375,1102,287,815,815,0,11,439000.0
439,439999,21.444516544991288,36.44780652503535,0.09164916077348195,56.64024877548218,26.351430654525757,47.64732360839844,1102,287,815,815,0,11,440000.0
440,440999,21.426782758106636,36.4189597440269,0.09178596968596964,56.78282570838928,26.414536237716675,47.55528259277344,1107,289,818,818,0,11,441000.0
441,441999,21.408528734462216,36.388269365028556,0.09193255836110392,56.91772675514221,26.47696852684021,47.654930114746094,1109,290,819,819,0,11,442000.0
442,442999,21.393049310751195,36.36335808977035,0.09204718495627284,57.06491160392761,26.54013180732727,47.7366943359375,1112,291,821,821,0,11,443000.0
443,443999,21.375140941738735,36.33439042726513,0.09218115114336456,57.17613887786865,26.600256204605103,47.82353591918945,1112,291,821,821,0,11,444000.0
444,444999,21.356825670198386,36.30551517324096,0.09234286806286773,57.532320976257324,26.66068744659424,47.83771896362305,1114,292,822,822,0,11,445000.0
445,445999,21.341065794805186,36.28057893393641,0.09247836120086217,57.66298842430115,26.720616102218628,47.955718994140625,1114,292,822,822,0,11,446000.0
446,446999,21.322989293493094,36.252014897466324,0.09264784243908963,57.78600883483887,26.781965255737305,48.236419677734375,1126,293,833,833,0,11,447000.0
447,447999,21.3049836130953,36.23819040690704,0.09266491233460006,57.9062397480011,26.84458589553833,48.803199768066406,1135,293,842,842,0,11,448000.0
448,448999,21.282883238717606,36.20702403512761,0.0928688044982976,58.03177785873413,26.90855097770691,49.081947326660156,1136,293,843,843,0,11,449000.0
449,449999,21.26371840451166,36.18748043197508,0.09296296094615264,58.16492295265198,26.969706535339355,49.11725997924805,1144,297,847,847,0,11,450000.0
450,450999,21.2446025158017,36.16223354962491,0.09312582187665186,58.28680086135864,27.02961301803589,49.35708236694336,1144,297,847,847,0,11,451000.0
451,451999,21.227272109514256,36.1349707187392,0.09325626555245115,58.43633246421814,27.09337282180786,49.47649002075195,1146,298,848,848,0,11,452000.0
452,452999,21.20881249282218,36.111662076566965,0.09336726223680081,58.577484369277954,27.157922983169556,49.52719497680664,1148,299,849,849,0,11,453000.0
453,453999,21.189386048106464,36.08487951551454,0.09350470401620048,58.70066285133362,27.221112966537476,49.683616638183594,1148,299,849,849,0,11,454000.0
454,454999,21.1719239533295,36.05930384687558,0.09364498612141647,58.84668445587158,27.2806396484375,49.72837448120117,1150,300,850,850,0,11,455000.0
455,455999,21.153034747054058,36.03401055722616,0.09378255275916181,58.98674535751343,27.343531131744385,49.84327697753906,1150,300,850,850,0,11,456000.0
456,456999,21.13334763156024,36.00765787935156,0.09390581210264548,59.10408425331116,27.403698205947876,49.93098449707031,1150,300,850,850,0,11,457000.0
457,457999,21.11670870140989,35.99252103327216,0.09391404255575908,59.248427629470825,27.464447021484375,49.94691848754883,1152,301,851,851,0,11,458000.0
458,458999,21.097206531265037,35.96216228271158,0.09406513504440539,59.372955083847046,27.523789644241333,50.05876922607422,1152,301,851,851,0,11,459000.0
459,459999,21.081077379615223,35.941211710703676,0.09407114357714585,59.502005100250244,27.584795475006104,49.95549011230469,1157,303,854,854,0,11,460000.0
460,460999,21.065535381871257,35.91682925490295,0.09412244119601754,59.66325879096985,27.644412994384766,50.001808166503906,1159,304,855,855,0,11,461000.0
461,461999,21.050085141053174,35.89062096607563,0.09419375706545308,59.775424003601074,27.702749013900757,50.14826583862305,1159,304,855,855,0,11,462000.0
462,462999,21.03605750956128,35.86560436434042,0.09424468273070263,59.903828620910645,27.765537977218628,50.245399475097656,1159,304,855,855,0,11,463000.0
463,463999,21.023543292520444,35.84380234817485,0.09429300603189439,60.05467438697815,27.827452898025513,50.21319580078125,1161,305,856,856,0,11,464000.0
464,464999,21.010598824334032,35.820416354617585,0.09433494951349941,60.184470891952515,27.88747787475586,50.30115509033203,1180,306,874,874,0,11,465000.0
465,465999,20.99955899430531,35.800560468182546,0.09437188124606621,60.313631772994995,27.947674989700317,50.27265930175781,1183,307,876,876,0,11,466000.0
466,466999,20.981927339613915,35.772595275184656,0.09447018112215777,60.4649019241333,28.00743842124939,50.3184814453125,1186,308,878,878,0,11,467000.0
467,467999,20.968082008584098,35.749148680477795,0.09438723296151008,60.589431047439575,28.069656133651733,51.28621292114258,1211,308,903,903,0,11,468000.0
468,468999,20.954605395562748,35.73880045760186,0.09434429500431485,60.69383692741394,28.128611087799072,51.63782501220703,1212,308,904,904,0,11,469000.0
469,469999,20.94297681418758,35.718794299403896,0.09427444872439972,60.805869817733765,28.188097715377808,51.852115631103516,1214,309,905,905,0,11,470000.0
470,470999,20.93152673962848,35.69704825184742,0.09425521280368188,60.9202401638031,28.24748992919922,51.98124313354492,1218,311,907,907,0,11,471000.0
471,471999,20.92394682663512,35.69142454505539,0.09416080221748846,61.06569147109985,28.306556224822998,52.044288635253906,1225,314,911,911,0,11,472000.0
472,472999,20.912819238708416,35.6709760516718,0.09417246252566258,61.19891309738159,28.365244388580322,52.14999771118164,1229,316,913,913,0,11,473000.0
473,473999,20.90186692526591,35.65620187192809,0.09409463586208111,61.33593702316284,28.428828716278076,52.163352966308594,1234,318,916,916,0,11,474000.0
474,474999,20.89464625974824,35.660882761807,0.09393841188935614,61.45888423919678,28.48935556411743,52.34994888305664,1236,319,917,917,0,11,475000.0
475,475999,20.887893794561272,35.65208745131158,0.09380758969704972,61.57745099067688,28.549965858459473,52.45681381225586,1238,320,918,918,0,11,476000.0
476,476999,20.880244290576567,35.64458961660396,0.09368803019988137,61.71147847175598,28.614315032958984,52.5562629699707,1240,321,919,919,0,11,477000.0
477,477999,20.87147995556398,35.62479308851565,0.0936038504791602,61.85165357589722,28.67742395401001,52.542911529541016,1244,323,921,921,0,11,478000.0
478,478999,20.862824519590106,35.60750938170723,0.09356331830440379,61.99151682853699,28.740797996520996,52.6187744140625,1247,324,923,923,0,11,479000.0
479,479999,20.855154321908635,35.589413367262445,0.09351227634987858,62.1178834438324,28.803674697875977,52.781097412109375,1247,324,923,923,0,11,480000.0
480,480999,20.846687619408893,35.56917081468976,0.09344847693687719,62.25780439376831,28.867839574813843,52.85786819458008,1249,325,924,924,0,11,481000.0
481,481999,20.840931560209274,35.55658958668598,0.09337578749912612,62.39292883872986,28.929113388061523,52.99280548095703,1249,325,924,924,0,11,482000.0
482,482999,20.836779255706528,35.542800492300216,0.09328162147751962,62.51692819595337,28.991716146469116,53.11457061767578,1249,325,924,924,0,11,483000.0
483,483999,20.83224668603924,35.53059923163808,0.09322643351797621,62.627848386764526,29.05360722541809,53.2314453125,1249,325,924,924,0,11,484000.0
484,484999,20.82826984467404,35.51864575378246,0.09312472072219657,62.762227058410645,29.114890336990356,53.28752517700195,1251,326,925,925,0,11,485000.0
485,485999,20.82422249026071,35.50706098087592,0.09303095009985196,62.91187238693237,29.178791999816895,53.357261657714844,1251,326,925,925,0,11,486000.0
486,486999,20.818856398812517,35.49355173139708,0.09297344483194603,63.05469250679016,29.248496532440186,53.43009567260742,1253,327,926,926,0,11,487000.0
487,487999,20.810498330053097,35.47676969873677,0.09286291571758076,63.19428086280823,29.311041355133057,53.97242736816406,1274,328,946,946,0,11,488000.0
488,488999,20.804571214224527,35.4747798749993,0.0927194969692472,63.32206463813782,29.371912717819214,54.263423919677734,1281,329,952,952,0,11,489000.0
489,489999,20.795126275435994,35.46598325728351,0.0926315741247894,63.44769620895386,29.43446397781372,54.512840270996094,1283,329,954,954,0,11,490000.0
490,490999,20.785064961221646,35.44437808846752,0.09261614502691895,63.55252981185913,29.49564218521118,54.744911193847656,1283,329,954,954,0,11,491000.0
491,491999,20.7809280680138,35.4438763062037,0.09248694630230425,63.686944246292114,29.555395126342773,54.735694885253906,1287,331,956,956,0,11,492000.0
492,492999,20.775443348657017,35.42999736721184,0.09244970365844607,63.83048129081726,29.616645336151123,54.873992919921875,1291,333,958,958,0,11,493000.0
493,493999,20.769860609147354,35.41674804327365,0.0923604802187713,63.97679924964905,29.67775797843933,54.81627655029297,1301,337,964,964,0,11,494000.0
494,494999,20.762890439420346,35.40473909564749,0.09229420360704177,64.09621143341064,29.741241931915283,55.102516174316406,1301,337,964,964,0,11,495000.0
495,495999,20.755398832834832,35.38623401883088,0.09220160328880977,64.22655987739563,29.80457377433777,55.25040817260742,1301,337,964,964,0,11,496000.0
496,496999,20.74990468363434,35.37488213067723,0.09211390124756436,64.36697220802307,29.866612672805786,55.1965217590332,1310,340,970,970,0,11,497000.0
497,497999,20.746009843077122,35.365212271498606,0.09205366817595917,64.50625848770142,29.930529594421387,55.179325103759766,1314,342,972,972,0,11,498000.0
498,498999,20.744165445382638,35.35725432465709,0.09197761615567901,64.64464950561523,29.99432635307312,55.2689323425293,1316,343,973,973,0,11,499000.0
499,499999,20.74608253576982,35.363666571869715,0.09193192210128887,64.77835941314697,30.05546522140503,55.439334869384766,1316,343,973,973,0,11,500000.0
500,500999,20.74561223488382,35.358552960747446,0.09183998062314946,64.91650080680847,30.12001872062683,55.430110931396484,1319,344,975,975,0,11,501000.0
501,501999,20.75080870308393,35.36744882957896,0.09175928825253599,65.06272792816162,30.181957006454468,55.4150505065918,1323,346,977,977,0,12,502000.0
502,502999,20.762507668792292,35.38739028044944,0.09181230563451048,65.18648648262024,30.244112968444824,55.62000274658203,1323,346,977,977,0,12,503000.0
503,503999,20.769408892125732,35.42471389077765,0.091668442892479,65.30934119224548,30.305383682250977,55.68416976928711,1325,347,978,978,0,12,504000.0
504,504999,20.775314289514313,35.43191887229224,0.09161235503208343,65.42716550827026,30.36639666557312,55.7281608581543,1327,348,979,979,0,12,505000.0
505,505999,20.782432986818264,35.441505886618614,0.09171621130731955,65.56909370422363,30.428091526031494,55.762210845947266,1329,349,980,980,0,12,506000.0
506,506999,20.7866055878868,35.47576006642409,0.09157841724268889,65.71783590316772,30.488297939300537,55.86016845703125,1333,350,983,983,0,12,507000.0
507,507999,20.785685377792788,35.472296883055556,0.09166642581867412,65.85895109176636,30.549086570739746,56.04244613647461,1333,350,983,983,0,12,508000.0
508,508999,20.781407632520136,35.48349735322973,0.09146167829275098,65.99360513687134,30.61431860923767,56.68854522705078,1354,351,1003,1003,0,12,509000.0
509,509999,20.77356289640767,35.473321143746396,0.09160622879423663,66.11653542518616,30.673547744750977,56.95548629760742,1357,351,1006,1006,0,12,510000.0
510,510999,20.76474105209161,35.46364253230647,0.09175646448072183,66.25468921661377,30.734007358551025,56.93487548828125,1363,353,1010,1010,0,12,511000.0
511,511999,20.754716449930942,35.448969853720726,0.09189294331632081,66.37378811836243,30.793741703033447,57.10546875,1367,354,1013,1013,0,12,512000.0
512,512999,20.747972226057307,35.445963783153324,0.09194789292712136,66.51476407051086,30.854271173477173,57.149681091308594,1371,356,1015,1015,0,12,513000.0
513,513999,20.738363033458633,35.43234564186126,0.09205346510562218,66.65298342704773,30.91478991508484,57.22877883911133,1375,358,1017,1017,0,12,514000.0
514,514999,20.729623483271634,35.416495292432856,0.0921919803034087,66.77746319770813,31.217281103134155,57.353187561035156,1377,359,1018,1018,0,12,515000.0
515,515999,20.71842974790433,35.39764667992055,0.09229034670055836,66.91842460632324,31.281148195266724,57.427860260009766,1383,361,1022,1022,0,12,516000.0
516,516999,20.709913145074886,35.38398995368735,0.09245865515100804,67.05349969863892,31.34849500656128,57.59553527832031,1383,361,1022,1022,0,12,517000.0
517,517999,20.701632546344108,35.36898391032757,0.09253704799225426,67.20420527458191,31.409977197647095,57.63838195800781,1387,363,1024,1024,0,12,518000.0
518,518999,20.69226644838171,35.35459115605229,0.09269646114556507,67.33349800109863,31.471407890319824,57.725502014160156,1389,364,1025,1025,0,12,519000.0
519,519999,20.681645612533128,35.33566462161678,0.09281122342220183,67.46451020240784,31.53835153579712,57.871192932128906,1389,364,1025,1025,0,12,520000.0
520,520999,20.676628206276437,35.37733227679227,0.0926117669199481,67.60190272331238,31.60060429573059,57.941490173339844,1391,365,1026,1026,0,12,521000.0
521,521999,20.670864040104085,35.364907413042445,0.09273679932000578,67.73601222038269,31.661203145980835,58.061424255371094,1391,365,1026,1026,0,12,522000.0
522,522999,20.663709103249236,35.3646826018914,0.09271426291005913,67.85667896270752,31.723005056381226,58.166141510009766,1391,365,1026,1026,0,12,523000.0
523,523999,20.65214983842736,35.34516159110464,0.09284656104067801,67.98820900917053,31.78206443786621,58.22250747680664,1395,366,1029,1029,0,12,524000.0
524,524999,20.641965516836166,35.32570508414961,0.09292201952595391,68.14316272735596,31.850210666656494,58.25455093383789,1397,367,1030,1030,0,12,525000.0
525,525999,20.638669581728497,35.346921880348155,0.09271469154342782,68.2637243270874,31.9137020111084,59.37078094482422,1424,367,1057,1057,0,12,526000.0
526,526999,20.629879940046703,35.33071027562349,0.0926903011715392,68.37670993804932,31.976345777511597,59.77442932128906,1426,367,1059,1059,0,12,527000.0
527,527999,20.62351547527807,35.318865657579735,0.09265391476432672,68.50280022621155,32.03615760803223,60.03384780883789,1430,368,1062,1062,0,12,528000.0
528,528999,20.61626661098215,35.30710523130921,0.09256087384772627,68.63176894187927,32.099682331085205,60.34822082519531,1434,369,1065,1065,0,12,529000.0
529,529999,20.6104521510819,35.29772390549178,0.09248676883034768,68.75867819786072,32.16050624847412,60.52406311035156,1438,371,1067,1067,0,12,530000.0
530,530999,20.607331934209796,35.30074296706847,0.09225633914755482,68.87147617340088,32.22387218475342,60.746238708496094,1438,371,1067,1067,0,12,531000.0
531,531999,20.599414192139147,35.29094858160589,0.09220750860562377,69.0277578830719,32.286746978759766,60.680721282958984,1449,376,1073,1073,0,12,532000.0
532,532999,20.592640273362342,35.31265121358368,0.09201333016971913,69.20174312591553,32.35291790962219,60.63467025756836,1461,382,1079,1079,0,12,533000.0
533,533999,20.587477224454265,35.310574817970746,0.09185130644757356,69.34155201911926,32.416603803634644,60.86204147338867,1463,383,1080,1080,0,12,534000.0
534,534999,20.582464814998158,35.297159553911904,0.09175168703121028,69.47143840789795,32.481213092803955,61.03544998168945,1467,384,1083,1083,0,12,535000.0
535,535999,20.578405825468263,35.294729170667736,0.09164087550745958,69.598215341568,32.54341745376587,61.24016189575195,1469,385,1084,1084,0,12,536000.0
536,536999,20.576390190834182,35.296644935676476,0.09156806943177975,69.73235893249512,32.604004859924316,61.29648971557617,1475,387,1088,1088,0,12,537000.0
537,537999,20.580375729701373,35.30493099306645,0.091414652394879,69.85372281074524,32.66505026817322,61.34122085571289,1481,389,1092,1092,0,12,538000.0
538,538999,20.58347963669206,35.30778973350502,0.09146252788409581,70.00468945503235,32.73090100288391,61.52350616455078,1483,390,1093,1093,0,12,539000.0
539,539999,20.58331774684759,35.30740279704465,0.09142971775089626,70.13990211486816,32.79258894920349,61.60105895996094,1485,391,1094,1094,0,12,540000.0
540,540999,20.5861233632862,35.3295015408601,0.09137855912259873,70.27156233787537,32.85409116744995,61.78117752075195,1487,392,1095,1095,0,12,541000.0
541,541999,20.586699382062765,35.323728361685944,0.09135625975833184,70.39510869979858,32.91479849815369,61.89699935913086,1489,393,1096,1096,0,12,542000.0
542,542999,20.586689105598552,35.31906431808291,0.09137520359152762,70.52402114868164,32.97648024559021,61.962425231933594,1491,394,1097,1097,0,12,543000.0
543,543999,20.582262074001044,35.306719301994484,0.09132426307605934,70.66428780555725,33.037519216537476,62.06852722167969,1493,395,1098,1098,0,12,544000.0
544,544999,20.577612508493072,35.299193217196496,0.09118905857766058,70.7825095653534,33.09776043891907,63.08008575439453,1526,396,1130,1130,0,12,545000.0
545,545999,20.56656583865146,35.29563040089592,0.09112700980150301,70.88352179527283,33.1578471660614,63.65032196044922,1528,396,1132,1132,0,12,546000.0
546,546999,20.555051584037308,35.276905990651464,0.0911393561654521,70.99690532684326,33.21639275550842,63.93297576904297,1533,398,1135,1135,0,12,547000.0
547,547999,20.545352014242905,35.27282859715285,0.09104565662020947,71.11156558990479,33.27578377723694,64.20174407958984,1537,400,1137,1137,0,12,548000.0
548,548999,20.53556357421718,35.25621728379159,0.09103692884299519,71.2313175201416,33.33484196662903,64.42527770996094,1539,401,1138,1138,0,12,549000.0
549,549999,20.527198313602472,35.24191625416386,0.09099475278943814,71.35867619514465,33.39417004585266,64.52979278564453,1543,403,1140,1140,0,12,550000.0
550,550999,20.520198882509288,35.226919053588354,0.09096781045393065,71.4836642742157,33.45270609855652,64.7007942199707,1547,405,1142,1142,0,12,551000.0
551,551999,20.517467181667328,35.219609300939986,0.09094275018985232,71.60440874099731,33.511380672454834,64.90650177001953,1549,406,1143,1143,0,12,552000.0
552,552999,20.51121641418182,35.206200132117665,0.09091860363015192,71.72823023796082,33.57047486305237,64.99446487426758,1553,408,1145,1145,0,12,553000.0
553,553999,20.508373685544015,35.19557851801715,0.09090404067577706,71.87658500671387,33.634241342544556,65.06798934936523,1559,411,1148,1148,0,12,554000.0
554,554999,20.505829205779623,35.18957843148332,0.09087015932704878,71.99511075019836,33.69523215293884,65.36157989501953,1559,411,1148,1148,0,12,555000.0
555,555999,20.502432757885845,35.17990122029866,0.09088749988583233,72.13060665130615,33.75562119483948,65.35835647583008,1565,414,1151,1151,0,12,556000.0
556,556999,20.498724202565985,35.16980346739684,0.09087912270412768,72.26501274108887,33.81663227081299,65.44036102294922,1569,416,1153,1153,0,12,557000.0
557,557999,20.493583385210933,35.15769064637745,0.09091813190707398,72.38583087921143,33.87798833847046,65.53500747680664,1571,417,1154,1154,0,12,558000.0
558,558999,20.490151708257763,35.14939114047553,0.09099540697833075,72.51581454277039,33.937840938568115,65.66184616088867,1573,418,1155,1155,0,12,559000.0
559,559999,20.485807442696245,35.13928260747279,0.09108937100538472,72.65239095687866,33.9980685710907,65.82402801513672,1575,419,1156,1156,0,12,560000.0
560,560999,20.481908669229185,35.12871365657063,0.09121339088318958,72.76048517227173,34.057369232177734,66.03356170654297,1575,419,1156,1156,0,12,561000.0
561,561999,20.481016402114914,35.12491649770793,0.09132103310926498,72.90937876701355,34.11753606796265,65.90880584716797,1586,422,1164,1164,0,12,562000.0
562,562999,20.479434551127035,35.11759689528617,0.09140445369569605,73.04302763938904,34.1821825504303,66.0785903930664,1588,423,1165,1165,0,12,563000.0
563,563999,20.477793103360362,35.11052805027961,0.09148803941899653,73.16087031364441,34.242117166519165,66.26858139038086,1588,423,1165,1165,0,12,564000.0
564,564999,20.47157206701653,35.099467604559564,0.09143002046693127,73.29896640777588,34.30682587623596,66.75521087646484,1611,425,1186,1186,0,12,565000.0
565,565999,20.461765113999277,35.09199031181303,0.09108374916788287,73.41389608383179,34.370572566986084,67.46259307861328,1618,425,1193,1193,0,12,566000.0
566,566999,20.449951522278138,35.075449170772785,0.09111523631578,73.52241921424866,34.429810762405396,67.78331756591797,1621,426,1195,1195,0,12,567000.0
567,567999,20.439336401208962,35.064232053874925,0.09112784861461398,73.6617796421051,34.49062705039978,67.85342025756836,1630,430,1200,1200,0,12,568000.0
568,568999,20.4269042883162,35.04447391094854,0.0911604526362435,73.78514075279236,34.553409814834595,68.13690948486328,1630,430,1200,1200,0,12,569000.0
569,569999,20.417182154757278,35.02859148112564,0.09118648392324324,73.91322588920593,34.613712549209595,68.3122673034668,1634,432,1202,1202,0,12,570000.0
570,570999,20.404596121479543,35.00808688395258,0.09124404040261536,74.33805012702942,34.675692558288574,68.32666397094727,1640,435,1205,1205,0,12,571000.0
571,571999,20.393953886225635,34.99049550170494,0.09128723195003474,74.45395994186401,34.73606729507446,68.57815551757812,1640,435,1205,1205,0,12,572000.0
572,572999,20.38175552444338,34.97097224386965,0.09133536193397873,74.60388803482056,34.80007457733154,68.56151580810547,1646,437,1209,1209,0,12,573000.0
573,573999,20.37222929613651,34.95406987771709,0.09137143321994201,74.72448492050171,34.86369252204895,68.7047348022461,1648,438,1210,1210,0,12,574000.0
574,574999,20.361182838811235,34.93448403932638,0.09139991081931931,74.85550498962402,34.92450428009033,68.79338455200195,1650,439,1211,1211,0,12,575000.0
575,575999,20.353134463352387,34.95274700581453,0.091221103007738,75.00517559051514,34.98688077926636,68.9415283203125,1650,439,1211,1211,0,12,576000.0
576,576999,20.341275484461566,34.93225889958449,0.09125127960657475,75.12356376647949,35.046873807907104,69.10494995117188,1650,439,1211,1211,0,12,577000.0
577,577999,20.332501144855286,34.91580387455862,0.0912675315477578,75.25706744194031,35.11307239532471,69.22489547729492,1650,439,1211,1211,0,12,578000.0
578,578999,20.322565936837623,34.89835756053448,0.09126594396938459,75.4108612537384,35.17659091949463,69.32228469848633,1650,439,1211,1211,0,12,579000.0
579,579999,20.31475076155495,34.88454790946619,0.09125656604878984,75.53727293014526,35.23672699928284,69.37652969360352,1652,440,1212,1212,0,12,580000.0
580,580999,20.308711798777356,34.89072242252594,0.0911318414061425,75.6619234085083,35.29735064506531,69.41202926635742,1654,441,1213,1213,0,12,581000.0
581,581999,20.29933142991823,34.87262599347429,0.09119273285853824,75.81358742713928,35.35879468917847,69.4278564453125,1656,442,1214,1214,0,12,582000.0
582,582999,20.291808790171675,34.85693746171626,0.09121245571482606,75.9288284778595,35.424845933914185,69.54131698608398,1656,442,1214,1214,0,12,583000.0
583,583999,20.281702312757332,34.839662597458705,0.0912546793333836,76.05922245979309,35.485599756240845,69.68056869506836,1656,442,1214,1214,0,12,584000.0
584,584999,20.275381103838132,34.84206185893085,0.09116931078022017,76.20403528213501,35.54988193511963,70.27520370483398,1676,443,1233,1233,0,12,585000.0
585,585999,20.262447968687354,34.82072866788827,0.09122082085035843,76.3131275177002,35.61081385612488,70.81970977783203,1680,443,1237,1237,0,12,586000.0
586,586999,20.251915716176576,34.816253894150755,0.09121221539542324,76.42690396308899,35.675616979599,71.10381317138672,1681,443,1238,1238,0,12,587000.0
587,587999,20.242457571016065,34.80198632666595,0.09118309957920867,76.57050132751465,35.73691487312317,71.20025634765625,1690,447,1243,1243,0,12,588000.0
588,588999,20.23475955740062,34.79034178727773,0.09111859861627647,76.70938038825989,35.80661153793335,71.33919143676758,1692,448,1244,1244,0,12,589000.0
589,589999,20.227431241293587,34.77808538955775,0.09109522054441033,76.87465810775757,35.867764472961426,71.44162368774414,1698,450,1248,1248,0,12,590000.0
590,590999,20.220400045204535,34.77128602415399,0.09104434468398381,77.00814366340637,35.928160429000854,71.55113983154297,1702,452,1250,1250,0,12,591000.0
591,591999,20.21273858775034,34.75616827797672,0.09103235881897875,77.12006378173828,35.98820376396179,71.75205612182617,1702,452,1250,1250,0,12,592000.0
592,592999,20.206096230438916,34.743443453406556,0.0910012145173924,77.25002551078796,36.04858136177063,71.85660171508789,1704,453,1251,1251,0,12,593000.0
593,593999,20.198745331890763,34.73108991314503,0.09098751481181644,77.3850965499878,36.108901262283325,71.8419418334961,1710,455,1255,1255,0,12,594000.0
594,594999,20.195625351156313,34.73044425924507,0.09089826914448518,77.51471757888794,36.16913318634033,72.02549362182617,1710,455,1255,1255,0,12,595000.0
595,595999,20.19090993822781,34.72582017070322,0.09083937560135302,77.65098118782043,36.22956347465515,72.13556671142578,1710,455,1255,1255,0,12,596000.0
596,596999,20.18624078677524,34.714805841331,0.09086625999720943,77.80063486099243,36.29046845436096,72.16920471191406,1714,457,1257,1257,0,12,597000.0
597,597999,20.180471783236435,34.70438532502704,0.09089518839452349,77.92150449752808,36.351349115371704,72.29476928710938,1719,458,1261,1261,0,12,598000.0
598,598999,20.17509707971975,34.692252823075144,0.09093253922347377,78.06136274337769,36.413657426834106,72.24295043945312,1725,460,1265,1265,0,12,599000.0
599,599999,20.172443885347104,34.6846331239004,0.09095191975399664,78.17777514457703,36.47348213195801,72.41378784179688,1725,460,1265,1265,0,12,600000.0
600,600999,20.167751201468977,34.673843636841916,0.09102147101722691,78.33594369888306,36.53362488746643,72.47418594360352,1727,461,1266,1266,0,12,601000.0
601,601999,20.164723401720327,34.66347312816915,0.09103006521532697,78.47658276557922,36.59975218772888,72.5999526977539,1727,461,1266,1266,0,12,602000.0
602,602999,20.159310321686124,34.65030928925572,0.09105304875207743,78.59406423568726,36.6604163646698,72.58988189697266,1731,462,1269,1269,0,12,603000.0
603,603999,20.153597442356595,34.64500777501389,0.09102079152098397,78.73680877685547,36.72103142738342,72.72393035888672,1731,462,1269,1269,0,12,604000.0
604,604999,20.146639827472928,34.63151959716089,0.09100145739349563,78.85827565193176,36.78264546394348,73.30339813232422,1740,463,1277,1277,0,12,605000.0
605,605999,20.139571025145145,34.61864369089837,0.09089150595355755,78.98060941696167,36.844268560409546,73.68921661376953,1740,463,1277,1277,0,12,606000.0
606,606999,20.133388425468617,34.606095228739626,0.09080880861056428,79.10711574554443,36.900572538375854,74.09365463256836,1757,464,1293,1293,0,12,607000.0
607,607999,20.126792078890954,34.594367197514636,0.09072968576033846,79.21798706054688,36.95757174491882,74.43715286254883,1757,464,1293,1293,0,12,608000.0
608,608999,20.121441263214923,34.58407438309195,0.09063475272922228,79.32689929008484,37.01420021057129,74.64855194091797,1757,464,1293,1293,0,12,609000.0
609,609999,20.117419537906816,34.57343559364179,0.09055504350335464,79.45378947257996,37.071738481521606,74.81031799316406,1759,465,1294,1294,0,12,610000.0
610,610999,20.114016709210258,34.57111211939473,0.0904252605856275,79.57070636749268,37.12940192222595,74.99295425415039,1759,465,1294,1294,0,12,611000.0
611,611999,20.108800694322017,34.55884988380586,0.09035374094202309,79.70186376571655,37.187450885772705,75.22001647949219,1779,467,1312,1312,0,12,612000.0
612,612999,20.104958970471287,34.5517542133095,0.09027523060732068,79.84637069702148,37.25118398666382,75.60990142822266,1806,469,1337,1337,0,12,613000.0
613,613999,20.1000444670033,34.54088249891669,0.09020750309639225,79.96155858039856,37.309894323349,75.83306121826172,1808,470,1338,1338,0,12,614000.0
614,614999,20.099038280172866,34.537088994440595,0.0901344522101174,80.08893632888794,37.367812395095825,76.02226638793945,1810,471,1339,1339,0,12,615000.0
615,615999,20.100273263970298,34.53561357684449,0.09007531378944145,80.2135910987854,37.42802381515503,76.23424911499023,1810,471,1339,1339,0,12,616000.0
616,616999,20.105346993231265,34.541478591788284,0.09009955111052914,80.33663249015808,37.49041271209717,76.39128112792969,1810,471,1339,1339,0,12,617000.0
617,617999,20.117525390265445,34.586209770613905,0.09006990850290719,80.46553993225098,37.54902791976929,76.4602279663086,1814,473,1341,1341,0,12,618000.0
618,618999,20.128482496877652,34.60298061285561,0.09014705813472323,80.58291339874268,37.6064019203186,76.64197158813477,1814,473,1341,1341,0,12,619000.0
619,619999,20.143327018504895,34.626706887735466,0.0902198621447663,80.71116161346436,37.664005756378174,76.78591918945312,1814,473,1341,1341,0,12,620000.0
620,620999,20.156240575522034,34.64191354792737,0.0903727650290902,80.84684038162231,37.72201156616211,76.82596206665039,1816,474,1342,1342,0,12,621000.0
621,621999,20.164933199456485,34.64802961024996,0.09050763831806397,80.9855809211731,37.78787684440613,77.00343322753906,1816,474,1342,1342,0,12,622000.0
622,622999,20.17751040755731,34.66267594809689,0.0905562124104996,81.101895570755,37.84603428840637,77.1086540222168,1816,474,1342,1342,0,12,623000.0
623,623999,20.184823509522708,34.662669379064745,0.09062268591903877,81.23128056526184,37.9066379070282,77.22997283935547,1818,475,1343,1343,0,12,624000.0
624,624999,20.186869869109756,34.65512353344327,0.09047727453597632,81.36776328086853,37.96616888046265,77.89578628540039,1823,475,1348,1348,0,12,625000.0
625,625999,20.185833137820435,34.64566870961651,0.09039902659614607,81.48812508583069,38.024375915527344,78.19509506225586,1825,475,1350,1350,0,12,626000.0
626,626999,20.185801770424895,34.64224745209958,0.09029165054624078,81.60071229934692,38.08009338378906,78.33587265014648,1825,475,1350,1350,0,12,627000.0
627,627999,20.184115813852383,34.63482767290056,0.09016840256714742,81.73010015487671,38.13849186897278,78.49708938598633,1825,475,1350,1350,0,12,628000.0
628,628999,20.18291793280258,34.63342963163446,0.090101208941198,81.84754252433777,38.197080850601196,78.62158203125,1825,475,1350,1350,0,12,629000.0
629,629999,20.180978354169177,34.622867692965585,0.09005607848733865,81.99429750442505,38.25678205490112,78.65360260009766,1829,477,1352,1352,0,12,630000.0
630,630999,20.1785997323363,34.61337970442742,0.0900356187548974,82.12890481948853,38.315155029296875,78.76815032958984,1829,477,1352,1352,0,12,631000.0
631,631999,20.178754893651572,34.636031604317445,0.08986181861576714,82.24475431442261,38.37365651130676,78.86627197265625,1829,477,1352,1352,0,12,632000.0
632,632999,20.178422737754737,34.62910794562843,0.08984612910197376,82.3511893749237,38.433765172958374,78.94877624511719,1829,477,1352,1352,0,12,633000.0
633,633999,20.17881700224469,34.627828007291725,0.08974869799250884,82.49416017532349,38.490349769592285,78.96270751953125,1831,478,1353,1353,0,12,634000.0
634,634999,20.178662690458072,34.62030063019043,0.08976152520515546,82.64024591445923,38.55083894729614,78.94395446777344,1835,480,1355,1355,0,12,635000.0
635,635999,20.18096115702571,34.61693127114493,0.08974362814363579,82.77653980255127,38.609394788742065,78.92472076416016,1837,481,1356,1356,0,12,636000.0
636,636999,20.185478117184072,34.63980687382167,0.08968452589617981,82.92006754875183,38.66764497756958,78.93389129638672,1839,482,1357,1357,0,12,637000.0
637,637999,20.187319016331777,34.63557361561081,0.08967534669033284,83.055655002594,38.72952318191528,79.0326042175293,1839,482,1357,1357,0,12,638000.0
638,638999,20.192298387298617,34.63600826369868,0.08973611474782994,83.1589252948761,38.78705668449402,79.10431671142578,1839,482,1357,1357,0,12,639000.0
639,639999,20.20006996901917,34.64376884502343,0.08977237196907117,83.28342056274414,38.84446310997009,79.1728286743164,1839,482,1357,1357,0,12,640000.0
640,640999,20.20667853402263,34.64699176784931,0.08981626571489865,83.40998458862305,38.90247058868408,79.1784439086914,1841,483,1358,1358,0,12,641000.0
641,641999,20.21255517475619,34.64792843218567,0.08979113814922945,83.55304789543152,38.972736120224,79.2604866027832,1841,483,1358,1358,0,12,642000.0
642,642999,20.220787735227574,34.65355968482009,0.08984153202751355,83.68214631080627,39.02979111671448,79.31052017211914,1841,483,1358,1358,0,12,643000.0
643,643999,20.225545643893568,34.65079266545607,0.08982080279100824,83.80779242515564,39.0873658657074,79.37579345703125,1841,483,1358,1358,0,12,644000.0
644,644999,20.228563650016685,34.64589609366277,0.0896690543367683,83.95419239997864,39.14816641807556,79.70562362670898,1842,483,1359,1359,0,12,645000.0
645,645999,20.231443464122325,34.655664222914865,0.08946792007908733,84.09957456588745,39.206937074661255,79.9559555053711,1843,483,1360,1360,0,12,646000.0
646,646999,20.232689523111432,34.64987924357422,0.08939165777651648,84.20776915550232,39.26440930366516,80.06562423706055,1843,483,1360,1360,0,12,647000.0
647,647999,20.231710790151617,34.646979925870866,0.0893429173219632,84.33985829353333,39.32194995880127,80.15810775756836,1843,483,1360,1360,0,12,648000.0
648,648999,20.229874241611416,34.636052723798485,0.08928773704578119,84.47415208816528,39.37983965873718,80.25103759765625,1844,483,1361,1361,0,12,649000.0
649,649999,20.230279726502413,34.628804695395495,0.08921202505807069,84.59883856773376,39.43712067604065,80.3031234741211,1844,483,1361,1361,0,12,650000.0
650,650999,20.23163683679052,34.621897768846495,0.08914014868759368,84.73350238800049,39.49531078338623,80.27564239501953,1848,484,1364,1364,0,12,651000.0
651,651999,20.233112313131045,34.619856326313204,0.08899944655277481,84.8801383972168,39.55663323402405,80.35330963134766,1848,484,1364,1364,0,12,652000.0
652,652999,20.235860384218608,34.625082011794504,0.08890372995103624,85.0026547908783,39.61525535583496,80.40839004516602,1848,484,1364,1364,0,12,653000.0
653,653999,20.242159309244304,34.628030634605636,0.08874303980195264,85.13291025161743,39.6760630607605,80.34864044189453,1851,485,1366,1366,0,12,654000.0
654,654999,20.248328269867528,34.6315552628278,0.08860616572736135,85.25933265686035,39.733856201171875,80.39527893066406,1851,485,1366,1366,0,12,655000.0
655,655999,20.252751540942903,34.62880348996809,0.08846966479903562,85.39089488983154,39.797794342041016,80.45804214477539,1851,485,1366,1366,0,12,656000.0
656,656999,20.259188334522754,34.63419380939727,0.08835898936682152,85.51273512840271,39.85540771484375,80.40596008300781,1853,486,1367,1367,0,12,657000.0
657,657999,20.268725509574132,34.647331815725956,0.08826557714417671,85.65595173835754,39.91667723655701,80.47428894042969,1853,486,1367,1367,0,12,658000.0
658,658999,20.28138487851169,34.678703407897196,0.08802375798110018,85.7869119644165,39.973095655441284,80.52881240844727,1853,486,1367,1367,0,12,659000.0
659,659999,20.289355579243317,34.699561031579556,0.08780632912767672,85.9055404663086,40.02961349487305,80.58191680908203,1853,486,1367,1367,0,12,660000.0
660,660999,20.295224906439756,34.700051158042264,0.08759698816728201,86.04001045227051,40.08580732345581,80.56742095947266,1855,487,1368,1368,0,12,661000.0
661,661999,20.29708361961677,34.70330899180464,0.08740702640652132,86.1776704788208,40.14395189285278,81.06640625,1863,488,1375,1375,0,12,662000.0
662,662999,20.29909488252876,34.709765802635054,0.08730555755296343,86.29270529747009,40.202091693878174,81.38971710205078,1866,488,1378,1378,0,12,663000.0
663,663999,20.298346652802014,34.712293125569595,0.08714869407212877,86.41007852554321,40.2598512172699,81.57144165039062,1866,488,1378,1378,0,12,664000.0
664,664999,20.298258082520718,34.70851303637605,0.08702122768397247,86.54312014579773,40.31889247894287,81.68145751953125,1873,490,1383,1383,0,12,665000.0
665,665999,20.297236681866796,34.69914743394362,0.0869777207646577,86.6696424484253,40.377814292907715,81.82402420043945,1873,490,1383,1383,0,12,666000.0
666,666999,20.29748824018983,34.69426917705441,0.08684359366354522,86.79051685333252,40.4355583190918,81.94112014770508,1873,490,1383,1383,0,12,667000.0
667,667999,20.299022873715437,34.69394476320216,0.08671764644127433,86.90699625015259,40.49657106399536,82.0419692993164,1873,490,1383,1383,0,12,668000.0
668,668999,20.299923957545477,34.68771891485968,0.08665201571479975,87.04139232635498,40.554011821746826,82.07674789428711,1875,491,1384,1384,0,12,669000.0
669,669999,20.30180239627985,34.69242003018226,0.08651250884780926,87.2015266418457,40.62143611907959,82.11140060424805,1907,493,1414,1414,0,12,670000.0
670,670999,20.304582210829466,34.70928675256807,0.08633162121449478,87.3340859413147,40.683441162109375,82.13684463500977,1911,495,1416,1416,0,12,671000.0
671,671999,20.305520617103564,34.70442855672677,0.08622220695486904,87.46856784820557,40.74502158164978,82.1902961730957,1914,496,1418,1418,0,12,672000.0
672,672999,20.30599342674221,34.699150644646075,0.08617416460469363,87.59050631523132,40.80582094192505,82.28236389160156,1914,496,1418,1418,0,12,673000.0
673,673999,20.305241845411178,34.6929286954351,0.08606330151561681,87.74552392959595,40.867724895477295,82.2706527709961,1918,497,1421,1421,0,12,674000.0
674,674999,20.307407835682618,34.71537601129987,0.08590123244044745,87.89673805236816,40.92961359024048,82.30035018920898,1920,498,1422,1422,0,12,675000.0
675,675999,20.30986974654292,34.71431757197011,0.08581169008486222,88.03777384757996,40.990866899490356,82.33474349975586,1922,499,1423,1423,0,12,676000.0
676,676999,20.311684461489875,34.70904021452113,0.08576190585599353,88.17634415626526,41.05271577835083,82.46508407592773,1922,499,1423,1423,0,12,677000.0
677,677999,20.315733890527884,34.71919627351093,0.0856698205584191,88.32357740402222,41.11682391166687,82.50575256347656,1924,500,1424,1424,0,12,678000.0
678,678999,20.316418945318475,34.71333455740476,0.08562551074203617,88.46135377883911,41.178990840911865,82.48147964477539,1928,501,1427,1427,0,12,679000.0
679,679999,20.31581306650363,34.706183885049306,0.08561095294240095,88.58159065246582,41.24083137512207,82.59757995605469,1928,501,1427,1427,0,12,680000.0
680,680999,20.317803883915698,34.70514873750662,0.0854224311400048,89.04248094558716,41.302332162857056,83.18361282348633,1941,502,1439,1439,0,12,681000.0
681,681999,20.317595107173993,34.70642274003924,0.0852160374235813,89.1645724773407,41.36376953125,83.49226760864258,1941,502,1439,1439,0,12,682000.0
682,682999,20.31645374208793,34.70241008437561,0.08508000207212862,89.28540706634521,41.42579388618469,83.70162200927734,1942,502,1440,1440,0,12,683000.0
683,683999,20.31698682940774,34.69999143898648,0.08491318501707057,89.41058945655823,41.48708963394165,83.81815338134766,1944,503,1441,1441,0,12,684000.0
684,684999,20.317066779763937,34.69800538621309,0.08479366656235343,89.55164122581482,41.548492670059204,83.93871688842773,1944,503,1441,1441,0,12,685000.0
685,685999,20.31848501449612,34.69513549905438,0.08471656351662005,89.70269465446472,41.61050534248352,83.96252059936523,1949,505,1444,1444,0,12,686000.0
686,686999,20.317232995408382,34.6862284043938,0.08465618162240252,89.83516669273376,41.67249584197998,84.1156234741211,1949,505,1444,1444,0,12,687000.0
687,687999,20.319006644607533,34.69144787327165,0.08460278545433852,89.9649064540863,41.73532152175903,84.25480651855469,1952,506,1446,1446,0,12,688000.0
688,688999,20.32177913753085,34.69535922167636,0.08459325773165538,90.1179130077362,41.79681062698364,84.21694946289062,1956,508,1448,1448,0,12,689000.0
689,689999,20.322071550247074,34.689057982803824,0.08457473154656503,90.24664402008057,41.85910367965698,84.28144836425781,1960,510,1450,1450,0,12,690000.0
690,690999,20.326422397036062,34.68936600639275,0.08464091807861496,90.37078356742859,41.92204451560974,84.42756271362305,1960,510,1450,1450,0,12,691000.0
691,691999,20.32970791549838,34.68922506054986,0.08457740351145382,90.5047926902771,41.98440957069397,84.53301620483398,1960,510,1450,1450,0,12,692000.0
692,692999,20.33356675416638,34.688006429850326,0.08455760207231455,90.64519047737122,42.046297550201416,84.56112670898438,1962,511,1451,1451,0,12,693000.0
693,693999,20.338488450227917,34.68908510169829,0.08450651880279547,90.78078532218933,42.1114718914032,84.68925857543945,1962,511,1451,1451,0,12,694000.0
694,694999,20.344470469173,34.69167575783571,0.08454016733894842,90.91872572898865,42.173574686050415,84.75362396240234,1962,511,1451,1451,0,12,695000.0
695,695999,20.352282828662254,34.696323454787326,0.08457334231055069,91.07795667648315,42.23616814613342,84.77502059936523,1964,512,1452,1452,0,12,696000.0
696,696999,20.359595503823037,34.69981338540603,0.08460599649097156,91.20727634429932,42.29803514480591,84.81756973266602,1966,513,1453,1453,0,12,697000.0
697,697999,20.36403155647065,34.69774599949168,0.08457832356443917,91.36042189598083,42.36071538925171,84.81685256958008,1968,514,1454,1454,0,12,698000.0
698,698999,20.370172918274687,34.69755785072436,0.08449865492867092,91.4890730381012,42.42287302017212,84.92239761352539,1968,514,1454,1454,0,12,699000.0
699,699999,20.373778959490647,34.69455459526106,0.08439621154138999,91.63620114326477,42.48497700691223,85.01495361328125,1968,514,1454,1454,0,12,700000.0
700,700999,20.37631012383897,34.69112664567206,0.08425431676054729,91.75775742530823,42.54693150520325,85.54181289672852,1975,514,1461,1461,0,12,701000.0
701,701999,20.37250064146602,34.6838647010171,0.0841594503699179,91.89901542663574,42.6053512096405,85.73405838012695,1980,515,1465,1465,0,12,702000.0
702,702999,20.367712994607,34.67662586730412,0.08412298022904108,92.01219058036804,42.663737773895264,85.91464614868164,1981,515,1466,1466,0,12,703000.0
703,703999,20.363172179180435,34.67394703795801,0.08407537568782086,92.14228391647339,42.722326040267944,86.0533218383789,1981,515,1466,1466,0,12,704000.0
704,704999,20.366148318205866,34.71649671702545,0.08387956282484332,92.26353192329407,42.780179023742676,86.0750617980957,1983,516,1467,1467,0,12,705000.0
705,705999,20.370879417941858,34.727760987159186,0.08393308546889677,92.39351916313171,42.83824872970581,86.11912536621094,1987,518,1469,1469,0,12,706000.0
706,706999,20.380437352269077,34.75592660822428,0.08393238779141077,92.51681542396545,42.8976354598999,86.26300811767578,1987,518,1469,1469,0,12,707000.0
707,707999,20.3927839797268,34.79179496109917,0.08406404318243332,92.64161348342896,42.95654344558716,86.32934951782227,1990,519,1471,1471,0,12,708000.0
708,708999,20.405232489748467,34.8252940185268,0.08414888758720163,92.81399130821228,43.01579761505127,86.24182510375977,1996,522,1474,1474,0,12,709000.0
709,709999,20.4169172797711,34.8638939517,0.08426201921279786,92.94933867454529,43.0761661529541,86.33006286621094,2000,524,1476,1476,0,12,710000.0
710,710999,20.430926096784436,34.90659321308235,0.0844667215740863,93.09067678451538,43.13730192184448,86.51266098022461,2000,524,1476,1476,0,12,711000.0
711,711999,20.441234586482285,34.93504832697185,0.08482879372995245,93.2152795791626,43.19593167304993,86.57839584350586,2004,526,1478,1478,0,12,712000.0
712,712999,20.450844951419064,34.95217948945038,0.08527905278373127,93.33508634567261,43.25426006317139,86.68832015991211,2004,526,1478,1478,0,12,713000.0
713,713999,20.461562689302173,34.97582948208376,0.08545506497504463,93.46985459327698,43.31382918357849,86.74535751342773,2007,527,1480,1480,0,12,714000.0
714,714999,20.47132499983423,34.9907551702988,0.08575126649935572,93.59639477729797,43.375213861465454,86.75247192382812,2009,528,1481,1481,0,12,715000.0
715,715999,20.484416890994275,35.01191661965141,0.08590226398569067,93.74252533912659,43.43703603744507,86.78776550292969,2014,529,1485,1485,0,12,716000.0
716,716999,20.497161860029784,35.03137626232783,0.08600605166413455,93.88581037521362,43.498942375183105,86.74824142456055,2016,530,1486,1486,0,12,717000.0
717,717999,20.508520792327563,35.0459414078988,0.08620002941645144,94.04604506492615,43.56119632720947,86.7243423461914,2020,532,1488,1488,0,12,718000.0
718,718999,20.51834736471891,35.0553834477709,0.08641418712279358,94.17671918869019,43.620134592056274,86.84624862670898,2020,532,1488,1488,0,12,719000.0
719,719999,20.522173976590157,35.05403800088735,0.0862744243543746,94.30940580368042,43.68518829345703,87.3513412475586,2031,533,1498,1498,0,12,720000.0
720,720999,20.524292201567803,35.06397900497065,0.08612722592804445,94.4173481464386,43.744072914123535,87.72441101074219,2031,533,1498,1498,0,12,721000.0
721,721999,20.524752724161225,35.06067615821377,0.0860114231612622,94.53999209403992,43.80225467681885,87.87870407104492,2034,534,1500,1500,0,12,722000.0
722,722999,20.525414637107268,35.06240540555179,0.08589717713870526,94.65835428237915,43.861753940582275,88.02895736694336,2036,535,1501,1501,0,12,723000.0
723,723999,20.527223815684405,35.06148230094227,0.08580747283803025,94.78045964241028,43.92016959190369,88.1700439453125,2038,536,1502,1502,0,12,724000.0
724,724999,20.52716627795425,35.057210443946715,0.08574014904839755,94.91340160369873,43.979533672332764,88.2493896484375,2042,538,1504,1504,0,12,725000.0
725,725999,20.528228411568058,35.05311663183803,0.08565185884805815,95.0389301776886,44.03832793235779,88.2986946105957,2049,539,1510,1510,0,12,726000.0
726,726999,20.528855230256788,35.04693472644467,0.08557066452985218,95.21465682983398,44.106497287750244,88.38278198242188,2052,540,1512,1512,0,12,727000.0
727,727999,20.528451173260063,35.04034257147817,0.08545791848548434,95.35928153991699,44.170830726623535,88.44698333740234,2056,542,1514,1514,0,12,728000.0
728,728999,20.529284410609986,35.036483055988924,0.0853675991316184,95.47531938552856,44.23046636581421,88.58980178833008,2056,542,1514,1514,0,12,729000.0
729,729999,20.52935505086794,35.03143377317019,0.08527528031039144,95.60307097434998,44.289230823516846,88.73312759399414,2058,543,1515,1515,0,12,730000.0
730,730999,20.527979107663505,35.022804463146834,0.08519476784693547,95.74351239204407,44.35083222389221,88.85477066040039,2058,543,1515,1515,0,12,731000.0
731,731999,20.529611972298074,35.043787537557996,0.08501263676825443,95.85488295555115,44.41042757034302,88.92337799072266,2058,543,1515,1515,0,12,732000.0
732,732999,20.528252555048372,35.03709452739556,0.08494582799544814,96.00180149078369,44.47238636016846,89.01050567626953,2058,543,1515,1515,0,12,733000.0
733,733999,20.528808509904913,35.02977682387577,0.08487112092534244,96.1442174911499,44.531658411026,89.08093643188477,2058,543,1515,1515,0,12,734000.0
734,734999,20.528349146663654,35.0206351710438,0.08479696062865272,96.29643440246582,44.60081458091736,89.1407241821289,2058,543,1515,1515,0,12,735000.0
735,735999,20.530136507949837,35.01668305453644,0.08478148293698329,96.42017579078674,44.659332036972046,89.1534538269043,2060,544,1516,1516,0,12,736000.0
736,736999,20.531224619293106,35.01090861159063,0.08472291067737248,96.54484796524048,44.71664047241211,89.15863800048828,2062,545,1517,1517,0,12,737000.0
737,737999,20.529527385072335,35.00192612370174,0.08473333463867327,96.67443084716797,44.77623009681702,89.23186874389648,2062,545,1517,1517,0,12,738000.0
738,738999,20.528535034789755,34.99384165663066,0.08463641064318328,96.79821228981018,44.83772420883179,89.31723403930664,2062,545,1517,1517,0,12,739000.0
739,739999,20.534007588565036,35.01975974240142,0.08433102381234137,96.92055082321167,44.89701771736145,89.97180938720703,2070,545,1525,1525,0,12,740000.0
740,740999,20.53403926732714,35.05201446964863,0.08408778243073833,97.02699542045593,44.95546221733093,90.2486572265625,2070,545,1525,1525,0,12,741000.0
741,741999,20.5324802687482,35.05931517844754,0.0839253464650167,97.15386986732483,45.0176944732666,90.39252853393555,2070,545,1525,1525,0,12,742000.0
742,742999,20.531691275575707,35.070879146934985,0.08378342889807433,97.29350781440735,45.07475566864014,90.47455215454102,2072,546,1526,1526,0,12,743000.0
743,743999,20.529280086583775,35.06621872751248,0.08373055589630174,97.41586804389954,45.13231945037842,90.60707473754883,2072,546,1526,1526,0,12,744000.0
744,744999,20.525265804288274,35.05541186123594,0.08364197963124165,97.53946256637573,45.18953466415405,90.68204116821289,2076,548,1528,1528,0,12,745000.0
745,745999,20.52565975937081,35.061400538810794,0.08356418137536203,97.64994978904724,45.24753546714783,90.7820816040039,2076,548,1528,1528,0,12,746000.0
746,746999,20.522862173418233,35.05562330243213,0.08334077511305438,97.79163885116577,45.30892467498779,90.75042724609375,2081,550,1531,1531,0,12,747000.0
747,747999,20.522807205890498,35.05931132484341,0.08305896120563694,97.94311618804932,45.37073731422424,90.792724609375,2091,552,1539,1539,0,12,748000.0
748,748999,20.51930570960919,35.05478307556257,0.0829340335160047,98.05529046058655,45.428114891052246,90.89212799072266,2091,552,1539,1539,0,12,749000.0
749,749999,20.51935847109533,35.054485388771376,0.08289183353076712,98.22934079170227,45.48764443397522,90.86181259155273,2103,555,1548,1548,0,12,750000.0
750,750999,20.51937501786171,35.056773178644654,0.08283892229804612,98.37824034690857,45.545568227767944,90.71976470947266,2125,558,1567,1567,0,12,751000.0
751,751999,20.515887194202296,35.04761205612232,0.08280137239744978,98.50528001785278,45.60758686065674,90.8120002746582,2132,559,1573,1573,0,12,752000.0
752,752999,20.51454517566232,35.045730382771865,0.08248592718225845,98.63176679611206,45.666783571243286,90.95183944702148,2132,559,1573,1573,0,12,753000.0
753,753999,20.515468463034363,35.04762940209062,0.08234351670435802,98.76763248443604,45.72622895240784,90.95734024047852,2140,560,1580,1580,0,12,754000.0
754,754999,20.51598470880968,35.046338365588376,0.08225308980541512,98.91740155220032,45.78552794456482,90.92339324951172,2144,562,1582,1582,0,12,755000.0
755,755999,20.517300405424084,35.045645459163836,0.08219508162817113,99.04131579399109,45.8452262878418,91.05907821655273,2144,562,1582,1582,0,12,756000.0
756,756999,20.519503379914134,35.045622096118734,0.08206026992987081,99.1668176651001,45.90394139289856,91.15793991088867,2144,562,1582,1582,0,12,757000.0
757,757999,20.519911701892045,35.0437245533918,0.08202356706643388,99.28500819206238,45.96347188949585,91.21894073486328,2144,562,1582,1582,0,12,758000.0
758,758999,20.518613833160014,35.03827964000876,0.08198853488158298,99.43038749694824,46.022972106933594,91.31050109863281,2144,562,1582,1582,0,12,759000.0
759,759999,20.519498239198892,35.03683908411871,0.08181961509158919,99.55465245246887,46.08264970779419,91.96545791625977,2154,562,1592,1592,0,12,760000.0
760,760999,20.5157578021463,35.031612248278634,0.08172565711952873,99.67493987083435,46.14139127731323,92.38394165039062,2156,562,1594,1594,0,12,761000.0
761,761999,20.50949680682569,35.019215235686744,0.0816980680189946,99.80837941169739,46.20162630081177,92.50947570800781,2195,564,1631,1631,0,12,762000.0
762,762999,20.506435536282783,35.02579396152278,0.08153469350457143,99.92910838127136,46.26040315628052,92.71106719970703,2197,565,1632,1632,0,12,763000.0
763,763999,20.502243844213975,35.021708387742486,0.0814515061199016,100.04073309898376,46.31762337684631,92.85478210449219,2197,565,1632,1632,0,12,764000.0
764,764999,20.49831055846703,35.01489192226295,0.081368951413054,100.16541910171509,46.37635517120361,92.94666290283203,2199,566,1633,1633,0,12,765000.0
765,765999,20.496786183514153,35.012525139889526,0.08127901202445409,100.30740880966187,46.43504810333252,92.99276733398438,2210,568,1642,1642,0,12,766000.0
766,766999,20.494309624397914,35.00986691800615,0.08119670523832401,100.43421792984009,46.497870683670044,93.1882553100586,2210,568,1642,1642,0,12,767000.0
767,767999,20.492155961983325,35.00594602177831,0.0811264431000086,100.57699704170227,46.55953860282898,93.21676635742188,2228,570,1658,1658,0,12,768000.0
768,768999,20.489822254136513,34.9997063986719,0.08104420634133891,100.72498965263367,46.61708641052246,93.14759063720703,2248,574,1674,1674,0,12,769000.0
769,769999,20.489815141814315,34.99864802885881,0.08096378817516203,100.85750341415405,46.67736840248108,93.3006706237793,2248,574,1674,1674,0,12,770000.0
770,770999,20.490436549265507,34.99611493477134,0.0809098612441781,100.98520278930664,46.740726947784424,93.3885498046875,2248,574,1674,1674,0,12,771000.0
771,771999,20.49001073945907,34.99930101258013,0.08079133325314991,101.10260844230652,46.79942607879639,93.50566101074219,2248,574,1674,1674,0,12,772000.0
772,772999,20.48870600495778,34.996001125090004,0.08075265654274,101.2319016456604,46.85827422142029,93.57038879394531,2248,574,1674,1674,0,12,773000.0
773,773999,20.48915636300384,34.993727052085475,0.0807159105497689,101.37562465667725,46.922717809677124,93.5723991394043,2250,575,1675,1675,0,12,774000.0
774,774999,20.49051957730007,34.99621445324172,0.08068905235266277,101.52778267860413,46.985387086868286,93.58306884765625,2257,577,1680,1680,0,12,775000.0
775,775999,20.492237402291593,34.99492660287777,0.08066862917116602,101.67081832885742,47.04509973526001,93.7059326171875,2257,577,1680,1680,0,12,776000.0
776,776999,20.49546358928141,35.02369069674638,0.08050222780370431,101.80013108253479,47.10989284515381,93.7386360168457,2259,578,1681,1681,0,12,777000.0
777,777999,20.49821715744182,35.023373888036424,0.08043623816102452,101.91213941574097,47.16830563545227,93.85113906860352,2259,578,1681,1681,0,12,778000.0
778,778999,20.501471402375703,35.0256562698552,0.08038603838868619,102.05683469772339,47.230624198913574,93.93132400512695,2259,578,1681,1681,0,12,779000.0
779,779999,20.501362113525495,35.02836465078277,0.08029592727081758,102.17935609817505,47.28961181640625,94.03837203979492,2259,578,1681,1681,0,12,780000.0
780,780999,20.50274001624792,35.04494761013901,0.0797963523364077,102.31311297416687,47.34906768798828,94.60682678222656,2275,580,1695,1695,0,12,781000.0
781,781999,20.497623735473454,35.03412382447476,0.07975662070056377,102.42661380767822,47.40620446205139,94.98539733886719,2277,580,1697,1697,0,12,782000.0
782,782999,20.49183820947733,35.02739604621284,0.07971873232000215,102.56399750709534,47.47065448760986,95.13481903076172,2283,581,1702,1702,0,12,783000.0
783,783999,20.48620263225566,35.019651543296064,0.07968100778456899,102.67815899848938,47.528098821640015,95.25971221923828,2293,582,1711,1711,0,12,784000.0
784,784999,20.483054681859375,35.026361428907286,0.07958858202521368,102.81676626205444,47.58563852310181,95.30480575561523,2303,583,1720,1720,0,12,785000.0
785,785999,20.478750807523518,35.017531307158784,0.07955659776379698,102.93962860107422,47.64396119117737,95.38520812988281,2308,584,1724,1724,0,12,786000.0
786,786999,20.47473729899752,35.009055396274874,0.07953221728544624,103.06583046913147,47.702253341674805,95.51374435424805,2310,585,1725,1725,0,12,787000.0
787,787999,20.472191250102714,35.01812236004852,0.07944356527360175,103.22260856628418,47.76632070541382,95.58612060546875,2326,587,1739,1739,0,12,788000.0
788,788999,20.46801934535878,35.02965508401843,0.07934832486042809,103.35881876945496,47.82563042640686,95.64095306396484,2330,589,1741,1741,0,12,789000.0
789,789999,20.462802390281038,35.0211975758776,0.07931466739561233,103.50055170059204,47.886428117752075,95.72037887573242,2339,590,1749,1749,0,12,790000.0
790,790999,20.457984527626618,35.01286073667241,0.07931265586224856,103.6425850391388,47.945308208465576,95.81193161010742,2341,591,1750,1750,0,12,791000.0
791,791999,20.455134962280724,35.00950575574291,0.07927976335655085,103.765456199646,48.00667476654053,95.92105865478516,2341,591,1750,1750,0,12,792000.0
792,792999,20.451249391414112,35.00403423154608,0.07925908805073201,103.90153288841248,48.0654935836792,95.9615364074707,2343,592,1751,1751,0,12,793000.0
793,793999,20.448812510093397,34.99853818256795,0.0792015574183661,104.05797910690308,48.1297550201416,95.98654556274414,2391,594,1797,1797,0,12,794000.0
794,794999,20.44507554453008,34.9875369897851,0.07914519358267691,104.18270134925842,48.19457650184631,96.37274932861328,2391,594,1797,1797,0,12,795000.0
795,795999,20.441523381091937,34.97895858450948,0.07913560964106792,104.32555890083313,48.252909660339355,96.59582138061523,2393,595,1798,1798,0,12,796000.0
796,796999,20.436614175556855,34.9668362585076,0.07911375852267377,104.44933581352234,48.3119683265686,96.8233642578125,2393,595,1798,1798,0,12,797000.0
797,797999,20.43169457052444,34.95578672160221,0.07907563312714017,104.59156537055969,48.372087240219116,97.67145919799805,2426,597,1829,1829,0,12,798000.0
798,798999,20.42258686605739,34.939978279310786,0.07912401530817048,104.7200436592102,48.43297600746155,98.15948867797852,2426,597,1829,1829,0,12,799000.0
799,799999,20.416013595458036,34.94274861251936,0.07908007799905226,104.8298830986023,48.49212074279785,98.48873901367188,2426,597,1829,1829,0,12,800000.0
800,800999,20.409128325796644,34.93558848139579,0.07909269217881076,104.96140384674072,48.552157402038574,98.74190902709961,2468,599,1869,1869,0,12,801000.0
801,801999,20.403731554241336,34.933295206640445,0.07907102661766396,105.08379316329956,48.61109972000122,99.0295524597168,2468,599,1869,1869,0,12,802000.0
802,802999,20.39657246995084,34.921263882582146,0.07906397432173151,105.1978497505188,48.67013669013977,99.27946853637695,2468,599,1869,1869,0,12,803000.0
803,803999,20.389138067053068,34.90852822286846,0.07904703992144002,105.31633114814758,48.729649782180786,99.52740478515625,2468,599,1869,1869,0,12,804000.0
804,804999,20.38314593629926,34.90082184785275,0.0790103563855431,105.84127187728882,48.79008626937866,99.59975814819336,2473,601,1872,1872,0,12,805000.0
805,805999,20.378384652157166,34.892483554483405,0.07895887832315751,105.9740674495697,48.85010075569153,99.77177047729492,2473,601,1872,1872,0,12,806000.0
806,806999,20.373634090195704,34.88633518729261,0.0789224276324092,106.09774494171143,48.910842418670654,99.93325805664062,2476,602,1874,1874,0,12,807000.0
807,807999,20.370087101617756,34.89514481062988,0.07883088007307992,106.21988940238953,48.97072219848633,100.10987091064453,2476,602,1874,1874,0,12,808000.0
808,808999,20.364640786708467,34.88830489400139,0.07877337250018346,106.35434460639954,49.02977108955383,100.14217758178711,2478,603,1875,1875,0,12,809000.0
809,809999,20.360241529463163,34.88175626256319,0.07873258936920002,106.48863101005554,49.09024691581726,100.39785766601562,2478,603,1875,1875,0,12,810000.0
810,810999,20.35547096165671,34.87716222445143,0.07868032889180399,106.63763332366943,49.1501624584198,100.33890914916992,2491,605,1886,1886,0,12,811000.0
811,811999,20.352510772195814,34.87275808911816,0.07861755635725032,106.77556729316711,49.21034836769104,100.32919692993164,2504,607,1897,1897,0,12,812000.0
812,812999,20.348124160251057,34.86471094080924,0.07858241719898429,106.92131447792053,49.27364373207092,100.38294982910156,2508,609,1899,1899,0,12,813000.0
813,813999,20.345952271925466,34.8603072817157,0.07851731928833505,107.06535029411316,49.336249351501465,100.53412246704102,2508,609,1899,1899,0,12,814000.0
814,814999,20.342154586875825,34.85219137872573,0.07847276866746389,107.18789553642273,49.396363258361816,100.6322021484375,2508,609,1899,1899,0,12,815000.0
815,815999,20.337205798581234,34.84126403948891,0.07843468694874822,107.32451462745667,49.456438302993774,100.75022888183594,2508,609,1899,1899,0,12,816000.0
816,816999,20.336992747027768,34.85390505967183,0.07830083402314014,107.4470853805542,49.51844501495361,101.71885681152344,2532,609,1923,1923,0,12,817000.0
817,817999,20.329760634797182,34.841714225561454,0.07827055416584316,107.57171559333801,49.5870099067688,102.14653396606445,2532,609,1923,1923,0,12,818000.0
818,818999,20.323729342531948,34.83216628620696,0.07825297257261132,107.67688703536987,49.645198583602905,102.42614364624023,2532,609,1923,1923,0,12,819000.0
819,819999,20.318679699336876,34.8210779394493,0.07826013801919351,107.8023111820221,49.704139709472656,102.65810775756836,2532,609,1923,1923,0,12,820000.0
820,820999,20.315517760738913,34.81740380964045,0.07824868493652859,107.94437098503113,49.76302218437195,102.76235961914062,2534,610,1924,1924,0,12,821000.0
821,821999,20.31341237052515,34.81134061974339,0.07827235570558888,108.07355451583862,49.82179498672485,102.88587188720703,2538,612,1926,1926,0,12,822000.0
822,822999,20.311617183352457,34.80577756738027,0.07834652340817505,108.18645668029785,49.88074064254761,103.08586502075195,2538,612,1926,1926,0,12,823000.0
823,823999,20.311857210257177,34.80323408500429,0.07849578520736034,108.31634330749512,49.94080448150635,103.1373176574707,2550,614,1936,1936,0,12,824000.0
824,824999,20.313519295028502,34.81437664926546,0.07845319917603011,108.48826360702515,50.00069332122803,103.12590026855469,2559,618,1941,1941,0,12,825000.0
825,825999,20.31607634802778,34.81683961603373,0.07856119673768691,108.62469148635864,50.064292907714844,103.3131217956543,2561,619,1942,1942,0,12,826000.0
826,826999,20.321274701193644,34.826856433005766,0.0786672433567901,108.75068926811218,50.12447500228882,103.47785949707031,2564,620,1944,1944,0,12,827000.0
827,827999,20.324404968306066,34.82971609242445,0.0787055438814741,108.91280961036682,50.1878445148468,103.43404388427734,2601,624,1977,1977,0,12,828000.0
828,828999,20.328175673013437,34.830692859889666,0.07883113094258765,109.06437373161316,50.25204372406006,103.5146484375,2605,626,1979,1979,0,12,829000.0
829,829999,20.332334708827997,34.83672020434019,0.07894752294860363,109.20198130607605,50.31513166427612,103.67620468139648,2607,627,1980,1980,0,12,830000.0
830,830999,20.337525889045107,34.844035260736206,0.07909008788084926,109.33133029937744,50.37775135040283,103.82655334472656,2607,627,1980,1980,0,12,831000.0
831,831999,20.342577946214448,34.84855640123138,0.07916845584460286,109.4692485332489,50.44130873680115,103.89170837402344,2613,628,1985,1985,0,12,832000.0
832,832999,20.34933601023428,34.856439987423585,0.07932022436249409,109.60668444633484,50.50504207611084,103.9598503112793,2615,629,1986,1986,0,12,833000.0
833,833999,20.35651036460956,34.86361241527023,0.07947619691329044,109.75822949409485,50.568586587905884,104.11304473876953,2615,629,1986,1986,0,12,834000.0
834,834999,20.35949047400839,34.863626192681025,0.07958379844976826,109.89172101020813,50.631712198257446,104.20529556274414,2615,629,1986,1986,0,12,835000.0
835,835999,20.360881812183013,34.85891256122349,0.07963525953609596,110.03442406654358,50.69515371322632,104.24871063232422,2617,630,1987,1987,0,12,836000.0
836,836999,20.361324307100826,34.85854508451138,0.07937552190401187,110.16938352584839,50.759000301361084,105.05400085449219,2651,631,2020,2020,0,12,837000.0
837,837999,20.360884646080798,34.86428252331858,0.07926993538210925,110.29407501220703,50.82214021682739,105.5588150024414,2652,631,2021,2021,0,12,838000.0
838,838999,20.359548695414766,34.86699777822322,0.07919043205916043,110.41387343406677,50.88399052619934,105.79719924926758,2652,631,2021,2021,0,12,839000.0
839,839999,20.359240810205247,34.866979069566,0.07920059257248624,110.54181814193726,50.94610381126404,105.97947311401367,2654,632,2022,2022,0,12,840000.0
840,840999,20.3604631894675,34.86540692014522,0.07921172867872983,110.6897714138031,51.00894379615784,106.0267448425293,2662,634,2028,2028,0,12,841000.0
841,841999,20.362850992482503,34.87331028622228,0.0791657880905231,110.82000398635864,51.07103204727173,106.19824600219727,2664,635,2029,2029,0,12,842000.0
842,842999,20.364897709554377,34.880857643613815,0.07919386870956668,110.94046831130981,51.13346743583679,106.41778182983398,2664,635,2029,2029,0,12,843000.0
843,843999,20.371850028064884,34.912796138657605,0.07914686782959546,111.08244633674622,51.19610118865967,106.48273086547852,2669,637,2032,2032,0,12,844000.0
844,844999,20.379215364594117,34.94217759929748,0.07924498104432887,111.21997380256653,51.25899314880371,106.63469696044922,2674,639,2035,2035,0,12,845000.0
845,845999,20.392605379353526,34.99251475515983,0.07948668468919684,111.37087368965149,51.322065114974976,106.6887321472168,2682,641,2041,2041,0,12,846000.0
846,846999,20.40393194335732,35.039914913508014,0.07969781848843072,111.53092336654663,51.38556742668152,106.71960830688477,2688,644,2044,2044,0,12,847000.0
847,847999,20.418573290465424,35.08813900114837,0.0800859332630548,111.64983534812927,51.44922208786011,106.967529296875,2688,644,2044,2044,0,12,848000.0
848,848999,20.430788586596467,35.12176289853628,0.08055682152482269,111.80794048309326,51.51557993888855,107.000244140625,2694,647,2047,2047,0,12,849000.0
849,849999,20.44747442538793,35.171388404544366,0.08091255912414508,111.96203184127808,51.57891130447388,107.08918380737305,2700,650,2050,2050,0,12,850000.0
850,850999,20.46321278505953,35.22040085548454,0.08140748346580706,112.0914056301117,51.64259719848633,107.27031707763672,2713,651,2062,2062,0,12,851000.0
851,851999,20.48192045900963,35.26839040564559,0.08178248935996568,112.22187280654907,51.70659422874451,107.41132736206055,2715,652,2063,2063,0,12,852000.0
852,852999,20.492805532336245,35.29080636105616,0.08155663837218341,112.38925433158875,51.77091360092163,108.01659393310547,2735,653,2082,2082,0,12,853000.0
853,853999,20.51204088185323,35.385908520551425,0.08099731886466466,112.51790356636047,51.83433413505554,108.66482162475586,2741,653,2088,2088,0,12,854000.0
854,854999,20.53723322556444,35.49362392301301,0.08095778676801402,112.63821148872375,51.89630889892578,108.95409774780273,2741,653,2088,2088,0,12,855000.0
855,855999,20.557164273670733,35.56787151358822,0.08107814884352693,112.77488589286804,51.95973753929138,109.09656143188477,2747,654,2093,2093,0,12,856000.0
856,856999,20.578237079919848,35.63806920770982,0.08131833693916812,112.91516613960266,52.02195954322815,109.18555450439453,2755,656,2099,2099,0,12,857000.0
857,857999,20.594331935045684,35.68152771633931,0.08171807196432823,113.02571702003479,52.08434057235718,109.41216278076172,2755,656,2099,2099,0,12,858000.0
858,858999,20.61192254351775,35.722878736361565,0.08218238268274725,113.16204404830933,52.14757561683655,109.52407836914062,2757,657,2100,2100,0,12,859000.0
859,859999,20.62945137136797,35.76323821180089,0.08242668831498079,113.29361867904663,52.210460901260376,109.66491317749023,2760,658,2102,2102,0,12,860000.0
860,860999,20.646162595471804,35.79786544391838,0.08275763247255197,113.41481447219849,52.272690773010254,109.85647964477539,2761,658,2103,2103,0,12,861000.0
861,861999,20.6584066131286,35.81519499901297,0.08280538696201833,113.57060384750366,52.33564829826355,109.89344787597656,2765,660,2105,2105,0,12,862000.0
862,862999,20.674772344622617,35.848786639652005,0.08293310271414278,113.72169423103333,52.399189710617065,109.89644241333008,2769,662,2107,2107,0,12,863000.0
863,863999,20.691030502947246,35.90222340275943,0.08294816885133716,113.87768626213074,52.463661432266235,109.87515640258789,2789,666,2123,2123,0,12,864000.0
864,864999,20.710824260197526,35.96214665176347,0.08342096664780685,114.02002120018005,52.52654790878296,109.95854568481445,2793,668,2125,2125,0,12,865000.0
865,865999,20.727888750523277,35.98750685443254,0.08358437410229069,114.17032742500305,52.58943510055542,109.99930191040039,2797,670,2127,2127,0,12,866000.0
866,866999,20.747540563097303,36.03260117167858,0.0838057511183663,114.3159430027008,52.6522171497345,110.05611419677734,2801,672,2129,2129,0,12,867000.0
867,867999,20.76434197108919,36.05323384800041,0.0842286843591562,114.4641923904419,52.71543836593628,110.09333801269531,2805,674,2131,2131,0,12,868000.0
868,868999,20.778128073205128,36.07738135358976,0.08422064844432309,114.62364959716797,52.779430866241455,110.62755584716797,2833,677,2156,2156,0,12,869000.0
869,869999,20.79339252695809,36.13642892629458,0.08396032414098398,114.73514413833618,52.841681718826294,111.3226089477539,2838,677,2161,2161,0,12,870000.0
870,870999,20.804049448094826,36.18238466520611,0.08380084508950092,114.86983132362366,52.90476417541504,111.60981750488281,2853,678,2175,2175,0,12,871000.0
871,871999,20.815518020062573,36.209854589943944,0.08392148589050707,114.9803671836853,52.96679067611694,111.9020004272461,2853,678,2175,2175,0,12,872000.0
872,872999,20.829390578828626,36.245554385962826,0.08410514042241102,115.11340141296387,53.030056953430176,111.99429702758789,2855,679,2176,2176,0,12,873000.0
873,873999,20.844905153143856,36.30568445061945,0.08421601016463542,115.24615359306335,53.09287881851196,112.12408828735352,2859,681,2178,2178,0,12,874000.0
874,874999,20.856434046257082,36.333655856196195,0.08441561584305368,115.38450860977173,53.159934282302856,112.28332138061523,2865,682,2183,2183,0,12,875000.0
875,875999,20.872437822201867,36.3906521284515,0.08472215987193787,115.528165102005,53.222880363464355,112.45624160766602,2867,683,2184,2184,0,12,876000.0
876,876999,20.887356883413478,36.42632676726484,0.08523478307373489,115.6895055770874,53.287580728530884,112.46145248413086,2874,686,2188,2188,0,12,877000.0
877,877999,20.906947538246566,36.49840084594983,0.08559918888205165,115.82131505012512,53.354191064834595,112.60770797729492,2876,687,2189,2189,0,12,878000.0
878,878999,20.926555129381736,36.545739821744306,0.08606940886469272,115.98283267021179,53.42765021324158,112.83737564086914,2879,688,2191,2191,0,12,879000.0
879,879999,20.94284857460389,36.579947070719086,0.0865916209019093,116.15435981750488,53.4943425655365,112.75056457519531,2897,692,2205,2205,0,12,880000.0
880,880999,20.962588179112736,36.62476718206084,0.08744559351684822,116.28858995437622,53.5585732460022,112.9334945678711,2899,693,2206,2206,0,12,881000.0
881,881999,20.980465881517446,36.6620962136298,0.08783270530673248,116.43627285957336,53.6216516494751,113.00318145751953,2903,695,2208,2208,0,12,882000.0
882,882999,21.001669216563855,36.717093882701725,0.08873322445516785,116.58244204521179,53.6850380897522,113.00727462768555,2907,697,2210,2210,0,12,883000.0
883,883999,21.01954224024595,36.751601402638,0.0894118858588312,116.71615099906921,53.7479362487793,113.15789794921875,2969,699,2270,2270,0,12,884000.0
884,884999,21.036306543434804,36.77634068552208,0.08993875763523562,116.8944673538208,53.81172800064087,113.17596817016602,2985,702,2283,2283,0,12,885000.0
885,885999,21.053043612545363,36.80364533444452,0.0905729112969097,117.00810313224792,53.874959230422974,113.3713493347168,2985,702,2283,2283,0,12,886000.0
886,886999,21.0730128098538,36.85148375080753,0.09117462759207895,117.12374782562256,53.937506437301636,113.49716186523438,2985,702,2283,2283,0,12,887000.0
887,887999,21.086465051630192,36.86495406837434,0.09168874933805093,117.25027251243591,54.00064516067505,113.66321182250977,2985,702,2283,2283,0,12,888000.0
888,888999,21.098377938033078,36.88671528667079,0.09176167786664857,117.38382387161255,54.06476020812988,114.59565734863281,3012,702,2310,2310,0,12,889000.0
889,889999,21.097864267858963,36.88995453908203,0.09163738875330307,117.53823781013489,54.1287157535553,114.90671157836914,3027,705,2322,2322,0,12,890000.0
890,890999,21.101402789481774,36.91242583449951,0.09152196979883154,117.6516797542572,54.19060564041138,115.21683502197266,3027,705,2322,2322,0,12,891000.0
891,891999,21.105657988322655,36.923227382457995,0.09146717837355423,117.78241300582886,54.25399613380432,115.37137603759766,3033,706,2327,2327,0,12,892000.0
892,892999,21.108655462143314,36.930035432552266,0.09138863438455969,117.90885829925537,54.316246032714844,115.5896224975586,3033,706,2327,2327,0,12,893000.0
893,893999,21.112942886416874,36.93752379582586,0.09134661159564006,118.07234406471252,54.37899398803711,115.5045394897461,3054,710,2344,2344,0,12,894000.0
894,894999,21.11511290703959,36.940294926292104,0.09132421002580005,118.20054459571838,54.44227981567383,115.7281723022461,3065,711,2354,2354,0,12,895000.0
895,895999,21.120155178318935,36.94797046185304,0.0913296153266342,118.34069061279297,54.50547003746033,115.96080780029297,3065,711,2354,2354,0,12,896000.0
896,896999,21.12433755075697,36.954780416624914,0.09133809157106976,118.47747898101807,54.56799030303955,116.0720329284668,3068,712,2356,2356,0,12,897000.0
897,897999,21.131794596497897,36.97147331850476,0.09141991515519676,118.607417345047,54.63042068481445,116.20087432861328,3070,713,2357,2357,0,12,898000.0
898,898999,21.140653966533524,36.98814468790154,0.091554792393157,118.73700737953186,54.693400621414185,116.34809875488281,3073,714,2359,2359,0,12,899000.0
899,899999,21.14631938944357,36.996285859688406,0.0916420942697288,118.89468240737915,54.756325483322144,116.35359954833984,3077,716,2361,2361,0,12,900000.0
900,900999,21.154995300165435,37.00731475822383,0.0918653995895452,119.04967308044434,54.818922996520996,116.42098999023438,3083,719,2364,2364,0,12,901000.0
901,901999,21.163120130228087,37.020300044380015,0.09204246555770512,119.18145942687988,54.881895780563354,116.6229019165039,3085,720,2365,2365,0,12,902000.0
902,902999,21.174210810568322,37.040041038828136,0.09231968691824155,119.31683945655823,54.94477868080139,116.79857635498047,3085,720,2365,2365,0,12,903000.0
903,903999,21.18811260471853,37.06651079930937,0.09262773087728537,119.44933676719666,55.008275747299194,116.8205680847168,3089,722,2367,2367,0,12,904000.0
904,904999,21.201232662484585,37.0850098770554,0.0929509155509487,119.61301064491272,55.0766122341156,116.86149978637695,3093,724,2369,2369,0,12,905000.0
905,905999,21.213775565591288,37.10153666977549,0.09324823462707987,119.75777578353882,55.13950324058533,116.94666290283203,3097,726,2371,2371,0,12,906000.0
906,906999,21.2283831255318,37.12777616382719,0.0935488618614716,119.87920212745667,55.201704025268555,117.13195419311523,3097,726,2371,2371,0,12,907000.0
907,907999,21.244930633001783,37.154298807014364,0.09397525271508633,120.00230407714844,55.715537548065186,117.29916000366211,3097,726,2371,2371,0,12,908000.0
908,908999,21.253352847825575,37.16073456666817,0.09422233319399909,120.12899708747864,55.778642892837524,117.52581024169922,3097,726,2371,2371,0,12,909000.0
909,909999,21.25802429952544,37.182709910674866,0.09395537272833565,120.27074837684631,55.842941999435425,118.64151000976562,3125,726,2399,2399,0,12,910000.0
910,910999,21.25662195860787,37.18207925439389,0.09394896450604451,120.4047908782959,55.90542936325073,118.96503829956055,3140,727,2413,2413,0,12,911000.0
911,911999,21.25851998204721,37.185834619967224,0.09389986719010912,120.53369641304016,55.96765351295471,119.26251220703125,3140,727,2413,2413,0,12,912000.0
912,912999,21.262351209523597,37.19682953826588,0.09379543498923404,120.65888500213623,56.0297212600708,119.4924430847168,3140,727,2413,2413,0,12,913000.0
913,913999,21.26292769607376,37.196111874576815,0.09377354100546853,120.788489818573,56.09231758117676,119.67936706542969,3140,727,2413,2413,0,12,914000.0
914,914999,21.264370420252312,37.19680116607813,0.09376947311467398,120.9099850654602,56.154250383377075,119.85320281982422,3140,727,2413,2413,0,12,915000.0
915,915999,21.26633588310993,37.19740160048922,0.09375781849408826,121.05179595947266,56.21696758270264,119.96084594726562,3142,728,2414,2414,0,12,916000.0
916,916999,21.26903791762772,37.20502306305517,0.09371538572544269,121.20484375953674,56.28161811828613,119.99276733398438,3147,730,2417,2417,0,12,917000.0
917,917999,21.27172807995624,37.2076539746314,0.0936963311310528,121.33147382736206,56.34406399726868,120.1679573059082,3147,730,2417,2417,0,12,918000.0
918,918999,21.279004252362906,37.2464876253358,0.09361066739934787,121.47083020210266,56.40654754638672,120.28954315185547,3150,731,2419,2419,0,12,919000.0
919,919999,21.28213778581789,37.247107581236406,0.09363145631791192,121.63574504852295,56.47370195388794,120.23934173583984,3160,734,2426,2426,0,12,920000.0
920,920999,21.286288563293446,37.25083722182837,0.09363695451112886,121.77438950538635,56.536253929138184,120.3527717590332,3162,735,2427,2427,0,12,921000.0
921,921999,21.290621707736296,37.25333380497407,0.09366678807494822,121.9413902759552,56.60468316078186,120.32952499389648,3169,738,2431,2431,0,12,922000.0
922,922999,21.297309974440573,37.26729963401493,0.09369404671157533,122.14315390586853,56.66861081123352,120.01739883422852,3201,746,2455,2455,0,12,923000.0
923,923999,21.302643545690543,37.27056904986869,0.09368804783524176,122.29821109771729,56.73931622505188,120.20173263549805,3207,747,2460,2460,0,12,924000.0
924,924999,21.30789458295988,37.27425154497449,0.0937496331172768,122.4502363204956,56.80509853363037,120.34304428100586,3211,749,2462,2462,0,12,925000.0
925,925999,21.313816061645323,37.27822060219049,0.09384639895175484,122.57652640342712,56.868712425231934,120.53653335571289,3213,750,2463,2463,0,12,926000.0
926,926999,21.31120891852064,37.2708066770297,0.09382394575188191,122.75414156913757,56.933725118637085,121.35284042358398,3252,754,2498,2498,0,12,927000.0
927,927999,21.306262009916114,37.26727479318574,0.09379148385823188,122.87648367881775,56.998708963394165,121.9760971069336,3257,754,2503,2503,0,12,928000.0
928,928999,21.302508331806685,37.262821161286304,0.09374527804170207,123.01109910011292,57.06231141090393,122.37447357177734,3257,754,2503,2503,0,12,929000.0
929,929999,21.297251872260333,37.25326760329537,0.09373111398717171,123.13875603675842,57.124499559402466,122.52525329589844,3260,755,2505,2505,0,12,930000.0
930,930999,21.293919322171135,37.2462843643412,0.09371928489606562,123.25475907325745,57.186718225479126,122.8625717163086,3261,755,2506,2506,0,12,931000.0
931,931999,21.289026221361635,37.23865554735055,0.09369135114027738,123.39266753196716,57.25688886642456,123.00243377685547,3264,756,2508,2508,0,12,932000.0
932,932999,21.28330204466616,37.22897927727939,0.09370093002901358,123.5449743270874,57.319904804229736,123.07965469360352,3270,759,2511,2511,0,12,933000.0
933,933999,21.281058992129896,37.2431449665556,0.09358962953380856,123.69193124771118,57.38368892669678,123.1796875,3273,760,2513,2513,0,12,934000.0
934,934999,21.277064157936447,37.233408676933266,0.09356103715818787,123.861163854599,57.449485540390015,123.2463607788086,3283,765,2518,2518,0,12,935000.0
935,935999,21.27430186117315,37.23067071784329,0.09349820123714003,123.98415303230286,57.51216411590576,123.56884765625,3284,765,2519,2519,0,12,936000.0
936,936999,21.269804337593442,37.22235992204149,0.09349520406496681,124.12528777122498,57.57510590553284,123.64665603637695,3289,767,2522,2522,0,12,937000.0
937,937999,21.26982417296208,37.22251913332102,0.0934258802844542,124.28135943412781,57.63921880722046,123.736083984375,3295,770,2525,2525,0,12,938000.0
938,938999,21.268969994510275,37.22746543651725,0.09333844373422062,124.4109959602356,57.702160596847534,123.97250747680664,3295,770,2525,2525,0,12,939000.0
939,939999,21.270353586791607,37.229335281118196,0.09327404886992607,124.55861186981201,57.76551914215088,124.07154846191406,3297,771,2526,2526,0,12,940000.0
940,940999,21.272606231549016,37.23393005035407,0.09321356881015119,124.70771718025208,57.82850670814514,124.15020751953125,3301,773,2528,2528,0,12,941000.0
941,941999,21.272555213051387,37.23186055695077,0.0931401987717293,124.85505223274231,57.89119338989258,124.1876335144043,3305,775,2530,2530,0,12,942000.0
942,942999,21.27444274597814,37.232865222722914,0.0930639661036392,124.99625515937805,57.95558738708496,124.33145904541016,3309,777,2532,2532,0,12,943000.0
943,943999,21.273630156588055,37.22994903119003,0.09300281325149595,125.12976622581482,58.01898217201233,124.47687149047852,3309,777,2532,2532,0,12,944000.0
944,944999,21.274054756565704,37.23346469483114,0.0929137982355468,125.25549817085266,58.081844329833984,124.65585327148438,3309,777,2532,2532,0,12,945000.0
945,945999,21.274173484441896,37.23037498343833,0.0928710845698455,125.42829132080078,58.146000385284424,125.08119583129883,3336,780,2556,2556,0,12,946000.0
946,946999,21.275045656735713,37.24327610725102,0.09246718037639046,125.55072712898254,58.20995283126831,125.92448806762695,3353,781,2572,2572,0,12,947000.0
947,947999,21.270463474234603,37.235684709631364,0.09238988842025952,125.6800811290741,58.273075103759766,126.22708129882812,3356,782,2574,2574,0,12,948000.0
948,948999,21.265244143673804,37.22615145875363,0.09233599824951932,125.79831981658936,58.336111307144165,126.58087921142578,3356,782,2574,2574,0,12,949000.0
949,949999,21.262852843324257,37.22550071851428,0.09224105692603479,125.92019319534302,58.39788246154785,126.76187133789062,3358,783,2575,2575,0,12,950000.0
950,950999,21.259098618750386,37.218242854858175,0.09217199354331151,126.0846254825592,58.460941791534424,126.77738189697266,3369,788,2581,2581,0,12,951000.0
951,951999,21.255834385169003,37.20972845314406,0.09210043159675696,126.19650077819824,58.52421426773071,127.11004638671875,3369,788,2581,2581,0,12,952000.0
952,952999,21.25226235638211,37.2022804298575,0.09202901844394018,126.33576607704163,58.5870943069458,127.21618270874023,3374,790,2584,2584,0,12,953000.0
953,953999,21.24801727161789,37.1936136315574,0.09199144040973317,126.5123360157013,58.65183091163635,127.14349746704102,3384,795,2589,2589,0,12,954000.0
954,954999,21.24483613408943,37.18982256333431,0.09192306216486068,126.66862273216248,58.715277910232544,127.32014465332031,3392,798,2594,2594,0,12,955000.0
955,955999,21.24205328128549,37.18315936887533,0.09190203263102292,126.79321026802063,58.77832794189453,127.5771713256836,3392,798,2594,2594,0,12,956000.0
956,956999,21.23974800730446,37.17815171575896,0.09184183787905986,126.94528269767761,58.84284043312073,127.59586715698242,3399,801,2598,2598,0,12,957000.0
957,957999,21.239161446053554,37.17461719454401,0.09180635701019013,127.0865249633789,58.90626835823059,127.7902717590332,3404,803,2601,2601,0,12,958000.0
958,958999,21.23823899925172,37.16917538942945,0.0917511843482377,127.22037410736084,58.97139859199524,127.97717666625977,3404,803,2601,2601,0,12,959000.0
959,959999,21.23975085503519,37.16910856828857,0.09171631347704134,127.34607362747192,59.0354163646698,128.09763717651367,3406,804,2602,2602,0,12,960000.0
960,960999,21.24296011536206,37.17386641416502,0.09167135918405656,127.47035241127014,59.0985164642334,128.30026245117188,3406,804,2602,2602,0,12,961000.0
961,961999,21.244922351525396,37.17480765073485,0.09160403319446064,127.62780284881592,59.16236233711243,128.16580200195312,3412,807,2605,2605,0,12,962000.0
962,962999,21.246329361863058,37.17294979375676,0.09159266821205736,127.78045797348022,59.22589659690857,128.33147811889648,3416,809,2607,2607,0,12,963000.0
963,963999,21.249751546397235,37.173379219106224,0.09154954741671084,127.92668628692627,59.28948378562927,128.5049591064453,3423,810,2613,2613,0,12,964000.0
964,964999,21.252714146798066,37.17247009843827,0.09151261174972858,128.06028509140015,59.35302448272705,128.53822708129883,3425,811,2614,2614,0,12,965000.0
965,965999,21.252803966963562,37.1660662153974,0.09151172807289654,128.17732453346252,59.416319131851196,128.70372772216797,3425,811,2614,2614,0,12,966000.0
966,966999,21.254829515997,37.170695778557,0.0912653691696459,128.31123089790344,59.48146033287048,129.75786590576172,3457,811,2646,2646,0,12,967000.0
967,967999,21.249980299491924,37.164878446035814,0.09105474632288835,128.42879462242126,59.54495358467102,130.39797973632812,3461,811,2650,2650,0,12,968000.0
968,968999,21.245338703305787,37.157467863953336,0.09084643534757175,128.54084038734436,59.607197523117065,130.73912811279297,3461,811,2650,2650,0,12,969000.0
969,969999,21.240734532975296,37.151616346236466,0.09067791571551409,128.67064595222473,59.670366287231445,130.99453353881836,3463,812,2651,2651,0,12,970000.0
970,970999,21.23575756214681,37.14302295900775,0.09053761884174305,128.78605914115906,59.73240780830383,131.1943588256836,3463,812,2651,2651,0,12,971000.0
971,971999,21.230157342380753,37.13228425513505,0.09042762277265548,128.93784976005554,59.79518914222717,131.27542114257812,3471,815,2656,2656,0,12,972000.0
972,972999,21.224270825976703,37.12238438833157,0.09031617988449159,129.06446290016174,59.85895371437073,131.45558547973633,3474,816,2658,2658,0,12,973000.0
973,973999,21.219827085734114,37.1140292291621,0.09017135484784622,129.1952657699585,59.92158102989197,131.56671524047852,3478,818,2660,2660,0,12,974000.0
974,974999,21.214634286214505,37.10376453850367,0.0900670357552058,129.3882119655609,59.98548245429993,131.51833724975586,3488,823,2665,2665,0,12,975000.0
975,975999,21.20985021575891,37.093975242665145,0.08996214998482543,129.5278205871582,60.048951148986816,131.75460815429688,3494,825,2669,2669,0,12,976000.0
976,976999,21.206115512630134,37.089173316975334,0.08986798724945022,129.65553307533264,60.111921548843384,131.9281005859375,3497,826,2671,2671,0,12,977000.0
977,977999,21.20139355150328,37.07852848814327,0.08979438201314405,129.8198947906494,60.17530870437622,132.00597763061523,3504,829,2675,2675,0,12,978000.0
978,978999,21.198918110207856,37.095320602878296,0.08957250053234156,129.95321798324585,60.23865985870361,132.18572616577148,3506,830,2676,2676,0,12,979000.0
979,979999,21.194631906169736,37.087024449167494,0.08949119266472871,130.10709428787231,60.30197739601135,132.0981903076172,3516,834,2682,2682,0,12,980000.0
980,980999,21.189316043058163,37.07652689812011,0.08945146452701436,130.22439885139465,60.365336656570435,132.38241958618164,3516,834,2682,2682,0,12,981000.0
981,981999,21.186886392636875,37.07157335426846,0.08938476612679869,130.3541054725647,60.42877793312073,132.57983779907227,3516,834,2682,2682,0,12,982000.0
982,982999,21.18367758581582,37.0642984799951,0.08932903227000966,130.51444172859192,60.49281144142151,132.586181640625,3520,836,2684,2684,0,12,983000.0
983,983999,21.17927793057342,37.05494598927022,0.08928525087205563,130.68346786499023,60.55632710456848,132.4429054260254,3530,841,2689,2689,0,12,984000.0
984,984999,21.17589045593798,37.046753113811235,0.089241732192474,130.81072807312012,60.619770765304565,132.6721954345703,3530,841,2689,2689,0,12,985000.0
985,985999,21.17144224012938,37.0370794437515,0.08920084411924845,130.95115447044373,60.68396067619324,132.81519317626953,3530,841,2689,2689,0,12,986000.0
986,986999,21.166128752441576,37.026352524661675,0.08917859812645379,131.06725358963013,60.746936321258545,133.00447845458984,3530,841,2689,2689,0,12,987000.0
987,987999,21.16775410469858,37.041657553511854,0.08911603625410514,131.1935691833496,60.81207609176636,134.29370498657227,3566,841,2725,2725,0,12,988000.0
988,988999,21.17595811834589,37.075652148297046,0.08884793635029076,131.31157445907593,60.87520909309387,134.87472534179688,3569,841,2728,2728,0,12,989000.0
989,989999,21.186304321955642,37.12858020386371,0.08892054821215778,131.4308216571808,60.93837308883667,135.22851943969727,3569,841,2728,2728,0,12,990000.0
990,990999,21.188017230095937,37.13135539478619,0.08900200746462195,131.56385827064514,61.00145363807678,135.47622680664062,3572,842,2730,2730,0,12,991000.0
991,991999,21.191454518446314,37.13410943584254,0.0889216273000919,131.68248987197876,61.06484913825989,135.74272537231445,3572,842,2730,2730,0,12,992000.0
992,992999,21.198436940550692,37.14687311043532,0.08872020697960892,131.83768129348755,61.12764596939087,135.76348495483398,3592,846,2746,2746,0,12,993000.0
993,993999,21.201618906728573,37.14917638577438,0.08869699672971887,131.96273136138916,61.19051957130432,135.9723014831543,3594,847,2747,2747,0,12,994000.0
994,994999,21.20427327282387,37.153520999012954,0.08868530368309757,132.10322666168213,61.25407862663269,136.1327362060547,3597,848,2749,2749,0,12,995000.0
995,995999,21.206237201631364,37.153845958004645,0.08871549272239565,132.27025985717773,61.31892728805542,136.19735717773438,3607,852,2755,2755,0,12,996000.0
996,996999,21.207879062477314,37.15420187443122,0.08871682561124228,132.41015601158142,61.382211208343506,136.3165626525879,3611,854,2757,2757,0,12,997000.0
997,997999,21.209958335206395,37.15235004275876,0.08863759572537,132.544775724411,61.44552731513977,136.59576416015625,3614,855,2759,2759,0,12,998000.0
998,998999,21.211304681113962,37.153203696705376,0.08859965802071079,132.71711683273315,61.50904726982117,136.58602905273438,3624,860,2764,2764,0,12,999000.0
999,999999,21.213526597035965,37.15755780437517,0.08850222295858001,132.84633255004883,61.57259130477905,136.78650665283203,3626,861,2765,2765,0,12,1000000.0
1000,1000999,21.214620375349902,37.15756677769341,0.08827118410887957,132.9748775959015,61.63752794265747,136.9701042175293,3628,862,2766,2766,0,12,1001000.0
1001,1001999,21.216810277988667,37.16735602563991,0.08816319583965315,133.1393585205078,61.70188045501709,136.98336029052734,3645,865,2780,2780,0,12,1002000.0
1002,1002999,21.21954293924045,37.16886454694307,0.0880062687823917,133.28702020645142,61.76522207260132,136.97489547729492,3651,868,2783,2783,0,12,1003000.0
1003,1003999,21.2211291484131,37.16738476071196,0.08788321853435155,133.43836975097656,61.82941794395447,137.13636779785156,3655,870,2785,2785,0,12,1004000.0
1004,1004999,21.22328831971657,37.16503018073537,0.08778072681130189,133.57988715171814,61.89410138130188,137.28567504882812,3657,871,2786,2786,0,12,1005000.0
1005,1005999,21.223527232403814,37.16129067857607,0.0877149741953166,133.72326135635376,61.957587242126465,137.43024826049805,3657,871,2786,2786,0,12,1006000.0
1006,1006999,21.224634439491687,37.164913585169224,0.0876333157204483,133.84184765815735,62.0248818397522,137.5936737060547,3657,871,2786,2786,0,12,1007000.0
1007,1007999,21.223276728310022,37.15951503020168,0.08754584376933305,134.50300455093384,62.09151816368103,138.8106575012207,3695,872,2823,2823,0,12,1008000.0
1008,1008999,21.220096712548994,37.15794799909913,0.0874115966971607,134.6301679611206,62.155678510665894,139.39365768432617,3703,873,2830,2830,0,12,1009000.0
1009,1009999,21.215432220075225,37.152172474238355,0.08734455642077432,134.76292204856873,62.218910217285156,139.75985717773438,3705,874,2831,2831,0,12,1010000.0
1010,1010999,21.210712894821476,37.14706335433033,0.08731133251501733,134.87862491607666,62.28178358078003,140.14056015014648,3705,874,2831,2831,0,12,1011000.0
1011,1011999,21.20710764970876,37.141340969714165,0.08727307825031472,135.0364272594452,62.34562063217163,140.25491333007812,3711,877,2834,2834,0,12,1012000.0
1012,1012999,21.20256558499663,37.133597922039286,0.08725972659803216,135.16609644889832,62.40892744064331,140.53808975219727,3713,878,2835,2835,0,12,1013000.0
1013,1013999,21.199220695320893,37.12657037708571,0.08722747728157665,135.29308795928955,62.4743447303772,140.78441619873047,3715,879,2836,2836,0,12,1014000.0
1014,1014999,21.1955345169748,37.12154700665361,0.08720937493946912,135.44926571846008,62.538344383239746,140.9059600830078,3723,882,2841,2841,0,12,1015000.0
1015,1015999,21.191242450566797,37.113802903111534,0.08723169670391817,135.61560225486755,62.60233116149902,140.97529220581055,3732,886,2846,2846,0,12,1016000.0
1016,1016999,21.188593351823606,37.10818614726419,0.08726972291680979,135.7575821876526,62.66646361351013,141.2320785522461,3736,888,2848,2848,0,12,1017000.0
1017,1017999,21.190203161408032,37.10833405562758,0.08734065308555783,135.9089379310608,62.73290777206421,141.41686630249023,3741,890,2851,2851,0,12,1018000.0
1018,1018999,21.193187750946432,37.1134614371414,0.08736576630628012,136.0781557559967,62.801785945892334,141.56900024414062,3747,893,2854,2854,0,12,1019000.0
1019,1019999,21.19508845549773,37.11418339566822,0.08744446628677183,136.22759008407593,62.86660289764404,141.71731185913086,3751,895,2856,2856,0,12,1020000.0
1020,1020999,21.196473455523186,37.11409448207045,0.08752052425344803,136.37375116348267,62.93083190917969,141.8091812133789,3755,897,2858,2858,0,12,1021000.0
1021,1021999,21.201111766928836,37.118476938396675,0.08754777463087371,136.5028235912323,62.99693059921265,142.0436248779297,3755,897,2858,2858,0,12,1022000.0
1022,1022999,21.205391242110206,37.12226881471537,0.08757844490635613,136.67140817642212,63.06159424781799,142.15161514282227,3759,899,2860,2860,0,12,1023000.0
1023,1023999,21.20960547164222,37.123231527725416,0.08758227888039194,136.82252311706543,63.12630867958069,142.2095489501953,3765,902,2863,2863,0,12,1024000.0
1024,1024999,21.213307387846445,37.123316248954275,0.08757843795083264,136.99388766288757,63.19066786766052,142.30484771728516,3769,904,2865,2865,0,12,1025000.0
1025,1025999,21.219113098584447,37.12815386060703,0.08754843538920021,137.13743948936462,63.254830837249756,142.4117660522461,3771,905,2866,2866,0,12,1026000.0
1026,1026999,21.22226032186882,37.12810314075515,0.08750900034574627,137.2682523727417,63.31905674934387,142.5614242553711,3773,906,2867,2867,0,12,1027000.0
1027,1027999,21.222792197978535,37.12377199907263,0.08748650017634418,137.39461827278137,63.3827862739563,142.8078155517578,3773,906,2867,2867,0,12,1028000.0
1028,1028999,21.21867366451582,37.116585249821775,0.08741603204882198,137.5310254096985,63.449827432632446,144.16155242919922,3814,907,2907,2907,0,12,1029000.0
1029,1029999,21.21396141685087,37.110663608677996,0.08737118013276057,137.64077019691467,63.51324725151062,144.71900177001953,3818,907,2911,2911,0,12,1030000.0
1030,1030999,21.209934297281436,37.10307058488364,0.0873357466381135,137.75119709968567,63.57517695426941,145.07727813720703,3818,907,2911,2911,0,12,1031000.0
1031,1031999,21.20445095086128,37.093232120592056,0.08733808602327175,137.87772393226624,63.63739228248596,145.36911392211914,3820,908,2912,2912,0,12,1032000.0
1032,1032999,21.199061130106823,37.08460584755482,0.0873127156221466,138.0368936061859,63.70059943199158,145.49420547485352,3827,911,2916,2916,0,12,1033000.0
1033,1033999,21.194401172462033,37.07700107068164,0.08730086367747403,138.17491459846497,63.76372528076172,145.67303085327148,3831,913,2918,2918,0,12,1034000.0
1034,1034999,21.18966419600883,37.06977273362759,0.08728070270279142,138.30273604393005,63.82785415649414,145.88216018676758,3833,914,2919,2919,0,12,1035000.0
1035,1035999,21.185189797224993,37.0647962015962,0.08723585121548783,138.4670000076294,63.89104676246643,145.86252975463867,3842,918,2924,2924,0,12,1036000.0
1036,1036999,21.1813174361184,37.06050679607184,0.08720958110042742,138.5905134677887,63.95366334915161,146.16167068481445,3843,918,2925,2925,0,12,1037000.0
1037,1037999,21.17820244304689,37.05446800283448,0.08717354168782532,138.72082662582397,64.01758909225464,146.3509979248047,3845,919,2926,2926,0,12,1038000.0
1038,1038999,21.17588178528245,37.04783029522505,0.08715692133340536,138.8672318458557,64.08099699020386,146.46681213378906,3850,921,2929,2929,0,12,1039000.0
1039,1039999,21.173455099554964,37.042489195763594,0.08713189511725017,139.0244870185852,64.14433264732361,146.46656036376953,3858,925,2933,2933,0,12,1040000.0
1040,1040999,21.172937091315795,37.0408459229595,0.08709914434296151,139.16133069992065,64.20796465873718,146.57819747924805,3862,927,2935,2935,0,12,1041000.0
1041,1041999,21.17192533534658,37.036246097015386,0.08704910635201979,139.2923984527588,64.27123141288757,146.8399543762207,3862,927,2935,2935,0,12,1042000.0
1042,1042999,21.173052036120673,37.034620939377426,0.08701104904285983,139.43247032165527,64.33461880683899,146.92787170410156,3864,928,2936,2936,0,12,1043000.0
1043,1043999,21.17522337280206,37.036109804110424,0.08698810160763515,139.59674263000488,64.39828133583069,146.93678665161133,3870,931,2939,2939,0,12,1044000.0
1044,1044999,21.176063408844307,37.035764458354414,0.08694511307982511,139.7277591228485,64.46242666244507,147.20393753051758,3870,931,2939,2939,0,12,1045000.0
1045,1045999,21.17771631670997,37.0355301542088,0.08687889585034081,139.88432955741882,64.5261812210083,147.1390151977539,3876,934,2942,2942,0,12,1046000.0
1046,1046999,21.180805209105642,37.03786401963786,0.08683479555558271,140.00917530059814,64.5894067287445,147.35332870483398,3876,934,2942,2942,0,12,1047000.0
1047,1047999,21.18330898861669,37.037445991863734,0.08679538591122127,140.14502382278442,64.6528959274292,147.5660858154297,3876,934,2942,2942,0,12,1048000.0
1048,1048999,21.181617908337394,37.03031769071469,0.08676727749839352,140.26857948303223,64.71774411201477,147.8252830505371,3876,934,2942,2942,0,12,1049000.0
1049,1049999,21.17933629905747,37.02851695987172,0.08664864917737514,140.40345072746277,64.78298306465149,149.13976287841797,3915,935,2980,2980,0,12,1050000.0
1050,1050999,21.17571512354823,37.02173695039957,0.08663600704751317,140.52543592453003,64.84590697288513,149.67945098876953,3950,936,3014,3014,0,12,1051000.0
1051,1051999,21.169195080852003,37.01095781367865,0.08665760956121216,140.66403794288635,64.90905141830444,149.97296142578125,3955,938,3017,3017,0,12,1052000.0
1052,1052999,21.166096427418843,37.00371803150432,0.08663783520136925,140.7853865623474,64.97157216072083,150.26752090454102,3976,939,3037,3037,0,12,1053000.0
1053,1053999,21.16127927062373,36.994335527557205,0.08664515121638283,140.92689108848572,65.03464889526367,150.47953033447266,3980,941,3039,3039,0,12,1054000.0
1054,1054999,21.15987796359641,36.99603768213409,0.08660777485928639,141.0404875278473,65.09834790229797,150.7352066040039,3980,941,3039,3039,0,12,1055000.0
1055,1055999,21.16033857414908,37.005452179673355,0.08651804651253014,141.18535828590393,65.16139245033264,150.8975944519043,3984,943,3041,3041,0,12,1056000.0
1056,1056999,21.162172337113052,37.018479894589795,0.08642963428242867,141.34073138237,65.22440695762634,150.97897720336914,3991,946,3045,3045,0,12,1057000.0
1057,1057999,21.170341020097148,37.074585908562405,0.08624325547152456,141.49556493759155,65.28938269615173,151.17632675170898,3996,948,3048,3048,0,12,1058000.0
1058,1058999,21.174771257096243,37.086516146381214,0.08630195335622404,141.65194869041443,65.35236763954163,151.19009399414062,4002,951,3051,3051,0,12,1059000.0
1059,1059999,21.179654610905832,37.11429649643286,0.08624130369183836,141.81501460075378,65.41655039787292,151.2847785949707,4013,954,3059,3059,0,12,1060000.0
1060,1060999,21.18539676215071,37.13854873691373,0.08623096261213936,141.96743607521057,65.48012685775757,151.44773864746094,4017,956,3061,3061,0,12,1061000.0
1061,1061999,21.194894227467266,37.176716992936235,0.08632816803453147,142.0875391960144,65.54316401481628,151.71623611450195,4017,956,3061,3061,0,12,1062000.0
1062,1062999,21.20328597728604,37.20182502204913,0.08651275424953209,142.22554779052734,65.60610246658325,151.8516502380371,4022,958,3064,3064,0,12,1063000.0
1063,1063999,21.213189048724946,37.23268298814435,0.08648746956289377,142.3661870956421,65.6704933643341,152.01240158081055,4026,960,3066,3066,0,12,1064000.0
1064,1064999,21.21796477668678,37.24318626585531,0.0863976048533387,142.52601504325867,65.73583436012268,152.97816467285156,4058,960,3098,3098,0,12,1065000.0
1065,1065999,21.22210805246883,37.25897071768661,0.08623273658853503,142.63807320594788,65.79899621009827,153.82675552368164,4068,960,3108,3108,0,12,1066000.0
1066,1066999,21.226527126547555,37.27370766399721,0.08618662142143929,142.76801800727844,65.8612973690033,154.3092384338379,4068,960,3108,3108,0,12,1067000.0
1067,1067999,21.230226068932748,37.29212794087707,0.08612212090415705,142.88747453689575,65.92458081245422,154.6830291748047,4069,960,3109,3109,0,12,1068000.0
1068,1068999,21.233107111082283,37.29633830831532,0.08607563134720841,143.0045096874237,65.98681688308716,154.97193145751953,4069,960,3109,3109,0,12,1069000.0
1069,1069999,21.238972629111238,37.31771398461436,0.08612866351436388,143.12595176696777,66.04910492897034,155.11128616333008,4072,961,3111,3111,0,12,1070000.0
1070,1070999,21.24378829523781,37.331282979342035,0.08617260040980168,143.26537036895752,66.11211609840393,155.32379150390625,4077,963,3114,3114,0,12,1071000.0
1071,1071999,21.248747966409553,37.34037645496422,0.0862512343773667,143.4205083847046,66.17500162124634,155.39081573486328,4086,966,3120,3120,0,12,1072000.0
1072,1072999,21.25363090075004,37.347504134226725,0.08635990211208366,143.54841899871826,66.23784899711609,155.60526657104492,4089,967,3122,3122,0,12,1073000.0
1073,1073999,21.26229865233518,37.372690753880896,0.08642225251910884,143.69816875457764,66.30062770843506,155.67328262329102,4095,970,3125,3125,0,12,1074000.0
1074,1074999,21.273593691600535,37.413850999405575,0.08649694323148915,143.86207246780396,66.3640992641449,155.68228912353516,4105,974,3131,3131,0,12,1075000.0
1075,1075999,21.283237048438693,37.42868296410088,0.08666274971146382,144.02397179603577,66.4282443523407,155.8390350341797,4109,976,3133,3133,0,12,1076000.0
1076,1076999,21.296222232536927,37.452708269734046,0.08690204511314348,144.15641593933105,66.49148321151733,155.99163436889648,4113,978,3135,3135,0,12,1077000.0
1077,1077999,21.308911737266282,37.47843151056739,0.08730112579636073,144.32050609588623,66.55498838424683,156.0158233642578,4148,981,3167,3167,0,12,1078000.0
1078,1078999,21.32476253377393,37.520900753801634,0.08746060340276507,144.45334792137146,66.61819195747375,156.20682525634766,4150,982,3168,3168,0,12,1079000.0
1079,1079999,21.341811855146517,37.55975532072022,0.08772191426166431,144.5746467113495,66.68165397644043,156.45025253295898,4150,982,3168,3168,0,12,1080000.0
1080,1080999,21.36052975044078,37.60437630510555,0.08813677397156738,144.72718906402588,66.74526572227478,156.5088233947754,4156,985,3171,3171,0,12,1081000.0
1081,1081999,21.378482098097372,37.66299630168048,0.08847775767616506,144.89151859283447,66.80907344818115,156.64699935913086,4160,987,3173,3173,0,12,1082000.0
1082,1082999,21.385907564448704,37.6808985828236,0.08810576510301849,145.0263433456421,66.87576603889465,158.02801132202148,4203,988,3215,3215,0,12,1083000.0
1083,1083999,21.385279748061986,37.68286099954568,0.08804054100493475,145.13574719429016,66.93953251838684,158.62677383422852,4207,988,3219,3219,0,12,1084000.0
1084,1084999,21.38667161981375,37.696819900936944,0.08795663187690872,145.2726330757141,67.00212955474854,158.84648513793945,4213,990,3223,3223,0,12,1085000.0
1085,1085999,21.38772482552981,37.70194466620679,0.08791853956410456,145.40373921394348,67.0659499168396,159.0953025817871,4218,992,3226,3226,0,12,1086000.0
1086,1086999,21.388598300698554,37.70221619483404,0.08795157903915096,145.5461621284485,67.129399061203,159.37185287475586,4222,994,3228,3228,0,12,1087000.0
1087,1087999,21.390818429768373,37.72191400246301,0.08790083345696553,145.69401168823242,67.19408774375916,159.59521865844727,4228,997,3231,3231,0,12,1088000.0
1088,1088999,21.3935393552115,37.725629506035034,0.087978993716195,145.8247184753418,67.25701022148132,159.80806732177734,4230,998,3232,3232,0,12,1089000.0
1089,1089999,21.395949405657934,37.727699443431,0.08804798052200791,145.96922302246094,67.32092595100403,160.04180526733398,4235,1000,3235,3235,0,12,1090000.0
1090,1090999,21.40018719236526,37.735607189795864,0.08814760162343682,146.10447573661804,67.38492584228516,160.30549240112305,4238,1001,3237,3237,0,12,1091000.0
1091,1091999,21.405973111952036,37.746005101442684,0.08830180483911942,146.25595450401306,67.44928479194641,160.38964080810547,4244,1004,3240,3240,0,12,1092000.0
1092,1092999,21.41289068772084,37.75376596477499,0.0885042076679754,146.37666535377502,67.51333522796631,160.7171516418457,4245,1004,3241,3241,0,12,1093000.0
1093,1093999,21.419279440518384,37.76243557181107,0.08880481249848127,146.52070665359497,67.57709765434265,160.77906036376953,4249,1006,3243,3243,0,12,1094000.0
1094,1094999,21.425737459805916,37.76938286825653,0.08900688838915782,146.66617918014526,67.64110517501831,160.94722747802734,4251,1007,3244,3244,0,12,1095000.0
1095,1095999,21.43386349510536,37.79158518741627,0.08935168747013511,146.81312131881714,67.70519042015076,161.10579299926758,4255,1009,3246,3246,0,12,1096000.0
1096,1096999,21.44307927434577,37.804093433089,0.08974271529901967,146.94328331947327,67.76899933815002,161.2698097229004,4257,1010,3247,3247,0,12,1097000.0
1097,1097999,21.45234060458206,37.81396051321536,0.0899726002846436,147.12066507339478,67.83420443534851,161.2784652709961,4263,1013,3250,3250,0,12,1098000.0
1098,1098999,21.45932812160664,37.81927425687776,0.0902810091674413,147.26579427719116,67.89805936813354,161.41704559326172,4291,1015,3276,3276,0,12,1099000.0
1099,1099999,21.46762443239315,37.82652973715445,0.0905206861483473,147.40179753303528,67.96228075027466,161.58513641357422,4293,1016,3277,3277,0,12,1100000.0
1100,1100999,21.473514630848353,37.8291702080298,0.09073027691196356,147.5232720375061,68.02703142166138,161.77128219604492,4293,1016,3277,3277,0,12,1101000.0
1101,1101999,21.477942270822787,37.83004245083502,0.0908638322150398,147.6536033153534,68.09115242958069,161.951171875,4293,1016,3277,3277,0,12,1102000.0
1102,1102999,21.478437937395206,37.828305531086635,0.09076951299309888,147.7729856967926,68.15632343292236,163.26970672607422,4333,1016,3317,3317,0,12,1103000.0
1103,1103999,21.47479097773429,37.82643115832792,0.09074233847250268,147.916175365448,68.2211925983429,163.74422073364258,4345,1018,3327,3327,0,12,1104000.0
1104,1104999,21.47092907423807,37.81986306010171,0.09071253427050197,148.05444049835205,68.89079213142395,164.03024673461914,4349,1020,3329,3329,0,12,1105000.0
1105,1105999,21.469107053889076,37.81743955744823,0.09068222389970093,148.17958879470825,68.95455288887024,164.39365768432617,4353,1021,3332,3332,0,12,1106000.0
1106,1106999,21.469067950753562,37.8167276834745,0.09067777910384833,148.32003259658813,69.018718957901,164.5837287902832,4358,1023,3335,3335,0,12,1107000.0
1107,1107999,21.467946435794197,37.812776654571266,0.09066291376670665,148.45740580558777,69.08298134803772,164.83756256103516,4360,1024,3336,3336,0,12,1108000.0
1108,1108999,21.466845024429652,37.80976137644115,0.09065190534283785,148.5854456424713,69.14788699150085,165.05978775024414,4364,1025,3339,3339,0,12,1109000.0
1109,1109999,21.46518415087555,37.80434752703851,0.09063909136790838,148.73971891403198,69.21122622489929,165.2422866821289,4369,1027,3342,3342,0,12,1110000.0
1110,1110999,21.462611230211337,37.796867570174854,0.09062062775976865,148.88961482048035,69.27558207511902,165.35601425170898,4374,1029,3345,3345,0,12,1111000.0
1111,1111999,21.4627239307105,37.79267665911061,0.09060814363102221,149.0146381855011,69.34127426147461,165.6669578552246,4374,1029,3345,3345,0,12,1112000.0
1112,1112999,21.46408700607265,37.79229918051217,0.09059017498438204,149.18262314796448,69.40520238876343,165.78802108764648,4381,1032,3349,3349,0,12,1113000.0
1113,1113999,21.461873975152322,37.78599141603103,0.09057376017527385,149.33951687812805,69.47011518478394,165.86180877685547,4387,1035,3352,3352,0,12,1114000.0
1114,1114999,21.462120669416706,37.78557568459247,0.0905755000847639,149.48984265327454,69.53405737876892,165.93948364257812,4393,1038,3355,3355,0,12,1115000.0
1115,1115999,21.461081378329727,37.77916208091819,0.09052480758729742,149.628657579422,69.59819483757019,166.14432907104492,4395,1039,3356,3356,0,12,1116000.0
1116,1116999,21.45966360478643,37.77528812043789,0.09051735212892065,149.7630512714386,69.66252875328064,166.33344650268555,4395,1039,3356,3356,0,12,1117000.0
1117,1117999,21.458023268048656,37.768278073259694,0.09050016528589544,149.91676545143127,69.72737097740173,166.42298889160156,4400,1041,3359,3359,0,12,1118000.0
1118,1118999,21.456181727860958,37.760987036123275,0.09049774806845923,150.07644820213318,69.79222178459167,166.53200912475586,4404,1043,3361,3361,0,12,1119000.0
1119,1119999,21.45370920823404,37.753618285730454,0.0904671796495633,150.2557098865509,69.85722351074219,166.50508880615234,4412,1047,3365,3365,0,12,1120000.0
1120,1120999,21.45168690924109,37.747031563335035,0.09044877161486864,150.3985288143158,69.92111396789551,166.66629028320312,4414,1048,3366,3366,0,12,1121000.0
1121,1121999,21.448281763968666,37.737784155000504,0.09041706757541734,150.52924299240112,69.98556542396545,166.86418914794922,4414,1048,3366,3366,0,12,1122000.0
1122,1122999,21.446122814338583,37.73006217496654,0.0903763117353823,150.6626513004303,70.05336809158325,167.82592010498047,4447,1048,3399,3399,0,12,1123000.0
1123,1123999,21.44149074970367,37.72836419813474,0.09032550602135914,150.7992067337036,70.11924004554749,168.62518310546875,4464,1049,3415,3415,0,12,1124000.0
1124,1124999,21.43400060436072,37.72146977608933,0.09034274506475248,150.95086860656738,70.18258261680603,168.91028213500977,4470,1051,3419,3419,0,12,1125000.0
1125,1125999,21.427837852824144,37.714380718443316,0.09036973493071687,151.0809519290924,70.2479395866394,169.37246704101562,4472,1052,3420,3420,0,12,1126000.0
1126,1126999,21.42164088397476,37.70931048752813,0.09034667254927731,151.19645595550537,70.31149911880493,169.69104385375977,4472,1052,3420,3420,0,12,1127000.0
1127,1127999,21.414613066924616,37.699435501477225,0.09035579695056062,151.338440656662,70.37522745132446,169.86711502075195,4476,1054,3422,3422,0,12,1128000.0
1128,1128999,21.407950391641034,37.68881556071054,0.09038255757983138,151.49836897850037,70.43934869766235,170.09835052490234,4482,1057,3425,3425,0,12,1129000.0
1129,1129999,21.401909295988563,37.68079207372668,0.09038852073039738,151.63056874275208,70.50438857078552,170.30712127685547,4485,1058,3427,3427,0,12,1130000.0
1130,1130999,21.396801154137293,37.677659138844284,0.09035480854119327,151.80656337738037,70.5683479309082,170.36278915405273,4493,1062,3431,3431,0,12,1131000.0
1131,1131999,21.390669979911284,37.66798682173302,0.09035298537674219,151.95699453353882,70.6322729587555,170.5316162109375,4502,1065,3437,3437,0,12,1132000.0
1132,1132999,21.384968324784108,37.658530320860166,0.09035907881354666,152.09975957870483,70.6961784362793,170.7317123413086,4504,1066,3438,3438,0,12,1133000.0
1133,1133999,21.379953325458906,37.650263173235494,0.09035050101331876,152.2502691745758,70.76047921180725,170.94451141357422,4509,1068,3441,3441,0,12,1134000.0
1134,1134999,21.37504380471703,37.64187984352467,0.09034416293887315,152.3874967098236,70.82467246055603,171.16366958618164,4511,1069,3442,3442,0,12,1135000.0
1135,1135999,21.371420133100465,37.63690526861481,0.0903152868427689,152.5271031856537,70.88954257965088,171.29295349121094,4513,1070,3443,3443,0,12,1136000.0
1136,1136999,21.367989367852854,37.633300881052804,0.09025095161253593,152.6452236175537,70.9530234336853,171.53641891479492,4513,1070,3443,3443,0,12,1137000.0
1137,1137999,21.363149112968905,37.62346842210438,0.09022881092441393,152.79753422737122,71.01735186576843,171.69029998779297,4515,1071,3444,3444,0,12,1138000.0
1138,1138999,21.361369904975025,37.62052720245884,0.0901859856806323,152.97003769874573,71.08137488365173,171.68954849243164,4521,1074,3447,3447,0,12,1139000.0
1139,1139999,21.358926573222046,37.61367959299938,0.09015577325126523,153.10531425476074,71.14643907546997,171.88333129882812,4523,1075,3448,3448,0,12,1140000.0
1140,1140999,21.358003141089217,37.60967979064464,0.09010397835869322,153.22811150550842,71.21017074584961,172.0608024597168,4523,1075,3448,3448,0,12,1141000.0
1141,1141999,21.355813652599306,37.603015703334464,0.09009095660948652,153.36375403404236,71.27373886108398,172.2170867919922,4523,1075,3448,3448,0,12,1142000.0
1142,1142999,21.353646013328287,37.59650972458452,0.09008086178681973,153.48721647262573,71.33755469322205,172.38059997558594,4523,1075,3448,3448,0,12,1143000.0
1143,1143999,21.353573980494975,37.600308368511776,0.08999293077425485,153.6158413887024,71.40337061882019,172.8477439880371,4524,1075,3449,3449,0,12,1144000.0
1144,1144999,21.355169225452475,37.60414125832918,0.08991786491011766,153.75295495986938,71.46289229393005,173.06181716918945,4526,1076,3450,3450,0,12,1145000.0
1145,1145999,21.356909804553784,37.605710337920286,0.08985088473923475,153.88872504234314,71.52189230918884,173.1271095275879,4558,1077,3481,3481,0,12,1146000.0
1146,1146999,21.360794066738077,37.6168024021135,0.08974185535832346,154.0444769859314,71.5819263458252,173.31977462768555,4575,1078,3497,3497,0,12,1147000.0
1147,1147999,21.36229902158033,37.62287359064642,0.08966916707918837,154.162672996521,71.64201498031616,173.7355842590332,4575,1078,3497,3497,0,12,1148000.0
1148,1148999,21.36608992243264,37.63271851035557,0.08963297140646365,154.3205144405365,71.70338416099548,173.78527069091797,4579,1080,3499,3499,0,12,1149000.0
1149,1149999,21.372614744098897,37.6472829789949,0.08964884192071687,154.44708847999573,71.76404857635498,173.91036224365234,4581,1081,3500,3500,0,12,1150000.0
1150,1150999,21.37983885123771,37.66723765839936,0.08982960138437945,154.56696033477783,71.82471823692322,174.14266967773438,4581,1081,3500,3500,0,12,1151000.0
1151,1151999,21.38596411500821,37.675206645538154,0.08995730145020708,154.69895720481873,71.88516187667847,174.30182647705078,4581,1081,3500,3500,0,12,1152000.0
1152,1152999,21.39409021690007,37.69343041371582,0.09030400336559186,154.83614540100098,71.9465262889862,174.37366104125977,4583,1082,3501,3501,0,12,1153000.0
1153,1153999,21.404998528200494,37.71342457126024,0.09072295704360056,154.98946452140808,72.00769352912903,174.36265563964844,4587,1084,3503,3503,0,12,1154000.0
1154,1154999,21.414184769890063,37.72930522510479,0.09100662949095684,155.1381938457489,72.06828737258911,174.41875457763672,4589,1085,3504,3504,0,12,1155000.0
1155,1155999,21.421127973988572,37.7395947239033,0.0913222144859418,155.28434920310974,72.12903714179993,174.44977569580078,4591,1086,3505,3505,0,12,1156000.0
1156,1156999,21.431086723374356,37.75510865570855,0.09158340668562048,155.42864894866943,72.19027352333069,174.45439910888672,4592,1087,3505,3505,0,12,1157000.0
1157,1157999,21.443722140968898,37.78479668651826,0.09192798279138792,155.55998182296753,72.25132870674133,174.49434661865234,4594,1088,3506,3506,0,12,1158000.0
1158,1158999,21.457066195169773,37.81349114826914,0.0922952372745478,155.71132922172546,72.31422019004822,174.92334365844727,4613,1090,3523,3523,0,12,1159000.0
1159,1159999,21.471466897891432,37.84063725187361,0.09276320483388123,155.83469796180725,72.37620282173157,175.2608985900879,4614,1090,3524,3524,0,12,1160000.0
1160,1160999,21.484613338610735,37.86000812362961,0.09307345782418541,155.95404076576233,72.43736624717712,175.4650421142578,4614,1090,3524,3524,0,12,1161000.0
1161,1161999,21.497392274397694,37.8767917114313,0.09360725763103639,156.07564568519592,72.49879574775696,175.62779235839844,4614,1090,3524,3524,0,12,1162000.0
1162,1162999,21.508183428541493,37.89404273952803,0.09399454177445898,156.21662831306458,72.56039118766785,175.74201202392578,4616,1091,3525,3525,0,12,1163000.0
1163,1163999,21.521743196705,37.92151487333282,0.09297377666000306,156.35616874694824,72.62205171585083,176.18538284301758,4618,1092,3526,3526,0,12,1164000.0
1164,1164999,21.52943611160362,37.93622070412896,0.09254242750871144,156.48500323295593,72.68370628356934,176.32872009277344,4620,1093,3527,3527,0,12,1165000.0
1165,1165999,21.537292749640297,37.94553206906644,0.09227341590623739,156.62996530532837,72.74524736404419,176.5385856628418,4620,1093,3527,3527,0,12,1166000.0
1166,1166999,21.54442713834654,37.9549014757628,0.09213392776607399,156.76498341560364,72.80722761154175,176.71095657348633,4620,1093,3527,3527,0,12,1167000.0
1167,1167999,21.549695388278856,37.9766170205119,0.09191784515935253,156.8889398574829,72.86895608901978,176.8119125366211,4622,1094,3528,3528,0,12,1168000.0
1168,1168999,21.556160155187133,37.98127245246727,0.09182256446685455,157.03237962722778,72.9308488368988,176.83368301391602,4626,1096,3530,3530,0,12,1169000.0
1169,1169999,21.562133500756232,37.98779949880002,0.09200005361755559,157.15077567100525,72.99212408065796,176.9531593322754,4626,1096,3530,3530,0,12,1170000.0
1170,1170999,21.56848521813752,37.995330598521974,0.09213688463828684,157.29776096343994,73.0545449256897,177.08404922485352,4626,1096,3530,3530,0,12,1171000.0
1171,1171999,21.574770598809675,38.00222263540064,0.09216983156751413,157.4296042919159,73.11618399620056,177.1813201904297,4626,1096,3530,3530,0,12,1172000.0
1172,1172999,21.58335619300666,38.01597464936339,0.09252706885558049,157.5792510509491,73.17780995368958,177.25386428833008,4626,1096,3530,3530,0,12,1173000.0
1173,1173999,21.594865254374376,38.03652642456876,0.09287760325821315,157.7301115989685,73.2460024356842,177.33767318725586,4626,1096,3530,3530,0,12,1174000.0
1174,1174999,21.60274173126932,38.04498602463989,0.09324294289523971,157.87410807609558,73.30778670310974,177.33239364624023,4628,1097,3531,3531,0,12,1175000.0
1175,1175999,21.612551993559954,38.0625290704639,0.09352706412236944,158.0061686038971,73.36952686309814,177.41029739379883,4628,1097,3531,3531,0,12,1176000.0
1176,1176999,21.623099665638563,38.08372318769288,0.09362179148372285,158.15830826759338,73.43122839927673,177.41857147216797,4630,1098,3532,3532,0,12,1177000.0
1177,1177999,21.637369521182155,38.1141441000607,0.09387201460655559,158.2909450531006,73.4928367137909,177.47134017944336,4630,1098,3532,3532,0,12,1178000.0
1178,1178999,21.646578122680122,38.1257408514736,0.09401989816206613,158.4114706516266,73.55451250076294,177.54726028442383,4630,1098,3532,3532,0,12,1179000.0
1179,1179999,21.65627120142691,38.1452566165309,0.09427889556295643,158.59249234199524,73.61650109291077,177.28704071044922,4638,1102,3536,3536,0,12,1180000.0
1180,1180999,21.66862149112553,38.16437523658114,0.09470060432548366,158.74938821792603,73.6784017086029,177.25274658203125,4642,1104,3538,3538,0,12,1181000.0
1181,1181999,21.677563411825872,38.17405270626071,0.09492931759283085,158.88351464271545,73.7407898902893,177.37430572509766,4643,1104,3539,3539,0,12,1182000.0
1182,1182999,21.684563545308052,38.182597544654904,0.0949973027715677,159.02825045585632,73.80269956588745,177.3901710510254,4645,1105,3540,3540,0,12,1183000.0
1183,1183999,21.696298925734755,38.20041554299005,0.09426708623140889,159.18413257598877,73.86485028266907,177.77223205566406,4648,1106,3542,3542,0,12,1184000.0
1184,1184999,21.703671785678974,38.20473345520657,0.09396957922428528,159.31516766548157,73.9262216091156,177.95980834960938,4648,1106,3542,3542,0,12,1185000.0
1185,1185999,21.709661444447942,38.21052769362984,0.09366267351441304,159.44135642051697,73.988849401474,178.05121612548828,4651,1107,3544,3544,0,12,1186000.0
1186,1186999,21.713519590911122,38.211830543287476,0.09349134392546299,159.58664917945862,74.05074191093445,178.18722534179688,4651,1107,3544,3544,0,12,1187000.0
1187,1187999,21.71673018361248,38.21067836972243,0.09334250216448114,159.71681261062622,74.11251425743103,178.29018020629883,4651,1107,3544,3544,0,12,1188000.0
1188,1188999,21.720158051094874,38.209660857492395,0.09311002126518664,159.85177302360535,74.17431616783142,178.3815574645996,4651,1107,3544,3544,0,12,1189000.0
1189,1189999,21.723746913531816,38.21104880385847,0.09286521241285828,159.99763989448547,74.23967003822327,178.4570770263672,4651,1107,3544,3544,0,12,1190000.0
1190,1190999,21.726094854892764,38.21108310027022,0.09275938388241967,160.1336052417755,74.30152297019958,178.54418563842773,4651,1107,3544,3544,0,12,1191000.0
1191,1191999,21.72942818028752,38.218897630909225,0.09262400909515789,160.26683521270752,74.36330938339233,178.6133270263672,4651,1107,3544,3544,0,12,1192000.0
1192,1192999,21.731859291087762,38.216147567944674,0.09252098634505346,160.38925957679749,74.42507314682007,178.67544174194336,4651,1107,3544,3544,0,12,1193000.0
1193,1193999,21.734139245185307,38.212604003615574,0.09248750673382256,160.5205774307251,74.48663997650146,178.7369041442871,4651,1107,3544,3544,0,12,1194000.0
1194,1194999,21.736049196190105,38.20966138698531,0.09243042289377401,160.68458700180054,74.54854464530945,178.68172454833984,4653,1108,3545,3545,0,12,1195000.0
1195,1195999,21.73840738662209,38.206063300315755,0.09234523592955424,160.82517910003662,74.61138463020325,178.7654037475586,4653,1108,3545,3545,0,12,1196000.0
1196,1196999,21.741667911968726,38.20318565274973,0.09231338648778431,160.95098400115967,74.67285943031311,178.81463241577148,4653,1108,3545,3545,0,12,1197000.0
1197,1197999,21.744214692457653,38.19967745088072,0.09216605746543749,161.0704128742218,74.73411059379578,178.87083053588867,4653,1108,3545,3545,0,12,1198000.0
1198,1198999,21.746872537066597,38.19639943504362,0.09205911132530653,161.22880625724792,74.79609227180481,178.8117218017578,4656,1109,3547,3547,0,12,1199000.0
1199,1199999,21.748756438708895,38.19309803972573,0.09200998606298816,161.35778045654297,74.85787081718445,178.88091659545898,4656,1109,3547,3547,0,12,1200000.0
1200,1200999,21.752417768237436,38.198718011728076,0.09169348473532468,161.4953966140747,74.91912341117859,179.0924415588379,4658,1109,3549,3549,0,12,1201000.0
1201,1201999,21.75672716266948,38.210431534458024,0.09140135660153437,161.63902521133423,74.9808235168457,179.21671676635742,4658,1109,3549,3549,0,12,1202000.0
1202,1202999,21.759310558989107,38.211600405635025,0.09115102067984915,161.78212761878967,75.04315137863159,179.34363174438477,4658,1109,3549,3549,0,12,1203000.0
1203,1203999,21.759578626195122,38.20720772132337,0.09098310878113858,161.92967653274536,75.10616111755371,179.3315315246582,4662,1111,3551,3551,0,12,1204000.0
1204,1204999,21.76106664113692,38.20687553834584,0.09078292766518958,162.0886960029602,75.17541098594666,179.46195220947266,4664,1112,3552,3552,0,12,1205000.0
1205,1205999,21.762299771698142,38.20415386720008,0.09059682346566555,162.22092723846436,75.23741745948792,179.58059310913086,4664,1112,3552,3552,0,12,1206000.0
1206,1206999,21.762990683340938,38.2006130864444,0.09035761549753496,162.37896084785461,75.3033800125122,179.64839935302734,4664,1112,3552,3552,0,12,1207000.0
1207,1207999,21.76203766490558,38.19385538184588,0.09020039903047905,162.51870584487915,75.36618876457214,179.71381378173828,4664,1112,3552,3552,0,12,1208000.0
1208,1208999,21.762925758750598,38.18845282686321,0.09002478180022888,162.6373953819275,75.42837285995483,179.77022552490234,4664,1112,3552,3552,0,12,1209000.0
1209,1209999,21.762586493503125,38.18197661598801,0.08986513323588341,162.76897978782654,75.49076080322266,179.81060409545898,4664,1112,3552,3552,0,12,1210000.0
1210,1210999,21.763193815288847,38.177384542337634,0.0896710789584394,162.89580059051514,75.55294132232666,179.85353088378906,4664,1112,3552,3552,0,12,1211000.0
1211,1211999,21.762905514752404,38.17277059726784,0.08953230984777394,163.04043793678284,75.61521410942078,179.89510345458984,4664,1112,3552,3552,0,12,1212000.0
1212,1212999,21.762980343176523,38.16888004497405,0.08943620566986077,163.17431712150574,75.67784023284912,179.93269729614258,4664,1112,3552,3552,0,12,1213000.0
1213,1213999,21.763316319773995,38.166116962150106,0.08934177113790465,163.31795811653137,75.74016952514648,179.87938690185547,4666,1113,3553,3553,0,12,1214000.0
1214,1214999,21.76356442759026,38.16217708207585,0.08929009823562828,163.4746732711792,75.80256271362305,179.82880020141602,4670,1114,3556,3556,0,12,1215000.0
1215,1215999,21.76341290554679,38.1574976815614,0.08922624619055941,163.61837530136108,75.86496186256409,179.90402603149414,4670,1114,3556,3556,0,12,1216000.0
1216,1216999,21.763792118840215,38.15469881709216,0.08916667379489218,163.75071835517883,75.92753624916077,179.9471206665039,4670,1114,3556,3556,0,12,1217000.0
1217,1217999,21.763252743236784,38.14946146757254,0.08912824674480602,163.89966773986816,75.98984456062317,179.9933967590332,4670,1114,3556,3556,0,12,1218000.0
1218,1218999,21.76178703478963,38.14366391449236,0.08912704136051897,164.04543280601501,76.05212330818176,180.03969192504883,4670,1114,3556,3556,0,12,1219000.0
1219,1219999,21.760706921331092,38.13814500110945,0.08912271236225278,164.16933512687683,76.11439037322998,180.07427597045898,4670,1114,3556,3556,0,12,1220000.0
1220,1220999,21.762975095204357,38.138984731541754,0.08892225866290271,164.28730964660645,76.17637205123901,180.31126403808594,4673,1114,3559,3559,0,12,1221000.0
1221,1221999,21.762793399863448,38.13483316037788,0.08874499085939436,164.41523838043213,76.2389669418335,180.46343994140625,4673,1114,3559,3559,0,12,1222000.0
1222,1222999,21.763286406157594,38.13201002789617,0.08856496410653658,164.5665783882141,76.30130577087402,180.5196990966797,4675,1115,3560,3560,0,12,1223000.0
1223,1223999,21.762270692716797,38.12513739163329,0.0884373494130265,164.71457505226135,76.36439323425293,180.63162994384766,4677,1116,3561,3561,0,12,1224000.0
1224,1224999,21.76038985470214,38.11799426488885,0.08834917158141564,164.86287140846252,76.42689681053162,180.60334014892578,4681,1118,3563,3563,0,12,1225000.0
1225,1225999,21.75935084408722,38.11100462134575,0.08821889958052109,165.01428198814392,76.48942470550537,180.7289695739746,4681,1118,3563,3563,0,12,1226000.0
1226,1226999,21.758828870371552,38.105488301300205,0.08812413157492871,165.14371728897095,76.55166840553284,180.8153419494629,4681,1118,3563,3563,0,12,1227000.0
1227,1227999,21.758005889282504,38.09877710384462,0.08798618753250054,165.2952299118042,76.61477518081665,180.81780624389648,4683,1119,3564,3564,0,12,1228000.0
1228,1228999,21.75690002246787,38.095249137844455,0.08789971651540385,165.4236340522766,76.67696166038513,180.89585494995117,4683,1119,3564,3564,0,12,1229000.0
1229,1229999,21.7555690387885,38.08795967390739,0.08781506468787359,165.57378911972046,76.73972487449646,180.8932991027832,4685,1120,3565,3565,0,12,1230000.0
1230,1230999,21.75706084055927,38.08674748669674,0.0877135948596891,165.70585203170776,76.8020224571228,180.94897079467773,4685,1120,3565,3565,0,12,1231000.0
1231,1231999,21.757941852263972,38.08569561916621,0.08764230997210964,165.83669805526733,76.86433863639832,180.99506759643555,4685,1120,3565,3565,0,12,1232000.0
1232,1232999,21.75798025755592,38.081881765427475,0.08757258689349867,165.98396253585815,76.92669320106506,181.04090881347656,4685,1120,3565,3565,0,12,1233000.0
1233,1233999,21.758094937381678,38.07912588919221,0.08751081270072969,166.11861419677734,76.98898386955261,181.0710220336914,4685,1120,3565,3565,0,12,1234000.0
1234,1234999,21.758621025975057,38.07790398335382,0.08748642687962915,166.24652576446533,77.05107998847961,181.11425399780273,4685,1120,3565,3565,0,12,1235000.0
1235,1235999,21.76075885733316,38.07976321722578,0.08744645225179426,166.39621329307556,77.11510944366455,181.1458511352539,4685,1120,3565,3565,0,12,1236000.0
1236,1236999,21.761954800131495,38.07839203620756,0.08741318758884109,166.53737545013428,77.17747068405151,181.1801528930664,4685,1120,3565,3565,0,12,1237000.0
1237,1237999,21.76270577323172,38.07562557977968,0.08740856216315784,166.67823839187622,77.23998093605042,181.2027587890625,4685,1120,3565,3565,0,12,1238000.0
1238,1238999,21.76419401506554,38.07440920335228,0.08741783072514231,166.80578112602234,77.30212712287903,181.23612213134766,4685,1120,3565,3565,0,12,1239000.0
1239,1239999,21.764231487820446,38.071177191356504,0.08743735466057667,166.94660115242004,77.36474299430847,181.2715721130371,4685,1120,3565,3565,0,12,1240000.0
1240,1240999,21.763702935826142,38.07367451442749,0.087446207658752,167.08103013038635,77.42691707611084,181.30747604370117,4685,1120,3565,3565,0,12,1241000.0
1241,1241999,21.765331709608294,38.07022333546958,0.08723271218795392,167.21614718437195,77.48857808113098,181.6177864074707,4688,1120,3568,3568,0,12,1242000.0
1242,1242999,21.764262880583605,38.06482451645983,0.08711338159343351,167.36093735694885,77.55119848251343,181.67803192138672,4694,1121,3573,3573,0,12,1243000.0
1243,1243999,21.762086770827764,38.0576549413818,0.08702193586141471,167.52371382713318,77.61349511146545,181.59121322631836,4703,1124,3579,3579,0,12,1244000.0
1244,1244999,21.760168154394382,38.05135439276426,0.08693447977210467,167.6591956615448,77.67586469650269,181.78291702270508,4703,1124,3579,3579,0,12,1245000.0
1245,1245999,21.757819265784708,38.04328356863128,0.08687105474602697,167.80060696601868,77.73800015449524,181.88710021972656,4705,1125,3580,3580,0,12,1246000.0
1246,1246999,21.755180645025032,38.03611937947182,0.08680129740373854,167.94163274765015,77.80036091804504,181.9269676208496,4707,1126,3581,3581,0,12,1247000.0
1247,1247999,21.753083753213403,38.02905240716684,0.08675012965608075,168.0848572254181,77.86287665367126,182.0375747680664,4707,1126,3581,3581,0,12,1248000.0
1248,1248999,21.751831798494646,38.02293568191091,0.08665963950348532,168.243812084198,77.92634010314941,182.0646743774414,4709,1127,3582,3582,0,12,1249000.0
1249,1249999,21.749561104943947,38.01565136769681,0.08661308072387641,168.38607954978943,77.98969650268555,182.14393997192383,4709,1127,3582,3582,0,12,1250000.0
1250,1250999,21.748082881267255,38.011909879068064,0.08655492379870122,168.50852417945862,78.05279564857483,182.22399520874023,4709,1127,3582,3582,0,12,1251000.0
1251,1251999,21.747694544714793,38.00646687528066,0.08648351684843358,168.63487219810486,78.11505031585693,182.28463745117188,4709,1127,3582,3582,0,12,1252000.0
1252,1252999,21.746519878833535,38.00148025835547,0.08643758137660928,168.7700936794281,78.17748689651489,182.32357788085938,4709,1127,3582,3582,0,12,1253000.0
1253,1253999,21.745140073627553,37.997556231543655,0.08636735990706557,168.9188621044159,78.24007606506348,182.2986831665039,4711,1128,3583,3583,0,12,1254000.0
1254,1254999,21.74354227200323,37.99197671480366,0.08634125021448191,169.07580375671387,78.30287981033325,182.30514526367188,4713,1129,3584,3584,0,12,1255000.0
1255,1255999,21.742451707064973,37.98753360807875,0.08635976726325767,169.2139801979065,78.36541938781738,182.3697967529297,4713,1129,3584,3584,0,12,1256000.0
1256,1256999,21.742456848713502,37.99617896593249,0.08630116563548662,169.3643126487732,78.42769122123718,182.42430114746094,4713,1129,3584,3584,0,12,1257000.0
1257,1257999,21.742525701727224,37.992583549177304,0.08625358986795884,169.50922465324402,78.49015998840332,182.40816497802734,4718,1130,3588,3588,0,12,1258000.0
1258,1258999,21.741626246087836,37.98822456448571,0.08625160551742639,169.6479434967041,78.55296492576599,182.3987693786621,4720,1131,3589,3589,0,12,1259000.0
1259,1259999,21.740390921256335,37.98309287376252,0.08626416422926397,169.8128960132599,78.61638617515564,182.27053451538086,4724,1133,3591,3591,0,12,1260000.0
1260,1260999,21.738508672455715,37.977138696637,0.08627978506923295,169.976238489151,78.6796977519989,182.16525268554688,4732,1135,3597,3597,0,12,1261000.0
1261,1261999,21.736057239061818,37.97008599619042,0.08629491987426485,170.117534160614,78.74266600608826,182.52696990966797,4736,1135,3601,3601,0,12,1262000.0
1262,1262999,21.73403365401668,37.96400232373776,0.08624921652765494,170.25678062438965,78.805011510849,182.83518981933594,4747,1136,3611,3611,0,12,1263000.0
1263,1263999,21.731122841181637,37.95721320248673,0.08625592896289935,170.3917896747589,78.8670105934143,183.04519271850586,4747,1136,3611,3611,0,12,1264000.0
1264,1264999,21.729905319038654,37.95151633241389,0.08624496326556297,170.54627108573914,78.93018007278442,183.22046279907227,4749,1137,3612,3612,0,12,1265000.0
1265,1265999,21.7304814139952,37.95051482135451,0.08626839755754978,170.66035842895508,78.99226999282837,183.37533950805664,4749,1137,3612,3612,0,12,1266000.0
1266,1266999,21.732755489515547,37.952097504681404,0.08627970173844357,170.79781079292297,79.0543143749237,183.51634216308594,4749,1137,3612,3612,0,12,1267000.0
1267,1267999,21.734603835618014,37.953323211189854,0.08628656666005163,170.9277858734131,79.11672186851501,183.615234375,4749,1137,3612,3612,0,12,1268000.0
1268,1268999,21.73638480755329,37.9545235714725,0.08630649966445869,171.09742426872253,79.17930221557617,183.54563903808594,4755,1140,3615,3615,0,12,1269000.0
1269,1269999,21.738646299147867,37.95633784757836,0.08631957972342552,171.24566960334778,79.24288368225098,183.6545639038086,4757,1141,3616,3616,0,12,1270000.0
1270,1270999,21.740812428687192,37.95873060692812,0.08631090068143021,171.3870153427124,79.3057177066803,183.72949600219727,4759,1142,3617,3617,0,12,1271000.0
1271,1271999,21.74417751265168,37.96243519574239,0.08631170120960585,171.51846599578857,79.36825489997864,183.74016189575195,4761,1143,3618,3618,0,12,1272000.0
1272,1272999,21.74750658062828,37.966630190563755,0.08632317550472868,171.65644001960754,79.43124032020569,183.86267471313477,4761,1143,3618,3618,0,12,1273000.0
1273,1273999,21.75029002717008,37.96785410786517,0.08633096854716349,171.80002856254578,79.494389295578,183.9185562133789,4763,1144,3619,3619,0,12,1274000.0
1274,1274999,21.75341159292119,37.96947954529233,0.08634126360858063,171.93929409980774,79.55706834793091,183.93013381958008,4765,1145,3620,3620,0,12,1275000.0
1275,1275999,21.756241594126372,37.97157975085038,0.08638575949058236,172.07981657981873,79.61969208717346,184.04784393310547,4765,1145,3620,3620,0,12,1276000.0
1276,1276999,21.759853000015884,37.97459319658421,0.08639656211589752,172.20584726333618,79.68241667747498,184.14154815673828,4765,1145,3620,3620,0,12,1277000.0
1277,1277999,21.763376948994665,37.98181947880304,0.08642263770837244,172.34104204177856,79.74523115158081,184.1868133544922,4765,1145,3620,3620,0,12,1278000.0
1278,1278999,21.767084811165805,37.98932379922256,0.08641816267685509,172.50053215026855,79.80841374397278,184.18870544433594,4772,1146,3626,3626,0,12,1279000.0
1279,1279999,21.770023755773618,37.99071730998736,0.08644379372432653,172.64048290252686,79.87167954444885,184.16007232666016,4774,1147,3627,3627,0,12,1280000.0
1280,1280999,21.77245220440546,37.990739883191225,0.08653599906132603,172.8135588169098,79.94425010681152,184.24342346191406,4774,1147,3627,3627,0,12,1281000.0
1281,1281999,21.772484495338393,37.987422329453835,0.08658739051243425,172.97707748413086,80.00725102424622,184.18545150756836,4783,1149,3634,3634,0,12,1282000.0
1282,1282999,21.77246301576808,37.98179089728821,0.08653856396579185,173.1267478466034,80.07598233222961,184.65069198608398,4788,1149,3639,3639,0,12,1283000.0
1283,1283999,21.772929255071872,37.978270812539485,0.08635142032648513,173.24867343902588,80.13876676559448,184.9103126525879,4788,1149,3639,3639,0,12,1284000.0
1284,1284999,21.7721330826142,37.97259401613026,0.08624102950234303,173.37770915031433,80.20089101791382,185.04574584960938,4796,1150,3646,3646,0,12,1285000.0
1285,1285999,21.771891631761267,37.9705633815448,0.08617488420515118,173.5116584300995,80.26307678222656,185.11974334716797,4804,1151,3653,3653,0,12,1286000.0
1286,1286999,21.76938751202691,37.961967107057184,0.08611927777251005,173.6336088180542,80.32473731040955,185.24054336547852,4804,1151,3653,3653,0,12,1287000.0
1287,1287999,21.767188920978114,37.95349393988064,0.08605385640651675,173.79804515838623,80.38791418075562,185.16582870483398,4816,1154,3662,3662,0,12,1288000.0
1288,1288999,21.7654665548935,37.94616370418789,0.08597606152538018,173.94545912742615,80.45068669319153,185.17932510375977,4820,1156,3664,3664,0,12,1289000.0
1289,1289999,21.76357299347743,37.945162623399696,0.08589147234585437,174.1200840473175,80.51344299316406,185.07495880126953,4843,1159,3684,3684,0,12,1290000.0
1290,1290999,21.760462978673647,37.93738264451557,0.0858562588144246,174.29969024658203,80.57677841186523,185.1107940673828,4855,1162,3693,3693,0,12,1291000.0
1291,1291999,21.757628282988783,37.93208775413252,0.08581890149713811,174.41294479370117,80.63981699943542,185.27223205566406,4855,1162,3693,3693,0,12,1292000.0
1292,1292999,21.755926548555752,37.9311502346142,0.08578007676063615,174.54844093322754,80.70230340957642,185.3795166015625,4855,1162,3693,3693,0,12,1293000.0
1293,1293999,21.752579163980837,37.92391392810661,0.08576299690688216,174.67678332328796,80.765065908432,185.49584579467773,4855,1162,3693,3693,0,12,1294000.0
1294,1294999,21.749631354036044,37.91744257969246,0.08574959116010539,174.84533429145813,80.83116459846497,185.49663925170898,4863,1163,3700,3700,0,12,1295000.0
1295,1295999,21.747516287481695,37.91338482282511,0.08573122553169799,174.99627494812012,80.89422917366028,185.49223709106445,4871,1164,3707,3707,0,12,1296000.0
1296,1296999,21.744707649285985,37.90712218926186,0.0857260799726609,175.1231586933136,80.95687079429626,185.5787353515625,4871,1164,3707,3707,0,12,1297000.0
1297,1297999,21.742681999435995,37.902085786658056,0.08574686551276489,175.24860382080078,81.02426767349243,185.66161346435547,4871,1164,3707,3707,0,12,1298000.0
1298,1298999,21.740622500625673,37.8961096879483,0.08574467808610198,175.455904006958,81.0902247428894,185.52395629882812,4889,1167,3722,3722,0,12,1299000.0
1299,1299999,21.739391298563064,37.89216510199806,0.0857109179432125,175.5857572555542,81.15316128730774,185.6258659362793,4889,1167,3722,3722,0,12,1300000.0
1300,1300999,21.736692944921966,37.88633129333839,0.08570544127149382,175.70981073379517,81.21587324142456,185.70151901245117,4889,1167,3722,3722,0,12,1301000.0
1301,1301999,21.735630606849906,37.883193796408904,0.08568936236942781,175.83715534210205,81.2827820777893,185.75106811523438,4889,1167,3722,3722,0,12,1302000.0
1302,1302999,21.73322947878974,37.87754742316288,0.08569283144411777,176.01093983650208,81.34556865692139,185.74042510986328,4897,1168,3729,3729,0,12,1303000.0
1303,1303999,21.73069444944258,37.87014421474826,0.08565269111466656,176.14826774597168,81.40924334526062,186.30672073364258,4910,1169,3741,3741,0,12,1304000.0
1304,1304999,21.73016037031307,37.864937645875294,0.08554606772604412,176.27998232841492,81.47702431678772,186.78192138671875,4913,1169,3744,3744,0,12,1305000.0
1305,1305999,21.728477138664065,37.86137366039872,0.08548460040621875,176.40106558799744,81.53954362869263,187.0657081604004,4913,1169,3744,3744,0,12,1306000.0
1306,1306999,21.72615910551839,37.855907944684255,0.08544086735218892,176.53995180130005,81.60270071029663,187.1778221130371,4915,1170,3745,3745,0,12,1307000.0
1307,1307999,21.722926256554416,37.847757616646966,0.08541458826381687,176.67452383041382,81.66612792015076,187.34547424316406,4946,1171,3775,3775,0,12,1308000.0
1308,1308999,21.719843075156767,37.83946245916985,0.08539282966135286,176.8083655834198,81.72881555557251,187.43513870239258,4948,1172,3776,3776,0,12,1309000.0
1309,1309999,21.7171005631704,37.830785877815025,0.08536524212551588,176.9238555431366,81.79110074043274,187.6543960571289,4948,1172,3776,3776,0,12,1310000.0
1310,1310999,21.712993745412447,37.82122796188982,0.08534548190933,177.07037830352783,81.85476016998291,187.7256317138672,4950,1173,3777,3777,0,12,1311000.0
1311,1311999,21.709906428349683,37.81496349370061,0.08532353457589881,177.2336790561676,81.91745018959045,187.79533004760742,4954,1175,3779,3779,0,12,1312000.0
1312,1312999,21.706225944125,37.808812805037405,0.08529500441009807,177.4106421470642,81.98063516616821,187.69221115112305,4985,1180,3805,3805,0,12,1313000.0
1313,1313999,21.702667486797562,37.80172091287995,0.08527850461183228,177.58392095565796,82.04417204856873,187.6594581604004,5001,1182,3819,3819,0,12,1314000.0
1314,1314999,21.698863307254918,37.79327040559253,0.08526765983694518,177.71399354934692,82.10745906829834,187.8065414428711,5003,1183,3820,3820,0,12,1315000.0
1315,1315999,21.69460000486494,37.78534843898275,0.08526738270081258,177.84967517852783,82.17169141769409,187.87553787231445,5005,1184,3821,3821,0,12,1316000.0
1316,1316999,21.69036028491031,37.77677904187,0.08526981799035205,178.01221179962158,82.23499202728271,187.87573623657227,5016,1186,3830,3830,0,12,1317000.0
1317,1317999,21.687317069310886,37.769679440450254,0.08526187409571728,178.17335152626038,82.29842114448547,187.91237258911133,5032,1188,3844,3844,0,12,1318000.0
1318,1318999,21.685061299804428,37.7696411678155,0.08520407348608894,178.29924392700195,82.36133480072021,188.0561408996582,5032,1188,3844,3844,0,12,1319000.0
1319,1319999,21.683015606012173,37.764484272862276,0.08519393073441428,178.43719696998596,82.42427015304565,188.19233322143555,5032,1188,3844,3844,0,12,1320000.0
1320,1320999,21.682283875013688,37.76323931328092,0.08517235700180115,178.5952663421631,82.48905324935913,188.22084426879883,5043,1190,3853,3853,0,12,1321000.0
1321,1321999,21.68085530609771,37.75954655970395,0.08516959798709789,178.7065794467926,82.55180764198303,188.3436393737793,5043,1190,3853,3853,0,12,1322000.0
1322,1322999,21.68050039087993,37.75692370355988,0.08517146787355478,178.83193564414978,82.61485171318054,188.42499542236328,5043,1190,3853,3853,0,12,1323000.0
1323,1323999,21.678871138520122,37.75382220049024,0.08514726299389119,178.9703073501587,82.67807579040527,188.52838516235352,5043,1190,3853,3853,0,12,1324000.0
1324,1324999,21.674849757649127,37.7454482435807,0.08516096060916112,179.12983870506287,82.74144458770752,189.12615203857422,5059,1191,3868,3868,0,12,1325000.0
1325,1325999,21.672412794987448,37.747550037299305,0.0850929362395223,179.270929813385,82.80505037307739,189.7491683959961,5070,1192,3878,3878,0,12,1326000.0
1326,1326999,21.668432894128234,37.74934692639138,0.08504498762729618,179.4103603363037,82.86809873580933,189.98554229736328,5081,1194,3887,3887,0,12,1327000.0
1327,1327999,21.663003091217202,37.742384667035616,0.08505405441368552,179.53304719924927,82.93194198608398,190.33423233032227,5081,1194,3887,3887,0,12,1328000.0
1328,1328999,21.658184253547432,37.737653460110664,0.08504638157065669,179.6601903438568,82.99472784996033,190.5748748779297,5081,1194,3887,3887,0,12,1329000.0
1329,1329999,21.652640860066203,37.72866952095114,0.08504897984614845,179.77788615226746,83.05761885643005,190.77568435668945,5081,1194,3887,3887,0,12,1330000.0
1330,1330999,21.647077949075953,37.71966816346897,0.0850659198015844,179.923504114151,83.12185406684875,190.8424949645996,5085,1196,3889,3889,0,12,1331000.0
1331,1331999,21.641241972238003,37.710872756644456,0.08507455371564476,180.0642716884613,83.18605828285217,191.0213851928711,5085,1196,3889,3889,0,12,1332000.0
1332,1332999,21.635629911685776,37.70101889281159,0.08509281286623127,180.1979696750641,83.24911069869995,191.1817741394043,5085,1196,3889,3889,0,12,1333000.0
1333,1333999,21.630362463558424,37.69263074560068,0.08509652095314979,180.3692488670349,83.31264591217041,191.13168716430664,5091,1199,3892,3892,0,12,1334000.0
1334,1334999,21.626364818259436,37.6868805669907,0.08511345639876444,180.4967303276062,83.37623524665833,191.31705474853516,5091,1199,3892,3892,0,12,1335000.0
1335,1335999,21.623409154930062,37.68493858107096,0.08511133300189766,180.6266303062439,83.43952012062073,191.46129608154297,5091,1199,3892,3892,0,12,1336000.0
1336,1336999,21.6207991833728,37.68075425157498,0.08509634220857765,180.79926800727844,83.50275564193726,191.39665985107422,5097,1202,3895,3895,0,12,1337000.0
1337,1337999,21.61798338030958,37.6754737281778,0.08509097073909722,180.9395878314972,83.56674599647522,191.51829528808594,5107,1203,3904,3904,0,12,1338000.0
1338,1338999,21.617368581277674,37.67454872125773,0.08508901816919856,181.07220911979675,83.62974166870117,191.6832389831543,5107,1203,3904,3904,0,12,1339000.0
1339,1339999,21.615964979095285,37.67560461705594,0.0850659644268369,181.19186878204346,83.69265151023865,191.81457138061523,5107,1203,3904,3904,0,12,1340000.0
1340,1340999,21.614327089572306,37.67290522696455,0.08503695505115982,181.3614227771759,83.75590634346008,191.84145736694336,5111,1205,3906,3906,0,12,1341000.0
1341,1341999,21.61126855110259,37.666151371852486,0.08504872822196241,181.5079207420349,83.81883215904236,191.9397430419922,5113,1206,3907,3907,0,12,1342000.0
1342,1342999,21.607695199924216,37.65906293958419,0.08504175999042529,182.3588650226593,83.88324546813965,192.7620391845703,5135,1206,3929,3929,0,12,1343000.0
1343,1343999,21.6029909051381,37.65235718743109,0.08506076487353142,182.50916266441345,83.94809579849243,193.1796760559082,5151,1208,3943,3943,0,12,1344000.0
1344,1344999,21.598146949542475,37.644389533832594,0.08509526311237181,182.63262581825256,84.01133441925049,193.49281692504883,5151,1208,3943,3943,0,12,1345000.0
1345,1345999,21.59372011344314,37.64349725731301,0.0851036449587268,182.7930121421814,84.07510471343994,193.56761169433594,5164,1210,3954,3954,0,12,1346000.0
1346,1346999,21.59013611947745,37.63631722250631,0.08512166515869413,182.93920016288757,84.13989615440369,193.82655334472656,5166,1211,3955,3955,0,12,1347000.0
1347,1347999,21.586429802542103,37.62914167273333,0.08513677194783031,183.06923532485962,84.20314359664917,193.97662353515625,5168,1212,3956,3956,0,12,1348000.0
1348,1348999,21.582584777847245,37.622057656428815,0.08513297865429337,183.23161268234253,84.26719188690186,194.09369277954102,5170,1213,3957,3957,0,12,1349000.0
1349,1349999,21.579773703083855,37.61977898031215,0.08511344022633482,183.35745477676392,84.33044242858887,194.30658721923828,5170,1213,3957,3957,0,12,1350000.0
1350,1350999,21.57764687874844,37.6198237863459,0.08508192972338491,183.50655889511108,84.39514470100403,194.3443603515625,5174,1215,3959,3959,0,12,1351000.0
1351,1351999,21.574396410036776,37.61379503192704,0.08507809923228282,183.65631818771362,84.45898628234863,194.42261505126953,5176,1216,3960,3960,0,12,1352000.0
1352,1352999,21.570776270502954,37.60642033402384,0.08507321612238161,183.80320048332214,84.52246308326721,194.53647994995117,5180,1218,3962,3962,0,12,1353000.0
1353,1353999,21.568327435893274,37.60268608628898,0.08505632839293631,183.95374631881714,84.58619570732117,194.63120651245117,5182,1219,3963,3963,0,12,1354000.0
1354,1354999,21.56687772618307,37.609412732017574,0.08500296711649447,184.0939965248108,84.6497266292572,194.7720947265625,5182,1219,3963,3963,0,12,1355000.0
1355,1355999,21.56518528293747,37.6048191828181,0.08498956503580235,184.24509048461914,84.71336603164673,194.8727569580078,5184,1220,3964,3964,0,12,1356000.0
1356,1356999,21.56320846877958,37.600464005256704,0.08497169314690622,184.38138699531555,84.77700877189636,195.00679397583008,5184,1220,3964,3964,0,12,1357000.0
1357,1357999,21.563337354330077,37.6074497953453,0.08491527337059579,184.5412232875824,84.84858655929565,195.12600708007812,5184,1220,3964,3964,0,12,1358000.0
1358,1358999,21.56264597226534,37.604723184633706,0.08487651272323904,184.67454361915588,84.91239333152771,195.2504005432129,5184,1220,3964,3964,0,12,1359000.0
1359,1359999,21.5619375556824,37.601713611769966,0.08485290157675451,184.8118932247162,84.97664308547974,195.34207916259766,5184,1220,3964,3964,0,12,1360000.0
1360,1360999,21.560618686105453,37.59729900047591,0.08484658098750175,184.97776317596436,85.04028487205505,195.22978591918945,5191,1223,3968,3968,0,12,1361000.0
1361,1361999,21.558545582850265,37.59131573730297,0.08483789753745441,185.1447298526764,85.10631084442139,195.2962417602539,5193,1224,3969,3969,0,12,1362000.0
1362,1362999,21.557677392591028,37.58885700778875,0.08481558675175682,185.3021833896637,85.17069339752197,196.08881378173828,5216,1225,3991,3991,0,12,1363000.0
1363,1363999,21.554232587788082,37.58382806167917,0.08481178191483207,185.4223508834839,85.23419189453125,196.62308883666992,5220,1225,3995,3995,0,12,1364000.0
1364,1364999,21.55229153808854,37.58225280343754,0.08481601836620256,185.54338932037354,85.29821157455444,197.00461959838867,5222,1225,3997,3997,0,12,1365000.0
1365,1365999,21.549702541406692,37.578351397569485,0.08485223233742123,185.68820023536682,85.36209630966187,197.17470932006836,5224,1226,3998,3998,0,12,1366000.0
1366,1366999,21.547341426195562,37.57443178854665,0.08487450005635899,185.83332014083862,85.42530918121338,197.29618072509766,5226,1227,3999,3999,0,12,1367000.0
1367,1367999,21.54789636076445,37.57647364708362,0.08483366113921942,185.96264338493347,85.48940896987915,197.55048751831055,5226,1227,3999,3999,0,12,1368000.0
1368,1368999,21.545745322042098,37.573578293920654,0.08485097153653143,186.10215187072754,85.55309867858887,197.71372985839844,5226,1227,3999,3999,0,12,1369000.0
1369,1369999,21.54468600211987,37.57222603374924,0.08487843601520173,186.24529719352722,85.6171441078186,197.85100555419922,5226,1227,3999,3999,0,12,1370000.0
1370,1370999,21.543470728610746,37.56870282442075,0.08489816249189674,186.41021537780762,85.68146920204163,197.84963989257812,5232,1230,4002,4002,0,12,1371000.0
1371,1371999,21.541357944431493,37.56384955287976,0.08490993710686279,186.56941723823547,85.74564385414124,197.8827362060547,5236,1232,4004,4004,0,12,1372000.0
1372,1372999,21.540478868323312,37.561773960231086,0.08493280513541435,186.75580763816833,85.8118462562561,197.79533004760742,5244,1236,4008,4008,0,12,1373000.0
1373,1373999,21.538499698491066,37.55769337209365,0.08493639099752925,186.92134594917297,85.88047933578491,197.83574676513672,5250,1239,4011,4011,0,12,1374000.0
1374,1374999,21.537083752209526,37.555635993185795,0.08496149122517549,187.06575441360474,85.94505214691162,197.92217636108398,5252,1240,4012,4012,0,12,1375000.0
1375,1375999,21.534584918591808,37.549027505665535,0.08495932762608771,187.21532106399536,86.0093297958374,198.0699920654297,5254,1241,4013,4013,0,12,1376000.0
1376,1376999,21.531813207493165,37.543919867962515,0.08498715254996203,187.35485911369324,86.07606053352356,198.2637481689453,5254,1241,4013,4013,0,12,1377000.0
1377,1377999,21.529778821552938,37.53958257036975,0.0850141443527258,187.49997687339783,86.14741134643555,198.41278076171875,5254,1241,4013,4013,0,12,1378000.0
1378,1378999,21.528439742379664,37.53734652224252,0.08503583901424483,187.65474557876587,86.21140241622925,198.46201705932617,5256,1242,4014,4014,0,12,1379000.0
1379,1379999,21.5265371464815,37.53193595334282,0.08503447972612488,187.79938530921936,86.27541399002075,198.6502342224121,5257,1242,4015,4015,0,12,1380000.0
1380,1380999,21.524613397648345,37.52645569834621,0.08505297417679514,187.95025396347046,86.33914971351624,198.59064483642578,5261,1244,4017,4017,0,12,1381000.0
1381,1381999,21.52167810772515,37.51923930991141,0.08504567256340301,188.12706327438354,86.40339970588684,198.58456802368164,5276,1247,4029,4029,0,12,1382000.0
1382,1382999,21.5184713543839,37.51193608111143,0.0850235462916108,188.2678964138031,86.4672703742981,198.73224258422852,5276,1247,4029,4029,0,12,1383000.0
1383,1383999,21.51554554517471,37.50774930329304,0.0849563970232513,188.40785837173462,86.5321798324585,199.3996925354004,5300,1248,4052,4052,0,12,1384000.0
1384,1384999,21.513126037820413,37.50385100519153,0.08475699347776389,188.55465626716614,86.59579563140869,199.8551025390625,5307,1249,4058,4058,0,12,1385000.0
1385,1385999,21.510644103849955,37.49973280177729,0.08462944572633724,188.68695735931396,86.65883469581604,200.15292739868164,5311,1250,4061,4061,0,12,1386000.0
1386,1386999,21.50739313683048,37.49580128185952,0.08456055820548514,188.83155870437622,86.72261261940002,200.386474609375,5313,1251,4062,4062,0,12,1387000.0
1387,1387999,21.503683634026867,37.48785636529477,0.08453166207878293,188.95937204360962,86.78554892539978,200.5194320678711,5315,1252,4063,4063,0,12,1388000.0
1388,1388999,21.50067487304641,37.48156535104594,0.08450177849239315,189.08714246749878,86.84977412223816,200.7666244506836,5315,1252,4063,4063,0,12,1389000.0
1389,1389999,21.49642466569824,37.47325484451104,0.0844984735251596,189.2121660709381,86.91291189193726,200.97329711914062,5315,1252,4063,4063,0,12,1390000.0
1390,1390999,21.492575546080833,37.465242797176955,0.08448903757225745,189.36226081848145,86.97647500038147,201.05164337158203,5319,1254,4065,4065,0,12,1391000.0
1391,1391999,21.48906015588876,37.45875514125565,0.084461340890998,189.52927494049072,87.04026365280151,201.0501251220703,5323,1256,4067,4067,0,12,1392000.0
1392,1392999,21.48530274432846,37.450935494176655,0.08446354346292728,189.66802048683167,87.10390162467957,201.15748596191406,5325,1257,4068,4068,0,12,1393000.0
1393,1393999,21.481726446248977,37.44429188080921,0.08445033372095112,189.80946135520935,87.1677634716034,201.21159744262695,5337,1258,4079,4079,0,12,1394000.0
1394,1394999,21.478900139025143,37.44101642967752,0.0844253336107268,189.97569298744202,87.23159861564636,201.18557357788086,5343,1261,4082,4082,0,12,1395000.0
1395,1395999,21.478634394178293,37.44487346309468,0.08432593395742927,190.11613965034485,87.29518413543701,201.37151336669922,5343,1261,4082,4082,0,12,1396000.0
1396,1396999,21.48098791058958,37.454515921992304,0.08418880228494252,190.25432658195496,87.35847449302673,201.50407028198242,5343,1261,4082,4082,0,12,1397000.0
1397,1397999,21.48434720412363,37.46576196929021,0.08405622312607208,190.3881778717041,87.42194962501526,201.57651138305664,5345,1262,4083,4083,0,12,1398000.0
1398,1398999,21.4878405376958,37.47647683699921,0.08396472897724361,190.53573203086853,87.48558568954468,201.65225219726562,5347,1263,4084,4084,0,12,1399000.0
1399,1399999,21.48995214095766,37.48037021634399,0.08390706582567853,190.721116065979,87.5494692325592,201.60644912719727,5353,1266,4087,4087,0,12,1400000.0
1400,1400999,21.494501110521977,37.49122697660706,0.08381404599949871,190.8664960861206,87.61323809623718,201.60673141479492,5357,1268,4089,4089,0,12,1401000.0
1401,1401999,21.495996179190737,37.49359535744379,0.08376820725563605,190.9940505027771,87.6770532131195,201.78878784179688,5357,1268,4089,4089,0,12,1402000.0
1402,1402999,21.498051540933805,37.4967156557486,0.08373309294684628,191.14719891548157,87.74085235595703,201.85907745361328,5359,1269,4090,4090,0,12,1403000.0
1403,1403999,21.49852924293737,37.49979423869601,0.08371073374172477,191.29500365257263,87.80437397956848,201.95693588256836,5361,1270,4091,4091,0,12,1404000.0
1404,1404999,21.496060822621363,37.4934886689137,0.08364907588732873,191.4237277507782,87.8689444065094,202.95230865478516,5387,1270,4117,4117,0,12,1405000.0
1405,1405999,21.494556419777677,37.48776854969186,0.0835271795391549,191.55207443237305,87.93292927742004,203.34900665283203,5390,1270,4120,4120,0,12,1406000.0
1406,1406999,21.4931183303814,37.48133194555492,0.0834229854987828,191.67005491256714,87.99601364135742,203.62747192382812,5390,1270,4120,4120,0,12,1407000.0
1407,1407999,21.490883235679192,37.4756572325547,0.08334293072580357,191.8257417678833,88.05938506126404,203.69830322265625,5394,1272,4122,4122,0,12,1408000.0
1408,1408999,21.48758324532058,37.468448066186596,0.08329693144857331,191.97310709953308,88.12309670448303,203.76452255249023,5398,1274,4124,4124,0,12,1409000.0
1409,1409999,21.484386820350483,37.4623943875934,0.08323101408520006,192.0904884338379,88.18739080429077,204.04745864868164,5398,1274,4124,4124,0,12,1410000.0
1410,1410999,21.48029347274789,37.45453692897195,0.08320313602633833,192.21686720848083,88.25087904930115,204.22163009643555,5398,1274,4124,4124,0,12,1411000.0
1411,1411999,21.477250521931982,37.448734896125885,0.08315066956557104,192.36467957496643,88.31427049636841,204.39534759521484,5398,1274,4124,4124,0,12,1412000.0
1412,1412999,21.474311803068375,37.44462094507551,0.08309202767824486,192.53242826461792,88.37811398506165,204.34638595581055,5404,1277,4127,4127,0,12,1413000.0
1413,1413999,21.471534997295173,37.44081236252947,0.08305551708820791,192.6984486579895,88.44259071350098,204.32329559326172,5410,1280,4130,4130,0,12,1414000.0
1414,1414999,21.472082369670236,37.449560094621475,0.08303910264111858,192.84019589424133,88.5064787864685,204.4159393310547,5413,1281,4132,4132,0,12,1415000.0
1415,1415999,21.472658683285196,37.46436310118855,0.08295135830267719,193.02090430259705,88.57125782966614,204.32459259033203,5421,1285,4136,4136,0,12,1416000.0
1416,1416999,21.472720262408313,37.467615302030886,0.08294745493300004,193.15923476219177,88.63501071929932,204.4467887878418,5423,1286,4137,4137,0,12,1417000.0
1417,1417999,21.47477265573124,37.47862873602917,0.08291813574581097,193.3259880542755,88.69971513748169,204.41869735717773,5429,1289,4140,4140,0,12,1418000.0
1418,1418999,21.47656296595489,37.48776101407471,0.0829349073172434,193.47951292991638,88.76535534858704,204.5807991027832,5433,1291,4142,4142,0,12,1419000.0
1419,1419999,21.47748232555313,37.49033660777733,0.08298633895392182,193.61032962799072,88.82950615882874,204.79439163208008,5433,1291,4142,4142,0,12,1420000.0
1420,1420999,21.48202161168265,37.50759419637368,0.08298054363456564,193.7653841972351,88.894211769104,204.87734985351562,5437,1293,4144,4144,0,12,1421000.0
1421,1421999,21.48646613754192,37.517095145311316,0.08299152969750123,193.8866581916809,88.95797848701477,205.03998565673828,5437,1293,4144,4144,0,12,1422000.0
1422,1422999,21.49046138533464,37.524688428542845,0.08300188409251241,194.04616856575012,89.02238726615906,205.1294708251953,5439,1294,4145,4145,0,12,1423000.0
1423,1423999,21.495245559084783,37.53384502575326,0.08299461555733878,194.17560243606567,89.08761930465698,205.27205276489258,5439,1294,4145,4145,0,12,1424000.0
1424,1424999,21.495700722522507,37.5330524336093,0.08296359362676053,194.31447553634644,89.1515040397644,205.4526596069336,5439,1294,4145,4145,0,12,1425000.0
1425,1425999,21.497531371614386,37.5395370895415,0.08266997700947631,194.4546251296997,89.21569395065308,206.33544158935547,5470,1295,4175,4175,0,12,1426000.0
1426,1426999,21.49892414719933,37.542981152315235,0.08238293292091059,194.58860898017883,89.27867650985718,206.6605110168457,5472,1295,4177,4177,0,12,1427000.0
1427,1427999,21.499485848107476,37.54276145017304,0.08212861915558167,194.73667645454407,89.34173655509949,206.84101486206055,5474,1296,4178,4178,0,12,1428000.0
1428,1428999,21.500591858920718,37.543399262375544,0.08193198449594452,194.87275409698486,89.40522384643555,206.9543800354004,5476,1297,4179,4179,0,12,1429000.0
1429,1429999,21.500792779422312,37.54228969753472,0.08177573264206062,195.0083043575287,89.46832418441772,207.04327392578125,5478,1298,4180,4180,0,12,1430000.0
1430,1430999,21.498953289750077,37.537468795897574,0.08172030153818721,195.18298983573914,89.53227186203003,206.9889030456543,5485,1301,4184,4184,0,12,1431000.0
1431,1431999,21.49701691111418,37.53302911188018,0.08169770974439472,195.34040760993958,89.59691309928894,207.0205535888672,5489,1303,4186,4186,0,12,1432000.0
1432,1432999,21.494729481632497,37.52961169124308,0.08161529574693416,195.48350358009338,89.66105103492737,207.2036247253418,5491,1304,4187,4187,0,12,1433000.0
1433,1433999,21.492945810817073,37.524630793283485,0.08159832002288026,195.6340229511261,89.72452974319458,207.22260284423828,5495,1306,4189,4189,0,12,1434000.0
1434,1434999,21.490691444135024,37.51976866499834,0.08160328197237665,195.80554461479187,89.78826475143433,207.21192169189453,5501,1309,4192,4192,0,12,1435000.0
1435,1435999,21.488808888608055,37.51490154669909,0.08160532900847928,195.94059467315674,89.85268592834473,207.31526947021484,5503,1310,4193,4193,0,12,1436000.0
1436,1436999,21.48762808768121,37.51269421800125,0.0815681536903593,196.09846329689026,89.91628432273865,207.37586212158203,5507,1312,4195,4195,0,12,1437000.0
1437,1437999,21.485989571858408,37.509099785573476,0.08155089148468675,196.24827480316162,89.97964525222778,207.4901237487793,5509,1313,4196,4196,0,12,1438000.0
1438,1438999,21.48563534900163,37.508272293584966,0.08152720646825584,196.37021255493164,90.04287195205688,207.6384391784668,5509,1313,4196,4196,0,12,1439000.0
1439,1439999,21.485708897717597,37.50662869743986,0.08153808138268537,196.4917290210724,90.10651206970215,207.7896499633789,5509,1313,4196,4196,0,12,1440000.0
1440,1440999,21.48627875706307,37.50768528244265,0.08155965053046088,196.64137601852417,90.1709680557251,207.8545379638672,5511,1314,4197,4197,0,12,1441000.0
1441,1441999,21.488109090978504,37.50920136468028,0.08159437764805677,196.79677820205688,90.23482370376587,207.91119003295898,5513,1315,4198,4198,0,12,1442000.0
1442,1442999,21.48843957375928,37.50852610906338,0.08158477739044534,196.95731496810913,90.30560088157654,207.91644668579102,5515,1316,4199,4199,0,12,1443000.0
1443,1443999,21.490366122564033,37.51042464911139,0.0815773838278151,197.10119581222534,90.36962175369263,208.03216934204102,5517,1317,4200,4200,0,12,1444000.0
1444,1444999,21.4933149579432,37.51742250427402,0.08156882757444417,197.25389289855957,90.43372845649719,208.05485153198242,5520,1318,4202,4202,0,12,1445000.0
1445,1445999,21.493682266092748,37.51511234750108,0.08157018016291528,197.39381384849548,90.49756217002869,208.19408798217773,5522,1319,4203,4203,0,12,1446000.0
1446,1446999,21.491278094200503,37.512207019000456,0.08150591104264282,197.5248966217041,90.5638780593872,209.1003189086914,5548,1319,4229,4229,0,12,1447000.0
1447,1447999,21.490927265813962,37.51709718155971,0.0813905965279732,197.64673566818237,90.6272644996643,209.38689041137695,5550,1319,4231,4231,0,12,1448000.0
1448,1448999,21.4882347389441,37.51123905087012,0.08136191276277316,197.77957463264465,90.69026780128479,209.59601211547852,5552,1320,4232,4232,0,12,1449000.0
1449,1449999,21.486733621991757,37.510499845913245,0.08133416568069263,197.9237358570099,90.75877928733826,209.73553848266602,5554,1321,4233,4233,0,12,1450000.0
1450,1450999,21.485478850236674,37.50941776455668,0.0813012515383249,198.05244994163513,90.82250571250916,209.93230056762695,5554,1321,4233,4233,0,12,1451000.0
1451,1451999,21.483657639985044,37.509136862446404,0.0812442223778802,198.19514846801758,90.88571429252625,210.01784896850586,5569,1322,4247,4247,0,12,1452000.0
1452,1452999,21.482653776789242,37.506474144343855,0.08121254473393935,198.3370394706726,90.94865489006042,210.1039581298828,5571,1323,4248,4248,0,12,1453000.0
1453,1453999,21.48156412319262,37.52356543151636,0.08112395971502595,198.4842975139618,91.01248097419739,210.12673950195312,5573,1324,4249,4249,0,12,1454000.0
1454,1454999,21.480886047796226,37.523443591390034,0.08112164506526298,198.63793349266052,91.07601118087769,210.12731170654297,5577,1326,4251,4251,0,12,1455000.0
1455,1455999,21.4806073666594,37.52277085686619,0.08109111897458665,198.7682077884674,91.14049887657166,210.2976531982422,5577,1326,4251,4251,0,12,1456000.0
1456,1456999,21.48115926582504,37.5363782217601,0.08102619874895756,198.92400002479553,91.20434355735779,210.32958221435547,5579,1327,4252,4252,0,12,1457000.0
1457,1457999,21.481276536229252,37.53768961711284,0.08099636531813947,199.12461757659912,91.27244162559509,210.3175926208496,5585,1330,4255,4255,0,12,1458000.0
1458,1458999,21.483031637271782,37.553749037533045,0.08091383493376725,199.27704763412476,91.33608627319336,210.36153411865234,5589,1332,4257,4257,0,12,1459000.0
1459,1459999,21.486649682148908,37.576596977265694,0.08082039343701686,199.4293601512909,91.39997291564941,210.41449356079102,5591,1333,4258,4258,0,12,1460000.0
1460,1460999,21.48893233444219,37.59610176746864,0.08074154677118206,199.5944218635559,91.4639241695404,210.35997009277344,5597,1336,4261,4261,0,12,1461000.0
1461,1461999,21.49163617844125,37.60228902192293,0.08061291543414628,199.72213673591614,91.5271532535553,210.50075912475586,5597,1336,4261,4261,0,12,1462000.0
1462,1462999,21.494816934848195,37.61449523580124,0.08049895869494272,199.88456392288208,91.59130549430847,210.50410079956055,5599,1337,4262,4262,0,12,1463000.0
1463,1463999,21.496280716482268,37.616764613083475,0.08037429050054568,200.0170259475708,91.66035866737366,211.30467224121094,5625,1337,4288,4288,0,12,1464000.0
1464,1464999,21.49775628896739,37.623904910929404,0.08032893782185957,200.1614212989807,91.72772026062012,211.77954864501953,5630,1337,4293,4293,0,12,1465000.0
1465,1465999,21.50096816467653,37.63571811869176,0.08034686478030839,200.3014633655548,91.79187965393066,212.0407829284668,5646,1338,4308,4308,0,12,1466000.0
1466,1466999,21.50436538134883,37.64584418247099,0.08031675480614131,200.43591928482056,91.85469269752502,212.24608993530273,5646,1338,4308,4308,0,12,1467000.0
1467,1467999,21.510337471489077,37.663690673002776,0.08026370934865756,200.57713866233826,91.91753268241882,212.37150955200195,5648,1339,4309,4309,0,12,1468000.0
1468,1468999,21.512904891658714,37.66972662203567,0.08026489526193126,200.7132134437561,91.9810516834259,212.54045867919922,5648,1339,4309,4309,0,12,1469000.0
1469,1469999,21.51631765791298,37.67575864052045,0.08034104230814709,200.87026000022888,92.04515075683594,212.56133651733398,5652,1341,4311,4311,0,12,1470000.0
1470,1470999,21.52125802493198,37.68484873016022,0.08039125918461965,201.0165877342224,92.1126799583435,212.65252685546875,5654,1342,4312,4312,0,12,1471000.0
1471,1471999,21.527322649736593,37.697922365267786,0.08045713920541486,201.14321398735046,92.17560172080994,212.81769943237305,5654,1342,4312,4312,0,12,1472000.0
1472,1472999,21.533152898805984,37.719365338066325,0.08053461351749969,201.315927028656,92.2392463684082,212.75779724121094,5660,1345,4315,4315,0,12,1473000.0
1473,1473999,21.53763234525672,37.72659848299364,0.08056028232590073,201.44536638259888,92.3026864528656,212.91653442382812,5660,1345,4315,4315,0,12,1474000.0
1474,1474999,21.5445559000378,37.74142134966437,0.08062558227888039,201.62033820152283,92.3661904335022,212.85686492919922,5666,1348,4318,4318,0,12,1475000.0
1475,1475999,21.55173427827358,37.75676204332046,0.08074675863749292,201.7715699672699,92.43019318580627,213.02534103393555,5668,1349,4319,4319,0,12,1476000.0
1476,1476999,21.558403531792024,37.76731727059589,0.08096513019594331,201.92684674263,92.49374079704285,213.07586288452148,5685,1351,4334,4334,0,12,1477000.0
1477,1477999,21.5648474390701,37.775008336171034,0.0811273070609988,202.06891012191772,92.56452894210815,213.24742889404297,5685,1351,4334,4334,0,12,1478000.0
1478,1478999,21.570650165710816,37.79205239171437,0.08122318116098837,202.24000334739685,92.62845277786255,213.18249130249023,5691,1354,4337,4337,0,12,1479000.0
1479,1479999,21.578034773092483,37.804951897462,0.0814468807714005,202.42486572265625,92.69289326667786,213.0495376586914,5698,1357,4341,4341,0,12,1480000.0
1480,1480999,21.578801022752884,37.80569807245165,0.08149028296131622,202.5623676776886,92.75714182853699,213.85715103149414,5725,1357,4368,4368,0,12,1481000.0
1481,1481999,21.577069866563615,37.808044917086015,0.08141583609428327,202.69449758529663,92.82103180885315,214.3887939453125,5732,1358,4374,4374,0,12,1482000.0
1482,1482999,21.57393213929788,37.806241411038165,0.08139959414763753,202.81950974464417,92.88475012779236,214.763427734375,5734,1358,4376,4376,0,12,1483000.0
1483,1483999,21.569805414361294,37.802932449792934,0.0814065499215163,202.9448070526123,92.94816589355469,214.99188995361328,5734,1358,4376,4376,0,12,1484000.0
1484,1484999,21.567414649712667,37.800245272367725,0.08140232180841522,203.08411169052124,93.0112886428833,215.24908447265625,5736,1359,4377,4377,0,12,1485000.0
1485,1485999,21.564525767855617,37.79717227124976,0.08141969572382735,203.2121696472168,93.07565689086914,215.42209243774414,5736,1359,4377,4377,0,12,1486000.0
1486,1486999,21.56112330103115,37.79062845651483,0.08142883494885145,203.3463044166565,93.1385703086853,215.5661735534668,5736,1359,4377,4377,0,12,1487000.0
1487,1487999,21.558539564156046,37.786745428770494,0.0814313819733119,203.47281622886658,93.20153641700745,215.70258712768555,5736,1359,4377,4377,0,12,1488000.0
1488,1488999,21.557400648655605,37.78787088514347,0.08143471881965247,203.64955282211304,93.26530456542969,215.5902862548828,5742,1362,4380,4380,0,12,1489000.0
1489,1489999,21.557053015744483,37.794612085748206,0.0813954240220569,203.80226850509644,93.3291757106781,215.60567092895508,5746,1364,4382,4382,0,12,1490000.0
1490,1490999,21.55632257976776,37.7960620948565,0.0813921611586258,203.94830775260925,93.39361810684204,215.72806549072266,5748,1365,4383,4383,0,12,1491000.0
1491,1491999,21.555218576543314,37.79497377929226,0.08140097089256537,204.10313057899475,93.4575297832489,215.80233001708984,5752,1367,4385,4385,0,12,1492000.0
1492,1492999,21.5550299811014,37.79579715094364,0.0814381191384328,204.26727652549744,93.52156209945679,215.86159896850586,5756,1369,4387,4387,0,12,1493000.0
1493,1493999,21.555635286853203,37.7972975805618,0.08148281745202057,204.4051411151886,93.58501243591309,216.02693939208984,5758,1370,4388,4388,0,12,1494000.0
1494,1494999,21.55740111365635,37.800183816898695,0.08154087743453675,204.54276204109192,93.6487455368042,216.10089874267578,5760,1371,4389,4389,0,12,1495000.0
1495,1495999,21.558944153103845,37.8037029124918,0.08165953862288511,204.70462703704834,93.7127332687378,216.19931030273438,5762,1372,4390,4390,0,12,1496000.0
1496,1496999,21.559962608013944,37.80321980502577,0.08170368523280491,204.8458595275879,93.77641415596008,216.28071975708008,5764,1373,4391,4391,0,12,1497000.0
1497,1497999,21.56337394177855,37.81224814122785,0.08174399740722704,204.9841823577881,93.8403913974762,216.39909744262695,5764,1373,4391,4391,0,12,1498000.0
1498,1498999,21.56694918901285,37.817008740838155,0.08185303465209803,205.13668775558472,93.90458989143372,216.41460800170898,5768,1375,4393,4393,0,12,1499000.0
1499,1499999,21.56831561878833,37.817045257496254,0.08193054315902426,205.30907559394836,93.96871376037598,216.4947853088379,5770,1376,4394,4394,0,12,1500000.0
1500,1500999,21.568606110898646,37.8251195813368,0.08190761395964663,205.4461648464203,94.03313207626343,217.32177734375,5795,1376,4419,4419,0,12,1501000.0
1501,1501999,21.565828313467634,37.83058539307648,0.08182654457687177,205.55634021759033,94.09699726104736,217.86756896972656,5802,1376,4426,4426,0,12,1502000.0
1502,1502999,21.561849010832468,37.82564370043584,0.0818066053266785,205.67837595939636,94.16051149368286,218.2156105041504,5803,1376,4427,4427,0,12,1503000.0
1503,1503999,21.557755680472415,37.81875840322149,0.08179846362120502,205.83995294570923,94.22451305389404,218.40241241455078,5808,1378,4430,4430,0,12,1504000.0
1504,1504999,21.55347529754821,37.812523585709855,0.08180136043350372,206.00401711463928,94.28845763206482,218.39824676513672,5812,1380,4432,4432,0,12,1505000.0
1505,1505999,21.55097802301285,37.81293166263085,0.0817523402551028,206.1209056377411,94.35199284553528,218.67312240600586,5812,1380,4432,4432,0,12,1506000.0
1506,1506999,21.54721095370168,37.8076079609963,0.08175235127522684,206.24795484542847,94.4151656627655,218.83927154541016,5812,1380,4432,4432,0,12,1507000.0
1507,1507999,21.543817428852858,37.80329757757864,0.08173692643724473,206.42276883125305,94.48049974441528,218.74679565429688,5820,1384,4436,4436,0,12,1508000.0
1508,1508999,21.540777388644837,37.79785914391414,0.08172269450288772,206.58239603042603,94.54779505729675,218.84793853759766,5824,1386,4438,4438,0,12,1509000.0
1509,1509999,21.53778219674395,37.79250187710835,0.08170789153203739,206.72430777549744,94.61216402053833,219.0086898803711,5826,1387,4439,4439,0,12,1510000.0
1510,1510999,21.535009104296,37.78674075382476,0.08170146131180112,206.86484742164612,94.6771810054779,219.15309524536133,5826,1387,4439,4439,0,12,1511000.0
1511,1511999,21.533153170054096,37.78503902125994,0.081673132435646,207.02333402633667,94.74160170555115,219.17417526245117,5828,1388,4440,4440,0,12,1512000.0
1512,1512999,21.531129818980546,37.78225169254657,0.08166790495270027,207.1713604927063,94.80612182617188,219.23118591308594,5832,1390,4442,4442,0,12,1513000.0
1513,1513999,21.52983421730163,37.77906468996292,0.08165986785727153,207.32567238807678,94.86978101730347,219.2878074645996,5836,1392,4444,4444,0,12,1514000.0
1514,1514999,21.528869863209284,37.77933753511771,0.08166463091193576,207.4638214111328,94.93391680717468,219.42185974121094,5838,1393,4445,4445,0,12,1515000.0
1515,1515999,21.52817888737207,37.77678442653731,0.08166578754305132,207.6002779006958,94.99785041809082,219.57230377197266,5838,1393,4445,4445,0,12,1516000.0
1516,1516999,21.52744677259426,37.77414073330134,0.08169450631419506,207.72295808792114,95.06139659881592,219.7057876586914,5838,1393,4445,4445,0,12,1517000.0
1517,1517999,21.52788971216673,37.77323027234782,0.08173148482402082,207.90237069129944,95.12559604644775,219.7172393798828,5842,1395,4447,4447,0,12,1518000.0
1518,1518999,21.529615807729993,37.77369902216584,0.08174073234652734,208.02161073684692,95.18885850906372,219.84678649902344,5842,1395,4447,4447,0,12,1519000.0
1519,1519999,21.531132053888278,37.774800654051376,0.08175694998354865,208.18924283981323,95.25300526618958,219.86792755126953,5846,1397,4449,4449,0,12,1520000.0
1520,1520999,21.531433320537303,37.773813840936825,0.08177658629332563,208.34188842773438,95.31758642196655,219.91773986816406,5848,1398,4450,4450,0,12,1521000.0
1521,1521999,21.530016353644427,37.76988139241238,0.08177709216618945,208.4966423511505,95.38266825675964,220.57647705078125,5875,1399,4476,4476,0,12,1522000.0
1522,1522999,21.525915427937335,37.77310497319988,0.08173054849256511,208.61335158348083,95.4464979171753,221.13134765625,5883,1399,4484,4484,0,12,1523000.0
1523,1523999,21.5207961848377,37.76967503712683,0.0817269802845888,208.76089882850647,95.50985980033875,221.34102249145508,5889,1401,4488,4488,0,12,1524000.0
1524,1524999,21.514835095989202,37.76143153256897,0.08175013543935783,208.88610744476318,95.57307457923889,221.64679718017578,5889,1401,4488,4488,0,12,1525000.0
1525,1525999,21.5093874873495,37.75316411760402,0.08177295680590946,209.00017642974854,95.63680267333984,221.83135986328125,5889,1401,4488,4488,0,12,1526000.0
1526,1526999,21.50447534759822,37.74639697523892,0.08179401222543159,209.15528464317322,95.70021629333496,221.97900772094727,5891,1402,4489,4489,0,12,1527000.0
1527,1527999,21.499746232954042,37.73916791896291,0.08180729907188833,209.30366325378418,95.76403212547302,222.0529899597168,5894,1403,4491,4491,0,12,1528000.0
1528,1528999,21.49474672235678,37.73133381900219,0.0818276512861783,209.46356391906738,95.82760500907898,221.98720169067383,5900,1406,4494,4494,0,12,1529000.0
1529,1529999,21.490098601577753,37.72419414583568,0.08184596361410468,209.6192388534546,95.89281582832336,222.12199020385742,5904,1408,4496,4496,0,12,1530000.0
1530,1530999,21.485987660498807,37.719243380120965,0.08183604144867229,209.75123977661133,95.95719122886658,222.33666229248047,5904,1408,4496,4496,0,12,1531000.0
1531,1531999,21.48263457140389,37.71359855798249,0.08183360499831216,209.90201330184937,96.02132964134216,222.38959503173828,5907,1409,4498,4498,0,12,1532000.0
1532,1532999,21.478388168196243,37.70655225021033,0.0818384954429432,210.07149362564087,96.08865904808044,222.45904541015625,5911,1411,4500,4500,0,12,1533000.0
1533,1533999,21.474478841343274,37.699220076899515,0.08185308499879784,210.2229869365692,96.15324449539185,222.5813331604004,5913,1412,4501,4501,0,12,1534000.0
1534,1534999,21.470741362530006,37.693885346925995,0.0818460206582502,210.34248089790344,96.21809482574463,222.72282028198242,5913,1412,4501,4501,0,12,1535000.0
1535,1535999,21.468161205448933,37.689525793233145,0.08183939917349925,210.47359776496887,96.28156900405884,222.83123016357422,5915,1413,4502,4502,0,12,1536000.0
1536,1536999,21.4666958889741,37.68690991695727,0.08184927585348156,210.63080763816833,96.3456461429596,222.8377685546875,5919,1415,4504,4504,0,12,1537000.0
1537,1537999,21.464506724202128,37.68252649053331,0.08185901865447331,210.79090023040771,96.41026139259338,222.9188232421875,5924,1417,4507,4507,0,12,1538000.0
1538,1538999,21.46291021742252,37.677864722663365,0.08186142786930484,210.9550120830536,96.47415828704834,222.97278213500977,5928,1419,4509,4509,0,12,1539000.0
1539,1539999,21.4613163488829,37.673865561101294,0.08185663764703477,211.12998747825623,96.53849267959595,223.0058250427246,5932,1421,4511,4511,0,12,1540000.0
1540,1540999,21.45977549679825,37.670401163274185,0.08185924498343677,211.27074790000916,96.6022641658783,223.11930465698242,5935,1422,4513,4513,0,12,1541000.0
1541,1541999,21.457231434265324,37.66460218831002,0.08187080056309959,211.43555545806885,96.67160224914551,223.12217712402344,5939,1424,4515,4515,0,12,1542000.0
1542,1542999,21.45333104254055,37.656768105844364,0.0818651468289372,211.59184980392456,97.58463430404663,224.11491012573242,5972,1425,4547,4547,0,12,1543000.0
1543,1543999,21.44990528923538,37.658251411285455,0.08161457310923825,211.7127330303192,97.64918351173401,224.66455078125,5978,1425,4553,4553,0,12,1544000.0
1544,1544999,21.44604277918955,37.65136853479978,0.08159906352065405,211.84241127967834,97.71329307556152,225.0343017578125,5979,1425,4554,4554,0,12,1545000.0
1545,1545999,21.44187123142461,37.64440136013038,0.0816055000904361,211.96021127700806,97.77710175514221,225.31873321533203,5979,1425,4554,4554,0,12,1546000.0
1546,1546999,21.439011572747095,37.63911003705274,0.08161744071988175,212.12152457237244,97.84125852584839,225.40260314941406,5984,1427,4557,4557,0,12,1547000.0
1547,1547999,21.43713326856281,37.63705856704061,0.08161291182099273,212.28450751304626,97.90537524223328,225.55132675170898,5988,1429,4559,4559,0,12,1548000.0
1548,1548999,21.43598519867924,37.635032245587425,0.08167368554917898,212.42500686645508,97.9707772731781,225.71359634399414,5991,1430,4561,4561,0,12,1549000.0
1549,1549999,21.43476474439299,37.63686613800664,0.08178862951294186,212.62169981002808,98.04501295089722,225.76533126831055,5997,1433,4564,4564,0,12,1550000.0
1550,1550999,21.43208416473624,37.63436735092855,0.08200546460813107,212.8001902103424,98.11127424240112,225.8636131286621,6003,1436,4567,4567,0,12,1551000.0
1551,1551999,21.432411266906836,37.64055924213608,0.08221097949754574,212.99113154411316,98.18326234817505,225.9044952392578,6009,1439,4570,4570,0,12,1552000.0
1552,1552999,21.4313180865022,37.641814937140715,0.0823804884029784,213.1185348033905,98.2483401298523,226.1281967163086,6009,1439,4570,4570,0,12,1553000.0
1553,1553999,21.43297639645417,37.651220393790226,0.08282095215342633,213.29223537445068,98.3131365776062,226.1502571105957,6015,1442,4573,4573,0,12,1554000.0
1554,1554999,21.43418085714908,37.6597090602999,0.08326827246297275,213.44290351867676,98.37876176834106,226.30278396606445,6017,1443,4574,4574,0,12,1555000.0
1555,1555999,21.435011286178078,37.665368795255695,0.08362220122037167,213.59762811660767,98.44495105743408,226.31256866455078,6021,1445,4576,4576,0,12,1556000.0
1556,1556999,21.435288072894046,37.66877882030704,0.08391330718949552,213.74958634376526,98.51083397865295,226.52081298828125,6023,1446,4577,4577,0,12,1557000.0
1557,1557999,21.436176127593683,37.673806428817606,0.08416808729876224,213.89173460006714,98.57623624801636,226.61212158203125,6025,1447,4578,4578,0,12,1558000.0
1558,1558999,21.435600304688812,37.672702184120375,0.08437631552384317,214.08491802215576,98.64267134666443,226.60598373413086,6032,1450,4582,4582,0,12,1559000.0
1559,1559999,21.436213240154487,37.67400482048652,0.08458193791301616,214.23045563697815,98.71049904823303,226.7238883972168,6034,1451,4583,4583,0,12,1560000.0
1560,1560999,21.436981428839687,37.6782783716861,0.08472096446475819,214.36317086219788,98.77573895454407,226.89533615112305,6034,1451,4583,4583,0,12,1561000.0
1561,1561999,21.437328828062114,37.67770544190836,0.08493586459826863,214.50077939033508,98.84079813957214,227.06407165527344,6034,1451,4583,4583,0,12,1562000.0
1562,1562999,21.43575174791908,37.67394678199806,0.08493907112921706,214.65862584114075,98.90603280067444,227.22797775268555,6036,1452,4584,4584,0,12,1563000.0
1563,1563999,21.43395753306743,37.672840898142645,0.08491389430960694,214.81041622161865,98.97331523895264,228.31318283081055,6072,1453,4619,4619,0,12,1564000.0
1564,1564999,21.433087438828043,37.67311687367375,0.08491292430884567,214.93109369277954,99.03758835792542,228.72118377685547,6073,1453,4620,4620,0,12,1565000.0
1565,1565999,21.433256912447465,37.67285939994709,0.08490505710346263,215.07557034492493,99.10341882705688,228.97754669189453,6081,1454,4627,4627,0,12,1566000.0
1566,1566999,21.435343877634292,37.67523614018773,0.08489044729461415,215.23436164855957,99.16793918609619,229.12616729736328,6085,1456,4629,4629,0,12,1567000.0
1567,1567999,21.437002827881958,37.675521744865776,0.0848900569833253,215.37273573875427,99.23193001747131,229.26055908203125,6088,1457,4631,4631,0,12,1568000.0
1568,1568999,21.438417478825553,37.676387292438704,0.0849040273362417,215.4995632171631,99.2960295677185,229.46015548706055,6088,1457,4631,4631,0,12,1569000.0
1569,1569999,21.440974943350508,37.679244748526436,0.08489229446446755,215.6471245288849,99.36183452606201,229.58718490600586,6090,1458,4632,4632,0,12,1570000.0
1570,1570999,21.442388605116545,37.68050887418693,0.0849179222083537,215.795095205307,99.42626094818115,229.7303237915039,6092,1459,4633,4633,0,12,1571000.0
1571,1571999,21.444822651568924,37.68291563007212,0.08490136778323543,215.97874903678894,99.49081420898438,229.72722625732422,6098,1462,4636,4636,0,12,1572000.0
1572,1572999,21.44903310643496,37.68918462468519,0.08488528801128781,216.1713764667511,99.55527091026306,229.71044158935547,6106,1466,4640,4640,0,12,1573000.0
1573,1573999,21.455256654974228,37.70822889724211,0.08488320812712069,216.30675101280212,99.62152624130249,229.94041442871094,6106,1466,4640,4640,0,12,1574000.0
1574,1574999,21.461225169548356,37.71769177599085,0.084911056814158,216.4480082988739,99.68616223335266,230.06708908081055,6106,1466,4640,4640,0,12,1575000.0
1575,1575999,21.468605207527343,37.73603738614541,0.08491159289575956,216.61914801597595,99.75023651123047,230.0702018737793,6111,1468,4643,4643,0,12,1576000.0
1576,1576999,21.477421225446236,37.75923184427441,0.08491561058309749,216.76006078720093,99.81413316726685,230.2044906616211,6113,1469,4644,4644,0,12,1577000.0
1577,1577999,21.48376445951693,37.76813799188721,0.08496634393020308,216.90572261810303,99.87903785705566,230.3242645263672,6115,1470,4645,4645,0,12,1578000.0
1578,1578999,21.488983683715954,37.774405269057624,0.08508591161821,217.11534070968628,99.94371724128723,230.13275527954102,6126,1475,4651,4651,0,12,1579000.0
1579,1579999,21.496977332096023,37.78565220132375,0.08521288512498226,217.2556402683258,100.00853729248047,230.37070846557617,6126,1475,4651,4651,0,12,1580000.0
1580,1580999,21.50430128222881,37.79473594043256,0.08529981561961864,217.3924458026886,100.07307291030884,230.53878021240234,6126,1475,4651,4651,0,12,1581000.0
1581,1581999,21.5122119882446,37.80434989889974,0.08545367169058593,217.54394006729126,100.13742637634277,230.60147094726562,6128,1476,4652,4652,0,12,1582000.0
1582,1582999,21.520456176567006,37.814316177111614,0.08560726067102387,217.6753261089325,100.2019956111908,230.75837326049805,6128,1476,4652,4652,0,12,1583000.0
1583,1583999,21.522414105862747,37.814935485584144,0.08567353192610805,217.8296549320221,100.26802921295166,231.42745208740234,6156,1477,4679,4679,0,12,1584000.0
1584,1584999,21.518000278009165,37.807452862235934,0.08565614915692066,217.94803428649902,100.33167719841003,231.9921646118164,6163,1477,4686,4686,0,12,1585000.0
1585,1585999,21.513106456154357,37.799004241125715,0.08566890770460911,218.0784478187561,100.39498853683472,232.35895156860352,6165,1477,4688,4688,0,12,1586000.0
1586,1586999,21.509441284469883,37.793508385187955,0.08566688503807829,218.21133708953857,100.45909380912781,232.56491470336914,6167,1478,4689,4689,0,12,1587000.0
1587,1587999,21.5056677650262,37.79048613694118,0.08565452453845634,218.3779981136322,100.52293848991394,232.6759262084961,6171,1480,4691,4691,0,12,1588000.0
1588,1588999,21.502677764657395,37.78658482219007,0.08564387451688216,218.50230360031128,100.58652806282043,232.9061393737793,6171,1480,4691,4691,0,12,1589000.0
1589,1589999,21.499462179123423,37.78069382000982,0.08563747230086372,218.62691187858582,100.65087127685547,233.08706665039062,6171,1480,4691,4691,0,12,1590000.0
1590,1590999,21.495571915061515,37.77340436841455,0.08563733501223147,218.79741954803467,100.71493744850159,233.11518096923828,6175,1482,4693,4693,0,12,1591000.0
1591,1591999,21.493017793913463,37.768376323007665,0.08561847868552241,218.9655373096466,100.77895283699036,233.1952018737793,6182,1485,4697,4697,0,12,1592000.0
1592,1592999,21.490678924177647,37.765178988364035,0.08560206438069373,219.10138845443726,100.8426742553711,233.30753707885742,6184,1486,4698,4698,0,12,1593000.0
1593,1593999,21.489298241863718,37.76267776112928,0.08556416377085407,219.25831389427185,100.90704941749573,233.2588996887207,6189,1488,4701,4701,0,12,1594000.0
1594,1594999,21.48853378186867,37.760971408425945,0.08554066582163256,219.44733595848083,100.97206521034241,233.2696876525879,6195,1491,4704,4704,0,12,1595000.0
1595,1595999,21.48853431244487,37.76036952911386,0.08554087505642938,219.58536314964294,101.0363552570343,233.41308975219727,6197,1492,4705,4705,0,12,1596000.0
1596,1596999,21.489343188381596,37.766272759720785,0.08557061996971038,219.72779893875122,101.10011982917786,233.54011917114258,6199,1493,4706,4706,0,12,1597000.0
1597,1597999,21.490818444518634,37.767799462939216,0.08559497891364476,219.88380336761475,101.16565275192261,233.66577529907227,6202,1494,4708,4708,0,12,1598000.0
1598,1598999,21.494580631803665,37.773965697547006,0.08563797743504276,220.02455186843872,101.22986793518066,233.72472381591797,6204,1495,4709,4709,0,12,1599000.0
1599,1599999,21.49842619601189,37.780142793773905,0.08572471547132343,220.1971206665039,101.29452180862427,233.70256805419922,6209,1497,4712,4712,0,12,1600000.0
1600,1600999,21.503802192950076,37.786948383477956,0.08576695451270921,220.36322617530823,101.35926747322083,233.7433090209961,6213,1499,4714,4714,0,12,1601000.0
1601,1601999,21.509654185251744,37.797055063555575,0.08581540108674002,220.51868605613708,101.42392206192017,233.81637954711914,6215,1500,4715,4715,0,12,1602000.0
1602,1602999,21.519153067542874,37.83053577414486,0.0857801857410343,220.63704705238342,101.48767137527466,233.96685791015625,6215,1500,4715,4715,0,12,1603000.0
1603,1603999,21.523615402225175,37.83625228912605,0.08578100730672322,220.767662525177,101.5515775680542,234.12566757202148,6215,1500,4715,4715,0,12,1604000.0
1604,1604999,21.525147267354217,37.837399057377986,0.08572989773521966,220.91564774513245,101.61729073524475,234.95774459838867,6246,1501,4745,4745,0,12,1605000.0
1605,1605999,21.525894481955003,37.85027806710457,0.08558883069600476,221.03969979286194,101.68221473693848,235.67127227783203,6254,1501,4753,4753,0,12,1606000.0
1606,1606999,21.52569876942818,37.85698385602844,0.08554014634012885,221.16719675064087,101.74560737609863,235.9532814025879,6257,1502,4755,4755,0,12,1607000.0
1607,1607999,21.525189549536435,37.860522789351975,0.08548312307584383,221.28670144081116,101.80995869636536,236.28428268432617,6257,1502,4755,4755,0,12,1608000.0
1608,1608999,21.5244595940464,37.85764233670783,0.08546330404129443,221.4546241760254,101.874831199646,236.3479461669922,6264,1505,4759,4759,0,12,1609000.0
1609,1609999,21.523735463754324,37.85726639942734,0.08545914576643832,221.58628678321838,101.94274234771729,236.5709114074707,6264,1505,4759,4759,0,12,1610000.0
1610,1610999,21.52378986815839,37.85929345605221,0.0854911309949008,221.74013781547546,102.00691771507263,236.6676139831543,6268,1507,4761,4761,0,12,1611000.0
1611,1611999,21.522886460977205,37.85820900497988,0.08556434560102488,221.90202713012695,102.07188749313354,236.79835510253906,6272,1509,4763,4763,0,12,1612000.0
1612,1612999,21.522004645117004,37.854820507526746,0.08561275567257931,222.02538585662842,102.13524270057678,237.01800918579102,6272,1509,4763,4763,0,12,1613000.0
1613,1613999,21.52194175091792,37.854818956856725,0.0856627636085483,222.18857598304749,102.19966983795166,237.0224266052246,6278,1512,4766,4766,0,12,1614000.0
1614,1614999,21.522274025633457,37.85437979740403,0.0857260266114136,222.3743031024933,102.26422238349915,237.0172576904297,6286,1515,4771,4771,0,12,1615000.0
1615,1615999,21.52281143842065,37.862164385010246,0.08578246394988842,222.50821161270142,102.32876014709473,237.21552658081055,6286,1515,4771,4771,0,12,1616000.0
1616,1616999,21.522229141911403,37.859467464709645,0.0858140952760933,222.68711686134338,102.39338564872742,237.18490600585938,6295,1519,4776,4776,0,12,1617000.0
1617,1617999,21.52294129576678,37.85867335441142,0.08586766841479265,222.85813808441162,102.45792889595032,237.2804298400879,6299,1521,4778,4778,0,12,1618000.0
1618,1618999,21.523075416310405,37.855540736511685,0.08588297739946393,222.9818558692932,102.52151226997375,237.4975471496582,6299,1521,4778,4778,0,12,1619000.0
1619,1619999,21.523143647302216,37.85282849047787,0.08591480779171634,223.13159441947937,102.58563685417175,237.5517692565918,6303,1523,4780,4780,0,12,1620000.0
1620,1620999,21.524417926571772,37.859721055007064,0.08585426758282355,223.31401991844177,102.65078997612,237.55991744995117,6309,1526,4783,4783,0,12,1621000.0
1621,1621999,21.523638126157977,37.85608613883201,0.0858609009889133,223.47542119026184,102.71523094177246,237.61541748046875,6314,1528,4786,4786,0,12,1622000.0
1622,1622999,21.52227903049031,37.85150483385481,0.08577013898450303,223.62272691726685,102.7804491519928,238.4512710571289,6344,1529,4815,4815,0,12,1623000.0
1623,1623999,21.521251426221713,37.85096143826722,0.08569812935715371,223.73440551757812,102.8443911075592,239.06070709228516,6350,1529,4821,4821,0,12,1624000.0
1624,1624999,21.518661079623204,37.844433432379624,0.08568166040426584,223.9007487297058,102.9085283279419,239.18760681152344,6358,1532,4826,4826,0,12,1625000.0
1625,1625999,21.515807963359897,37.84103633786461,0.08565057621965899,224.04414653778076,102.97291374206543,239.39397048950195,6360,1533,4827,4827,0,12,1626000.0
1626,1626999,21.514054710669207,37.83844303801805,0.08559065603914828,224.19246864318848,103.03647947311401,239.56760025024414,6365,1535,4830,4830,0,12,1627000.0
1627,1627999,21.511604861392808,37.8329482249854,0.08555835986039317,224.35232377052307,103.10770392417908,239.69455337524414,6369,1536,4833,4833,0,12,1628000.0
1628,1628999,21.509388192204916,37.828705359110316,0.08544647135374639,224.4804847240448,103.17180061340332,239.8090934753418,6371,1537,4834,4834,0,12,1629000.0
1629,1629999,21.506531668511,37.82284234963383,0.08540459040909387,224.6430003643036,103.23616170883179,239.87101364135742,6377,1539,4838,4838,0,12,1630000.0
1630,1630999,21.50407265431173,37.82119628960744,0.08532080724085844,224.7981915473938,103.30019903182983,239.99402618408203,6381,1541,4840,4840,0,12,1631000.0
1631,1631999,21.501390560160768,37.815616296151426,0.08526373309059831,224.94772005081177,103.36450529098511,240.1210594177246,6383,1542,4841,4841,0,12,1632000.0
1632,1632999,21.49899668349882,37.812128810904156,0.08522281894068118,225.13348603248596,103.44275903701782,240.16905975341797,6389,1545,4844,4844,0,12,1633000.0
1633,1633999,21.49646665210465,37.80822973617542,0.08517882467214644,225.29817128181458,103.507169008255,240.16789627075195,6393,1547,4846,4846,0,12,1634000.0
1634,1634999,21.493788525146407,37.80299867817928,0.08515157694172781,225.48251461982727,103.57884407043457,240.23078155517578,6428,1550,4878,4878,0,12,1635000.0
1635,1635999,21.490695429393664,37.79806524277026,0.08512782204135338,225.6168189048767,103.643239736557,240.50325393676758,6428,1550,4878,4878,0,12,1636000.0
1636,1636999,21.488033650153447,37.79625565622868,0.08510739722061345,225.77966833114624,103.70764398574829,240.5524024963379,6432,1552,4880,4880,0,12,1637000.0
1637,1637999,21.487931914058002,37.80631057611058,0.08500407780820662,225.92699027061462,103.77203798294067,240.66212844848633,6434,1553,4881,4881,0,12,1638000.0
1638,1638999,21.48610163751443,37.801998616855094,0.08497478990863949,226.07894945144653,103.83597254753113,240.81825256347656,6436,1554,4882,4882,0,12,1639000.0
1639,1639999,21.485123585618712,37.79872872424841,0.08494766282674582,226.20325684547424,103.89971613883972,240.95775985717773,6436,1554,4882,4882,0,12,1640000.0
1640,1640999,21.483279851049986,37.793565440627006,0.08491353253306178,226.34130263328552,103.96337342262268,241.0642204284668,6436,1554,4882,4882,0,12,1641000.0
1641,1641999,21.48138430898889,37.7936741756339,0.08486156423609037,226.49950790405273,104.02834177017212,241.0365982055664,6440,1556,4884,4884,0,12,1642000.0
1642,1642999,21.47900901098847,37.790345487582044,0.08481836267688425,226.6515121459961,104.0941219329834,241.87970733642578,6469,1557,4912,4912,0,12,1643000.0
1643,1643999,21.475408477653147,37.785293530935995,0.0847968639777753,226.78657388687134,104.16149401664734,242.40385818481445,6477,1558,4919,4919,0,12,1644000.0
1644,1644999,21.471887762051047,37.78241913742871,0.08477518135971762,226.93201971054077,104.22565293312073,242.71853637695312,6482,1559,4923,4923,0,12,1645000.0
1645,1645999,21.467902800717567,37.778461942991534,0.08475924888583308,227.08665323257446,104.28941106796265,242.9280891418457,6491,1561,4930,4930,0,12,1646000.0
1646,1646999,21.46553437453032,37.79069410589573,0.08467998693428291,227.21007132530212,104.35297703742981,243.14884185791016,6491,1561,4930,4930,0,12,1647000.0
1647,1647999,21.462494694801343,37.785322703182416,0.08466228809373588,227.33746647834778,104.41740536689758,243.37177658081055,6491,1561,4930,4930,0,12,1648000.0
1648,1648999,21.458485463665756,37.77786500417937,0.08465835124094512,227.5047800540924,104.48504066467285,243.40176010131836,6495,1563,4932,4932,0,12,1649000.0
1649,1649999,21.453755646277447,37.77042348270618,0.08467238487532858,227.65905022621155,104.54895377159119,243.42084884643555,6499,1565,4934,4934,0,12,1650000.0
1650,1650999,21.449538604408072,37.76307400275678,0.08468657787663614,227.84452438354492,104.61380791664124,243.44158554077148,6507,1569,4938,4938,0,12,1651000.0
1651,1651999,21.44558402643484,37.75645020351483,0.08467929138817931,228.00398302078247,104.67857694625854,243.66788482666016,6509,1570,4939,4939,0,12,1652000.0
1652,1652999,21.44162153078864,37.74968345003173,0.08468002165611166,228.12721800804138,104.74273633956909,243.82900619506836,6509,1570,4939,4939,0,12,1653000.0
1653,1653999,21.438490085436285,37.743951554672925,0.08466464361438664,228.3048918247223,104.80726146697998,243.8513069152832,6515,1573,4942,4942,0,12,1654000.0
1654,1654999,21.434891809941725,37.73726920809228,0.08465952200505711,228.4918863773346,104.87200903892517,243.84727096557617,6522,1576,4946,4946,0,12,1655000.0
1655,1655999,21.432382332914933,37.7324994581705,0.08463129388726875,228.62355136871338,104.93681573867798,244.0569076538086,6522,1576,4946,4946,0,12,1656000.0
1656,1656999,21.431285469852273,37.72965637546441,0.08459060856386513,228.74415802955627,105.00078105926514,244.24574279785156,6522,1576,4946,4946,0,12,1657000.0
1657,1657999,21.431285792935324,37.72792049183762,0.08453267822547417,228.9030406475067,105.06514596939087,244.32063674926758,6524,1577,4947,4947,0,12,1658000.0
1658,1658999,21.43180095341836,37.72725633878825,0.08446202190346053,229.05388855934143,105.12987351417542,244.40584564208984,6526,1578,4948,4948,0,12,1659000.0
1659,1659999,21.433596465529064,37.729549312843865,0.08437199315172494,229.2236578464508,105.19417810440063,244.44677352905273,6553,1580,4973,4973,0,12,1660000.0
1660,1660999,21.43380965460133,37.727484302006346,0.08432991696209802,229.3557093143463,105.2592260837555,244.6101188659668,6553,1580,4973,4973,0,12,1661000.0
1661,1661999,21.433647867896898,37.7253985728372,0.08428825405093443,229.50723004341125,105.32357120513916,244.62453842163086,6555,1581,4974,4974,0,12,1662000.0
1662,1662999,21.433277423409667,37.72298453204742,0.08425041666966304,229.66596293449402,105.38848948478699,244.66127395629883,6559,1583,4976,4976,0,12,1663000.0
1663,1663999,21.430329042132875,37.71767457052586,0.08422603134773277,229.80411648750305,105.46334981918335,245.5947608947754,6589,1583,5006,5006,0,12,1664000.0
1664,1664999,21.425880772028055,37.71256866759717,0.08424513087429486,229.9405553340912,105.52725625038147,246.0884246826172,6600,1584,5016,5016,0,12,1665000.0
1665,1665999,21.4205577468636,37.70517813525969,0.08428433320110329,230.09753012657166,105.5914876461029,246.32372665405273,6609,1586,5023,5023,0,12,1666000.0
1666,1666999,21.415184277762553,37.70127702716177,0.08431540281039718,230.22475171089172,105.65568995475769,246.6081886291504,6609,1586,5023,5023,0,12,1667000.0
1667,1667999,21.409396915480666,37.69365845915081,0.0843618246057598,230.3457374572754,105.71900868415833,246.82049942016602,6609,1586,5023,5023,0,12,1668000.0
1668,1668999,21.404319953945407,37.686679800336584,0.08439476243640609,230.47843027114868,105.78631520271301,247.02687072753906,6609,1586,5023,5023,0,12,1669000.0
1669,1669999,21.3987664590113,37.679424827063514,0.08443779308003985,230.65728116035461,105.85054993629456,246.9420394897461,6615,1589,5026,5026,0,12,1670000.0
1670,1670999,21.393377156574033,37.67212189137946,0.08447681640537774,230.81511545181274,105.92584824562073,247.12860488891602,6617,1590,5027,5027,0,12,1671000.0
1671,1671999,21.388235068869406,37.66454437819608,0.08450731253485633,230.98381328582764,105.9898726940155,247.18156814575195,6623,1593,5030,5030,0,12,1672000.0
1672,1672999,21.383369465435287,37.656932474787524,0.08453780046266668,231.13401460647583,106.05375242233276,247.3199005126953,6625,1594,5031,5031,0,12,1673000.0
1673,1673999,21.37866637745113,37.650614591886956,0.08454745876650815,231.2527015209198,106.11731624603271,247.5065040588379,6625,1594,5031,5031,0,12,1674000.0
1674,1674999,21.37415130406853,37.64354479659027,0.08455771052353034,231.43822717666626,106.18099761009216,247.4437026977539,6632,1597,5035,5035,0,12,1675000.0
1675,1675999,21.37001046144876,37.63702639979299,0.08457066574320893,231.6118984222412,106.24712753295898,247.54304122924805,6636,1599,5037,5037,0,12,1676000.0
1676,1676999,21.36608321854134,37.63035889492299,0.08456636635014636,231.7371587753296,106.31141877174377,247.69669723510742,6636,1599,5037,5037,0,12,1677000.0
1677,1677999,21.36321426531107,37.62557366101589,0.08454506159149477,231.87795209884644,106.37556385993958,247.7750129699707,6638,1600,5038,5038,0,12,1678000.0
1678,1678999,21.36217241603874,37.62350832952789,0.08451985391201677,232.078449010849,106.44118595123291,247.7175750732422,6646,1604,5042,5042,0,12,1679000.0
1679,1679999,21.362067446957713,37.62658632899504,0.08448086509288066,232.20799231529236,106.50516152381897,247.9063377380371,6646,1604,5042,5042,0,12,1680000.0
1680,1680999,21.361966765670896,37.62928612263851,0.08443996281754784,232.3666229248047,106.56947445869446,248.03956985473633,6653,1605,5048,5048,0,12,1681000.0
1681,1681999,21.362039073835874,37.63147572164695,0.08439912010590767,232.50447726249695,106.63379240036011,248.10564041137695,6656,1606,5050,5050,0,12,1682000.0
1682,1682999,21.36061848903569,37.62735283930031,0.08440149111255069,232.64588594436646,106.6977641582489,248.13964462280273,6658,1607,5051,5051,0,12,1683000.0
1683,1683999,21.358525469703746,37.622048949161275,0.08440552539391877,232.82336044311523,106.76257348060608,248.1606101989746,6662,1609,5053,5053,0,12,1684000.0
1684,1684999,21.35472691712905,37.61537320226333,0.08441012853760244,232.96467995643616,106.83619141578674,249.37419891357422,6697,1609,5088,5088,0,12,1685000.0
1685,1685999,21.349509556974738,37.607989366984846,0.08443618841467115,233.07595801353455,106.90041828155518,249.92600631713867,6702,1609,5093,5093,0,12,1686000.0
1686,1686999,21.345628712187096,37.601553960989,0.08446139369534811,233.20225524902344,106.96849751472473,250.28224182128906,6703,1609,5094,5094,0,12,1687000.0
1687,1687999,21.341663849431146,37.59492219026381,0.08450110423637525,233.3523690700531,107.03241872787476,250.50023651123047,6708,1611,5097,5097,0,12,1688000.0
1688,1688999,21.33810010756704,37.58922181749806,0.08453016688731196,233.48821353912354,107.0963487625122,250.6707992553711,6710,1612,5098,5098,0,12,1689000.0
1689,1689999,21.335335435573327,37.58680243784974,0.08456258158650032,233.66093707084656,107.16084218025208,250.76817321777344,6716,1615,5101,5101,0,12,1690000.0
1690,1690999,21.33295539041491,37.5832376292806,0.0846511006432269,233.80680179595947,107.2263240814209,251.01551818847656,6718,1616,5102,5102,0,12,1691000.0
1691,1691999,21.330159492962583,37.57942455692338,0.08481761277742728,233.9628074169159,107.29051232337952,251.16402435302734,6722,1618,5104,5104,0,12,1692000.0
1692,1692999,21.32801310422042,37.580144060559256,0.08495213928731615,234.10157704353333,107.35532236099243,251.40070724487305,6722,1618,5104,5104,0,12,1693000.0
1693,1693999,21.327981870340928,37.59180545917472,0.08509822555092317,234.25656032562256,107.4196195602417,251.4803237915039,6726,1620,5106,5106,0,12,1694000.0
1694,1694999,21.327187787854722,37.592955320128276,0.08530906987944875,234.37269759178162,107.48370885848999,251.6229362487793,6726,1620,5106,5106,0,12,1695000.0
1695,1695999,21.328481163411308,37.59945783762403,0.08570593521636594,234.5494887828827,107.54818367958069,251.6233139038086,6734,1623,5111,5111,0,12,1696000.0
1696,1696999,21.328363161048664,37.601501001092295,0.08607247030400444,234.68513298034668,107.61271953582764,251.79161071777344,6734,1623,5111,5111,0,12,1697000.0
1697,1697999,21.327913903552997,37.60284883104687,0.08630586202969137,234.84335017204285,107.67696976661682,251.89179611206055,6736,1624,5112,5112,0,12,1698000.0
1698,1698999,21.328406474575452,37.60559375807509,0.08658379695418883,235.01742100715637,107.7417984008789,251.84809112548828,6744,1627,5117,5117,0,12,1699000.0
1699,1699999,21.329822800939358,37.61270001204555,0.0868187513471691,235.17770314216614,107.80682730674744,251.9678077697754,6748,1629,5119,5119,0,12,1700000.0
1700,1700999,21.330497169838345,37.61418716383975,0.08706108387457856,235.3399064540863,107.87181758880615,252.0659942626953,6752,1631,5121,5121,0,12,1701000.0
1701,1701999,21.33172968735609,37.615824984532296,0.08733307667472578,235.46837830543518,107.93702745437622,252.25101470947266,6752,1631,5121,5121,0,12,1702000.0
1702,1702999,21.33426103674449,37.6200662905852,0.0874629650528882,235.61205124855042,108.00151944160461,252.30685424804688,6754,1632,5122,5122,0,12,1703000.0
1703,1703999,21.335295270183117,37.61992687040288,0.08758815976124124,235.757719039917,108.06647849082947,252.45338821411133,6754,1632,5122,5122,0,12,1704000.0
1704,1704999,21.336552534455787,37.63202674950233,0.08757554218967467,235.89283895492554,108.13146185874939,252.6276741027832,6754,1632,5122,5122,0,12,1705000.0
1705,1705999,21.335416817491225,37.63491529998084,0.08746135150272083,236.03525853157043,108.19790744781494,254.06684494018555,6801,1633,5168,5168,0,12,1706000.0
1706,1706999,21.331389077899885,37.62825202507155,0.08745720037152072,236.14757680892944,108.26208591461182,254.72514724731445,6805,1633,5172,5172,0,12,1707000.0
1707,1707999,21.327333200189443,37.6213034405533,0.08746869973425409,236.25950074195862,108.325199842453,255.10149765014648,6805,1633,5172,5172,0,12,1708000.0
1708,1708999,21.32399483193216,37.62039989785877,0.08743614468004623,236.41567540168762,108.39202690124512,255.43571853637695,6809,1635,5174,5174,0,12,1709000.0
1709,1709999,21.321128771794044,37.615956209560494,0.08742447649377294,236.54514002799988,108.45541715621948,255.71543884277344,6811,1636,5175,5175,0,12,1710000.0
1710,1710999,21.317978554019238,37.6109327270467,0.08741930526339547,236.66983079910278,108.51858139038086,255.9843864440918,6811,1636,5175,5175,0,12,1711000.0
1711,1711999,21.315908437311872,37.60693101710794,0.08740254207796894,236.78944993019104,108.58146786689758,256.21847915649414,6811,1636,5175,5175,0,12,1712000.0
1712,1712999,21.31419044795681,37.60327860257649,0.0873851876551861,236.96415305137634,108.64531135559082,256.2897529602051,6817,1639,5178,5178,0,12,1713000.0
1713,1713999,21.31273595906717,37.59946032252883,0.08736836253641556,237.1653208732605,108.71051549911499,256.31725692749023,6827,1644,5183,5183,0,12,1714000.0
1714,1714999,21.311931475052383,37.61123306891863,0.08728453385831536,237.30258417129517,108.77405047416687,256.54749298095703,6829,1645,5184,5184,0,12,1715000.0
1715,1715999,21.312179201225277,37.610658370273896,0.08726222024910868,237.4870409965515,108.83835554122925,256.5502281188965,6835,1648,5187,5187,0,12,1716000.0
1716,1716999,21.311746939402607,37.609605287022575,0.08725432854509274,237.62329196929932,108.90347099304199,256.732177734375,6837,1649,5188,5188,0,12,1717000.0
1717,1717999,21.312870968839555,37.61776671569807,0.08721426035247215,237.75419902801514,108.96724152565002,256.92341232299805,6839,1650,5189,5189,0,12,1718000.0
1718,1718999,21.314486400768377,37.62163441049352,0.08720383668853315,237.89821600914001,109.03142356872559,257.0642967224121,6841,1651,5190,5190,0,12,1719000.0
1719,1719999,21.316102554890325,37.62497968032423,0.08719037983124633,238.08518981933594,109.09612202644348,257.1111640930176,6847,1654,5193,5193,0,12,1720000.0
1720,1720999,21.319793360314076,37.63241709022692,0.08719214884167514,238.2538878917694,109.16016292572021,257.20284271240234,6853,1657,5196,5196,0,12,1721000.0
1721,1721999,21.324484636013167,37.646970566006345,0.08716783487949131,238.3874969482422,109.2247486114502,257.42241287231445,6855,1658,5197,5197,0,12,1722000.0
1722,1722999,21.32844719249787,37.65934031131676,0.0872311743995966,238.54267764091492,109.28936886787415,257.5583801269531,6857,1659,5198,5198,0,12,1723000.0
1723,1723999,21.33151986782388,37.66483072013672,0.08727588072734216,238.6822509765625,109.35411739349365,257.7545738220215,6857,1659,5198,5198,0,12,1724000.0
1724,1724999,21.335604609601695,37.67245130561537,0.08728458053935328,238.8328492641449,109.41834378242493,257.8431587219238,6861,1660,5201,5201,0,12,1725000.0
1725,1725999,21.33611472361568,37.672331906199034,0.087273255269528,238.96097350120544,109.48408150672913,258.6612892150879,6884,1660,5224,5224,0,12,1726000.0
1726,1726999,21.332789188431228,37.66693090492813,0.08724172865582347,239.07345151901245,109.54869890213013,259.6873016357422,6905,1660,5245,5245,0,12,1727000.0
1727,1727999,21.32903169116155,37.661991668717796,0.08724372811484848,239.19569945335388,109.61244106292725,260.1957817077637,6907,1660,5247,5247,0,12,1728000.0
1728,1728999,21.326064569923297,37.66164452321118,0.08721523171777257,239.3137412071228,109.67542362213135,260.57052993774414,6907,1660,5247,5247,0,12,1729000.0
1729,1729999,21.32326455544039,37.658202932181524,0.08720334496426863,239.46643614768982,109.73880767822266,260.76477432250977,6911,1662,5249,5249,0,12,1730000.0
1730,1730999,21.32098752164012,37.6543063005544,0.08720074480751128,239.635071516037,109.80237579345703,260.88562774658203,6917,1665,5252,5252,0,12,1731000.0
1731,1731999,21.3183577844465,37.64925243094933,0.0871928770586311,239.76987981796265,109.865966796875,261.13035583496094,6919,1666,5253,5253,0,12,1732000.0
1732,1732999,21.31542350687517,37.644297852338596,0.08718954489139696,239.91661477088928,109.93113446235657,261.2836265563965,6923,1668,5255,5255,0,12,1733000.0
1733,1733999,21.313105425034205,37.63995113263379,0.08717481906846514,240.10582184791565,109.99505615234375,261.4049263000488,6931,1672,5259,5259,0,12,1734000.0
1734,1734999,21.312529403799807,37.63957284024081,0.0871590615908312,240.26695919036865,110.05949807167053,261.58827209472656,6935,1674,5261,5261,0,12,1735000.0
1735,1735999,21.31212950280746,37.639669225550925,0.08714388977182463,240.40752744674683,110.1243827342987,261.7100410461426,6939,1675,5264,5264,0,12,1736000.0
1736,1736999,21.312416196920882,37.652082379944595,0.08713087710800127,241.5328929424286,110.18895077705383,261.8893737792969,6941,1676,5265,5265,0,12,1737000.0
1737,1737999,21.31237751674561,37.651878151546924,0.0871311497504409,241.73875260353088,110.25359010696411,261.8391647338867,6949,1680,5269,5269,0,12,1738000.0
1738,1738999,21.312699250628906,37.65214839959807,0.08713825095731054,241.8782980442047,110.31833982467651,261.9672203063965,6951,1681,5270,5270,0,12,1739000.0
1739,1739999,21.312853663986008,37.65167851990518,0.0871541063085507,241.9992334842682,110.38295817375183,262.24142837524414,6951,1681,5270,5270,0,12,1740000.0
1740,1740999,21.31458409426314,37.654422257587605,0.08714198050050592,242.14987635612488,110.4472107887268,262.3830680847168,6953,1682,5271,5271,0,12,1741000.0
1741,1741999,21.316575484925306,37.658022980684514,0.08716326954357467,242.322598695755,110.51153898239136,262.40163803100586,6959,1684,5275,5275,0,12,1742000.0
1742,1742999,21.320306287938394,37.665847939177134,0.08720680372140455,242.49499821662903,110.5764319896698,262.5422554016113,6989,1686,5303,5303,0,12,1743000.0
1743,1743999,21.32488988774032,37.685648204905576,0.08717213878013119,242.66219305992126,110.64079856872559,262.64845275878906,6993,1688,5305,5305,0,12,1744000.0
1744,1744999,21.328351540699643,37.693326990077864,0.08716795782042219,242.8458490371704,110.70605182647705,262.71235275268555,6997,1690,5307,5307,0,12,1745000.0
1745,1745999,21.33036239014369,37.69599020530648,0.0871877896111507,242.95898461341858,110.77002716064453,262.9076385498047,6997,1690,5307,5307,0,12,1746000.0
1746,1746999,21.32999514209192,37.69639807664897,0.08712658759307601,243.08631205558777,110.838050365448,264.2248992919922,7037,1690,5347,5347,0,12,1747000.0
1747,1747999,21.330078912111926,37.69808702828755,0.08710133374532802,243.2260980606079,110.91189193725586,265.04523849487305,7046,1690,5356,5356,0,12,1748000.0
1748,1748999,21.32805572413352,37.69509158920487,0.08709380559745927,243.38513898849487,110.97818684577942,265.3237762451172,7050,1692,5358,5358,0,12,1749000.0
1749,1749999,21.326400401132993,37.69479909378053,0.0870843938422371,243.50461316108704,111.04200983047485,265.75453186035156,7051,1692,5359,5359,0,12,1750000.0
1750,1750999,21.3251251554602,37.693719472874186,0.08708683044707288,243.63951230049133,111.10610556602478,266.08349227905273,7053,1693,5360,5360,0,12,1751000.0
1751,1751999,21.324113707345333,37.695581863252926,0.08706711226544506,243.79191207885742,111.17063975334167,266.2977867126465,7057,1695,5362,5362,0,12,1752000.0
1752,1752999,21.323440201548117,37.695175959005816,0.08707723328953065,243.9513599872589,111.2354896068573,266.476863861084,7061,1697,5364,5364,0,12,1753000.0
1753,1753999,21.322404449353467,37.69266595944856,0.08708790442356573,244.13921785354614,111.30093479156494,266.57843017578125,7067,1700,5367,5367,0,12,1754000.0
1754,1754999,21.322230502037144,37.69193866605369,0.08706499120176625,244.35212326049805,111.36693120002747,266.64690017700195,7077,1705,5372,5372,0,12,1755000.0
1755,1755999,21.321666162396053,37.690788547199446,0.08708388221961438,244.54564714431763,111.43325662612915,266.783390045166,7083,1708,5375,5375,0,12,1756000.0
1756,1756999,21.320688775124097,37.690002912944216,0.08707843615031619,244.67374324798584,111.50066995620728,267.11865234375,7083,1708,5375,5375,0,12,1757000.0
1757,1757999,21.321918220791947,37.69813868205317,0.0870613108761279,244.80095195770264,111.56566643714905,267.3840637207031,7083,1708,5375,5375,0,12,1758000.0
1758,1758999,21.322013764285465,37.69667425464016,0.08705130091823254,245.00542616844177,111.63278794288635,267.38838958740234,7091,1712,5379,5379,0,12,1759000.0
1759,1759999,21.323035185958783,37.6966023329956,0.08703185280911119,245.14297819137573,111.69826531410217,267.60833740234375,7091,1712,5379,5379,0,12,1760000.0
1760,1760999,21.32353688671294,37.695649287434,0.08704344557302357,245.27524280548096,111.76359844207764,267.8406791687012,7091,1712,5379,5379,0,12,1761000.0
1761,1761999,21.326003233155415,37.69778542710794,0.08705611575841621,245.43390250205994,111.82898044586182,268.03498458862305,7093,1713,5380,5380,0,12,1762000.0
1762,1762999,21.327120641624802,37.69749548173203,0.08706336676468895,245.5661656856537,111.89491176605225,268.24755096435547,7093,1713,5380,5380,0,12,1763000.0
1763,1763999,21.3291293893305,37.70258713482426,0.08703996176902062,245.72361946105957,111.95999264717102,268.4015655517578,7095,1714,5381,5381,0,12,1764000.0
1764,1764999,21.32634252534793,37.697603503084295,0.08703140124375197,245.8981192111969,112.03068780899048,268.7346534729004,7110,1717,5393,5393,0,12,1765000.0
1765,1765999,21.322002211743712,37.693192706748405,0.08704145344989478,246.05755019187927,112.09128260612488,269.0081253051758,7114,1718,5396,5396,0,12,1766000.0
1766,1766999,21.318292901140065,37.69008483273098,0.0870478605832109,246.19285655021667,112.15143585205078,269.1800308227539,7115,1718,5397,5397,0,12,1767000.0
1767,1767999,21.315349762620727,37.687129485352195,0.08703077309353646,246.33090376853943,112.21258163452148,269.8076934814453,7132,1719,5413,5413,0,12,1768000.0
1768,1768999,21.312229142631494,37.68395429456741,0.08700617476418437,246.44134950637817,112.27380657196045,270.2199020385742,7133,1719,5414,5414,0,12,1769000.0
1769,1769999,21.308803471486645,37.67890254182257,0.0870020221465142,246.57822179794312,112.33502054214478,270.44617462158203,7135,1720,5415,5415,0,12,1770000.0
1770,1770999,21.30538870413419,37.67357792982943,0.08699259186482111,246.6958110332489,112.39585471153259,270.69397354125977,7135,1720,5415,5415,0,12,1771000.0
1771,1771999,21.302756756120026,37.67202297822957,0.08695847426715708,246.87340593338013,112.4574294090271,270.7651176452637,7140,1722,5418,5418,0,12,1772000.0
1772,1772999,21.30061781299906,37.668873084822955,0.08692051601350514,247.05278897285461,112.51865363121033,270.8698425292969,7144,1724,5420,5420,0,12,1773000.0
1773,1773999,21.298435180578153,37.66652507726562,0.08688614245772208,247.20278072357178,112.5795476436615,270.9382667541504,7146,1725,5421,5421,0,12,1774000.0
1774,1774999,21.296730984577437,37.66357790672675,0.0868537568604274,247.32656979560852,112.64069962501526,271.1368751525879,7146,1725,5421,5421,0,12,1775000.0
1775,1775999,21.295973953026316,37.664206564232394,0.08680855795452092,247.45534086227417,112.7013943195343,271.26856994628906,7147,1725,5422,5422,0,12,1776000.0
1776,1776999,21.296579393183126,37.668480241235734,0.0867465651090168,247.6137456893921,112.76261639595032,271.3150939941406,7155,1726,5429,5429,0,12,1777000.0
1777,1777999,21.29696995803223,37.66914730088125,0.08669515638093295,247.74667024612427,112.82338857650757,271.4244613647461,7155,1726,5429,5429,0,12,1778000.0
1778,1778999,21.299202043588007,37.675271597867145,0.08663637877178298,247.89370775222778,112.88420057296753,271.46188735961914,7157,1727,5430,5430,0,12,1779000.0
1779,1779999,21.301391490146617,37.679337085666106,0.08664356873731771,248.04752898216248,112.94520807266235,271.5013427734375,7159,1728,5431,5431,0,12,1780000.0
1780,1780999,21.30572510436589,37.68902466253476,0.08662566511561764,248.2071931362152,113.01042699813843,271.60851669311523,7161,1729,5432,5432,0,12,1781000.0
1781,1781999,21.310118763320666,37.699666346126314,0.08665508864359484,248.3809473514557,113.07343983650208,271.5835494995117,7165,1731,5434,5434,0,12,1782000.0
1782,1782999,21.31520976006385,37.71082814757898,0.08664907658831889,248.49524354934692,113.13455295562744,271.7269630432129,7165,1731,5434,5434,0,12,1783000.0
1783,1783999,21.31791780917366,37.7147688822885,0.08661975226277896,248.64205169677734,113.19913792610168,271.85450744628906,7165,1731,5434,5434,0,12,1784000.0
1784,1784999,21.319347599718206,37.71356210460193,0.08649410920990841,248.77276015281677,113.26094079017639,272.3621711730957,7172,1731,5441,5441,0,12,1785000.0
1785,1785999,21.318228894682736,37.71115562491057,0.0864476267219546,248.91674971580505,113.32250809669495,272.6084289550781,7173,1731,5442,5442,0,12,1786000.0
1786,1786999,21.316402363060785,37.70684976953655,0.08640888542982461,249.0369095802307,113.38579368591309,272.7699317932129,7174,1731,5443,5443,0,12,1787000.0
1787,1787999,21.31498766055826,37.70452440169321,0.08637268731980352,249.16133451461792,113.446542263031,272.88583755493164,7174,1731,5443,5443,0,12,1788000.0
1788,1788999,21.314038687545747,37.70253597280559,0.08633824305953819,249.3248782157898,113.5072705745697,272.84937286376953,7176,1732,5444,5444,0,12,1789000.0
1789,1789999,21.313595576955073,37.70036822483951,0.08628667826780134,249.4691002368927,113.56791853904724,272.9087333679199,7178,1733,5445,5445,0,12,1790000.0
1790,1790999,21.311990860012042,37.69521432924522,0.08624352946055747,249.6018090248108,113.62889671325684,273.01002502441406,7178,1733,5445,5445,0,12,1791000.0
1791,1791999,21.31124770078121,37.69238084272864,0.08618972882571929,249.7542290687561,113.68966627120972,273.08238220214844,7180,1734,5446,5446,0,12,1792000.0
1792,1792999,21.3095293749976,37.68723785215547,0.08615447184916969,249.95689487457275,113.75100994110107,273.0086784362793,7186,1737,5449,5449,0,12,1793000.0
1793,1793999,21.30901749225581,37.6942732649428,0.0860794287479889,250.0837438106537,113.81200313568115,273.1478157043457,7186,1737,5449,5449,0,12,1794000.0
1794,1794999,21.30950042650005,37.692865929302414,0.08601970285011029,250.20879578590393,113.87309074401855,273.23509979248047,7186,1737,5449,5449,0,12,1795000.0
1795,1795999,21.308741187250185,37.68876286147408,0.0859719227226673,250.35311675071716,113.93419122695923,273.3124885559082,7186,1737,5449,5449,0,12,1796000.0
1796,1796999,21.30842714513205,37.68642346488314,0.0859272145615243,250.49670672416687,113.9958906173706,273.3769989013672,7186,1737,5449,5449,0,12,1797000.0
1797,1797999,21.307886316131604,37.68259965988702,0.08589619840431362,250.6761028766632,114.0647439956665,273.35963439941406,7188,1738,5450,5450,0,12,1798000.0
1798,1798999,21.30733588136334,37.67943123192241,0.08586132903221122,250.82767295837402,114.12576842308044,273.3517036437988,7190,1739,5451,5451,0,12,1799000.0
1799,1799999,21.307512233379125,37.67723940874346,0.08583103830876326,250.984628200531,114.18747806549072,273.40939712524414,7192,1740,5452,5452,0,12,1800000.0
1800,1800999,21.30797694466995,37.684119082820125,0.08576808100864242,251.12426614761353,114.24902987480164,273.4877166748047,7192,1740,5452,5452,0,12,1801000.0
1801,1801999,21.308009390501034,37.68172435589347,0.08574005686524211,251.25939869880676,114.31032872200012,273.5512924194336,7192,1740,5452,5452,0,12,1802000.0
1802,1802999,21.308383653886512,37.67899457314756,0.08571761084924379,251.4071660041809,114.37121391296387,273.59217071533203,7192,1740,5452,5452,0,12,1803000.0
1803,1803999,21.307364173903235,37.67502355486279,0.08571023755950369,251.5393214225769,114.43669056892395,273.62883377075195,7192,1740,5452,5452,0,12,1804000.0
1804,1804999,21.30558467972546,37.67007663242462,0.08571178336146479,251.69194078445435,114.4977433681488,273.67526626586914,7192,1740,5452,5452,0,12,1805000.0
1805,1805999,21.30491926751544,37.66715388398441,0.08564681808616292,251.83441877365112,114.56548833847046,273.9189033508301,7202,1741,5461,5461,0,12,1806000.0
1806,1806999,21.302372776405477,37.66197108066552,0.08564663724998212,251.97425270080566,114.62723278999329,274.14776611328125,7202,1741,5461,5461,0,12,1807000.0
1807,1807999,21.301303752312815,37.66050645150774,0.08564762572928297,252.12611055374146,114.6883339881897,274.26811599731445,7204,1742,5462,5462,0,12,1808000.0
1808,1808999,21.301945743105307,37.663467955325814,0.08562706338441972,252.2636833190918,114.74954342842102,274.35932540893555,7206,1743,5463,5463,0,12,1809000.0
1809,1809999,21.301325824740225,37.66494353850563,0.08560131946165916,252.40462279319763,114.81107306480408,274.480411529541,7206,1743,5463,5463,0,12,1810000.0
1810,1810999,21.30198481272719,37.667200132692805,0.08560450141418796,252.5870521068573,114.8724992275238,274.3928337097168,7211,1745,5466,5466,0,12,1811000.0
1811,1811999,21.30341473931765,37.670699836537516,0.08559986609995085,252.72702479362488,114.93522095680237,274.502140045166,7213,1746,5467,5467,0,12,1812000.0
1812,1812999,21.304989205427066,37.67135683295105,0.08559398967019982,252.86618399620056,114.99646019935608,274.59704971313477,7215,1747,5468,5468,0,12,1813000.0
1813,1813999,21.305222274521824,37.67059951747788,0.08557170948348825,253.0687961578369,115.05889463424683,274.59169006347656,7219,1749,5470,5470,0,12,1814000.0
1814,1814999,21.30559787359116,37.67137830544917,0.08556931037312676,253.18416142463684,115.12059020996094,274.7156562805176,7220,1749,5471,5471,0,12,1815000.0
1815,1815999,21.307429055468425,37.67585143787505,0.08555941965301372,253.30654406547546,115.18170499801636,274.82016372680664,7220,1749,5471,5471,0,12,1816000.0
1816,1816999,21.30782943587334,37.674652821376085,0.08556992447680734,253.48109197616577,115.24358868598938,274.8667869567871,7220,1749,5471,5471,0,12,1817000.0
1817,1817999,21.307989075536273,37.67310953118087,0.08555687861356964,253.60890531539917,115.30491900444031,274.9426956176758,7220,1749,5471,5471,0,12,1818000.0
1818,1818999,21.310269113803297,37.6806633075596,0.08553597804515134,253.75372409820557,115.36600279808044,274.9944381713867,7220,1749,5471,5471,0,12,1819000.0
1819,1819999,21.311631245368353,37.68036376577015,0.08551142964433522,253.92379236221313,115.427649974823,274.8571014404297,7225,1751,5474,5474,0,12,1820000.0
1820,1820999,21.313302217268827,37.68042849092683,0.0854821428606054,254.06652665138245,115.4901671409607,274.9461669921875,7227,1752,5475,5475,0,12,1821000.0
1821,1821999,21.315828259519694,37.68307520518703,0.08547888796496228,254.21940922737122,115.55190396308899,274.94255447387695,7229,1753,5476,5476,0,12,1822000.0
1822,1822999,21.31776641947552,37.683210671051995,0.08546993040443107,254.3568992614746,115.61402130126953,275.0486030578613,7229,1753,5476,5476,0,12,1823000.0
1823,1823999,21.322338217446415,37.68875912279835,0.08547480668696594,254.54702520370483,115.6763231754303,274.88150787353516,7234,1755,5479,5479,0,12,1824000.0
1824,1824999,21.324741979807655,37.68952275376439,0.08547855289892059,254.68955826759338,115.73947310447693,275.01514434814453,7235,1755,5480,5480,0,12,1825000.0
1825,1825999,21.324661494236913,37.68684104715667,0.08543225125880771,254.81868839263916,115.80137753486633,275.49709701538086,7247,1755,5492,5492,0,12,1826000.0
1826,1826999,21.32178186411373,37.68325950407774,0.08541534548022367,254.92544388771057,115.86271166801453,275.8443832397461,7247,1755,5492,5492,0,12,1827000.0
1827,1827999,21.318936000339146,37.678975738819545,0.08540067722580669,255.0736529827118,115.9245617389679,276.00744247436523,7249,1756,5493,5493,0,12,1828000.0
1828,1828999,21.31744193863347,37.67902502617849,0.08536906867491156,255.21802043914795,115.9860475063324,276.08568954467773,7253,1758,5495,5495,0,12,1829000.0
1829,1829999,21.31408241280374,37.67267371840532,0.08535943005722058,255.4193561077118,116.04854464530945,276.17727279663086,7259,1761,5498,5498,0,12,1830000.0
1830,1830999,21.31256386127257,37.68086860133596,0.08527614478473755,255.56813764572144,116.11078596115112,276.3099136352539,7261,1762,5499,5499,0,12,1831000.0
1831,1831999,21.311325668708495,37.67710431653465,0.08524892758014968,255.68259978294373,116.17320609092712,276.46639251708984,7261,1762,5499,5499,0,12,1832000.0
1832,1832999,21.31055367032788,37.67619921659589,0.0852252943060855,255.81824922561646,116.23593497276306,276.59663009643555,7261,1762,5499,5499,0,12,1833000.0
1833,1833999,21.30992354272559,37.673595380115735,0.08520564076084713,255.99021935462952,116.29795908927917,276.6419906616211,7263,1763,5500,5500,0,12,1834000.0
1834,1834999,21.3100334409366,37.672687004855455,0.08519638078414471,256.1186122894287,116.35981917381287,276.7464599609375,7263,1763,5500,5500,0,12,1835000.0
1835,1835999,21.31182649921135,37.67478577467804,0.08517790859217922,256.25409173965454,116.42193841934204,276.81834411621094,7263,1763,5500,5500,0,12,1836000.0
1836,1836999,21.313636778109853,37.67791796277171,0.0851691433668651,256.43203496932983,116.48468446731567,276.7302474975586,7273,1765,5508,5508,0,12,1837000.0
1837,1837999,21.316071143088195,37.681829650191474,0.08514838191763063,256.5751507282257,116.54685568809509,276.8128967285156,7275,1766,5509,5509,0,12,1838000.0
1838,1838999,21.318520379284553,37.684839077842625,0.08515126636969539,256.7274081707001,116.60922932624817,276.8258476257324,7277,1767,5510,5510,0,12,1839000.0
1839,1839999,21.321965009818335,37.689494554745686,0.08520635131486931,256.86084842681885,116.67137217521667,276.94759368896484,7277,1767,5510,5510,0,12,1840000.0
1840,1840999,21.32600863780655,37.696772533333956,0.08527097101019676,256.9939875602722,116.73334670066833,277.03900146484375,7277,1767,5510,5510,0,12,1841000.0
1841,1841999,21.33163851572776,37.70504066773914,0.08533536592699831,257.1812081336975,116.79579186439514,276.9634552001953,7281,1769,5512,5512,0,12,1842000.0
1842,1842999,21.336683811319375,37.71096469805393,0.08542901626834154,257.3685073852539,116.85857939720154,276.8790817260742,7287,1772,5515,5515,0,12,1843000.0
1843,1843999,21.343296784023455,37.72080666968221,0.08550635319605382,257.5190362930298,116.92083024978638,276.9930839538574,7289,1773,5516,5516,0,12,1844000.0
1844,1844999,21.34977657411854,37.74012416512522,0.08554778243352545,257.66264724731445,116.98315811157227,277.03439712524414,7293,1774,5519,5519,0,12,1845000.0
1845,1845999,21.353384301024782,37.7450177403588,0.0855890708076239,257.81988406181335,117.04602026939392,277.0682373046875,7295,1775,5520,5520,0,12,1846000.0
1846,1846999,21.35418730246554,37.74317566304596,0.0855416161401712,257.9379937648773,117.10887384414673,277.7568244934082,7309,1775,5534,5534,0,12,1847000.0
1847,1847999,21.35119967184111,37.73851722948741,0.08552401381803754,258.06302094459534,117.17011857032776,278.10303497314453,7310,1775,5535,5535,0,12,1848000.0
1848,1848999,21.348246963895335,37.73246037005069,0.08551333250164517,258.1890366077423,117.23599672317505,278.30554962158203,7310,1775,5535,5535,0,12,1849000.0
1849,1849999,21.34547281904354,37.729044437394855,0.0854936557671041,258.3896234035492,117.29866337776184,278.2530097961426,7318,1779,5539,5539,0,12,1850000.0
1850,1850999,21.342722487446952,37.723987745450046,0.08548563161086054,258.56803798675537,117.36160016059875,278.38312911987305,7324,1782,5542,5542,0,12,1851000.0
1851,1851999,21.340343664315892,37.71850507230332,0.08547336712373221,258.7075140476227,117.4236114025116,278.60766983032227,7326,1783,5543,5543,0,12,1852000.0
1852,1852999,21.337365121176365,37.7130343712444,0.08547095918979408,258.8354411125183,117.48536515235901,278.79545974731445,7326,1783,5543,5543,0,12,1853000.0
1853,1853999,21.334846344758237,37.70785691433927,0.08547376546606056,258.99121594429016,117.54827117919922,278.868953704834,7328,1784,5544,5544,0,12,1854000.0
1854,1854999,21.332438090644374,37.70258062094859,0.08548488893089812,259.1840388774872,117.61105871200562,278.80094146728516,7336,1788,5548,5548,0,12,1855000.0
1855,1855999,21.331196735090323,37.699431580302566,0.08549071073592063,259.33237528800964,117.67332530021667,278.90360260009766,7341,1789,5552,5552,0,12,1856000.0
1856,1856999,21.329293678152386,37.69527936276598,0.08550559978365146,259.4580936431885,117.73575592041016,279.0344581604004,7341,1789,5552,5552,0,12,1857000.0
1857,1857999,21.328469098580573,37.69360803611819,0.08553683448034932,259.6367928981781,117.79972314834595,278.9285087585449,7348,1791,5557,5557,0,12,1858000.0
1858,1858999,21.327971672378204,37.6916244522958,0.08558995127103108,259.79077672958374,117.86246919631958,279.01935958862305,7350,1792,5558,5558,0,12,1859000.0
1859,1859999,21.329254961592547,37.69394284502899,0.08560881179231927,259.9021227359772,117.92474126815796,279.12202072143555,7350,1792,5558,5558,0,12,1860000.0
1860,1860999,21.330424353862877,37.69410561555558,0.08562424884581799,260.03983664512634,117.98715710639954,279.2711944580078,7350,1792,5558,5558,0,12,1861000.0
1861,1861999,21.333083900851587,37.69743339158485,0.08566711624977519,260.23638677597046,118.05034852027893,279.28769302368164,7353,1794,5559,5559,0,12,1862000.0
1862,1862999,21.334762250528176,37.69885955680115,0.08573738728097535,260.37432980537415,118.11257696151733,279.30773544311523,7355,1795,5560,5560,0,12,1863000.0
1863,1863999,21.33700083263917,37.70019037435654,0.08580160725670272,260.5054292678833,118.17541861534119,279.49229431152344,7355,1795,5560,5560,0,12,1864000.0
1864,1864999,21.339914874132198,37.702733399721254,0.0858574481701242,260.6428437232971,118.23844909667969,279.5717124938965,7357,1796,5561,5561,0,12,1865000.0
1865,1865999,21.342507707921566,37.70426921637026,0.08589357584858692,260.79096364974976,118.3008759021759,279.62113189697266,7359,1797,5562,5562,0,12,1866000.0
1866,1866999,21.342912099999825,37.70262966474619,0.08592437199502101,260.9540784358978,118.36383843421936,279.6164016723633,7364,1798,5566,5566,0,12,1867000.0
1867,1867999,21.341957167372048,37.7041038653079,0.08586110074460074,261.0788698196411,118.42683601379395,280.45530700683594,7382,1798,5584,5584,0,12,1868000.0
1868,1868999,21.337407300212913,37.696982771531715,0.0858562997767579,261.193500995636,118.48871421813965,280.8507614135742,7383,1798,5585,5585,0,12,1869000.0
1869,1869999,21.334314344069007,37.6955349587453,0.08583269627734913,261.3378825187683,118.55059242248535,281.0840873718262,7385,1799,5586,5586,0,12,1870000.0
1870,1870999,21.330783394341218,37.689802892272326,0.08583811284921683,261.50189328193665,118.61283850669861,281.16269302368164,7391,1802,5589,5589,0,12,1871000.0
1871,1871999,21.327342584911563,37.68369851657468,0.08582918193785571,261.6608667373657,118.67615461349487,281.3380661010742,7395,1804,5591,5591,0,12,1872000.0
1872,1872999,21.32391599618811,37.677877426288,0.08581954859409169,261.79562544822693,118.73823523521423,281.4793395996094,7397,1805,5592,5592,0,12,1873000.0
1873,1873999,21.321066943303705,37.671770673136294,0.08581579711014409,261.9790072441101,118.80097770690918,281.5334167480469,7403,1808,5595,5595,0,12,1874000.0
1874,1874999,21.318626297420597,37.66768718183131,0.08579928184592933,262.1351957321167,118.86323404312134,281.6217842102051,7407,1810,5597,5597,0,12,1875000.0
1875,1875999,21.31626668903387,37.66244763074415,0.08581036109193807,262.327650308609,118.92665576934814,281.6854438781738,7417,1813,5604,5604,0,12,1876000.0
1876,1876999,21.314168162844204,37.65880677014019,0.0858152761603943,262.45327401161194,118.98907804489136,281.92444610595703,7417,1813,5604,5604,0,12,1877000.0
1877,1877999,21.31253169562142,37.65693356577381,0.08580715287165563,262.589706659317,119.06118535995483,282.08430099487305,7417,1813,5604,5604,0,12,1878000.0
1878,1878999,21.311209090715312,37.65488171918567,0.0858157668634959,262.73006558418274,119.13242554664612,282.22156143188477,7417,1813,5604,5604,0,12,1879000.0
1879,1879999,21.310480445563037,37.652798503070834,0.08582510051983638,262.8688986301422,119.19505667686462,282.3456001281738,7417,1813,5604,5604,0,12,1880000.0
1880,1880999,21.31028973950449,37.657090985588496,0.08580105649540204,263.02834367752075,119.25806021690369,282.38260650634766,7419,1814,5605,5605,0,12,1881000.0
1881,1881999,21.309893660788333,37.65520582665815,0.08582150925479515,263.1933445930481,119.32064056396484,282.3525276184082,7423,1816,5607,5607,0,12,1882000.0
1882,1882999,21.31097594195896,37.655579052770754,0.08580164769486864,263.3380398750305,119.38331294059753,282.44804763793945,7425,1817,5608,5608,0,12,1883000.0
1883,1883999,21.31107193699128,37.65397622774522,0.0858446769959238,263.4855420589447,119.44622659683228,282.51319885253906,7431,1818,5613,5613,0,12,1884000.0
1884,1884999,21.31282161317932,37.6556237931676,0.08587979665994039,263.62370705604553,119.50929594039917,282.6605644226074,7431,1818,5613,5613,0,12,1885000.0
1885,1885999,21.31426404996489,37.65580086821094,0.08588973407377087,263.78336930274963,119.57249450683594,282.75682067871094,7433,1819,5614,5614,0,12,1886000.0
1886,1886999,21.314879179374454,37.654310670749496,0.08590253573850071,263.9179244041443,119.63537359237671,282.8812599182129,7433,1819,5614,5614,0,12,1887000.0
1887,1887999,21.315676842800006,37.65303576234269,0.08589217995033649,264.04058146476746,119.69826245307922,282.9706840515137,7433,1819,5614,5614,0,12,1888000.0
1888,1888999,21.314481845895074,37.648583022643734,0.08583294166078803,264.16966247558594,119.76144647598267,283.832820892334,7451,1819,5632,5632,0,12,1889000.0
1889,1889999,21.31103704303202,37.64251100821839,0.08582387236345945,264.28765654563904,119.82410216331482,284.31815338134766,7453,1819,5634,5634,0,12,1890000.0
1890,1890999,21.30882932113243,37.63954145920591,0.08580514018128815,264.4082827568054,119.88584542274475,284.5641288757324,7453,1819,5634,5634,0,12,1891000.0
1891,1891999,21.305725283835518,37.63394154595474,0.0858011833558886,264.5664231777191,119.95092344284058,284.7347946166992,7457,1821,5636,5636,0,12,1892000.0
1892,1892999,21.302488730327067,37.62796208874908,0.08579831799406745,264.7282416820526,120.01477384567261,284.85458755493164,7461,1823,5638,5638,0,12,1893000.0
1893,1893999,21.30019711024314,37.623699435795345,0.08579988679410422,264.8976972103119,120.07752275466919,284.9059143066406,7467,1826,5641,5641,0,12,1894000.0
1894,1894999,21.29795589558387,37.6214975553568,0.08578751662332806,265.08290100097656,120.14188528060913,285.00971603393555,7473,1829,5644,5644,0,12,1895000.0
1895,1895999,21.295655109175968,37.618857213963175,0.08578009834775269,265.2548701763153,120.20579814910889,285.1047019958496,7477,1831,5646,5646,0,12,1896000.0
1896,1896999,21.293395790656533,37.614111741123885,0.08576932652008284,265.4221284389496,120.26858973503113,285.2422561645508,7487,1834,5653,5653,0,12,1897000.0
1897,1897999,21.290641835761573,37.608973830782126,0.0857611463386666,265.59291100502014,120.3318018913269,285.2623825073242,7492,1836,5656,5656,0,12,1898000.0
1898,1898999,21.289043527999244,37.605672650223745,0.08574551367916505,265.7359251976013,120.39476251602173,285.3346176147461,7499,1837,5662,5662,0,12,1899000.0
1899,1899999,21.286826057456466,37.60374808727582,0.0857224987049825,265.8779399394989,120.45758748054504,285.48465728759766,7501,1838,5663,5663,0,12,1900000.0
1900,1900999,21.284206789623326,37.598044885592685,0.08570984745838117,266.0324378013611,120.52075338363647,285.5729866027832,7510,1839,5671,5671,0,12,1901000.0
1901,1901999,21.281945370443303,37.59301947934965,0.08571017989883734,266.1953818798065,120.58365941047668,285.5500144958496,7514,1841,5673,5673,0,12,1902000.0
1902,1902999,21.280223895260917,37.58878119413087,0.08570540709296903,266.3216633796692,120.64656734466553,285.75414276123047,7514,1841,5673,5673,0,12,1903000.0
1903,1903999,21.279288451736598,37.585273938805045,0.08570619322150785,266.4896023273468,120.70995306968689,285.8476448059082,7516,1842,5674,5674,0,12,1904000.0
1904,1904999,21.277719644738365,37.580649890768456,0.08569569331727545,266.6196060180664,120.77278137207031,285.9960708618164,7516,1842,5674,5674,0,12,1905000.0
1905,1905999,21.275996268923397,37.576134185882864,0.08568318663951147,266.7538492679596,120.8355975151062,286.12176513671875,7516,1842,5674,5674,0,12,1906000.0
1906,1906999,21.27479293761304,37.57222786289199,0.08562501101645104,266.87568831443787,120.8984260559082,287.05356216430664,7531,1842,5689,5689,0,12,1907000.0
1907,1907999,21.272391295510815,37.56773592985977,0.08560947431510413,266.9820580482483,120.9606339931488,287.54675674438477,7532,1842,5690,5690,0,12,1908000.0
1908,1908999,21.269552314266456,37.5632572103443,0.08560809916019341,267.09827852249146,121.02206611633301,287.82807540893555,7532,1842,5690,5690,0,12,1909000.0
1909,1909999,21.26678899412713,37.55851299264285,0.08559871090381843,267.2366507053375,121.0837733745575,287.9575004577637,7534,1843,5691,5691,0,12,1910000.0
1910,1910999,21.264095458583288,37.55340462076833,0.08558581189975689,267.3585216999054,121.14578533172607,288.2120895385742,7535,1843,5692,5692,0,12,1911000.0
1911,1911999,21.261409704145432,37.54747023674612,0.0855909728768558,267.53699922561646,121.20808219909668,288.17906188964844,7549,1847,5702,5702,0,12,1912000.0
1912,1912999,21.258079604557913,37.540735918167314,0.08559638991115925,267.73423886299133,121.27099633216858,288.1717529296875,7555,1850,5705,5705,0,12,1913000.0
1913,1913999,21.255595456385134,37.53535960671196,0.08558581016945876,267.885760307312,121.33380365371704,288.29662704467773,7559,1852,5707,5707,0,12,1914000.0
1914,1914999,21.253478073725258,37.53520029611516,0.08555034060864064,268.04100370407104,121.39802122116089,288.50442123413086,7561,1853,5708,5708,0,12,1915000.0
1915,1915999,21.251333071987837,37.53205543614237,0.08552990788737735,268.18559765815735,121.46032500267029,288.5852928161621,7563,1854,5709,5709,0,12,1916000.0
1916,1916999,21.24906940152893,37.52734293911137,0.08551097472339231,268.3100266456604,121.52265191078186,288.7802925109863,7563,1854,5709,5709,0,12,1917000.0
1917,1917999,21.24691589789681,37.52350406026432,0.085496918832764,268.43690252304077,121.58478927612305,288.9236640930176,7563,1854,5709,5709,0,12,1918000.0
1918,1918999,21.245298121511734,37.53214227343879,0.08543057707586277,268.57045221328735,121.6475260257721,289.0187530517578,7563,1854,5709,5709,0,12,1919000.0
1919,1919999,21.244007944147256,37.5297153767487,0.08540593555322984,268.7407863140106,121.71020412445068,288.9761543273926,7573,1856,5717,5717,0,12,1920000.0
1920,1920999,21.24286511039568,37.52831317248631,0.08540972080952913,268.90405225753784,121.77378439903259,289.07177352905273,7575,1857,5718,5718,0,12,1921000.0
1921,1921999,21.24152970129213,37.52773275361372,0.08539364054389753,269.04588055610657,121.83711671829224,289.1924591064453,7575,1857,5718,5718,0,12,1922000.0
1922,1922999,21.239474259034157,37.52280080381515,0.085395798647243,269.18463253974915,121.9000825881958,289.29364013671875,7575,1857,5718,5718,0,12,1923000.0
1923,1923999,21.23811841515208,37.51929302191035,0.08541086524155705,269.33346676826477,121.96345853805542,289.341495513916,7576,1858,5718,5718,0,12,1924000.0
1924,1924999,21.235868018795376,37.514728140759246,0.08540201369135425,269.4540910720825,122.02590370178223,289.4347457885742,7576,1858,5718,5718,0,12,1925000.0
1925,1925999,21.233323179610245,37.50964646360125,0.08541641430511604,269.59047508239746,122.08848595619202,289.5284729003906,7576,1858,5718,5718,0,12,1926000.0
1926,1926999,21.23088325231597,37.50755089313493,0.08536987035812527,269.71459460258484,122.15157127380371,290.49170684814453,7591,1858,5733,5733,0,12,1927000.0
1927,1927999,21.226784341149255,37.503506612121285,0.08535765016261743,269.8296959400177,122.21304750442505,290.855281829834,7592,1858,5734,5734,0,12,1928000.0
1928,1928999,21.222481831663142,37.49724072056312,0.0853635507651267,269.9639265537262,122.2745909690857,291.0674285888672,7594,1859,5735,5735,0,12,1929000.0
1929,1929999,21.21884267150511,37.49340766475587,0.08536868356686433,270.1546537876129,122.33772373199463,291.1330223083496,7600,1862,5738,5738,0,12,1930000.0
1930,1930999,21.214702572709626,37.48696421391311,0.08537928090463331,270.28355598449707,122.39993715286255,291.3456268310547,7602,1863,5739,5739,0,12,1931000.0
1931,1931999,21.210431546846976,37.48021292613518,0.08538892802873321,270.4248106479645,122.46210551261902,291.48160552978516,7604,1864,5740,5740,0,12,1932000.0
1932,1932999,21.20662552473543,37.473638263817,0.08539085004350389,270.5666651725769,122.52553749084473,291.62134552001953,7606,1865,5741,5741,0,12,1933000.0
1933,1933999,21.20288841412645,37.46777788111267,0.08539324541877891,270.7248821258545,122.58836245536804,291.7336654663086,7608,1866,5742,5742,0,12,1934000.0
1934,1934999,21.199480598742927,37.46248150519332,0.08539276121960082,270.90779519081116,122.65117025375366,291.7447395324707,7614,1869,5745,5745,0,12,1935000.0
1935,1935999,21.19575854144162,37.45623992644748,0.08540482133412841,271.03430128097534,122.71422410011292,291.95418548583984,7614,1869,5745,5745,0,12,1936000.0
1936,1936999,21.192699520998758,37.450712780399044,0.08540522503501069,271.2099401950836,122.77734518051147,291.990779876709,7618,1871,5747,5747,0,12,1937000.0
1937,1937999,21.190416449096208,37.44818631362263,0.0853931987749289,271.3356819152832,122.840163230896,292.1495361328125,7618,1871,5747,5747,0,12,1938000.0
1938,1938999,21.18707068063532,37.44307897094137,0.08538880431884244,271.46950340270996,122.90237760543823,292.26198959350586,7618,1871,5747,5747,0,12,1939000.0
1939,1939999,21.184552987604484,37.43790349392011,0.08537652735985835,271.6023316383362,122.9648163318634,292.3381156921387,7618,1871,5747,5747,0,12,1940000.0
1940,1940999,21.181871463058656,37.43382606949019,0.08536970025952517,271.7884883880615,123.03328967094421,292.33530044555664,7622,1873,5749,5749,0,12,1941000.0
1941,1941999,21.17983269350634,37.43036613665071,0.08535838733419854,271.9237017631531,123.09559464454651,292.48011779785156,7622,1873,5749,5749,0,12,1942000.0
1942,1942999,21.177475919352627,37.425242472040324,0.08535512969911485,272.07091426849365,123.1582932472229,292.5877342224121,7622,1873,5749,5749,0,12,1943000.0
1943,1943999,21.175699282732882,37.424645385084865,0.08533653137279107,272.194296836853,123.22024965286255,292.67162322998047,7622,1873,5749,5749,0,12,1944000.0
1944,1944999,21.173644961853256,37.41954698124988,0.08533676676701762,272.3423960208893,123.28276920318604,292.74683380126953,7622,1873,5749,5749,0,12,1945000.0
1945,1945999,21.17124735300563,37.414452405996286,0.08532896883486463,272.46249294281006,123.34517478942871,292.8048400878906,7622,1873,5749,5749,0,12,1946000.0
1946,1946999,21.168312981796497,37.408772659526186,0.08532483353884734,272.58762431144714,123.40741968154907,292.9091033935547,7622,1873,5749,5749,0,12,1947000.0
1947,1947999,21.16598790284566,37.4035737205915,0.08531400255155352,272.7074408531189,123.47109651565552,293.8139762878418,7636,1873,5763,5763,0,12,1948000.0
1948,1948999,21.161824192410283,37.39751232317686,0.08532296591589295,272.84448528289795,123.53310465812683,294.0448455810547,7640,1874,5766,5766,0,12,1949000.0
1949,1949999,21.15814875873419,37.391674731584736,0.08531975720204743,272.9715313911438,123.59591269493103,294.2492904663086,7642,1875,5767,5767,0,12,1950000.0
1950,1950999,21.155077701247745,37.38793342377021,0.08530571502572148,273.1373646259308,123.65836977958679,294.34899139404297,7648,1878,5770,5770,0,12,1951000.0
1951,1951999,21.151661747351223,37.38150343949464,0.08530488235975764,273.2765612602234,123.72060227394104,294.5255661010742,7650,1879,5771,5771,0,12,1952000.0
1952,1952999,21.14792977638912,37.37515140850125,0.0853130919895625,273.4843645095825,123.78797793388367,294.45774841308594,7662,1883,5779,5779,0,12,1953000.0
1953,1953999,21.144190838344564,37.36889838852366,0.0853265140776025,273.61967396736145,123.85168695449829,294.69440841674805,7662,1883,5779,5779,0,12,1954000.0
1954,1954999,21.140566322655033,37.362015518555346,0.08533128565353643,273.74662709236145,123.91486358642578,294.8797607421875,7662,1883,5779,5779,0,12,1955000.0
1955,1955999,21.13698761807171,37.35724981173981,0.08532475696079955,273.9341011047363,123.97849321365356,294.8739433288574,7668,1886,5782,5782,0,12,1956000.0
1956,1956999,21.13365117011858,37.351981950339926,0.08533179835334326,274.0554931163788,124.04140257835388,295.0732765197754,7668,1886,5782,5782,0,12,1957000.0
1957,1957999,21.13129217540928,37.349249596245684,0.0853157480534088,274.1967635154724,124.10471844673157,295.22729873657227,7668,1886,5782,5782,0,12,1958000.0
1958,1958999,21.128177918824388,37.3463794794907,0.08530282515072418,274.32148265838623,124.16747665405273,295.30843353271484,7668,1886,5782,5782,0,12,1959000.0
1959,1959999,21.125537385735512,37.34235327126327,0.08530107077065252,274.4985091686249,124.23758745193481,295.3240203857422,7670,1887,5783,5783,0,12,1960000.0
1960,1960999,21.123006372324692,37.33726601976696,0.0852870261696046,274.6250669956207,124.30039358139038,295.4296455383301,7670,1887,5783,5783,0,12,1961000.0
1961,1961999,21.12057223431497,37.33176019735728,0.08528251475456394,274.75829219818115,124.3628442287445,295.5272560119629,7670,1887,5783,5783,0,12,1962000.0
1962,1962999,21.11885695986824,37.328317905494096,0.08526781386777171,274.92112922668457,124.42702293395996,295.55630111694336,7674,1889,5785,5785,0,12,1963000.0
1963,1963999,21.117428611370272,37.32487053885719,0.08524616300544341,275.063276052475,124.48981022834778,295.6687240600586,7674,1889,5785,5785,0,12,1964000.0
1964,1964999,21.11528599242364,37.319810475671986,0.08523328637851313,275.22358536720276,124.55294823646545,295.6764106750488,7677,1890,5787,5787,0,12,1965000.0
1965,1965999,21.114396212931588,37.31969903241365,0.08520742939718395,275.3603684902191,124.61604404449463,295.7657051086426,7677,1890,5787,5787,0,12,1966000.0
1966,1966999,21.111950501252927,37.31432587978235,0.08520153979361222,275.48637771606445,124.67942786216736,295.84106826782227,7677,1890,5787,5787,0,12,1967000.0
1967,1967999,21.110537802930832,37.310196896019846,0.08519037132245788,275.6211359500885,124.742014169693,295.95176696777344,7687,1891,5796,5796,0,12,1968000.0
1968,1968999,21.11248023237512,37.314809206420286,0.08506261234773316,275.7415328025818,124.8073079586029,297.01233673095703,7703,1891,5812,5812,0,12,1969000.0
1969,1969999,21.11586147022963,37.326052692995994,0.08487134921715256,275.866819858551,124.87152314186096,297.38349533081055,7703,1891,5812,5812,0,12,1970000.0
1970,1970999,21.11798610243157,37.329298330131216,0.08481451398973405,275.9822881221771,124.93430352210999,297.62553787231445,7703,1891,5812,5812,0,12,1971000.0
1971,1971999,21.12041706250594,37.33520770897747,0.08480269428231413,276.17560935020447,124.99765300750732,297.6430473327637,7711,1895,5816,5816,0,12,1972000.0
1972,1972999,21.122857611455554,37.34078686897865,0.08481530075332311,276.31916093826294,125.0607967376709,297.8492660522461,7713,1896,5817,5817,0,12,1973000.0
1973,1973999,21.127273081873245,37.35466952003988,0.08489008156853006,276.47207975387573,125.12405729293823,297.97917556762695,7717,1898,5819,5819,0,12,1974000.0
1974,1974999,21.131314538225354,37.36536692024003,0.08500472392248093,276.61488795280457,125.18707299232483,298.16551971435547,7717,1898,5819,5819,0,12,1975000.0
1975,1975999,21.134978125150578,37.375480129715804,0.08507266250435663,276.8215391635895,125.25087022781372,298.07522201538086,7725,1902,5823,5823,0,12,1976000.0
1976,1976999,21.138569465953733,37.38448210994548,0.08509237840480288,276.9642848968506,125.3149311542511,298.27345275878906,7727,1903,5824,5824,0,12,1977000.0
1977,1977999,21.142729676209317,37.39475925637319,0.08516182271386663,277.1056137084961,125.37873458862305,298.4164276123047,7729,1904,5825,5825,0,12,1978000.0
1978,1978999,21.146600077515014,37.4036105580667,0.08531874776446313,277.22272419929504,125.44213366508484,298.6092338562012,7730,1904,5826,5826,0,12,1979000.0
1979,1979999,21.150857993000738,37.41804885024438,0.08537684399713574,277.38519835472107,125.50580286979675,298.6572685241699,7732,1905,5827,5827,0,12,1980000.0
1980,1980999,21.15406011930312,37.42416388665811,0.08546247218427327,277.56871342658997,125.569997549057,298.61222076416016,7736,1907,5829,5829,0,12,1981000.0
1981,1981999,21.157254384226924,37.427932201954704,0.08551745723577597,277.7070071697235,125.63383650779724,298.70420837402344,7738,1908,5830,5830,0,12,1982000.0
1982,1982999,21.16199279177552,37.43575631085527,0.08561901571330333,277.8359878063202,125.69750642776489,298.9134407043457,7738,1908,5830,5830,0,12,1983000.0
1983,1983999,21.16646245713418,37.444034938677866,0.08564630541587226,277.9824266433716,125.76226592063904,299.0572280883789,7738,1908,5830,5830,0,12,1984000.0
1984,1984999,21.17069262861195,37.4507858219893,0.08569731679250125,278.1079132556915,125.82565498352051,299.15710067749023,7738,1908,5830,5830,0,12,1985000.0
1985,1985999,21.17619612720131,37.46110586847733,0.08574385508591176,278.284259557724,125.88974070549011,299.11706161499023,7742,1910,5832,5832,0,12,1986000.0
1986,1986999,21.180289486590333,37.46455072665461,0.08580829616462782,278.4176788330078,125.95352554321289,299.2284126281738,7742,1910,5832,5832,0,12,1987000.0
1987,1987999,21.183008432673535,37.4650956146909,0.08578506426143928,278.5393614768982,126.01682901382446,299.3965759277344,7742,1910,5832,5832,0,12,1988000.0
1988,1988999,21.18163160462424,37.46449783643577,0.08571072312557226,278.6609160900116,126.08021330833435,300.3609199523926,7760,1910,5850,5850,0,12,1989000.0
1989,1989999,21.18014968699461,37.4608639533812,0.08566337497468568,278.79540514945984,126.14324522018433,300.6599769592285,7768,1911,5857,5857,0,12,1990000.0
1990,1990999,21.18007061549235,37.461250079338626,0.08563364358748471,278.934072971344,126.20620965957642,300.8552932739258,7770,1912,5858,5858,0,12,1991000.0
1991,1991999,21.1788329362393,37.45793092542705,0.0856191981876745,279.1025528907776,126.26906371116638,300.9666061401367,7776,1915,5861,5861,0,12,1992000.0
1992,1992999,21.17981034918878,37.45915823603739,0.08557158101114049,279.23707389831543,126.33262467384338,301.1120071411133,7778,1916,5862,5862,0,12,1993000.0
1993,1993999,21.180464668117267,37.45973182185876,0.0855693753941158,279.4305250644684,126.39608001708984,301.1147766113281,7786,1920,5866,5866,0,12,1994000.0
1994,1994999,21.182059567812917,37.46174425098968,0.08558503653054672,279.602744102478,126.4595251083374,301.24889373779297,7790,1922,5868,5868,0,12,1995000.0
1995,1995999,21.184212198186117,37.463669995550454,0.0856044503619976,279.80153155326843,126.52484273910522,301.3169174194336,7796,1925,5871,5871,0,12,1996000.0
1996,1996999,21.18778260660413,37.469998203160394,0.08561697229929388,279.9464819431305,126.5881187915802,301.52743911743164,7798,1926,5872,5872,0,12,1997000.0
1997,1997999,21.190472623373324,37.47422408451285,0.08569565315631622,280.0805296897888,126.6513319015503,301.65058517456055,7800,1927,5873,5873,0,12,1998000.0
1998,1998999,21.19505639918483,37.4832536557461,0.08577074428100728,280.2115092277527,126.71534252166748,301.8425979614258,7800,1927,5873,5873,0,12,1999000.0
1999,1999999,21.199718950667137,37.49150310853412,0.08583426447704923,280.35442090034485,126.77873635292053,301.9609375,7800,1927,5873,5873,0,12,2000000.0
2000,2000999,21.20561564393996,37.50331963883982,0.08588994169217923,280.48034381866455,126.84182620048523,302.0762252807617,7800,1927,5873,5873,0,12,2001000.0
2001,2001999,21.21140991247878,37.5142184100576,0.08598028522330847,280.6416585445404,126.90561866760254,302.0703430175781,7814,1929,5885,5885,0,12,2002000.0
2002,2002999,21.21645675325097,37.522240771117765,0.08608578198471062,280.7972013950348,126.9690454006195,302.2035331726074,7814,1929,5885,5885,0,12,2003000.0
2003,2003999,21.22216103724001,37.53813420614423,0.08614082070596163,280.9154431819916,127.03181147575378,302.29507064819336,7814,1929,5885,5885,0,12,2004000.0
2004,2004999,21.22782372423422,37.545158086424685,0.08621496825902863,281.0718960762024,127.0950996875763,302.36285400390625,7816,1930,5886,5886,0,12,2005000.0
2005,2005999,21.233831292123728,37.55375950568731,0.08630574656196754,281.2395408153534,127.16036105155945,302.38068771362305,7818,1931,5887,5887,0,12,2006000.0
2006,2006999,21.241246931048543,37.56502686185715,0.08638755997636816,281.40601992607117,127.2241759300232,302.3450927734375,7830,1933,5897,5897,0,12,2007000.0
2007,2007999,21.2455866053853,37.56910690728011,0.08648550804921029,281.5464599132538,127.28805756568909,302.3811225891113,7832,1934,5898,5898,0,12,2008000.0
2008,2008999,21.246822246586312,37.572617312088376,0.08643680671739651,281.6645939350128,127.3516173362732,303.16455459594727,7849,1934,5915,5915,0,12,2009000.0
2009,2009999,21.24402590978821,37.571663955045686,0.08637945202461539,281.784051656723,127.41543006896973,303.57316970825195,7851,1934,5917,5917,0,12,2010000.0
2010,2010999,21.241112816570396,37.56711766233882,0.08636634722469505,281.9295210838318,127.4790871143341,303.72927474975586,7853,1935,5918,5918,0,12,2011000.0
2011,2011999,21.23852771065287,37.56296021428369,0.08635615059298918,282.11822152137756,127.54247617721558,303.7841377258301,7859,1938,5921,5921,0,12,2012000.0
2012,2012999,21.236194283912788,37.57076683150695,0.08627777230432265,282.25940895080566,127.6060061454773,304.01816177368164,7861,1939,5922,5922,0,12,2013000.0
2013,2013999,21.233104376123947,37.56464856741473,0.08626633284411667,282.41283321380615,127.66996693611145,304.1394500732422,7865,1941,5924,5924,0,12,2014000.0
2014,2014999,21.230415000986493,37.559883206864704,0.08625080072015734,282.59031534194946,127.7337167263031,304.26777267456055,7869,1943,5926,5926,0,12,2015000.0
2015,2015999,21.22798142172138,37.55479187656227,0.08624419490791124,282.73166513442993,127.79701709747314,304.40413665771484,7871,1944,5927,5927,0,12,2016000.0
2016,2016999,21.225297686974432,37.54956321973437,0.08624067348925268,282.88199377059937,127.8605842590332,304.5144958496094,7873,1945,5928,5928,0,12,2017000.0
2017,2017999,21.223611088682755,37.548270058351584,0.08621680695917422,283.033882856369,127.92434573173523,304.6552200317383,7875,1946,5929,5929,0,12,2018000.0
2018,2018999,21.22245386860826,37.54478124887772,0.08621229610488723,283.1625063419342,127.98748183250427,304.80363845825195,7875,1946,5929,5929,0,12,2019000.0
2019,2019999,21.221814812578764,37.54272632534691,0.08620563473158949,283.2891252040863,128.05053043365479,304.9358673095703,7875,1946,5929,5929,0,12,2020000.0
2020,2020999,21.22198360303161,37.541111089373246,0.08618494721059766,283.4276452064514,128.11387062072754,305.0801887512207,7876,1946,5930,5930,0,12,2021000.0
2021,2021999,21.22251736554843,37.54173320660218,0.08617617874326255,283.5573658943176,128.17702317237854,305.16839599609375,7876,1946,5930,5930,0,12,2022000.0
2022,2022999,21.22403379188943,37.54377817835824,0.08615653315350513,283.68051409721375,128.24090242385864,305.27850341796875,7876,1946,5930,5930,0,12,2023000.0
2023,2023999,21.22731456066029,37.551567522071586,0.08614727842459868,283.87976121902466,128.30569410324097,305.319522857666,7880,1948,5932,5932,0,12,2024000.0
2024,2024999,21.232810561334908,37.565486835069756,0.08615230828979825,284.0555398464203,128.3692090511322,305.24628829956055,7884,1950,5934,5934,0,12,2025000.0
2025,2025999,21.239365936074826,37.57848267298603,0.0861867940336386,284.1735510826111,128.43282628059387,305.384334564209,7884,1950,5934,5934,0,12,2026000.0
2026,2026999,21.244878505478532,37.59289066759186,0.0861741519735113,284.30285358428955,128.496276140213,305.5111770629883,7884,1950,5934,5934,0,12,2027000.0
2027,2027999,21.248556060973478,37.59883395530046,0.08616018536612235,284.4624574184418,128.55983877182007,305.5212173461914,7886,1951,5935,5935,0,12,2028000.0
2028,2028999,21.249561025566816,37.599521084311704,0.08618062513437807,284.59146094322205,128.62311434745789,305.684024810791,7886,1951,5935,5935,0,12,2029000.0
2029,2029999,21.249053971030104,37.6001036216121,0.08610187966536087,284.7287104129791,128.68696427345276,306.4675102233887,7906,1952,5954,5954,0,12,2030000.0
2030,2030999,21.24702252975661,37.596712692410435,0.08610023952398738,284.87809705734253,129.89032006263733,306.70966720581055,7909,1953,5956,5956,0,12,2031000.0
2031,2031999,21.24431790297072,37.592559360989874,0.08610933393320419,285.0161108970642,129.95342898368835,306.91395568847656,7911,1954,5957,5957,0,12,2032000.0
2032,2032999,21.243011314880597,37.59330300708682,0.08609226734058906,285.1832356452942,130.01666116714478,306.9871711730957,7917,1956,5961,5961,0,12,2033000.0
2033,2033999,21.240920665755812,37.58889695432819,0.08608064512289726,285.36753964424133,130.0805733203888,307.02407455444336,7923,1959,5964,5964,0,12,2034000.0
2034,2034999,21.238826414872133,37.58473063010608,0.08607209542612948,285.5555453300476,130.14489102363586,307.06556701660156,7929,1962,5967,5967,0,12,2035000.0
2035,2035999,21.237156250703094,37.581148337189674,0.08606970056691943,285.6848270893097,130.20862793922424,307.31568145751953,7929,1962,5967,5967,0,12,2036000.0
2036,2036999,21.235544543086977,37.58112356644084,0.08607197486467433,285.8769996166229,130.2722237110138,307.18687438964844,7937,1966,5971,5971,0,12,2037000.0
2037,2037999,21.233716954413904,37.57888812127268,0.08605804430697328,286.0516631603241,130.33755898475647,307.4727325439453,7939,1967,5972,5972,0,12,2038000.0
2038,2038999,21.23229517899014,37.58128375516646,0.08602784767636695,286.18032360076904,130.40151476860046,307.6907653808594,7939,1967,5972,5972,0,12,2039000.0
2039,2039999,21.231315273919595,37.58360838797915,0.08600275126562584,286.3293876647949,130.46553540229797,307.8185005187988,7939,1967,5972,5972,0,12,2040000.0
2040,2040999,21.229222234155145,37.578583844825566,0.08599785008391869,286.481595993042,130.52915930747986,307.9076385498047,7942,1968,5974,5974,0,12,2041000.0
2041,2041999,21.22784406781277,37.57512456481722,0.0859926273512972,286.62369203567505,130.59394478797913,308.0514831542969,7942,1968,5974,5974,0,12,2042000.0
2042,2042999,21.226743665263623,37.57166736323342,0.08598939678678097,286.74892592430115,130.6575140953064,308.2013130187988,7942,1968,5974,5974,0,12,2043000.0
2043,2043999,21.226001728684594,37.571390396331545,0.08597559784689646,286.9334363937378,130.73019433021545,308.25680923461914,7946,1970,5976,5976,0,12,2044000.0
2044,2044999,21.224708157093467,37.57065792206955,0.08597575107837352,287.07339096069336,130.7939670085907,308.3380241394043,7948,1971,5977,5977,0,12,2045000.0
2045,2045999,21.223093197849675,37.56603430657596,0.08597776673170843,287.23219108581543,130.85809063911438,308.45850372314453,7948,1971,5977,5977,0,12,2046000.0
2046,2046999,21.220865320424057,37.560523879726915,0.08598109236729246,287.3677384853363,130.92145085334778,308.6009826660156,7948,1971,5977,5977,0,12,2047000.0
2047,2047999,21.217976071448554,37.555637918901176,0.08594798367412604,287.49475479125977,130.9865436553955,309.48985290527344,7967,1971,5996,5996,0,12,2048000.0
2048,2048999,21.2161581406753,37.555826913265264,0.08590496718039164,287.63280725479126,131.04942083358765,309.8314666748047,7968,1971,5997,5997,0,12,2049000.0
2049,2049999,21.21407856948617,37.55210411310203,0.08589965063390037,287.78033351898193,131.11198472976685,310.0065574645996,7970,1972,5998,5998,0,12,2050000.0
2050,2050999,21.212013166100785,37.54948308586905,0.08588263790406514,287.91515159606934,131.17513060569763,310.18449783325195,7973,1973,6000,6000,0,12,2051000.0
2051,2051999,21.21025476217426,37.545751093919186,0.08586131152537291,288.0380690097809,131.23774766921997,310.3935775756836,7973,1973,6000,6000,0,12,2052000.0
2052,2052999,21.20849813335491,37.54627067063596,0.08583241626827753,288.22561383247375,131.30117201805115,310.46845626831055,7979,1976,6003,6003,0,12,2053000.0
2053,2053999,21.20859573907007,37.54935776652647,0.08581161476710775,288.430538892746,131.3652217388153,310.4981575012207,7985,1979,6006,6006,0,12,2054000.0
2054,2054999,21.2085717280928,37.552448779475775,0.08579660760663566,288.56376028060913,131.4294490814209,310.70628356933594,7985,1979,6006,6006,0,12,2055000.0
2055,2055999,21.20886666617336,37.55308250124894,0.0857648827460441,288.73561239242554,131.4928207397461,310.7394714355469,7989,1981,6008,6008,0,12,2056000.0
2056,2056999,21.210578959739973,37.5591212132722,0.08579455578057715,288.8879442214966,131.55785059928894,310.8846778869629,7991,1982,6009,6009,0,12,2057000.0
2057,2057999,21.212348319155456,37.56813282323042,0.08576187539148106,289.0095250606537,131.62100982666016,311.0166931152344,7991,1982,6009,6009,0,12,2058000.0
2058,2058999,21.21614753417928,37.57733491943229,0.08576082517672201,289.16966938972473,131.68389058113098,311.12641525268555,7994,1983,6011,6011,0,12,2059000.0
2059,2059999,21.220255497228973,37.58992754769432,0.0857511838615641,289.3198866844177,131.74718928337097,311.1562194824219,7996,1984,6012,6012,0,12,2060000.0
2060,2060999,21.22375054528947,37.59735608957582,0.08578403967476278,289.48104548454285,131.81121706962585,311.23218536376953,7998,1985,6013,6013,0,12,2061000.0
2061,2061999,21.226631611401125,37.601525708248936,0.0857817770660162,289.6415078639984,131.8752179145813,311.2566795349121,8002,1987,6015,6015,0,12,2062000.0
2062,2062999,21.231475094626276,37.61142403695065,0.08586225209853093,289.83965826034546,131.93871593475342,311.1340560913086,8008,1990,6018,6018,0,12,2063000.0
2063,2063999,21.235881290719913,37.62510100629875,0.08589367122574687,290.0059175491333,132.00295734405518,311.21320724487305,8010,1991,6019,6019,0,12,2064000.0
2064,2064999,21.24031573849221,37.6327865344802,0.08595414166661464,290.1396815776825,132.06667947769165,311.3696746826172,8010,1991,6019,6019,0,12,2065000.0
2065,2065999,21.242860738445394,37.64005428623415,0.08585606198967732,290.28434109687805,132.1302981376648,311.54920959472656,8010,1991,6019,6019,0,12,2066000.0
2066,2066999,21.243830369152466,37.65070662264095,0.08574390660850173,290.4067642688751,132.1936547756195,312.33727645874023,8027,1991,6036,6036,0,12,2067000.0
2067,2067999,21.243087835114082,37.65048414474333,0.08569948773210678,290.53166604042053,132.25795078277588,312.62796783447266,8028,1991,6037,6037,0,12,2068000.0
2068,2068999,21.242325041348263,37.64815937681641,0.08569032731771165,290.7179615497589,132.32030940055847,312.6944885253906,8036,1994,6042,6042,0,12,2069000.0
2069,2069999,21.241874622459694,37.648136222133935,0.08565348122324712,290.87058901786804,132.38293623924255,312.8719825744629,8038,1995,6043,6043,0,12,2070000.0
2070,2070999,21.242254524614502,37.652800642369435,0.08559824977044006,291.0049088001251,132.4452223777771,313.03690338134766,8038,1995,6043,6043,0,12,2071000.0
2071,2071999,21.24206217728745,37.65226033769146,0.08557511363202308,291.1949052810669,132.50923442840576,312.9660530090332,8045,1998,6047,6047,0,12,2072000.0
2072,2072999,21.24264368557387,37.652209146760825,0.08554333486505705,291.35398960113525,132.572181224823,313.1039619445801,8049,2000,6049,6049,0,12,2073000.0
2073,2073999,21.24418115516872,37.654173587016246,0.08553538040761344,291.5082540512085,132.63525986671448,313.1914863586426,8051,2001,6050,6050,0,12,2074000.0
2074,2074999,21.2448429879104,37.65429750012132,0.08553686071604749,291.69215154647827,132.69885206222534,313.2085762023926,8057,2003,6054,6054,0,12,2075000.0
2075,2075999,21.247580638453762,37.65990921139858,0.08550533768800084,291.8109321594238,132.76374077796936,313.37035369873047,8057,2003,6054,6054,0,12,2076000.0
2076,2076999,21.251019006482903,37.66813390805927,0.08548050003955288,291.9667375087738,132.82706952095032,313.4709167480469,8059,2004,6055,6055,0,12,2077000.0
2077,2077999,21.253515799200787,37.67213485587857,0.08547934062599549,292.10511898994446,132.8908498287201,313.6226501464844,8059,2004,6055,6055,0,12,2078000.0
2078,2078999,21.256181944533747,37.67602104050201,0.08549377877276565,292.2766454219818,132.95485734939575,313.6024475097656,8064,2006,6058,6058,0,12,2079000.0
2079,2079999,21.259295763742525,37.68400523534262,0.08548237368213363,292.4477095603943,133.0183277130127,313.52614974975586,8068,2008,6060,6060,0,12,2080000.0
2080,2080999,21.261324082084133,37.6855446621904,0.08550010346824821,292.5959596633911,133.08493971824646,313.6466293334961,8070,2009,6061,6061,0,12,2081000.0
2081,2081999,21.263979589826143,37.68804549502054,0.08552917460849341,292.8458003997803,133.1500699520111,313.38846588134766,8082,2014,6068,6068,0,12,2082000.0
2082,2082999,21.266852077520706,37.69548581828997,0.08551245738465241,293.00626707077026,133.21384596824646,313.56815338134766,8084,2015,6069,6069,0,12,2083000.0
2083,2083999,21.269184710081916,37.69685861544687,0.08553287399037446,293.1275997161865,133.27737259864807,313.7394332885742,8084,2015,6069,6069,0,12,2084000.0
2084,2084999,21.271623267238375,37.69774221594367,0.0855408351885052,293.2779815196991,133.34144830703735,313.79378509521484,8086,2016,6070,6070,0,12,2085000.0
2085,2085999,21.2732405041695,37.701974231875674,0.08555117804686496,293.4398741722107,133.40565872192383,313.8626403808594,8088,2017,6071,6071,0,12,2086000.0
2086,2086999,21.271900632030267,37.69959381061093,0.0855123202008794,293.55892038345337,133.47137355804443,314.75877380371094,8107,2017,6090,6090,0,12,2087000.0
2087,2087999,21.267622131208423,37.69427105094439,0.08552534799341283,293.6947875022888,133.53447484970093,315.0559501647949,8122,2018,6104,6104,0,12,2088000.0
2088,2088999,21.26384611863595,37.68769802070532,0.08554496694867275,293.85372972488403,133.59883308410645,315.2761650085449,8124,2019,6105,6105,0,12,2089000.0
2089,2089999,21.260712121813466,37.683892930296054,0.08553649699945653,294.0358166694641,133.66171383857727,315.33532333374023,8132,2022,6110,6110,0,12,2090000.0
2090,2090999,21.2571636037771,37.678665757110515,0.08553304403263151,294.1692762374878,133.72461676597595,315.4785346984863,8134,2023,6111,6111,0,12,2091000.0
2091,2091999,21.252911840795882,37.67213951539201,0.08554771585949239,294.31685733795166,133.78764367103577,315.606632232666,8136,2024,6112,6112,0,12,2092000.0
2092,2092999,21.24949949784965,37.66655360955337,0.08555526841300487,294.5514233112335,133.85169959068298,315.4584274291992,8148,2029,6119,6119,0,12,2093000.0
2093,2093999,21.246295864917435,37.66099914613393,0.08555366989688584,294.70194268226624,133.9160451889038,315.7087860107422,8150,2030,6120,6120,0,12,2094000.0
2094,2094999,21.24390183533014,37.65635849067447,0.08554558224950393,294.8604154586792,133.97903490066528,315.8576202392578,8152,2031,6121,6121,0,12,2095000.0
2095,2095999,21.240947477065834,37.65119776634356,0.08555865522658035,295.0029265880585,134.04402256011963,316.0134582519531,8152,2031,6121,6121,0,12,2096000.0
2096,2096999,21.23958326536774,37.64874488211718,0.08553798778261279,295.14384365081787,134.10681581497192,316.0906677246094,8154,2032,6122,6122,0,12,2097000.0
2097,2097999,21.238584350075108,37.64652587989239,0.08551548573545587,295.27373242378235,134.16974925994873,316.2251396179199,8154,2032,6122,6122,0,12,2098000.0
2098,2098999,21.238250696247224,37.64601276628276,0.08547622534127763,295.40274238586426,134.2332501411438,316.36710357666016,8155,2032,6123,6123,0,12,2099000.0
2099,2099999,21.23841451290017,37.64587636147008,0.08544256835958786,295.57449436187744,134.2969229221344,316.3750915527344,8157,2033,6124,6124,0,12,2100000.0
2100,2100999,21.23846399855177,37.64533040360016,0.08543416095080059,295.72144532203674,134.36038160324097,316.47240447998047,8159,2034,6125,6125,0,12,2101000.0
2101,2101999,21.239917517905887,37.647387008170156,0.08542843639214048,295.8795392513275,134.42354202270508,316.479679107666,8161,2035,6126,6126,0,12,2102000.0
2102,2102999,21.24317189956027,37.65201074540655,0.08541110684597975,296.0680158138275,134.48742127418518,316.41043853759766,8168,2038,6130,6130,0,12,2103000.0
2103,2103999,21.246553689845307,37.65672165546218,0.08540839135088296,296.2049894332886,134.55107808113098,316.5696792602539,8168,2038,6130,6130,0,12,2104000.0
2104,2104999,21.248912948636658,37.65999005994063,0.0854162094368035,296.35891032218933,134.61422324180603,316.6225280761719,8170,2039,6131,6131,0,12,2105000.0
2105,2105999,21.25011954190216,37.66021178794033,0.08545103765607598,296.5231258869171,134.67812824249268,316.6731986999512,8172,2040,6132,6132,0,12,2106000.0
2106,2106999,21.249192657975996,37.656493363363396,0.08542922521004814,296.6711769104004,134.74242520332336,317.4244728088379,8197,2041,6156,6156,0,12,2107000.0
2107,2107999,21.24706652018725,37.65310285743661,0.0853715202896056,296.7839481830597,134.80626368522644,317.8328857421875,8197,2041,6156,6156,0,12,2108000.0
2108,2108999,21.2451523407277,37.64958065013574,0.08532869580121794,296.9234495162964,134.8692102432251,318.04113388061523,8200,2042,6158,6158,0,12,2109000.0
2109,2109999,21.243920277116175,37.65110651624217,0.08528808308808056,297.13389801979065,134.93307971954346,318.11010360717773,8208,2046,6162,6162,0,12,2110000.0
2110,2110999,21.241095322446505,37.6457570208224,0.08525820112220206,297.27109122276306,134.99617648124695,318.34830474853516,8210,2047,6163,6163,0,12,2111000.0
2111,2111999,21.239320691768732,37.64384635344738,0.08522565773449275,297.4976694583893,135.0603060722351,318.32494354248047,8221,2052,6169,6169,0,12,2112000.0
2112,2112999,21.236559785793443,37.63845646455873,0.0852020089659894,297.6671140193939,135.12417101860046,318.47542572021484,8225,2054,6171,6171,0,12,2113000.0
2113,2113999,21.23425055367957,37.63368470009225,0.08518839386335475,297.8320949077606,135.18832755088806,318.6150131225586,8229,2056,6173,6173,0,12,2114000.0
2114,2114999,21.2318097812883,37.62880440842874,0.08517009770649497,297.9978530406952,135.25225257873535,318.66015625,8233,2058,6175,6175,0,12,2115000.0
2115,2115999,21.22981055149476,37.62441919944576,0.08516068641003505,298.15879487991333,135.31697964668274,318.8243980407715,8235,2059,6176,6176,0,12,2116000.0
2116,2116999,21.228053239784316,37.62011871874241,0.08513033862621233,298.3223366737366,135.38252353668213,318.8933753967285,8239,2061,6178,6178,0,12,2117000.0
2117,2117999,21.226692426551082,37.616780989067806,0.0850948740866837,298.4708240032196,135.44588255882263,319.0724983215332,8270,2062,6208,6208,0,12,2118000.0
2118,2118999,21.22570201293762,37.614888089239564,0.08507940668941327,298.608473777771,135.5095419883728,319.23772048950195,8271,2062,6209,6209,0,12,2119000.0
2119,2119999,21.224540352532337,37.61194689129971,0.08505916259968327,298.7458121776581,135.57337617874146,319.353572845459,8271,2062,6209,6209,0,12,2120000.0
2120,2120999,21.223610203849216,37.60910888827676,0.08503518718566527,298.89414167404175,135.63688135147095,319.4233283996582,8273,2063,6210,6210,0,12,2121000.0
2121,2121999,21.223075793228062,37.607688805706886,0.08502088865606539,299.0121474266052,135.70136857032776,319.58503341674805,8273,2063,6210,6210,0,12,2122000.0
2122,2122999,21.22301145774263,37.60563322185318,0.08498950288861873,299.20725750923157,135.76580595970154,319.59485244750977,8278,2065,6213,6213,0,12,2123000.0
2123,2123999,21.223072039976078,37.60410195512659,0.08497620651135607,299.3389003276825,135.82917428016663,319.6966743469238,8278,2065,6213,6213,0,12,2124000.0
2124,2124999,21.223786277543056,37.60379750626531,0.0849608083950879,299.47021293640137,135.89333987236023,319.803165435791,8278,2065,6213,6213,0,12,2125000.0
2125,2125999,21.224118805078085,37.60243357684427,0.08495254456719148,299.6034588813782,135.95725297927856,319.9104537963867,8278,2065,6213,6213,0,12,2126000.0
2126,2126999,21.222811098887252,37.59879539529127,0.08495130234754833,299.77880597114563,136.0215232372284,319.9782905578613,8280,2066,6214,6214,0,12,2127000.0
2127,2127999,21.220179913903802,37.592878995266055,0.08493888434269015,299.8992774486542,136.08623003959656,321.00426864624023,8303,2066,6237,6237,0,12,2128000.0
2128,2128999,21.217153594267586,37.58763143516878,0.08489339895066705,300.01804089546204,136.14895963668823,321.36145782470703,8304,2066,6238,6238,0,12,2129000.0
2129,2129999,21.21411481606529,37.58270377164002,0.08488311727239861,300.17700386047363,136.21186661720276,321.49952697753906,8308,2068,6240,6240,0,12,2130000.0
2130,2130999,21.211144164798743,37.57869475245663,0.08488726558509285,300.36623430252075,136.27708625793457,321.630313873291,8314,2071,6243,6243,0,12,2131000.0
2131,2131999,21.208121128904402,37.573870243980274,0.08488033362548209,300.5406367778778,136.34060621261597,321.722469329834,8320,2074,6246,6246,0,12,2132000.0
2132,2132999,21.205054698489196,37.568400219322854,0.08486930697537975,300.7208924293518,136.4051775932312,321.88145446777344,8327,2077,6250,6250,0,12,2133000.0
2133,2133999,21.20205555342541,37.56382830595998,0.08484767796666115,300.8577547073364,136.46871948242188,322.0334587097168,8329,2078,6251,6251,0,12,2134000.0
2134,2134999,21.198241738474216,37.55767482233901,0.0848482662039235,301.01960015296936,136.5329773426056,322.1187324523926,8333,2080,6253,6253,0,12,2135000.0
2135,2135999,21.194898649837704,37.5521600464074,0.08484873771715529,301.2339174747467,136.59793853759766,322.0252265930176,8342,2084,6258,6258,0,12,2136000.0
2136,2136999,21.19128236405746,37.54614646838284,0.0848561010510106,301.36242842674255,136.6619472503662,322.27259826660156,8342,2084,6258,6258,0,12,2137000.0
2137,2137999,21.187812185896203,37.54019971465785,0.08484889195139955,301.51329588890076,136.72563290596008,322.39825439453125,8344,2085,6259,6259,0,12,2138000.0
2138,2138999,21.18396526885233,37.534201652143054,0.08485575130895684,301.6386866569519,136.7897744178772,322.53174209594727,8344,2085,6259,6259,0,12,2139000.0
2139,2139999,21.181078896759182,37.5297352755757,0.08485012485942345,301.8017735481262,136.85359597206116,322.6017837524414,8348,2086,6262,6262,0,12,2140000.0
2140,2140999,21.177921141733375,37.52445410813568,0.08484144352375744,301.9258098602295,136.9181399345398,322.7186851501465,8348,2086,6262,6262,0,12,2141000.0
2141,2141999,21.175366934274678,37.520096686709756,0.08483588232052608,302.0557961463928,136.98206758499146,322.8412895202637,8348,2086,6262,6262,0,12,2142000.0
2142,2142999,21.17320722504279,37.51588633838108,0.08480964914205424,302.18179154396057,137.04580307006836,322.95715713500977,8348,2086,6262,6262,0,12,2143000.0
2143,2143999,21.17143076762395,37.51222377445857,0.08479479007215618,302.31465673446655,137.10925316810608,323.0824546813965,8348,2086,6262,6262,0,12,2144000.0
2144,2144999,21.169318009286332,37.50767208580478,0.08478003382460697,302.51374411582947,137.17653894424438,323.0875663757324,8350,2087,6263,6263,0,12,2145000.0
2145,2145999,21.16797868014436,37.5047247717108,0.08475392566698536,302.66563081741333,137.24092483520508,323.10527420043945,8352,2088,6264,6264,0,12,2146000.0
2146,2146999,21.16628805018573,37.50082589768264,0.08473442496872152,302.79127621650696,137.30427980422974,323.20559310913086,8352,2088,6264,6264,0,12,2147000.0
2147,2147999,21.16326396044456,37.49555506270678,0.08472457755671914,302.91044640541077,137.36769151687622,323.3914375305176,8352,2088,6264,6264,0,12,2148000.0
2148,2148999,21.1595628529022,37.48922171163126,0.08473764400782535,303.0526559352875,137.4326753616333,324.16124725341797,8375,2089,6286,6286,0,12,2149000.0
2149,2149999,21.155914012112465,37.483331091980936,0.08473098576447424,303.1819865703583,137.49540996551514,324.4274787902832,8377,2090,6287,6287,0,12,2150000.0
2150,2150999,21.15219067125179,37.477815742251195,0.08474260200516626,303.31933975219727,137.55842471122742,324.5831184387207,8380,2091,6289,6289,0,12,2151000.0
2151,2151999,21.148814900397745,37.47389231171562,0.08474371246839607,303.5236704349518,137.62186074256897,324.5160255432129,8390,2095,6295,6295,0,12,2152000.0
2152,2152999,21.145332803499358,37.471399043469866,0.08473664585517371,303.6867365837097,137.6850528717041,324.57300186157227,8396,2097,6299,6299,0,12,2153000.0
2153,2153999,21.141983810841243,37.4671889839619,0.08472970020517012,303.8830797672272,137.74902439117432,324.57963943481445,8404,2101,6303,6303,0,12,2154000.0
2154,2154999,21.138310835191774,37.46184597363651,0.08472906024480442,304.0169155597687,137.81292915344238,324.82630920410156,8404,2101,6303,6303,0,12,2155000.0
2155,2155999,21.1351339715902,37.45817812052134,0.08471534954615956,304.2132182121277,137.87691187858582,324.861270904541,8410,2104,6306,6306,0,12,2156000.0
2156,2156999,21.131745576582635,37.45295907689983,0.08471638346297894,304.3694739341736,137.9404594898224,325.0335693359375,8412,2105,6307,6307,0,12,2157000.0
2157,2157999,21.12874771908953,37.447512263231786,0.08470464551599255,304.5028145313263,138.00430178642273,325.1847915649414,8414,2106,6308,6308,0,12,2158000.0
2158,2158999,21.12553484292316,37.44173198405494,0.08469642850514059,304.63550090789795,138.0689835548401,325.3761978149414,8414,2106,6308,6308,0,12,2159000.0
2159,2159999,21.12283391294407,37.43735842592786,0.08468593352108023,304.79453349113464,138.13293385505676,325.3975524902344,8416,2107,6309,6309,0,12,2160000.0
2160,2160999,21.120170003522087,37.43291912985826,0.0846838711566581,304.97066140174866,138.19732975959778,325.4256057739258,8422,2109,6313,6313,0,12,2161000.0
2161,2161999,21.11781633245294,37.429271854276145,0.0846703785787506,305.09489583969116,138.26122045516968,325.55954360961914,8422,2109,6313,6313,0,12,2162000.0
2162,2162999,21.116061440105504,37.436116982660884,0.0846280439126873,305.23082208633423,138.3248541355133,325.67518615722656,8422,2109,6313,6313,0,12,2163000.0
2163,2163999,21.11436969951892,37.43304635359119,0.08461935138449839,305.3678150177002,138.38868737220764,325.8296585083008,8422,2109,6313,6313,0,12,2164000.0
2164,2164999,21.11234274700678,37.42854275109898,0.0846184397379306,305.5002200603485,138.45293283462524,325.94465255737305,8422,2109,6313,6313,0,12,2165000.0
2165,2165999,21.110341592380482,37.42487084059911,0.08461651445172902,305.6410460472107,138.51691436767578,326.00390243530273,8422,2109,6313,6313,0,12,2166000.0
2166,2166999,21.108432096834488,37.4206542026674,0.08461548235560734,305.7857012748718,138.58111214637756,326.09128189086914,8422,2109,6313,6313,0,12,2167000.0
2167,2167999,21.106524924822562,37.41624903877979,0.08460709814748335,305.92008900642395,138.6451599597931,326.1569023132324,8422,2109,6313,6313,0,12,2168000.0
2168,2168999,21.103780356574397,37.41092421130122,0.08460249861334312,306.0604500770569,138.7085211277008,326.28603744506836,8422,2109,6313,6313,0,12,2169000.0
2169,2169999,21.099924794430784,37.406092267708,0.08463108573905587,306.1785726547241,138.7728841304779,327.2242660522461,8443,2109,6334,6334,0,12,2170000.0
2170,2170999,21.09568451365713,37.400291192064934,0.08467285129991176,306.2925832271576,138.83528685569763,327.56344985961914,8444,2109,6335,6335,0,12,2171000.0
2171,2171999,21.091485222403204,37.394549454189615,0.08471692747421666,306.44411635398865,138.89829540252686,327.68432998657227,8448,2111,6337,6337,0,12,2172000.0
2172,2172999,21.088368467548076,37.39099409066202,0.08472972154315106,306.607435464859,138.96134614944458,327.82465744018555,8453,2113,6340,6340,0,12,2173000.0
2173,2173999,21.08526860287453,37.38716556449195,0.0847460886250403,306.75565457344055,139.02541303634644,328.01246643066406,8456,2114,6342,6342,0,12,2174000.0
2174,2174999,21.08208841721215,37.38341794280125,0.08477019445368805,306.92357206344604,139.09003019332886,328.03784942626953,8461,2116,6345,6345,0,12,2175000.0
2175,2175999,21.078828847759077,37.37959988020067,0.08479193279441799,307.10249042510986,139.15395140647888,328.12134170532227,8465,2118,6347,6347,0,12,2176000.0
2176,2176999,21.075482174008172,37.37480460830669,0.08482190629379416,307.27474784851074,139.21773600578308,328.17454528808594,8469,2120,6349,6349,0,12,2177000.0
2177,2177999,21.072477104480733,37.370001127395454,0.0848520619076848,307.4132568836212,139.28282761573792,328.37260818481445,8471,2121,6350,6350,0,12,2178000.0
2178,2178999,21.069165811200186,37.36509347601389,0.08487564772201495,307.5395419597626,139.34764409065247,328.5479278564453,8471,2121,6350,6350,0,12,2179000.0
2179,2179999,21.06656881961251,37.3607678441163,0.08489688023168529,307.6977596282959,139.41199827194214,328.59614181518555,8475,2122,6353,6353,0,12,2180000.0
2180,2180999,21.063690981857853,37.35611312307083,0.08490431505808427,307.8726909160614,139.47637367248535,328.5938262939453,8481,2124,6357,6357,0,12,2181000.0
2181,2181999,21.060851080919747,37.3510204870038,0.08493714022100529,308.0522232055664,139.54062795639038,328.65367889404297,8485,2126,6359,6359,0,12,2182000.0
2182,2182999,21.05777996046495,37.34557829681735,0.08497085403897575,308.19458413124084,139.60537934303284,328.81475830078125,8487,2127,6360,6360,0,12,2183000.0
2183,2183999,21.055758855178418,37.341339233870876,0.08498142514527607,308.34387016296387,139.66879200935364,328.9320640563965,8490,2128,6362,6362,0,12,2184000.0
2184,2184999,21.053405344667013,37.33673239817963,0.0849944870619943,308.50570940971375,139.73273921012878,329.0002861022949,8492,2129,6363,6363,0,12,2185000.0
2185,2185999,21.05023469790475,37.331174715721566,0.08502308539493475,308.65535521507263,139.79654359817505,329.05782318115234,8494,2130,6364,6364,0,12,2186000.0
2186,2186999,21.047552089915072,37.32636900397431,0.08501114637526141,308.813845872879,139.8618061542511,329.52069091796875,8514,2132,6382,6382,0,12,2187000.0
2187,2187999,21.044690594307006,37.323932347535404,0.08501606871481793,308.9222447872162,139.9253978729248,330.319393157959,8522,2132,6390,6390,0,12,2188000.0
2188,2188999,21.041353593962075,37.32231071130228,0.08500756239211193,309.03651094436646,139.98842024803162,330.6521682739258,8522,2132,6390,6390,0,12,2189000.0
2189,2189999,21.03755537397551,37.318023129854616,0.08504120151744687,309.17672395706177,140.0513994693756,330.79687881469727,8524,2133,6391,6391,0,12,2190000.0
2190,2190999,21.033784077547253,37.312540208388306,0.0850693242482985,309.35116243362427,140.11598420143127,330.9563217163086,8529,2135,6394,6394,0,12,2191000.0
2191,2191999,21.02994890933202,37.306506340058384,0.085097342835742,309.48963832855225,140.17921662330627,331.1662139892578,8531,2136,6395,6395,0,12,2192000.0
2192,2192999,21.026877637985805,37.30408646196423,0.08508810824571722,309.63358902931213,140.24227929115295,331.28562927246094,8533,2137,6396,6396,0,12,2193000.0
2193,2193999,21.023359221852495,37.29812839598944,0.0850927051006568,309.84260511398315,140.30625772476196,331.2742156982422,8542,2141,6401,6401,0,12,2194000.0
2194,2194999,21.020197184738354,37.29330970023662,0.08509116231927438,310.01244831085205,140.3703169822693,331.4224433898926,8547,2143,6404,6404,0,12,2195000.0
2195,2195999,21.017176769516226,37.288025103445655,0.08508289862979956,310.1869924068451,140.43442797660828,331.49218368530273,8552,2145,6407,6407,0,12,2196000.0
2196,2196999,21.014569558130223,37.28358482949532,0.085065115200893,310.3172769546509,140.49945330619812,331.6924247741699,8552,2145,6407,6407,0,12,2197000.0
2197,2197999,21.012955062122842,37.28566605067994,0.08501876121027918,310.4618670940399,140.5631296634674,331.76348876953125,8554,2146,6408,6408,0,12,2198000.0
2198,2198999,21.010877509660585,37.28180644041984,0.08500048053135956,310.5875904560089,140.62805557250977,331.97562408447266,8555,2146,6409,6409,0,12,2199000.0
2199,2199999,21.00935046636658,37.279461786830105,0.08498071101126126,310.70815563201904,140.69142389297485,332.1287384033203,8555,2146,6409,6409,0,12,2200000.0
2200,2200999,21.00795281105234,37.27764022928095,0.08493750914448339,310.8843529224396,140.7555239200592,332.15179443359375,8559,2148,6411,6411,0,12,2201000.0
2201,2201999,21.006759526335344,37.27938884462677,0.08489811245802714,311.0686023235321,140.81976747512817,332.2026481628418,8564,2150,6414,6414,0,12,2202000.0
2202,2202999,21.006317601366572,37.279147253705254,0.08488271003386227,311.2584500312805,140.884197473526,332.1974563598633,8570,2153,6417,6417,0,12,2203000.0
2203,2203999,21.005297541386195,37.27671681058155,0.08484382716554806,311.428528547287,140.94848132133484,332.2531051635742,8579,2155,6424,6424,0,12,2204000.0
2204,2204999,21.004213559546145,37.27780452643629,0.08480229637932657,311.5720386505127,141.01288294792175,332.3808403015137,8579,2155,6424,6424,0,12,2205000.0
2205,2205999,21.002777803071943,37.27422643253326,0.08477568702310312,311.7171094417572,141.07820558547974,332.5149612426758,8579,2155,6424,6424,0,12,2206000.0
2206,2206999,21.00069677511025,37.270146878544054,0.08477006020032996,311.86213421821594,141.14332056045532,333.3472709655762,8607,2156,6451,6451,0,12,2207000.0
2207,2207999,20.9963583568236,37.267130262808614,0.08477504246457279,311.9849488735199,141.21642231941223,334.026798248291,8608,2156,6452,6452,0,12,2208000.0
2208,2208999,20.991599051669755,37.26184988031148,0.08480764836669186,312.0943877696991,141.27947974205017,334.42181396484375,8609,2156,6453,6453,0,12,2209000.0
2209,2209999,20.986847375769468,37.25593786423889,0.08484443889091509,312.20485401153564,141.34185194969177,334.6893653869629,8609,2156,6453,6453,0,12,2210000.0
2210,2210999,20.982630441676413,37.25308794595245,0.08485777429347297,312.4266436100006,141.4055118560791,334.6991500854492,8619,2161,6458,6458,0,12,2211000.0
2211,2211999,20.977971034035193,37.24652712053983,0.08489782375059451,312.57606863975525,141.4686155319214,334.9211654663086,8623,2163,6460,6460,0,12,2212000.0
2212,2212999,20.973360440892947,37.240653438288554,0.08492181569961788,312.7389841079712,141.53181338310242,335.0723342895508,8627,2165,6462,6462,0,12,2213000.0
2213,2213999,20.96880815835618,37.233962288886055,0.08495517566102939,312.9439330101013,141.59686493873596,335.14290618896484,8635,2169,6466,6466,0,12,2214000.0
2214,2214999,20.9645975908374,37.22818970972725,0.08498035113969449,313.1452867984772,141.66754364967346,335.30083084106445,8639,2171,6468,6468,0,12,2215000.0
2215,2215999,20.960308077531653,37.2220979854989,0.08500679603200745,313.26651525497437,141.73214030265808,335.564884185791,8639,2171,6468,6468,0,12,2216000.0
2216,2216999,20.956722690258307,37.21647222530838,0.08501942978758137,313.38061594963074,141.7954683303833,335.7174606323242,8639,2171,6468,6468,0,12,2217000.0
2217,2217999,20.95332714201718,37.211058404054576,0.08502319736974728,313.532098531723,141.85905647277832,335.8237190246582,8641,2172,6469,6469,0,12,2218000.0
2218,2218999,20.949928540499943,37.206562932897214,0.08502438403880275,313.70441460609436,141.92315936088562,335.7828712463379,8645,2174,6471,6471,0,12,2219000.0
2219,2219999,20.946900038937375,37.203199052703525,0.08501025425705266,313.840523481369,141.99154615402222,336.00573348999023,8646,2174,6472,6472,0,12,2220000.0
2220,2220999,20.944015532773065,37.198669102984546,0.08500526994454838,313.98308396339417,142.05645179748535,336.1440315246582,8648,2175,6473,6473,0,12,2221000.0
2221,2221999,20.94140150247561,37.19557026635495,0.08499608704316852,314.15952825546265,142.1207721233368,336.19162368774414,8652,2177,6475,6475,0,12,2222000.0
2222,2222999,20.93901264508548,37.19159339238246,0.084985721808302,314.3346905708313,142.18460416793823,336.19346618652344,8656,2179,6477,6477,0,12,2223000.0
2223,2223999,20.935983452943006,37.186442942556496,0.0849940117963498,314.4860327243805,142.24893188476562,336.2985725402832,8658,2180,6478,6478,0,12,2224000.0
2224,2224999,20.93406237955537,37.187501415218925,0.08497052768577817,314.6363649368286,142.31286096572876,336.4314498901367,8660,2181,6479,6479,0,12,2225000.0
2225,2225999,20.931489656746052,37.18353266885619,0.08496977326880018,314.7828674316406,142.3776352405548,336.5153007507324,8664,2182,6482,6482,0,12,2226000.0
2226,2226999,20.92835623019694,37.17828369081903,0.08497663969869151,314.9237103462219,142.44173741340637,336.65829849243164,8664,2182,6482,6482,0,12,2227000.0
2227,2227999,20.924777529421785,37.172845671699655,0.0849929292918935,315.05832982063293,142.50678730010986,337.6127014160156,8688,2182,6506,6506,0,12,2228000.0
2228,2228999,20.920772858364963,37.169058853610025,0.08501048999546346,315.19006514549255,142.57194209098816,338.00353240966797,8691,2183,6508,6508,0,12,2229000.0
2229,2229999,20.916975908482772,37.16455473095157,0.08503667835555329,315.3282194137573,142.63439273834229,338.2489356994629,8698,2184,6514,6514,0,12,2230000.0
2230,2230999,20.91294597251172,37.1588196234272,0.08506341050147603,315.4627764225006,142.69653224945068,338.41070556640625,8700,2185,6515,6515,0,12,2231000.0
2231,2231999,20.90962344192491,37.155621900392454,0.08506375501125873,315.6364026069641,142.76063585281372,338.5872039794922,8704,2187,6517,6517,0,12,2232000.0
2232,2232999,20.90537209202523,37.14935555659992,0.08509181992352599,315.7956666946411,142.8239426612854,338.7730178833008,8708,2189,6519,6519,0,12,2233000.0
2233,2233999,20.901306982910103,37.143192185466475,0.08512020457299574,315.94360613822937,142.88703298568726,338.95507431030273,8710,2190,6520,6520,0,12,2234000.0
2234,2234999,20.897980780643223,37.138278373408184,0.08514103953451224,316.12615942955017,142.95173001289368,339.0359344482422,8714,2192,6522,6522,0,12,2235000.0
2235,2235999,20.894693703883444,37.13271883271119,0.08515133330089752,316.29495310783386,143.0150809288025,339.06401443481445,8718,2194,6524,6524,0,12,2236000.0
2236,2236999,20.89196907680979,37.12793256687823,0.08515667246402958,316.45234537124634,143.07852268218994,339.1316909790039,8722,2196,6526,6526,0,12,2237000.0
2237,2237999,20.890179621423417,37.124873664067145,0.08515385528816866,316.6513361930847,143.143816947937,339.14183807373047,8729,2199,6530,6530,0,12,2238000.0
2238,2238999,20.889201276579183,37.12381763191605,0.08515150152799789,316.7689776420593,143.20745849609375,339.35425567626953,8729,2199,6530,6530,0,12,2239000.0
2239,2239999,20.890105585336048,37.134837089005906,0.0849827870115879,316.92615818977356,143.27191281318665,339.4693908691406,8732,2200,6532,6532,0,12,2240000.0
2240,2240999,20.890789052546744,37.147116692099075,0.08490465463098684,317.0734100341797,143.33522295951843,339.5479850769043,8736,2201,6535,6535,0,12,2241000.0
2241,2241999,20.891416813231462,37.160858379018194,0.08484856055829926,317.21066784858704,143.3986144065857,339.65106201171875,8738,2202,6536,6536,0,12,2242000.0
2242,2242999,20.893442970687474,37.174232490203735,0.0849259479818979,317.3592417240143,143.46241974830627,339.79114151000977,8740,2203,6537,6537,0,12,2243000.0
2243,2243999,20.895124457229883,37.17944921065463,0.08486682439274662,317.54264426231384,143.5266351699829,339.768798828125,8744,2205,6539,6539,0,12,2244000.0
2244,2244999,20.895465542257018,37.18085458705349,0.0850396199464144,317.71861028671265,143.5910108089447,339.7710838317871,8749,2207,6542,6542,0,12,2245000.0
2245,2245999,20.895538350604173,37.181439848868344,0.08501460433906527,317.87580728530884,143.65491151809692,339.83616638183594,8751,2208,6543,6543,0,12,2246000.0
2246,2246999,20.894940808182024,37.18093789649546,0.08500725283412347,318.0823941230774,143.7196967601776,339.81168365478516,8757,2211,6546,6546,0,12,2247000.0
2247,2247999,20.894218875149313,37.180248084071664,0.08495526706565171,318.20038628578186,143.78404068946838,341.001163482666,8784,2211,6573,6573,0,12,2248000.0
2248,2248999,20.893585186811535,37.1808622599229,0.0849547223649183,318.30872559547424,143.84803652763367,341.5317840576172,8785,2211,6574,6574,0,12,2249000.0
2249,2249999,20.893620559779087,37.18257461885827,0.08495752822313996,318.4403796195984,143.91154718399048,341.77293395996094,8787,2212,6575,6575,0,12,2250000.0
2250,2250999,20.89277461291691,37.181575713624945,0.08498196767400756,318.5567739009857,143.97441744804382,342.06523513793945,8787,2212,6575,6575,0,12,2251000.0
2251,2251999,20.893815035656548,37.18361697780958,0.08502448271437646,318.7625501155853,144.03845500946045,342.03450775146484,8796,2216,6580,6580,0,12,2252000.0
2252,2252999,20.895295515611277,37.18593132052082,0.08511326012111975,318.92179560661316,144.10186553001404,342.1694793701172,8802,2218,6584,6584,0,12,2253000.0
2253,2253999,20.896146969299803,37.187172628515206,0.0852343438137555,319.1566517353058,144.16814970970154,342.1339340209961,8812,2223,6589,6589,0,12,2254000.0
2254,2254999,20.8983568575776,37.19214601407518,0.08540081953618872,319.3191192150116,144.23241591453552,342.3714027404785,8816,2225,6591,6591,0,12,2255000.0
2255,2255999,20.89985602706165,37.19325420128296,0.0855407542689196,319.46503710746765,144.29612064361572,342.57614517211914,8818,2226,6592,6592,0,12,2256000.0
2256,2256999,20.902191422120854,37.19910614854253,0.08575174213509118,319.6206696033478,144.360657453537,342.7388038635254,8820,2227,6593,6593,0,12,2257000.0
2257,2257999,20.905401403397473,37.20559944997135,0.08599880714098851,319.75597071647644,144.42419981956482,342.9626274108887,8820,2227,6593,6593,0,12,2258000.0
2258,2258999,20.907667712904914,37.20865459688036,0.08624217940575474,319.8959753513336,144.48841428756714,343.03482818603516,8822,2228,6594,6594,0,12,2259000.0
2259,2259999,20.90960105661984,37.210652358251735,0.08643586925921731,320.0228886604309,144.55212903022766,343.1857795715332,8823,2228,6595,6595,0,12,2260000.0
2260,2260999,20.911586434644462,37.2143467324594,0.08655109630968505,320.15960144996643,144.6158890724182,343.3381805419922,8823,2228,6595,6595,0,12,2261000.0
2261,2261999,20.914170244244612,37.218083040113406,0.08667710034299259,320.27861189842224,144.67923378944397,343.4883346557617,8823,2228,6595,6595,0,12,2262000.0
2262,2262999,20.91648006916149,37.221145484159564,0.08681944422168286,320.49003744125366,144.74363374710083,343.3511161804199,8830,2231,6599,6599,0,12,2263000.0
2263,2263999,20.91903557793062,37.22312892353648,0.08686604730881653,320.64148235321045,144.80800032615662,343.42100524902344,8832,2232,6600,6600,0,12,2264000.0
2264,2264999,20.920727717562805,37.22324748247132,0.08691415529190005,320.78650426864624,144.8720097541809,343.5503234863281,8834,2233,6601,6601,0,12,2265000.0
2265,2265999,20.922621750140276,37.223686433176454,0.08693855848182486,320.9912073612213,144.936598777771,343.4776039123535,8840,2236,6604,6604,0,12,2266000.0
2266,2266999,20.922480063706164,37.22086189386373,0.08694182702872721,321.13040375709534,145.01320219039917,343.6969413757324,8840,2236,6604,6604,0,12,2267000.0
2267,2267999,20.920661840467815,37.219651207216224,0.08687725200723029,321.2759563922882,145.07854557037354,344.91415786743164,8871,2237,6634,6634,0,12,2268000.0
2268,2268999,20.917860166530502,37.21566057155643,0.08684779906842277,321.40299797058105,145.14119505882263,345.32191467285156,8874,2238,6636,6636,0,12,2269000.0
2269,2269999,20.914768738738513,37.211090641789,0.08685104776762675,321.5317053794861,145.20397400856018,345.63842010498047,8877,2239,6638,6638,0,12,2270000.0
2270,2270999,20.912102351188153,37.20762818661342,0.0868491686950299,321.71460008621216,145.2676079273224,345.7929573059082,8885,2242,6643,6643,0,12,2271000.0
2271,2271999,20.909125015424994,37.20295799763469,0.08684911540910278,321.8942971229553,145.33525276184082,345.9023895263672,8891,2245,6646,6646,0,12,2272000.0
2272,2272999,20.906772231621684,37.198977716067496,0.08684810007888222,322.07723903656006,145.39875864982605,346.0235061645508,8897,2248,6649,6649,0,12,2273000.0
2273,2273999,20.90452615764759,37.195698466512454,0.08684986608885226,322.29765939712524,145.4673457145691,346.08912658691406,8905,2252,6653,6653,0,12,2274000.0
2274,2274999,20.902904955093927,37.194022135208144,0.08689628090932178,322.4910316467285,145.53265070915222,346.28799057006836,8913,2255,6658,6658,0,12,2275000.0
2275,2275999,20.901754785709077,37.20047107009269,0.08689487955674668,322.66223907470703,145.59710788726807,346.4257926940918,8917,2257,6660,6660,0,12,2276000.0
2276,2276999,20.901210177136477,37.201829924591365,0.08694346363187422,322.80479097366333,145.66101574897766,346.622013092041,8919,2258,6661,6661,0,12,2277000.0
2277,2277999,20.901721153282775,37.204988370054096,0.08702809681137236,322.9291088581085,145.72533583641052,346.8973197937012,8919,2258,6661,6661,0,12,2278000.0
2278,2278999,20.903079920280664,37.211444445175744,0.0871491635364503,323.05167412757874,145.78927278518677,347.04154205322266,8919,2258,6661,6661,0,12,2279000.0
2279,2279999,20.9039849153197,37.21557182671981,0.08728427302495634,323.2548496723175,145.8538680076599,347.105770111084,8926,2261,6665,6665,0,12,2280000.0
2280,2280999,20.90551629540234,37.218741644954775,0.08739634563578202,323.397577047348,145.9178740978241,347.26555252075195,8928,2262,6666,6666,0,12,2281000.0
2281,2281999,20.908046885711443,37.22805929611205,0.0874574033215445,323.55078172683716,145.9825563430786,347.38452911376953,8930,2263,6667,6667,0,12,2282000.0
2282,2282999,20.911035170985087,37.23417416990678,0.08755966334060994,323.6875157356262,146.04650712013245,347.5900077819824,8930,2263,6667,6667,0,12,2283000.0
2283,2283999,20.912758709667646,37.23594835484877,0.08765560150420004,323.86771035194397,146.11092829704285,347.616153717041,8934,2265,6669,6669,0,12,2284000.0
2284,2284999,20.916315681288193,37.241009090153995,0.08779317393162989,324.04863572120667,146.17532658576965,347.67226791381836,8938,2267,6671,6671,0,12,2285000.0
2285,2285999,20.91940797208658,37.24552268538554,0.08783208956516586,324.1998791694641,146.23956894874573,347.7488441467285,8940,2268,6672,6672,0,12,2286000.0
2286,2286999,20.92068108181974,37.24540409647101,0.08788902052253367,324.32155561447144,146.3037657737732,347.94957733154297,8940,2268,6672,6672,0,12,2287000.0
2287,2287999,20.920377070309005,37.2432908901204,0.08784927766481399,324.45387077331543,146.3692741394043,348.97104263305664,8967,2268,6699,6699,0,12,2288000.0
2288,2288999,20.916878526845778,37.2378126066763,0.08785449160143255,324.56354904174805,146.4332890510559,349.58100509643555,8969,2268,6701,6701,0,12,2289000.0
2289,2289999,20.91422158958316,37.23321498003949,0.08786921523082125,324.70020723342896,146.4971308708191,349.86795806884766,8978,2269,6709,6709,0,12,2290000.0
2290,2290999,20.912978839061903,37.23092114414686,0.08785953570633775,324.83275723457336,146.56014466285706,350.07941818237305,8980,2270,6710,6710,0,12,2291000.0
2291,2291999,20.91238372081317,37.230573991216886,0.08785155694009061,325.0230281352997,146.62411880493164,350.1312675476074,8986,2273,6713,6713,0,12,2292000.0
2292,2292999,20.912264325683022,37.23054675699501,0.08783202831659753,325.18112802505493,146.68859934806824,350.33841705322266,8990,2275,6715,6715,0,12,2293000.0
2293,2293999,20.91102281761417,37.2272803060423,0.08784305671629045,325.4263381958008,146.75398659706116,350.23929595947266,9001,2280,6721,6721,0,12,2294000.0
2294,2294999,20.91084075977946,37.2258005143849,0.0878434450521981,325.59755659103394,146.8183536529541,350.43579864501953,9005,2282,6723,6723,0,12,2295000.0
2295,2295999,20.911187945854437,37.2257821787287,0.08785072865504695,325.78844165802,146.88330960273743,350.5232696533203,9011,2285,6726,6726,0,12,2296000.0
2296,2296999,20.91160830351426,37.2261386577948,0.08784370348769632,325.9132378101349,146.94746708869934,350.8239631652832,9011,2285,6726,6726,0,12,2297000.0
2297,2297999,20.912053387139014,37.22599486064283,0.08787500655895975,326.05396246910095,147.01247549057007,350.9668884277344,9013,2286,6727,6727,0,12,2298000.0
2298,2298999,20.91207581829788,37.22461752130477,0.08792584564802097,326.1968002319336,147.07643389701843,351.14398193359375,9015,2287,6728,6728,0,12,2299000.0
2299,2299999,20.913083775906266,37.22450111972469,0.08794150172906767,326.3632950782776,147.14079880714417,351.2478942871094,9018,2288,6730,6730,0,12,2300000.0
2300,2300999,20.914333240504543,37.22673604133042,0.08798721946005283,326.48033928871155,147.2045018672943,351.41211700439453,9018,2288,6730,6730,0,12,2301000.0
2301,2301999,20.915631421736474,37.22727255674229,0.08802995640466105,326.63668036460876,147.2692313194275,351.51935958862305,9020,2289,6731,6731,0,12,2302000.0
2302,2302999,20.91741746350638,37.23038596987617,0.0880720944969573,326.81582736968994,147.3345708847046,351.5936622619629,9024,2291,6733,6733,0,12,2303000.0
2303,2303999,20.919110474110443,37.231647562418615,0.0881332025590561,326.9977366924286,147.39943051338196,351.6467514038086,9030,2293,6737,6737,0,12,2304000.0
2304,2304999,20.921198314749024,37.23974816276537,0.08817705471394355,327.1662003993988,147.46388721466064,351.69323348999023,9034,2295,6739,6739,0,12,2305000.0
2305,2305999,20.92282481156163,37.240859402446674,0.08823228542754813,327.2928149700165,147.52808809280396,351.8346138000488,9034,2295,6739,6739,0,12,2306000.0
2306,2306999,20.925218227230882,37.24575245653711,0.08825309531511061,327.437139749527,147.59223198890686,351.98530197143555,9034,2295,6739,6739,0,12,2307000.0
2307,2307999,20.925736392673745,37.24424196818527,0.08828226425652319,327.56921434402466,147.65748572349548,352.15556716918945,9034,2295,6739,6739,0,12,2308000.0
2308,2308999,20.924245634130184,37.2414022886582,0.08831220130322603,327.6905996799469,147.72405195236206,353.1813850402832,9058,2295,6763,6763,0,12,2309000.0
2309,2309999,20.92129322219285,37.23962816958189,0.08832288752135486,327.80510902404785,147.78718328475952,353.63379287719727,9060,2295,6765,6765,0,12,2310000.0
2310,2310999,20.918120337201533,37.23431467908603,0.08836253998494503,327.91316318511963,147.8505973815918,353.8972511291504,9060,2295,6765,6765,0,12,2311000.0
2311,2311999,20.91470820501323,37.22892241558239,0.08840090916441434,328.0690541267395,147.9141972064972,354.08409881591797,9063,2296,6767,6767,0,12,2312000.0
2312,2312999,20.911441163844362,37.22357701962091,0.08843230457916751,328.18950152397156,147.9774489402771,354.3030548095703,9063,2296,6767,6767,0,12,2313000.0
2313,2313999,20.90802779775637,37.21798974632138,0.08846522001088264,328.4573926925659,148.042546749115,354.1364631652832,9079,2303,6776,6776,0,12,2314000.0
2314,2314999,20.90437343585575,37.212013891571814,0.08850791220259047,328.60327768325806,148.10661029815674,354.353515625,9081,2304,6777,6777,0,12,2315000.0
2315,2315999,20.90112282680525,37.20653246889433,0.08854316051216005,328.8330159187317,148.17386889457703,354.36096954345703,9089,2308,6781,6781,0,12,2316000.0
2316,2316999,20.898100475284068,37.20101320837831,0.08857327251821367,329.0341286659241,148.23895001411438,354.46891021728516,9095,2311,6784,6784,0,12,2317000.0
2317,2317999,20.89466791283344,37.19525138253762,0.08861086836711374,329.1601870059967,148.30267143249512,354.71463775634766,9095,2311,6784,6784,0,12,2318000.0
2318,2318999,20.891500550919606,37.19008268621011,0.08864213923800934,329.2865228652954,148.36665296554565,354.88167572021484,9095,2311,6784,6784,0,12,2319000.0
2319,2319999,20.88894922673398,37.18592704370142,0.08865408696705568,330.76919531822205,148.43041276931763,355.0470848083496,9096,2311,6785,6785,0,12,2320000.0
2320,2320999,20.88685296787809,37.18175445446152,0.08867502440184194,330.92468523979187,148.49517011642456,355.1222152709961,9098,2312,6786,6786,0,12,2321000.0
2321,2321999,20.88449789817073,37.17805141984517,0.08869323458441625,331.0858449935913,148.5590877532959,355.20133209228516,9102,2313,6789,6789,0,12,2322000.0
2322,2322999,20.882220251372686,37.173532718032206,0.08872089689669593,331.21285033226013,148.62346053123474,355.35523223876953,9102,2313,6789,6789,0,12,2323000.0
2323,2323999,20.87982413573383,37.168816184268096,0.08874584281638154,331.3953802585602,148.68780183792114,355.3618469238281,9129,2315,6814,6814,0,12,2324000.0
2324,2324999,20.877202677107118,37.16359102018546,0.08878970908395623,331.52281975746155,148.75151014328003,355.4938163757324,9129,2315,6814,6814,0,12,2325000.0
2325,2325999,20.874264570748192,37.15863648180466,0.08881711955184401,331.66920351982117,148.81519889831543,355.71697998046875,9129,2315,6814,6814,0,12,2326000.0
2326,2326999,20.871467777507156,37.15781432252139,0.08881487416535983,331.79346561431885,148.88132882118225,356.8681411743164,9155,2315,6840,6840,0,12,2327000.0
2327,2327999,20.86850387343354,37.156274614719315,0.08883448529486282,331.91124868392944,148.9445559978485,357.3094673156738,9157,2315,6842,6842,0,12,2328000.0
2328,2328999,20.864961434471454,37.150780469347794,0.08888302351923716,332.031067609787,149.00749731063843,357.54536056518555,9157,2315,6842,6842,0,12,2329000.0
2329,2329999,20.861653820741477,37.145543028409044,0.08891755856630157,332.22948837280273,149.07155513763428,357.66295623779297,9165,2318,6847,6847,0,12,2330000.0
2330,2330999,20.857996763965442,37.139984048762535,0.0889602083456954,332.4115734100342,149.135320186615,357.8322868347168,9171,2321,6850,6850,0,12,2331000.0
2331,2331999,20.854404456838544,37.134850937235115,0.08898416046690782,332.6127429008484,149.2000856399536,357.9632339477539,9177,2324,6853,6853,0,12,2332000.0
2332,2332999,20.850698813143538,37.12989093219545,0.08900998499767143,332.7931637763977,149.26434183120728,358.07543563842773,9181,2326,6855,6855,0,12,2333000.0
2333,2333999,20.847371663342138,37.12467598835178,0.08903266921505326,332.98269176483154,149.32916522026062,358.1343231201172,9187,2329,6858,6858,0,12,2334000.0
2334,2334999,20.84461029528887,37.12258914548729,0.08902967228068559,333.1826651096344,149.3936483860016,358.18519592285156,9195,2332,6863,6863,0,12,2335000.0
2335,2335999,20.842038926851995,37.11933189996434,0.08903091844532118,333.36978578567505,149.46039962768555,358.35193252563477,9199,2334,6865,6865,0,12,2336000.0
2336,2336999,20.83946610756203,37.115315557548264,0.08903292636353344,333.49411845207214,149.52467107772827,358.53137588500977,9199,2334,6865,6865,0,12,2337000.0
2337,2337999,20.837862384558505,37.11921137358411,0.08898979452789291,333.6332218647003,149.58900690078735,358.72452545166016,9200,2334,6866,6866,0,12,2338000.0
2338,2338999,20.836062501398494,37.115896867778254,0.08897581993749726,333.7528896331787,149.6541624069214,358.88941955566406,9200,2334,6866,6866,0,12,2339000.0
2339,2339999,20.83368729329409,37.11142405610114,0.08897323351290065,333.9170582294464,149.71835684776306,358.94683837890625,9202,2335,6867,6867,0,12,2340000.0
2340,2340999,20.83225126092923,37.108912628003516,0.08895284530432124,334.1146786212921,149.7827558517456,358.94174575805664,9211,2338,6873,6873,0,12,2341000.0
2341,2341999,20.830197729459737,37.10462634054838,0.08894583818699675,334.25554370880127,149.84755492210388,359.12350845336914,9211,2338,6873,6873,0,12,2342000.0
2342,2342999,20.82862800566613,37.10632363414384,0.08891975255701512,334.4130811691284,149.91261219978333,359.1315155029297,9213,2339,6874,6874,0,12,2343000.0
2343,2343999,20.826882141332156,37.10251560848743,0.08890424170353761,334.56997776031494,149.9769356250763,359.29024505615234,9213,2339,6874,6874,0,12,2344000.0
2344,2344999,20.824914061403465,37.09895075737168,0.08888328057692096,334.69751048088074,150.04300117492676,359.4195556640625,9213,2339,6874,6874,0,12,2345000.0
2345,2345999,20.822152240062106,37.09355011527247,0.08887640440624744,334.83198142051697,150.10620164871216,359.6909828186035,9213,2339,6874,6874,0,12,2346000.0
2346,2346999,20.818942373126102,37.09446032509548,0.08885978251527893,334.94907307624817,150.1713411808014,360.87950897216797,9238,2339,6899,6899,0,12,2347000.0
2347,2347999,20.814869384875408,37.08916121609728,0.0888892991353395,335.06216955184937,150.23494219779968,361.28027725219727,9240,2339,6901,6901,0,12,2348000.0
2348,2348999,20.810299253241805,37.08263765784488,0.0889330979377091,335.1963064670563,150.29786348342896,361.54199600219727,9242,2340,6902,6902,0,12,2349000.0
2349,2349999,20.80654789623066,37.07782241160399,0.08895882276349032,335.4331269264221,150.36290526390076,361.60969161987305,9252,2345,6907,6907,0,12,2350000.0
2350,2350999,20.80247833752003,37.07185961651632,0.08899002067986328,335.6004867553711,150.42626237869263,361.7823905944824,9256,2347,6909,6909,0,12,2351000.0
2351,2351999,20.798743380189276,37.066565051980746,0.08901516573975521,335.7484896183014,150.4904808998108,361.99285888671875,9258,2348,6910,6910,0,12,2352000.0
2352,2352999,20.794698586552826,37.06044108027705,0.08904059074061044,335.94578218460083,150.5563840866089,362.06945419311523,9264,2351,6913,6913,0,12,2353000.0
2353,2353999,20.790917587974903,37.05525666416004,0.08906136454629177,336.0990195274353,150.62110567092896,362.25954818725586,9266,2352,6914,6914,0,12,2354000.0
2354,2354999,20.78767346116928,37.050601195806244,0.0890798637221597,336.29431319236755,150.68528294563293,362.29862213134766,9272,2355,6917,6917,0,12,2355000.0
2355,2355999,20.784651416292807,37.04570498305984,0.08908383648210982,336.42832112312317,150.74982285499573,362.51242446899414,9272,2355,6917,6917,0,12,2356000.0
2356,2356999,20.782448505942487,37.04184009577416,0.08906918340544079,336.586101770401,150.81338691711426,362.58094787597656,9274,2356,6918,6918,0,12,2357000.0
2357,2357999,20.78070158268976,37.03834507561189,0.08905747351375148,336.71313095092773,150.87730598449707,362.6972007751465,9274,2356,6918,6918,0,12,2358000.0
2358,2358999,20.779652238548834,37.03653945531116,0.08902167276803541,336.8435757160187,150.94074201583862,362.85223388671875,9275,2356,6919,6919,0,12,2359000.0
2359,2359999,20.77823286113889,37.03377927154521,0.08899809090353517,337.0178918838501,151.00456476211548,362.7757873535156,9279,2358,6921,6921,0,12,2360000.0
2360,2360999,20.777429555958605,37.03226566219432,0.08897864688883106,337.2027966976166,151.06925296783447,362.90690994262695,9281,2359,6922,6922,0,12,2361000.0
2361,2361999,20.777181710401457,37.03146450644063,0.08895144567114477,337.35721826553345,151.13538146018982,362.95496368408203,9283,2360,6923,6923,0,12,2362000.0
2362,2362999,20.77666569077823,37.02986718706569,0.08893967672365977,337.4901604652405,151.19882488250732,363.1250915527344,9283,2360,6923,6923,0,12,2363000.0
2363,2363999,20.777245856649852,37.02977881621804,0.08892140522598657,337.65721464157104,151.26300644874573,363.19860458374023,9285,2361,6924,6924,0,12,2364000.0
2364,2364999,20.77670180948736,37.02862150857007,0.08890538059359687,337.7931764125824,151.32758903503418,363.3334846496582,9285,2361,6924,6924,0,12,2365000.0
2365,2365999,20.77528499404458,37.02483034091474,0.08890445796913116,337.9230966567993,151.39110708236694,363.4588394165039,9285,2361,6924,6924,0,12,2366000.0
2366,2366999,20.77366910275835,37.021956886753976,0.08888737797545543,338.04455637931824,151.46635675430298,363.93503189086914,9293,2361,6932,6932,0,12,2367000.0
2367,2367999,20.769954331547172,37.0164994598105,0.08891670543309615,338.183785200119,151.52604055404663,364.35866928100586,9298,2362,6936,6936,0,12,2368000.0
2368,2368999,20.76683174984874,37.014460272874274,0.08891819342687923,338.3224844932556,151.5871798992157,364.561767578125,9298,2362,6936,6936,0,12,2369000.0
2369,2369999,20.7628647232769,37.00822400055939,0.08894952703362746,338.4572706222534,151.6464705467224,364.7197914123535,9299,2362,6937,6937,0,12,2370000.0
2370,2370999,20.759407222775707,37.00313761968175,0.08896197485391688,338.630978345871,151.7077751159668,365.31803131103516,9320,2364,6956,6956,0,12,2371000.0
2371,2371999,20.75600839792797,36.998184652546016,0.08897737809801731,338.76396226882935,151.7688648700714,365.62108993530273,9322,2365,6957,6957,0,12,2372000.0
2372,2372999,20.75272926319563,36.99528166846935,0.08898281237474126,338.87633323669434,151.83059191703796,365.93560791015625,9322,2365,6957,6957,0,12,2373000.0
2373,2373999,20.74920353692582,36.98957621994013,0.08900815903762216,339.0100886821747,151.89158511161804,366.1324234008789,9322,2365,6957,6957,0,12,2374000.0
2374,2374999,20.7458444839853,36.98413408568924,0.08903113823960451,339.18164896965027,151.95219230651855,366.15682220458984,9327,2367,6960,6960,0,12,2375000.0
2375,2375999,20.742635294230453,36.978805503250115,0.08904770563169928,339.3226206302643,152.01346898078918,366.3565864562988,9329,2368,6961,6961,0,12,2376000.0
2376,2376999,20.73931459966787,36.97366756663012,0.08906201271147185,339.5058071613312,152.07632446289062,366.4449653625488,9331,2369,6962,6962,0,12,2377000.0
2377,2377999,20.736913994593653,36.96970508520815,0.08905953679565604,339.6600203514099,152.13775968551636,366.56297302246094,9333,2370,6963,6963,0,12,2378000.0
2378,2378999,20.734247080294,36.965571443366436,0.08905888229000769,339.7680330276489,152.19816875457764,366.7071723937988,9334,2370,6964,6964,0,12,2379000.0
2379,2379999,20.73286064321119,36.96408699086776,0.08903304106320153,339.9300832748413,152.25917840003967,366.8115119934082,9334,2370,6964,6964,0,12,2380000.0
2380,2380999,20.73334781611104,36.9721348313975,0.08894908585430106,340.04190158843994,152.31947088241577,366.94178009033203,9334,2370,6964,6964,0,12,2381000.0
2381,2381999,20.734333233640434,36.97494073611642,0.08889153072737865,340.19993448257446,152.38052320480347,367.0279083251953,9336,2371,6965,6965,0,12,2382000.0
2382,2382999,20.73567195545563,36.977617939871216,0.08883136521433699,340.3456697463989,152.443256855011,367.138671875,9336,2371,6965,6965,0,12,2383000.0
2383,2383999,20.73763411013721,36.98239482346237,0.08877048413298316,340.4865174293518,152.50400066375732,367.23160552978516,9336,2371,6965,6965,0,12,2384000.0
2384,2384999,20.739493261102798,36.98491766291721,0.08871711555523032,340.6151239871979,152.56516480445862,367.3219299316406,9336,2371,6965,6965,0,12,2385000.0
2385,2385999,20.740962082492572,36.987049424142995,0.08866708632591758,340.77124881744385,152.62698936462402,367.3108215332031,9338,2372,6966,6966,0,12,2386000.0
2386,2386999,20.741739321902106,36.98791823222247,0.08861717149069426,340.93631529808044,152.6883897781372,367.40785217285156,9340,2373,6967,6967,0,12,2387000.0
2387,2387999,20.73893635390391,36.98284838222474,0.0886279354649755,341.06882905960083,152.74955105781555,367.888614654541,9348,2373,6975,6975,0,12,2388000.0
2388,2388999,20.735943097312607,36.9783370700097,0.08863753359059767,341.1943175792694,152.80989694595337,368.0770034790039,9348,2373,6975,6975,0,12,2389000.0
2389,2389999,20.73365529068223,36.97592481479034,0.0886361571518125,341.3492157459259,152.87033605575562,368.16537857055664,9348,2373,6975,6975,0,12,2390000.0
2390,2390999,20.7308037349948,36.971669323487,0.08864513196306945,341.49885272979736,152.93121123313904,368.2235336303711,9350,2374,6976,6976,0,12,2391000.0
2391,2391999,20.72815777512079,36.966801668200304,0.08864665260934779,341.65108728408813,152.99142217636108,368.24462509155273,9352,2375,6977,6977,0,12,2392000.0
2392,2392999,20.72544284195588,36.9617075666185,0.08865769346394636,341.7844338417053,153.05223155021667,368.3700294494629,9352,2375,6977,6977,0,12,2393000.0
2393,2393999,20.723088933711008,36.95680646717188,0.08866187974529693,341.92630529403687,153.1131112575531,368.450984954834,9352,2375,6977,6977,0,12,2394000.0
2394,2394999,20.7205059313823,36.951563234361984,0.08867421071015058,342.0839641094208,153.17507767677307,368.46007919311523,9354,2376,6978,6978,0,12,2395000.0
2395,2395999,20.71807106186546,36.94743823801251,0.08867461083141981,342.274133682251,153.23661351203918,368.4324722290039,9360,2379,6981,6981,0,12,2396000.0
2396,2396999,20.715769748606736,36.944197836550536,0.08866837968300756,342.45183277130127,153.29747343063354,368.43270111083984,9362,2380,6982,6982,0,12,2397000.0
2397,2397999,20.713482059713527,36.93976672318614,0.08866929122183498,342.60436630249023,153.35861611366272,368.5637969970703,9362,2380,6982,6982,0,12,2398000.0
2398,2398999,20.71186002462061,36.93652200753974,0.08865473439730187,342.73556685447693,153.4190423488617,368.5663146972656,9364,2381,6983,6983,0,12,2399000.0
2399,2399999,20.710851962987146,36.934723766762886,0.08862914917821041,342.89515709877014,153.4795172214508,368.6468086242676,9364,2381,6983,6983,0,12,2400000.0
2400,2400999,20.7111039286423,36.93487700908154,0.0885947895283794,343.03009510040283,153.54041981697083,368.7188911437988,9364,2381,6983,6983,0,12,2401000.0
2401,2401999,20.71087666716745,36.93357534334907,0.0885667815327329,343.18017649650574,153.6013834476471,368.7242965698242,9366,2382,6984,6984,0,12,2402000.0
2402,2402999,20.711232219912148,36.93331700679699,0.08852784661772473,343.33632230758667,153.66230082511902,368.79570388793945,9366,2382,6984,6984,0,12,2403000.0
2403,2403999,20.714568597533283,36.94044041411496,0.08844552362642022,343.476589679718,153.72244930267334,368.86012268066406,9366,2382,6984,6984,0,12,2404000.0
2404,2404999,20.71752902612587,36.9478782491112,0.08837618565452898,343.6490738391876,153.7835545539856,368.8764533996582,9368,2383,6985,6985,0,12,2405000.0
2405,2405999,20.72060363744496,36.95370981416987,0.08831267203787763,343.82070088386536,153.84871363639832,368.8155059814453,9370,2384,6986,6986,0,12,2406000.0
2406,2406999,20.722813660873506,36.956256914173125,0.08827092524463187,343.9589333534241,153.90960931777954,368.89666748046875,9370,2384,6986,6986,0,12,2407000.0
2407,2407999,20.721684290528106,36.956412295463686,0.08824458101515364,344.08385944366455,153.9707055091858,369.275146484375,9378,2384,6994,6994,0,12,2408000.0
2408,2408999,20.71964441814191,36.965596797916994,0.08818355430046532,344.27849888801575,154.03133583068848,369.32152938842773,9383,2386,6997,6997,0,12,2409000.0
2409,2409999,20.716988812021068,36.96195452294727,0.08818948257080039,344.45561504364014,154.09243273735046,369.3912124633789,9387,2388,6999,6999,0,12,2410000.0
2410,2410999,20.7146150654255,36.95803336605009,0.08819636239936035,344.5789396762848,154.1531698703766,369.6002311706543,9387,2388,6999,6999,0,12,2411000.0
2411,2411999,20.711902733262676,36.95385330222459,0.0881987032015954,344.7473373413086,154.21418285369873,369.6218910217285,9391,2390,7001,7001,0,12,2412000.0
2412,2412999,20.709603582737614,36.95012755951512,0.0882004196399152,344.92226243019104,154.27638363838196,369.7305030822754,9393,2391,7002,7002,0,12,2413000.0
2413,2413999,20.70680231592625,36.945137134568036,0.0882080711365224,345.037722826004,154.33703088760376,369.86940002441406,9393,2391,7002,7002,0,12,2414000.0
2414,2414999,20.70482572916144,36.94111742410618,0.08821005702915818,345.16197657585144,154.39762139320374,369.97054290771484,9393,2391,7002,7002,0,12,2415000.0
2415,2415999,20.702490834507316,36.93746005101269,0.08820491302053446,345.41279697418213,154.4588577747345,369.6528968811035,9402,2395,7007,7007,0,12,2416000.0
2416,2416999,20.700197341102925,36.93319492811209,0.08820090411728343,345.52790904045105,154.5203561782837,369.85607528686523,9402,2395,7007,7007,0,12,2417000.0
2417,2417999,20.698248204166855,36.9301135984487,0.08818979877586208,345.67444038391113,154.58124375343323,369.9540328979492,9402,2395,7007,7007,0,12,2418000.0
2418,2418999,20.696127973521136,36.9260146584992,0.08817813806268271,345.79777908325195,154.64324688911438,370.10313415527344,9402,2395,7007,7007,0,12,2419000.0
2419,2419999,20.694999276379587,36.92467216808335,0.08815592940069927,345.9318907260895,154.70397329330444,370.2329559326172,9402,2395,7007,7007,0,12,2420000.0
2420,2420999,20.69440903800808,36.923473033463786,0.08813685891379142,346.0558922290802,154.76477336883545,370.4082145690918,9402,2395,7007,7007,0,12,2421000.0
2421,2421999,20.695207037418676,36.925411124572655,0.0881251341264353,346.21672010421753,154.82669591903687,370.4005699157715,9405,2396,7009,7009,0,12,2422000.0
2422,2422999,20.695946412519202,36.927856042642176,0.0881068763346522,346.3906559944153,154.88835549354553,370.45083236694336,9407,2397,7010,7010,0,12,2423000.0
2423,2423999,20.69843823969337,36.931990882692745,0.08809285806596234,346.5612258911133,154.95022654533386,370.42316818237305,9411,2399,7012,7012,0,12,2424000.0
2424,2424999,20.700728925364555,36.936174497009,0.08810587858648145,346.6912348270416,155.01387667655945,370.6072807312012,9412,2399,7013,7013,0,12,2425000.0
2425,2425999,20.703397509012643,36.94173191852293,0.08809460964552018,346.847190618515,155.07519936561584,370.6674690246582,9414,2400,7014,7014,0,12,2426000.0
2426,2426999,20.70425458785447,36.942600734130174,0.08809341015956174,346.97809505462646,155.13692903518677,370.76600646972656,9414,2400,7014,7014,0,12,2427000.0
2427,2427999,20.705689660618148,36.94675368889893,0.08807928562153977,347.134122133255,155.19817090034485,370.74789810180664,9416,2401,7015,7015,0,12,2428000.0
2428,2428999,20.704461139249307,36.94511701644576,0.0880551925264208,347.2817883491516,155.25986051559448,371.32128524780273,9427,2401,7026,7026,0,12,2429000.0
2429,2429999,20.702574076272285,36.944495608521805,0.08803061034957504,347.42122316360474,155.32114243507385,371.6021957397461,9428,2401,7027,7027,0,12,2430000.0
2430,2430999,20.700682837892625,36.94203803175863,0.0880246446215156,347.56929636001587,155.38267397880554,371.73106384277344,9430,2402,7028,7028,0,12,2431000.0
2431,2431999,20.698184797885688,36.93805677950687,0.08802264559304662,347.7316384315491,155.44435048103333,371.7714157104492,9434,2404,7030,7030,0,12,2432000.0
2432,2432999,20.695894892729847,36.93430372958033,0.08801420689792805,347.88274669647217,155.50674295425415,371.91911697387695,9436,2405,7031,7031,0,12,2433000.0
2433,2433999,20.694437134652386,36.93313171072528,0.08798501634625655,348.02401423454285,155.5683674812317,372.01725006103516,9438,2406,7032,7032,0,12,2434000.0
2434,2434999,20.692616888951004,36.93116716546603,0.08796085874427595,348.1732659339905,155.63031840324402,372.180362701416,9438,2406,7032,7032,0,12,2435000.0
2435,2435999,20.690617916318075,36.927319389573704,0.08794345838053119,348.34363555908203,155.69176936149597,372.19128036499023,9442,2408,7034,7034,0,12,2436000.0
2436,2436999,20.688549026627793,36.92296031856651,0.08793748976374915,348.54951763153076,155.75421357154846,372.0987091064453,9448,2411,7037,7037,0,12,2437000.0
2437,2437999,20.68659243657364,36.918706168458804,0.08793386253758273,348.7097408771515,155.8162808418274,372.2096481323242,9450,2412,7038,7038,0,12,2438000.0
2438,2438999,20.684636562058746,36.91491018021254,0.08791933364015092,348.84363436698914,155.87820482254028,372.329532623291,9450,2412,7038,7038,0,12,2439000.0
2439,2439999,20.683082668664145,36.911419346680574,0.08789583010573188,348.97049951553345,155.9397370815277,372.4497375488281,9450,2412,7038,7038,0,12,2440000.0
2440,2440999,20.68208882528969,36.908900075512165,0.08786301624968618,349.1041986942291,156.0016314983368,372.54379653930664,9450,2412,7038,7038,0,12,2441000.0
2441,2441999,20.681939234564975,36.907108930082316,0.0878203995367729,349.2477309703827,156.06319761276245,372.58943939208984,9450,2412,7038,7038,0,12,2442000.0
2442,2442999,20.681339012189195,36.90381069732264,0.08777699909229164,349.3828299045563,156.12447476387024,372.65075302124023,9450,2412,7038,7038,0,12,2443000.0
2443,2443999,20.681530380102387,36.90193660332993,0.08773259540013534,349.51115107536316,156.18654918670654,372.7309379577637,9451,2412,7039,7039,0,12,2444000.0
2444,2444999,20.68155281683568,36.89935807058211,0.08768880066036089,349.6798655986786,156.24830985069275,372.7168769836426,9453,2413,7040,7040,0,12,2445000.0
2445,2445999,20.681813737999978,36.89736195424145,0.08764237084158388,349.81659722328186,156.3103015422821,372.79709243774414,9453,2413,7040,7040,0,12,2446000.0
2446,2446999,20.681555045719602,36.89493003897687,0.08760820154683546,349.952796459198,156.37196826934814,372.84891510009766,9453,2413,7040,7040,0,12,2447000.0
2447,2447999,20.681586559399474,36.89234314118364,0.0875725733469741,350.115375995636,156.43377876281738,372.77698135375977,9457,2414,7043,7043,0,12,2448000.0
2448,2448999,20.681453987799088,36.892552410744266,0.08752972005212689,350.2433350086212,156.49552178382874,372.8482131958008,9457,2414,7043,7043,0,12,2449000.0
2449,2449999,20.68072675886278,36.893655959461455,0.08747976626334908,350.36511421203613,156.55733180046082,373.51060485839844,9471,2414,7057,7057,0,12,2450000.0
2450,2450999,20.678563399446656,36.89000073209751,0.08747468608978515,350.4772205352783,156.61948347091675,373.83019638061523,9472,2414,7058,7058,0,12,2451000.0
2451,2451999,20.67683039316643,36.88650854224668,0.08747230949084683,350.60114550590515,156.68095445632935,374.03937911987305,9472,2414,7058,7058,0,12,2452000.0
2452,2452999,20.67483261658475,36.88300681137394,0.08746992730948966,350.81553840637207,156.74324798583984,374.0504951477051,9480,2418,7062,7062,0,12,2453000.0
2453,2453999,20.673316186521415,36.8809275272458,0.0874541163268,350.9849977493286,156.80607390403748,374.13327407836914,9482,2419,7063,7063,0,12,2454000.0
2454,2454999,20.67228546414487,36.88024908721138,0.08743150657265653,351.13203382492065,156.868093252182,374.3423881530762,9484,2420,7064,7064,0,12,2455000.0
2455,2455999,20.67084020632881,36.877029835871646,0.08741675681851624,351.31252217292786,156.93053913116455,374.4006233215332,9513,2422,7091,7091,0,12,2456000.0
2456,2456999,20.66997337427984,36.87584691979448,0.08739120450563309,351.50527906417847,156.99279308319092,374.3364944458008,9519,2425,7094,7094,0,12,2457000.0
2457,2457999,20.668597515703887,36.87323428599048,0.08737933374115003,351.65394926071167,157.05491876602173,374.5935707092285,9521,2426,7095,7095,0,12,2458000.0
2458,2458999,20.666981435526157,36.86940963105676,0.08737579579698163,351.7982132434845,157.11697554588318,374.7637634277344,9521,2426,7095,7095,0,12,2459000.0
2459,2459999,20.666396285963028,36.86735827763344,0.08735493863601074,351.9591763019562,157.17924189567566,374.8102912902832,9523,2427,7096,7096,0,12,2460000.0
2460,2460999,20.666321292598525,36.869788990701586,0.08729851499402907,352.0991542339325,157.2413318157196,374.90550231933594,9523,2427,7096,7096,0,12,2461000.0
2461,2461999,20.66687057908709,36.868639812359405,0.08726543563737144,352.2772660255432,157.30357480049133,374.842529296875,9527,2429,7098,7098,0,12,2462000.0
2462,2462999,20.666622048032657,36.86558494916023,0.0872477063886945,352.39193630218506,157.36626625061035,374.9932975769043,9527,2429,7098,7098,0,12,2463000.0
2463,2463999,20.666561444829316,36.86284544151183,0.08722498824748737,352.5302646160126,157.42816996574402,375.1106986999512,9527,2429,7098,7098,0,12,2464000.0
2464,2464999,20.66693358856786,36.86056276993768,0.0872003390032573,352.6916058063507,157.49390602111816,375.13551330566406,9529,2430,7099,7099,0,12,2465000.0
2465,2465999,20.66605594163776,36.85670280671224,0.08718779860162751,352.8536219596863,157.55928707122803,375.09252166748047,9534,2431,7103,7103,0,12,2466000.0
2466,2466999,20.66535347783534,36.85314641200302,0.08716246105297021,353.01200342178345,157.6216163635254,375.2563705444336,9534,2431,7103,7103,0,12,2467000.0
2467,2467999,20.66420570615777,36.8532749068944,0.08712868948192143,353.1653211116791,157.68491196632385,375.9801597595215,9554,2432,7122,7122,0,12,2468000.0
2468,2468999,20.662915136651826,36.851879236808855,0.08711596951119649,353.2883734703064,157.7464780807495,376.303955078125,9555,2432,7123,7123,0,12,2469000.0
2469,2469999,20.661389730402174,36.850064005418666,0.08710727773907478,353.43197417259216,157.80904245376587,376.5243377685547,9558,2433,7125,7125,0,12,2470000.0
2470,2470999,20.660134342872027,36.84759617514637,0.08709515872925333,353.6275579929352,157.87117958068848,376.63058853149414,9565,2436,7129,7129,0,12,2471000.0
2471,2471999,20.659167804945348,36.84535902674556,0.08707661209333672,353.7657630443573,157.93425107002258,376.8355484008789,9567,2437,7130,7130,0,12,2472000.0
2472,2472999,20.657186379633274,36.84129066593828,0.08707447707980875,353.9350748062134,157.99642515182495,376.8763313293457,9575,2439,7136,7136,0,12,2473000.0
2473,2473999,20.656866912669628,36.840823203781135,0.08704334545354397,354.0922441482544,158.0588026046753,377.0209541320801,9577,2440,7137,7137,0,12,2474000.0
2474,2474999,20.655634152128965,36.838056821114456,0.08702218791897676,354.2747542858124,158.12143540382385,377.00292587280273,9583,2443,7140,7140,0,12,2475000.0
2475,2475999,20.655172843084966,36.843902399410695,0.08696192827166871,354.4204435348511,158.1849467754364,377.1909828186035,9585,2444,7141,7141,0,12,2476000.0
2476,2476999,20.654452428161346,36.84187930377631,0.08693543693538308,354.5735867023468,158.24718236923218,377.3117256164551,9587,2445,7142,7142,0,12,2477000.0
2477,2477999,20.65478335518123,36.84463958021405,0.08688769288116782,354.72228622436523,158.30943775177002,377.4254455566406,9587,2445,7142,7142,0,12,2478000.0
2478,2478999,20.655115032468338,36.84325849370137,0.08686800499428693,354.8834421634674,158.37158870697021,377.4309997558594,9589,2446,7143,7143,0,12,2479000.0
2479,2479999,20.656747897134956,36.84384026519907,0.08683105339967878,355.0412218570709,158.43371629714966,377.4339065551758,9591,2447,7144,7144,0,12,2480000.0
2480,2480999,20.657798550182488,36.843507758737374,0.08681583561777373,355.1699388027191,158.49535489082336,377.54951095581055,9591,2447,7144,7144,0,12,2481000.0
2481,2481999,20.660034898052086,36.84539582661369,0.08679256212011977,355.2948970794678,158.55850553512573,377.6826934814453,9591,2447,7144,7144,0,12,2482000.0
2482,2482999,20.662338404382716,36.85334072339011,0.086732979783114,355.5068402290344,158.62101459503174,377.5376319885254,9601,2450,7151,7151,0,12,2483000.0
2483,2483999,20.664767007954115,36.85635516487574,0.08669901110675338,355.65997290611267,158.68355298042297,377.54017639160156,9607,2451,7156,7156,0,12,2484000.0
2484,2484999,20.66623388926956,36.85600976321053,0.08668953938764856,355.80991888046265,158.74627804756165,377.68911361694336,9607,2451,7156,7156,0,12,2485000.0
2485,2485999,20.668394371770546,36.859032478750066,0.08666169577923277,355.9412214756012,158.80821132659912,377.78734970092773,9607,2451,7156,7156,0,12,2486000.0
2486,2486999,20.668262775973336,36.85641273580361,0.0866510719287249,356.1012716293335,158.870032787323,377.95384216308594,9608,2451,7157,7157,0,12,2487000.0
2487,2487999,20.6663253007213,36.854460786470014,0.08663108621816751,356.227108001709,158.9336450099945,378.8842468261719,9627,2451,7176,7176,0,12,2488000.0
2488,2488999,20.664404519113017,36.85293131720411,0.08662132038863612,356.3331344127655,158.9948763847351,379.2503242492676,9628,2451,7177,7177,0,12,2489000.0
2489,2489999,20.662697747364074,36.851075794649525,0.08661391718320721,356.4920217990875,159.05618858337402,379.33348083496094,9635,2453,7182,7182,0,12,2490000.0
2490,2490999,20.66140096395361,36.849900370630635,0.08659788889476006,356.71278285980225,159.12003111839294,379.39822006225586,9643,2457,7186,7186,0,12,2491000.0
2491,2491999,20.659323812123098,36.84841830543264,0.08659427860965163,356.8811378479004,159.18251585960388,379.54637908935547,9647,2459,7188,7188,0,12,2492000.0
2492,2492999,20.657617504737054,36.845597239474415,0.08658806253603768,356.98918199539185,159.24432468414307,379.84557723999023,9647,2459,7188,7188,0,12,2493000.0
2493,2493999,20.655970788947652,36.842954947903245,0.08657392529560815,357.2029490470886,159.30673670768738,379.8257484436035,9653,2462,7191,7191,0,12,2494000.0
2494,2494999,20.65399585180282,36.83929768963893,0.08656677073239438,357.3605480194092,159.369225025177,380.0477828979492,9655,2463,7192,7192,0,12,2495000.0
2495,2495999,20.652788031130804,36.83860446176044,0.08654653021887615,357.5069839954376,159.4316325187683,380.2104835510254,9657,2464,7193,7193,0,12,2496000.0
2496,2496999,20.650734638519737,36.83381140804292,0.08654151471643634,357.65170645713806,159.49392247200012,380.31318283081055,9662,2465,7197,7197,0,12,2497000.0
2497,2497999,20.649606750792202,36.835272643645325,0.08648967626189974,357.80448150634766,159.55745267868042,380.40849685668945,9664,2466,7198,7198,0,12,2498000.0
2498,2498999,20.648490794639976,36.83224556478465,0.08647606708500699,357.95457339286804,159.6197235584259,380.3954391479492,9666,2467,7199,7199,0,12,2499000.0
2499,2499999,20.647670514187425,36.82900335008445,0.08644514931275149,358.0986909866333,159.68188905715942,380.4243850708008,9668,2468,7200,7200,0,12,2500000.0
2500,2500999,20.647359253433304,36.82780028449864,0.08641759388800785,358.24341559410095,159.74356532096863,380.58740997314453,9668,2468,7200,7200,0,12,2501000.0
2501,2501999,20.646650244015103,36.8242214711885,0.08639831536541742,358.4692802429199,159.80617690086365,380.36691665649414,9680,2472,7208,7208,0,12,2502000.0
2502,2502999,20.645822084978718,36.82076302446705,0.08638102373369416,358.61533212661743,159.87186932563782,380.52757263183594,9682,2473,7209,7209,0,12,2503000.0
2503,2503999,20.645495506574296,36.81757394860013,0.08636362027483935,358.772358417511,159.93427801132202,380.59033966064453,9684,2474,7210,7210,0,12,2504000.0
2504,2504999,20.644604550063736,36.813511925697426,0.08635796950007657,358.91005086898804,159.996235370636,380.70742416381836,9684,2474,7210,7210,0,12,2505000.0
2505,2505999,20.64359313124045,36.80979457450879,0.08634899270525564,359.03459787368774,160.0581316947937,380.83154296875,9684,2474,7210,7210,0,12,2506000.0
2506,2506999,20.642760661249145,36.80603683198774,0.08633616818424339,359.16467022895813,160.12027525901794,380.920166015625,9684,2474,7210,7210,0,12,2507000.0
2507,2507999,20.640848911768934,36.80214616096676,0.08631472413082786,359.3117938041687,160.18294024467468,381.3956527709961,9694,2474,7220,7220,0,12,2508000.0
2508,2508999,20.637380882699336,36.796183735302144,0.08634405189338712,359.4186372756958,160.24489283561707,382.1479263305664,9698,2474,7224,7224,0,12,2509000.0
2509,2509999,20.634852553673447,36.792443061658126,0.0863632676373467,359.5237338542938,160.30674624443054,382.4823188781738,9698,2474,7224,7224,0,12,2510000.0
2510,2510999,20.632209538252926,36.788317697470866,0.08639026696011676,359.64430046081543,160.36785078048706,382.708740234375,9698,2474,7224,7224,0,12,2511000.0
2511,2511999,20.62989525415905,36.78792467303512,0.0863904043160918,359.81513571739197,160.429523229599,382.8162727355957,9702,2476,7226,7226,0,12,2512000.0
2512,2512999,20.626813281227797,36.78277228151706,0.08641577327959227,359.9440743923187,160.491553068161,383.0072784423828,9702,2476,7226,7226,0,12,2513000.0
2513,2513999,20.624030718613177,36.77866622413265,0.08644489337393202,360.0892651081085,160.55321145057678,383.19065856933594,9704,2477,7227,7227,0,12,2514000.0
2514,2514999,20.620644022076316,36.77312240433968,0.08647080584408595,360.2704586982727,160.61497259140015,383.19042205810547,9708,2479,7229,7229,0,12,2515000.0
2515,2515999,20.61735860310433,36.769358729802015,0.08649244436561154,360.4189553260803,160.67680287361145,383.281494140625,9710,2480,7230,7230,0,12,2516000.0
2516,2516999,20.61429183531324,36.76400158967193,0.08651342449561583,360.5834529399872,160.7389223575592,383.4031562805176,9712,2481,7231,7231,0,12,2517000.0
2517,2517999,20.611919923812525,36.759652462669756,0.08652384804190327,360.70918345451355,160.8006465435028,383.5273742675781,9712,2481,7231,7231,0,12,2518000.0
2518,2518999,20.609542445283378,36.75557384664353,0.08653330335683362,360.85712933540344,160.86287307739258,383.55976486206055,9714,2482,7232,7232,0,12,2519000.0
2519,2519999,20.607230333625655,36.750584288414004,0.08654448164761308,360.9908275604248,160.92471957206726,383.6530113220215,9714,2482,7232,7232,0,12,2520000.0
2520,2520999,20.605101294713865,36.74558383524199,0.08654635150099244,361.1629123687744,160.98674511909485,383.6082649230957,9721,2483,7238,7238,0,12,2521000.0
2521,2521999,20.603019248624175,36.7412353027537,0.08654911031506085,361.2990596294403,161.0482747554779,383.7314567565918,9721,2483,7238,7238,0,12,2522000.0
2522,2522999,20.60092919443151,36.73704505744686,0.0865564870609773,361.48587012290955,161.11012506484985,383.63450622558594,9735,2486,7249,7249,0,12,2523000.0
2523,2523999,20.59912651430839,36.733536844697234,0.08656492213624734,361.6470925807953,161.17181730270386,383.65735244750977,9737,2487,7250,7250,0,12,2524000.0
2524,2524999,20.597461752949645,36.72936082862333,0.08657463365577744,361.80059599876404,161.23344802856445,383.79697036743164,9737,2487,7250,7250,0,12,2525000.0
2525,2525999,20.59574130941634,36.72531735494358,0.08657831954205941,361.92824053764343,161.29599690437317,383.90212631225586,9737,2487,7250,7250,0,12,2526000.0
2526,2526999,20.593740665759693,36.72093008454052,0.08658464120373632,362.063925743103,161.3584041595459,383.97266387939453,9737,2487,7250,7250,0,12,2527000.0
2527,2527999,20.591805736392534,36.716796947055165,0.08658900397400915,362.26029419898987,161.42026162147522,383.91662979125977,9740,2489,7251,7251,0,12,2528000.0
2528,2528999,20.589332130060935,36.71228191440909,0.08660147685001984,362.377952337265,161.48233437538147,384.80162811279297,9751,2489,7262,7262,0,12,2529000.0
2529,2529999,20.58650784765345,36.70892592145,0.08661129035332449,362.48945593833923,161.5441131591797,385.1641311645508,9751,2489,7262,7262,0,12,2530000.0
2530,2530999,20.58377715318267,36.704454011317715,0.08662648618925906,362.601042509079,161.6066575050354,385.42233657836914,9751,2489,7262,7262,0,12,2531000.0
2531,2531999,20.58148787174958,36.70391405210091,0.08661621578261158,362.7853684425354,161.66896605491638,385.52327728271484,9755,2491,7264,7264,0,12,2532000.0
2532,2532999,20.578622258323975,36.69945321366809,0.08662836231551685,362.93160247802734,161.73137736320496,385.69600677490234,9757,2492,7265,7265,0,12,2533000.0
2533,2533999,20.576749788673435,36.69599256590822,0.08663359432136863,363.0994327068329,161.7941770553589,385.8024482727051,9761,2494,7267,7267,0,12,2534000.0
2534,2534999,20.574228006810355,36.6911320133219,0.0866493071849539,363.2283465862274,161.85589361190796,385.9568672180176,9761,2494,7267,7267,0,12,2535000.0
2535,2535999,20.571413257090235,36.68618419088719,0.08666414768231112,363.3928790092468,161.9183759689331,386.0448455810547,9763,2495,7268,7268,0,12,2536000.0
2536,2536999,20.56922008886868,36.682437847270165,0.08667147352497939,363.57315373420715,161.9837145805359,386.11181640625,9765,2496,7269,7269,0,12,2537000.0
2537,2537999,20.566448358883296,36.67728539763255,0.0866879790094287,363.68651843070984,162.0454273223877,386.22776794433594,9765,2496,7269,7269,0,12,2538000.0
2538,2538999,20.564159263841585,36.67329511376178,0.08668911633762177,363.82010984420776,162.1083061695099,386.348331451416,9766,2496,7270,7270,0,12,2539000.0
2539,2539999,20.56190200693665,36.66866442675834,0.08668972717751022,363.9384467601776,162.16997051239014,386.42698669433594,9766,2496,7270,7270,0,12,2540000.0
2540,2540999,20.560009353054152,36.66476355988783,0.08668281068840822,364.08730578422546,162.23198008537292,386.5223617553711,9774,2497,7277,7277,0,12,2541000.0
2541,2541999,20.55861626917889,36.66177472380626,0.08666786219495637,364.22681951522827,162.29390788078308,386.65207290649414,9774,2497,7277,7277,0,12,2542000.0
2542,2542999,20.558887433307884,36.66495371440954,0.08663816763715138,364.36562633514404,162.35589122772217,386.71571350097656,9776,2498,7278,7278,0,12,2543000.0
2543,2543999,20.559583376390652,36.66525835484413,0.08664616969485073,364.5538284778595,162.41804933547974,386.7145767211914,9786,2500,7286,7286,0,12,2544000.0
2544,2544999,20.559986474145145,36.66483139231563,0.08669364348371511,364.77449584007263,162.48290371894836,386.69165420532227,9792,2503,7289,7289,0,12,2545000.0
2545,2545999,20.56122256471756,36.66827506824553,0.0867067760720801,364.9263792037964,162.54524946212769,386.7469673156738,9794,2504,7290,7290,0,12,2546000.0
2546,2546999,20.56248720734184,36.668888809897176,0.08672040334369979,365.04582715034485,162.60692477226257,386.8759956359863,9794,2504,7290,7290,0,12,2547000.0
2547,2547999,20.562485254706544,36.66672403045274,0.08670104252688537,365.2044975757599,162.6691815853119,386.96704483032227,9794,2504,7290,7290,0,12,2548000.0
2548,2548999,20.56130580237909,36.66352823665638,0.08672327502384336,365.3884620666504,162.7325942516327,387.06816482543945,9806,2506,7300,7300,0,12,2549000.0
2549,2549999,20.559325332762008,36.660854691123966,0.0867230186929856,365.51695132255554,162.7948088645935,387.9201545715332,9813,2506,7307,7307,0,12,2550000.0
2550,2550999,20.557586427533554,36.65824841933024,0.08672514530842801,365.65711092948914,162.85649180412292,388.1776237487793,9816,2507,7309,7309,0,12,2551000.0
2551,2551999,20.55531983596319,36.65369757976543,0.08673830215946865,365.82595038414,162.91891717910767,388.35405349731445,9823,2508,7315,7315,0,12,2552000.0
2552,2552999,20.552905027079042,36.649056073101264,0.08675024005258836,365.9717810153961,162.98095989227295,388.5204315185547,9825,2509,7316,7316,0,12,2553000.0
2553,2553999,20.55169440931742,36.647435152308795,0.08673380388886709,366.1143305301666,163.04429006576538,388.6545867919922,9827,2510,7317,7317,0,12,2554000.0
2554,2554999,20.550264263329154,36.64422248573774,0.0867288329015059,366.23952174186707,163.10592246055603,388.86322021484375,9827,2510,7317,7317,0,12,2555000.0
2555,2555999,20.549130091125026,36.64373438461022,0.08670796037080286,366.38093519210815,163.16801142692566,389.00099182128906,9827,2510,7317,7317,0,12,2556000.0
2556,2556999,20.54846917512973,36.64977309603346,0.08666256875406952,366.5506691932678,163.22997450828552,388.99503326416016,9831,2512,7319,7319,0,12,2557000.0
2557,2557999,20.54808134531728,36.6488709559089,0.08664973425727085,366.71580719947815,163.2927873134613,389.1109848022461,9835,2514,7321,7321,0,12,2558000.0
2558,2558999,20.547536974109214,36.64686271892702,0.08663187845278553,366.87615871429443,163.35506653785706,389.2567558288574,9835,2514,7321,7321,0,12,2559000.0
2559,2559999,20.54805833282202,36.64782059758427,0.08661353743699263,366.9956817626953,163.41687488555908,389.4575958251953,9835,2514,7321,7321,0,12,2560000.0
2560,2560999,20.548655443595795,36.64747919781152,0.08659029240298455,367.1167166233063,163.47878742218018,389.5699920654297,9835,2514,7321,7321,0,12,2561000.0
2561,2561999,20.550523297822327,36.649953501852224,0.08657561546329107,367.2547883987427,163.54070281982422,389.78570556640625,9835,2514,7321,7321,0,12,2562000.0
2562,2562999,20.553594963234005,36.65512723452869,0.08657412656340857,367.3867299556732,163.60285019874573,389.9352607727051,9835,2514,7321,7321,0,12,2563000.0
2563,2563999,20.55632235628265,36.65817170373195,0.08655169899067017,367.5205936431885,163.66547298431396,390.0409164428711,9835,2514,7321,7321,0,12,2564000.0
2564,2564999,20.559546189678564,36.66317565988659,0.0865780395648097,367.69427371025085,163.72773122787476,390.0920181274414,9837,2515,7322,7322,0,12,2565000.0
2565,2565999,20.563861506334735,36.66924765809104,0.08658803752449229,367.8274133205414,163.78941798210144,390.20733642578125,9837,2515,7322,7322,0,12,2566000.0
2566,2566999,20.569449101319158,36.67836901667432,0.08662829360080959,367.9512767791748,163.851154088974,390.28361892700195,9837,2515,7322,7322,0,12,2567000.0
2567,2567999,20.573195358662044,36.68619360206578,0.08665224806089333,368.12024092674255,163.9130973815918,390.27820587158203,9844,2516,7328,7328,0,12,2568000.0
2568,2568999,20.578261493186748,36.69436268164521,0.0867200549077759,368.2577874660492,163.97504043579102,390.3850898742676,9844,2516,7328,7328,0,12,2569000.0
2569,2569999,20.579966188930452,36.6999454940136,0.08670351728832004,368.38312315940857,164.0380346775055,391.0379295349121,9854,2516,7338,7338,0,12,2570000.0
2570,2570999,20.57799779797141,36.696620371659534,0.08669787271317386,368.5059504508972,164.10003757476807,391.47330474853516,9855,2516,7339,7339,0,12,2571000.0
2571,2571999,20.575862462645595,36.69383920627822,0.08670080223059562,368.68344831466675,164.16335487365723,391.5982971191406,9859,2518,7341,7341,0,12,2572000.0
2572,2572999,20.574317938019476,36.694129028068595,0.08668689517078898,368.80260157585144,164.22606754302979,391.8379440307617,9859,2518,7341,7341,0,12,2573000.0
2573,2573999,20.57243363114257,36.690672135948134,0.08669152294411453,368.96987676620483,164.28854179382324,391.9266929626465,9865,2520,7345,7345,0,12,2574000.0
2574,2574999,20.570631905147028,36.68764430249485,0.08669295117198694,369.1146831512451,164.3505256175995,392.02657318115234,9867,2521,7346,7346,0,12,2575000.0
2575,2575999,20.568871012205516,36.684453082142944,0.08668832514247604,369.2604601383209,164.4140625,392.1539649963379,9869,2522,7347,7347,0,12,2576000.0
2576,2576999,20.567161835153488,36.68091523521309,0.08668315505256796,369.44624972343445,164.47703766822815,392.2196922302246,9878,2523,7355,7355,0,12,2577000.0
2577,2577999,20.56600365075647,36.67812403209692,0.08667446293768333,369.58729100227356,164.539204120636,392.3248748779297,9880,2524,7356,7356,0,12,2578000.0
2578,2578999,20.565293205478618,36.67702156787778,0.08665146740425678,369.723970413208,164.6016399860382,392.50127029418945,9880,2524,7356,7356,0,12,2579000.0
2579,2579999,20.56384584877832,36.673890139188096,0.086641230230316,369.8679223060608,164.6641595363617,392.61684799194336,9880,2524,7356,7356,0,12,2580000.0
2580,2580999,20.563689033503028,36.67290339287482,0.08661304966630579,369.98397970199585,164.72801184654236,392.79229736328125,9880,2524,7356,7356,0,12,2581000.0
2581,2581999,20.563458092674257,36.67193354221238,0.08659695155555525,370.11319875717163,164.79011225700378,392.9194869995117,9880,2524,7356,7356,0,12,2582000.0
2582,2582999,20.563567080104797,36.671623115228655,0.08657580030135759,370.2717809677124,164.8525574207306,393.0286331176758,9882,2525,7357,7357,0,12,2583000.0
2583,2583999,20.56413764580622,36.672513575311086,0.08654792208657403,370.3921465873718,164.91559195518494,393.1925163269043,9882,2525,7357,7357,0,12,2584000.0
2584,2584999,20.564816528706995,36.67346314016194,0.0865271700496506,370.54863476753235,164.9783980846405,393.25951385498047,9892,2526,7366,7366,0,12,2585000.0
2585,2585999,20.56578239405453,36.67378797518436,0.08650720127930722,370.75526571273804,165.04122924804688,393.197078704834,9896,2528,7368,7368,0,12,2586000.0
2586,2586999,20.56744567621426,36.6750873387443,0.08648940039203157,370.89552760124207,165.1049132347107,393.3213005065918,9898,2529,7369,7369,0,12,2587000.0
2587,2587999,20.568867835901422,36.67617615674064,0.08646251447467967,371.0336055755615,165.1673617362976,393.4749069213867,9898,2529,7369,7369,0,12,2588000.0
2588,2588999,20.57114735743868,36.67885698819332,0.08643019376757022,371.18668937683105,165.23031640052795,393.49248123168945,9900,2530,7370,7370,0,12,2589000.0
2589,2589999,20.57420126184127,36.68454394561668,0.086379473450931,371.3226797580719,165.29303312301636,393.645263671875,9900,2530,7370,7370,0,12,2590000.0
2590,2590999,20.57391408888661,36.682685049201964,0.08636700222957838,371.46729922294617,165.3561511039734,394.3980026245117,9911,2530,7381,7381,0,12,2591000.0
2591,2591999,20.57143710377842,36.68022686614462,0.08637126214695878,371.58076310157776,165.41848611831665,394.8371696472168,9913,2530,7383,7383,0,12,2592000.0
2592,2592999,20.569265776502714,36.6772548600652,0.08638669326454651,371.6996474266052,165.4806523323059,395.0990409851074,9913,2530,7383,7383,0,12,2593000.0
2593,2593999,20.566694953682667,36.67272818974872,0.08640588385110193,371.85518193244934,165.5430293083191,395.26518630981445,9915,2531,7384,7384,0,12,2594000.0
2594,2594999,20.563895074209455,36.66788845570534,0.08642495863688626,371.9731411933899,165.60556769371033,395.43882751464844,9915,2531,7384,7384,0,12,2595000.0
2595,2595999,20.561296467801274,36.663338059798434,0.08644418858817271,372.15470266342163,165.66828322410583,395.4850769042969,9919,2533,7386,7386,0,12,2596000.0
2596,2596999,20.55872520485619,36.658547398750095,0.08645149696822374,372.3000257015228,165.73073816299438,395.63618087768555,9919,2533,7386,7386,0,12,2597000.0
2597,2597999,20.556075069649665,36.65415900775014,0.0864710819762241,372.46594858169556,165.79354691505432,395.59095764160156,9923,2535,7388,7388,0,12,2598000.0
2598,2598999,20.554087057820393,36.650481411869045,0.08647572062816067,372.67811393737793,165.85709142684937,395.61153411865234,9931,2539,7392,7392,0,12,2599000.0
2599,2599999,20.5517480176375,36.64593673247639,0.08648856025758889,372.81382060050964,165.9208996295929,395.77470779418945,9931,2539,7392,7392,0,12,2600000.0
2600,2600999,20.55024062827493,36.64295871728576,0.08647860707150734,372.93717193603516,165.98378562927246,395.9954719543457,9931,2539,7392,7392,0,12,2601000.0
2601,2601999,20.548731572336063,36.63962298067557,0.08648585101298345,373.0713441371918,166.04673290252686,396.20374298095703,9931,2539,7392,7392,0,12,2602000.0
2602,2602999,20.54779048143742,36.63758136482555,0.08647365155339992,373.1973361968994,166.10909342765808,396.36937713623047,9931,2539,7392,7392,0,12,2603000.0
2603,2603999,20.547055661955262,36.63517291902747,0.08646558299274243,373.3254659175873,166.17200469970703,396.4892921447754,9931,2539,7392,7392,0,12,2604000.0
2604,2604999,20.54708919071062,36.633885278991826,0.08644963402598649,373.4651126861572,166.23452425003052,396.60157775878906,9931,2539,7392,7392,0,12,2605000.0
2605,2605999,20.547717925975345,36.63351556759501,0.08643266752347678,373.60669922828674,166.29719424247742,396.7153663635254,9931,2539,7392,7392,0,12,2606000.0
2606,2606999,20.54773239078936,36.63285823482698,0.08641006822292419,373.73783707618713,166.35981154441833,396.8165702819824,9931,2539,7392,7392,0,12,2607000.0
2607,2607999,20.548421419840093,36.631867377631245,0.08639318517821626,373.87142992019653,166.4220757484436,396.9031791687012,9931,2539,7392,7392,0,12,2608000.0
2608,2608999,20.547100597049138,36.62850416718478,0.08638386804939402,374.0067582130432,166.48515439033508,397.577392578125,9941,2539,7402,7402,0,12,2609000.0
2609,2609999,20.544963247813694,36.62407629946102,0.08639830502957979,374.1224205493927,166.5477113723755,397.9463005065918,9943,2539,7404,7404,0,12,2610000.0
2610,2610999,20.54318161883892,36.62047104023067,0.08640791090492672,374.2679822444916,166.6098084449768,398.0791015625,9945,2540,7405,7405,0,12,2611000.0
2611,2611999,20.540849924375397,36.61541690816821,0.08642291043024042,374.4143793582916,166.67276072502136,398.1235542297363,9947,2541,7406,7406,0,12,2612000.0
2612,2612999,20.53831200288974,36.61098441534715,0.08644480951159672,374.554890871048,166.73577666282654,398.2932586669922,9950,2542,7408,7408,0,12,2613000.0
2613,2613999,20.535464075173596,36.60575689597253,0.08647167476311546,374.7427201271057,166.79911375045776,398.30738830566406,9954,2544,7410,7410,0,12,2614000.0
2614,2614999,20.532531908834166,36.60140289926036,0.08648801258840522,374.9316852092743,166.86307835578918,398.2985382080078,9958,2546,7412,7412,0,12,2615000.0
2615,2615999,20.529667454257947,36.59664302053739,0.08650484313458762,375.09385895729065,166.92756271362305,398.3146553039551,9962,2548,7414,7414,0,12,2616000.0
2616,2616999,20.526798038281513,36.591403219267434,0.08652172264912583,375.2963044643402,166.9917914867401,398.412841796875,9968,2551,7417,7417,0,12,2617000.0
2617,2617999,20.524275803773257,36.587182073382074,0.0865266597676645,375.4807255268097,167.05536246299744,398.46451568603516,9972,2553,7419,7419,0,12,2618000.0
2618,2618999,20.522031295261723,36.58292952460762,0.08651904609244543,375.63281416893005,167.1226441860199,398.70507049560547,9972,2553,7419,7419,0,12,2619000.0
2619,2619999,20.520985086546677,36.58053752962722,0.08650066851909177,375.7597644329071,167.18668341636658,398.93371963500977,9972,2553,7419,7419,0,12,2620000.0
2620,2620999,20.52033914916553,36.57876775836238,0.08648275914074077,375.9126718044281,167.2499406337738,399.01506423950195,9976,2554,7422,7422,0,12,2621000.0
2621,2621999,20.519876493465045,36.57722860648167,0.08647444655990766,376.0348937511444,167.31264066696167,399.1721420288086,9976,2554,7422,7422,0,12,2622000.0
2622,2622999,20.5213707817838,36.5828527453765,0.08643400318141825,376.19003438949585,167.375342130661,399.2694282531738,9978,2555,7423,7423,0,12,2623000.0
2623,2623999,20.521841751672603,36.58256347255705,0.08642466604809229,376.34133195877075,167.43816137313843,399.37701416015625,9978,2555,7423,7423,0,12,2624000.0
2624,2624999,20.522696438214854,36.58272116787431,0.08641865865523968,376.51959800720215,167.50115394592285,399.304386138916,9982,2557,7425,7425,0,12,2625000.0
2625,2625999,20.52315594598506,36.58231736980181,0.08641127262673398,376.6559340953827,167.5641746520996,399.43143463134766,9982,2557,7425,7425,0,12,2626000.0
2626,2626999,20.522803176292182,36.5799803787507,0.08641079580833655,376.8011381626129,167.62762546539307,399.51863861083984,9982,2557,7425,7425,0,12,2627000.0
2627,2627999,20.52144137014198,36.57631228654618,0.08641563763801141,376.9259419441223,167.69034051895142,399.63765716552734,9982,2557,7425,7425,0,12,2628000.0
2628,2628999,20.518594469671697,36.57107840137297,0.08642615046643887,377.07077383995056,167.75390076637268,400.21800231933594,10000,2558,7442,7442,0,12,2629000.0
2629,2629999,20.51553216387494,36.56791109944643,0.08643000832241399,377.1999292373657,167.81658911705017,400.5328483581543,10000,2558,7442,7442,0,12,2630000.0
2630,2630999,20.51232284069283,36.56282681058574,0.0864413009731625,377.34698152542114,167.87900638580322,400.7231788635254,10001,2558,7443,7443,0,12,2631000.0
2631,2631999,20.509624781762344,36.55835747785896,0.08645412803406538,377.49441742897034,167.94124054908752,400.8175392150879,10003,2559,7444,7444,0,12,2632000.0
2632,2632999,20.50657381644415,36.55340774204702,0.08646751505537986,377.6183707714081,168.00398206710815,400.97021865844727,10003,2559,7444,7444,0,12,2633000.0
2633,2633999,20.503700735666072,36.549289959178246,0.08647773631044509,377.7684905529022,168.06685733795166,401.04938888549805,10005,2560,7445,7445,0,12,2634000.0
2634,2634999,20.50053785680392,36.54474178677441,0.0864842039367354,377.9364514350891,168.13499093055725,401.06277084350586,10007,2561,7446,7446,0,12,2635000.0
2635,2635999,20.49736259378308,36.539545203192546,0.08649729258000172,378.127587556839,168.19824838638306,401.03882217407227,10011,2563,7448,7448,0,12,2636000.0
2636,2636999,20.494677955095696,36.53728981348494,0.08649063655657852,378.30025935173035,168.2612280845642,401.0694999694824,10015,2565,7450,7450,0,12,2637000.0
2637,2637999,20.49204650655484,36.53303471492209,0.08649534606406162,378.42558240890503,168.32512426376343,401.2768249511719,10015,2565,7450,7450,0,12,2638000.0
2638,2638999,20.489146129675785,36.52834160704363,0.08649882813351262,378.5570955276489,168.38765144348145,401.4235191345215,10015,2565,7450,7450,0,12,2639000.0
2639,2639999,20.486648843787375,36.525359242744,0.08649315816016656,378.7129726409912,168.4506630897522,401.44254302978516,10017,2566,7451,7451,0,12,2640000.0
2640,2640999,20.48464248001841,36.521376123116795,0.08648459293649813,378.8764498233795,168.5140426158905,401.5921859741211,10019,2567,7452,7452,0,12,2641000.0
2641,2641999,20.482991870446494,36.51827584151618,0.08647012822950906,378.99874210357666,168.5767104625702,401.7464141845703,10019,2567,7452,7452,0,12,2642000.0
2642,2642999,20.481952968533,36.515998118929545,0.08645182278721619,379.13891792297363,168.63933444023132,401.8862075805664,10019,2567,7452,7452,0,12,2643000.0
2643,2643999,20.481093010330913,36.51338059271816,0.08643901805242127,379.2911922931671,168.7020299434662,401.9465217590332,10021,2568,7453,7453,0,12,2644000.0
2644,2644999,20.48053949627401,36.51146934454619,0.08642431644931514,379.44264674186707,168.76464462280273,402.05979919433594,10021,2568,7453,7453,0,12,2645000.0
2645,2645999,20.48214383868402,36.512858252072675,0.0863858256383635,379.5636866092682,168.82684183120728,402.1392364501953,10021,2568,7453,7453,0,12,2646000.0
2646,2646999,20.48292010738599,36.5120688190304,0.0863712226162835,379.713086605072,168.889310836792,402.2287406921387,10021,2568,7453,7453,0,12,2647000.0
2647,2647999,20.484235315621,36.513459442191085,0.08635660101951281,379.84780955314636,168.95697808265686,402.30033111572266,10021,2568,7453,7453,0,12,2648000.0
2648,2648999,20.484220996449487,36.513311067856904,0.08634379346949261,379.986745595932,169.0194330215454,402.38525772094727,10021,2568,7453,7453,0,12,2649000.0
2649,2649999,20.48125691346929,36.509481080255895,0.08634876264862079,380.1260266304016,169.09035801887512,403.0592041015625,10033,2568,7465,7465,0,12,2650000.0
2650,2650999,20.477744960212792,36.50506445914317,0.08635737661104204,380.2495858669281,169.1522717475891,403.36612701416016,10033,2568,7465,7465,0,12,2651000.0
2651,2651999,20.474377567477806,36.50029113722392,0.08636780472261851,380.4039969444275,169.21480107307434,403.4484634399414,10035,2569,7466,7466,0,12,2652000.0
2652,2652999,20.471529042911975,36.49651924842189,0.08636600269890926,380.55267691612244,169.27674007415771,403.58380126953125,10037,2570,7467,7467,0,12,2653000.0
2653,2653999,20.46871143617015,36.493000402252335,0.08637146127615924,380.75347208976746,169.34339308738708,403.56879806518555,10041,2572,7469,7469,0,12,2654000.0
2654,2654999,20.466206504959047,36.489950815117986,0.0863714819949778,380.87676334381104,169.40567183494568,403.7471733093262,10041,2572,7469,7469,0,12,2655000.0
2655,2655999,20.463856010627616,36.48636535294055,0.0863699618561048,381.01803255081177,169.46770405769348,403.87363052368164,10041,2572,7469,7469,0,12,2656000.0
2656,2656999,20.461641070606678,36.48247293269183,0.08637467086069184,381.21924090385437,169.530371427536,403.67831802368164,10046,2575,7471,7471,0,12,2657000.0
2657,2657999,20.46025519946954,36.48029936547247,0.08635192763893429,381.4043505191803,169.6006212234497,403.81493759155273,10050,2577,7473,7473,0,12,2658000.0
2658,2658999,20.459430608591877,36.47924020558003,0.08632661176977707,381.52839374542236,169.66322207450867,403.99267959594727,10050,2577,7473,7473,0,12,2659000.0
2659,2659999,20.460755529624336,36.48250891685859,0.08625979010968743,381.6971230506897,169.7258095741272,404.0942840576172,10052,2578,7474,7474,0,12,2660000.0
2660,2660999,20.46322289255166,36.4875513108234,0.08617581615386571,381.8773624897003,169.788800239563,404.09138107299805,10058,2580,7478,7478,0,12,2661000.0
2661,2661999,20.466075208138076,36.49362227473724,0.08610076040670922,382.0779688358307,169.85337734222412,403.9741897583008,10064,2583,7481,7481,0,12,2662000.0
2662,2662999,20.47061365268221,36.50683149791841,0.08601915090291923,382.2556116580963,169.91645431518555,403.97435760498047,10068,2585,7483,7483,0,12,2663000.0
2663,2663999,20.47613122619482,36.52338319857747,0.08595403616939745,382.37965846061707,169.97924613952637,404.165225982666,10068,2585,7483,7483,0,12,2664000.0
2664,2664999,20.481721523273496,36.53686473579604,0.08589983870154716,382.5645191669464,170.0420572757721,404.083683013916,10072,2587,7485,7485,0,12,2665000.0
2665,2665999,20.486105389042272,36.542439538704066,0.08592141917693052,382.769748210907,170.1069405078888,404.1117286682129,10078,2590,7488,7488,0,12,2666000.0
2666,2666999,20.492799038297775,36.55442512304409,0.0859351058739638,382.9577114582062,170.17025327682495,404.1438331604004,10082,2592,7490,7490,0,12,2667000.0
2667,2667999,20.496877569869113,36.559100090398545,0.08594863055899438,383.0755887031555,170.23315262794495,404.3609046936035,10082,2592,7490,7490,0,12,2668000.0
2668,2668999,20.50039082216307,36.56487966525348,0.08592081389455575,383.2085075378418,170.296528339386,404.52198028564453,10082,2592,7490,7490,0,12,2669000.0
2669,2669999,20.49846712562356,36.56468689419848,0.08589242998106017,383.33423256874084,170.35939407348633,405.2627487182617,10096,2592,7504,7504,0,12,2670000.0
2670,2670999,20.49649739679634,36.56494714633349,0.08586650947228824,383.44688415527344,170.42148995399475,405.56909561157227,10096,2592,7504,7504,0,12,2671000.0
2671,2671999,20.493649253568424,36.56106635002365,0.08587290800737013,383.6177570819855,170.48422479629517,405.66111755371094,10098,2593,7505,7505,0,12,2672000.0
2672,2672999,20.490907984093816,36.557817916182145,0.08586860905335814,383.76483702659607,170.55428886413574,405.8220405578613,10098,2593,7505,7505,0,12,2673000.0
2673,2673999,20.488428384243754,36.554435622831534,0.08586756117642014,383.90948271751404,170.61659717559814,405.92126083374023,10100,2594,7506,7506,0,12,2674000.0
2674,2674999,20.485601896327257,36.550119944865166,0.0858733719851813,384.0445351600647,170.67867255210876,406.04151916503906,10100,2594,7506,7506,0,12,2675000.0
2675,2675999,20.482828217963096,36.54554454248462,0.08587305914392918,384.20267486572266,170.74133205413818,406.1137008666992,10103,2595,7508,7508,0,12,2676000.0
2676,2676999,20.48095430258125,36.54309962878972,0.08587334962890814,384.3820466995239,170.80546832084656,406.1320457458496,10107,2597,7510,7510,0,12,2677000.0
2677,2677999,20.47885556319974,36.540273639467465,0.08587019942950713,384.5703139305115,170.86836862564087,406.12495040893555,10111,2599,7512,7512,0,12,2678000.0
2678,2678999,20.477389751051174,36.54027451111179,0.08584546815087024,384.7338435649872,170.93285584449768,406.13689041137695,10113,2600,7513,7513,0,12,2679000.0
2679,2679999,20.478134963051577,36.54767478758738,0.08577976245359065,384.8773138523102,170.995276927948,406.2365837097168,10115,2601,7514,7514,0,12,2680000.0
2680,2680999,20.480694201542363,36.557552047201376,0.08572837034177372,385.00259804725647,171.05770111083984,406.37795639038086,10115,2601,7514,7514,0,12,2681000.0
2681,2681999,20.484140630887666,36.567005207258546,0.08567004188093152,385.17477011680603,171.1206772327423,406.4018249511719,10117,2602,7515,7515,0,12,2682000.0
2682,2682999,20.490379196047837,36.5857956566587,0.08562228343826406,385.3431806564331,171.1833815574646,406.4061813354492,10133,2604,7529,7529,0,12,2683000.0
2683,2683999,20.495797141824845,36.5997831654262,0.08562704406915167,385.47865629196167,171.24618554115295,406.5300064086914,10133,2604,7529,7529,0,12,2684000.0
2684,2684999,20.502143980389967,36.61389574665536,0.08570214495253126,385.64435482025146,171.308979511261,406.55728912353516,10135,2605,7530,7530,0,12,2685000.0
2685,2685999,20.509997168527377,36.630685446146316,0.08575868219512828,385.813348531723,171.37207221984863,406.5475959777832,10139,2607,7532,7532,0,12,2686000.0
2686,2686999,20.518025286577426,36.64722370986594,0.08583245993088684,385.96682143211365,171.43499636650085,406.6340789794922,10141,2608,7533,7533,0,12,2687000.0
2687,2687999,20.52474390328546,36.66214586188105,0.0858769023335324,386.129585981369,171.49849247932434,406.70002365112305,10143,2609,7534,7534,0,12,2688000.0
2688,2688999,20.53073880992688,36.674097567086726,0.08593687583112763,386.3342423439026,171.56205248832703,406.565372467041,10149,2612,7537,7537,0,12,2689000.0
2689,2689999,20.53185882117347,36.67441238911236,0.08592343700485405,386.46905994415283,171.62646055221558,407.1054916381836,10162,2612,7550,7550,0,12,2690000.0
2690,2690999,20.530266611299812,36.67544119125733,0.08589964217471446,386.6142876148224,171.6883955001831,407.3785095214844,10162,2612,7550,7550,0,12,2691000.0
2691,2691999,20.528100195601123,36.671619147982845,0.08589110986124282,386.72912883758545,171.75003361701965,407.57147216796875,10163,2612,7551,7551,0,12,2692000.0
2692,2692999,20.526047587928236,36.66866316797563,0.0858841276895429,386.9047996997833,171.81234622001648,407.46356201171875,10168,2614,7554,7554,0,12,2693000.0
2693,2693999,20.52365644561154,36.664944800324044,0.08587737647955995,387.0489273071289,171.87557649612427,407.58911895751953,10170,2615,7555,7555,0,12,2694000.0
2694,2694999,20.52103555816407,36.660950100336514,0.08587321844080464,387.24272441864014,171.93823909759521,407.5476531982422,10175,2617,7558,7558,0,12,2695000.0
2695,2695999,20.519092337590518,36.65905070720765,0.08585995393189394,387.35728931427,172.0002317428589,407.7297554016113,10175,2617,7558,7558,0,12,2696000.0
2696,2696999,20.516783278327434,36.6551945422601,0.08585392397847291,387.49830985069275,172.06270027160645,407.8344039916992,10175,2617,7558,7558,0,12,2697000.0
2697,2697999,20.514201142099253,36.65066612263376,0.08585374251475109,387.7503447532654,172.1260221004486,407.65220642089844,10183,2621,7562,7562,0,12,2698000.0
2698,2698999,20.511791394750386,36.646403656983196,0.08585027359774322,387.9103000164032,172.19024443626404,407.8323402404785,10185,2622,7563,7563,0,12,2699000.0
2699,2699999,20.509687793157724,36.644009204429736,0.085842078952995,388.02355909347534,172.25231194496155,407.9761428833008,10185,2622,7563,7563,0,12,2700000.0
2700,2700999,20.50832982815342,36.64121658727654,0.0858063131936675,388.1699140071869,172.31506896018982,408.0811424255371,10185,2622,7563,7563,0,12,2701000.0
2701,2701999,20.507314939235208,36.638444378582854,0.08576053625896474,388.3128046989441,172.3778223991394,408.1500015258789,10185,2622,7563,7563,0,12,2702000.0
2702,2702999,20.506602126156245,36.635548705771946,0.08572877824594272,388.428005695343,172.4397542476654,408.2447814941406,10186,2622,7564,7564,0,12,2703000.0
2703,2703999,20.50680217198387,36.6383802871256,0.08566349975465137,388.5651397705078,172.50194668769836,408.3165092468262,10186,2622,7564,7564,0,12,2704000.0
2704,2704999,20.506318282075625,36.63623504396515,0.08563336402942134,388.73657274246216,172.56440043449402,408.33534240722656,10188,2623,7565,7565,0,12,2705000.0
2705,2705999,20.505451797751338,36.63314175066102,0.08561123838192863,388.86191868782043,172.6261694431305,408.3961715698242,10188,2623,7565,7565,0,12,2706000.0
2706,2706999,20.505142992306105,36.63065068627828,0.08559162350601968,388.98631858825684,172.68896532058716,408.47201919555664,10188,2623,7565,7565,0,12,2707000.0
2707,2707999,20.50485789385361,36.62913140343925,0.08556967361197665,389.1905941963196,172.7530951499939,408.38754653930664,10192,2625,7567,7567,0,12,2708000.0
2708,2708999,20.50381796685715,36.62597586451057,0.08555843086459558,389.3096516132355,172.81548738479614,408.4657287597656,10192,2625,7567,7567,0,12,2709000.0
2709,2709999,20.502290771397078,36.62245989127391,0.0855471082923559,389.4475350379944,172.87759017944336,408.5359992980957,10192,2625,7567,7567,0,12,2710000.0
2710,2710999,20.500292627715293,36.61820323171543,0.08553590658009169,389.60225772857666,172.9406349658966,409.0369338989258,10206,2625,7581,7581,0,12,2711000.0
2711,2711999,20.4976408655864,36.61383381661201,0.08554212046837728,389.7463290691376,173.00415420532227,409.34726333618164,10207,2625,7582,7582,0,12,2712000.0
2712,2712999,20.49470805298326,36.60868881086993,0.08554780720334254,389.8584637641907,173.0658938884735,409.5442237854004,10207,2625,7582,7582,0,12,2713000.0
2713,2713999,20.492371002403146,36.604306172922634,0.08555014105865577,389.97851514816284,173.12829494476318,409.6662368774414,10207,2625,7582,7582,0,12,2714000.0
2714,2714999,20.48993933278133,36.600471682568525,0.08554998442625339,390.2094020843506,173.19155192375183,409.4043388366699,10217,2629,7588,7588,0,12,2715000.0
2715,2715999,20.48718056108935,36.59586842083004,0.08555415641847353,390.3690092563629,173.2554030418396,409.5074882507324,10219,2630,7589,7589,0,12,2716000.0
2716,2716999,20.48497191679931,36.59358377580675,0.0855481484264603,390.49992990493774,173.31886982917786,409.70884704589844,10219,2630,7589,7589,0,12,2717000.0
2717,2717999,20.483121619581944,36.59010021866959,0.08554339679614986,390.63422870635986,173.38168621063232,409.82961654663086,10219,2630,7589,7589,0,12,2718000.0
2718,2718999,20.481405329138905,36.58709084578454,0.08553730043458985,390.8592429161072,173.44515347480774,409.6781768798828,10227,2634,7593,7593,0,12,2719000.0
2719,2719999,20.479497820360603,36.58365412445157,0.08553398108421872,391.0107433795929,173.5080463886261,409.87114334106445,10229,2635,7594,7594,0,12,2720000.0
2720,2720999,20.47778066977976,36.58018020366572,0.08553010760022017,391.148149728775,173.5717327594757,409.98200607299805,10229,2635,7594,7594,0,12,2721000.0
2721,2721999,20.47711784491175,36.578060850023846,0.08552296197643772,391.2904713153839,173.63426208496094,410.0810356140137,10231,2636,7595,7595,0,12,2722000.0
2722,2722999,20.476602982744385,36.57727589963794,0.08551763929830059,391.4260632991791,173.6972532272339,410.19902420043945,10231,2636,7595,7595,0,12,2723000.0
2723,2723999,20.47663923833625,36.576079613735786,0.08551374932393829,391.5987648963928,173.76050543785095,410.2913703918457,10245,2637,7608,7608,0,12,2724000.0
2724,2724999,20.476814569068953,36.575345098922504,0.08550836179900845,391.7251102924347,173.82344675064087,410.53762435913086,10246,2637,7609,7609,0,12,2725000.0
2725,2725999,20.477249628074212,36.57473026171945,0.08550364248478703,391.8662545681,173.88626313209534,410.70324325561523,10246,2637,7609,7609,0,12,2726000.0
2726,2726999,20.477749710290738,36.574497393762016,0.08550554013996214,392.02122950553894,173.94927716255188,410.78478622436523,10248,2638,7610,7610,0,12,2727000.0
2727,2727999,20.478485128198823,36.57468410098377,0.08549424467827849,392.172890663147,174.0122938156128,410.8640556335449,10251,2639,7612,7612,0,12,2728000.0
2728,2728999,20.47976851969498,36.575879316814344,0.08548921461097936,392.30990195274353,174.07496166229248,410.9799613952637,10251,2639,7612,7612,0,12,2729000.0
2729,2729999,20.480796896006876,36.57611598073613,0.08547716369624814,392.4741725921631,174.1432728767395,410.9707221984863,10253,2640,7613,7613,0,12,2730000.0
2730,2730999,20.480888273115667,36.575397150081926,0.0854627430733168,392.60299849510193,174.20668005943298,411.1031188964844,10253,2640,7613,7613,0,12,2731000.0
2731,2731999,20.47960184034438,36.57301095473378,0.0854603744452892,392.76485538482666,174.27000546455383,411.5098991394043,10269,2641,7628,7628,0,12,2732000.0
2732,2732999,20.477086414407687,36.569522892569836,0.08546619215896045,392.8807740211487,174.33234572410583,411.84885025024414,10271,2641,7630,7630,0,12,2733000.0
2733,2733999,20.474918927314167,36.568061711577336,0.08546567344759537,393.0388195514679,174.39511823654175,411.89856719970703,10274,2642,7632,7632,0,12,2734000.0
2734,2734999,20.472159774999618,36.56341946656402,0.08548353920416796,393.16163969039917,174.45761108398438,412.07069396972656,10274,2642,7632,7632,0,12,2735000.0
2735,2735999,20.469735250347163,36.55949433885159,0.08549219532803365,393.2811324596405,174.52015328407288,412.1925811767578,10274,2642,7632,7632,0,12,2736000.0
2736,2736999,20.46747591704422,36.556276600148514,0.08549721174883784,393.43621349334717,174.58335304260254,412.2507629394531,10276,2643,7633,7633,0,12,2737000.0
2737,2737999,20.465504241004098,36.5531420966143,0.08550186523595982,393.6386022567749,174.64677333831787,412.29490661621094,10310,2645,7665,7665,0,12,2738000.0
2738,2738999,20.46319987697475,36.549794126591195,0.0855036861341889,393.7809422016144,174.70956683158875,412.40198516845703,10310,2645,7665,7665,0,12,2739000.0
2739,2739999,20.461356969324385,36.54676517616309,0.08550411934096125,394.0148048400879,174.77294993400574,412.3182601928711,10319,2649,7670,7670,0,12,2740000.0
2740,2740999,20.459576696737614,36.54336639468782,0.08550005474958933,394.1703495979309,174.83599734306335,412.3891716003418,10321,2650,7671,7671,0,12,2741000.0
2741,2741999,20.458071017842627,36.54021628993201,0.08549618510125834,394.30474400520325,174.8985080718994,412.5010795593262,10321,2650,7671,7671,0,12,2742000.0
2742,2742999,20.456303425483718,36.53779935854149,0.08549155044017753,394.4764292240143,174.9617955684662,412.51459884643555,10334,2652,7682,7682,0,12,2743000.0
2743,2743999,20.455234429740468,36.53620527710459,0.08548180997483323,394.6062867641449,175.02439069747925,412.6585350036621,10335,2652,7683,7683,0,12,2744000.0
2744,2744999,20.453522711073497,36.53283029791217,0.08549412753165841,394.770033121109,175.08701419830322,412.6460151672363,10348,2653,7695,7695,0,12,2745000.0
2745,2745999,20.452635381688715,36.53119742424978,0.08549055843482234,394.92787528038025,175.1510467529297,412.88684844970703,10350,2654,7696,7696,0,12,2746000.0
2746,2746999,20.451213173317782,36.527672566889244,0.08550079492320695,395.0920600891113,175.21429562568665,412.9711227416992,10352,2655,7697,7697,0,12,2747000.0
2747,2747999,20.449642748045697,36.5240299477001,0.08551159862873192,395.2778367996216,175.27828979492188,413.01983642578125,10356,2657,7699,7699,0,12,2748000.0
2748,2748999,20.447821898397457,36.520280088884476,0.08552804461504315,395.3958189487457,175.34188055992126,413.20472717285156,10357,2657,7700,7700,0,12,2749000.0
2749,2749999,20.445192830420194,36.51639245887283,0.08554389339885726,395.5381097793579,175.4052219390869,413.8851013183594,10372,2657,7715,7715,0,12,2750000.0
2750,2750999,20.442027275279422,36.51193182479846,0.08556647628882796,395.65504479408264,175.46846842765808,414.3256645202637,10375,2657,7718,7718,0,12,2751000.0
2751,2751999,20.438720661165853,36.50663970085907,0.08560407446466345,395.80179238319397,175.53150010108948,414.56090545654297,10379,2658,7721,7721,0,12,2752000.0
2752,2752999,20.435633628790637,36.50224932716586,0.08562883366723772,395.91738748550415,175.59376335144043,414.73498916625977,10379,2658,7721,7721,0,12,2753000.0
2753,2753999,20.432823334426313,36.49809510826709,0.08565488890933148,396.030149936676,175.65692281723022,414.93689727783203,10380,2658,7722,7722,0,12,2754000.0
2754,2754999,20.429971391471586,36.493767601625756,0.08567449428511942,396.1903645992279,175.7198362350464,414.993953704834,10382,2659,7723,7723,0,12,2755000.0
2755,2755999,20.427232509568757,36.49009045912609,0.08568225261611784,396.3421263694763,175.78296422958374,415.0985641479492,10384,2660,7724,7724,0,12,2756000.0
2756,2756999,20.424688708244414,36.48642510508669,0.08568472359877133,396.6131896972656,175.84743118286133,414.97462463378906,10395,2665,7730,7730,0,12,2757000.0
2757,2757999,20.422361530865544,36.482820860767404,0.08568379765238177,398.415265083313,175.91246795654297,414.9902534484863,10406,2670,7736,7736,0,12,2758000.0
2758,2758999,20.42020938550871,36.47920335606095,0.08567795339642148,398.56553387641907,175.97620511054993,415.1114044189453,10408,2671,7737,7737,0,12,2759000.0
2759,2759999,20.419303788072877,36.48413031617292,0.08562370104709871,398.7192270755768,176.04012870788574,415.2415084838867,10410,2672,7738,7738,0,12,2760000.0
2760,2760999,20.417853088311542,36.48121997064722,0.08560792401717987,398.838440656662,176.10410690307617,415.3782844543457,10410,2672,7738,7738,0,12,2761000.0
2761,2761999,20.417301064098496,36.478996878774694,0.08557684925972575,398.9863603115082,176.16764044761658,415.5249137878418,10411,2672,7739,7739,0,12,2762000.0
2762,2762999,20.417018020722963,36.47702177259601,0.08554293687776604,399.12689089775085,176.23108339309692,415.57300186157227,10413,2673,7740,7740,0,12,2763000.0
2763,2763999,20.418012018610472,36.477269668125494,0.08550880541723982,399.30376863479614,176.29474472999573,415.62192153930664,10415,2674,7741,7741,0,12,2764000.0
2764,2764999,20.417890657252155,36.47582669726494,0.08549142220248929,399.46392011642456,176.3591856956482,415.69358825683594,10417,2675,7742,7742,0,12,2765000.0
2765,2765999,20.418120922785416,36.47496993323182,0.08547199641819314,399.6254105567932,176.42422747612,415.7681427001953,10422,2676,7746,7746,0,12,2766000.0
2766,2766999,20.4183464514664,36.47388959970574,0.08545075768785282,399.7952642440796,176.48816466331482,415.8182029724121,10426,2677,7749,7749,0,12,2767000.0
2767,2767999,20.418268591184404,36.47192131237166,0.08542579197088529,399.9292914867401,176.55180859565735,415.8847351074219,10426,2677,7749,7749,0,12,2768000.0
2768,2768999,20.417631109534273,36.46920972195409,0.08541411100156515,400.06599164009094,176.61540007591248,415.9863052368164,10426,2677,7749,7749,0,12,2769000.0
2769,2769999,20.415565631423814,36.46603712186185,0.0854071815500298,400.1855103969574,176.6792426109314,416.6261978149414,10439,2677,7762,7762,0,12,2770000.0
2770,2770999,20.412263931034637,36.461058931306205,0.08542639136477082,400.3526213169098,176.74268412590027,416.89036560058594,10442,2678,7764,7764,0,12,2771000.0
2771,2771999,20.4092230050773,36.456782606544806,0.08543708895666224,400.53127789497375,176.80584406852722,417.0091133117676,10448,2680,7768,7768,0,12,2772000.0
2772,2772999,20.406006766669044,36.452890636483886,0.08545041656449315,400.65459513664246,176.86866426467896,417.25016021728516,10448,2680,7768,7768,0,12,2773000.0
2773,2773999,20.40322854850958,36.44943051702386,0.08545618154749446,400.86134243011475,176.94042587280273,417.3084831237793,10454,2683,7771,7771,0,12,2774000.0
2774,2774999,20.400074875982696,36.445104788519814,0.08546701398256473,401.0255825519562,177.00394773483276,417.4385643005371,10456,2684,7772,7772,0,12,2775000.0
2775,2775999,20.397103046595007,36.44027931127306,0.08548095179825033,401.16310024261475,177.06722903251648,417.6211814880371,10456,2684,7772,7772,0,12,2776000.0
2776,2776999,20.39391471512513,36.435312892556496,0.08549287234199643,401.2919330596924,177.13177609443665,417.7397575378418,10456,2684,7772,7772,0,12,2777000.0
2777,2777999,20.39121079595607,36.431014321789284,0.08549597902316197,401.53591537475586,177.1962432861328,417.5101089477539,10465,2688,7777,7777,0,12,2778000.0
2778,2778999,20.388534881418057,36.426417831310886,0.08550398434514184,401.67083859443665,177.2599811553955,417.73299407958984,10465,2688,7777,7777,0,12,2779000.0
2779,2779999,20.385908070711512,36.421898190496236,0.08550317395207352,401.841379404068,177.3243179321289,417.8069534301758,10467,2689,7778,7778,0,12,2780000.0
2780,2780999,20.38403585596033,36.419000365528596,0.08549181920140636,401.9726502895355,177.38784527778625,417.90066146850586,10467,2689,7778,7778,0,12,2781000.0
2781,2781999,20.381903141567808,36.41504423392474,0.08549262394900303,402.1029760837555,177.4511091709137,417.974853515625,10467,2689,7778,7778,0,12,2782000.0
2782,2782999,20.38047265694334,36.41211150690438,0.08547183421002136,402.2411584854126,177.51428079605103,418.06764221191406,10468,2689,7779,7779,0,12,2783000.0
2783,2783999,20.378896418378133,36.40858067964897,0.08545899219701725,402.36607027053833,177.5772726535797,418.15139389038086,10468,2689,7779,7779,0,12,2784000.0
2784,2784999,20.377298442531504,36.40511012178655,0.08544870380960645,402.5433473587036,177.64201068878174,418.1706314086914,10470,2690,7780,7780,0,12,2785000.0
2785,2785999,20.37598943314012,36.402378437370956,0.08543715442475419,402.71127486228943,177.7052721977234,418.0721664428711,10473,2691,7782,7782,0,12,2786000.0
2786,2786999,20.374455917958517,36.39876959544438,0.08543445698400876,402.8702359199524,177.76837253570557,418.0859184265137,10475,2692,7783,7783,0,12,2787000.0
2787,2787999,20.372921752110052,36.397396355863975,0.08541769266442167,402.9914984703064,177.83144688606262,418.1914596557617,10475,2692,7783,7783,0,12,2788000.0
2788,2788999,20.37107840507231,36.39402291722001,0.08541146931201826,403.1307759284973,177.8952658176422,418.26110458374023,10475,2692,7783,7783,0,12,2789000.0
2789,2789999,20.36854706210227,36.389769899726716,0.08541777802549277,403.27196645736694,177.9588224887848,418.34142303466797,10475,2692,7783,7783,0,12,2790000.0
2790,2790999,20.367900683090266,36.39347519383692,0.08540060254407911,403.4025151729584,178.02298402786255,419.0303764343262,10492,2692,7800,7800,0,12,2791000.0
2791,2791999,20.36794603241771,36.39415362679247,0.08540126236351098,403.5713748931885,178.08753418922424,419.26609802246094,10498,2694,7804,7804,0,12,2792000.0
2792,2792999,20.366460381381884,36.39258884293979,0.08541917963885559,403.70810079574585,178.1502401828766,419.48520278930664,10500,2695,7805,7805,0,12,2793000.0
2793,2793999,20.3652781102291,36.39229623575977,0.08541463730265364,403.8417327404022,178.21306586265564,419.72085189819336,10500,2695,7805,7805,0,12,2794000.0
2794,2794999,20.36359257827292,36.3907942969895,0.08543028266448716,404.0999343395233,178.27841591835022,419.5935173034668,10511,2700,7811,7811,0,12,2795000.0
2795,2795999,20.363020771864214,36.39252441925548,0.0854389367569448,404.2513954639435,178.34218549728394,419.8391876220703,10513,2701,7812,7812,0,12,2796000.0
2796,2796999,20.361392515697368,36.39049165980136,0.08543877980775194,404.40006017684937,178.4057855606079,419.979305267334,10515,2702,7813,7813,0,12,2797000.0
2797,2797999,20.360320414380727,36.38982298546818,0.08547221695585061,404.60413098335266,178.46941018104553,420.01763916015625,10522,2705,7817,7817,0,12,2798000.0
2798,2798999,20.35965355712755,36.3887762709064,0.08552023714988422,404.8421950340271,178.53553295135498,419.9759407043457,10530,2709,7821,7821,0,12,2799000.0
2799,2799999,20.359558778576996,36.39448380033375,0.08546729812217146,405.0074164867401,178.59937691688538,420.0307388305664,10532,2710,7822,7822,0,12,2800000.0
2800,2800999,20.35874086653391,36.39246879421321,0.0855171974823229,405.13941621780396,178.66322565078735,420.25311279296875,10533,2710,7823,7823,0,12,2801000.0
2801,2801999,20.358165390779753,36.390850079886505,0.08552362363945454,405.28934144973755,178.72838234901428,420.3099822998047,10535,2711,7824,7824,0,12,2802000.0
2802,2802999,20.358003455039004,36.38988535343738,0.0855530891887919,405.41374468803406,178.79249334335327,420.57613372802734,10538,2711,7827,7827,0,12,2803000.0
2803,2803999,20.357771501480308,36.389218966891,0.08553904489144704,405.5397288799286,178.8556764125824,420.75031661987305,10538,2711,7827,7827,0,12,2804000.0
2804,2804999,20.357185075938933,36.38748479221592,0.08552903787319144,405.72771525382996,178.919673204422,420.74921798706055,10561,2713,7848,7848,0,12,2805000.0
2805,2805999,20.35707339277832,36.38587780051372,0.08552145961023816,405.96428632736206,178.9837884902954,420.6676368713379,10571,2717,7854,7854,0,12,2806000.0
2806,2806999,20.35727929512942,36.38468776435999,0.08551611383589797,406.16799688339233,179.0491337776184,420.7900161743164,10575,2719,7856,7856,0,12,2807000.0
2807,2807999,20.35796925289327,36.39110957498739,0.08548919552589263,406.2843334674835,179.11267018318176,420.94746017456055,10575,2719,7856,7856,0,12,2808000.0
2808,2808999,20.358068848715853,36.38957129092192,0.08547443403141453,406.40715074539185,179.17611122131348,421.08131408691406,10575,2719,7856,7856,0,12,2809000.0
2809,2809999,20.357569692693374,36.387333213471294,0.08547195992849577,406.57788252830505,179.24042654037476,421.1854705810547,10577,2720,7857,7857,0,12,2810000.0
2810,2810999,20.356116886061603,36.383573368389925,0.0854604805625101,406.713515996933,179.30410742759705,421.49795150756836,10586,2720,7866,7866,0,12,2811000.0
2811,2811999,20.352928456839503,36.37919049981947,0.08547565715568972,406.8365216255188,179.36864113807678,422.26813888549805,10597,2720,7877,7877,0,12,2812000.0
2812,2812999,20.349668896197947,36.37485803151847,0.08549408121452062,406.9846770763397,179.43171787261963,422.4791450500488,10600,2721,7879,7879,0,12,2813000.0
2813,2813999,20.346530271431394,36.370714788646225,0.08551200146425197,407.1364824771881,179.4950144290924,422.6924285888672,10602,2722,7880,7880,0,12,2814000.0
2814,2814999,20.34343354164211,36.36609195202073,0.08552810307500569,407.36624455451965,179.56003427505493,422.6469078063965,10611,2726,7885,7885,0,12,2815000.0
2815,2815999,20.34053985829577,36.3615935433243,0.08554141584113262,407.4854485988617,179.622882604599,422.8942642211914,10611,2726,7885,7885,0,12,2816000.0
2816,2816999,20.338026446766747,36.35840481248372,0.08554294156576192,407.6306166648865,179.68756008148193,422.9576835632324,10613,2727,7886,7886,0,12,2817000.0
2817,2817999,20.33563103791538,36.35492207783807,0.08553843729443122,407.86834955215454,179.75233125686646,422.8847427368164,10622,2731,7891,7891,0,12,2818000.0
2818,2818999,20.333163787387853,36.35100672137355,0.08553515656086352,408.0794336795807,179.81702375411987,422.9374122619629,10628,2734,7894,7894,0,12,2819000.0
2819,2819999,20.33067109598488,36.34660591988932,0.08552980962305334,408.2940351963043,179.88197231292725,422.9629135131836,10635,2737,7898,7898,0,12,2820000.0
2820,2820999,20.328462574876827,36.34246963125012,0.08552329528662994,408.4279189109802,179.94626760482788,423.22129821777344,10635,2737,7898,7898,0,12,2821000.0
2821,2821999,20.326983691522575,36.33992205261609,0.08548738550191204,408.5618453025818,180.01272773742676,423.44565200805664,10636,2737,7899,7899,0,12,2822000.0
2822,2822999,20.32694922637123,36.3474693545695,0.08540429485726919,408.71454310417175,180.07701420783997,423.5326690673828,10638,2738,7900,7900,0,12,2823000.0
2823,2823999,20.327675732822975,36.34851001556706,0.08533732215243761,408.8432867527008,180.1408486366272,423.74471282958984,10639,2738,7901,7901,0,12,2824000.0
2824,2824999,20.328674134320007,36.34941473206047,0.08527743714903502,409.00443482398987,180.20461916923523,423.84438705444336,10643,2739,7904,7904,0,12,2825000.0
2825,2825999,20.330363657409144,36.35196462208746,0.08523080300851049,409.17283630371094,180.27143788337708,423.9441909790039,10645,2740,7905,7905,0,12,2826000.0
2826,2826999,20.3316572260512,36.35296719287984,0.0851922114477609,409.30509400367737,180.33480501174927,424.11401748657227,10645,2740,7905,7905,0,12,2827000.0
2827,2827999,20.332462376988513,36.35212462655105,0.08515404319185582,409.4798493385315,180.39886832237244,424.16053009033203,10647,2741,7906,7906,0,12,2828000.0
2828,2828999,20.3345431353113,36.353968928018986,0.08513862898377977,409.6481566429138,180.4632785320282,424.2002487182617,10649,2742,7907,7907,0,12,2829000.0
2829,2829999,20.335752534660667,36.35411217411523,0.08512167545267257,409.7869505882263,180.526859998703,424.2783393859863,10652,2743,7909,7909,0,12,2830000.0
2830,2830999,20.336350148294283,36.35288722537607,0.0850902158262411,409.9230041503906,180.5907120704651,424.39267349243164,10652,2743,7909,7909,0,12,2831000.0
2831,2831999,20.335784426683233,36.35045964230348,0.08506711856128524,410.09779715538025,180.6570246219635,424.79984283447266,10667,2744,7923,7923,0,12,2832000.0
2832,2832999,20.333847723282844,36.3480806372886,0.0850387714984866,410.21399331092834,180.7193582057953,425.27914810180664,10671,2744,7927,7927,0,12,2833000.0
2833,2833999,20.33152263453246,36.345193748661764,0.08503543357734777,410.3356921672821,180.7815330028534,425.54652404785156,10672,2744,7928,7928,0,12,2834000.0
2834,2834999,20.32874639130611,36.34040706686333,0.0850450023058088,410.4861032962799,180.84366655349731,425.6296806335449,10674,2745,7929,7929,0,12,2835000.0
2835,2835999,20.326804617166196,36.3368183168921,0.08504539160590652,410.68301367759705,180.90660309791565,425.6805191040039,10681,2748,7933,7933,0,12,2836000.0
2836,2836999,20.325220405361293,36.33476261921948,0.08503454901500218,410.8384189605713,180.97051095962524,425.78394317626953,10683,2749,7934,7934,0,12,2837000.0
2837,2837999,20.324020996179406,36.33365709091,0.08501734308254771,411.007004737854,181.03305983543396,425.89022064208984,10686,2750,7936,7936,0,12,2838000.0
2838,2838999,20.32350230202191,36.33374980963912,0.08498835473824784,411.12927627563477,181.0955412387848,426.0238380432129,10686,2750,7936,7936,0,12,2839000.0
2839,2839999,20.323556395961425,36.336242995296786,0.08494829618523314,411.3796920776367,181.15883708000183,425.8714408874512,10696,2755,7941,7941,0,12,2840000.0
2840,2840999,20.32414089436735,36.33910795329634,0.0849121049887831,411.5400595664978,181.2244462966919,426.0790481567383,10698,2756,7942,7942,0,12,2841000.0
2841,2841999,20.32514940928504,36.34242521978265,0.0849078386896599,411.69503116607666,181.28820896148682,426.1486511230469,10701,2757,7944,7944,0,12,2842000.0
2842,2842999,20.3275184559678,36.3495638228885,0.08488193267594524,411.82981872558594,181.351135969162,426.3247489929199,10702,2757,7945,7945,0,12,2843000.0
2843,2843999,20.33198943972102,36.36579961932939,0.08485248483951258,411.97532534599304,181.41431427001953,426.43877029418945,10702,2757,7945,7945,0,12,2844000.0
2844,2844999,20.335471838880515,36.37374442657506,0.08488311952685612,412.13484168052673,181.47789883613586,426.5825843811035,10708,2758,7950,7950,0,12,2845000.0
2845,2845999,20.340103779927023,36.38606427499459,0.08498006822865845,412.26133394241333,181.54265141487122,426.73852157592773,10708,2758,7950,7950,0,12,2846000.0
2846,2846999,20.344386305539405,36.39594272956644,0.08510317087294583,412.4743106365204,181.6063597202301,426.7223815917969,10717,2762,7955,7955,0,12,2847000.0
2847,2847999,20.349275813331328,36.40811897820157,0.08523804160033244,412.61383986473083,181.66951417922974,426.8947296142578,10717,2762,7955,7955,0,12,2848000.0
2848,2848999,20.353922403817606,36.41769235326223,0.08542993774664931,412.8074514865875,181.7343008518219,426.90820693969727,10721,2764,7957,7957,0,12,2849000.0
2849,2849999,20.357711330630107,36.42428287545557,0.08553810612772728,412.9923040866852,181.799959897995,426.9519500732422,10725,2766,7959,7959,0,12,2850000.0
2850,2850999,20.36201650855575,36.43229070922651,0.08571232728851852,413.16478419303894,181.86400842666626,427.01839447021484,10731,2768,7963,7963,0,12,2851000.0
2851,2851999,20.364694868298553,36.43600681095055,0.08576901274126025,413.32407236099243,181.92744779586792,427.06072998046875,10734,2769,7965,7965,0,12,2852000.0
2852,2852999,20.363963064790127,36.43388251985355,0.08574816660442652,413.4902777671814,181.99141931533813,427.7817192077637,10755,2770,7985,7985,0,12,2853000.0
2853,2853999,20.362099905951187,36.43094944220083,0.08574192108728751,413.5991761684418,182.0539333820343,428.13798904418945,10756,2770,7986,7986,0,12,2854000.0
2854,2854999,20.35978695145867,36.4266843439085,0.08574224030111621,413.7253215312958,182.1164357662201,428.3495407104492,10756,2770,7986,7986,0,12,2855000.0
2855,2855999,20.359092634106933,36.42997204768245,0.08570325119293876,413.91305327415466,182.17907810211182,428.4128723144531,10760,2772,7988,7988,0,12,2856000.0
2856,2856999,20.357241192306255,36.42663956126109,0.08569830837101522,414.0868046283722,182.2423164844513,428.48918533325195,10765,2774,7991,7991,0,12,2857000.0
2857,2857999,20.355878121007244,36.42397118468928,0.08568375650514604,414.262788772583,182.3049774169922,428.51789474487305,10770,2776,7994,7994,0,12,2858000.0
2858,2858999,20.353965400188635,36.42016839800115,0.0856770358927853,414.38563203811646,182.36855101585388,428.6910209655762,10770,2776,7994,7994,0,12,2859000.0
2859,2859999,20.352631845958754,36.41823652076287,0.08566364745449406,414.5197899341583,182.43191766738892,428.83638763427734,10770,2776,7994,7994,0,12,2860000.0
2860,2860999,20.351995440352642,36.41737635931376,0.08563777043211962,414.7332065105438,182.49518513679504,428.70724868774414,10777,2779,7998,7998,0,12,2861000.0
2861,2861999,20.351247896506298,36.41529987217045,0.08562055346642217,414.88699102401733,182.55857729911804,428.80292892456055,10781,2780,8001,8001,0,12,2862000.0
2862,2862999,20.350321274947145,36.41323081980192,0.08560741190307386,415.04159283638,182.62148642539978,428.82775115966797,10785,2781,8004,8004,0,12,2863000.0
2863,2863999,20.35035220179177,36.41313226293412,0.08556890587879673,415.22201108932495,182.68609762191772,428.75598526000977,10789,2783,8006,8006,0,12,2864000.0
2864,2864999,20.350240637616132,36.41152643337974,0.08555103141211151,415.37326073646545,182.7494659423828,428.8404312133789,10792,2784,8008,8008,0,12,2865000.0
2865,2865999,20.350279983909985,36.41122794530765,0.08552438449333344,415.50206184387207,182.81234216690063,428.97850799560547,10793,2784,8009,8009,0,12,2866000.0
2866,2866999,20.350670787610216,36.41060986456033,0.08550212671671742,415.66613602638245,182.87550854682922,429.0421829223633,10796,2785,8011,8011,0,12,2867000.0
2867,2867999,20.350829774383385,36.41096318621179,0.08548533472538777,415.78540420532227,182.93855142593384,429.1872673034668,10796,2785,8011,8011,0,12,2868000.0
2868,2868999,20.351106529564507,36.41012026609176,0.08547156613268869,415.95845890045166,183.0019338130951,429.2267761230469,10798,2786,8012,8012,0,12,2869000.0
2869,2869999,20.351771965079738,36.40979016118182,0.08545249196805471,416.1240475177765,183.06511855125427,429.2744026184082,10801,2787,8014,8014,0,12,2870000.0
2870,2870999,20.351904043029695,36.408161648348276,0.08544488436480224,416.2439618110657,183.12801146507263,429.3843078613281,10801,2787,8014,8014,0,12,2871000.0
2871,2871999,20.352077397410056,36.40659726116,0.08543116299830489,416.4366581439972,183.19164323806763,429.30067443847656,10807,2789,8018,8018,0,12,2872000.0
2872,2872999,20.351411970951453,36.40373526735966,0.08542752304228174,416.60328102111816,183.25551676750183,429.34194564819336,10809,2790,8019,8019,0,12,2873000.0
2873,2873999,20.34946176356958,36.399670593605926,0.0854230855475413,416.7460434436798,183.31992030143738,429.88909912109375,10825,2791,8034,8034,0,12,2874000.0
2874,2874999,20.346492908143038,36.39546662323992,0.08543600849332789,416.93315076828003,183.38362836837769,430.11548233032227,10835,2793,8042,8042,0,12,2875000.0
2875,2875999,20.343817669419735,36.3931509284326,0.08543915961359971,417.04834508895874,183.44606065750122,430.37068939208984,10836,2793,8043,8043,0,12,2876000.0
2876,2876999,20.34122595230511,36.389499296463015,0.08544948368941718,417.1856880187988,183.50893664360046,430.57969665527344,10837,2793,8044,8044,0,12,2877000.0
2877,2877999,20.338426609527172,36.385039623631044,0.08546478458354245,417.3354606628418,183.57153344154358,430.70773696899414,10839,2794,8045,8045,0,12,2878000.0
2878,2878999,20.33591215907765,36.3815931955852,0.08547051842721398,417.4549129009247,183.63415455818176,430.84614181518555,10839,2794,8045,8045,0,12,2879000.0
2879,2879999,20.333525689844315,36.37770367777413,0.0854750155709828,417.6337115764618,183.69760131835938,430.78328704833984,10845,2796,8049,8049,0,12,2880000.0
2880,2880999,20.331551281106716,36.37467706539947,0.08546848051944456,417.7585084438324,183.76127457618713,430.9733200073242,10845,2796,8049,8049,0,12,2881000.0
2881,2881999,20.32992900440528,36.37203003815168,0.085452854782057,418.011093378067,183.82608580589294,430.90798568725586,10853,2800,8053,8053,0,12,2882000.0
2882,2882999,20.329105865634677,36.37083710689834,0.08542359678342781,418.1426613330841,183.89009165763855,431.0833625793457,10853,2800,8053,8053,0,12,2883000.0
2883,2883999,20.329014480712274,36.3699136164346,0.0853826018773185,418.2790193557739,183.95303320884705,431.2295608520508,10853,2800,8053,8053,0,12,2884000.0
2884,2884999,20.329376793189954,36.37072715654944,0.08534155504276397,418.4575786590576,184.01657915115356,431.25067138671875,10859,2802,8057,8057,0,12,2885000.0
2885,2885999,20.32981505165805,36.37014226228671,0.08532829288653698,418.61201453208923,184.08102226257324,431.3399467468262,10862,2803,8059,8059,0,12,2886000.0
2886,2886999,20.33071885306279,36.371098702401014,0.08530593364646388,418.75141882896423,184.144061088562,431.4051399230957,10864,2804,8060,8060,0,12,2887000.0
2887,2887999,20.331816739244577,36.37163480454693,0.08529349350360371,418.95691561698914,184.20750999450684,431.3820495605469,10871,2807,8064,8064,0,12,2888000.0
2888,2888999,20.332768043960687,36.37145892506682,0.08527231077539654,419.1359827518463,184.27128219604492,431.4132843017578,10878,2809,8069,8069,0,12,2889000.0
2889,2889999,20.33302143935242,36.370173363578125,0.0852613381707995,419.30208230018616,184.33592247962952,431.5219497680664,10881,2810,8071,8071,0,12,2890000.0
2890,2890999,20.332701086812577,36.367711082843094,0.08525268641189587,419.4540021419525,184.4004716873169,431.6317710876465,10883,2811,8072,8072,0,12,2891000.0
2891,2891999,20.331584957139363,36.36987311106145,0.08519378615866857,419.6055762767792,184.46500492095947,432.528751373291,10907,2812,8095,8095,0,12,2892000.0
2892,2892999,20.32924848905179,36.36699447440632,0.08520887683499434,419.72335410118103,184.52766299247742,432.9413948059082,10909,2812,8097,8097,0,12,2893000.0
2893,2893999,20.32686116048714,36.362630809473686,0.08523780267943015,419.8668839931488,184.5913393497467,433.1571235656738,10909,2812,8097,8097,0,12,2894000.0
2894,2894999,20.325573857528628,36.36112087192213,0.08524058134606483,420.02726650238037,184.6541941165924,433.3426971435547,10914,2814,8100,8100,0,12,2895000.0
2895,2895999,20.32360441440743,36.3580805852042,0.08525109077529536,420.1450312137604,184.71755838394165,433.6067810058594,10914,2814,8100,8100,0,12,2896000.0
2896,2896999,20.32156381037046,36.3548555891678,0.0852606137319003,420.2884223461151,184.78109669685364,433.72325897216797,10916,2815,8101,8101,0,12,2897000.0
2897,2897999,20.319363574880033,36.350899122012684,0.08527689421977735,420.44171476364136,184.84416484832764,433.82759857177734,10919,2816,8103,8103,0,12,2898000.0
2898,2898999,20.317448110583463,36.347598119915716,0.08528302757422868,420.6777467727661,184.90843868255615,433.73165130615234,10929,2820,8109,8109,0,12,2899000.0
2899,2899999,20.315774031464386,36.34491710166449,0.0852891572753447,420.90597653388977,184.97285771369934,433.7598304748535,10937,2824,8113,8113,0,12,2900000.0
2900,2900999,20.314655341619897,36.34286268168867,0.08529007815918066,421.04014229774475,185.03646636009216,433.98594665527344,10937,2824,8113,8113,0,12,2901000.0
2901,2901999,20.313445844505868,36.340217871325805,0.08528673392252206,421.1772041320801,185.09956312179565,434.1798667907715,10941,2825,8116,8116,0,12,2902000.0
2902,2902999,20.31285791522033,36.33838338886478,0.0852803996865843,421.3079082965851,185.16246581077576,434.35218048095703,10941,2825,8116,8116,0,12,2903000.0
2903,2903999,20.31267064854662,36.34007247846705,0.08525461341704976,421.477578163147,185.22563910484314,434.46073150634766,10943,2826,8117,8117,0,12,2904000.0
2904,2904999,20.31260009025539,36.338509313778644,0.08523986958406182,421.6317620277405,185.28984904289246,434.51290130615234,10945,2827,8118,8118,0,12,2905000.0
2905,2905999,20.312680239640418,36.33756607694405,0.08522617832048351,421.78390407562256,185.35340356826782,434.5396919250488,10948,2828,8120,8120,0,12,2906000.0
2906,2906999,20.3129047155377,36.33736949553531,0.08520166534708318,421.9530928134918,185.41732788085938,434.58182525634766,10950,2829,8121,8121,0,12,2907000.0
2907,2907999,20.312356297735207,36.33741543645195,0.08517410108796708,422.14193320274353,185.4809217453003,434.7015190124512,10954,2831,8123,8123,0,12,2908000.0
2908,2908999,20.309731466117015,36.332925170283694,0.08519660118568129,422.26259422302246,185.5450587272644,435.4626922607422,10969,2831,8138,8138,0,12,2909000.0
2909,2909999,20.307182694747503,36.330399372404955,0.08521916375402572,422.3786931037903,185.60850429534912,435.8872833251953,10973,2831,8142,8142,0,12,2910000.0
2910,2910999,20.304698680782437,36.327226703452105,0.08525351260306535,422.502788066864,185.67101097106934,436.08997344970703,10973,2831,8142,8142,0,12,2911000.0
2911,2911999,20.3022576246388,36.324347987198614,0.08527958859707963,422.67839527130127,185.73501801490784,436.17987060546875,10977,2832,8145,8145,0,12,2912000.0
2912,2912999,20.299232097658624,36.32020991881347,0.08532057284079342,422.79577469825745,185.79748129844666,436.3107261657715,10977,2832,8145,8145,0,12,2913000.0
2913,2913999,20.296386799355933,36.316417718721645,0.08534394720054361,422.96715116500854,185.86033749580383,436.3364143371582,10985,2834,8151,8151,0,12,2914000.0
2914,2914999,20.293714049616053,36.31284811176676,0.08536245318813218,423.1408715248108,185.92433309555054,436.2564888000488,10989,2836,8153,8153,0,12,2915000.0
2915,2915999,20.29226420093503,36.31276202061332,0.0853533647288579,423.43432450294495,185.98966479301453,436.12738037109375,11001,2842,8159,8159,0,12,2916000.0
2916,2916999,20.29129569208524,36.312842094096034,0.08535956172423298,423.5631308555603,186.05333018302917,436.4084243774414,11001,2842,8159,8159,0,12,2917000.0
2917,2917999,20.290368596704184,36.31339539046001,0.0853591727780505,423.7518332004547,186.1189045906067,436.43001556396484,11007,2844,8163,8163,0,12,2918000.0
2918,2918999,20.290374555567663,36.31448937816386,0.08535877874162501,423.94090127944946,186.18278169631958,436.4688720703125,11012,2846,8166,8166,0,12,2919000.0
2919,2919999,20.290000800911525,36.31428162682803,0.08534946596114323,424.09007811546326,186.24645113945007,436.6845588684082,11017,2847,8170,8170,0,12,2920000.0
2920,2920999,20.28991476269984,36.31442270062061,0.08535333609084605,424.2080008983612,186.31005597114563,436.91422271728516,11017,2847,8170,8170,0,12,2921000.0
2921,2921999,20.289764111116654,36.31390782483884,0.08533885731841695,424.38604283332825,186.37419772148132,436.98177337646484,11021,2848,8173,8173,0,12,2922000.0
2922,2922999,20.289697059438847,36.31343509289505,0.08533012602900014,424.62671184539795,186.43872380256653,436.96816635131836,11029,2852,8177,8177,0,12,2923000.0
2923,2923999,20.28993263642754,36.315742357783705,0.0853088212154679,424.75235629081726,186.50246620178223,437.19982528686523,11029,2852,8177,8177,0,12,2924000.0
2924,2924999,20.290359749440462,36.315329609842344,0.08530774902606075,424.9064509868622,186.56674885749817,437.26060485839844,11031,2853,8178,8178,0,12,2925000.0
2925,2925999,20.289628272943705,36.31273177717337,0.08529567907248259,425.0491187572479,186.63042664527893,437.3638496398926,11034,2854,8180,8180,0,12,2926000.0
2926,2926999,20.288990137186634,36.31071097158907,0.0852782193641467,425.1838233470917,186.694806098938,437.5010643005371,11034,2854,8180,8180,0,12,2927000.0
2927,2927999,20.287154495098836,36.30731684283947,0.08527139304041953,425.3808526992798,186.75934267044067,437.5682792663574,11046,2856,8190,8190,0,12,2928000.0
2928,2928999,20.284342383014174,36.303277995637764,0.08528514551442401,425.5055248737335,186.8231978416443,438.57643127441406,11063,2856,8207,8207,0,12,2929000.0
2929,2929999,20.28093599030376,36.29906178276539,0.08530338183234021,425.6179828643799,186.8859589099884,438.93935775756836,11063,2856,8207,8207,0,12,2930000.0
2930,2930999,20.277560370257216,36.29421309036118,0.0853244523683383,425.7841658592224,186.94955444335938,439.0748062133789,11067,2858,8209,8209,0,12,2931000.0
2931,2931999,20.274432099635693,36.290254151681815,0.08534398420127165,425.91534972190857,187.0127875804901,439.32463455200195,11067,2858,8209,8209,0,12,2932000.0
2932,2932999,20.271715622810813,36.285960154094546,0.08535304145558409,426.1433434486389,187.077308177948,439.32978439331055,11075,2862,8213,8213,0,12,2933000.0
2933,2933999,20.269186451684757,36.28172248165331,0.08536441651166848,426.25217294692993,187.1401927471161,439.57472229003906,11075,2862,8213,8213,0,12,2934000.0
2934,2934999,20.266905941166304,36.27826840464465,0.08536480757437703,426.4686875343323,187.2041473388672,439.5719451904297,11081,2865,8216,8216,0,12,2935000.0
2935,2935999,20.26437825160612,36.27416981886505,0.0853700424473598,426.67375564575195,187.26931977272034,439.61229705810547,11087,2868,8219,8219,0,12,2936000.0
2936,2936999,20.26235478427256,36.27147509954922,0.08536296034956692,426.848513841629,187.33350896835327,439.73722076416016,11091,2870,8221,8221,0,12,2937000.0
2937,2937999,20.261013979065396,36.27111529934761,0.08534774372524034,426.9902546405792,187.3971688747406,439.9325294494629,11091,2870,8221,8221,0,12,2938000.0
2938,2938999,20.261039597502204,36.27380072002699,0.0853033007746703,427.13773012161255,187.4608256816864,440.07398223876953,11094,2871,8223,8223,0,12,2939000.0
2939,2939999,20.261465800919595,36.28383813285275,0.08524332712241134,427.2522819042206,187.5247097015381,440.2211608886719,11094,2871,8223,8223,0,12,2940000.0
2940,2940999,20.262885977469782,36.29041381822258,0.08518659980555698,427.41777658462524,187.58827352523804,440.4167175292969,11099,2872,8227,8227,0,12,2941000.0
2941,2941999,20.263700823997567,36.29359390035858,0.08520192664154147,427.56212401390076,187.6515531539917,440.5976219177246,11101,2873,8228,8228,0,12,2942000.0
2942,2942999,20.263657881695185,36.29401434304835,0.08521800215042485,427.76290011405945,187.71569681167603,440.58528900146484,11107,2876,8231,8231,0,12,2943000.0
2943,2943999,20.26483097606894,36.296234986786615,0.08521005784759683,428.00876688957214,187.78040266036987,440.5946464538574,11116,2880,8236,8236,0,12,2944000.0
2944,2944999,20.265298468612688,36.29688911452201,0.08520000302892439,428.1606366634369,187.8445131778717,440.79841232299805,11118,2881,8237,8237,0,12,2945000.0
2945,2945999,20.26677190615558,36.29986640149331,0.08520303758662118,428.31459307670593,187.90905714035034,440.9328842163086,11121,2882,8239,8239,0,12,2946000.0
2946,2946999,20.2662463757367,36.29880391295109,0.0852248963449872,428.48251247406006,187.97317695617676,441.0462646484375,11123,2883,8240,8240,0,12,2947000.0
2947,2947999,20.265523434457826,36.29716942476508,0.08526517957580404,428.62625670433044,188.03702521324158,441.1470260620117,11126,2884,8242,8242,0,12,2948000.0
2948,2948999,20.26478704411638,36.299266441034234,0.08525995934498432,428.7537839412689,188.10127878189087,441.8759422302246,11147,2884,8263,8263,0,12,2949000.0
2949,2949999,20.2622698439202,36.298187495114135,0.08526603897857665,428.8686809539795,188.1639895439148,442.44969940185547,11148,2884,8264,8264,0,12,2950000.0
2950,2950999,20.26002303935454,36.29701777245071,0.08526211104823389,428.9899265766144,188.22704601287842,442.76560974121094,11148,2884,8264,8264,0,12,2951000.0
2951,2951999,20.258536635589266,36.29637183936209,0.0852555939778572,429.13322162628174,188.28973412513733,442.9165153503418,11150,2885,8265,8265,0,12,2952000.0
2952,2952999,20.258037340026185,36.29815770892143,0.08523605821451063,429.3138065338135,188.35253167152405,442.98746490478516,11154,2887,8267,8267,0,12,2953000.0
2953,2953999,20.258867438568615,36.30129979254209,0.0852350335736689,429.45992040634155,188.41644310951233,443.2429847717285,11156,2888,8268,8268,0,12,2954000.0
2954,2954999,20.258811838131848,36.30185237076526,0.08524689826507059,429.65777015686035,188.47999548912048,443.20506286621094,11162,2891,8271,8271,0,12,2955000.0
2955,2955999,20.258757143018553,36.30240484496458,0.08524631607298538,429.8351240158081,188.54362416267395,443.3794288635254,11166,2893,8273,8273,0,12,2956000.0
2956,2956999,20.258813819994227,36.30794416058219,0.08526586314863793,430.042053937912,188.6076934337616,443.4417152404785,11172,2896,8276,8276,0,12,2957000.0
2957,2957999,20.258369715397446,36.306930992094614,0.08530615314027634,430.23201870918274,188.67161965370178,443.54614639282227,11178,2898,8280,8280,0,12,2958000.0
2958,2958999,20.2579594750299,36.30586327687728,0.08535026913235355,430.3810839653015,188.73554706573486,443.6944122314453,11180,2899,8281,8281,0,12,2959000.0
2959,2959999,20.257541509376843,36.30431204592849,0.08534834546553227,430.53368878364563,188.8001470565796,443.91386795043945,11183,2900,8283,8283,0,12,2960000.0
2960,2960999,20.258166922727863,36.30460981048513,0.08534642086203836,430.651433467865,188.8641574382782,444.1399383544922,11185,2900,8285,8285,0,12,2961000.0
2961,2961999,20.259391656765448,36.308820623914215,0.08533143827805345,430.77863693237305,188.92775440216064,444.28636169433594,11185,2900,8285,8285,0,12,2962000.0
2962,2962999,20.260180542122196,36.30883492798039,0.08534593447910055,430.97251200675964,188.99210333824158,444.2480697631836,11191,2902,8289,8289,0,12,2963000.0
2963,2963999,20.261764793756665,36.310283919125474,0.08538142773199164,431.0966258049011,189.0555877685547,444.4410743713379,11191,2902,8289,8289,0,12,2964000.0
2964,2964999,20.263077374600158,36.3111370006268,0.08542172318574637,431.3275547027588,189.1207001209259,444.45621490478516,11199,2905,8294,8294,0,12,2965000.0
2965,2965999,20.265179465993054,36.312989597626434,0.08544973124382482,431.4576106071472,189.18442463874817,444.5984420776367,11199,2905,8294,8294,0,12,2966000.0
2966,2966999,20.266391476302218,36.31315227186238,0.08548316443671267,431.6115183830261,189.24799942970276,444.6454048156738,11202,2906,8296,8296,0,12,2967000.0
2967,2967999,20.267094358637642,36.311948838210206,0.08550514608377147,431.7488169670105,189.3121461868286,444.76057052612305,11202,2906,8296,8296,0,12,2968000.0
2968,2968999,20.266730005902723,36.30986739761369,0.08551827538575596,431.9206540584564,189.37623524665833,444.8054618835449,11204,2907,8297,8297,0,12,2969000.0
2969,2969999,20.264358482644113,36.30553376787975,0.08553143606852709,432.0330958366394,189.43963146209717,445.6656723022461,11224,2907,8317,8317,0,12,2970000.0
2970,2970999,20.26178625811879,36.302700274701024,0.08553479558932786,432.14689540863037,189.50220322608948,446.0367774963379,11224,2907,8317,8317,0,12,2971000.0
2971,2971999,20.259345001968125,36.29942836825678,0.08554402132904793,432.32514929771423,189.5643928050995,446.0995101928711,11229,2909,8320,8320,0,12,2972000.0
2972,2972999,20.257227559273705,36.298685665307694,0.08553571977439722,432.56319880485535,189.62836003303528,446.088436126709,11241,2913,8328,8328,0,12,2973000.0
2973,2973999,20.254750319186982,36.29560574422853,0.08553825683100458,432.7182240486145,189.69092440605164,446.24964904785156,11245,2914,8331,8331,0,12,2974000.0
2974,2974999,20.252507421617324,36.29837883532783,0.08551659502166808,432.88702416419983,189.75391626358032,446.39054107666016,11249,2916,8333,8333,0,12,2975000.0
2975,2975999,20.2499836247442,36.29466343866884,0.08551862583973746,433.08691239356995,189.81732845306396,446.42572021484375,11257,2919,8338,8338,0,12,2976000.0
2976,2976999,20.247469799402577,36.290687210840694,0.08552326246163444,433.2707986831665,189.88212180137634,446.53804779052734,11261,2921,8340,8340,0,12,2977000.0
2977,2977999,20.245244653022297,36.28699315730068,0.08552435197104635,433.51800537109375,189.94570660591125,446.4275550842285,11270,2925,8345,8345,0,12,2978000.0
2978,2978999,20.243568164298143,36.28454725696835,0.0855142807849153,433.6402316093445,190.00865197181702,446.7587699890137,11270,2925,8345,8345,0,12,2979000.0
2979,2979999,20.24226884421831,36.28266880320923,0.08549190445356292,433.7873477935791,190.0730538368225,446.96204376220703,11274,2926,8348,8348,0,12,2980000.0
2980,2980999,20.24180349813498,36.281995714047696,0.08546418957458757,433.9575695991516,190.13670086860657,447.07885360717773,11278,2928,8350,8350,0,12,2981000.0
2981,2981999,20.24177646865441,36.28212655465659,0.08543085268238715,434.08156538009644,190.20086765289307,447.40563201904297,11281,2928,8353,8353,0,12,2982000.0
2982,2982999,20.242446738461314,36.28296661461626,0.08539438811243494,434.2068235874176,190.2642481327057,447.6486282348633,11281,2928,8353,8353,0,12,2983000.0
2983,2983999,20.243210457358032,36.28327181644836,0.08536257554771898,434.4094533920288,190.32821226119995,447.59325408935547,11289,2931,8358,8358,0,12,2984000.0
2984,2984999,20.24453856296533,36.28457460822659,0.08533766588181324,434.6034393310547,190.39260983467102,447.72265625,11293,2933,8360,8360,0,12,2985000.0
2985,2985999,20.24670458661608,36.287717967117885,0.08530905802935129,434.79630637168884,190.45794415473938,447.8105354309082,11300,2936,8364,8364,0,12,2986000.0
2986,2986999,20.247877593586193,36.28838458137309,0.08533708588011368,434.9552254676819,190.52236247062683,448.0122375488281,11322,2937,8385,8385,0,12,2987000.0
2987,2987999,20.250018787823084,36.291061480214616,0.08533282066013759,435.0883152484894,190.58680248260498,448.2079315185547,11322,2937,8385,8385,0,12,2988000.0
2988,2988999,20.25294433025824,36.29668521787713,0.08534039129964743,435.2368700504303,190.65087246894836,448.35499572753906,11322,2937,8385,8385,0,12,2989000.0
2989,2989999,20.254054774338407,36.299901945550694,0.08532422466165768,435.3705861568451,190.7148356437683,448.5805435180664,11322,2937,8385,8385,0,12,2990000.0
2990,2990999,20.25245722942588,36.2996210422702,0.08530402911832746,435.52610206604004,190.78688263893127,449.24123764038086,11336,2938,8398,8398,0,12,2991000.0
2991,2991999,20.250514258756972,36.29921897991251,0.08528840140668092,435.6509790420532,190.84631609916687,449.5434379577637,11337,2938,8399,8399,0,12,2992000.0
2992,2992999,20.24793259099151,36.29499338496282,0.08529688830781834,435.78724813461304,190.90568113327026,449.7464485168457,11340,2938,8402,8402,0,12,2993000.0
2993,2993999,20.24563166626476,36.29218699870728,0.08529716566681744,435.92199444770813,190.96506094932556,449.8895835876465,11341,2938,8403,8403,0,12,2994000.0
2994,2994999,20.243597812660905,36.28992073853795,0.08528644231877558,436.09061074256897,191.02460408210754,449.9853096008301,11343,2939,8404,8404,0,12,2995000.0
2995,2995999,20.241344457288026,36.286038448466506,0.08529025315193806,436.2524576187134,191.08496952056885,450.4954719543457,11361,2940,8421,8421,0,12,2996000.0
2996,2996999,20.239737089832705,36.28331668967295,0.08528445621133551,436.35797119140625,191.14536452293396,450.9081840515137,11362,2940,8422,8422,0,12,2997000.0
2997,2997999,20.237956973735365,36.280071240021236,0.08527921903718072,436.5013177394867,191.20621013641357,451.1589698791504,11365,2941,8424,8424,0,12,2998000.0
2998,2998999,20.236198685087373,36.276912397003,0.08527494500188948,436.6552288532257,191.2676181793213,451.3370552062988,11367,2942,8425,8425,0,12,2999000.0
2999,2999999,20.235164153816573,36.274721570259786,0.08525928920935977,436.78534746170044,191.32817101478577,451.55432510375977,11367,2942,8425,8425,0,12,3000000.0
3000,3000999,20.23453391406946,36.27334570313083,0.08523351147322755,436.93514370918274,191.3889513015747,451.60742950439453,11369,2943,8426,8426,0,12,3001000.0
3001,3001999,20.233759972143268,36.2711809850411,0.08521069480734189,437.0661880970001,191.4500138759613,451.7424621582031,11369,2943,8426,8426,0,12,3002000.0
3002,3002999,20.23355514457434,36.27126515643415,0.08517781915140543,437.18732810020447,191.5103166103363,451.8726463317871,11369,2943,8426,8426,0,12,3003000.0
3003,3003999,20.234797625215307,36.27460037227575,0.08512299897415387,437.31483459472656,191.5702519416809,451.98172760009766,11369,2943,8426,8426,0,12,3004000.0
3004,3004999,20.23758037011261,36.281616627667596,0.08505737006480674,437.4438548088074,191.63042402267456,452.1076126098633,11369,2943,8426,8426,0,12,3005000.0
3005,3005999,20.241782614119046,36.29332047903539,0.08498036477142656,437.5782346725464,191.69071197509766,452.2353401184082,11369,2943,8426,8426,0,12,3006000.0
3006,3006999,20.247100902682284,36.304788156307225,0.08488901699340767,437.73715448379517,191.75105786323547,452.25080490112305,11371,2944,8427,8427,0,12,3007000.0
3007,3007999,20.253612371263472,36.31945589856286,0.08483207993128161,437.868013381958,191.81110668182373,452.3472023010254,11371,2944,8427,8427,0,12,3008000.0
3008,3008999,20.260744746373604,36.336899654941995,0.08481945704118288,438.0473618507385,191.87195491790771,452.349063873291,11375,2946,8429,8429,0,12,3009000.0
3009,3009999,20.26775769724086,36.3490760786225,0.08482443461688338,438.2097692489624,191.93234133720398,452.3769187927246,11377,2947,8430,8430,0,12,3010000.0
3010,3010999,20.27106770410232,36.35399622540949,0.08485058030690629,438.36236453056335,191.99383878707886,452.56314849853516,11379,2948,8431,8431,0,12,3011000.0
3011,3011999,20.27213771380903,36.35786910854399,0.0847546252929462,438.4821403026581,192.05487394332886,453.073673248291,11388,2948,8440,8440,0,12,3012000.0
3012,3012999,20.272103028270553,36.357509180022745,0.08471789151137499,438.63133573532104,192.11543154716492,453.3054428100586,11389,2948,8441,8441,0,12,3013000.0
3013,3013999,20.272185899848,36.355864284530945,0.08468970082961336,438.7500960826874,192.1750144958496,453.4342041015625,11389,2948,8441,8441,0,12,3014000.0
3014,3014999,20.27170638093134,36.35432151202288,0.0846582433885944,438.87063121795654,192.23462200164795,453.519962310791,11389,2948,8441,8441,0,12,3015000.0
3015,3015999,20.271489610825682,36.353791319000244,0.0846235197880808,438.9937090873718,192.2944140434265,453.6105842590332,11389,2948,8441,8441,0,12,3016000.0
3016,3016999,20.270565687912264,36.351424319178435,0.08460342745582028,439.1639974117279,192.3549988269806,453.6357192993164,11391,2949,8442,8442,0,12,3017000.0
3017,3017999,20.27006232822988,36.34887996957542,0.08457922952929897,439.316531419754,192.41527438163757,453.65424728393555,11393,2950,8443,8443,0,12,3018000.0
3018,3018999,20.2693421839193,36.346227659635886,0.08456849446576764,439.55732560157776,192.47602343559265,453.5014533996582,11401,2954,8447,8447,0,12,3019000.0
3019,3019999,20.268398802931458,36.343292465987865,0.08455272718225548,439.6837589740753,192.53638100624084,453.67842864990234,11401,2954,8447,8447,0,12,3020000.0
3020,3020999,20.267776490868915,36.34060077394869,0.08454260524598012,439.8205237388611,192.59700417518616,453.78113174438477,11401,2954,8447,8447,0,12,3021000.0
3021,3021999,20.267594523593164,36.33896218086303,0.08452081269198386,439.975378036499,192.65738797187805,453.82376861572266,11401,2954,8447,8447,0,12,3022000.0
3022,3022999,20.268177581215987,36.339205356597276,0.08449067947764577,440.1273376941681,192.7179832458496,453.86577224731445,11403,2955,8448,8448,0,12,3023000.0
3023,3023999,20.269702218171854,36.34048608502693,0.08444990474354885,440.2889037132263,192.77839279174805,453.8477592468262,11405,2956,8449,8449,0,12,3024000.0
3024,3024999,20.27043723585697,36.33989003869355,0.08442528981355268,440.4313917160034,192.83889889717102,453.9663772583008,11405,2956,8449,8449,0,12,3025000.0
3025,3025999,20.271437053036458,36.343151856258785,0.08438873673434655,440.55665493011475,192.89977169036865,454.04119873046875,11405,2956,8449,8449,0,12,3026000.0
3026,3026999,20.27216035618445,36.34264079509014,0.08437748164821379,440.73534512519836,192.96053814888,453.96074295043945,11425,2958,8467,8467,0,12,3027000.0
3027,3027999,20.27195288958315,36.34026208713581,0.08436545756787073,440.89116168022156,193.02114510536194,454.0391731262207,11425,2958,8467,8467,0,12,3028000.0
3028,3028999,20.27118313849627,36.337178288522665,0.08435116142624044,441.02160835266113,193.0829417705536,454.2857971191406,11430,2958,8472,8472,0,12,3029000.0
3029,3029999,20.27099544368593,36.33917395935974,0.08432681942032993,441.1487910747528,193.14287948608398,454.5866241455078,11433,2958,8475,8475,0,12,3030000.0
3030,3030999,20.270337928291084,36.33762592021418,0.08432140735947657,441.29792857170105,193.20317435264587,454.7591438293457,11434,2958,8476,8476,0,12,3031000.0
3031,3031999,20.27044278293163,36.338059461180464,0.08431500643263756,441.4421718120575,193.26337122917175,454.8562202453613,11436,2959,8477,8477,0,12,3032000.0
3032,3032999,20.271078986231036,36.33846297670578,0.08429968716224201,441.5553557872772,193.32354831695557,454.9842834472656,11437,2959,8478,8478,0,12,3033000.0
3033,3033999,20.271541667119642,36.33829477751961,0.0842948890314068,441.69875717163086,193.38375973701477,455.0699272155762,11437,2959,8478,8478,0,12,3034000.0
3034,3034999,20.2716121247657,36.33805850383909,0.08428721050538501,441.82521200180054,193.44386649131775,455.131778717041,11437,2959,8478,8478,0,12,3035000.0
3035,3035999,20.272531365604507,36.338566309324655,0.08428429103003832,441.9885756969452,193.50410294532776,455.100154876709,11439,2960,8479,8479,0,12,3036000.0
3036,3036999,20.27320614012929,36.33820141575938,0.08428420585998808,442.14040517807007,193.56478452682495,455.1494331359863,11441,2961,8480,8480,0,12,3037000.0
3037,3037999,20.27438389802344,36.340324465035316,0.08428525021208777,442.2866449356079,193.62511682510376,455.2134208679199,11441,2961,8480,8480,0,12,3038000.0
3038,3038999,20.27664155011336,36.346727731659605,0.0842860591877378,442.50915360450745,193.6864457130432,455.0825958251953,11448,2964,8484,8484,0,12,3039000.0
3039,3039999,20.279080151436155,36.350808383314394,0.08431071687034764,442.6417977809906,193.7471318244934,455.1753845214844,11448,2964,8484,8484,0,12,3040000.0
3040,3040999,20.281130230696863,36.35302407653793,0.08434687985813427,442.76575779914856,193.8077049255371,455.24517822265625,11448,2964,8484,8484,0,12,3041000.0
3041,3041999,20.2844988832847,36.36003323989872,0.08436786845332156,442.90190958976746,193.8682451248169,455.3386001586914,11448,2964,8484,8484,0,12,3042000.0
3042,3042999,20.28921617614666,36.37540685101957,0.08436968303992509,443.02617383003235,193.9286003112793,455.3988723754883,11448,2964,8484,8484,0,12,3043000.0
3043,3043999,20.29319168066267,36.383613288103874,0.08443338205172868,443.2325575351715,193.98958492279053,455.3061065673828,11453,2966,8487,8487,0,12,3044000.0
3044,3044999,20.29682060854356,36.388178456045104,0.08453541349537053,443.3567841053009,194.05044770240784,455.3818702697754,11453,2966,8487,8487,0,12,3045000.0
3045,3045999,20.30081389390822,36.392579663962046,0.08461634946411156,443.53837394714355,194.111590385437,455.32060623168945,11455,2967,8488,8488,0,12,3046000.0
3046,3046999,20.304954434286163,36.397837803447466,0.0847082061640193,443.6508700847626,194.1726245880127,455.379207611084,11455,2967,8488,8488,0,12,3047000.0
3047,3047999,20.30856429262795,36.404437972815074,0.08476773209609056,443.79200768470764,194.23352599143982,455.44300842285156,11455,2967,8488,8488,0,12,3048000.0
3048,3048999,20.308886029899238,36.40334014974157,0.08476535285788211,443.96215772628784,194.29504919052124,455.82587814331055,11466,2968,8498,8498,0,12,3049000.0
3049,3049999,20.308089140841616,36.402722217514004,0.08473051085704242,444.1310987472534,194.3556113243103,456.0387535095215,11470,2969,8501,8501,0,12,3050000.0
3050,3050999,20.30707303006233,36.40203176618447,0.08471285032064857,444.2690055370331,194.41584658622742,456.24339294433594,11473,2970,8503,8503,0,12,3051000.0
3051,3051999,20.306148872574404,36.39981555327678,0.0847014449864314,444.4118392467499,194.47625517845154,456.32734298706055,11475,2971,8504,8504,0,12,3052000.0
3052,3052999,20.30513714493846,36.398485304080005,0.08468805251799849,444.55870151519775,194.53807020187378,456.44315338134766,11477,2972,8505,8505,0,12,3053000.0
3053,3053999,20.30418183221945,36.39580343443497,0.08468134472185507,444.70367908477783,194.59877371788025,456.5134696960449,11479,2973,8506,8506,0,12,3054000.0
3054,3054999,20.30371567760609,36.394200921435115,0.084663207018563,444.8781716823578,194.659526348114,456.5680465698242,11481,2974,8507,8507,0,12,3055000.0
3055,3055999,20.303503897755903,36.392236018770745,0.08465041009342988,445.0401692390442,194.72014164924622,456.6026420593262,11483,2975,8508,8508,0,12,3056000.0
3056,3056999,20.303403323207867,36.39072495462134,0.0846431466265517,445.1839303970337,194.78112626075745,456.74817657470703,11483,2975,8508,8508,0,12,3057000.0
3057,3057999,20.303762029972333,36.39003378115248,0.08463979523320753,445.36954975128174,194.84227800369263,456.7352752685547,11487,2977,8510,8510,0,12,3058000.0
3058,3058999,20.304813338533407,36.39021842919663,0.08464700458594887,445.4897634983063,194.90295672416687,456.85072326660156,11487,2977,8510,8510,0,12,3059000.0
3059,3059999,20.307803737948053,36.39524279323933,0.0846640928794763,445.65685415267944,194.96602702140808,456.8820266723633,11489,2978,8511,8511,0,12,3060000.0
3060,3060999,20.310195480703474,36.3989450164676,0.08469576243108146,445.7791967391968,195.02712678909302,456.982723236084,11489,2978,8511,8511,0,12,3061000.0
3061,3061999,20.312954745206714,36.40315512863252,0.08473397486783418,445.97551465034485,195.088365316391,456.8934020996094,11493,2980,8513,8513,0,12,3062000.0
3062,3062999,20.316644373157384,36.41233140104765,0.08476987925229407,446.0920145511627,195.14969754219055,457.0261535644531,11493,2980,8513,8513,0,12,3063000.0
3063,3063999,20.32179713310132,36.42350499157418,0.08484044249881029,446.22462940216064,195.21059107780457,457.1570472717285,11493,2980,8513,8513,0,12,3064000.0
3064,3064999,20.326379703581555,36.43119456378543,0.08491195688200126,446.40108466148376,195.27187943458557,457.1512222290039,11495,2981,8514,8514,0,12,3065000.0
3065,3065999,20.33019625895736,36.43622604309378,0.08500243909225391,446.58920979499817,195.33367609977722,457.11572265625,11499,2983,8516,8516,0,12,3066000.0
3066,3066999,20.333954679061247,36.44151024787004,0.08507204239257304,446.7860610485077,195.39545607566833,457.0244941711426,11504,2985,8519,8519,0,12,3067000.0
3067,3067999,20.33734995405203,36.444972471058975,0.0851398638521903,446.9117741584778,195.45673441886902,457.1326484680176,11504,2985,8519,8519,0,12,3068000.0
3068,3068999,20.3388463943527,36.445242552647876,0.08515002984439479,447.0325903892517,195.51780080795288,457.3357353210449,11505,2985,8520,8520,0,12,3069000.0
3069,3069999,20.338909594510614,36.44613658635559,0.08509477015769085,447.1537628173828,195.57948565483093,458.0026512145996,11516,2985,8531,8531,0,12,3070000.0
3070,3070999,20.33811867930694,36.44501104350205,0.0850650930051392,447.2710452079773,195.6398527622223,458.2276840209961,11516,2985,8531,8531,0,12,3071000.0
3071,3071999,20.337141459939204,36.44301965128675,0.08504982853544496,447.42125487327576,195.70047974586487,458.33350372314453,11518,2986,8532,8532,0,12,3072000.0
3072,3072999,20.336321767476907,36.44285596236145,0.08501588839965657,447.6342203617096,195.76711082458496,458.34182357788086,11524,2989,8535,8535,0,12,3073000.0
3073,3073999,20.335155588403612,36.43969984128824,0.08499519222981611,447.82502913475037,195.8289544582367,458.38341903686523,11529,2991,8538,8538,0,12,3074000.0
3074,3074999,20.334113975563824,36.439056187982935,0.08497409835896508,447.949914932251,195.89168977737427,458.597713470459,11529,2991,8538,8538,0,12,3075000.0
3075,3075999,20.33321062790341,36.437227893311956,0.08494775645278752,448.0646643638611,195.95262098312378,458.7236557006836,11529,2991,8538,8538,0,12,3076000.0
3076,3076999,20.332444483277623,36.43513177984402,0.08493593942124023,448.2842741012573,196.01449847221375,458.5909843444824,11535,2994,8541,8541,0,12,3077000.0
3077,3077999,20.331604317262503,36.432837330365345,0.08493215711725899,448.4582586288452,196.07656383514404,458.62750244140625,11542,2996,8546,8546,0,12,3078000.0
3078,3078999,20.33137550739604,36.4323010656762,0.08492369859596227,448.62098693847656,196.1382646560669,458.73143768310547,11544,2997,8547,8547,0,12,3079000.0
3079,3079999,20.331403510485707,36.431289717549035,0.08492141488211391,448.76496028900146,196.2013144493103,458.87395095825195,11544,2997,8547,8547,0,12,3080000.0
3080,3080999,20.33181821725163,36.43130927551957,0.08490232120959851,448.9094593524933,196.26259183883667,458.9605903625488,11544,2997,8547,8547,0,12,3081000.0
3081,3081999,20.331831156341003,36.43011620483829,0.0848864857316124,449.0656967163086,196.32412242889404,458.90869522094727,11549,2998,8551,8551,0,12,3082000.0
3082,3082999,20.332647292007245,36.430828803175984,0.08487748634153547,449.1795983314514,196.38524842262268,459.0098686218262,11549,2998,8551,8551,0,12,3083000.0
3083,3083999,20.333189916148875,36.43058739368775,0.08487889136048643,449.34333777427673,196.44699454307556,459.0524787902832,11551,2999,8552,8552,0,12,3084000.0
3084,3084999,20.333611130492347,36.429585203846294,0.08487789251133704,449.4775319099426,196.5091679096222,459.12985610961914,11551,2999,8552,8552,0,12,3085000.0
3085,3085999,20.334558146828773,36.42957192187708,0.08487399547411079,449.6249985694885,196.57082319259644,459.2191467285156,11551,2999,8552,8552,0,12,3086000.0
3086,3086999,20.334998305378683,36.428646155412736,0.0848776292541078,449.7603178024292,196.6333770751953,459.30225372314453,11551,2999,8552,8552,0,12,3087000.0
3087,3087999,20.33495907104645,36.42666950733817,0.08487533897317712,449.898806810379,196.6948127746582,459.3485450744629,11551,2999,8552,8552,0,12,3088000.0
3088,3088999,20.334723932147053,36.4243529042669,0.0848756985988115,450.06314969062805,196.7576460838318,459.3365898132324,11553,3000,8553,8553,0,12,3089000.0
3089,3089999,20.333970235309724,36.421226219330485,0.08485827244962085,450.18531608581543,196.81977152824402,460.0183334350586,11569,3000,8569,8569,0,12,3090000.0
3090,3090999,20.33231353955663,36.418479393504455,0.08483273024349924,450.36590099334717,196.88145112991333,460.179443359375,11581,3002,8579,8579,0,12,3091000.0
3091,3091999,20.330116482290812,36.41514768458064,0.08482921695416523,450.49940395355225,196.94246006011963,460.4426078796387,11583,3003,8580,8580,0,12,3092000.0
3092,3092999,20.32853892687802,36.41395598771522,0.08481535952870967,450.63560795783997,197.00470185279846,460.62924575805664,11585,3004,8581,8581,0,12,3093000.0
3093,3093999,20.32657780399555,36.410677634724806,0.08480930595883729,450.84499645233154,197.06652975082397,460.67944717407227,11591,3007,8584,8584,0,12,3094000.0
3094,3094999,20.324768794575675,36.407872949365995,0.08479462827812911,451.020366191864,197.1282923221588,460.8208656311035,11595,3009,8586,8586,0,12,3095000.0
3095,3095999,20.322609811098857,36.404134611682395,0.0847892880404093,451.1770544052124,197.19037866592407,460.9968147277832,11597,3010,8587,8587,0,12,3096000.0
3096,3096999,20.321419363965695,36.4035244734942,0.08475931038986284,451.29658365249634,197.2527084350586,461.15668869018555,11597,3010,8587,8587,0,12,3097000.0
3097,3097999,20.32029848309115,36.402566455671405,0.08474120759406101,451.5373878479004,197.31502437591553,461.0666198730469,11603,3013,8590,8590,0,12,3098000.0
3098,3098999,20.319359442790276,36.40053584693384,0.08472126444450012,451.68093490600586,197.37668752670288,461.2140769958496,11605,3014,8591,8591,0,12,3099000.0
3099,3099999,20.318495861350613,36.39881359917982,0.08468704927921866,451.8262507915497,197.43856167793274,461.3078498840332,11607,3015,8592,8592,0,12,3100000.0
3100,3100999,20.318479197101663,36.398586324331276,0.08466214086046187,452.00871872901917,197.50256252288818,461.3788719177246,11609,3016,8593,8593,0,12,3101000.0
3101,3101999,20.318896040602258,36.40033459628109,0.08462221822534288,452.15939259529114,197.5647737979889,461.42028427124023,11611,3017,8594,8594,0,12,3102000.0
3102,3102999,20.31949501669632,36.40087074981319,0.08460381607391121,452.29184675216675,197.62790727615356,461.5561828613281,11611,3017,8594,8594,0,12,3103000.0
3103,3103999,20.3199990259734,36.40165607589509,0.08457593429837418,452.4439489841461,197.69007897377014,461.6118469238281,11613,3018,8595,8595,0,12,3104000.0
3104,3104999,20.32019436257306,36.4011837638287,0.08454458971557288,452.59474182128906,197.7527093887329,461.71374893188477,11615,3019,8596,8596,0,12,3105000.0
3105,3105999,20.321346589299182,36.40244326441483,0.08450826123053012,452.73452734947205,197.81469631195068,461.76380920410156,11617,3020,8597,8597,0,12,3106000.0
3106,3106999,20.3221193291775,36.403247509290594,0.08447666352806305,452.8831114768982,197.87685894966125,461.8970031738281,11617,3020,8597,8597,0,12,3107000.0
3107,3107999,20.323669976650528,36.40548364784081,0.08444645862920774,453.1181266307831,197.94670724868774,461.7843246459961,11627,3023,8604,8604,0,12,3108000.0
3108,3108999,20.32494377638897,36.40618411803288,0.08441842327409077,453.25746154785156,198.00921034812927,461.91590881347656,11627,3023,8604,8604,0,12,3109000.0
3109,3109999,20.325534718935526,36.40562998178011,0.08440186619796985,453.4344229698181,198.07187414169312,461.97806549072266,11633,3024,8609,8609,0,12,3110000.0
3110,3110999,20.324338918462495,36.403689572547336,0.08438452779953065,453.55119276046753,198.13448190689087,462.9563980102539,11654,3024,8630,8630,0,12,3111000.0
3111,3111999,20.322127881211205,36.400334444962084,0.08438023857332477,453.656042098999,198.19564747810364,463.33612060546875,11654,3024,8630,8630,0,12,3112000.0
3112,3112999,20.3201479611284,36.39784203655515,0.08437751583207709,453.79792952537537,198.25675439834595,463.5388641357422,11657,3025,8632,8632,0,12,3113000.0
3113,3113999,20.317879387815946,36.394516037999544,0.08438180350708735,453.942013502121,198.31838417053223,463.72643661499023,11659,3026,8633,8633,0,12,3114000.0
3114,3114999,20.315857739819545,36.39099351650611,0.08437849950857101,454.1775221824646,198.38220620155334,463.8095703125,11667,3030,8637,8637,0,12,3115000.0
3115,3115999,20.314228141830093,36.38954254054266,0.08436458572975081,454.35245418548584,198.44435596466064,464.00402450561523,11671,3032,8639,8639,0,12,3116000.0
3116,3116999,20.312986903194062,36.388011394792116,0.08434693371070234,454.572692155838,198.51040148735046,464.123348236084,11677,3035,8642,8642,0,12,3117000.0
3117,3117999,20.312145607395816,36.38628781323815,0.08432054398193534,454.7540092468262,198.57318806648254,464.279541015625,11681,3037,8644,8644,0,12,3118000.0
3118,3118999,20.311320461108014,36.38471259807504,0.08430732178719313,454.99150705337524,198.63613367080688,464.2456588745117,11689,3041,8648,8648,0,12,3119000.0
3119,3119999,20.310846180649435,36.38372107151944,0.0843048266216615,455.1736731529236,198.69988894462585,464.37908935546875,11693,3043,8650,8650,0,12,3120000.0
3120,3120999,20.310955169905572,36.384166711270446,0.08432959583125466,455.3374545574188,198.76267838478088,464.5451011657715,11695,3044,8651,8651,0,12,3121000.0
3121,3121999,20.31080816418956,36.38295701801876,0.08437213044459013,455.45718455314636,198.825767993927,464.74134826660156,11695,3044,8651,8651,0,12,3122000.0
3122,3122999,20.31101748995871,36.38355058096066,0.08439632173600753,455.61454463005066,198.8885531425476,464.8775329589844,11697,3045,8652,8652,0,12,3123000.0
3123,3123999,20.31175354465676,36.38481278937327,0.08441544469571982,455.74372148513794,198.9512231349945,465.0097541809082,11697,3045,8652,8652,0,12,3124000.0
3124,3124999,20.312474456655824,36.38535608820675,0.08443963691502854,455.8739824295044,199.0134675502777,465.14602279663086,11697,3045,8652,8652,0,12,3125000.0
3125,3125999,20.313767906968355,36.387036423772614,0.08444792186402683,455.9959828853607,199.07585406303406,465.29912185668945,11697,3045,8652,8652,0,12,3126000.0
3126,3126999,20.31430201520818,36.386699911658276,0.08445933729241195,456.20398211479187,199.13871335983276,465.31307220458984,11730,3047,8683,8683,0,12,3127000.0
3127,3127999,20.314905132492324,36.38628784920188,0.08445691081529527,456.3372280597687,199.20115494728088,465.40836334228516,11730,3047,8683,8683,0,12,3128000.0
3128,3128999,20.315821355101566,36.38623779867105,0.08445027970048669,456.4992392063141,199.26351642608643,465.457706451416,11732,3048,8684,8684,0,12,3129000.0
3129,3129999,20.31593222277197,36.384974239578455,0.08444894596791586,456.66423773765564,199.327392578125,465.51708221435547,11734,3049,8685,8685,0,12,3130000.0
3130,3130999,20.315508819793493,36.3827253261988,0.0844499517105447,456.80212903022766,199.38940024375916,465.65541076660156,11734,3049,8685,8685,0,12,3131000.0
3131,3131999,20.315916410915584,36.385492332657805,0.08438251793782225,456.92303466796875,199.4581105709076,466.60971450805664,11748,3049,8699,8699,0,12,3132000.0
3132,3132999,20.31489642890644,36.3826156192145,0.08435220842590829,457.03245878219604,199.5196394920349,467.01272201538086,11750,3049,8701,8701,0,12,3133000.0
3133,3133999,20.31360883706363,36.37970218047533,0.08433832611070768,457.14891266822815,199.58126091957092,467.27827072143555,11750,3049,8701,8701,0,12,3134000.0
3134,3134999,20.31258919389318,36.378886386449416,0.08431629862903367,457.2944028377533,199.64285373687744,467.3371772766113,11755,3050,8705,8705,0,12,3135000.0
3135,3135999,20.312006769116266,36.37796533251762,0.08429454300859907,457.47303891181946,199.70469164848328,467.4126663208008,11759,3052,8707,8707,0,12,3136000.0
3136,3136999,20.311554616633792,36.37680376439409,0.08427684367302346,457.66550517082214,199.76675939559937,467.49042892456055,11769,3054,8715,8715,0,12,3137000.0
3137,3137999,20.31102469577002,36.375313150083784,0.08426781451837362,457.82114458084106,199.82883596420288,467.62214279174805,11771,3055,8716,8716,0,12,3138000.0
3138,3138999,20.310858253498292,36.37513420001063,0.0842440192980225,457.98416781425476,199.89102244377136,467.72504806518555,11773,3056,8717,8717,0,12,3139000.0
3139,3139999,20.311282441633423,36.375217815604415,0.08423260897052331,458.17832231521606,199.95312094688416,467.7093963623047,11777,3058,8719,8719,0,12,3140000.0
3140,3140999,20.31300193021945,36.383030228598365,0.08420901911714429,458.2995798587799,200.0160632133484,467.9709167480469,11777,3058,8719,8719,0,12,3141000.0
3141,3141999,20.316769948956814,36.39142765487203,0.08421320386061226,458.43113255500793,200.07778215408325,468.1192970275879,11777,3058,8719,8719,0,12,3142000.0
3142,3142999,20.323329081377302,36.40705965393773,0.0842102980232241,458.54821705818176,200.13952898979187,468.2309265136719,11777,3058,8719,8719,0,12,3143000.0
3143,3143999,20.331165906383468,36.4379431275594,0.08416330735560229,458.73484468460083,200.2018322944641,468.20113372802734,11781,3060,8721,8721,0,12,3144000.0
3144,3144999,20.3398316375087,36.4645814507703,0.08419543126631723,458.857782125473,200.26404571533203,468.3343963623047,11781,3060,8721,8721,0,12,3145000.0
3145,3145999,20.35068617907347,36.500275038406976,0.08422057824234452,459.05205941200256,200.32711601257324,468.3057518005371,11785,3062,8723,8723,0,12,3146000.0
3146,3146999,20.363576983058948,36.54058026892145,0.08431193071577614,459.1678123474121,200.38890480995178,468.49810791015625,11785,3062,8723,8723,0,12,3147000.0
3147,3147999,20.375236331407628,36.57705848398205,0.08443547711814703,459.3678023815155,200.45201873779297,468.4188995361328,11789,3064,8725,8725,0,12,3148000.0
3148,3148999,20.38572094255526,36.60240571471879,0.08456150644703264,459.5433735847473,200.51466631889343,468.49708557128906,11791,3065,8726,8726,0,12,3149000.0
3149,3149999,20.396225679450584,36.62896917974922,0.08479510659519018,459.6964020729065,200.5773811340332,468.5912895202637,11792,3066,8726,8726,0,12,3150000.0
3150,3150999,20.40663550024666,36.65502515251833,0.08499536136638675,459.8124873638153,200.6404047012329,468.7367477416992,11792,3066,8726,8726,0,12,3151000.0
3151,3151999,20.413413586082847,36.669478706362234,0.08510057730505438,460.00510334968567,200.7045774459839,469.44640350341797,11812,3068,8744,8744,0,12,3152000.0
3152,3152999,20.413377629605996,36.67441583878297,0.0850509775532644,460.1196811199188,200.7662444114685,469.9646110534668,11813,3068,8745,8745,0,12,3153000.0
3153,3153999,20.41249711723032,36.67321206893205,0.0850449170163341,460.2251355648041,200.82811784744263,470.26425552368164,11814,3068,8746,8746,0,12,3154000.0
3154,3154999,20.41186225333859,36.672668025614314,0.08503285996892163,460.34645676612854,200.88919925689697,470.4902038574219,11814,3068,8746,8746,0,12,3155000.0
3155,3155999,20.41113463166541,36.67164194441942,0.08501628085318702,460.54235196113586,200.951096534729,470.53726959228516,11820,3071,8749,8749,0,12,3156000.0
3156,3156999,20.410493200460706,36.670240137575824,0.08500597684394295,460.6981167793274,201.01303601264954,470.6478614807129,11825,3072,8753,8753,0,12,3157000.0
3157,3157999,20.409452863116535,36.66770106057181,0.08499760804969592,460.92233633995056,201.07653069496155,470.6494255065918,11831,3075,8756,8756,0,12,3158000.0
3158,3158999,20.40926843536358,36.67212877038493,0.08495627229951075,461.10876870155334,201.13874912261963,470.79536056518555,11835,3077,8758,8758,0,12,3159000.0
3159,3159999,20.40840112533352,36.67006773662181,0.08494048326355597,461.31970477104187,201.20114755630493,470.8294105529785,11841,3080,8761,8761,0,12,3160000.0
3160,3160999,20.40792112279778,36.6686049945149,0.08492058770089839,461.4469938278198,201.26332235336304,471.0158920288086,11841,3080,8761,8761,0,12,3161000.0
3161,3161999,20.407332155476993,36.667084396284096,0.08490207640920755,461.5680823326111,201.32520866394043,471.19115829467773,11841,3080,8761,8761,0,12,3162000.0
3162,3162999,20.40727313097867,36.667142352687925,0.08487990528365585,461.7681972980499,201.38806819915771,471.17568588256836,11845,3082,8763,8763,0,12,3163000.0
3163,3163999,20.4073022353662,36.666943398739456,0.08485774087063791,461.88995337486267,201.4498631954193,471.3145751953125,11845,3082,8763,8763,0,12,3164000.0
3164,3164999,20.407591315948206,36.66676753903184,0.08483102192577052,462.01852893829346,201.51168203353882,471.43381118774414,11845,3082,8763,8763,0,12,3165000.0
3165,3165999,20.407821770943094,36.66562333612236,0.08480967079535007,462.14302039146423,201.5739448070526,471.5440979003906,11845,3082,8763,8763,0,12,3166000.0
3166,3166999,20.407715402051036,36.66384338660744,0.08479638773006115,462.31311655044556,201.64193654060364,471.63793182373047,11847,3083,8764,8764,0,12,3167000.0
3167,3167999,20.407884468255965,36.662832399909426,0.0847843772625696,462.4850194454193,201.7040650844574,471.63467025756836,11849,3084,8765,8765,0,12,3168000.0
3168,3168999,20.40805623144662,36.66132659763282,0.08477622509098903,462.6646680831909,201.7664566040039,471.7405815124512,11856,3085,8771,8771,0,12,3169000.0
3169,3169999,20.40741456962832,36.66018242114699,0.08476477191373843,462.7954707145691,201.82834720611572,471.88751220703125,11856,3085,8771,8771,0,12,3170000.0
3170,3170999,20.40803131680998,36.659101545616714,0.0846751331496085,462.9428813457489,201.89138913154602,472.7519226074219,11887,3086,8801,8801,0,12,3171000.0
3171,3171999,20.408213242335993,36.65767763389452,0.08459079338631315,463.10891580581665,201.95394945144653,473.02442932128906,11893,3088,8805,8805,0,12,3172000.0
3172,3172999,20.40647654404957,36.654677655943864,0.08458763933120084,463.26023864746094,202.01590418815613,473.2692565917969,11895,3089,8806,8806,0,12,3173000.0
3173,3173999,20.404315514641528,36.65055435394633,0.08458884529002342,463.40650033950806,202.0785846710205,473.41115951538086,11897,3090,8807,8807,0,12,3174000.0
3174,3174999,20.402694279419443,36.64713430643767,0.08458031491111329,463.58718705177307,202.14127111434937,473.63348388671875,11902,3092,8810,8810,0,12,3175000.0
3175,3175999,20.400927027971072,36.644715822512424,0.08456933414167034,463.7165675163269,202.20332074165344,473.8796844482422,11902,3092,8810,8810,0,12,3176000.0
3176,3176999,20.398967816246746,36.641048616749686,0.08456297838646132,463.89448952674866,202.26629447937012,473.94532012939453,11906,3094,8812,8812,0,12,3177000.0
3177,3177999,20.397224199643134,36.637442598181266,0.08455655803905282,464.0763051509857,202.32881379127502,474.0153045654297,11910,3096,8814,8814,0,12,3178000.0
3178,3178999,20.39564946209167,36.63546287276967,0.08454109946402233,464.25732827186584,202.391277551651,474.11534881591797,11915,3098,8817,8817,0,12,3179000.0
3179,3179999,20.394105636284312,36.632791238247684,0.08453408695911524,464.38431549072266,202.4530692100525,474.2982711791992,11915,3098,8817,8817,0,12,3180000.0
3180,3180999,20.392601135363424,36.629656048036544,0.08452578983761716,464.5339014530182,202.51508355140686,474.44923400878906,11917,3099,8818,8818,0,12,3181000.0
3181,3181999,20.39104210427199,36.62645942984011,0.08452499468454644,464.6788396835327,202.57717323303223,474.6056938171387,11917,3099,8818,8818,0,12,3182000.0
3182,3182999,20.389711830405393,36.623317414418565,0.08451952934738327,464.8053774833679,202.63919162750244,474.713680267334,11917,3099,8818,8818,0,12,3183000.0
3183,3183999,20.389102928176786,36.62177132291274,0.08450345754120603,464.9167711734772,202.70107460021973,474.84299087524414,11917,3099,8818,8818,0,12,3184000.0
3184,3184999,20.389361393529658,36.62420193299916,0.08446010753785815,465.06044816970825,202.76355290412903,474.95987701416016,11917,3099,8818,8818,0,12,3185000.0
3185,3185999,20.389743239171622,36.62470508989819,0.08444283035490019,465.231568813324,202.82605600357056,475.0118942260742,11919,3100,8819,8819,0,12,3186000.0
3186,3186999,20.390035416060098,36.62453706027964,0.0844174171408193,465.41239166259766,202.8899531364441,474.9791946411133,11923,3102,8821,8821,0,12,3187000.0
3187,3187999,20.39076544857143,36.62523433201245,0.08440009879667398,465.5741403102875,202.95261120796204,475.0488815307617,11925,3103,8822,8822,0,12,3188000.0
3188,3188999,20.391434215919215,36.62565908864526,0.0844009348453989,465.7158463001251,203.01532077789307,475.15046310424805,11925,3103,8822,8822,0,12,3189000.0
3189,3189999,20.391861480321854,36.62478962356174,0.08438875267715995,465.8465008735657,203.0851743221283,475.26927947998047,11925,3103,8822,8822,0,12,3190000.0
3190,3190999,20.392435446006335,36.624943448004515,0.08434836312524718,466.01094460487366,203.14850783348083,475.9512062072754,11942,3104,8838,8838,0,12,3191000.0
3191,3191999,20.391639268564344,36.62175970795949,0.08430130809435343,466.1805543899536,203.21050548553467,476.1980438232422,11946,3106,8840,8840,0,12,3192000.0
3192,3192999,20.389942013294213,36.61919298704249,0.08429440670522537,466.3143391609192,203.28424978256226,476.571590423584,11947,3106,8841,8841,0,12,3193000.0
3193,3193999,20.388347996966893,36.616743732348205,0.08428715891879746,466.4212763309479,203.34607672691345,476.8181571960449,11947,3106,8841,8841,0,12,3194000.0
3194,3194999,20.3865946395459,36.61463293369847,0.0842768510377675,466.5841979980469,203.4081311225891,476.9364128112793,11949,3107,8842,8842,0,12,3195000.0
3195,3195999,20.38495119671879,36.61311547667493,0.08425345508170745,466.76733350753784,203.47056651115417,477.06213760375977,11953,3109,8844,8844,0,12,3196000.0
3196,3196999,20.38306678814772,36.60956979582173,0.0842434391624215,466.94154691696167,203.53319120407104,477.19135665893555,11957,3111,8846,8846,0,12,3197000.0
3197,3197999,20.381192356054264,36.60610960917632,0.08424164125073852,467.1032612323761,203.595600605011,477.3293037414551,11959,3112,8847,8847,0,12,3198000.0
3198,3198999,20.379934331049604,36.60499224974961,0.08422097157599207,467.2900037765503,203.65795159339905,477.3514862060547,11963,3114,8849,8849,0,12,3199000.0
3199,3199999,20.37849751608277,36.60190164320353,0.08421171391973081,467.44406938552856,203.72071170806885,477.56719970703125,11965,3115,8850,8850,0,12,3200000.0
3200,3200999,20.377610745874115,36.60021275507288,0.08421043042145115,467.6165409088135,203.7835774421692,477.66452407836914,11967,3116,8851,8851,0,12,3201000.0
3201,3201999,20.37746725719577,36.60029753447552,0.0841879130701565,467.76297903060913,203.84639930725098,477.7669372558594,11969,3117,8852,8852,0,12,3202000.0
3202,3202999,20.377054599248357,36.59970988674456,0.08418109528964546,467.9636061191559,203.91031980514526,477.8034362792969,11979,3119,8860,8860,0,12,3203000.0
3203,3203999,20.378702563856216,36.6045170458272,0.08415503016236114,468.08560013771057,203.97292828559875,477.9502410888672,11979,3119,8860,8860,0,12,3204000.0
3204,3204999,20.38195208084258,36.611960224311815,0.08412440631413731,468.2123520374298,204.03571486473083,478.1035385131836,11979,3119,8860,8860,0,12,3205000.0
3205,3205999,20.385336307957246,36.62296835240322,0.08409854821675122,468.3854458332062,204.09846830368042,478.1429252624512,11981,3120,8861,8861,0,12,3206000.0
3206,3206999,20.38931448370861,36.63095488946577,0.08410487724212046,468.5408172607422,204.16147780418396,478.1640739440918,11983,3121,8862,8862,0,12,3207000.0
3207,3207999,20.39374476248892,36.63949322840554,0.0841175215183011,468.70916080474854,204.22502279281616,478.2434616088867,11985,3122,8863,8863,0,12,3208000.0
3208,3208999,20.39802119129291,36.64738258737039,0.08417992257192719,468.8493683338165,204.28788042068481,478.3554496765137,11985,3122,8863,8863,0,12,3209000.0
3209,3209999,20.40181679428828,36.65538312100466,0.08420835077935873,468.9884662628174,204.35077548027039,478.44265365600586,11985,3122,8863,8863,0,12,3210000.0
3210,3210999,20.406464445959745,36.66354307522627,0.08426043145572792,469.15965509414673,204.4138069152832,478.5089569091797,11987,3123,8864,8864,0,12,3211000.0
3211,3211999,20.409756895922165,36.675331745303815,0.08427417607174437,469.3156385421753,204.47700762748718,478.9978904724121,12003,3124,8879,8879,0,12,3212000.0
3212,3212999,20.40816662696434,36.673347054107374,0.08424828013563568,469.42777585983276,204.53994512557983,479.5388374328613,12005,3124,8881,8881,0,12,3213000.0
3213,3213999,20.4067202000092,36.67047568819395,0.08422790893658993,469.536509513855,204.60201907157898,479.8313865661621,12005,3124,8881,8881,0,12,3214000.0
3214,3214999,20.40492414053639,36.667119151327384,0.08422954145042338,469.6939241886139,206.45616841316223,479.9882354736328,12007,3125,8882,8882,0,12,3215000.0
3215,3215999,20.403404313780772,36.66422564907609,0.08421966968546801,469.8717794418335,206.51829051971436,480.01679611206055,12011,3127,8884,8884,0,12,3216000.0
3216,3216999,20.4019997756869,36.6622865577926,0.08420540389244613,470.077378988266,206.58189821243286,480.0634117126465,12017,3130,8887,8887,0,12,3217000.0
3217,3217999,20.400650659846026,36.660699716008125,0.08419542245499045,470.20840334892273,206.64465641975403,480.2865905761719,12017,3130,8887,8887,0,12,3218000.0
3218,3218999,20.399432934523045,36.659330849118525,0.08418561267721325,470.39842224121094,206.70774030685425,480.341007232666,12021,3132,8889,8889,0,12,3219000.0
3219,3219999,20.39899646282132,36.65977292411619,0.0841636150915478,470.55741453170776,206.77182412147522,480.45904541015625,12023,3133,8890,8890,0,12,3220000.0
3220,3220999,20.399104574745174,36.66404440671753,0.08413968276573147,470.72675681114197,206.83472990989685,480.60998153686523,12025,3134,8891,8891,0,12,3221000.0
3221,3221999,20.400246104865733,36.66903897226488,0.08411651622399818,470.8909876346588,206.8980700969696,480.67303466796875,12027,3135,8892,8892,0,12,3222000.0
3222,3222999,20.403870990940593,36.68011682947073,0.0841069058165137,471.03457260131836,206.9610939025879,480.8492622375488,12027,3135,8892,8892,0,12,3223000.0
3223,3223999,20.40745067515209,36.69380986062699,0.08411842017529392,471.1757843494415,207.023770570755,480.9446258544922,12027,3135,8892,8892,0,12,3224000.0
3224,3224999,20.41330473940134,36.711144736228576,0.08412461243420444,471.302259683609,207.08618474006653,481.05456924438477,12027,3135,8892,8892,0,12,3225000.0
3225,3225999,20.419797284902266,36.729926664788614,0.08421333862528713,471.4707157611847,207.15048456192017,481.12273025512695,12029,3136,8893,8893,0,12,3226000.0
3226,3226999,20.425568466496788,36.746271382345924,0.08424712573217208,471.5944664478302,207.21335577964783,481.2447700500488,12029,3136,8893,8893,0,12,3227000.0
3227,3227999,20.43297767662913,36.767640494519654,0.08432712670709663,471.75712156295776,207.27633452415466,481.29314041137695,12031,3137,8894,8894,0,12,3228000.0
3228,3228999,20.43970466712103,36.78761737886272,0.08442154550910863,471.9760181903839,207.33973693847656,481.15505599975586,12037,3140,8897,8897,0,12,3229000.0
3229,3229999,20.44714192621237,36.80676311592938,0.08449208935233665,472.1564700603485,207.4035930633545,481.2290916442871,12039,3141,8898,8898,0,12,3230000.0
3230,3230999,20.45682046148668,36.83385407139953,0.08459742335481235,472.27262783050537,207.4664511680603,481.3745422363281,12039,3141,8898,8898,0,12,3231000.0
3231,3231999,20.462051564983085,36.845185559875304,0.08464834213324912,472.45252776145935,207.53162384033203,481.48123931884766,12041,3142,8899,8899,0,12,3232000.0
3232,3232999,20.462689349927405,36.846282340480535,0.08465545364415139,472.5759027004242,207.5965428352356,482.3956756591797,12056,3142,8914,8914,0,12,3233000.0
3233,3233999,20.461483846117083,36.84455272733053,0.08464131298839372,472.69152188301086,207.65887713432312,482.7693519592285,12056,3142,8914,8914,0,12,3234000.0
3234,3234999,20.460518270033642,36.847142836328786,0.08461379073315356,472.8464171886444,207.72158646583557,482.9216766357422,12058,3143,8915,8915,0,12,3235000.0
3235,3235999,20.4597729905184,36.84587243387362,0.08460559144131896,472.97270584106445,207.78560709953308,483.1716117858887,12058,3143,8915,8915,0,12,3236000.0
3236,3236999,20.458755024590385,36.84411819068246,0.08459042897666069,473.1700451374054,207.8490297794342,483.2624206542969,12062,3145,8917,8917,0,12,3237000.0
3237,3237999,20.457703646470772,36.841982595409725,0.08458713738701795,473.32219672203064,207.91208028793335,483.3830757141113,12064,3146,8918,8918,0,12,3238000.0
3238,3238999,20.456010224835605,36.83850555844115,0.08458908455274072,473.4815902709961,207.9762680530548,483.50671005249023,12066,3147,8919,8919,0,12,3239000.0
3239,3239999,20.454813694052365,36.835657877261845,0.0845854030688763,473.7111864089966,208.0404176712036,483.51114654541016,12072,3150,8922,8922,0,12,3240000.0
3240,3240999,20.453969528320325,36.833497003628544,0.08457593188458778,473.91644501686096,208.1039743423462,483.5189781188965,12076,3152,8924,8924,0,12,3241000.0
3241,3241999,20.45347044305841,36.83166747737803,0.08457237399718043,474.06708884239197,208.1672556400299,483.70758056640625,12078,3153,8925,8925,0,12,3242000.0
3242,3242999,20.453093840773196,36.82969912632239,0.08455751081140062,474.20983147621155,208.23155450820923,483.88032150268555,12078,3153,8925,8925,0,12,3243000.0
3243,3243999,20.45400035304195,36.831562414641795,0.08455187489179228,474.3738136291504,208.2949779033661,483.93257904052734,12080,3154,8926,8926,0,12,3244000.0
3244,3244999,20.455340133794724,36.833192593989125,0.08455126463180263,474.503586769104,208.35863661766052,484.09204483032227,12080,3154,8926,8926,0,12,3245000.0
3245,3245999,20.45809246952468,36.83939985971503,0.08454762634916735,474.7000472545624,208.42217540740967,484.05992126464844,12084,3156,8928,8928,0,12,3246000.0
3246,3246999,20.461874582715307,36.85232668051871,0.08451100778166898,474.8877613544464,208.48558592796326,484.08936309814453,12088,3158,8930,8930,0,12,3247000.0
3247,3247999,20.46640921629688,36.86203253320749,0.08449302446511509,475.011816740036,208.54946875572205,484.2972640991211,12088,3158,8930,8930,0,12,3248000.0
3248,3248999,20.471690536543424,36.87336062293489,0.08450683288330385,475.1809480190277,208.6158001422882,484.3799476623535,12091,3159,8932,8932,0,12,3249000.0
3249,3249999,20.476264962226356,36.88329871266525,0.08451136085383237,475.3375780582428,208.67991995811462,484.51658630371094,12091,3159,8932,8932,0,12,3250000.0
3250,3250999,20.48068876980248,36.8905007624164,0.08455976219130679,475.48686003685,208.74539351463318,484.6351432800293,12091,3159,8932,8932,0,12,3251000.0
3251,3251999,20.48622342433064,36.898796180436946,0.08463989804747762,475.6394786834717,208.81316494941711,484.7406196594238,12091,3159,8932,8932,0,12,3252000.0
3252,3252999,20.48884353344931,36.90383672238318,0.08468887069901809,475.8018579483032,208.8767499923706,484.8365478515625,12102,3160,8942,8942,0,12,3253000.0
3253,3253999,20.488052902691937,36.90206945724287,0.08464186127969386,475.92609763145447,208.94093346595764,485.77491760253906,12118,3160,8958,8958,0,12,3254000.0
3254,3254999,20.48649965909851,36.89913132459498,0.0846275372608647,476.07289719581604,209.00441670417786,486.048152923584,12120,3161,8959,8959,0,12,3255000.0
3255,3255999,20.485636402565728,36.90114477831455,0.08457769029067441,476.22537779808044,209.0674765110016,486.20506286621094,12123,3162,8961,8961,0,12,3256000.0
3256,3256999,20.4844806904409,36.898474126544244,0.08455993286790753,476.3624563217163,209.13113141059875,486.42980194091797,12123,3162,8961,8961,0,12,3257000.0
3257,3257999,20.48341406379331,36.89760945345293,0.08453585836558986,476.5788736343384,209.19443893432617,486.4716262817383,12129,3165,8964,8964,0,12,3258000.0
3258,3258999,20.482849040265247,36.896362442861175,0.08450863396016328,476.72505378723145,209.25723242759705,486.643611907959,12131,3166,8965,8965,0,12,3259000.0
3259,3259999,20.482017744395304,36.89589353741524,0.08447296294271112,476.8769907951355,209.32006192207336,486.7544288635254,12133,3167,8966,8966,0,12,3260000.0
3260,3260999,20.48103488404038,36.893535019302924,0.0844506208644914,477.1000306606293,209.3854124546051,486.78868865966797,12139,3170,8969,8969,0,12,3261000.0
3261,3261999,20.48016694593018,36.891228557322876,0.08442590336406364,477.3026158809662,209.44937181472778,486.89919662475586,12143,3172,8971,8971,0,12,3262000.0
3262,3262999,20.47950354816034,36.88989816791666,0.08440458422628261,477.45876812934875,209.51257729530334,487.1000747680664,12146,3173,8973,8973,0,12,3263000.0
3263,3263999,20.478872841799713,36.88929784991473,0.08438555925146807,477.61435079574585,209.5759401321411,487.1980400085449,12148,3174,8974,8974,0,12,3264000.0
3264,3264999,20.47914578748595,36.88871655809684,0.08436548198476035,477.760879278183,209.639164686203,487.33967208862305,12148,3174,8974,8974,0,12,3265000.0
3265,3265999,20.479558953053555,36.888517509302744,0.08433784959238544,477.89849972724915,209.70199370384216,487.4510955810547,12148,3174,8974,8974,0,12,3266000.0
3266,3266999,20.481063360515577,36.88979059495354,0.08430982030453571,478.022349357605,209.7648618221283,487.54742431640625,12148,3174,8974,8974,0,12,3267000.0
3267,3267999,20.483834568700654,36.89384236138293,0.08426631518294048,478.15623235702515,209.82792806625366,487.65396881103516,12148,3174,8974,8974,0,12,3268000.0
3268,3268999,20.48708198882841,36.89795468335673,0.08423319804369045,478.39024353027344,209.8918972015381,487.5160484313965,12154,3177,8977,8977,0,12,3269000.0
3269,3269999,20.49051163984779,36.90289165351477,0.08421405195080123,478.5788106918335,209.955406665802,487.4892272949219,12158,3179,8979,8979,0,12,3270000.0
3270,3270999,20.49440458254519,36.90790190957332,0.08420351571746931,478.7113137245178,210.01911091804504,487.645938873291,12158,3179,8979,8979,0,12,3271000.0
3271,3271999,20.497312098362325,36.91058399453376,0.08420801195507077,478.86819219589233,210.08309412002563,487.7944145202637,12158,3179,8979,8979,0,12,3272000.0
3272,3272999,20.49985806988704,36.91249676017859,0.08422980918615186,479.03181648254395,210.14696192741394,487.7990417480469,12160,3180,8980,8980,0,12,3273000.0
3273,3273999,20.50199365165376,36.91377130702874,0.08424047760170328,479.1589193344116,210.2103190422058,487.94272232055664,12160,3180,8980,8980,0,12,3274000.0
3274,3274999,20.502404437748844,36.91205599192538,0.08419972406163878,479.36520195007324,210.27625966072083,488.6187629699707,12190,3182,9008,9008,0,12,3275000.0
3275,3275999,20.503038120419212,36.91032046193425,0.08412427274834566,479.49023175239563,210.33903074264526,488.9546203613281,12192,3182,9010,9010,0,12,3276000.0
3276,3276999,20.50333856545625,36.90860893915158,0.08405839803070347,479.60090160369873,210.4011218547821,489.2052879333496,12192,3182,9010,9010,0,12,3277000.0
3277,3277999,20.50310859711498,36.906396660611506,0.08401763801023998,479.754296541214,210.46350145339966,489.3415756225586,12194,3183,9011,9011,0,12,3278000.0
3278,3278999,20.501897377707266,36.90316225734784,0.08399367643690514,479.970073223114,210.526700258255,489.34879302978516,12200,3186,9014,9014,0,12,3279000.0
3279,3279999,20.50169511533375,36.9048048880844,0.08393925174106232,480.16394233703613,210.58984851837158,489.3104591369629,12204,3188,9016,9016,0,12,3280000.0
3280,3280999,20.49998772269578,36.90192254709956,0.08392542614061949,480.3457281589508,210.65516662597656,489.33630752563477,12208,3190,9018,9018,0,12,3281000.0
3281,3281999,20.49852335925225,36.898807483142924,0.08390646387281309,480.53970432281494,210.71857118606567,489.42298889160156,12212,3192,9020,9020,0,12,3282000.0
3282,3282999,20.496962153408532,36.89580051244981,0.08388748791297884,480.75977897644043,210.7826030254364,489.45742416381836,12218,3195,9023,9023,0,12,3283000.0
3283,3283999,20.495845704567664,36.893027968603704,0.08386571652762032,480.91331815719604,210.84637331962585,489.67189025878906,12221,3196,9025,9025,0,12,3284000.0
3284,3284999,20.495183914522443,36.89203074603995,0.08384040113417013,481.11498260498047,210.9106342792511,489.7506790161133,12225,3198,9027,9027,0,12,3285000.0
3285,3285999,20.495064270398213,36.891050480874114,0.08380413334955117,481.25483441352844,210.97443509101868,489.9103546142578,12225,3198,9027,9027,0,12,3286000.0
3286,3286999,20.495334718870808,36.89025508249433,0.08378112417176042,481.46598958969116,211.03882360458374,489.88720321655273,12231,3201,9030,9030,0,12,3287000.0
3287,3287999,20.495961708775717,36.89014017325385,0.08375584381894019,481.62126207351685,211.10244131088257,490.0497169494629,12232,3201,9031,9031,0,12,3288000.0
3288,3288999,20.49691813189752,36.89065133545869,0.0837274454853566,481.76331210136414,211.16558170318604,490.12171173095703,12234,3202,9032,9032,0,12,3289000.0
3289,3289999,20.497894295298114,36.89079417616443,0.08370210326508687,481.91754364967346,211.23103618621826,490.26729583740234,12234,3202,9032,9032,0,12,3290000.0
3290,3290999,20.498862943290522,36.89034395266918,0.08367784634051212,482.0797679424286,211.29486107826233,490.29042053222656,12236,3203,9033,9033,0,12,3291000.0
3291,3291999,20.499749311885555,36.88964716591434,0.08366462768545158,482.27489376068115,211.3593099117279,490.3171195983887,12250,3205,9045,9045,0,12,3292000.0
3292,3292999,20.500979885879744,36.89216937103744,0.08363963341686698,482.39972591400146,211.42249536514282,490.4427185058594,12250,3205,9045,9045,0,12,3293000.0
3293,3293999,20.502220256982238,36.89819024805778,0.08359240158503489,482.54733324050903,211.4858477115631,490.558349609375,12250,3205,9045,9045,0,12,3294000.0
3294,3294999,20.502535895020298,36.89672782805992,0.08357969270329912,482.71146035194397,211.54956912994385,490.70502853393555,12250,3205,9045,9045,0,12,3295000.0
3295,3295999,20.501670021616615,36.895582676483,0.08355956415470778,482.845276594162,211.61395812034607,491.4402885437012,12268,3205,9063,9063,0,12,3296000.0
3296,3296999,20.50149022455606,36.89568700929642,0.08351799164710894,482.9697690010071,211.6776819229126,491.8676986694336,12270,3205,9065,9065,0,12,3297000.0
3297,3297999,20.500990541979537,36.89403159751521,0.0835090913954194,483.12770771980286,211.74460577964783,492.0609321594238,12273,3206,9067,9067,0,12,3298000.0
3298,3298999,20.5005690560166,36.892397116080815,0.08350268559906249,483.2976291179657,211.80836248397827,492.27579498291016,12275,3207,9068,9068,0,12,3299000.0
3299,3299999,20.50045769046914,36.89169341561574,0.08348729943059219,483.4836061000824,211.87120485305786,492.365909576416,12279,3209,9070,9070,0,12,3300000.0
3300,3300999,20.500326631385043,36.89050140720058,0.08347619367990056,483.6392731666565,211.93375706672668,492.52135848999023,12281,3210,9071,9071,0,12,3301000.0
3301,3301999,20.50079359450501,36.89039012479551,0.08344617164281498,483.7669711112976,211.99648714065552,492.73200607299805,12282,3210,9072,9072,0,12,3302000.0
3302,3302999,20.50125507616308,36.889543241436655,0.08342095897773594,483.97939801216125,212.06133580207825,492.7084770202637,12288,3213,9075,9075,0,12,3303000.0
3303,3303999,20.502640007166605,36.89225763508543,0.08340460442723718,484.159521818161,212.12478017807007,492.8726043701172,12291,3214,9077,9077,0,12,3304000.0
3304,3304999,20.503846730088853,36.89451558134777,0.08338263926323863,484.3143892288208,212.1877453327179,493.00788497924805,12293,3215,9078,9078,0,12,3305000.0
3305,3305999,20.50647238132539,36.9057786761518,0.0833494001761409,484.47382974624634,212.25053358078003,493.1154327392578,12295,3216,9079,9079,0,12,3306000.0
3306,3306999,20.510694095229336,36.917298507364336,0.08337338732353727,484.72107911109924,212.315114736557,492.8790855407715,12304,3220,9084,9084,0,12,3307000.0
3307,3307999,20.514403024952028,36.92494118504678,0.08344166816813958,484.9643585681915,212.3809494972229,492.7373390197754,12313,3224,9089,9089,0,12,3308000.0
3308,3308999,20.518082593660573,36.932511227201836,0.08353263185470283,485.12156558036804,212.44474911689758,492.99896240234375,12315,3225,9090,9090,0,12,3309000.0
3309,3309999,20.52166844974584,36.938532400494836,0.08362896854400381,485.2658655643463,212.50832605361938,493.2138671875,12315,3225,9090,9090,0,12,3310000.0
3310,3310999,20.524633771885643,36.94257194457092,0.08371280419043514,485.39624547958374,212.57182240486145,493.3774719238281,12315,3225,9090,9090,0,12,3311000.0
3311,3311999,20.52824816938984,36.94854625811827,0.08383998428723083,485.58957982063293,212.63599038124084,493.3624610900879,12319,3227,9092,9092,0,12,3312000.0
3312,3312999,20.53088947312465,36.951603967945374,0.0839236562810548,485.71891474723816,212.69994974136353,493.5352668762207,12319,3227,9092,9092,0,12,3313000.0
3313,3313999,20.532728109910742,36.95254568176815,0.08399081570101219,485.86160016059875,212.76358675956726,493.6946716308594,12319,3227,9092,9092,0,12,3314000.0
3314,3314999,20.532743909188426,36.952922842740165,0.08398447030786127,485.97893619537354,212.82734656333923,494.5973243713379,12339,3227,9112,9112,0,12,3315000.0
3315,3315999,20.531929709437627,36.95246188286617,0.0839626859875846,486.1187300682068,212.88996863365173,495.01224517822266,12340,3227,9113,9113,0,12,3316000.0
3316,3316999,20.530964537398756,36.95103081051958,0.08395526620794225,486.30981850624084,212.95300197601318,495.1145782470703,12345,3229,9116,9116,0,12,3317000.0
3317,3317999,20.530452494602688,36.95194329319449,0.0839392334911343,486.4532346725464,213.01556825637817,495.30235290527344,12347,3230,9117,9117,0,12,3318000.0
3318,3318999,20.530735760552336,36.952706872709115,0.08391746173352876,486.63640117645264,213.08033967018127,495.42353439331055,12352,3232,9120,9120,0,12,3319000.0
3319,3319999,20.531054983401567,36.95468052329315,0.08389952081030427,486.79748463630676,213.1434187889099,495.57678985595703,12354,3233,9121,9121,0,12,3320000.0
3320,3320999,20.53130993483443,36.95642876510282,0.0838903407860635,486.99897170066833,213.20643091201782,495.58959579467773,12360,3236,9124,9124,0,12,3321000.0
3321,3321999,20.532596574968952,36.95899081893982,0.08388421930597723,487.17673110961914,213.27008605003357,495.6524238586426,12364,3238,9126,9126,0,12,3322000.0
3322,3322999,20.533246506324183,36.95915132482309,0.08391669947716351,487.4082353115082,213.33367323875427,495.81535720825195,12371,3241,9130,9130,0,12,3323000.0
3323,3323999,20.534433626255485,36.96123902079987,0.08396449581293763,487.5505096912384,213.3966555595398,496.0407371520996,12371,3241,9130,9130,0,12,3324000.0
3324,3324999,20.535788629267437,36.96325744399007,0.0840244376536965,487.703893661499,213.4596037864685,496.1500434875488,12373,3242,9131,9131,0,12,3325000.0
3325,3325999,20.537235440606498,36.96487947042733,0.08410018509859729,487.8789687156677,213.5229263305664,496.17381286621094,12390,3244,9146,9146,0,12,3326000.0
3326,3326999,20.539353045298984,36.97322872629306,0.08415700261858472,488.04669523239136,213.58655738830566,496.2634811401367,12393,3245,9148,9148,0,12,3327000.0
3327,3327999,20.540847689640437,36.9776064749491,0.08424620816560224,488.2042577266693,213.6508252620697,496.38899993896484,12406,3246,9160,9160,0,12,3328000.0
3328,3328999,20.54297898332057,36.98365386321642,0.08434442447449753,488.3908257484436,213.71473383903503,496.4428825378418,12408,3247,9161,9161,0,12,3329000.0
3329,3329999,20.544826292977866,36.985758644778166,0.08441458431962168,488.5223488807678,213.77772903442383,496.5919494628906,12408,3247,9161,9161,0,12,3330000.0
3330,3330999,20.546942967965293,36.98997007591927,0.08452440879040912,488.68582034111023,213.8409547805786,496.5963821411133,12410,3248,9162,9162,0,12,3331000.0
3331,3331999,20.548812032978308,36.99202182402883,0.08459016451903811,488.8484754562378,213.90457606315613,496.6844139099121,12412,3249,9163,9163,0,12,3332000.0
3332,3332999,20.550972670074376,36.99715538436081,0.08463432461352982,488.9634757041931,213.9674265384674,496.80353927612305,12412,3249,9163,9163,0,12,3333000.0
3333,3333999,20.55241179336922,36.997799137774905,0.08471846582130338,489.125616312027,214.03138399124146,496.9648666381836,12412,3249,9163,9163,0,12,3334000.0
3334,3334999,20.553104241801126,37.00144421308095,0.08473452778341872,489.2510368824005,214.0955147743225,497.598575592041,12428,3249,9179,9179,0,12,3335000.0
3335,3335999,20.551819593327803,36.99991006145274,0.08472263587509365,489.372043132782,214.1587655544281,498.15991592407227,12433,3249,9184,9184,0,12,3336000.0
3336,3336999,20.550216412738287,36.99705123429793,0.08470705473960338,489.49133586883545,214.22117233276367,498.4900588989258,12434,3249,9185,9185,0,12,3337000.0
3337,3337999,20.54855990224391,36.99378429128765,0.08470036387348523,489.6351902484894,214.28392696380615,498.65477752685547,12436,3250,9186,9186,0,12,3338000.0
3338,3338999,20.547384630734086,36.992295632099605,0.0846830640031433,489.9432234764099,214.34776139259338,498.54920196533203,12449,3256,9193,9193,0,12,3339000.0
3339,3339999,20.545743135339656,36.98914223080497,0.0846692562888669,490.1471018791199,214.41118550300598,498.6403579711914,12458,3259,9199,9199,0,12,3340000.0
3340,3340999,20.544475262404667,36.98782671179987,0.08465883537774543,490.36377787590027,214.47475361824036,498.7562484741211,12464,3262,9202,9202,0,12,3341000.0
3341,3341999,20.5430756102737,36.98533299530577,0.08465129914881953,490.5061602592468,214.53926801681519,498.9296989440918,12466,3263,9203,9203,0,12,3342000.0
3342,3342999,20.542187623951058,36.98316469397267,0.08463446074060099,490.65450406074524,214.60218787193298,499.1019973754883,12468,3264,9204,9204,0,12,3343000.0
3343,3343999,20.541979344970255,36.983145302382404,0.08461887779309796,490.8981423377991,214.66649985313416,499.2067451477051,12475,3267,9208,9208,0,12,3344000.0
3344,3344999,20.541850753006898,36.98264285280579,0.0845982186870371,491.02925062179565,214.7296838760376,499.3865776062012,12475,3267,9208,9208,0,12,3345000.0
3345,3345999,20.543085176949464,36.98605807056948,0.08457149168675882,491.1610052585602,214.79275727272034,499.55908584594727,12475,3267,9208,9208,0,12,3346000.0
3346,3346999,20.54527963741998,36.99168035482,0.08454825619795892,491.34471702575684,214.85640454292297,499.5172233581543,12479,3269,9210,9210,0,12,3347000.0
3347,3347999,20.54773707786336,36.996304601066356,0.08453168302387282,491.50028705596924,214.91961526870728,499.64514923095703,12481,3270,9211,9211,0,12,3348000.0
3348,3348999,20.550498045180245,37.001359493592936,0.0845579133447445,491.70653438568115,214.98532581329346,499.71979904174805,12486,3272,9214,9214,0,12,3349000.0
3349,3349999,20.554281092489045,37.00969714335088,0.08458692648880728,491.8360433578491,215.04844069480896,499.9252586364746,12486,3272,9214,9214,0,12,3350000.0
3350,3350999,20.558582993462913,37.01771068471685,0.08465716190269124,491.9618992805481,215.11132907867432,500.1137008666992,12486,3272,9214,9214,0,12,3351000.0
3351,3351999,20.563337798651148,37.0337455792589,0.08465956201631164,492.1499230861664,215.17523670196533,500.1023483276367,12493,3274,9219,9219,0,12,3352000.0
3352,3352999,20.566930470733833,37.04073331889924,0.08467959186665486,492.28189516067505,215.23829412460327,500.2527503967285,12493,3274,9219,9219,0,12,3353000.0
3353,3353999,20.57068021120307,37.04822343374825,0.08470259768449862,492.49712657928467,215.30236053466797,500.2086410522461,12497,3276,9221,9221,0,12,3354000.0
3354,3354999,20.573003670862082,37.0500955921911,0.08474983209810749,492.66333270072937,215.36619114875793,500.27756118774414,12499,3277,9222,9222,0,12,3355000.0
3355,3355999,20.57397464802566,37.050943821895494,0.08475607772472926,492.78531098365784,215.42986798286438,500.80809020996094,12510,3277,9233,9233,0,12,3356000.0
3356,3356999,20.573435858111754,37.04961815578954,0.08472760010387848,492.90803718566895,215.49234580993652,501.4178466796875,12518,3277,9241,9241,0,12,3357000.0
3357,3357999,20.572886085219203,37.05063739907436,0.08469788591860339,493.0416610240936,215.55420970916748,501.7113380432129,12518,3277,9241,9241,0,12,3358000.0
3358,3358999,20.572096198349865,37.049456661453895,0.08468382220596393,493.2077536582947,215.61664533615112,501.77751541137695,12521,3278,9243,9243,0,12,3359000.0
3359,3359999,20.571084507508033,37.046717406667,0.08466466612339685,493.40652894973755,215.67878460884094,501.7594413757324,12527,3281,9246,9246,0,12,3360000.0
3360,3360999,20.57035136320772,37.04434229747265,0.08464325894085867,493.5939996242523,215.74167108535767,501.96883392333984,12531,3283,9248,9248,0,12,3361000.0
3361,3361999,20.570040556560265,37.042847469663855,0.08462457345151042,493.73890829086304,215.80457544326782,502.11149978637695,12533,3284,9249,9249,0,12,3362000.0
3362,3362999,20.569382460996632,37.04069777283318,0.08461560022099612,493.9041609764099,215.8673870563507,502.23033905029297,12535,3285,9250,9250,0,12,3363000.0
3363,3363999,20.569020054215656,37.04068005510389,0.08459338738466726,494.1210343837738,215.93083333969116,502.1529350280762,12542,3288,9254,9254,0,12,3364000.0
3364,3364999,20.568468679657123,37.0393207412111,0.08457160869306835,494.37762808799744,215.99626564979553,502.12194442749023,12551,3292,9259,9259,0,12,3365000.0
3365,3365999,20.568399767594027,37.03823093043131,0.08455558321853784,494.55980229377747,216.05946707725525,502.2195701599121,12555,3294,9261,9261,0,12,3366000.0
3366,3366999,20.569628212709823,37.044979727997806,0.0845142473493169,494.7284896373749,216.12309503555298,502.38745498657227,12557,3295,9262,9262,0,12,3367000.0
3367,3367999,20.572523819218983,37.054747747282306,0.08446078683001512,494.86866903305054,216.1880910396576,502.6329040527344,12557,3295,9262,9262,0,12,3368000.0
3368,3368999,20.576750203698108,37.0631693194626,0.08443634021202107,495.00944328308105,216.25132274627686,502.8004341125488,12557,3295,9262,9262,0,12,3369000.0
3369,3369999,20.581258606820757,37.07513939783398,0.08441795727243118,495.1324167251587,216.31458973884583,502.9704780578613,12558,3295,9263,9263,0,12,3370000.0
3370,3370999,20.588341705304458,37.096018805370925,0.08441107910674761,495.27800846099854,216.3810818195343,503.0989990234375,12558,3295,9263,9263,0,12,3371000.0
3371,3371999,20.59754280390454,37.122113225802494,0.08445895422018801,495.3964173793793,216.44393658638,503.24947357177734,12558,3295,9263,9263,0,12,3372000.0
3372,3372999,20.606719218574376,37.14825109085175,0.08455941987481985,495.61752676963806,216.51160430908203,503.2047233581543,12563,3297,9266,9266,0,12,3373000.0
3373,3373999,20.615508726708946,37.17018429200618,0.08464341006277198,495.75404810905457,216.57601737976074,503.3447036743164,12563,3297,9266,9266,0,12,3374000.0
3374,3374999,20.623821421479377,37.187408875838074,0.08480238340579793,495.9079098701477,216.6389753818512,503.39844512939453,12565,3298,9267,9267,0,12,3375000.0
3375,3375999,20.631550888978417,37.20317173791122,0.08491203153434201,496.041583776474,216.7018346786499,503.52166748046875,12565,3298,9267,9267,0,12,3376000.0
3376,3376999,20.635293334134126,37.210877894072325,0.0849093352416257,496.2384247779846,216.76583981513977,504.113956451416,12591,3300,9291,9291,0,12,3377000.0
3377,3377999,20.63484666491738,37.21099244875142,0.08490188574491753,496.3505733013153,216.82799434661865,504.46925354003906,12591,3300,9291,9291,0,12,3378000.0
3378,3378999,20.634717409158103,37.212012694555284,0.08488331097665658,496.4667634963989,216.89076566696167,504.7394676208496,12591,3300,9291,9291,0,12,3379000.0
3379,3379999,20.63588801902591,37.216384033001496,0.08487851300082616,496.6392583847046,216.95328950881958,504.8517074584961,12595,3302,9293,9293,0,12,3380000.0
3380,3380999,20.63687998981978,37.22341108062868,0.08484893002902938,496.89434695243835,217.01697731018066,504.8312644958496,12604,3306,9298,9298,0,12,3381000.0
3381,3381999,20.637364356762735,37.223587216215805,0.08485477017431775,497.05408453941345,217.08010363578796,505.0248107910156,12606,3307,9299,9299,0,12,3382000.0
3382,3382999,20.638559351156434,37.22546169790935,0.08487400400405032,497.22866320610046,217.14327239990234,505.0901222229004,12610,3309,9301,9301,0,12,3383000.0
3383,3383999,20.639573252108995,37.22609734401355,0.0848940371703093,497.4301047325134,217.20706987380981,505.10465240478516,12615,3311,9304,9304,0,12,3384000.0
3384,3384999,20.640384358423862,37.226723957488765,0.08490347722206881,497.6280584335327,217.2705090045929,505.13948822021484,12620,3313,9307,9307,0,12,3385000.0
3385,3385999,20.640580895182193,37.22643739531126,0.08492422160059632,497.78446555137634,217.33514618873596,505.33232498168945,12623,3314,9309,9309,0,12,3386000.0
3386,3386999,20.641860778932738,37.227447460284196,0.08494488309448922,497.9365978240967,217.39815735816956,505.45423126220703,12625,3315,9310,9310,0,12,3387000.0
3387,3387999,20.642324682516197,37.22655295543906,0.08496667378291833,498.140967130661,217.46183347702026,505.4856719970703,12630,3317,9313,9313,0,12,3388000.0
3388,3388999,20.64345013017365,37.227983424213434,0.08498625978531049,498.268182516098,217.5253562927246,505.6382827758789,12630,3317,9313,9313,0,12,3389000.0
3389,3389999,20.644420487774557,37.22889897633391,0.0850229547861987,498.3981993198395,217.5889105796814,505.7481803894043,12631,3317,9314,9314,0,12,3390000.0
3390,3390999,20.64528843183883,37.228788461944504,0.08504640382699902,498.55310440063477,217.65220475196838,505.80550384521484,12633,3318,9315,9315,0,12,3391000.0
3391,3391999,20.64686262871142,37.23224483363457,0.08506799009926613,498.6969063282013,217.71559953689575,505.9161949157715,12633,3318,9315,9315,0,12,3392000.0
3392,3392999,20.648070603786213,37.23283843041485,0.08509209169358833,498.85692167282104,217.77915024757385,505.9295082092285,12635,3319,9316,9316,0,12,3393000.0
3393,3393999,20.649334933503376,37.233580338063405,0.08510393607411448,498.9826810359955,217.84291076660156,506.0535583496094,12635,3319,9316,9316,0,12,3394000.0
3394,3394999,20.65023363083674,37.233197704630875,0.08511585759394746,499.14243745803833,217.90623950958252,506.16226959228516,12635,3319,9316,9316,0,12,3395000.0
3395,3395999,20.65102813312432,37.23196147936534,0.08515396656010021,499.27272844314575,217.9695122241974,506.232608795166,12635,3319,9316,9316,0,12,3396000.0
3396,3396999,20.65151956621286,37.23301652890426,0.08515663449693978,499.4016959667206,218.03277945518494,506.3059730529785,12635,3319,9316,9316,0,12,3397000.0
3397,3397999,20.65128693142785,37.23578896526814,0.08513046771939825,499.5802638530731,218.0974314212799,507.05300521850586,12660,3320,9340,9340,0,12,3398000.0
3398,3398999,20.649945160801213,37.23559967042135,0.08511195365804336,499.7278530597687,218.16082191467285,507.436767578125,12664,3321,9343,9343,0,12,3399000.0
3399,3399999,20.647843191691408,37.23221168914176,0.08511264641796001,499.9102535247803,218.22390246391296,507.6133689880371,12670,3323,9347,9347,0,12,3400000.0
3400,3400999,20.645853402086203,37.229698169908836,0.08510900456171178,500.0187270641327,218.28630256652832,507.8715019226074,12670,3323,9347,9347,0,12,3401000.0
3401,3401999,20.643722008707662,37.226388316332326,0.08511089014342121,500.1581313610077,218.34952068328857,508.04191970825195,12670,3323,9347,9347,0,12,3402000.0
3402,3402999,20.641868409993165,37.224518642799836,0.08510211049826155,500.3682963848114,218.41264939308167,508.0593605041504,12677,3326,9351,9351,0,12,3403000.0
3403,3403999,20.639722829756654,37.220962421925066,0.08510320312432829,500.52134442329407,218.47587776184082,508.23792266845703,12679,3327,9352,9352,0,12,3404000.0
3404,3404999,20.637501603388575,37.21726089570798,0.08510882522861718,500.7066252231598,218.53901767730713,508.2671775817871,12684,3329,9355,9355,0,12,3405000.0
3405,3405999,20.63521621838138,37.213255585239956,0.08511299081147361,500.9584677219391,218.60302543640137,508.1880989074707,12693,3333,9360,9360,0,12,3406000.0
3406,3406999,20.634084191826215,37.21209929308236,0.08509939811049083,501.15325570106506,218.6667001247406,508.39714431762695,12698,3335,9363,9363,0,12,3407000.0
3407,3407999,20.632982483111846,37.209663876484825,0.08508618272733148,501.3042302131653,218.7307870388031,508.50071716308594,12701,3336,9365,9365,0,12,3408000.0
3408,3408999,20.6318646585851,37.20734789376429,0.08507217924741262,501.4808485507965,218.7959291934967,508.62102127075195,12703,3337,9366,9366,0,12,3409000.0
3409,3409999,20.63167446039352,37.208251648396484,0.08504007271690173,501.62809133529663,218.85914778709412,508.67276763916016,12705,3338,9367,9367,0,12,3410000.0
3410,3410999,20.630999581330908,37.206842053792464,0.08501612095868105,501.75598764419556,218.92243599891663,508.8543167114258,12706,3338,9368,9368,0,12,3411000.0
3411,3411999,20.63130516619412,37.20696080056202,0.08498803273038469,501.8922538757324,218.99057173728943,509.0231018066406,12706,3338,9368,9368,0,12,3412000.0
3412,3412999,20.632522546330375,37.21313877407223,0.08494216307232028,502.02801060676575,219.05416917800903,509.1649627685547,12706,3338,9368,9368,0,12,3413000.0
3413,3413999,20.634790229087148,37.21962768047789,0.08488413595489064,502.19409823417664,219.1183307170868,509.18701934814453,12708,3339,9369,9369,0,12,3414000.0
3414,3414999,20.638248336523084,37.23185836662743,0.0848335077021779,502.449453830719,219.18311429023743,508.93720626831055,12716,3343,9373,9373,0,12,3415000.0
3415,3415999,20.641502106443564,37.23931540145582,0.08484295489099858,502.6492033004761,219.24763345718384,509.0086326599121,12724,3345,9379,9379,0,12,3416000.0
3416,3416999,20.645193507657208,37.24868316816254,0.08482391685781232,502.78685212135315,219.31137919425964,509.2040252685547,12724,3345,9379,9379,0,12,3417000.0
3417,3417999,20.649034312954193,37.2572453420031,0.0848074070381114,502.903932094574,219.3746988773346,509.36258697509766,12724,3345,9379,9379,0,12,3418000.0
3418,3418999,20.65071629915215,37.25975320377521,0.08479423278184806,503.0278432369232,219.43870377540588,510.0558967590332,12743,3345,9398,9398,0,12,3419000.0
3419,3419999,20.649022569309082,37.25875945723229,0.08478325406433884,503.143443107605,219.5020251274109,510.7595520019531,12750,3345,9405,9405,0,12,3420000.0
3420,3420999,20.647093486734597,37.25794199377795,0.08477379181106015,503.26095271110535,219.5651729106903,511.11899185180664,12750,3345,9405,9405,0,12,3421000.0
3421,3421999,20.645641394312584,37.25701003453517,0.08475354891217357,503.4395868778229,219.62850832939148,511.2371253967285,12754,3347,9407,9407,0,12,3422000.0
3422,3422999,20.643588320775134,37.254114249869026,0.0847547308071408,503.65469551086426,219.69147753715515,511.35366439819336,12760,3350,9410,9410,0,12,3423000.0
3423,3423999,20.641829321360113,37.25132676198745,0.08474071005002937,503.76318359375,219.75478339195251,511.6362113952637,12760,3350,9410,9410,0,12,3424000.0
3424,3424999,20.63994442282634,37.24821580579101,0.08473795062607603,503.99739265441895,219.8197295665741,511.7010612487793,12767,3353,9414,9414,0,12,3425000.0
3425,3425999,20.637986555578003,37.24527526747621,0.08473249132918537,504.20586490631104,219.88345098495483,511.747802734375,12773,3356,9417,9417,0,12,3426000.0
3426,3426999,20.6365755064987,37.24359677446355,0.08471646860011683,504.3415243625641,219.94765186309814,511.97465896606445,12773,3356,9417,9417,0,12,3427000.0
3427,3427999,20.635144935532434,37.24085566922916,0.08471304038864658,504.55068159103394,220.0113980770111,511.9801597595215,12778,3358,9420,9420,0,12,3428000.0
3428,3428999,20.634188672375164,37.24282118766642,0.08468387129656962,504.70279455184937,220.0750391483307,512.0931282043457,12780,3359,9421,9421,0,12,3429000.0
3429,3429999,20.6335882606832,37.24147285707331,0.08466938197032059,504.8166038990021,220.13791728019714,512.2776107788086,12780,3359,9421,9421,0,12,3430000.0
3430,3430999,20.632737143459046,37.239652362706536,0.08465562005737204,505.01898527145386,220.21296501159668,512.3381118774414,12782,3360,9422,9422,0,12,3431000.0
3431,3431999,20.632720872772886,37.23946361549764,0.08464077617865373,505.1892023086548,220.27755451202393,512.389820098877,12785,3361,9424,9424,0,12,3432000.0
3432,3432999,20.63365755470187,37.24293350389836,0.08461267108319903,505.3053364753723,220.34093570709229,512.5804786682129,12786,3361,9425,9425,0,12,3433000.0
3433,3433999,20.6347946578664,37.245833273316364,0.08458802849815772,505.4380660057068,220.40417957305908,512.7074165344238,12786,3361,9425,9425,0,12,3434000.0
3434,3434999,20.636202045524673,37.24738433445383,0.08456502261805166,505.5835371017456,220.46736645698547,512.790355682373,12788,3362,9426,9426,0,12,3435000.0
3435,3435999,20.63750818336916,37.24838962148297,0.08455272835688887,505.75445556640625,220.5310308933258,512.8775901794434,12790,3363,9427,9427,0,12,3436000.0
3436,3436999,20.63946624177001,37.25036457433424,0.08454391072393519,505.93321776390076,220.5956904888153,512.9023475646973,12792,3364,9428,9428,0,12,3437000.0
3437,3437999,20.64140903058498,37.254653082813206,0.08453291166561028,506.07261991500854,220.65908432006836,513.0295181274414,12792,3364,9428,9428,0,12,3438000.0
3438,3438999,20.642725848942614,37.25494802608686,0.08454381623515439,506.2285170555115,220.72247672080994,513.1213188171387,12794,3365,9429,9429,0,12,3439000.0
3439,3439999,20.642961834368474,37.253572478995316,0.08454047620889149,506.3675057888031,220.78572010993958,513.3102836608887,12794,3365,9429,9429,0,12,3440000.0
3440,3440999,20.64147873744179,37.2509033308426,0.08453166045580995,506.4936866760254,220.85015606880188,514.4577903747559,12821,3365,9456,9456,0,12,3441000.0
3441,3441999,20.63935595316396,37.24733639468453,0.0845399321914051,506.6066834926605,220.91253280639648,514.8923873901367,12822,3365,9457,9457,0,12,3442000.0
3442,3442999,20.637153373937693,37.24375629360199,0.08455139874785467,506.75811862945557,220.9763219356537,515.1076507568359,12824,3366,9458,9458,0,12,3443000.0
3443,3443999,20.63496084638165,37.24024650500377,0.08455668252804005,506.9275698661804,221.03930473327637,515.233325958252,12828,3368,9460,9460,0,12,3444000.0
3444,3444999,20.63305473105149,37.23777591910234,0.08455183570170444,507.1037817001343,221.1019411087036,515.3775444030762,12832,3370,9462,9462,0,12,3445000.0
3445,3445999,20.631271828286163,37.235985099468394,0.08454348040778381,507.3357996940613,221.170068025589,515.462516784668,12839,3373,9466,9466,0,12,3446000.0
3446,3446999,20.629288996584595,37.2330281880777,0.08454134401447921,507.55391120910645,221.23385548591614,515.5819091796875,12845,3376,9469,9469,0,12,3447000.0
3447,3447999,20.627386206573522,37.23225974964583,0.08453532428707711,507.7337381839752,221.2969572544098,515.6607360839844,12849,3378,9471,9471,0,12,3448000.0
3448,3448999,20.6260848956306,37.234114234911225,0.08451158144289483,507.9762899875641,221.36075949668884,515.7331619262695,12860,3382,9478,9478,0,12,3449000.0
3449,3449999,20.62463379923893,37.23284597041303,0.0845020067525657,508.1141777038574,221.42501306533813,515.9619178771973,12860,3382,9478,9478,0,12,3450000.0
3450,3450999,20.6234969424947,37.23611267623196,0.08447074091801188,508.29393196105957,221.4881410598755,515.9924964904785,12864,3384,9480,9480,0,12,3451000.0
3451,3451999,20.622163672862563,37.23357874499768,0.08446553499881759,508.44789576530457,221.5518283843994,516.1528739929199,12866,3385,9481,9481,0,12,3452000.0
3452,3452999,20.62090768805194,37.23132210058771,0.08446295967245243,508.5785622596741,221.6164584159851,516.3267021179199,12867,3385,9482,9482,0,12,3453000.0
3453,3453999,20.61998421052604,37.229204950848015,0.0844553554475369,508.712543964386,221.67953181266785,516.4858665466309,12867,3385,9482,9482,0,12,3454000.0
3454,3454999,20.618743582673357,37.22641355674372,0.08445203477374386,508.86089038848877,221.7428011894226,516.6504173278809,12867,3385,9482,9482,0,12,3455000.0
3455,3455999,20.6174141278169,37.22334369156449,0.08444980832304771,508.975145816803,221.8056619167328,516.782283782959,12867,3385,9482,9482,0,12,3456000.0
3456,3456999,20.616068786544066,37.220539700881744,0.0844537605822,509.1172995567322,221.869647026062,516.9179000854492,12867,3385,9482,9482,0,12,3457000.0
3457,3457999,20.614896280554902,37.21750385535324,0.08445727929493274,509.2490532398224,221.93278050422668,517.0364227294922,12867,3385,9482,9482,0,12,3458000.0
3458,3458999,20.613627196276287,37.21468486151723,0.08445117822964054,509.38429379463196,221.99644303321838,517.445182800293,12878,3385,9493,9493,0,12,3459000.0
3459,3459999,20.611685933126758,37.2123370065156,0.08445439604317284,509.4936616420746,222.05964255332947,518.386547088623,12894,3385,9509,9509,0,12,3460000.0
3460,3460999,20.610104616052237,37.21310915021362,0.08444472729752672,509.6120774745941,222.12222361564636,518.7976036071777,12895,3385,9510,9510,0,12,3461000.0
3461,3461999,20.607964681736192,37.21008347887859,0.08446029520854947,509.7310757637024,222.18445014953613,519.0490646362305,12895,3385,9510,9510,0,12,3462000.0
3462,3462999,20.605762936835028,37.206482682484015,0.08446797257458538,509.97953510284424,222.2481164932251,519.0874176025391,12905,3389,9516,9516,0,12,3463000.0
3463,3463999,20.6042099560018,37.205576639896854,0.08445670548165918,510.1264922618866,222.31175351142883,519.3607139587402,12907,3390,9517,9517,0,12,3464000.0
3464,3464999,20.602298638864127,37.2029698526514,0.0844562300837306,510.3649911880493,222.3754951953888,519.3996696472168,12915,3394,9521,9521,0,12,3465000.0
3465,3465999,20.600438322371197,37.200452656502605,0.08445277739623935,510.5206780433655,222.438738822937,519.628490447998,12917,3395,9522,9522,0,12,3466000.0
3466,3466999,20.59893161924578,37.197935828863926,0.08444477753121749,510.76354217529297,222.50260734558105,519.5709419250488,12928,3399,9529,9529,0,12,3467000.0
3467,3467999,20.597613045538274,37.195370589531464,0.08443727510100019,510.91197395324707,222.56600856781006,519.8572959899902,12929,3399,9530,9530,0,12,3468000.0
3468,3468999,20.59621112699627,37.19286374642492,0.0844270103233058,511.0319094657898,222.62889051437378,520.062198638916,12929,3399,9530,9530,0,12,3469000.0
3469,3469999,20.595563010508553,37.195362298814175,0.08438988479202625,511.1613793373108,222.6931710243225,520.1936187744141,12929,3399,9530,9530,0,12,3470000.0
3470,3470999,20.594965329343736,37.19527833197857,0.08436661907123932,511.33869767189026,222.7563920021057,520.2408638000488,12933,3401,9532,9532,0,12,3471000.0
3471,3471999,20.594354741317062,37.193884816383274,0.08434558114252522,511.5028305053711,222.82151865959167,520.3884391784668,12965,3402,9563,9563,0,12,3472000.0
3472,3472999,20.5939336972005,37.19195535097596,0.08433076476078172,511.6570246219635,222.88499355316162,520.5378074645996,12965,3402,9563,9563,0,12,3473000.0
3473,3473999,20.593422309059118,37.190402129288834,0.08431446766124673,511.7812066078186,222.94766783714294,520.6729621887207,12965,3402,9563,9563,0,12,3474000.0
3474,3474999,20.593240504721535,37.189427097971404,0.08429840308645253,511.90818190574646,223.0105686187744,520.7982711791992,12965,3402,9563,9563,0,12,3475000.0
3475,3475999,20.593536122153207,37.189295996357686,0.08427552440311503,512.0414514541626,223.07355618476868,520.8897132873535,12965,3402,9563,9563,0,12,3476000.0
3476,3476999,20.593684227406758,37.188228838217235,0.08425888923944991,512.2490017414093,223.13707518577576,520.856388092041,12969,3404,9565,9565,0,12,3477000.0
3477,3477999,20.593850637382292,37.18719820768215,0.0842440734211024,512.3834025859833,223.20035576820374,520.9795684814453,12969,3404,9565,9565,0,12,3478000.0
3478,3478999,20.59340741715556,37.18516141348543,0.0842317047601181,512.5010142326355,223.26354598999023,521.1162109375,12969,3404,9565,9565,0,12,3479000.0
3479,3479999,20.59218672310889,37.182959844363374,0.08420482855206668,512.6139807701111,223.327467918396,522.148307800293,12994,3404,9590,9590,0,12,3480000.0
3480,3480999,20.589793660066782,37.17930045927641,0.08420736787238037,512.7247996330261,223.38966870307922,522.5978393554688,12994,3404,9590,9590,0,12,3481000.0
3481,3481999,20.587812051873527,37.17642829664085,0.08420161552764371,512.842367887497,223.45197343826294,522.918643951416,12995,3404,9591,9591,0,12,3482000.0
3482,3482999,20.58636140465599,37.17473379965931,0.08418932329966411,513.0135238170624,223.51476454734802,523.0608062744141,12999,3406,9593,9593,0,12,3483000.0
3483,3483999,20.584647845462726,37.173869246344715,0.08417216598821897,513.2868883609772,223.57847666740417,523.1023101806641,13009,3411,9598,9598,0,12,3484000.0
3484,3484999,20.583446187854936,37.17284430601964,0.08415589829181025,513.4424381256104,223.64138555526733,523.3694343566895,13011,3412,9599,9599,0,12,3485000.0
3485,3485999,20.5824192058072,37.17070033242418,0.08414807201672891,513.5670962333679,223.70449566841125,523.646842956543,13011,3412,9599,9599,0,12,3486000.0
3486,3486999,20.5824789065066,37.171120502741466,0.08412360225277893,513.8013336658478,223.76777172088623,523.5534286499023,13019,3416,9603,9603,0,12,3487000.0
3487,3487999,20.583180756733643,37.17212131905172,0.08410981454576727,513.9670400619507,223.83157062530518,523.7676467895508,13021,3417,9604,9604,0,12,3488000.0
3488,3488999,20.584645784070407,37.17542653631382,0.08411406827460988,514.1950619220734,223.896333694458,523.882869720459,13028,3420,9608,9608,0,12,3489000.0
3489,3489999,20.58728502532535,37.181960450937765,0.08411178310937706,514.3204715251923,223.95935940742493,524.1121559143066,13028,3420,9608,9608,0,12,3490000.0
3490,3490999,20.590547974766203,37.188460582720126,0.08413597548426044,514.5221455097198,224.0232231616974,524.1915664672852,13032,3422,9610,9610,0,12,3491000.0
3491,3491999,20.594747624199904,37.19605326012464,0.08422504152653643,514.7024254798889,224.0871798992157,524.3050842285156,13036,3424,9612,9612,0,12,3492000.0
3492,3492999,20.599667028139724,37.20449713581018,0.08432160384187326,514.8574562072754,224.15098905563354,524.3975524902344,13039,3425,9614,9614,0,12,3493000.0
3493,3493999,20.604573885801422,37.21242214294318,0.08441415194238155,514.9810361862183,224.2148163318634,524.6321640014648,13039,3425,9614,9614,0,12,3494000.0
3494,3494999,20.610945884649308,37.225137251156035,0.08456314288638522,515.1389045715332,224.27953267097473,524.8107528686523,13041,3426,9615,9615,0,12,3495000.0
3495,3495999,20.61794770451748,37.238059915095505,0.08478331870420819,515.3532133102417,224.34357595443726,524.7566413879395,13047,3429,9618,9618,0,12,3496000.0
3496,3496999,20.624242511664928,37.249267420505774,0.08500119157111219,515.5948603153229,224.40825390815735,524.6542434692383,13055,3433,9622,9622,0,12,3497000.0
3497,3497999,20.62880723195073,37.25808935654935,0.08516758591082829,515.7560427188873,224.47442507743835,524.818431854248,13058,3434,9624,9624,0,12,3498000.0
3498,3498999,20.6345798361701,37.26685326486843,0.08539104925397001,515.8888740539551,224.539128780365,525.0432624816895,13058,3434,9624,9624,0,12,3499000.0
3499,3499999,20.638950249763134,37.27452397891709,0.08559196313864914,516.0411620140076,224.60283279418945,525.2462272644043,13060,3435,9625,9625,0,12,3500000.0
3500,3500999,20.63764069813868,37.27277549954785,0.08557430686996592,516.2279868125916,224.66839170455933,526.1349830627441,13090,3437,9653,9653,0,12,3501000.0
3501,3501999,20.636109845598583,37.27118304001104,0.08556029429886791,516.3976204395294,224.73087787628174,526.4495582580566,13098,3439,9659,9659,0,12,3502000.0
3502,3502999,20.635234726148678,37.27052097900225,0.08554840082017434,516.5372207164764,224.79338335990906,526.7303085327148,13100,3440,9660,9660,0,12,3503000.0
3503,3503999,20.63439799391002,37.26951950929129,0.08553326183085685,516.7207255363464,224.85735321044922,526.8848838806152,13104,3442,9662,9662,0,12,3504000.0
3504,3504999,20.63311804084202,37.26798545440057,0.08552110243335542,516.9668338298798,224.92138504981995,526.9809532165527,13116,3446,9670,9670,0,12,3505000.0
3505,3505999,20.632192195946075,37.26606523629197,0.08551660858406551,517.2044978141785,224.98535180091858,527.0459518432617,13124,3450,9674,9674,0,12,3506000.0
3506,3506999,20.631541047205364,37.26742874551219,0.08548965246523599,517.3959929943085,225.05375027656555,527.2290649414062,13128,3452,9676,9676,0,12,3507000.0
3507,3507999,20.631101115972314,37.26709526239903,0.08548400431617564,517.6448373794556,225.11800265312195,527.3614616394043,13136,3456,9680,9680,0,12,3508000.0
3508,3508999,20.630613838675824,37.26607317786483,0.08549104408338015,517.8445136547089,225.1824460029602,527.5988121032715,13141,3458,9683,9683,0,12,3509000.0
3509,3509999,20.632480552688634,37.27263996546533,0.08552314248174353,517.9989361763,225.24628686904907,527.8229141235352,13143,3459,9684,9684,0,12,3510000.0
3510,3510999,20.635733866212377,37.283137725886746,0.08557107728840174,518.1245973110199,225.30950284004211,528.0955696105957,13143,3459,9684,9684,0,12,3511000.0
3511,3511999,20.640977262771,37.30044293545664,0.08575949774625491,518.2681736946106,225.37313318252563,528.2125854492188,13145,3460,9685,9685,0,12,3512000.0
3512,3512999,20.645782610945854,37.312615601602715,0.08584314519513736,518.4306755065918,225.43662405014038,528.3391609191895,13148,3461,9687,9687,0,12,3513000.0
3513,3513999,20.651460411565804,37.327950776698465,0.08593479424215555,518.5955648422241,225.50145721435547,528.5245475769043,13150,3462,9688,9688,0,12,3514000.0
3514,3514999,20.656885348739454,37.34731313611111,0.08599901288694389,518.7704377174377,225.57276129722595,528.6574783325195,13153,3463,9690,9690,0,12,3515000.0
3515,3515999,20.661510905629118,37.356246490651884,0.08609147976289722,518.8959255218506,225.63648128509521,528.8509330749512,13153,3463,9690,9690,0,12,3516000.0
3516,3516999,20.666808945713555,37.36726785743807,0.08619677144674509,519.0600526332855,225.70039415359497,528.9981422424316,13155,3464,9691,9691,0,12,3517000.0
3517,3517999,20.67172619940697,37.376928724012245,0.08630442353065804,519.2588677406311,225.76451015472412,529.016429901123,13159,3466,9693,9693,0,12,3518000.0
3518,3518999,20.676092097693733,37.383923911854716,0.08637703076549319,519.420526266098,225.8289954662323,529.1651954650879,13161,3467,9694,9694,0,12,3519000.0
3519,3519999,20.679096870424353,37.38728787139927,0.08642888330573317,519.5465948581696,225.89245223999023,529.348934173584,13161,3467,9694,9694,0,12,3520000.0
3520,3520999,20.67905383952139,37.38704548765896,0.0863998447402049,519.7335097789764,225.95713901519775,530.119312286377,13192,3469,9723,9723,0,12,3521000.0
3521,3521999,20.67807435838792,37.386274604979334,0.08638684954187092,519.8447263240814,226.0200834274292,530.5675468444824,13192,3469,9723,9723,0,12,3522000.0
3522,3522999,20.67743983038186,37.386617549139096,0.08636949848023079,519.9545092582703,226.0827353000641,530.8258247375488,13192,3469,9723,9723,0,12,3523000.0
3523,3523999,20.67733990428438,37.389404873124455,0.08635030055600712,520.1364741325378,226.1457977294922,530.9735870361328,13196,3471,9725,9725,0,12,3524000.0
3524,3524999,20.6766888417787,37.38788288440471,0.08634268131045197,520.3827767372131,226.20952820777893,530.9565849304199,13209,3475,9734,9734,0,12,3525000.0
3525,3525999,20.676400347636207,37.38726531340468,0.08633469072699196,520.5383434295654,226.2727301120758,531.1867637634277,13211,3476,9735,9735,0,12,3526000.0
3526,3526999,20.675744023139107,37.385359791554066,0.08632404708221375,520.7933449745178,226.33715867996216,531.1853637695312,13220,3480,9740,9740,0,12,3527000.0
3527,3527999,20.67516288329062,37.38393895918381,0.08633616632804642,520.9915471076965,226.40128183364868,531.3524475097656,13224,3482,9742,9742,0,12,3528000.0
3528,3528999,20.675539019831522,37.38575223762713,0.08633229950720278,521.2190456390381,226.4660587310791,531.3558387756348,13230,3485,9745,9745,0,12,3529000.0
3529,3529999,20.678113319584902,37.39464360187416,0.08632683125010265,521.3899302482605,226.53097939491272,531.5961265563965,13233,3486,9747,9747,0,12,3530000.0
3530,3530999,20.681122053226904,37.40221704602018,0.08636370094270795,521.5440363883972,226.59621405601501,531.7803649902344,13235,3487,9748,9748,0,12,3531000.0
3531,3531999,20.686201726358334,37.417928067039234,0.08640073768306367,521.7068543434143,226.66022109985352,531.8928260803223,13237,3488,9749,9749,0,12,3532000.0
3532,3532999,20.69295733623123,37.43612958019507,0.08642561891054168,521.8665704727173,226.724276304245,532.059154510498,13239,3489,9750,9750,0,12,3533000.0
3533,3533999,20.700946565843953,37.4601190309171,0.08649885476796626,522.0855085849762,226.78844141960144,532.019287109375,13246,3492,9754,9754,0,12,3534000.0
3534,3534999,20.710696640643928,37.4918892020334,0.08660016271363724,522.249276638031,226.85432982444763,532.1854095458984,13248,3493,9755,9755,0,12,3535000.0
3535,3535999,20.722421246952678,37.533189739914725,0.08672492255968611,522.3888735771179,226.91869497299194,532.3788070678711,13248,3493,9755,9755,0,12,3536000.0
3536,3536999,20.73400790394335,37.56923538823462,0.0869505350810923,522.5432794094086,226.98251223564148,532.5157012939453,13250,3494,9756,9756,0,12,3537000.0
3537,3537999,20.74591639651917,37.60151826966817,0.08725144346429803,522.6975898742676,227.04663681983948,532.6411743164062,13252,3495,9757,9757,0,12,3538000.0
3538,3538999,20.758699633802806,37.632839643664894,0.08766434016989932,522.8980660438538,227.11294198036194,532.6645774841309,13256,3497,9759,9759,0,12,3539000.0
3539,3539999,20.765085956373024,37.64506603919272,0.08778470146322959,523.0767638683319,227.17867255210876,533.2468910217285,13279,3498,9781,9781,0,12,3540000.0
3540,3540999,20.76426947882478,37.64484872750262,0.08776269649985002,523.1884379386902,227.24269247055054,534.1149368286133,13290,3498,9792,9792,0,12,3541000.0
3541,3541999,20.764040036232583,37.648543831622966,0.08773839131555183,523.3088254928589,227.30646085739136,534.544246673584,13291,3498,9793,9793,0,12,3542000.0
3542,3542999,20.764613458057074,37.65126856767538,0.08771320460494558,523.4156649112701,227.3685965538025,534.8084716796875,13291,3498,9793,9793,0,12,3543000.0
3543,3543999,20.765177317991665,37.653242114612574,0.08768601764909878,523.6294848918915,227.43187022209167,534.8962364196777,13297,3501,9796,9796,0,12,3544000.0
3544,3544999,20.765933714956475,37.65618606224638,0.0876645863887957,523.8106112480164,227.4950830936432,535.0347023010254,13301,3503,9798,9798,0,12,3545000.0
3545,3545999,20.76584818425145,37.65522554444723,0.08765831419649406,524.0044643878937,227.55913734436035,535.259464263916,13305,3505,9800,9800,0,12,3546000.0
3546,3546999,20.766506654908984,37.65678678747485,0.08764233373340102,524.2136204242706,227.6321074962616,535.3924217224121,13309,3507,9802,9802,0,12,3547000.0
3547,3547999,20.767415471152052,37.65802102256508,0.08762456343809633,524.3465330600739,227.69574999809265,535.5852699279785,13309,3507,9802,9802,0,12,3548000.0
3548,3548999,20.769102218355528,37.66134086517941,0.08761560398972157,524.5416493415833,227.75948691368103,535.6454658508301,13314,3509,9805,9805,0,12,3549000.0
3549,3549999,20.771301196941078,37.66448851387694,0.08760605197702731,524.6802186965942,227.82318091392517,535.8296966552734,13314,3509,9805,9805,0,12,3550000.0
3550,3550999,20.774054735434373,37.67222298306654,0.08759437610374254,524.8123960494995,227.88647842407227,536.0038070678711,13314,3509,9805,9805,0,12,3551000.0
3551,3551999,20.778148165716544,37.68175904032691,0.08759793584185915,524.9370827674866,227.94958782196045,536.1330718994141,13314,3509,9805,9805,0,12,3552000.0
3552,3552999,20.782523718899505,37.69021348409791,0.08763473657150433,525.0599844455719,228.01366353034973,536.2543182373047,13315,3509,9806,9806,0,12,3553000.0
3553,3553999,20.78726200944469,37.70046316058204,0.08767415676711132,525.2002594470978,228.07709789276123,536.3927116394043,13315,3509,9806,9806,0,12,3554000.0
3554,3554999,20.79293461487546,37.717498973982146,0.08772009855734952,525.3251175880432,228.14020991325378,536.5321464538574,13315,3509,9806,9806,0,12,3555000.0
3555,3555999,20.800435725224478,37.7354008897304,0.08780352352100518,525.4861578941345,228.20345258712769,536.6037673950195,13317,3510,9807,9807,0,12,3556000.0
3556,3556999,20.807676743699737,37.75570067147912,0.08789541045575011,525.7377908229828,228.26729321479797,536.3159637451172,13325,3514,9811,9811,0,12,3557000.0
3557,3557999,20.81386755629319,37.77019917210551,0.0880029643207556,525.9697847366333,228.33158469200134,536.3607597351074,13330,3516,9814,9814,0,12,3558000.0
3558,3558999,20.82356017119057,37.79566446754253,0.08819340806340004,526.0885820388794,228.39487624168396,536.5474700927734,13330,3516,9814,9814,0,12,3559000.0
3559,3559999,20.830690683556703,37.80954678807899,0.0883365099425073,526.2457611560822,228.4582142829895,536.730541229248,13332,3517,9815,9815,0,12,3560000.0
3560,3560999,20.830609016718416,37.810462082426845,0.08830123833884906,526.3654820919037,228.52309274673462,537.8791580200195,13359,3517,9842,9842,0,12,3561000.0
3561,3561999,20.82959728383722,37.811061530302695,0.08827025461091909,526.4859642982483,228.58540678024292,538.2650108337402,13359,3517,9842,9842,0,12,3562000.0
3562,3562999,20.829010907066575,37.81121868677289,0.08825318607738009,526.6325371265411,228.64866948127747,538.4548225402832,13361,3518,9843,9843,0,12,3563000.0
3563,3563999,20.828909063348586,37.81834232006263,0.08820386809038538,526.7760851383209,228.7108654975891,538.6486473083496,13363,3519,9844,9844,0,12,3564000.0
3564,3564999,20.828167149013726,37.81696153751383,0.08818512469566342,526.9571239948273,228.77422165870667,538.8534812927246,13367,3521,9846,9846,0,12,3565000.0
3565,3565999,20.82784455694589,37.815724670128695,0.08816322538981913,527.1515288352966,228.83836770057678,538.9437408447266,13371,3523,9848,9848,0,12,3566000.0
3566,3566999,20.82695280796682,37.81540102980428,0.08813625882650367,527.379106760025,228.9067530632019,538.9708290100098,13377,3526,9851,9851,0,12,3567000.0
3567,3567999,20.826478382640694,37.81343984576181,0.0881273015174685,527.5737297534943,228.97039437294006,539.0945205688477,13381,3528,9853,9853,0,12,3568000.0
3568,3568999,20.82594063794,37.811576983571335,0.08811606467785227,527.7838110923767,229.0353319644928,539.1818199157715,13388,3531,9857,9857,0,12,3569000.0
3569,3569999,20.82641540385349,37.81381712559388,0.08808918809304811,527.9067850112915,229.09859704971313,539.445728302002,13388,3531,9857,9857,0,12,3570000.0
3570,3570999,20.82657566192415,37.812892705373066,0.0880781164217429,528.070417881012,229.1627779006958,539.5735206604004,13390,3532,9858,9858,0,12,3571000.0
3571,3571999,20.826682211742717,37.81206703630574,0.08806593366966198,528.2224309444427,229.22606468200684,539.617618560791,13392,3533,9859,9859,0,12,3572000.0
3572,3572999,20.828064162057156,37.815882361324114,0.08805308793543243,528.3538303375244,229.29055666923523,539.7909698486328,13392,3533,9859,9859,0,12,3573000.0
3573,3573999,20.830043040580318,37.820912016302685,0.08805122051024694,528.534411907196,229.35419631004333,539.8377952575684,13395,3534,9861,9861,0,12,3574000.0
3574,3574999,20.832184088795056,37.82420800601459,0.0880651514545715,528.6632838249207,229.41743803024292,540.0148429870605,13395,3534,9861,9861,0,12,3575000.0
3575,3575999,20.8346336282266,37.82633059102877,0.08810411071012902,528.794549703598,229.4809968471527,540.1831970214844,13395,3534,9861,9861,0,12,3576000.0
3576,3576999,20.838034214326616,37.83425935995488,0.0881362056402637,528.9404089450836,229.54423713684082,540.3154525756836,13395,3534,9861,9861,0,12,3577000.0
3577,3577999,20.841638694644466,37.83958537432933,0.08819701577446148,529.070925951004,229.6076943874359,540.3904724121094,13395,3534,9861,9861,0,12,3578000.0
3578,3578999,20.84434281969626,37.84279680415105,0.08823886611190512,529.2312388420105,229.67276263237,540.4012413024902,13397,3535,9862,9862,0,12,3579000.0
3579,3579999,20.848123119765763,37.84791455589731,0.08831524052552853,529.360280752182,229.7360019683838,540.5159339904785,13397,3535,9862,9862,0,12,3580000.0
3580,3580999,20.850554053890612,37.8529442578065,0.08835981419424488,529.4950766563416,229.79962611198425,540.6594924926758,13397,3535,9862,9862,0,12,3581000.0
3581,3581999,20.84964786923022,37.850667600877664,0.08835156579797143,529.61887383461,229.8643035888672,541.7521476745605,13423,3535,9888,9888,0,12,3582000.0
3582,3582999,20.84777883751027,37.84802378230101,0.08835061849885839,529.760556936264,229.92720341682434,542.1646766662598,13425,3536,9889,9889,0,12,3583000.0
3583,3583999,20.846076116560305,37.84603799786063,0.08835236816809233,529.9706432819366,229.99018263816833,542.2998313903809,13457,3539,9918,9918,0,12,3584000.0
3584,3584999,20.844437649434035,37.84323395294683,0.08834903793988802,530.1536846160889,230.05379128456116,542.5273704528809,13461,3541,9920,9920,0,12,3585000.0
3585,3585999,20.843254696161505,37.842578015606016,0.08833341400579398,530.2797713279724,230.1164791584015,542.7985305786133,13461,3541,9920,9920,0,12,3586000.0
3586,3586999,20.842302585438734,37.840857960150394,0.08832289203793875,530.460878610611,230.17925095558167,542.9305419921875,13465,3543,9922,9922,0,12,3587000.0
3587,3587999,20.840883590714597,37.83854412779509,0.08831955924477342,530.6497683525085,230.24354457855225,543.0541496276855,13469,3545,9924,9924,0,12,3588000.0
3588,3588999,20.84009173182387,37.83801046736085,0.08830670535354745,530.7901298999786,230.30615234375,543.213752746582,13471,3546,9925,9925,0,12,3589000.0
3589,3589999,20.839369056268037,37.836263337056,0.08830364860945106,531.0264737606049,230.37010025978088,543.2048263549805,13476,3548,9928,9928,0,12,3590000.0
3590,3590999,20.839331321084263,37.83973744500287,0.08828326748559456,531.1467144489288,230.43409085273743,543.4268035888672,13476,3548,9928,9928,0,12,3591000.0
3591,3591999,20.839844364827716,37.84005429538118,0.08827950128998863,531.2971711158752,230.49744081497192,543.499340057373,13478,3549,9929,9929,0,12,3592000.0
3592,3592999,20.840504611041165,37.8401604634779,0.08828922746345913,531.4912467002869,230.56165289878845,543.5347480773926,13482,3551,9931,9931,0,12,3593000.0
3593,3593999,20.841702145243918,37.84094082061763,0.0883117030218874,531.6196279525757,230.62453031539917,543.7074012756348,13483,3551,9932,9932,0,12,3594000.0
3594,3594999,20.842381461298594,37.84379111683019,0.08831145627934733,531.7587819099426,230.68746995925903,543.857234954834,13483,3551,9932,9932,0,12,3595000.0
3595,3595999,20.844029289093754,37.85036806909574,0.08832955972236345,531.8913714885712,230.7501266002655,544.021125793457,13483,3551,9932,9932,0,12,3596000.0
3596,3596999,20.84546772794426,37.854159640391224,0.08834214920174044,532.0174124240875,230.81302046775818,544.1308479309082,13483,3551,9932,9932,0,12,3597000.0
3597,3597999,20.846434854120155,37.855066036130744,0.08835229109062792,532.3032188415527,230.8770775794983,543.8965682983398,13493,3556,9937,9937,0,12,3598000.0
3598,3598999,20.847657569540473,37.856410256258705,0.08837413109706005,532.4583961963654,230.95002460479736,544.1078186035156,13493,3556,9937,9937,0,12,3599000.0
3599,3599999,20.850129593378934,37.85914952912074,0.08840400859868525,532.618870973587,231.01297879219055,544.3089866638184,13496,3557,9939,9939,0,12,3600000.0
3600,3600999,20.84891392020552,37.8575025777795,0.0883939124737042,532.800311088562,231.0858404636383,544.7238807678223,13503,3559,9944,9944,0,12,3601000.0
3601,3601999,20.847134027612324,37.85618515664447,0.08839021649358136,532.9895069599152,231.14661145210266,545.1976509094238,13522,3561,9961,9961,0,12,3602000.0
3602,3602999,20.84552184439553,37.853303278205495,0.08839152535955652,533.1010046005249,231.20813393592834,545.665210723877,13524,3561,9963,9963,0,12,3603000.0
3603,3603999,20.844032803348018,37.85144243010665,0.08838421982599698,533.2199482917786,231.26873636245728,545.9694137573242,13526,3561,9965,9965,0,12,3604000.0
3604,3604999,20.84290834324058,37.8495749441341,0.08837899474176358,533.3350200653076,231.32930374145508,546.1963386535645,13526,3561,9965,9965,0,12,3605000.0
3605,3605999,20.841788829819656,37.84827495438033,0.0883695106540644,533.4544651508331,231.38958406448364,546.3690223693848,13526,3561,9965,9965,0,12,3606000.0
3606,3606999,20.840826268876093,37.84792548391097,0.08835371359395239,533.6949107646942,231.45140409469604,546.3098068237305,13533,3564,9969,9969,0,12,3607000.0
3607,3607999,20.84053460639979,37.848015826079084,0.08833188310783358,533.8257279396057,231.5119936466217,546.5279502868652,13533,3564,9969,9969,0,12,3608000.0
3608,3608999,20.840992598388645,37.8491562445803,0.08830741360213223,533.9412009716034,231.57241487503052,546.6978149414062,13533,3564,9969,9969,0,12,3609000.0
3609,3609999,20.84192954059443,37.851913930701556,0.08827888971154141,534.1787798404694,231.63395738601685,546.6483154296875,13539,3567,9972,9972,0,12,3610000.0
3610,3610999,20.84416500353424,37.85662237538032,0.08826797031929468,534.3025138378143,231.69589114189148,546.8196258544922,13539,3567,9972,9972,0,12,3611000.0
3611,3611999,20.84712778989935,37.867097101407246,0.08824991434750329,534.4346542358398,231.75705981254578,546.9463272094727,13539,3567,9972,9972,0,12,3612000.0
3612,3612999,20.851256051838384,37.87748668912717,0.08824435895098337,534.5683324337006,231.8179702758789,547.0709190368652,13540,3567,9973,9973,0,12,3613000.0
3613,3613999,20.854822680566077,37.88739431555227,0.0882272968652934,534.7333786487579,231.87922739982605,547.0935134887695,13543,3568,9975,9975,0,12,3614000.0
3614,3614999,20.86009634899314,37.90615647518175,0.08826821007411034,534.9021565914154,231.9408028125763,547.1344261169434,13545,3569,9976,9976,0,12,3615000.0
3615,3615999,20.864912858606747,37.91665446552177,0.08833804063133577,535.1016047000885,232.00318241119385,547.0786209106445,13549,3571,9978,9978,0,12,3616000.0
3616,3616999,20.869390381927893,37.92860821255189,0.08843133289099414,535.2564678192139,232.06617856025696,547.143741607666,13551,3572,9979,9979,0,12,3617000.0
3617,3617999,20.873548892843562,37.936998099744415,0.088493923917502,535.3950340747833,232.12827563285828,547.2867965698242,13551,3572,9979,9979,0,12,3618000.0
3618,3618999,20.877055521041118,37.94142427446057,0.08856537552102284,535.5213465690613,232.1895308494568,547.4172782897949,13551,3572,9979,9979,0,12,3619000.0
3619,3619999,20.879968118392277,37.946298982445235,0.08869021932299204,535.6994309425354,232.25115489959717,547.5252799987793,13553,3573,9980,9980,0,12,3620000.0
3620,3620999,20.88064395572309,37.94516914940438,0.08864471002514762,535.8617644309998,232.31269025802612,547.7324714660645,13556,3574,9982,9982,0,12,3621000.0
3621,3621999,20.880596925498974,37.944553052864514,0.08862345263522942,535.9948174953461,232.3747043609619,547.8754920959473,13556,3574,9982,9982,0,12,3622000.0
3622,3622999,20.880788671893313,37.944576362505295,0.08860343543809379,536.1052331924438,232.4355068206787,547.9724769592285,13556,3574,9982,9982,0,12,3623000.0
3623,3623999,20.880777169661464,37.943413462427856,0.08859296866984168,536.2525675296783,232.49678373336792,548.0634727478027,13556,3574,9982,9982,0,12,3624000.0
3624,3624999,20.880464649686182,37.94148388326673,0.08858742286917543,536.3843822479248,232.5580837726593,548.1393661499023,13556,3574,9982,9982,0,12,3625000.0
3625,3625999,20.88005676105124,37.9398118720056,0.08858673898562941,536.5201735496521,232.61895537376404,548.2169189453125,13556,3574,9982,9982,0,12,3626000.0
3626,3626999,20.879914900529442,37.93826511918934,0.0885833081458316,536.7201025485992,232.68034505844116,548.0712547302246,13560,3576,9984,9984,0,12,3627000.0
3627,3627999,20.88011261141095,37.937495803601145,0.08858578110145054,536.8781836032867,232.74174571037292,548.1528663635254,13562,3577,9985,9985,0,12,3628000.0
3628,3628999,20.881172549162333,37.93910524909964,0.08860300096404561,537.0503485202789,232.8030867576599,548.1736755371094,13564,3578,9986,9986,0,12,3629000.0
3629,3629999,20.882412888442026,37.94377694788525,0.08862591709558099,537.1963729858398,232.8660159111023,548.2538566589355,13564,3578,9986,9986,0,12,3630000.0
3630,3630999,20.883674582571217,37.94533147610787,0.0886795662868618,537.3200898170471,232.92681336402893,548.3203239440918,13564,3578,9986,9986,0,12,3631000.0
3631,3631999,20.885430614745776,37.947084750027685,0.08872216069225969,537.5304698944092,232.98863005638123,548.2388496398926,13568,3580,9988,9988,0,12,3632000.0
3632,3632999,20.886907586053102,37.94827180115432,0.08875573733056685,537.6798031330109,233.05001187324524,548.2608413696289,13569,3581,9988,9988,0,12,3633000.0
3633,3633999,20.88852571683822,37.95007765854556,0.08882178769873361,537.9267349243164,233.11237144470215,548.0807037353516,13575,3584,9991,9991,0,12,3634000.0
3634,3634999,20.89087044947474,37.9561667036542,0.08886698357878431,538.083863735199,233.1738841533661,548.1541290283203,13577,3585,9992,9992,0,12,3635000.0
3635,3635999,20.89292579589714,37.95753655719765,0.08891562947982234,538.2256488800049,233.23547339439392,548.250602722168,13577,3585,9992,9992,0,12,3636000.0
3636,3636999,20.89488366382646,37.95934987620614,0.0889764005674969,538.3627529144287,233.2971031665802,548.3474617004395,13577,3585,9992,9992,0,12,3637000.0
3637,3637999,20.896158655675137,37.96126650589407,0.08899961528659639,538.4904410839081,233.35945773124695,548.3992767333984,13577,3585,9992,9992,0,12,3638000.0
3638,3638999,20.89795659681617,37.9638245089192,0.08902906068933514,538.6729273796082,233.42129468917847,548.3826904296875,13583,3586,9997,9997,0,12,3639000.0
3639,3639999,20.898829117370557,37.96864581271992,0.0890383247125307,538.7878956794739,233.48237252235413,548.4511299133301,13583,3586,9997,9997,0,12,3640000.0
3640,3640999,20.89914578548501,37.96679841967559,0.08900175128148269,538.9505887031555,233.54389071464539,548.5707969665527,13586,3587,9999,9999,0,12,3641000.0
3641,3641999,20.898718053538087,37.964501211157355,0.08897635563085071,539.0737557411194,233.60552263259888,548.7286491394043,13586,3587,9999,9999,0,12,3642000.0
3642,3642999,20.89801141618889,37.96183756619779,0.08896681765482084,539.2729086875916,233.66735005378723,548.7145004272461,13590,3589,10001,10001,0,12,3643000.0
3643,3643999,20.897730593724464,37.959321460975076,0.08894027897632606,539.4116921424866,233.72908735275269,548.8492317199707,13590,3589,10001,10001,0,12,3644000.0
3644,3644999,20.89723791202369,37.957016945831775,0.0889141848614966,539.5814213752747,233.79070162773132,548.8503150939941,13592,3590,10002,10002,0,12,3645000.0
3645,3645999,20.89694718551139,37.95512999881991,0.08888672749264892,539.7197363376617,233.85366463661194,548.9428520202637,13592,3590,10002,10002,0,12,3646000.0
3646,3646999,20.89622097457544,37.95241911987554,0.08886039651541278,539.8501653671265,233.9152910709381,549.0147438049316,13592,3590,10002,10002,0,12,3647000.0
3647,3647999,20.895701973913315,37.95164749214462,0.0888196458541054,540.0175259113312,233.97697639465332,548.9915046691895,13594,3591,10003,10003,0,12,3648000.0
3648,3648999,20.895313739084653,37.949294894407814,0.08878215846268,540.1550049781799,234.03931188583374,549.0657005310059,13594,3591,10003,10003,0,12,3649000.0
3649,3649999,20.895638002186885,37.94822498878541,0.08871810221769294,540.3265933990479,234.10094690322876,549.0510063171387,13596,3592,10004,10004,0,12,3650000.0
3650,3650999,20.89527076909211,37.94596019339669,0.08866781550641467,540.5035798549652,234.16259503364563,548.9624977111816,13598,3593,10005,10005,0,12,3651000.0
3651,3651999,20.895615075126027,37.94474050204091,0.08861177147032573,540.702677488327,234.2245671749115,548.9018325805664,13602,3595,10007,10007,0,12,3652000.0
3652,3652999,20.895811981635934,37.94349382479587,0.08859435929064363,540.8591253757477,234.28654265403748,548.8986511230469,13608,3596,10012,10012,0,12,3653000.0
3653,3653999,20.896731402637563,37.94391492532406,0.08861489241558596,541.0225954055786,234.34888577461243,548.9300537109375,13610,3597,10013,10013,0,12,3654000.0
3654,3654999,20.89747804005453,37.94316941477716,0.08861900690165248,541.1786224842072,234.4112033843994,548.8682708740234,13616,3598,10018,10018,0,12,3655000.0
3655,3655999,20.898552314014925,37.94399118503445,0.08860923856102221,541.3260612487793,234.47343587875366,548.9418067932129,13616,3598,10018,10018,0,12,3656000.0
3656,3656999,20.89969212845134,37.945755032805835,0.08861756475230476,541.4942893981934,234.53583788871765,548.8902282714844,13619,3599,10020,10020,0,12,3657000.0
3657,3657999,20.900500631642238,37.94661028162698,0.08859599106509553,541.6768572330475,234.59856390953064,548.9047927856445,13621,3600,10021,10021,0,12,3658000.0
3658,3658999,20.90145662527301,37.94787653539998,0.08859190050707366,541.8238880634308,234.66079783439636,548.9783592224121,13621,3600,10021,10021,0,12,3659000.0
3659,3659999,20.901095300287903,37.94593399994216,0.08860826690801471,541.9533338546753,234.72288155555725,549.0664443969727,13621,3600,10021,10021,0,12,3660000.0
3660,3660999,20.90142918745078,37.946238075485724,0.08852097041103646,542.1453578472137,234.78473782539368,549.1934242248535,13633,3602,10031,10031,0,12,3661000.0
3661,3661999,20.90072432253008,37.94441843315039,0.08850906371946976,542.3325107097626,234.8466603755951,549.2395515441895,13637,3604,10033,10033,0,12,3662000.0
3662,3662999,20.89990745495676,37.94272926192039,0.08850774366099667,542.4589610099792,234.908203125,549.3860168457031,13637,3604,10033,10033,0,12,3663000.0
3663,3663999,20.898749943296593,37.939757485324435,0.08850833408166803,542.6191849708557,234.9697926044464,549.4513130187988,13639,3605,10034,10034,0,12,3664000.0
3664,3664999,20.898010710709592,37.93710773699892,0.08850129162884135,542.8217644691467,235.03274703025818,549.4854850769043,13643,3607,10036,10036,0,12,3665000.0
3665,3665999,20.897177042646366,37.93462355375882,0.08849013530165195,543.0223100185394,235.09513306617737,549.524112701416,13647,3609,10038,10038,0,12,3666000.0
3666,3666999,20.89621763715096,37.93190254017478,0.0884836444658329,543.1411364078522,235.15699362754822,549.6704025268555,13647,3609,10038,10038,0,12,3667000.0
3667,3667999,20.89558057106613,37.92989341945099,0.08845943502983078,543.3236465454102,235.21937942504883,549.6825866699219,13653,3610,10043,10043,0,12,3668000.0
3668,3668999,20.895596654864843,37.93348714479102,0.08839915684661859,543.4453725814819,235.2812216281891,549.7894630432129,13653,3610,10043,10043,0,12,3669000.0
3669,3669999,20.895347593599965,37.93156532757463,0.08836446520020313,543.5879435539246,235.34282517433167,549.9033470153809,13653,3610,10043,10043,0,12,3670000.0
3670,3670999,20.89500569697085,37.9293849156028,0.08834322559594376,543.718418598175,235.40469598770142,549.9844818115234,13653,3610,10043,10043,0,12,3671000.0
3671,3671999,20.894728860939832,37.92745055056268,0.08830196105057175,543.8863666057587,235.46705198287964,549.99853515625,13655,3611,10044,10044,0,12,3672000.0
3672,3672999,20.895051413856454,37.92827446294814,0.08825872976940885,544.0254328250885,235.52909088134766,550.0714263916016,13655,3611,10044,10044,0,12,3673000.0
3673,3673999,20.895177775697274,37.9265392356479,0.08823219754179978,544.1448168754578,235.59078931808472,550.1603927612305,13655,3611,10044,10044,0,12,3674000.0
3674,3674999,20.895502551289024,37.92483241918276,0.08819412479817013,544.285774230957,235.65314769744873,550.2207984924316,13655,3611,10044,10044,0,12,3675000.0
3675,3675999,20.895567095692307,37.92327106384883,0.08816749988183825,544.4331257343292,235.71515226364136,550.2742576599121,13655,3611,10044,10044,0,12,3676000.0
3676,3676999,20.895790343829475,37.924768094625364,0.08812750681768144,544.5704426765442,235.7778148651123,550.3388633728027,13655,3611,10044,10044,0,12,3677000.0
3677,3677999,20.89502988245287,37.92188720360379,0.08810577821645627,544.7440955638885,235.83993649482727,550.4855690002441,13663,3612,10051,10051,0,12,3678000.0
3678,3678999,20.89343454341255,37.91880892627464,0.08809670479749498,544.8771476745605,235.9018235206604,550.6596374511719,13663,3612,10051,10051,0,12,3679000.0
3679,3679999,20.89171445238449,37.91559193567793,0.08808957647692517,545.0350966453552,235.96347641944885,550.6983985900879,13665,3613,10052,10052,0,12,3680000.0
3680,3680999,20.89017225512051,37.91251725131738,0.088080754102835,545.202234506607,236.02560663223267,550.7291374206543,13667,3614,10053,10053,0,12,3681000.0
3681,3681999,20.88868002600453,37.90932170084795,0.08807275059692077,545.3646655082703,236.0885305404663,550.819522857666,13669,3615,10054,10054,0,12,3682000.0
3682,3682999,20.887442167175145,37.907511071847225,0.08806435188962525,545.4875314235687,236.15042567253113,550.9247245788574,13669,3615,10054,10054,0,12,3683000.0
3683,3683999,20.885951189969735,37.904274661459674,0.08805121502594404,545.7115938663483,236.21318984031677,550.9103775024414,13673,3617,10056,10056,0,12,3684000.0
3684,3684999,20.88488499275969,37.90192713650091,0.08804304413239306,545.8250787258148,236.27476286888123,551.0069732666016,13673,3617,10056,10056,0,12,3685000.0
3685,3685999,20.883839645856725,37.89951133191847,0.08803056514182417,545.9570090770721,236.33694195747375,551.0807876586914,13673,3617,10056,10056,0,12,3686000.0
3686,3686999,20.883538194520128,37.898694564744524,0.08798755719130591,546.087804555893,236.3988814353943,551.1313705444336,13673,3617,10056,10056,0,12,3687000.0
3687,3687999,20.883129071607936,37.8967853461151,0.08797009549388835,546.2229249477386,236.46098518371582,551.1774253845215,13673,3617,10056,10056,0,12,3688000.0
3688,3688999,20.88347399647912,37.89624063438647,0.08793443996779915,546.3702826499939,236.523015499115,551.2073745727539,13673,3617,10056,10056,0,12,3689000.0
3689,3689999,20.88394311626666,37.89793459656839,0.08791068717872363,546.499073266983,236.58510613441467,551.2447395324707,13673,3617,10056,10056,0,12,3690000.0
3690,3690999,20.88448698697751,37.897945846973336,0.08786888053177833,546.6968533992767,236.6477780342102,551.1276779174805,13677,3619,10058,10058,0,12,3691000.0
3691,3691999,20.885350299821827,37.89846731140065,0.08783210010778741,546.864691734314,236.7102870941162,551.0724487304688,13682,3620,10062,10062,0,12,3692000.0
3692,3692999,20.88640464308392,37.89871075238813,0.08780215282162662,547.0428454875946,236.77449917793274,551.1021957397461,13684,3621,10063,10063,0,12,3693000.0
3693,3693999,20.887815912396533,37.901571389179914,0.08776125139338242,547.1951339244843,236.83779168128967,551.2004661560059,13684,3621,10063,10063,0,12,3694000.0
3694,3694999,20.88861721647326,37.90126147842467,0.08773342795034678,547.3205230236053,236.9001100063324,551.2632369995117,13684,3621,10063,10063,0,12,3695000.0
3695,3695999,20.889487176173827,37.900529299372224,0.08771062239436489,547.455769777298,236.96238040924072,551.311450958252,13684,3621,10063,10063,0,12,3696000.0
3696,3696999,20.88982489990973,37.89963031123904,0.08769664546260925,547.5794858932495,237.0245337486267,551.3596801757812,13684,3621,10063,10063,0,12,3697000.0
3697,3697999,20.889274092743538,37.897726885123696,0.08767858251909222,547.762567281723,237.08681917190552,551.6067390441895,13695,3622,10073,10073,0,12,3698000.0
3698,3698999,20.88727881409763,37.893924631134816,0.087677685653474,547.8770272731781,237.1494264602661,551.8162155151367,13695,3622,10073,10073,0,12,3699000.0
3699,3699999,20.885775416004606,37.891325635791496,0.08767354174216113,548.0354437828064,237.21080541610718,551.8436126708984,13697,3623,10074,10074,0,12,3700000.0
3700,3700999,20.884143270593295,37.88787389579472,0.08767710631313641,548.2351756095886,237.2734353542328,551.7650108337402,13705,3625,10080,10080,0,12,3701000.0
3701,3701999,20.882389802128948,37.88557723827021,0.08767151985107924,548.3981096744537,237.33592987060547,551.8948211669922,13707,3626,10081,10081,0,12,3702000.0
3702,3702999,20.88083541848953,37.88211914744355,0.08767231650932772,548.5331788063049,237.39792013168335,552.0315093994141,13707,3626,10081,10081,0,12,3703000.0
3703,3703999,20.879380535572384,37.87885537219753,0.08766892775686552,548.6949939727783,237.46051740646362,552.0940818786621,13709,3627,10082,10082,0,12,3704000.0
3704,3704999,20.878358116493136,37.87736987166262,0.08766198153938254,548.9048380851746,237.5231909751892,551.9919395446777,13717,3629,10088,10088,0,12,3705000.0
3705,3705999,20.877912620313708,37.87930809815857,0.08763818447000316,549.0336155891418,237.5854458808899,552.1014251708984,13717,3629,10088,10088,0,12,3706000.0
3706,3706999,20.877111439139355,37.8778733891204,0.0876385660338993,549.2047550678253,237.6479811668396,552.1948509216309,13720,3630,10090,10090,0,12,3707000.0
3707,3707999,20.87726378540502,37.878447037324854,0.08763421224913626,549.3738157749176,237.7107288837433,552.2702674865723,13722,3631,10091,10091,0,12,3708000.0
3708,3708999,20.877664504558236,37.87981707803038,0.08761737633893296,549.5407185554504,237.77325439453125,552.3021545410156,13724,3632,10092,10092,0,12,3709000.0
3709,3709999,20.878707625359525,37.88628226209407,0.08758813265344789,549.6991469860077,237.83561897277832,552.3256645202637,13726,3633,10093,10093,0,12,3710000.0
3710,3710999,20.879329671027456,37.886829656124924,0.08758513490196396,549.8711087703705,237.8987112045288,552.3506851196289,13728,3634,10094,10094,0,12,3711000.0
3711,3711999,20.880274678247556,37.888603984479815,0.08756499762820413,549.9942283630371,237.96230340003967,552.4373321533203,13728,3634,10094,10094,0,12,3712000.0
3712,3712999,20.88109959651345,37.88899389895758,0.08754131354157291,550.202064037323,238.02597570419312,552.4111976623535,13732,3636,10096,10096,0,12,3713000.0
3713,3713999,20.88267078558806,37.8925710354308,0.08751704701449647,550.3425307273865,238.08868074417114,552.5127449035645,13732,3636,10096,10096,0,12,3714000.0
3714,3714999,20.883805116619623,37.89362210070992,0.08750908594880602,550.5133395195007,238.15125632286072,552.4724807739258,13738,3637,10101,10101,0,12,3715000.0
3715,3715999,20.88471817202654,37.893714491603056,0.0875091358412049,550.6421785354614,238.21370935440063,552.5710906982422,13738,3637,10101,10101,0,12,3716000.0
3716,3716999,20.885466359129644,37.89363811768196,0.08748868260455755,550.8083367347717,238.276287317276,552.5869903564453,13744,3638,10106,10106,0,12,3717000.0
3717,3717999,20.88507151448539,37.89196448133403,0.0874773425399954,550.9193911552429,238.3382761478424,552.7022552490234,13744,3638,10106,10106,0,12,3718000.0
3718,3718999,20.884047207031703,37.891110072328,0.08746802063130643,551.0428144931793,238.40044593811035,553.2736206054688,13755,3638,10117,10117,0,12,3719000.0
3719,3719999,20.882273114670735,37.88825553565,0.08747198535704448,551.1932611465454,238.46279668807983,553.4975166320801,13761,3639,10122,10122,0,12,3720000.0
3720,3720999,20.880222797947027,37.885007827670336,0.08748038715100193,551.3775265216827,238.52526879310608,553.6227149963379,13765,3641,10124,10124,0,12,3721000.0
3721,3721999,20.87850925953544,37.88209298538126,0.08748923918472507,551.5381970405579,238.58776378631592,553.7712287902832,13767,3642,10125,10125,0,12,3722000.0
3722,3722999,20.876630114611082,37.87883242488664,0.08749471136613451,551.6675527095795,238.65003871917725,553.9505424499512,13767,3642,10125,10125,0,12,3723000.0
3723,3723999,20.875313616079744,37.876600138323056,0.08748760952987844,551.8943779468536,238.7128689289093,553.9470405578613,13773,3645,10128,10128,0,12,3724000.0
3724,3724999,20.87381436482547,37.873768714751385,0.08748346891425318,552.0521287918091,240.85349035263062,554.112361907959,13775,3646,10129,10129,0,12,3725000.0
3725,3725999,20.872361281983114,37.87147652375937,0.08747833707882002,552.2065811157227,240.9164206981659,554.246021270752,13775,3646,10129,10129,0,12,3726000.0
3726,3726999,20.871571434322213,37.87034190294491,0.08746432754309186,552.3456828594208,240.97905111312866,554.4216423034668,13776,3646,10130,10130,0,12,3727000.0
3727,3727999,20.87059115012093,37.86810618726124,0.08744904037918733,552.5102324485779,241.04313158988953,554.4225845336914,13779,3647,10132,10132,0,12,3728000.0
3728,3728999,20.869566027145197,37.86579673671988,0.08744185580969599,552.6245634555817,241.1056900024414,554.5282745361328,13779,3647,10132,10132,0,12,3729000.0
3729,3729999,20.86916179775532,37.86467781678352,0.0874261640306997,552.7948703765869,241.16888403892517,554.6084594726562,13781,3648,10133,10133,0,12,3730000.0
3730,3730999,20.868586728427104,37.86247222473892,0.08741569326886778,552.9313268661499,241.23206615447998,554.692497253418,13781,3648,10133,10133,0,12,3731000.0
3731,3731999,20.86808339369101,37.861276201627135,0.08740432805145426,553.0712249279022,241.29543256759644,554.7849082946777,13781,3648,10133,10133,0,12,3732000.0
3732,3732999,20.86728363472599,37.85906406582471,0.08739550490543757,553.2332682609558,241.35876083374023,554.8629684448242,13781,3648,10133,10133,0,12,3733000.0
3733,3733999,20.867119001522727,37.86010122227336,0.08737501327648367,553.4092099666595,241.42219972610474,554.8738479614258,13783,3649,10134,10134,0,12,3734000.0
3734,3734999,20.866523522054216,37.85795023241938,0.08736863185139443,553.5263600349426,241.48501253128052,554.9718589782715,13783,3649,10134,10134,0,12,3735000.0
3735,3735999,20.86599134376823,37.85555998026619,0.08736271452086974,553.6617903709412,241.5477352142334,555.0377616882324,13783,3649,10134,10134,0,12,3736000.0
3736,3736999,20.864949411405586,37.854423793080194,0.08734789057302206,553.8082754611969,241.61008524894714,555.103157043457,13783,3649,10134,10134,0,12,3737000.0
3737,3737999,20.86363253793652,37.852417105854016,0.08730839663020018,554.00212931633,241.6732873916626,555.5774459838867,13794,3651,10143,10143,0,12,3738000.0
3738,3738999,20.862022371182317,37.85004439602647,0.08730282340647044,554.1469519138336,241.7371473312378,555.8204193115234,13802,3652,10150,10150,0,12,3739000.0
3739,3739999,20.860389861202265,37.84657747225608,0.0873120191423753,554.3034365177155,241.7996678352356,555.9782981872559,13804,3653,10151,10151,0,12,3740000.0
3740,3740999,20.85899528874805,37.84419574408368,0.08731134253241768,554.4903175830841,241.86304640769958,556.0606803894043,13808,3655,10153,10153,0,12,3741000.0
3741,3741999,20.857974093271864,37.843942798249365,0.08730574514585987,554.6233706474304,241.92552733421326,556.243522644043,13808,3655,10153,10153,0,12,3742000.0
3742,3742999,20.85671169641687,37.84166806104911,0.0872972218056366,554.7883017063141,241.98993158340454,556.3535614013672,13810,3656,10154,10154,0,12,3743000.0
3743,3743999,20.855548794975885,37.8400721288631,0.0872852692666799,554.969841003418,242.05308413505554,556.437572479248,13812,3657,10155,10155,0,12,3744000.0
3744,3744999,20.85506744156464,37.839178885539624,0.08727084509596417,555.1479396820068,242.11591792106628,556.4241256713867,13820,3658,10162,10162,0,12,3745000.0
3745,3745999,20.85473098285228,37.84288465511988,0.08723976804914935,555.2807173728943,242.17835927009583,556.5739250183105,13821,3658,10163,10163,0,12,3746000.0
3746,3746999,20.85524097561219,37.84301749437863,0.0872264113853971,555.433443069458,242.24079632759094,556.5617408752441,13823,3659,10164,10164,0,12,3747000.0
3747,3747999,20.85589527851384,37.84438211702344,0.0872173011059576,555.5727157592773,242.3034257888794,556.6547508239746,13823,3659,10164,10164,0,12,3748000.0
3748,3748999,20.85688880315534,37.8450857230555,0.08719645739615933,555.7702670097351,242.36758375167847,556.6628456115723,13827,3661,10166,10166,0,12,3749000.0
3749,3749999,20.858725989645613,37.849073285560706,0.08717453276060017,555.9026579856873,242.43033051490784,556.7481346130371,13827,3661,10166,10166,0,12,3750000.0
3750,3750999,20.86098884428759,37.85657435403368,0.08713384216369036,556.2165548801422,242.49412298202515,556.4244956970215,13843,3666,10177,10177,0,12,3751000.0
3751,3751999,20.863113341140405,37.86266536326408,0.08712885020631778,556.3567109107971,242.55714750289917,556.6398239135742,13843,3666,10177,10177,0,12,3752000.0
3752,3752999,20.864596737180253,37.866028439665286,0.08712778062743542,556.4891316890717,242.62011981010437,556.7746543884277,13843,3666,10177,10177,0,12,3753000.0
3753,3753999,20.8670006652561,37.87330399656422,0.08710861319291108,556.6076929569244,242.68287110328674,556.8659286499023,13843,3666,10177,10177,0,12,3754000.0
3754,3754999,20.869115421373237,37.87513615265012,0.08711850351814143,556.7571549415588,242.7474558353424,556.956657409668,13843,3666,10177,10177,0,12,3755000.0
3755,3755999,20.870895152905806,37.87906852295425,0.0871281162569798,556.8982512950897,242.8105869293213,557.0316123962402,13843,3666,10177,10177,0,12,3756000.0
3756,3756999,20.87171412085351,37.87844374529785,0.08713388273063005,557.0222117900848,242.8733582496643,557.1090545654297,13843,3666,10177,10177,0,12,3757000.0
3757,3757999,20.87092506647189,37.875803289449195,0.08712359203845244,557.1644096374512,242.93607187271118,557.6478233337402,13850,3666,10184,10184,0,12,3758000.0
3758,3758999,20.869359409630196,37.873592906108264,0.08711365045652253,557.2925496101379,242.99969053268433,557.9317665100098,13850,3666,10184,10184,0,12,3759000.0
3759,3759999,20.86764100919077,37.870860202775326,0.08710925955825655,557.4167878627777,243.06168603897095,558.0811653137207,13850,3666,10184,10184,0,12,3760000.0
3760,3760999,20.86634456241461,37.86911053167399,0.08709771895034846,557.543967962265,243.1237497329712,558.2223472595215,13850,3666,10184,10184,0,12,3761000.0
3761,3761999,20.86571114761623,37.87113886056108,0.08706174800486621,557.6994700431824,243.1865155696869,558.2815704345703,13852,3667,10185,10185,0,12,3762000.0
3762,3762999,20.8647132673644,37.86917351580701,0.08704827204412746,557.9750216007233,243.25015497207642,558.1978149414062,13861,3671,10190,10190,0,12,3763000.0
3763,3763999,20.864057353955623,37.86916929347901,0.08702747013189294,558.1033051013947,243.31486058235168,558.4372978210449,13861,3671,10190,10190,0,12,3764000.0
3764,3764999,20.863194644208022,37.86757453489277,0.08701515738704513,558.3049037456512,243.37805247306824,558.4404525756836,13872,3673,10199,10199,0,12,3765000.0
3765,3765999,20.862369969328583,37.86589709504726,0.0870038589588713,558.4702627658844,243.44111514091492,558.4901924133301,13874,3674,10200,10200,0,12,3766000.0
3766,3766999,20.862102191910445,37.865535100835885,0.08698173791254094,558.6236262321472,243.50410342216492,558.6713409423828,13875,3674,10201,10201,0,12,3767000.0
3767,3767999,20.86197521950225,37.865017130338934,0.08696264808224896,558.8005545139313,243.5672538280487,558.7161293029785,13884,3675,10209,10209,0,12,3768000.0
3768,3768999,20.862864786906055,37.86663277128207,0.0869362439308975,558.9343559741974,243.62971949577332,558.817066192627,13884,3675,10209,10209,0,12,3769000.0
3769,3769999,20.865473270889748,37.87454103298405,0.08688461211852905,559.0936372280121,243.69255113601685,558.8109283447266,13886,3676,10210,10210,0,12,3770000.0
3770,3770999,20.86863150428157,37.883102716230475,0.08683578018548965,559.2556829452515,243.755624294281,558.8489303588867,13888,3677,10211,10211,0,12,3771000.0
3771,3771999,20.873101157799294,37.89720881480426,0.0867790969779042,559.4044346809387,243.81843733787537,558.8603363037109,13896,3678,10218,10218,0,12,3772000.0
3772,3772999,20.876895185399025,37.905869508954666,0.08676072070414409,559.6608271598816,243.88204073905945,558.810546875,13902,3681,10221,10221,0,12,3773000.0
3773,3773999,20.882024077448115,37.91941861325531,0.08673004015409114,559.8271811008453,243.94498705863953,558.9247589111328,13904,3682,10222,10222,0,12,3774000.0
3774,3774999,20.8868590145802,37.93191163426415,0.0867209771108719,560.0742161273956,244.009694814682,558.7996864318848,13910,3685,10225,10225,0,12,3775000.0
3775,3775999,20.89073018998258,37.93791868773413,0.08674810795919718,560.2489519119263,244.07345700263977,558.8841552734375,13916,3686,10230,10230,0,12,3776000.0
3776,3776999,20.894935083364356,37.94489499631721,0.08678134071520183,560.4053199291229,244.136953830719,558.9514389038086,13918,3687,10231,10231,0,12,3777000.0
3777,3777999,20.89746421052399,37.94749073501155,0.08680773308136724,560.5715503692627,244.20045709609985,558.9804801940918,13920,3688,10232,10232,0,12,3778000.0
3778,3778999,20.89743051203535,37.946429041128944,0.08681806054158292,560.7024908065796,244.26424980163574,559.6231384277344,13931,3688,10243,10243,0,12,3779000.0
3779,3779999,20.89563734716832,37.947736600588904,0.08679950534796854,560.832524061203,244.32685112953186,559.9448623657227,13931,3688,10243,10243,0,12,3780000.0
3780,3780999,20.894243329550232,37.946639140415805,0.08678888891593917,561.0625932216644,244.3897089958191,559.818489074707,13953,3691,10262,10262,0,12,3781000.0
3781,3781999,20.893011787048714,37.944937536869915,0.08677942241946446,561.1952095031738,244.45227813720703,560.0353584289551,13953,3691,10262,10262,0,12,3782000.0
3782,3782999,20.891861207070985,37.943649678888,0.08676495162595399,561.3949570655823,244.5172734260559,560.0699996948242,13957,3693,10264,10264,0,12,3783000.0
3783,3783999,20.89082155966092,37.94139518213665,0.08675117214344119,561.6242990493774,244.58109331130981,560.0856704711914,13964,3696,10268,10268,0,12,3784000.0
3784,3784999,20.88983799486993,37.94055375383017,0.08673230383643382,561.7618741989136,244.64480662345886,560.3722724914551,13964,3696,10268,10268,0,12,3785000.0
3785,3785999,20.889069998542688,37.93926549921584,0.0867150733724309,561.9017221927643,244.70808935165405,560.5100288391113,13964,3696,10268,10268,0,12,3786000.0
3786,3786999,20.888185963533473,37.93749225259233,0.08669950166547846,562.1116945743561,244.77196979522705,560.4422264099121,13968,3698,10270,10270,0,12,3787000.0
3787,3787999,20.888398995644074,37.94027835080781,0.08666471953326516,562.2452812194824,244.8351309299469,560.6609802246094,13969,3698,10271,10271,0,12,3788000.0
3788,3788999,20.890611933973535,37.94757133836596,0.0866123535458877,562.3800914287567,244.89846324920654,560.8004035949707,13969,3698,10271,10271,0,12,3789000.0
3789,3789999,20.895461591557485,37.962535155335246,0.0865455495074664,562.5501437187195,244.96202611923218,560.8348007202148,13971,3699,10272,10272,0,12,3790000.0
3790,3790999,20.901030658185217,37.98263026154051,0.08648423790181292,562.8930201530457,245.02734518051147,560.5773048400879,13983,3705,10278,10278,0,12,3791000.0
3791,3791999,20.907765742920574,38.001670702963025,0.08647938675581135,563.0868630409241,245.09087467193604,560.6629753112793,13994,3707,10287,10287,0,12,3792000.0
3792,3792999,20.915159398485002,38.01793172518594,0.08653360753982131,563.2791740894318,245.1546814441681,560.7078285217285,13998,3709,10289,10289,0,12,3793000.0
3793,3793999,20.923584762570528,38.037554435132414,0.08661249270450233,563.4479873180389,245.21873426437378,560.880298614502,14000,3710,10290,10290,0,12,3794000.0
3794,3794999,20.93175302212102,38.055213061323954,0.0867585542779592,563.663640499115,245.283944606781,560.8534851074219,14004,3712,10292,10292,0,12,3795000.0
3795,3795999,20.93979806396519,38.07248766131107,0.0869349345760525,563.8620870113373,245.3497495651245,560.7902450561523,14008,3714,10294,10294,0,12,3796000.0
3796,3796999,20.947140277311366,38.085783185291135,0.08711770262076635,564.0618197917938,245.4137818813324,560.7979049682617,14027,3716,10311,10311,0,12,3797000.0
3797,3797999,20.955126452211605,38.09958192652372,0.08734683415164102,564.1947953701019,245.47784781455994,560.955638885498,14027,3716,10311,10311,0,12,3798000.0
3798,3798999,20.959839632935246,38.10559791608065,0.08749834224542696,564.336407661438,245.54159116744995,561.1037712097168,14027,3716,10311,10311,0,12,3799000.0
3799,3799999,20.959971124948897,38.106007211479884,0.0874656885414048,564.4696452617645,245.60539412498474,561.908576965332,14040,3716,10324,10324,0,12,3800000.0
3800,3800999,20.95878134065834,38.10411471105995,0.08743757804009089,564.6294240951538,245.66855907440186,562.0611686706543,14042,3717,10325,10325,0,12,3801000.0
3801,3801999,20.958054662931666,38.10307614220716,0.08741476369794532,564.7469146251678,245.73267650604248,562.245288848877,14042,3717,10325,10325,0,12,3802000.0
3802,3802999,20.9585659190741,38.10550122338991,0.08737249269593839,564.9159786701202,245.79586243629456,562.3265037536621,14044,3718,10326,10326,0,12,3803000.0
3803,3803999,20.95812532570394,38.10442065516494,0.0873508042433897,565.1230142116547,245.85986304283142,562.385913848877,14049,3720,10329,10329,0,12,3804000.0
3804,3804999,20.957578032089828,38.10284220406243,0.08733134580233515,565.3204550743103,245.92406249046326,562.481330871582,14053,3722,10331,10331,0,12,3805000.0
3805,3805999,20.95705597604859,38.102398067201754,0.08731116031729802,565.5144302845001,245.98928713798523,562.5432167053223,14061,3724,10337,10337,0,12,3806000.0
3806,3806999,20.957057546337293,38.101667943525946,0.0872928947036038,565.7175588607788,246.0534679889679,562.6473846435547,14066,3726,10340,10340,0,12,3807000.0
3807,3807999,20.957359211595072,38.10597850885681,0.08726475126693667,565.9166667461395,246.11788773536682,562.6929893493652,14071,3728,10343,10343,0,12,3808000.0
3808,3808999,20.95828146082388,38.1068656211201,0.0872573442416269,566.0756103992462,246.181631565094,562.867546081543,14073,3729,10344,10344,0,12,3809000.0
3809,3809999,20.958878560078944,38.10787468171195,0.08724887778880819,566.2481133937836,246.2455599308014,562.9045257568359,14080,3730,10350,10350,0,12,3810000.0
3810,3810999,20.961173631014006,38.11646412641728,0.08721586248175017,566.4208188056946,246.3099193572998,562.9804039001465,14082,3731,10351,10351,0,12,3811000.0
3811,3811999,20.963713722566162,38.12065922448813,0.08724342429825926,566.5455386638641,246.37391471862793,563.1990203857422,14083,3731,10352,10352,0,12,3812000.0
3812,3812999,20.96622817817212,38.12371747527648,0.08727373829560214,566.6768865585327,246.43799948692322,563.3414497375488,14083,3731,10352,10352,0,12,3813000.0
3813,3813999,20.97000070852519,38.129947626217685,0.08730620669445888,566.8716125488281,246.50236916542053,563.3641662597656,14095,3733,10362,10362,0,12,3814000.0
3814,3814999,20.974299647009154,38.13986047828668,0.08735180203779969,567.0736927986145,246.56661534309387,563.3908729553223,14099,3735,10364,10364,0,12,3815000.0
3815,3815999,20.978702956609432,38.14846934969698,0.08742228733611601,567.2387285232544,246.631192445755,563.4979553222656,14101,3736,10365,10365,0,12,3816000.0
3816,3816999,20.98231174434587,38.15394238292707,0.0874920134656656,567.4891307353973,246.69567203521729,563.4068222045898,14112,3739,10373,10373,0,12,3817000.0
3817,3817999,20.98625983583074,38.16025166445499,0.0875464650835509,567.6714453697205,246.76114416122437,563.4161529541016,14117,3740,10377,10377,0,12,3818000.0
3818,3818999,20.989721482386383,38.16363188144581,0.08762055977583894,567.9401485919952,246.82607698440552,563.3154067993164,14125,3744,10381,10381,0,12,3819000.0
3819,3819999,20.991182973006875,38.1637877719685,0.08762355140345612,568.057835817337,246.8924880027771,563.8616409301758,14136,3744,10392,10392,0,12,3820000.0
3820,3820999,20.989782432385276,38.16219927233068,0.08760520117982384,568.1937699317932,246.95714735984802,564.3143043518066,14137,3744,10393,10393,0,12,3821000.0
3821,3821999,20.988615530302425,38.160180306207245,0.08758715853462307,568.3940560817719,247.02048635482788,564.4249992370605,14141,3746,10395,10395,0,12,3822000.0
3822,3822999,20.987742367364763,38.1589083816776,0.08757008060173654,568.5237822532654,247.08379364013672,564.616096496582,14141,3746,10395,10395,0,12,3823000.0
3823,3823999,20.986428675299397,38.156520038582414,0.08754928198540424,568.6920032501221,247.1468629837036,564.7040786743164,14153,3747,10406,10406,0,12,3824000.0
3824,3824999,20.98491560636116,38.15367658733809,0.08753990210019236,568.8889553546906,247.21066117286682,564.7458953857422,14158,3749,10409,10409,0,12,3825000.0
3825,3825999,20.983120379331915,38.15032990709337,0.0875356660575386,569.1629776954651,247.27494144439697,564.5943298339844,14166,3753,10413,10413,0,12,3826000.0
3826,3826999,20.981718379251994,38.14757659639779,0.08752612856051112,569.4071407318115,247.3394157886505,564.6026878356934,14176,3756,10420,10420,0,12,3827000.0
3827,3827999,20.980349736887998,38.14546165271321,0.08751636751392444,569.5942776203156,247.40379905700684,564.6797142028809,14190,3758,10432,10432,0,12,3828000.0
3828,3828999,20.978734939493446,38.14250035668272,0.08751038209385131,569.7101757526398,247.47116923332214,564.9723854064941,14191,3758,10433,10433,0,12,3829000.0
3829,3829999,20.977600950427874,38.140826823178124,0.0874990055678524,569.9423549175262,247.53542852401733,564.9814071655273,14197,3761,10436,10436,0,12,3830000.0
3830,3830999,20.97654195906253,38.13899881771184,0.08748235384316272,570.1365711688995,247.59936547279358,565.0844802856445,14201,3763,10438,10438,0,12,3831000.0
3831,3831999,20.975997659203195,38.13783309410651,0.08746020108445529,570.3449892997742,247.6657440662384,565.1741485595703,14212,3765,10447,10447,0,12,3832000.0
3832,3832999,20.97558703377601,38.13664967872494,0.0874339170549594,570.4739201068878,247.72950506210327,565.4286880493164,14214,3765,10449,10449,0,12,3833000.0
3833,3833999,20.975226454792754,38.134735969100646,0.08741270243844834,570.6776955127716,247.79446601867676,565.4755630493164,14218,3767,10451,10451,0,12,3834000.0
3834,3834999,20.97498964334176,38.13334869213849,0.08739307090609771,570.8499076366425,247.85920786857605,565.6072006225586,14220,3768,10452,10452,0,12,3835000.0
3835,3835999,20.9752812254616,38.13230881167775,0.0873677125127662,571.0263202190399,247.92528772354126,565.7107048034668,14227,3769,10458,10458,0,12,3836000.0
3836,3836999,20.975755157610436,38.13173747203708,0.08734413183775314,571.1732134819031,247.98969721794128,565.8650550842285,14227,3769,10458,10458,0,12,3837000.0
3837,3837999,20.97617468428408,38.13107939827285,0.08732228609285508,571.3087632656097,248.05362010002136,565.951473236084,14227,3769,10458,10458,0,12,3838000.0
3838,3838999,20.976373133497773,38.12982686735821,0.08730489710854272,571.4661691188812,248.11782932281494,565.9991912841797,14239,3770,10469,10469,0,12,3839000.0
3839,3839999,20.976930369814266,38.1288600038958,0.08728725664428483,571.6087899208069,248.18208742141724,566.091625213623,14239,3770,10469,10469,0,12,3840000.0
3840,3840999,20.976479750681836,38.12674427366321,0.0872763990312364,571.7346811294556,248.2458038330078,566.2263145446777,14239,3770,10469,10469,0,12,3841000.0
3841,3841999,20.975064991768946,38.1244045197467,0.08726880972937734,571.8696513175964,248.31002688407898,567.0537071228027,14254,3770,10484,10484,0,12,3842000.0
3842,3842999,20.97367048762523,38.12298489612919,0.08725908407731886,572.0590753555298,248.37519550323486,567.1907119750977,14260,3772,10488,10488,0,12,3843000.0
3843,3843999,20.971948851771508,38.120358677518425,0.08726201162016112,572.289879322052,248.43873739242554,567.2341690063477,14285,3775,10510,10510,0,12,3844000.0
3844,3844999,20.97034680865875,38.11759908810132,0.08725866514780278,572.4568798542023,248.50276231765747,567.4339485168457,14287,3776,10511,10511,0,12,3845000.0
3845,3845999,20.968455887887313,38.114123562454544,0.08725949968708291,572.6619789600372,248.56846618652344,567.5359382629395,14292,3778,10514,10514,0,12,3846000.0
3846,3846999,20.966987519554056,38.11145158382914,0.08726089099256018,572.8321487903595,248.63261651992798,567.725887298584,14294,3779,10515,10515,0,12,3847000.0
3847,3847999,20.96543736309238,38.108515509233314,0.0872623945904758,572.9849755764008,248.69705176353455,567.9190139770508,14296,3780,10516,10516,0,12,3848000.0
3848,3848999,20.96376997317281,38.105218310034644,0.08726967825433662,573.1619946956635,248.76130843162537,568.1145782470703,14299,3781,10518,10518,0,12,3849000.0
3849,3849999,20.962280400319226,38.1022638067495,0.08727584840723002,573.2851240634918,248.82647323608398,568.2741775512695,14299,3781,10518,10518,0,12,3850000.0
3850,3850999,20.961179650785684,38.099955388695015,0.08727483164213035,573.4796130657196,248.89072155952454,568.3773155212402,14304,3783,10521,10521,0,12,3851000.0
3851,3851999,20.960195874855557,38.098013006235284,0.08727238810489069,573.6487584114075,248.9547939300537,568.4663848876953,14306,3784,10522,10522,0,12,3852000.0
3852,3852999,20.95939285197414,38.097624440766396,0.0872647202033795,573.8135387897491,249.01909518241882,568.6000823974609,14308,3785,10523,10523,0,12,3853000.0
3853,3853999,20.958859315747603,38.09650081381931,0.08725339148889655,574.0338134765625,249.08421897888184,568.7096176147461,14313,3787,10526,10526,0,12,3854000.0
3854,3854999,20.95855435272538,38.100751125820835,0.0872364664487365,574.1489601135254,249.14831280708313,568.9070167541504,14314,3787,10527,10527,0,12,3855000.0
3855,3855999,20.95769886448499,38.09841303152931,0.087230324147472,574.3156569004059,249.21248841285706,569.0113563537598,14316,3788,10528,10528,0,12,3856000.0
3856,3856999,20.957419247903477,38.096900473161156,0.08722499309302989,574.4801614284515,249.2762954235077,569.1044540405273,14318,3789,10529,10529,0,12,3857000.0
3857,3857999,20.956936497923753,38.09589590790543,0.08721701901483803,574.6388204097748,249.34050369262695,569.2370338439941,14318,3789,10529,10529,0,12,3858000.0
3858,3858999,20.957150872102932,38.09575975169407,0.0872079563174254,574.8112933635712,249.40599417686462,569.2893600463867,14320,3790,10530,10530,0,12,3859000.0
3859,3859999,20.956829612287528,38.094191289206975,0.08720145668181434,574.9425303936005,249.46974158287048,569.3865280151367,14320,3790,10530,10530,0,12,3860000.0
3860,3860999,20.956773533724892,38.09289696329332,0.08719317520285796,575.105348110199,249.53387188911438,569.3961334228516,14322,3791,10531,10531,0,12,3861000.0
3861,3861999,20.95622011883964,38.09086251931833,0.08719032339519417,575.2414197921753,249.59834146499634,569.5149002075195,14322,3791,10531,10531,0,12,3862000.0
3862,3862999,20.955609070539555,38.09022790578111,0.08717187825604689,575.4509735107422,249.66308403015137,569.8956832885742,14339,3793,10546,10546,0,12,3863000.0
3863,3863999,20.953935801319176,38.08757292735223,0.08716568507088363,575.6068434715271,249.72650599479675,570.3049087524414,14344,3794,10550,10550,0,12,3864000.0
3864,3864999,20.952137033315378,38.085119837278405,0.08717301212395157,575.730482339859,249.79142594337463,570.587215423584,14345,3794,10551,10551,0,12,3865000.0
3865,3865999,20.950785696486562,38.083991056111664,0.08716880738722277,575.8855755329132,249.8547444343567,570.719898223877,14347,3795,10552,10552,0,12,3866000.0
3866,3866999,20.949069251064234,38.081585925031355,0.08716861484252669,576.1090190410614,249.9187891483307,570.7507438659668,14352,3797,10555,10555,0,12,3867000.0
3867,3867999,20.94743075572602,38.079550353940036,0.08716722013681788,576.2292664051056,249.98209381103516,570.9426879882812,14352,3797,10555,10555,0,12,3868000.0
3868,3868999,20.94561709198958,38.07607850107131,0.08716831629894739,576.4171214103699,250.04638981819153,571.060791015625,14354,3798,10556,10556,0,12,3869000.0
3869,3869999,20.944874650776068,38.076290094924715,0.08714509722008534,576.5499904155731,250.11143970489502,571.24755859375,14355,3798,10557,10557,0,12,3870000.0
3870,3870999,20.944605647881975,38.07570394764834,0.08711993645612648,576.7172029018402,250.1755654811859,571.3110580444336,14357,3799,10558,10558,0,12,3871000.0
3871,3871999,20.944808394160503,38.07680450751681,0.08708531396450891,576.8721058368683,250.23943543434143,571.5451126098633,14360,3800,10560,10560,0,12,3872000.0
3872,3872999,20.9450362700775,38.0767835958271,0.08706720441473537,577.0245654582977,250.30412888526917,571.6252517700195,14362,3801,10561,10561,0,12,3873000.0
3873,3873999,20.945179553013414,38.07622749733224,0.08704329035089264,577.2605283260345,250.3685426712036,571.5905952453613,14368,3804,10564,10564,0,12,3874000.0
3874,3874999,20.94589375485936,38.07669898813521,0.08702131380439548,577.3952302932739,250.4328911304474,571.8358535766602,14370,3804,10566,10566,0,12,3875000.0
3875,3875999,20.94626772358268,38.07620205719598,0.08700080969788415,577.5732154846191,250.4965991973877,571.9003372192383,14372,3805,10567,10567,0,12,3876000.0
3876,3876999,20.946402154032267,38.075283664073694,0.08698656480075562,577.7313685417175,250.56041312217712,572.0062980651855,14374,3806,10568,10568,0,12,3877000.0
3877,3877999,20.94671845799987,38.0744307676156,0.086969782831544,577.8968677520752,250.62504529953003,572.0365447998047,14376,3807,10569,10569,0,12,3878000.0
3878,3878999,20.94709939830087,38.073807978017854,0.08695167640663426,578.1121046543121,250.6897051334381,572.0208587646484,14380,3809,10571,10571,0,12,3879000.0
3879,3879999,20.947495719989053,38.0733470933922,0.08693168399545836,578.238463640213,250.7536358833313,572.1845169067383,14380,3809,10571,10571,0,12,3880000.0
3880,3880999,20.947703008016475,38.07184129793051,0.08692202116392123,578.4173703193665,250.81764674186707,572.2415351867676,14382,3810,10572,10572,0,12,3881000.0
3881,3881999,20.946489826960992,38.06876336004577,0.0869229795050861,578.5846583843231,250.88138508796692,572.7599906921387,14400,3811,10589,10589,0,12,3882000.0
3882,3882999,20.94474669192689,38.0655384349697,0.08692145024777809,578.7779033184052,250.9445652961731,573.0627708435059,14406,3813,10593,10593,0,12,3883000.0
3883,3883999,20.94339763247319,38.06295324931614,0.08691149749748028,578.9249494075775,251.00810503959656,573.2398719787598,14408,3814,10594,10594,0,12,3884000.0
3884,3884999,20.942110334330973,38.06040312363304,0.08690485871540976,579.0808699131012,251.071302652359,573.4225578308105,14411,3815,10596,10596,0,12,3885000.0
3885,3885999,20.940758665184948,38.058128075450284,0.08690152553303176,579.3422386646271,251.13527941703796,573.4675712585449,14419,3819,10600,10600,0,12,3886000.0
3886,3886999,20.9395152859491,38.05650081517741,0.08689744185740789,579.5287804603577,251.19871139526367,573.5570487976074,14423,3821,10602,10602,0,12,3887000.0
3887,3887999,20.938275669945742,38.05394329548588,0.08689013177163063,579.7244629859924,251.26266026496887,573.7283935546875,14427,3823,10604,10604,0,12,3888000.0
3888,3888999,20.936898515240348,38.0512862092093,0.08688951139928858,579.9337620735168,251.3282241821289,573.9139518737793,14432,3825,10607,10607,0,12,3889000.0
3889,3889999,20.936343699983347,38.04996170330692,0.08687674896832553,580.0518455505371,251.39223647117615,574.2100296020508,14433,3825,10608,10608,0,12,3890000.0
3890,3890999,20.9358456028722,38.049503235146254,0.08685758647182373,580.2236754894257,251.45605087280273,574.3960800170898,14435,3826,10609,10609,0,12,3891000.0
3891,3891999,20.9359813184675,38.0496683631132,0.08682352035206953,580.3487324714661,251.51945757865906,574.5798950195312,14435,3826,10609,10609,0,12,3892000.0
3892,3892999,20.936524429653147,38.05038892995571,0.08679182370357641,580.5404040813446,251.58367443084717,574.5939445495605,14439,3828,10611,10611,0,12,3893000.0
3893,3893999,20.937233972876573,38.05361985111762,0.08676555015796283,580.701340675354,251.64764857292175,574.7473945617676,14443,3829,10614,10614,0,12,3894000.0
3894,3894999,20.938230448304996,38.05395657741446,0.08674694250913917,580.8531756401062,251.71137309074402,574.9047966003418,14445,3830,10615,10615,0,12,3895000.0
3895,3895999,20.93973037182322,38.05549033618104,0.08672267934178957,581.0064351558685,251.77492666244507,575.0396385192871,14445,3830,10615,10615,0,12,3896000.0
3896,3896999,20.94162949038317,38.05866932701384,0.0867023047188703,581.1412501335144,251.8397195339203,575.1917762756348,14445,3830,10615,10615,0,12,3897000.0
3897,3897999,20.943432732544057,38.06132099644768,0.08669569023292445,581.3061981201172,251.90412282943726,575.2594795227051,14447,3831,10616,10616,0,12,3898000.0
3898,3898999,20.94522794715961,38.06433804648992,0.08668242023030259,581.4264597892761,251.96760368347168,575.3366584777832,14447,3831,10616,10616,0,12,3899000.0
3899,3899999,20.9471769892739,38.068479001130974,0.08665140689516437,581.6663200855255,252.03187942504883,575.2048721313477,14453,3834,10619,10619,0,12,3900000.0
3900,3900999,20.948744880915932,38.06902316244083,0.08665279460074882,581.8017802238464,252.09634351730347,575.4041595458984,14453,3834,10619,10619,0,12,3901000.0
3901,3901999,20.949225515818725,38.06778734602254,0.0866419262210727,582.0259199142456,252.16044521331787,575.4689865112305,14480,3836,10644,10644,0,12,3902000.0
3902,3902999,20.948580271021893,38.069152096356554,0.08660610998121898,582.152045249939,252.22419238090515,576.3056564331055,14499,3836,10663,10663,0,12,3903000.0
3903,3903999,20.946849224368204,38.066117948972405,0.08659839188122043,582.311719417572,252.28795671463013,576.4753150939941,14502,3837,10665,10665,0,12,3904000.0
3904,3904999,20.94535419285626,38.063263981660604,0.08659100708892042,582.5114023685455,252.35166358947754,576.6276817321777,14506,3839,10667,10667,0,12,3905000.0
3905,3905999,20.944148086414124,38.06194168534855,0.08657208144453443,582.667809009552,252.41500806808472,576.8085250854492,14508,3840,10668,10668,0,12,3906000.0
3906,3906999,20.942670856067664,38.05929494670426,0.08656494624709876,582.8384568691254,252.47982454299927,576.9621505737305,14511,3841,10670,10670,0,12,3907000.0
3907,3907999,20.941338727812077,38.0567586439223,0.08655695029206034,583.0364420413971,252.54354071617126,577.071720123291,14515,3843,10672,10672,0,12,3908000.0
3908,3908999,20.94016219323977,38.05692323074284,0.08653556821836006,583.2374377250671,252.60734677314758,577.1849021911621,14520,3845,10675,10675,0,12,3909000.0
3909,3909999,20.939052419309196,38.054215591313046,0.08652229719665672,583.3988473415375,252.67252469062805,577.3386726379395,14523,3846,10677,10677,0,12,3910000.0
3910,3910999,20.93867663184015,38.05315159766176,0.08649836369839137,583.5304436683655,252.73593401908875,577.5107460021973,14523,3846,10677,10677,0,12,3911000.0
3911,3911999,20.938235960995883,38.05172539684931,0.08647425186030167,583.6601605415344,252.79900336265564,577.7717552185059,14524,3846,10678,10678,0,12,3912000.0
3912,3912999,20.937752619449544,38.04989883280372,0.08645929585111967,583.8175158500671,252.86256051063538,577.8728065490723,14526,3847,10679,10679,0,12,3913000.0
3913,3913999,20.938655700808418,38.05715526287551,0.08639784757029856,584.0059485435486,252.9262719154358,577.9036598205566,14530,3849,10681,10681,0,12,3914000.0
3914,3914999,20.938924032983973,38.05674120627203,0.08637741235993102,584.244152545929,252.99035692214966,577.9494323730469,14537,3852,10685,10685,0,12,3915000.0
3915,3915999,20.939525917510867,38.05636036443777,0.08635168337854604,584.4125905036926,253.05409288406372,578.110652923584,14540,3853,10687,10687,0,12,3916000.0
3916,3916999,20.940445324566852,38.05647154148746,0.08633474714486034,584.611270904541,253.11818480491638,578.1718292236328,14544,3855,10689,10689,0,12,3917000.0
3917,3917999,20.941255303586143,38.0569612218352,0.086308536294611,584.7744810581207,253.18363332748413,578.3534202575684,14546,3856,10690,10690,0,12,3918000.0
3918,3918999,20.942556091169116,38.05795800663908,0.08629042953353216,584.9400405883789,253.2480742931366,578.4851264953613,14548,3857,10691,10691,0,12,3919000.0
3919,3919999,20.943751735220452,38.058736485333064,0.08627972345611845,585.0842638015747,253.31173634529114,578.6458473205566,14549,3857,10692,10692,0,12,3920000.0
3920,3920999,20.94461433203949,38.05874753380364,0.08626849653349977,585.290159702301,253.37674951553345,578.7192115783691,14555,3859,10696,10696,0,12,3921000.0
3921,3921999,20.946703257261454,38.063113469675706,0.08623917381376689,585.4447972774506,253.44074010849,578.8027000427246,14557,3860,10697,10697,0,12,3922000.0
3922,3922999,20.947900383663434,38.06355297918943,0.08621987846812307,585.602846622467,253.50564289093018,578.8818855285645,14559,3861,10698,10698,0,12,3923000.0
3923,3923999,20.947773600458806,38.06228411387842,0.08620610685357111,585.7662787437439,253.56990218162537,579.5334167480469,14580,3862,10718,10718,0,12,3924000.0
3924,3924999,20.945588715967745,38.058941216444154,0.08621477749380468,585.8979752063751,253.63263416290283,579.9140625,14581,3862,10719,10719,0,12,3925000.0
3925,3925999,20.943847995408714,38.056592567081005,0.08620701685903942,586.0267868041992,253.6954426765442,580.148021697998,14582,3862,10720,10720,0,12,3926000.0
3926,3926999,20.942639978320493,38.05511070760412,0.08619275778128954,586.1412127017975,253.758118391037,580.3623008728027,14582,3862,10720,10720,0,12,3927000.0
3927,3927999,20.941472765526758,38.053015568464964,0.08618142444980315,586.4042756557465,253.82249999046326,580.3840026855469,14590,3866,10724,10724,0,12,3928000.0
3928,3928999,20.94027256911501,38.051314342767824,0.0861687973948867,586.6527986526489,253.88629126548767,580.4666748046875,14597,3869,10728,10728,0,12,3929000.0
3929,3929999,20.93923855178777,38.04872670146857,0.08616308633170622,586.80775141716,253.95046663284302,580.6379470825195,14599,3870,10729,10729,0,12,3930000.0
3930,3930999,20.938219783598324,38.04632661015652,0.08615549525649768,586.9297523498535,254.01478338241577,580.8459091186523,14599,3870,10729,10729,0,12,3931000.0
3931,3931999,20.937134564932553,38.043458080270895,0.0861525803825195,587.1113388538361,254.08150553703308,580.9315299987793,14602,3871,10731,10731,0,12,3932000.0
3932,3932999,20.936295338274846,38.041312838962334,0.08613968554377716,587.2696371078491,254.1450276374817,581.155632019043,14605,3872,10733,10733,0,12,3933000.0
3933,3933999,20.93620869497705,38.04412497777822,0.08610998863752739,587.4997036457062,254.20958971977234,581.1256065368652,14611,3875,10736,10736,0,12,3934000.0
3934,3934999,20.935706220219462,38.0422507155193,0.08610490056313702,587.6207892894745,254.27485942840576,581.3615570068359,14611,3875,10736,10736,0,12,3935000.0
3935,3935999,20.93568732069313,38.04164693817709,0.08609815344126581,587.8450615406036,254.34021258354187,581.4451713562012,14616,3877,10739,10739,0,12,3936000.0
3936,3936999,20.936457794452593,38.04169290695935,0.08607931194562268,588.0063223838806,254.40403246879578,581.5849876403809,14624,3878,10746,10746,0,12,3937000.0
3937,3937999,20.937743113571585,38.04272542133122,0.0860692213165577,588.2071516513824,254.46863269805908,581.6940765380859,14646,3880,10766,10766,0,12,3938000.0
3938,3938999,20.938624249750415,38.04264319000941,0.08605716555551557,588.3405776023865,254.5324285030365,581.8797187805176,14646,3880,10766,10766,0,12,3939000.0
3939,3939999,20.940483158911423,38.0440848907141,0.08604333230543615,588.5043711662292,254.5963773727417,581.93359375,14648,3881,10767,10767,0,12,3940000.0
3940,3940999,20.94226808361433,38.0453896951669,0.08603882256587492,588.6309292316437,254.65999579429626,582.072208404541,14648,3881,10767,10767,0,12,3941000.0
3941,3941999,20.94438039191715,38.04660144849494,0.08603602164370816,588.7901575565338,254.72378015518188,582.1657447814941,14651,3882,10769,10769,0,12,3942000.0
3942,3942999,20.945343841491276,38.04619496748321,0.08602862050603832,588.9835679531097,254.7880575656891,582.151725769043,14653,3883,10770,10770,0,12,3943000.0
3943,3943999,20.94645080900737,38.045816427934014,0.08602497141575505,589.1062669754028,254.85346126556396,582.2728462219238,14653,3883,10770,10770,0,12,3944000.0
3944,3944999,20.946456126650098,38.04410926215523,0.08601658702771309,589.276430606842,254.91767191886902,582.7781639099121,14673,3884,10789,10789,0,12,3945000.0
3945,3945999,20.945668679577523,38.04403727598191,0.08598394174455393,589.4039235115051,254.9814293384552,583.3542137145996,14678,3884,10794,10794,0,12,3946000.0
3946,3946999,20.94485448912859,38.04394168386125,0.08596702135470435,589.5972347259521,255.04486274719238,583.518440246582,14698,3886,10812,10812,0,12,3947000.0
3947,3947999,20.94456114927188,38.0462021500031,0.08595363287971558,589.7440819740295,255.10879731178284,583.7172889709473,14700,3887,10813,10813,0,12,3948000.0
3948,3948999,20.945284720751314,38.049550773668,0.08595216932170613,589.9719643592834,255.17270731925964,583.7873687744141,14722,3890,10832,10832,0,12,3949000.0
3949,3949999,20.946085231323455,38.053708006506135,0.0860013955029505,590.2077343463898,255.23708844184875,583.9421157836914,14729,3893,10836,10836,0,12,3950000.0
3950,3950999,20.94627506995048,38.0545267847256,0.08604658827603662,590.4029057025909,255.30433821678162,584.1086807250977,14733,3895,10838,10838,0,12,3951000.0
3951,3951999,20.946818440685476,38.0564619555113,0.08609096147817619,590.5613610744476,255.36799693107605,584.2764549255371,14735,3896,10839,10839,0,12,3952000.0
3952,3952999,20.9479050508045,38.05843302108608,0.08613084370567314,590.7782361507416,255.43228578567505,584.3757171630859,14745,3898,10847,10847,0,12,3953000.0
3953,3953999,20.94903546081442,38.06261909789516,0.0861758772415917,590.9327869415283,255.49612522125244,584.5702590942383,14749,3899,10850,10850,0,12,3954000.0
3954,3954999,20.95038164460046,38.06527214586753,0.0862137411917574,591.0949854850769,255.5605800151825,584.693775177002,14751,3900,10851,10851,0,12,3955000.0
3955,3955999,20.95259276026812,38.06924519749787,0.0862545376327496,591.3035171031952,255.62506532669067,584.7446212768555,14755,3902,10853,10853,0,12,3956000.0
3956,3956999,20.953877374943414,38.07156438839124,0.08630719840346956,591.5074203014374,255.68988418579102,584.866138458252,14760,3904,10856,10856,0,12,3957000.0
3957,3957999,20.955762501385543,38.07361190199403,0.08633014844268372,591.672438621521,255.75513768196106,585.0189018249512,14763,3905,10858,10858,0,12,3958000.0
3958,3958999,20.95790076794049,38.076933804700325,0.08633999956260308,591.870409488678,255.8192582130432,585.1227645874023,14785,3907,10878,10878,0,12,3959000.0
3959,3959999,20.960068884935936,38.07942647132193,0.08638793666199462,592.0285913944244,255.88339614868164,585.2700881958008,14787,3908,10879,10879,0,12,3960000.0
3960,3960999,20.962991370146813,38.08367469339041,0.08642537978361398,592.2368814945221,255.94793891906738,585.2840843200684,14791,3910,10881,10881,0,12,3961000.0
3961,3961999,20.967677121712505,38.1012338361313,0.08645156095365536,592.3702018260956,256.0122094154358,585.4858627319336,14792,3910,10882,10882,0,12,3962000.0
3962,3962999,20.971405621442013,38.10909168663793,0.08648217470573627,592.5861315727234,256.07689785957336,585.530158996582,14800,3912,10888,10888,0,12,3963000.0
3963,3963999,20.9758488243142,38.118233867884896,0.08649275988307736,592.7616145610809,256.14183735847473,585.5770874023438,14802,3913,10889,10889,0,12,3964000.0
3964,3964999,20.979168131054095,38.12301108664601,0.08650551729134026,592.8851220607758,256.2054765224457,585.7454948425293,14802,3913,10889,10889,0,12,3965000.0
3965,3965999,20.979966329768935,38.126722572681075,0.08648801045930865,593.0485813617706,256.27091932296753,586.4255104064941,14823,3914,10909,10909,0,12,3966000.0
3966,3966999,20.97883690366301,38.12700246595414,0.08647238174538219,593.2132444381714,256.334175825119,586.7116737365723,14842,3915,10927,10927,0,12,3967000.0
3967,3967999,20.978479761986307,38.12747450185602,0.0864559516791028,593.38800740242,256.3985435962677,586.8293914794922,14845,3916,10929,10929,0,12,3968000.0
3968,3968999,20.978612014200724,38.12938014972528,0.08643044549554524,593.5038869380951,256.46130633354187,587.0345993041992,14845,3916,10929,10929,0,12,3969000.0
3969,3969999,20.978766844135233,38.12976988808173,0.08643283404742863,593.7583701610565,256.52536845207214,587.0859985351562,14853,3920,10933,10933,0,12,3970000.0
3970,3970999,20.979721527306758,38.13117380531075,0.08642030166747483,594.0241115093231,256.58936834335327,587.1105575561523,14862,3924,10938,10938,0,12,3971000.0
3971,3971999,20.980666506883672,38.132476859252556,0.08641110633117599,594.1499140262604,256.6529824733734,587.4340705871582,14862,3924,10938,10938,0,12,3972000.0
3972,3972999,20.982257364944648,38.13571573393594,0.08643760441353299,594.3896827697754,256.7178111076355,587.4885025024414,14869,3927,10942,10942,0,12,3973000.0
3973,3973999,20.98434866275283,38.13961344476859,0.08645150731932405,594.5190832614899,256.78254890441895,587.6735038757324,14869,3927,10942,10942,0,12,3974000.0
3974,3974999,20.986936280447097,38.14378903137757,0.08646797668590767,594.6818013191223,256.8465735912323,587.8085479736328,14872,3928,10944,10944,0,12,3975000.0
3975,3975999,20.991251964092847,38.1517950894714,0.0865483909709065,594.84974360466,256.917115688324,587.9153022766113,14874,3929,10945,10945,0,12,3976000.0
3976,3976999,20.996309667648227,38.167857861006794,0.08660705213355879,595.122565984726,256.98175835609436,587.8144264221191,14887,3933,10954,10954,0,12,3977000.0
3977,3977999,21.001734630895772,38.177172481852,0.08673384425480557,595.2789697647095,257.04653000831604,587.9383888244629,14895,3934,10961,10961,0,12,3978000.0
3978,3978999,21.007497064066524,38.18688237980006,0.08690869587705219,595.4517178535461,257.1107003688812,588.0671653747559,14901,3935,10966,10966,0,12,3979000.0
3979,3979999,21.0131703627411,38.19778165378544,0.08706465950682862,595.6105272769928,257.1745743751526,588.1164169311523,14903,3936,10967,10967,0,12,3980000.0
3980,3980999,21.02035525258016,38.21386067184049,0.08730777937643175,595.8875081539154,257.2399914264679,588.0432624816895,14914,3940,10974,10974,0,12,3981000.0
3981,3981999,21.026384660543005,38.22506076457073,0.08752356047632726,596.0712311267853,257.3063876628876,588.2032127380371,14916,3941,10975,10975,0,12,3982000.0
3982,3982999,21.03275220195866,38.236344953409095,0.08776765783765816,596.2279875278473,257.3705794811249,588.2763710021973,14919,3942,10977,10977,0,12,3983000.0
3983,3983999,21.038177031968214,38.243178665226566,0.0880270355210141,596.3619828224182,257.43460607528687,588.4622230529785,14919,3942,10977,10977,0,12,3984000.0
3984,3984999,21.044122950583102,38.25261986962344,0.0882879488668179,596.6327981948853,257.49972796440125,588.3777885437012,14932,3946,10986,10986,0,12,3985000.0
3985,3985999,21.04857476513714,38.260600606769515,0.08847441884741925,596.7613408565521,257.56384205818176,588.8733177185059,14941,3946,10995,10995,0,12,3986000.0
3986,3986999,21.04771936394327,38.25980768325064,0.08844935340195004,596.873025894165,257.62826013565063,589.6573181152344,14955,3946,11009,11009,0,12,3987000.0
3987,3987999,21.04660535811069,38.25810718338386,0.08843769377162025,596.9990401268005,257.6911783218384,589.9669914245605,14956,3946,11010,11010,0,12,3988000.0
3988,3988999,21.04606824979713,38.25693202561717,0.08842340373852897,597.258918762207,257.7552399635315,589.8708724975586,14965,3950,11015,11015,0,12,3989000.0
3989,3989999,21.045621249539593,38.257118488031196,0.08840127314028268,597.4603843688965,257.81923365592957,590.0883865356445,14974,3952,11022,11022,0,12,3990000.0
3990,3990999,21.04469273570017,38.25501819958048,0.088393812023002,597.6504411697388,257.8830671310425,590.1972351074219,14978,3954,11024,11024,0,12,3991000.0
3991,3991999,21.04375828056737,38.252811104168984,0.08838683857581109,597.9248116016388,257.94860887527466,590.2008018493652,14986,3958,11028,11028,0,12,3992000.0
3992,3992999,21.04321168755876,38.25152929256407,0.08837536489739173,598.0780184268951,258.01270508766174,590.3979377746582,14988,3959,11029,11029,0,12,3993000.0
3993,3993999,21.043061868688376,38.250708576260664,0.08835655798117015,598.2013516426086,258.07750368118286,590.679141998291,14989,3959,11030,11030,0,12,3994000.0
3994,3994999,21.042760951816298,38.24951949057337,0.08834319046501415,598.3350248336792,258.1412250995636,590.8843154907227,14990,3959,11031,11031,0,12,3995000.0
3995,3995999,21.042501972254485,38.24844871230211,0.08833309350176344,598.5081765651703,258.20588636398315,590.9476318359375,14992,3960,11032,11032,0,12,3996000.0
3996,3996999,21.042982492935714,38.24859576519581,0.0883163847794256,598.6474282741547,258.26958560943604,591.097843170166,14992,3960,11032,11032,0,12,3997000.0
3997,3997999,21.043834087317776,38.248556129622074,0.08830320097105282,598.8344812393188,258.3334653377533,591.1074066162109,14996,3962,11034,11034,0,12,3998000.0
3998,3998999,21.045461449357205,38.2503582221388,0.08831471079789088,599.0084619522095,258.39751720428467,591.2610893249512,15000,3963,11037,11037,0,12,3999000.0
3999,3999999,21.046740839474257,38.251122669898386,0.08831410034192011,599.1372747421265,258.46093225479126,591.425407409668,15000,3963,11037,11037,0,12,4000000.0
4000,4000999,21.04817759756182,38.25226484072636,0.08832527934142964,599.3309576511383,258.52518486976624,591.4181861877441,15009,3965,11044,11044,0,12,4001000.0
4001,4001999,21.049692754058487,38.25287978119062,0.08834173356725639,599.4850671291351,258.58978605270386,591.5860595703125,15009,3965,11044,11044,0,12,4002000.0
4002,4002999,21.050555121701393,38.252211654426226,0.08836022785306918,599.767689704895,258.65488028526306,591.4177513122559,15022,3969,11053,11053,0,12,4003000.0
4003,4003999,21.051785338406855,38.2522942434786,0.08838562647629811,599.9225134849548,258.7189128398895,591.5063972473145,15026,3970,11056,11056,0,12,4004000.0
4004,4004999,21.0528576665253,38.25209393297508,0.08839751869804258,600.0552666187286,258.7849762439728,591.6742248535156,15026,3970,11056,11056,0,12,4005000.0
4005,4005999,21.053850216134673,38.25133095759041,0.08844285401114615,600.1806161403656,258.8489508628845,591.8044586181641,15026,3970,11056,11056,0,12,4006000.0
4006,4006999,21.05383542178966,38.249545141174984,0.08847534284983949,600.3253848552704,258.91321301460266,591.9731979370117,15026,3970,11056,11056,0,12,4007000.0
4007,4007999,21.052070172886708,38.24637508182266,0.0884830026885437,600.4505972862244,258.97773933410645,592.8747062683105,15046,3970,11076,11076,0,12,4008000.0
4008,4008999,21.05031314531367,38.24433602782289,0.08848517389521526,600.6238312721252,259.045884847641,593.1932258605957,15051,3971,11080,11080,0,12,4009000.0
4009,4009999,21.048761189121613,38.24472281068209,0.08847427065076419,600.8172566890717,259.1100261211395,593.3305702209473,15056,3973,11083,11083,0,12,4010000.0
4010,4010999,21.04699592560266,38.24191521846727,0.088481568118431,600.9768741130829,259.17389035224915,593.517032623291,15059,3974,11085,11085,0,12,4011000.0
4011,4011999,21.045293874534277,38.23899123760562,0.08848526615391061,601.1678838729858,259.23766255378723,593.6151733398438,15063,3976,11087,11087,0,12,4012000.0
4012,4012999,21.043765201426332,38.236203347077556,0.08848494541346485,601.4039943218231,259.3026010990143,593.6855697631836,15069,3979,11090,11090,0,12,4013000.0
4013,4013999,21.04211839812021,38.23345784150867,0.08848712097677569,601.5594100952148,259.36711621284485,593.8402137756348,15072,3980,11092,11092,0,12,4014000.0
4014,4014999,21.04087478544377,38.231662124297756,0.08848179735528905,601.7310202121735,259.4312119483948,594.0306205749512,15075,3981,11094,11094,0,12,4015000.0
4015,4015999,21.039513794608677,38.22881989599965,0.0884864820982143,601.8427181243896,259.4961633682251,594.2874069213867,15076,3981,11095,11095,0,12,4016000.0
4016,4016999,21.038435466620427,38.22821005728948,0.08846966862376582,601.9991338253021,259.56066274642944,594.3657684326172,15078,3982,11096,11096,0,12,4017000.0
4017,4017999,21.0373604135924,38.22592299823886,0.08846419133151717,602.1804242134094,259.6248655319214,594.4397315979004,15081,3983,11098,11098,0,12,4018000.0
4018,4018999,21.036341280664544,38.22370425028281,0.08845604306383903,602.407487154007,259.6896884441376,594.4913291931152,15088,3986,11102,11102,0,12,4019000.0
4019,4019999,21.036398376406474,38.22915720643839,0.08841139472314652,602.6379070281982,259.7538437843323,594.3733978271484,15095,3989,11106,11106,0,12,4020000.0
4020,4020999,21.03610156021268,38.2285837615316,0.08840270277353346,602.8410284519196,259.82005167007446,594.5816421508789,15099,3991,11108,11108,0,12,4021000.0
4021,4021999,21.03647079099736,38.230428312239574,0.08837646901971086,602.9618141651154,259.88395953178406,594.8153495788574,15099,3991,11108,11108,0,12,4022000.0
4022,4022999,21.036876666623254,38.22956512845882,0.08835723628630465,603.1186473369598,259.94820165634155,594.8755111694336,15101,3992,11109,11109,0,12,4023000.0
4023,4023999,21.03762562000583,38.23084442351688,0.08832919801076144,603.2619504928589,260.01408863067627,595.0887107849121,15102,3992,11110,11110,0,12,4024000.0
4024,4024999,21.038211364704644,38.229943058109505,0.08831925613395242,603.396710395813,260.0782504081726,595.2402992248535,15102,3992,11110,11110,0,12,4025000.0
4025,4025999,21.037685463940882,38.22815410724652,0.08830510169775285,603.6736426353455,260.1430857181549,595.1666297912598,15111,3996,11115,11115,0,12,4026000.0
4026,4026999,21.03590760938151,38.22561319404291,0.08831057686593002,603.8326444625854,260.20791888237,596.039623260498,15134,3997,11137,11137,0,12,4027000.0
4027,4027999,21.034501869304528,38.22462000012854,0.08830570458032805,603.9464514255524,260.2715256214142,596.4499473571777,15136,3997,11139,11139,0,12,4028000.0
4028,4028999,21.032939876186507,38.2219000403831,0.08829743646966937,604.1313762664795,260.3351836204529,596.6578712463379,15141,3999,11142,11142,0,12,4029000.0
4029,4029999,21.03122767274864,38.219286617123906,0.08829969562868367,604.2890944480896,260.3990304470062,596.8619422912598,15143,4000,11143,11143,0,12,4030000.0
4030,4030999,21.029810608344214,38.2177150351172,0.08829571065552422,604.422167301178,260.46216225624084,597.1021690368652,15143,4000,11143,11143,0,12,4031000.0
4031,4031999,21.028146621774074,38.21446743915934,0.08829592158303112,604.6870093345642,260.5265803337097,597.0774803161621,15151,4004,11147,11147,0,12,4032000.0
4032,4032999,21.026743398502788,38.212806143743165,0.08828714960457873,604.8525702953339,260.5906403064728,597.2265625,15154,4005,11149,11149,0,12,4033000.0
4033,4033999,21.025796336047282,38.21645850639505,0.08825254389217452,604.9694564342499,260.65432262420654,597.4573593139648,15154,4005,11149,11149,0,12,4034000.0
4034,4034999,21.024698901804673,38.214810375530575,0.08824391495842243,605.1809294223785,260.7184901237488,597.5476684570312,15159,4007,11152,11152,0,12,4035000.0
4035,4035999,21.023868796708747,38.21339623498946,0.08823104417339434,605.3072710037231,260.7819130420685,597.7254524230957,15159,4007,11152,11152,0,12,4036000.0
4036,4036999,21.023371643910835,38.21421856358453,0.0882107193908711,605.4755711555481,260.84550285339355,597.8046646118164,15161,4008,11153,11153,0,12,4037000.0
4037,4037999,21.022960452908453,38.21271655218847,0.08819439392340833,605.6435024738312,260.90963101387024,597.971248626709,15164,4009,11155,11155,0,12,4038000.0
4038,4038999,21.02263710596082,38.21212979414923,0.08817546184096348,605.7567193508148,260.9744927883148,598.119068145752,15165,4009,11156,11156,0,12,4039000.0
4039,4039999,21.02285620271535,38.213579908432905,0.08814381442257957,605.9615442752838,261.03872060775757,598.161693572998,15169,4011,11158,11158,0,12,4040000.0
4040,4040999,21.022678413887583,38.212199356485954,0.088131220595564,606.1697974205017,261.1032192707062,598.1819114685059,15177,4013,11164,11164,0,12,4041000.0
4041,4041999,21.023571892073814,38.212218971979894,0.08810889442146552,606.4387919902802,261.16810154914856,598.0784683227539,15185,4017,11168,11168,0,12,4042000.0
4042,4042999,21.023916883940824,38.21131259108969,0.08809049391388946,606.5916101932526,261.232782125473,598.2752494812012,15186,4017,11169,11169,0,12,4043000.0
4043,4043999,21.024745586573086,38.211055863082,0.08807544187924188,606.7247064113617,261.3019211292267,598.4465713500977,15186,4017,11169,11169,0,12,4044000.0
4044,4044999,21.025596803823444,38.21069983956591,0.08806324726261938,606.8608176708221,261.3657658100128,598.5571708679199,15186,4017,11169,11169,0,12,4045000.0
4045,4045999,21.025816440894033,38.20927726475063,0.08806226162826014,607.0717437267303,261.43023586273193,598.5205535888672,15194,4019,11175,11175,0,12,4046000.0
4046,4046999,21.02520282164509,38.20802217588564,0.08805233064962836,607.2346408367157,261.4951822757721,599.4046592712402,15218,4020,11198,11198,0,12,4047000.0
4047,4047999,21.023381318801487,38.20691283477714,0.0880511569991762,607.3591163158417,261.55885648727417,599.8418579101562,15220,4020,11200,11200,0,12,4048000.0
4048,4048999,21.02171010890588,38.20411851242087,0.0880518515345029,607.5038938522339,261.6213891506195,600.097053527832,15223,4021,11202,11202,0,12,4049000.0
4049,4049999,21.020269571770537,38.20196067780278,0.08804722156430889,607.6560845375061,261.6847457885742,600.3460540771484,15226,4022,11204,11204,0,12,4050000.0
4050,4050999,21.018786133744722,38.19904494370884,0.08804813675040923,607.8256678581238,261.74870109558105,600.5148544311523,15228,4023,11205,11205,0,12,4051000.0
4051,4051999,21.017732570455426,38.196530604184176,0.08804412207000079,608.0324611663818,261.8121476173401,600.5638008117676,15232,4025,11207,11207,0,12,4052000.0
4052,4052999,21.01703778504804,38.195025290193556,0.08803769479013113,608.1559600830078,261.8756148815155,600.8121719360352,15232,4025,11207,11207,0,12,4053000.0
4053,4053999,21.016649549286118,38.1936998324069,0.08802807908542631,608.3516380786896,261.9392375946045,600.8905067443848,15236,4027,11209,11209,0,12,4054000.0
4054,4054999,21.016525714493014,38.192663334901475,0.08801841641894059,608.469699382782,262.00331807136536,601.1106567382812,15237,4027,11210,11210,0,12,4055000.0
4055,4055999,21.01681205064287,38.19270082205834,0.08800052348992216,608.6317853927612,262.0676553249359,601.2737884521484,15240,4028,11212,11212,0,12,4056000.0
4056,4056999,21.01728216994533,38.19345434310746,0.08800736148778399,608.9096949100494,262.13195633888245,601.1177062988281,15248,4032,11216,11216,0,12,4057000.0
4057,4057999,21.018065965017957,38.19426631526899,0.08802438107760235,609.0787563323975,262.1965889930725,601.268970489502,15250,4033,11217,11217,0,12,4058000.0
4058,4058999,21.019084135646928,38.195950118913856,0.08804173115191816,609.2706408500671,262.26070952415466,601.3666687011719,15255,4035,11220,11220,0,12,4059000.0
4059,4059999,21.020377026546118,38.19745268070561,0.08804712652060076,609.4397690296173,262.3244905471802,601.4886054992676,15258,4036,11222,11222,0,12,4060000.0
4060,4060999,21.021785609695378,38.19860114926139,0.08803690358348093,609.6368179321289,262.38851952552795,601.5528030395508,15262,4038,11224,11224,0,12,4061000.0
4061,4061999,21.02369411696951,38.200845990939676,0.08804694233301047,609.8461861610413,262.4531219005585,601.5988998413086,15267,4040,11227,11227,0,12,4062000.0
4062,4062999,21.02563392152012,38.202649418241485,0.08808381722511427,610.0553817749023,262.5172686576843,601.6516532897949,15271,4042,11229,11229,0,12,4063000.0
4063,4063999,21.027785736768816,38.204297854577064,0.08808851698745579,610.2144300937653,262.5814673900604,601.80322265625,15274,4043,11231,11231,0,12,4064000.0
4064,4064999,21.029111034261444,38.20479386968182,0.08811729157372072,610.3883423805237,262.64651584625244,601.9081115722656,15276,4044,11232,11232,0,12,4065000.0
4065,4065999,21.031136043209862,38.20597248479131,0.08812447582843341,610.5290174484253,262.7111496925354,602.0489959716797,15276,4044,11232,11232,0,12,4066000.0
4066,4066999,21.032504036357402,38.20565070749747,0.0881364116127119,610.6551077365875,262.776424407959,602.2261962890625,15276,4044,11232,11232,0,12,4067000.0
4067,4067999,21.03386886628812,38.208360224287965,0.08811851445177221,610.8366429805756,262.8414797782898,602.9158325195312,15302,4045,11257,11257,0,12,4068000.0
4068,4068999,21.032158071024124,38.20537620592155,0.08811291698069212,610.9686653614044,262.914719581604,603.4942283630371,15305,4045,11260,11260,0,12,4069000.0
4069,4069999,21.03039031759298,38.202898070746336,0.08812307532924901,611.0821595191956,262.9781904220581,603.8511772155762,15306,4045,11261,11261,0,12,4070000.0
4070,4070999,21.02895227182982,38.20297058032548,0.08811307346018049,611.2355906963348,263.0414683818817,604.0213356018066,15309,4046,11263,11263,0,12,4071000.0
4071,4071999,21.02714057260403,38.199900279346394,0.08812131990865268,611.3975195884705,263.1048631668091,604.1762428283691,15312,4047,11265,11265,0,12,4072000.0
4072,4072999,21.025486766232518,38.19739156059672,0.08812493453405545,611.6950261592865,263.170033454895,604.1579627990723,15322,4052,11270,11270,0,12,4073000.0
4073,4073999,21.024062542102662,38.19552560647964,0.08812865322123464,611.854825258255,263.23385095596313,604.4023933410645,15324,4053,11271,11271,0,12,4074000.0
4074,4074999,21.022533043927535,38.19261179598041,0.08812421847487861,612.0603971481323,263.29804372787476,604.5514450073242,15328,4055,11273,11273,0,12,4075000.0
4075,4075999,21.021282985927176,38.19059201744953,0.08811517299246341,612.1821982860565,263.36188077926636,604.8387107849121,15329,4055,11274,11274,0,12,4076000.0
4076,4076999,21.019696487870107,38.18752369665548,0.08811625481070517,612.4234175682068,263.4310700893402,604.86181640625,15338,4058,11280,11280,0,12,4077000.0
4077,4077999,21.018437393889464,38.18524342014593,0.08811362036487236,612.6822276115417,263.49606108665466,604.7889633178711,15344,4061,11283,11283,0,12,4078000.0
4078,4078999,21.017157181238705,38.18279762632503,0.08810534280994176,612.846134185791,263.56239008903503,605.0008697509766,15346,4062,11284,11284,0,12,4079000.0
4079,4079999,21.01592901132222,38.18050001072091,0.08809887058939725,613.0497033596039,263.62726879119873,605.117359161377,15350,4064,11286,11286,0,12,4080000.0
4080,4080999,21.015071148633947,38.17883252911286,0.08808761471791238,613.2465291023254,263.6925401687622,605.2900733947754,15356,4066,11290,11290,0,12,4081000.0
4081,4081999,21.01415257255616,38.17647664908392,0.08807361038587691,613.4000549316406,263.7575476169586,605.4962577819824,15358,4067,11291,11291,0,12,4082000.0
4082,4082999,21.013502915016957,38.178166658099286,0.08804807753766342,613.5356676578522,263.8215835094452,605.6744079589844,15358,4067,11291,11291,0,12,4083000.0
4083,4083999,21.013066294604343,38.17695808806646,0.08803712350601278,613.7236785888672,263.8862216472626,605.8246040344238,15360,4068,11292,11292,0,12,4084000.0
4084,4084999,21.01242229750088,38.17530908306746,0.08802955453254391,613.8795506954193,263.9510221481323,605.9658966064453,15362,4069,11293,11293,0,12,4085000.0
4085,4085999,21.011557296090775,38.17310499424787,0.08802628830702253,614.0825023651123,264.0155749320984,606.021312713623,15367,4071,11296,11296,0,12,4086000.0
4086,4086999,21.010800936219496,38.170833501946476,0.08802365811967738,614.2555248737335,264.08034801483154,606.0922622680664,15369,4072,11297,11297,0,12,4087000.0
4087,4087999,21.010201432044077,38.168533921976106,0.08801943820116354,614.4093687534332,264.1543951034546,606.3125877380371,15369,4072,11297,11297,0,12,4088000.0
4088,4088999,21.009199418508988,38.166052076855294,0.08801629134170474,614.5690832138062,264.218786239624,606.4489440917969,15371,4073,11298,11298,0,12,4089000.0
4089,4089999,21.007357548622966,38.162916229246555,0.08800948101145412,614.7104082107544,264.2843930721283,607.4886054992676,15397,4073,11324,11324,0,12,4090000.0
4090,4090999,21.00538792899624,38.15961375116977,0.08800531201853135,614.8570990562439,264.3475170135498,607.8107681274414,15400,4074,11326,11326,0,12,4091000.0
4091,4091999,21.00337855243468,38.1565674255782,0.08800120999612115,614.9774401187897,264.4107303619385,608.077278137207,15400,4074,11326,11326,0,12,4092000.0
4092,4092999,21.00181834750967,38.153682793076726,0.08799924064018072,615.2084846496582,264.47442054748535,608.1914176940918,15407,4077,11330,11330,0,12,4093000.0
4093,4093999,21.000556591987305,38.15142521005444,0.08798596396950353,615.4139676094055,264.5383548736572,608.331298828125,15411,4079,11332,11332,0,12,4094000.0
4094,4094999,20.999151733799412,38.1491085498198,0.08797505494550173,615.5661308765411,264.60198163986206,608.4945983886719,15413,4080,11333,11333,0,12,4095000.0
4095,4095999,20.997566210814238,38.14610811490975,0.08797040583185611,615.7313776016235,264.66706824302673,608.6612243652344,15415,4081,11334,11334,0,12,4096000.0
4096,4096999,20.996356413273087,38.14358218421731,0.08796261915580406,615.917829990387,264.7315318584442,608.8526802062988,15420,4083,11337,11337,0,12,4097000.0
4097,4097999,20.995208855185936,38.14180040140172,0.08795431885246074,616.0376205444336,264.7949526309967,609.0475006103516,15420,4083,11337,11337,0,12,4098000.0
4098,4098999,20.99427036597893,38.14017348844057,0.0879430751193142,616.2461140155792,264.8592391014099,609.0991249084473,15426,4085,11341,11341,0,12,4099000.0
4099,4099999,20.99323199516444,38.13850220316066,0.08792928857131144,616.4998722076416,264.9248287677765,609.0635185241699,15433,4088,11345,11345,0,12,4100000.0
4100,4100999,20.992682635701296,38.13706620143411,0.08791245736855868,616.6999905109406,264.9893567562103,609.1346015930176,15437,4090,11347,11347,0,12,4101000.0
4101,4101999,20.99280323567648,38.14125173653008,0.08787293259623952,616.871743440628,265.0537214279175,609.3428764343262,15440,4091,11349,11349,0,12,4102000.0
4102,4102999,20.99265642655824,38.13992608270138,0.08785549032329676,617.0236010551453,265.1189045906067,609.4480094909668,15443,4092,11351,11351,0,12,4103000.0
4103,4103999,20.99291737782824,38.1393575795365,0.08783793841390974,617.195015668869,265.18376994132996,609.6110229492188,15445,4093,11352,11352,0,12,4104000.0
4104,4104999,20.993056609904908,38.13896456876374,0.08782107549097296,617.3272025585175,265.2478578090668,609.800235748291,15445,4093,11352,11352,0,12,4105000.0
4105,4105999,20.993348955204016,38.13840311794203,0.0877997480378957,617.5096673965454,265.31249809265137,609.8926773071289,15447,4094,11353,11353,0,12,4106000.0
4106,4106999,20.99392874315507,38.13795968827707,0.08778391601772528,617.6634616851807,265.3765826225281,609.9762191772461,15450,4095,11355,11355,0,12,4107000.0
4107,4107999,20.99431948171461,38.13735470821475,0.08777343028806395,617.780513048172,265.4409718513489,610.1714859008789,15450,4095,11355,11355,0,12,4108000.0
4108,4108999,20.99514415234146,38.13685208530848,0.08776762671586702,617.9338138103485,265.50556111335754,610.2923202514648,15450,4095,11355,11355,0,12,4109000.0
4109,4109999,20.99547765287972,38.13544540016788,0.0877569916322205,618.1064949035645,265.57028102874756,610.3684349060059,15452,4096,11356,11356,0,12,4110000.0
4110,4110999,20.99511697984764,38.13398066384851,0.08774623038873486,618.2804944515228,265.6355621814728,611.2341232299805,15478,4097,11381,11381,0,12,4111000.0
4111,4111999,20.993821008592835,38.131619523703236,0.08774205660700629,618.438600063324,265.6990165710449,611.6346549987793,15483,4098,11385,11385,0,12,4112000.0
4112,4112999,20.993272385426096,38.13026053555699,0.08774210767233459,618.5500154495239,265.7617230415344,611.9409103393555,15484,4098,11386,11386,0,12,4113000.0
4113,4113999,20.99357129310879,38.13061548379382,0.08774018179049525,618.6705157756805,265.8248088359833,612.2059783935547,15485,4098,11387,11387,0,12,4114000.0
4114,4114999,20.99377928690378,38.13065599970524,0.08774680351740494,618.940388917923,265.88906693458557,612.2613868713379,15493,4102,11391,11391,0,12,4115000.0
4115,4115999,20.993628855864902,38.12950321197295,0.08777422156045656,619.1973276138306,265.95301055908203,612.2736282348633,15501,4106,11395,11395,0,12,4116000.0
4116,4116999,20.993764700818684,38.128644715175085,0.08780236696121735,619.4471890926361,266.02008271217346,612.4317970275879,15508,4109,11399,11399,0,12,4117000.0
4117,4117999,20.993833897279494,38.128829702764286,0.08780949374881608,619.650885105133,266.0847895145416,612.5940895080566,15514,4111,11403,11403,0,12,4118000.0
4118,4118999,20.994027493716743,38.13221710773543,0.08779303120913096,619.8168041706085,266.149037361145,612.8005218505859,15516,4112,11404,11404,0,12,4119000.0
4119,4119999,20.994505593859824,38.132373984936635,0.08780160751236976,619.9308981895447,266.2129647731781,613.1319808959961,15518,4112,11406,11406,0,12,4120000.0
4120,4120999,20.995131024771492,38.13264604935626,0.08780886255221076,620.1621477603912,266.2775616645813,613.1371459960938,15524,4115,11409,11409,0,12,4121000.0
4121,4121999,20.99641539022989,38.134280676938495,0.08778017578071973,620.2965605258942,266.3417282104492,613.3934288024902,15524,4115,11409,11409,0,12,4122000.0
4122,4122999,20.99799189863523,38.13571233447296,0.08778328246595724,620.5137741565704,266.4069137573242,613.5605545043945,15529,4117,11412,11412,0,12,4123000.0
4123,4123999,20.999530804048685,38.137515144669926,0.0877902414571814,620.6295895576477,266.4704649448395,613.7732734680176,15530,4117,11413,11413,0,12,4124000.0
4124,4124999,21.001523711533814,38.141759849170946,0.08779226784521443,620.7918877601624,266.5346248149872,613.8966979980469,15532,4118,11414,11414,0,12,4125000.0
4125,4125999,21.003408994727558,38.14381468061407,0.0877917610884259,620.9160323143005,266.59853649139404,614.1047439575195,15532,4118,11414,11414,0,12,4126000.0
4126,4126999,21.00598161434195,38.14693642611204,0.0878198470680438,621.0977783203125,266.66354036331177,614.1358909606934,15534,4119,11415,11415,0,12,4127000.0
4127,4127999,21.008137117115258,38.14911433892837,0.08783294820239163,621.2773513793945,266.72839760780334,614.2333831787109,15542,4120,11422,11422,0,12,4128000.0
4128,4128999,21.011379424362968,38.15700986052065,0.08788130307418252,621.4373352527618,266.792320728302,614.3501243591309,15544,4121,11423,11423,0,12,4129000.0
4129,4129999,21.013918283929563,38.15943385436718,0.08790089551220526,621.6121604442596,266.85641837120056,614.3814544677734,15546,4122,11424,11424,0,12,4130000.0
4130,4130999,21.015936293874343,38.160477323833184,0.087924461749877,621.7486290931702,266.9205131530762,614.5541572570801,15546,4122,11424,11424,0,12,4131000.0
4131,4131999,21.01633509194557,38.16201967317985,0.0879205023193711,621.9085590839386,266.98693680763245,615.2611274719238,15573,4123,11450,11450,0,12,4132000.0
4132,4132999,21.015347069568495,38.161688194533376,0.08791462129776173,622.0262370109558,267.0501551628113,615.8060913085938,15574,4123,11451,11451,0,12,4133000.0
4133,4133999,21.014203712656247,38.160418278587926,0.08790257042477467,622.1452507972717,267.11326718330383,616.1260795593262,15575,4123,11452,11452,0,12,4134000.0
4134,4134999,21.013079764579125,38.15942250185679,0.08788970627582315,622.3389945030212,267.17782759666443,616.2864112854004,15584,4125,11459,11459,0,12,4135000.0
4135,4135999,21.012294389797464,38.15916182007843,0.08787678686340916,622.5659165382385,267.24208521842957,616.3779449462891,15591,4128,11463,11463,0,12,4136000.0
4136,4136999,21.011343889788968,38.157168253971534,0.08786817213012865,622.8026452064514,267.30623960494995,616.4605598449707,15597,4131,11466,11466,0,12,4137000.0
4137,4137999,21.01032310431634,38.15480958922942,0.08786389427301788,623.0672287940979,267.37226605415344,616.5505752563477,15605,4135,11470,11470,0,12,4138000.0
4138,4138999,21.00931688590881,38.15259418759689,0.08785755820392971,623.3021113872528,267.4367473125458,616.6758117675781,15611,4138,11473,11473,0,12,4139000.0
4139,4139999,21.008490973758988,38.15115315134369,0.08784319115138572,623.426703453064,267.5008945465088,617.0278854370117,15612,4138,11474,11474,0,12,4140000.0
4140,4140999,21.00767400202568,38.149136630456645,0.08783090972730545,623.5397672653198,267.5649631023407,617.2854652404785,15613,4138,11475,11475,0,12,4141000.0
4141,4141999,21.007178363247412,38.148790252439674,0.0878150043491287,623.7074544429779,267.6287920475006,617.4014930725098,15615,4139,11476,11476,0,12,4142000.0
4142,4142999,21.00724832262595,38.14878299486789,0.0877924246519084,623.8400974273682,267.6923999786377,617.5728721618652,15615,4139,11476,11476,0,12,4143000.0
4143,4143999,21.00826505044408,38.15505597572034,0.08775009884036267,624.0169558525085,267.7565059661865,617.6750946044922,15617,4140,11477,11477,0,12,4144000.0
4144,4144999,21.009774398248336,38.15779400929147,0.08773298167841048,624.2197179794312,267.82151460647583,617.7487907409668,15623,4142,11481,11481,0,12,4145000.0
4145,4145999,21.012285224136072,38.16690914316343,0.08768506766774453,624.3851644992828,267.88562846183777,617.9405937194824,15625,4143,11482,11482,0,12,4146000.0
4146,4146999,21.015788299302677,38.17811812741006,0.08764593952461419,624.5047538280487,267.9497694969177,618.1148643493652,15625,4143,11482,11482,0,12,4147000.0
4147,4147999,21.022345913162308,38.1955341561826,0.087620120662948,624.7224049568176,268.01406717300415,618.1091041564941,15630,4145,11485,11485,0,12,4148000.0
4148,4148999,21.028775225196846,38.21203997203428,0.08762536884644379,624.9631750583649,268.0790820121765,618.1512413024902,15642,4148,11494,11494,0,12,4149000.0
4149,4149999,21.034493844262506,38.22293297478334,0.08764583463335252,625.1315817832947,268.1434073448181,618.2961769104004,15649,4149,11500,11500,0,12,4150000.0
4150,4150999,21.04089283677201,38.23670859634065,0.08771154775692935,625.3337135314941,268.2078514099121,618.2781257629395,15653,4151,11502,11502,0,12,4151000.0
4151,4151999,21.046786042549076,38.24703421239506,0.08781998223510168,625.4740068912506,268.27268624305725,618.4801940917969,15653,4151,11502,11502,0,12,4152000.0
4152,4152999,21.049441792418737,38.25069265409814,0.08783183235026681,625.6326196193695,268.33939480781555,619.2138519287109,15684,4152,11532,11532,0,12,4153000.0
4153,4153999,21.04816001590694,38.24884611236505,0.0878202622874521,625.7454521656036,268.40257263183594,619.7869033813477,15686,4152,11534,11534,0,12,4154000.0
4154,4154999,21.046929174875572,38.247232666827465,0.08781383670537724,625.8634083271027,268.46565294265747,620.108024597168,15687,4152,11535,11535,0,12,4155000.0
4155,4155999,21.04619159412083,38.248046212913025,0.08779346225772944,626.093095779419,268.5301172733307,620.2759017944336,15694,4155,11539,11539,0,12,4156000.0
4156,4156999,21.04570035789193,38.24701740405643,0.08777436448437725,626.2809057235718,268.5943834781647,620.4523391723633,15698,4157,11541,11541,0,12,4157000.0
4157,4157999,21.044613837089663,38.24446309177446,0.08776740930603577,626.445513010025,268.65847158432007,620.6082077026367,15700,4158,11542,11542,0,12,4158000.0
4158,4158999,21.04359040144,38.24254848857626,0.08775773384938645,626.6511838436127,268.7234396934509,620.7296524047852,15704,4160,11544,11544,0,12,4159000.0
4159,4159999,21.042829613608895,38.24069595541991,0.0877470919640001,626.7770001888275,268.7874610424042,620.9895286560059,15705,4160,11545,11545,0,12,4160000.0
4160,4160999,21.04220600860655,38.239601875717646,0.08773476904436017,627.024665594101,268.8522129058838,620.9934158325195,15712,4163,11549,11549,0,12,4161000.0
4161,4161999,21.041836006234323,38.23841685161438,0.08772379000327246,627.1873910427094,268.91684007644653,621.1671333312988,15714,4164,11550,11550,0,12,4162000.0
4162,4162999,21.041977667184494,38.23801841507793,0.08770546494885778,627.3118574619293,268.98065423965454,621.3529319763184,15714,4164,11550,11550,0,12,4163000.0
4163,4163999,21.04240517302373,38.23783391610678,0.08768392659934521,627.4705188274384,269.0447995662689,621.4861679077148,15717,4165,11552,11552,0,12,4164000.0
4164,4164999,21.043473361159172,38.23906571642692,0.08766373763990143,627.6025469303131,269.10876202583313,621.6819381713867,15718,4165,11553,11553,0,12,4165000.0
4165,4165999,21.044342398671027,38.23936028360076,0.08764746601394313,627.8803243637085,269.173269033432,621.581657409668,15726,4169,11557,11557,0,12,4166000.0
4166,4166999,21.046441827356215,38.24557294923859,0.08760870411949973,628.0084838867188,269.2370710372925,621.7876167297363,15726,4169,11557,11557,0,12,4167000.0
4167,4167999,21.04713155753529,38.2456078763725,0.08759303774120908,628.1281883716583,269.3009943962097,621.9324951171875,15726,4169,11557,11557,0,12,4168000.0
4168,4168999,21.048095177035027,38.24551837939637,0.08757771286965055,628.3814210891724,269.365597486496,621.8136253356934,15737,4172,11565,11565,0,12,4169000.0
4169,4169999,21.049203402416598,38.24558373645187,0.08756535627016926,628.5013561248779,269.4298846721649,621.9894027709961,15737,4172,11565,11565,0,12,4170000.0
4170,4170999,21.04965553081106,38.244975453469095,0.08755493074222054,628.6990721225739,269.4946858882904,622.1437683105469,15739,4173,11566,11566,0,12,4171000.0
4171,4171999,21.04827098219695,38.24222295168382,0.08755248083269174,628.9029424190521,269.5598568916321,622.947624206543,15763,4175,11588,11588,0,12,4172000.0
4172,4172999,21.046330645622795,38.239144417907895,0.08756085911761835,629.020206451416,269.6228361129761,623.4020881652832,15765,4175,11590,11590,0,12,4173000.0
4173,4173999,21.04470110449278,38.2377175464638,0.08755944944953609,629.1346344947815,269.686518907547,623.6903533935547,15766,4175,11591,11591,0,12,4174000.0
4174,4174999,21.043357423291923,38.23578398606191,0.08755699335021139,629.299765586853,269.74986839294434,623.8645553588867,15768,4176,11592,11592,0,12,4175000.0
4175,4175999,21.042287359524696,38.23374627786038,0.08755883572425438,629.4627070426941,269.8132150173187,624.0237007141113,15770,4177,11593,11593,0,12,4176000.0
4176,4176999,21.041333931229968,38.231942744408414,0.08755323846423357,629.6931998729706,269.87822341918945,624.1038856506348,15776,4180,11596,11596,0,12,4177000.0
4177,4177999,21.04037108751793,38.23096168465358,0.08753875336357719,629.9449415206909,269.9426848888397,624.0644760131836,15783,4183,11600,11600,0,12,4178000.0
4178,4178999,21.041102162681913,38.23510847101641,0.08749271585654372,630.0947577953339,270.0067653656006,624.2748222351074,15785,4184,11601,11601,0,12,4179000.0
4179,4179999,21.0449246112746,38.24844308691416,0.08741034999898722,630.2536993026733,270.0713789463043,624.4912300109863,15788,4185,11603,11603,0,12,4180000.0
4180,4180999,21.049072058858968,38.26115703341867,0.08736723858742645,630.3885681629181,270.13482451438904,624.7347030639648,15788,4185,11603,11603,0,12,4181000.0
4181,4181999,21.055999116692877,38.285119322663306,0.08733907278265907,630.69211602211,270.19900035858154,624.5244979858398,15802,4190,11612,11612,0,12,4182000.0
4182,4182999,21.063463479623373,38.304797662735844,0.08742284631958941,630.9242148399353,270.2633755207062,624.6656799316406,15816,4193,11623,11623,0,12,4183000.0
4183,4183999,21.071053454353905,38.32612216563319,0.08758811756569507,631.1601107120514,270.3290536403656,624.7776908874512,15822,4196,11626,11626,0,12,4184000.0
4184,4184999,21.0777812137871,38.3434551664004,0.08775186541552371,631.4083170890808,270.393860578537,624.7371025085449,15830,4199,11631,11631,0,12,4185000.0
4185,4185999,21.085581365276095,38.360860902710286,0.08798505807406609,631.5777895450592,270.458176612854,624.8908843994141,15836,4200,11636,11636,0,12,4186000.0
4186,4186999,21.093817509206847,38.3839386653347,0.08831051466826145,631.783891916275,270.524781703949,624.9657516479492,15840,4202,11638,11638,0,12,4187000.0
4187,4187999,21.099965743014085,38.39518939204865,0.08858626403082392,631.9031765460968,270.58881068229675,625.1917762756348,15841,4202,11639,11639,0,12,4188000.0
4188,4188999,21.107259573489934,38.41225274313636,0.08893334551597032,632.032167673111,270.6531980037689,625.3251075744629,15841,4202,11639,11639,0,12,4189000.0
4189,4189999,21.11397399315379,38.42521609503152,0.08917336233543138,632.3193018436432,270.7187469005585,625.2534790039062,15853,4206,11647,11647,0,12,4190000.0
4190,4190999,21.117496197788235,38.43247546107615,0.0892148413604501,632.4955098628998,270.7843725681305,625.9940452575684,15876,4207,11669,11669,0,12,4191000.0
4191,4191999,21.117351576162793,38.4344962680388,0.08918202528654018,632.6928837299347,270.8485429286957,626.2853355407715,15884,4209,11675,11675,0,12,4192000.0
4192,4192999,21.117512977312547,38.437626600417566,0.08915484333683088,632.854216337204,270.91154050827026,626.5396957397461,15887,4210,11677,11677,0,12,4193000.0
4193,4193999,21.117780343743146,38.43875722567279,0.08913472402446099,632.9683744907379,270.9752790927887,626.8176651000977,15888,4210,11678,11678,0,12,4194000.0
4194,4194999,21.118152112354576,38.439386533490755,0.08911698531679457,633.1713087558746,271.03939151763916,626.9119262695312,15892,4212,11680,11680,0,12,4195000.0
4195,4195999,21.11814498881512,38.438832589550074,0.08909738592016458,633.3320782184601,271.1026146411896,627.0597229003906,15894,4213,11681,11681,0,12,4196000.0
4196,4196999,21.117872346300835,38.438059065678075,0.08908395391985335,633.5666432380676,271.1667900085449,627.1138381958008,15900,4216,11684,11684,0,12,4197000.0
4197,4197999,21.117966166666832,38.43759786496473,0.08907285438305412,633.7494540214539,271.2307415008545,627.2645416259766,15903,4217,11686,11686,0,12,4198000.0
4198,4198999,21.1183943437543,38.43835407550176,0.08905645966958986,633.876859664917,271.2937581539154,627.4690170288086,15903,4217,11686,11686,0,12,4199000.0
4199,4199999,21.118917021846922,38.43900573451933,0.08905573235331443,634.0534217357635,271.3612422943115,627.6343994140625,15909,4218,11691,11691,0,12,4200000.0
4200,4200999,21.120048041817547,38.44106697623983,0.08905676234108206,634.1686511039734,271.42519211769104,627.7671051025391,15909,4218,11691,11691,0,12,4201000.0
4201,4201999,21.121396696099456,38.443473581860935,0.08905427467501625,634.3039298057556,271.4890990257263,627.8944396972656,15909,4218,11691,11691,0,12,4202000.0
4202,4202999,21.12339117791452,38.44636607990159,0.08907459344473234,634.4865765571594,271.55317282676697,628.0369148254395,15912,4219,11693,11693,0,12,4203000.0
4203,4203999,21.125444190710876,38.449625280926384,0.08909756030772431,634.6533377170563,271.61667680740356,628.0932769775391,15915,4220,11695,11695,0,12,4204000.0
4204,4204999,21.12781794580976,38.452214418866426,0.0891197097765144,634.8981156349182,271.6815412044525,628.0395011901855,15921,4223,11698,11698,0,12,4205000.0
4205,4205999,21.130782358269613,38.45694767243821,0.08916844550076641,635.0952570438385,271.74711894989014,628.1658744812012,15925,4225,11700,11700,0,12,4206000.0
4206,4206999,21.13372853134356,38.46073154279073,0.08919178421126417,635.2641472816467,271.81146812438965,628.2999420166016,15927,4226,11701,11701,0,12,4207000.0
4207,4207999,21.136774426560418,38.46539243876202,0.08924532706844746,635.438378572464,271.87535190582275,628.4505653381348,15933,4227,11706,11706,0,12,4208000.0
4208,4208999,21.13937889425806,38.46797087892832,0.08928044506073618,635.6473922729492,271.93886613845825,628.4365158081055,15941,4229,11712,11712,0,12,4209000.0
4209,4209999,21.142617491161232,38.47129716341488,0.08933528195592888,635.7788498401642,272.0032615661621,628.5943565368652,15941,4229,11712,11712,0,12,4210000.0
4210,4210999,21.144142564856786,38.47136387159366,0.08938761163386522,635.9819710254669,272.0677089691162,628.5830612182617,15945,4231,11714,11714,0,12,4211000.0
4211,4211999,21.144878612707526,38.47193528914368,0.08936663080156237,636.0991704463959,272.13365411758423,629.5985984802246,15975,4231,11744,11744,0,12,4212000.0
4212,4212999,21.143296534494116,38.47064369014814,0.08935675426836653,636.2156844139099,272.1969704627991,630.1869354248047,15976,4231,11745,11745,0,12,4213000.0
4213,4213999,21.141642027439552,38.46808176525955,0.08935877042544604,636.3614525794983,272.25977754592896,630.5449295043945,15980,4232,11748,11748,0,12,4214000.0
4214,4214999,21.140401787509152,38.46579103970166,0.0893573395492615,636.4705045223236,272.3234689235687,630.8411293029785,15981,4232,11749,11749,0,12,4215000.0
4215,4215999,21.138997786595503,38.4632453069574,0.08935685623470635,636.7423303127289,272.3872892856598,630.9039154052734,15989,4236,11753,11753,0,12,4216000.0
4216,4216999,21.137630049640943,38.46138737441127,0.08935392637908401,637.007167339325,272.4509000778198,630.9949951171875,15997,4240,11757,11757,0,12,4217000.0
4217,4217999,21.13611391021055,38.4588134740149,0.08935647297496652,637.1992611885071,272.51589703559875,631.2549324035645,16001,4242,11759,11759,0,12,4218000.0
4218,4218999,21.134662106309165,38.456142210906954,0.08935366702366043,637.3600227832794,272.57943415641785,631.4309577941895,16003,4243,11760,11760,0,12,4219000.0
4219,4219999,21.1337130986868,38.45507230064511,0.08934362534260176,637.5614631175995,272.64359879493713,631.6298522949219,16008,4245,11763,11763,0,12,4220000.0
4220,4220999,21.132914846881746,38.453800120306155,0.08933504933902792,637.8005278110504,272.70952677726746,631.7921981811523,16015,4248,11767,11767,0,12,4221000.0
4221,4221999,21.132023001408903,38.451772717013085,0.08932697322934269,637.9614808559418,272.77331924438477,632.0030899047852,16017,4249,11768,11768,0,12,4222000.0
4222,4222999,21.13162528500331,38.4505447727965,0.08932370990767335,638.1273427009583,272.83691453933716,632.1333274841309,16019,4250,11769,11769,0,12,4223000.0
4223,4223999,21.132606709881898,38.4523561231319,0.08933277298919162,638.2952239513397,272.90179562568665,632.3046073913574,16022,4251,11771,11771,0,12,4224000.0
4224,4224999,21.133604396564053,38.45412607064261,0.08933799528159414,638.4454097747803,272.96540999412537,632.4987907409668,16025,4252,11773,11773,0,12,4225000.0
4225,4225999,21.135100610419173,38.455964181672904,0.08936714992389072,638.5975623130798,273.02957248687744,632.6457366943359,16027,4253,11774,11774,0,12,4226000.0
4226,4226999,21.136371702022682,38.458119773292225,0.08939610612932358,638.7301161289215,273.094279050827,632.8353500366211,16027,4253,11774,11774,0,12,4227000.0
4227,4227999,21.13839279459542,38.46448842036939,0.08941232269142196,638.9401860237122,273.1583638191223,632.8802490234375,16031,4255,11776,11776,0,12,4228000.0
4228,4228999,21.14053795332831,38.4683733176098,0.08943776882649135,639.0965073108673,273.22292947769165,633.0778579711914,16031,4255,11776,11776,0,12,4229000.0
4229,4229999,21.14197081381465,38.47085448646532,0.08947480854836898,639.2576599121094,273.28729486465454,633.1832389831543,16034,4256,11778,11778,0,12,4230000.0
4230,4230999,21.143299527044082,38.471409544544535,0.08949650087838668,639.4216010570526,273.3512833118439,633.247428894043,16036,4257,11779,11779,0,12,4231000.0
4231,4231999,21.14455167722113,38.47173937038704,0.08951947178921749,639.5700130462646,273.41562485694885,633.3765182495117,16036,4257,11779,11779,0,12,4232000.0
4232,4232999,21.144424760838863,38.470130175233436,0.08952911394640795,639.6855714321136,273.4943051338196,633.8067474365234,16044,4257,11787,11787,0,12,4233000.0
4233,4233999,21.142391003951467,38.467410632714085,0.089535396170078,639.8386740684509,273.5547411441803,634.2367706298828,16049,4258,11791,11791,0,12,4234000.0
4234,4234999,21.14033805571343,38.46515903263028,0.08954052861519846,639.9796261787415,273.6143248081207,634.4560356140137,16050,4258,11792,11792,0,12,4235000.0
4235,4235999,21.138236717563696,38.462039353465904,0.08954747467456459,640.1149554252625,273.67414474487305,634.649974822998,16053,4258,11795,11795,0,12,4236000.0
4236,4236999,21.13649842522396,38.45939708634428,0.08954822400464302,640.3187963962555,273.73529720306396,635.1171493530273,16073,4260,11813,11813,0,12,4237000.0
4237,4237999,21.13542369629348,38.458255262686826,0.08953292198147778,640.4233429431915,273.7964506149292,635.5780220031738,16075,4260,11815,11815,0,12,4238000.0
4238,4238999,21.134151130754578,38.4558391851344,0.08952653758492446,640.5550060272217,273.86201667785645,635.8411407470703,16075,4260,11815,11815,0,12,4239000.0
4239,4239999,21.1330960894535,38.454127926834964,0.08951235525757262,640.6804146766663,273.928334236145,636.059024810791,16075,4260,11815,11815,0,12,4240000.0
4240,4240999,21.132178913641628,38.45241975533315,0.08950522257737636,640.8373346328735,273.98887968063354,636.2294464111328,16078,4261,11817,11817,0,12,4241000.0
4241,4241999,21.131760802459052,38.452304404771205,0.08950159865486984,641.0508842468262,274.05052375793457,636.255786895752,16082,4263,11819,11819,0,12,4242000.0
4242,4242999,21.1314132833745,38.45167215624,0.08949695567204974,641.2207324504852,274.1116375923157,636.4467964172363,16089,4264,11825,11825,0,12,4243000.0
4243,4243999,21.131195336822536,38.45077103226644,0.08948837864163217,641.3531727790833,274.17219948768616,636.595142364502,16089,4264,11825,11825,0,12,4244000.0
4244,4244999,21.131913333022155,38.45139357854096,0.08947890051534402,641.4639301300049,274.2328004837036,636.6918182373047,16089,4264,11825,11825,0,12,4245000.0
4245,4245999,21.133011609606875,38.454874758035864,0.08949480293230072,641.6388833522797,274.29395747184753,636.7569732666016,16092,4265,11827,11827,0,12,4246000.0
4246,4246999,21.134429626687233,38.45650457115251,0.08954672946364062,641.7940149307251,274.3547568321228,636.8158874511719,16094,4266,11828,11828,0,12,4247000.0
4247,4247999,21.135409177031136,38.45740084075995,0.08958571286562,641.9756317138672,274.4159343242645,636.8595771789551,16096,4267,11829,11829,0,12,4248000.0
4248,4248999,21.13737665284005,38.46019581584703,0.08964628509111416,642.1284329891205,274.4767572879791,636.9428558349609,16098,4268,11830,11830,0,12,4249000.0
4249,4249999,21.139300166294746,38.46244797205784,0.08967153287848462,642.3298904895782,274.53823375701904,636.8880081176758,16102,4270,11832,11832,0,12,4250000.0
4250,4250999,21.141238174126094,38.46470422148909,0.0897112575566199,642.5222492218018,274.59965777397156,636.9760475158691,16105,4271,11834,11834,0,12,4251000.0
4251,4251999,21.143036721524666,38.466283752114045,0.08973328917716283,642.6410727500916,274.6614143848419,637.1502456665039,16105,4271,11834,11834,0,12,4252000.0
4252,4252999,21.144787346325888,38.467295283212295,0.08976297231503805,642.8096618652344,274.7227475643158,637.2028579711914,16107,4272,11835,11835,0,12,4253000.0
4253,4253999,21.145697217631515,38.468738754326125,0.08977063884352887,642.947603225708,274.78333854675293,637.343936920166,16107,4272,11835,11835,0,12,4254000.0
4254,4254999,21.145031572810797,38.46626438436257,0.08975478152927896,643.0615289211273,274.8448221683502,637.9089012145996,16116,4272,11844,11844,0,12,4255000.0
4255,4255999,21.14415955864061,38.46428026103763,0.08973640881547973,643.2401585578918,274.9055063724518,638.0171928405762,16118,4273,11845,11845,0,12,4256000.0
4256,4256999,21.14319574504082,38.462185323082565,0.08972824868182816,643.3715071678162,274.9710078239441,638.2222023010254,16119,4273,11846,11846,0,12,4257000.0
4257,4257999,21.142566569555555,38.46076966983878,0.08971499320341281,643.5057055950165,275.0315055847168,638.3593368530273,16119,4273,11846,11846,0,12,4258000.0
4258,4258999,21.142110202138767,38.460415684164644,0.08969035463193997,643.6352326869965,275.09192967414856,638.4432754516602,16119,4273,11846,11846,0,12,4259000.0
4259,4259999,21.14130541135479,38.4594009992964,0.08967972863376172,643.8127508163452,275.152574300766,638.4802627563477,16121,4274,11847,11847,0,12,4260000.0
4260,4260999,21.14025528877225,38.45706743457105,0.08966612700793575,643.9545056819916,275.21299028396606,638.5589828491211,16121,4274,11847,11847,0,12,4261000.0
4261,4261999,21.139275758053227,38.45477583342351,0.08965722083522687,644.1271333694458,275.27873826026917,638.5838432312012,16123,4275,11848,11848,0,12,4262000.0
4262,4262999,21.138356337697783,38.45262391851487,0.08964859334929853,644.2873890399933,275.3396553993225,638.6127700805664,16125,4276,11849,11849,0,12,4263000.0
4263,4263999,21.138162911105884,38.4522040805396,0.08962643948323035,644.5141794681549,275.4006814956665,638.6080474853516,16129,4278,11851,11851,0,12,4264000.0
4264,4264999,21.137715162334157,38.45042771869335,0.08960149067494438,644.6446986198425,275.4614872932434,638.7007637023926,16129,4278,11851,11851,0,12,4265000.0
4265,4265999,21.13714270585592,38.448983453710056,0.08958311849985912,644.8242118358612,275.5226831436157,638.7085876464844,16131,4279,11852,11852,0,12,4266000.0
4266,4266999,21.137584639756323,38.450384930286695,0.08955420387347168,644.9492321014404,275.5832769870758,638.7859802246094,16131,4279,11852,11852,0,12,4267000.0
4267,4267999,21.137250111057888,38.44863331019111,0.08954253041936788,645.0756258964539,275.64400815963745,638.835994720459,16131,4279,11852,11852,0,12,4268000.0
4268,4268999,21.13730115730017,38.44818623495308,0.08952616229473465,645.2503564357758,275.70490193367004,638.8195495605469,16133,4280,11853,11853,0,12,4269000.0
4269,4269999,21.137346175594008,38.44834889995869,0.08952780315349784,645.4201328754425,275.76710534095764,638.8417854309082,16135,4281,11854,11854,0,12,4270000.0
4270,4270999,21.13734081426317,38.44776233758692,0.08951784374557825,645.5628900527954,278.24809551239014,638.9239387512207,16135,4281,11854,11854,0,12,4271000.0
4271,4271999,21.137882476261034,38.45037072108592,0.08949609317326657,645.7568480968475,278.3102676868439,638.9076271057129,16137,4282,11855,11855,0,12,4272000.0
4272,4272999,21.13757128660076,38.44837760510409,0.08949244110901289,645.9356565475464,278.3717420101166,638.8383598327637,16139,4283,11856,11856,0,12,4273000.0
4273,4273999,21.137631259768277,38.44702007834221,0.0894869166329737,646.0656368732452,278.43860626220703,638.9285774230957,16139,4283,11856,11856,0,12,4274000.0
4274,4274999,21.136957991869608,38.44489748751764,0.0894815180333215,646.1917200088501,278.50013422966003,639.0230560302734,16139,4283,11856,11856,0,12,4275000.0
4275,4275999,21.135952302567997,38.44292562578734,0.08947274724653453,646.3309109210968,278.5628979206085,639.5270729064941,16150,4283,11867,11867,0,12,4276000.0
4276,4276999,21.13446080342115,38.440921316764154,0.08946671303714415,646.4698915481567,278.62440729141235,639.8041343688965,16152,4283,11869,11869,0,12,4277000.0
4277,4277999,21.132727240275585,38.437756955833805,0.08946259422045855,646.6364071369171,278.6861298084259,639.9610176086426,16155,4284,11871,11871,0,12,4278000.0
4278,4278999,21.13142169799463,38.435414425745435,0.08945616903773257,646.7989180088043,278.7476670742035,640.0938911437988,16186,4285,11901,11901,0,12,4279000.0
4279,4279999,21.130623845427465,38.434868514027066,0.08944128498069714,646.9370756149292,278.80867099761963,640.2177505493164,16186,4285,11901,11901,0,12,4280000.0
4280,4280999,21.129540674932628,38.43231203277845,0.08942162795912667,647.0634417533875,278.86977076530457,640.3004989624023,16186,4285,11901,11901,0,12,4281000.0
4281,4281999,21.12841615379931,38.43010474884983,0.08940567012219969,647.2126631736755,278.931268453598,640.3782958984375,16186,4285,11901,11901,0,12,4282000.0
4282,4282999,21.12742709652212,38.427873601410255,0.08939122630683582,647.343296289444,278.9926121234894,640.4313735961914,16186,4285,11901,11901,0,12,4283000.0
4283,4283999,21.12676734515717,38.42665036015402,0.08936993088907796,647.5595996379852,279.054758310318,640.3634338378906,16190,4287,11903,11903,0,12,4284000.0
4284,4284999,21.125889116892814,38.42430276901822,0.08935285750044997,647.8061792850494,279.11861395835876,640.3212738037109,16196,4290,11906,11906,0,12,4285000.0
4285,4285999,21.125453906485816,38.42288909058322,0.08933008402381526,647.9404509067535,279.18070554733276,640.4363441467285,16196,4290,11906,11906,0,12,4286000.0
4286,4286999,21.125842630049114,38.424486434315234,0.08928690535870398,648.0867207050323,279.2425317764282,640.5409736633301,16196,4290,11906,11906,0,12,4287000.0
4287,4287999,21.12608870729799,38.42414352155905,0.0892498896530326,648.259681224823,279.3043100833893,640.5275650024414,16198,4291,11907,11907,0,12,4288000.0
4288,4288999,21.126466353654624,38.42367683386991,0.0892130845521254,648.4800770282745,279.3664982318878,640.4727478027344,16202,4293,11909,11909,0,12,4289000.0
4289,4289999,21.12807436454598,38.42723604966944,0.08915616652471181,648.6031482219696,279.42840480804443,640.6386680603027,16202,4293,11909,11909,0,12,4290000.0
4290,4290999,21.129937933506273,38.429758997349296,0.08910821019226989,648.7409465312958,279.4905278682709,640.7350997924805,16202,4293,11909,11909,0,12,4291000.0
4291,4291999,21.13190020600102,38.43278871664868,0.0890652767589667,648.8735644817352,279.55230712890625,640.7963409423828,16202,4293,11909,11909,0,12,4292000.0
4292,4292999,21.134353428122537,38.43709138286044,0.08901668095483206,649.0542507171631,279.61457324028015,640.7735443115234,16204,4294,11910,11910,0,12,4293000.0
4293,4293999,21.137638900062782,38.44534570158346,0.08896034107401485,649.2332470417023,279.6773066520691,640.7370796203613,16206,4295,11911,11911,0,12,4294000.0
4294,4294999,21.141288504898064,38.456549911901554,0.0889236970080115,649.3953268527985,279.74042201042175,640.8498497009277,16206,4295,11911,11911,0,12,4295000.0
4295,4295999,21.14397363118538,38.461234780535,0.08889187847211366,649.5819268226624,279.80324244499207,640.81640625,16208,4296,11912,11912,0,12,4296000.0
4296,4296999,21.145312859469033,38.46363767431052,0.08887873666540613,649.7131049633026,279.8658254146576,641.2626724243164,16217,4296,11921,11921,0,12,4297000.0
4297,4297999,21.144231162893252,38.46224516987051,0.08886927377244314,649.8378355503082,279.92891907691956,641.6591911315918,16221,4296,11925,11925,0,12,4298000.0
4298,4298999,21.14302312798327,38.460956920770265,0.08885720637698158,649.9521231651306,279.98992252349854,641.9050407409668,16222,4296,11926,11926,0,12,4299000.0
4299,4299999,21.142385081549964,38.46038804860728,0.08884035746405883,650.1152906417847,280.05162715911865,642.043270111084,16224,4297,11927,11927,0,12,4300000.0
4300,4300999,21.141489414805633,38.458642658289286,0.08882518491484603,650.2584190368652,280.11314868927,642.1887435913086,16224,4297,11927,11927,0,12,4301000.0
4301,4301999,21.14047712130839,38.456409107101095,0.08881602976324621,650.4317307472229,280.1746778488159,642.2050514221191,16226,4298,11928,11928,0,12,4302000.0
4302,4302999,21.13947574084479,38.454537160144284,0.0888016609670722,650.602153301239,280.2367560863495,642.3050842285156,16228,4299,11929,11929,0,12,4303000.0
4303,4303999,21.138877852121862,38.45305326546627,0.08878867088315223,650.7799980640411,280.2991876602173,642.324592590332,16232,4300,11932,11932,0,12,4304000.0
4304,4304999,21.137955524407435,38.45098606577325,0.08877754959020978,650.9884157180786,280.3619577884674,642.3367233276367,16236,4302,11934,11934,0,12,4305000.0
4305,4305999,21.137540235980026,38.44950795299154,0.0887615159366828,651.2192969322205,280.4265615940094,642.3796272277832,16240,4304,11936,11936,0,12,4306000.0
4306,4306999,21.13734776130624,38.448242314858284,0.08873813911792439,651.3859798908234,280.4886176586151,642.4449272155762,16242,4305,11937,11937,0,12,4307000.0
4307,4307999,21.13738780093275,38.44766657954108,0.08871141789383985,651.5195307731628,280.55036306381226,642.5381088256836,16242,4305,11937,11937,0,12,4308000.0
4308,4308999,21.136780329290055,38.445662314769585,0.08869772786960528,651.6983625888824,280.612441778183,642.5810432434082,16244,4306,11938,11938,0,12,4309000.0
4309,4309999,21.136759002743535,38.444397844335526,0.08867637007547435,651.826592206955,280.67446732521057,642.6831970214844,16244,4306,11938,11938,0,12,4310000.0
4310,4310999,21.137256220202417,38.45074476594042,0.0886227266939118,651.9780316352844,280.7363636493683,642.7787208557129,16244,4306,11938,11938,0,12,4311000.0
4311,4311999,21.137341895087015,38.44991357832525,0.08859828801308423,652.1116120815277,280.7988278865814,642.8390846252441,16244,4306,11938,11938,0,12,4312000.0
4312,4312999,21.137446285425014,38.4485851959376,0.08857900063228819,652.25541639328,280.8615207672119,642.9300270080566,16244,4306,11938,11938,0,12,4313000.0
4313,4313999,21.137493292231934,38.44741691343674,0.08855796644984648,652.4702923297882,280.9257023334503,642.8245468139648,16248,4308,11940,11940,0,12,4314000.0
4314,4314999,21.13722574623316,38.445901577809224,0.08854416629675388,652.6156499385834,280.98787236213684,642.9491233825684,16248,4308,11940,11940,0,12,4315000.0
4315,4315999,21.13641849425662,38.44378031020606,0.08853382262317999,652.7963759899139,281.0506019592285,643.3326873779297,16259,4309,11950,11950,0,12,4316000.0
4316,4316999,21.135668449068778,38.442386654151754,0.08852714254967131,652.9828898906708,281.11344289779663,643.5711517333984,16266,4310,11956,11956,0,12,4317000.0
4317,4317999,21.13568129923966,38.44275321795771,0.08851296101628447,653.1506605148315,281.1754946708679,643.7420768737793,16269,4311,11958,11958,0,12,4318000.0
4318,4318999,21.135561596490117,38.44263379716209,0.08849609301967487,653.3050739765167,281.2377817630768,643.9142112731934,16271,4312,11959,11959,0,12,4319000.0
4319,4319999,21.135507485890464,38.441491617376265,0.08848363931035486,653.4420804977417,281.3000898361206,644.0982398986816,16272,4312,11960,11960,0,12,4320000.0
4320,4320999,21.13570257095901,38.441288034100985,0.08848084849081417,653.6897785663605,281.36275696754456,644.1001472473145,16280,4315,11965,11965,0,12,4321000.0
4321,4321999,21.135827727801345,38.44041392872428,0.08847712029794352,653.8485510349274,281.4252164363861,644.231689453125,16282,4316,11966,11966,0,12,4322000.0
4322,4322999,21.135821891518464,38.439598540288834,0.08847189910833675,654.0409474372864,281.48770570755005,644.3051223754883,16284,4317,11967,11967,0,12,4323000.0
4323,4323999,21.1357701165757,38.43859832756714,0.08846813271757603,654.305114030838,281.55042362213135,644.1772956848145,16293,4320,11973,11973,0,12,4324000.0
4324,4324999,21.136219247427867,38.43804704582358,0.08845654324939622,654.4595620632172,281.61298847198486,644.2828941345215,16295,4321,11974,11974,0,12,4325000.0
4325,4325999,21.136789922906896,38.43769041475136,0.08844553853384585,654.6702704429626,281.6778848171234,644.3296318054199,16299,4323,11976,11976,0,12,4326000.0
4326,4326999,21.13788103064335,38.43954432619441,0.08842659657360241,654.8104104995728,281.740385055542,644.4661750793457,16299,4323,11976,11976,0,12,4327000.0
4327,4327999,21.138686067402055,38.439631530959154,0.08841562075337861,654.9380695819855,281.8027939796448,644.5780906677246,16299,4323,11976,11976,0,12,4328000.0
4328,4328999,21.139749927999897,38.439734477342746,0.08840645472082032,655.1313729286194,281.86558294296265,644.6035346984863,16304,4324,11980,11980,0,12,4329000.0
4329,4329999,21.141518777062107,38.44370602207223,0.08839673332033549,655.2670447826385,281.92809438705444,644.7127304077148,16304,4324,11980,11980,0,12,4330000.0
4330,4330999,21.143277877561868,38.445000404518375,0.08841409139467526,655.4109280109406,281.99153423309326,644.8049812316895,16304,4324,11980,11980,0,12,4331000.0
4331,4331999,21.146136013848224,38.44877305788797,0.08843809393985558,655.5476055145264,282.05576181411743,644.8970985412598,16304,4324,11980,11980,0,12,4332000.0
4332,4332999,21.14850103752633,38.45193619031632,0.08847676070437849,655.7211060523987,282.1184170246124,644.8843803405762,16306,4325,11981,11981,0,12,4333000.0
4333,4333999,21.15122617517938,38.45502586580122,0.08849898909694809,655.876959323883,282.1819226741791,644.9759216308594,16306,4325,11981,11981,0,12,4334000.0
4334,4334999,21.15393629787857,38.45794167734203,0.08851760804168263,656.0211062431335,282.24448227882385,645.0520401000977,16306,4325,11981,11981,0,12,4335000.0
4335,4335999,21.15519748168877,38.45848908155329,0.08851920454652451,656.1551268100739,282.30729126930237,645.4268417358398,16317,4325,11992,11992,0,12,4336000.0
4336,4336999,21.154150397872698,38.45735256169799,0.08850302269553911,656.3094851970673,282.36943197250366,645.8427238464355,16329,4326,12003,12003,0,12,4337000.0
4337,4337999,21.153240552508485,38.459390908611844,0.08847948554540674,656.4202449321747,282.4313759803772,646.1784706115723,16330,4326,12004,12004,0,12,4338000.0
4338,4338999,21.15213600421938,38.45734211761909,0.08847486025351792,656.6216716766357,282.4941234588623,646.3663673400879,16334,4328,12006,12006,0,12,4339000.0
4339,4339999,21.151420489833722,38.456032256974076,0.08846421966139495,656.8010814189911,282.55626368522644,646.4880294799805,16336,4329,12007,12007,0,12,4340000.0
4340,4340999,21.150313894873545,38.453881574273225,0.0884541986135996,657.0039682388306,282.6201786994934,646.5598220825195,16344,4331,12013,12013,0,12,4341000.0
4341,4341999,21.149453432994736,38.45334934000039,0.08844104517799767,657.2311532497406,282.68475222587585,646.6808624267578,16348,4333,12015,12015,0,12,4342000.0
4342,4342999,21.149058023565463,38.453291106952754,0.08842271568245363,657.434522151947,282.7475130558014,646.6729278564453,16356,4335,12021,12021,0,12,4343000.0
4343,4343999,21.14864591326064,38.45191136019745,0.08841141924040397,657.6376857757568,282.81023120880127,646.7409820556641,16360,4337,12023,12023,0,12,4344000.0
4344,4344999,21.148351051160276,38.450247999326756,0.08840347852909303,657.8894560337067,282.8735041618347,646.719352722168,16370,4340,12030,12030,0,12,4345000.0
4345,4345999,21.14902664206769,38.45119175814315,0.0883909187162637,658.0485732555389,282.9361844062805,646.8914566040039,16377,4341,12036,12036,0,12,4346000.0
4346,4346999,21.149856209108513,38.45213235168325,0.08837233791454602,658.2171139717102,283.00072598457336,646.9529457092285,16379,4342,12037,12037,0,12,4347000.0
4347,4347999,21.150782080124973,38.45308529982918,0.08835579409653249,658.4504685401917,283.06381273269653,646.9491500854492,16383,4344,12039,12039,0,12,4348000.0
4348,4348999,21.151929993516934,38.454689020802995,0.08833934537417643,658.586240530014,283.12719559669495,647.1436805725098,16383,4344,12039,12039,0,12,4349000.0
4349,4349999,21.154004876396897,38.45975313693098,0.088312314825164,658.7636804580688,283.1899175643921,647.1635475158691,16389,4345,12044,12044,0,12,4350000.0
4350,4350999,21.156139800515728,38.46770570774655,0.08827612994750955,658.8982396125793,283.25305557250977,647.2930221557617,16389,4345,12044,12044,0,12,4351000.0
4351,4351999,21.158734174431963,38.47140850923365,0.08827068526467396,659.0256760120392,283.3173174858093,647.4104080200195,16389,4345,12044,12044,0,12,4352000.0
4352,4352999,21.16123889254503,38.47449782594851,0.08826963361460038,659.2816514968872,283.3806164264679,647.3422927856445,16395,4348,12047,12047,0,12,4353000.0
4353,4353999,21.163817156560288,38.477561194619454,0.08828085835293198,659.4665627479553,283.44393253326416,647.4107513427734,16397,4349,12048,12048,0,12,4354000.0
4354,4354999,21.166252005115982,38.480018636767504,0.08828054012169473,659.5908172130585,283.50685024261475,647.5724678039551,16397,4349,12048,12048,0,12,4355000.0
4355,4355999,21.16920750197359,38.48341615284538,0.08829288317655204,659.7776579856873,283.57012248039246,647.5921020507812,16401,4350,12051,12051,0,12,4356000.0
4356,4356999,21.170094693973596,38.48273003566022,0.08830235560033384,659.9074985980988,283.6331512928009,647.7598266601562,16401,4350,12051,12051,0,12,4357000.0
4357,4357999,21.169116121227624,38.480805808229306,0.08829265686862242,660.0311965942383,283.7004075050354,648.6799659729004,16421,4350,12071,12071,0,12,4358000.0
4358,4358999,21.16810580400758,38.48103547068024,0.08827538454360018,660.1520953178406,283.7626349925995,649.0489501953125,16421,4350,12071,12071,0,12,4359000.0
4359,4359999,21.16755848116045,38.48059828553503,0.0882673925254327,660.4269771575928,283.8256571292877,649.1179275512695,16435,4354,12081,12081,0,12,4360000.0
4360,4360999,21.16732379831584,38.48005490393568,0.08826073674318069,660.5500981807709,283.8901243209839,649.3549842834473,16435,4354,12081,12081,0,12,4361000.0
4361,4361999,21.167804441832445,38.482237776298426,0.08822744627710022,660.7543950080872,283.9525570869446,649.4182281494141,16439,4356,12083,12083,0,12,4362000.0
4362,4362999,21.168091872232,38.482629105116,0.08821615664072147,661.0239119529724,284.015828371048,649.4492874145508,16451,4360,12091,12091,0,12,4363000.0
4363,4363999,21.167764296077234,38.481449309749024,0.08820707498045843,661.2878911495209,284.08223128318787,649.5748977661133,16458,4363,12095,12095,0,12,4364000.0
4364,4364999,21.168020861036887,38.48105406940547,0.08819373719401957,661.5760054588318,284.1460585594177,649.5993194580078,16471,4367,12104,12104,0,12,4365000.0
4365,4365999,21.16771434927027,38.47961877198411,0.08818826135236257,661.7746815681458,284.2117500305176,649.7382583618164,16475,4369,12106,12106,0,12,4366000.0
4366,4366999,21.16815631987817,38.47952405048181,0.08817434134497781,661.979053735733,284.2757098674774,649.9669990539551,16479,4371,12108,12108,0,12,4367000.0
4367,4367999,21.168200247020582,38.47881839440425,0.08816396909887159,662.1394283771515,284.33916544914246,650.1384391784668,16481,4372,12109,12109,0,12,4368000.0
4368,4368999,21.168716816333493,38.47873358183895,0.088158008239696,662.3221192359924,284.4047236442566,650.2932929992676,16483,4373,12110,12110,0,12,4369000.0
4369,4369999,21.169437382337954,38.47943590299294,0.0881449565931981,662.4900352954865,284.46829628944397,650.45068359375,16485,4374,12111,12111,0,12,4370000.0
4370,4370999,21.170225068851042,38.47945024403622,0.08813443564979473,662.6654167175293,284.53230118751526,650.5787162780762,16487,4375,12112,12112,0,12,4371000.0
4371,4371999,21.17076619878281,38.47906385588043,0.08812447792236155,662.8076648712158,284.59600138664246,650.7709159851074,16487,4375,12112,12112,0,12,4372000.0
4372,4372999,21.17186597368436,38.480094246909196,0.08811518380736305,662.9428770542145,284.6592719554901,650.9590950012207,16487,4375,12112,12112,0,12,4373000.0
4373,4373999,21.172834066427118,38.48048702938608,0.0881096428835384,663.123123884201,284.7230055332184,651.0238380432129,16494,4376,12118,12118,0,12,4374000.0
4374,4374999,21.173754121272413,38.481442285311005,0.08809651230846438,663.2702403068542,284.7866733074188,651.1486854553223,16494,4376,12118,12118,0,12,4375000.0
4375,4375999,21.17469991727131,38.48223230407705,0.0880835377480208,663.4279336929321,284.85050439834595,651.2726669311523,16494,4376,12118,12118,0,12,4376000.0
4376,4376999,21.175410327836314,38.48176573210459,0.08807994246565687,663.5558435916901,284.91390895843506,651.3914756774902,16494,4376,12118,12118,0,12,4377000.0
4377,4377999,21.17572691614845,38.48164621408613,0.08806901756847285,663.6951489448547,284.97774958610535,651.5212898254395,16494,4376,12118,12118,0,12,4378000.0
4378,4378999,21.176048665103718,38.48196703248707,0.08804349520024402,663.8597176074982,285.04385209083557,652.370246887207,16512,4377,12135,12135,0,12,4379000.0
4379,4379999,21.17615213564309,38.48304129099779,0.08801895838918838,663.980907201767,285.10676288604736,652.7636299133301,16512,4377,12135,12135,0,12,4380000.0
4380,4380999,21.176067518764988,38.48226494663706,0.08800297774629717,664.147527217865,285.17010474205017,652.9497566223145,16521,4378,12143,12143,0,12,4381000.0
4381,4381999,21.17640328712457,38.48230777445834,0.08798536049091055,664.2615685462952,285.23336029052734,653.1741714477539,16521,4378,12143,12143,0,12,4382000.0
4382,4382999,21.176861798344092,38.48243616333013,0.08796651934758315,664.4359076023102,285.29593682289124,653.2990798950195,16523,4379,12144,12144,0,12,4383000.0
4383,4383999,21.177809237355337,38.49334024971204,0.0879030681465216,664.5738246440887,285.35863733291626,653.4789657592773,16523,4379,12144,12144,0,12,4384000.0
4384,4384999,21.17790204110489,38.493180256001615,0.08788383952016077,664.7158033847809,285.4212522506714,653.6263427734375,16524,4379,12145,12145,0,12,4385000.0
4385,4385999,21.1784029662977,38.493547312637645,0.08787090870686598,664.8863182067871,285.4836959838867,653.6782684326172,16526,4380,12146,12146,0,12,4386000.0
4386,4386999,21.178548689829753,38.49359655146239,0.08785505676302496,665.108204126358,285.5461919307709,653.686637878418,16530,4382,12148,12148,0,12,4387000.0
4387,4387999,21.178864506906393,38.49384649534501,0.08784150199794305,665.3124141693115,285.6090679168701,653.7373123168945,16540,4384,12156,12156,0,12,4388000.0
4388,4388999,21.1796316608824,38.494659624002026,0.08782862337690911,665.490195274353,285.67218804359436,653.8156318664551,16542,4385,12157,12157,0,12,4389000.0
4389,4389999,21.180224718046432,38.4947515654764,0.08782095193911144,665.6166727542877,285.73467683792114,653.9888534545898,16542,4385,12157,12157,0,12,4390000.0
4390,4390999,21.18120858529978,38.49652779753713,0.08780513174511029,665.7608957290649,285.79704880714417,654.0986557006836,16542,4385,12157,12157,0,12,4391000.0
4391,4391999,21.182081024226,38.49704375023113,0.08780743787507361,665.9386870861053,285.85982966423035,654.1439208984375,16544,4386,12158,12158,0,12,4392000.0
4392,4392999,21.183137844479585,38.4980109882005,0.08779257168948429,666.0808386802673,285.9241769313812,654.2810173034668,16544,4386,12158,12158,0,12,4393000.0
4393,4393999,21.184238119397847,38.498750111957776,0.08779416850252797,666.2440168857574,285.9865255355835,654.326976776123,16552,4387,12165,12165,0,12,4394000.0
4394,4394999,21.18631926516098,38.5056314909808,0.08775920669961712,666.3656034469604,286.0487060546875,654.4239311218262,16552,4387,12165,12165,0,12,4395000.0
4395,4395999,21.187616647415087,38.507852341788464,0.08775078622290122,666.5788879394531,286.1119511127472,654.4272308349609,16554,4388,12166,12166,0,12,4396000.0
4396,4396999,21.188986633672567,38.50981129025012,0.08773240678471883,666.7164771556854,286.1744568347931,654.5214881896973,16554,4388,12166,12166,0,12,4397000.0
4397,4397999,21.190397585059106,38.512450651807356,0.08771619183641122,666.8984305858612,286.2372930049896,654.5128746032715,16556,4389,12167,12167,0,12,4398000.0
4398,4398999,21.190951654373777,38.511762726918285,0.08771321697294443,667.0274524688721,286.2996573448181,654.6144523620605,16556,4389,12167,12167,0,12,4399000.0
4399,4399999,21.190441010860383,38.50984852711126,0.08770505282351837,667.1459782123566,286.3635678291321,655.4948539733887,16568,4389,12179,12179,0,12,4400000.0
4400,4400999,21.189245705078545,38.50955865287537,0.08769656297038697,667.2993197441101,286.42776703834534,655.8360748291016,16578,4390,12188,12188,0,12,4401000.0
4401,4401999,21.187775540937636,38.50773440036159,0.0876930719026997,667.4226517677307,286.4901087284088,656.1546173095703,16579,4390,12189,12189,0,12,4402000.0
4402,4402999,21.186412607226632,38.505999674801615,0.08769130589398011,667.5866467952728,286.5529716014862,656.2914810180664,16581,4391,12190,12190,0,12,4403000.0
4403,4403999,21.18503971512092,38.5034504173147,0.08768947009286998,667.7918565273285,286.61751794815063,656.4186210632324,16585,4393,12192,12192,0,12,4404000.0
4404,4404999,21.184068331204863,38.50163795485897,0.08768105440546381,667.9690546989441,286.6804497241974,656.5673904418945,16587,4394,12193,12193,0,12,4405000.0
4405,4405999,21.182923536085035,38.49900474595701,0.08767912015627177,668.1063179969788,286.74335408210754,656.7799415588379,16589,4394,12195,12195,0,12,4406000.0
4406,4406999,21.182337708532447,38.497841341686566,0.08766474721121054,668.3145761489868,286.80607414245605,656.8262557983398,16600,4396,12204,12204,0,12,4407000.0
4407,4407999,21.182037587735337,38.49776644040743,0.08764773122542169,668.5417540073395,286.869256734848,656.8931846618652,16604,4398,12206,12206,0,12,4408000.0
4408,4408999,21.182695123642286,38.500726051762015,0.08761164602596005,668.7010004520416,286.9323055744171,657.0269050598145,16606,4399,12207,12207,0,12,4409000.0
4409,4409999,21.185225093069594,38.50910480160967,0.08754779832771775,668.8460822105408,286.9953486919403,657.1909217834473,16606,4399,12207,12207,0,12,4410000.0
4410,4410999,21.188837312855142,38.52144843170588,0.08747323994175737,669.0137240886688,287.05821204185486,657.272647857666,16608,4400,12208,12208,0,12,4411000.0
4411,4411999,21.19370320094821,38.54069276041966,0.08738474618321912,669.199565410614,287.12153029441833,657.3689651489258,16610,4401,12209,12209,0,12,4412000.0
4412,4412999,21.198424471967,38.554529578515655,0.08734085840336525,669.3692445755005,287.1863634586334,657.4716110229492,16612,4402,12210,12210,0,12,4413000.0
4413,4413999,21.2033271829669,38.57075259353116,0.08734265705488076,669.5395426750183,287.24991846084595,657.5750160217285,16614,4403,12211,12211,0,12,4414000.0
4414,4414999,21.209152154846524,38.58999018850191,0.08732167338013719,669.7854971885681,287.31343030929565,657.5405960083008,16620,4406,12214,12214,0,12,4415000.0
4415,4415999,21.215215723273584,38.61055640219543,0.08739557419794186,669.9581744670868,287.37650299072266,657.704288482666,16622,4407,12215,12215,0,12,4416000.0
4416,4416999,21.221504329576614,38.6260955304601,0.08744771226724068,670.1637156009674,287.44003558158875,657.7792854309082,16624,4408,12216,12216,0,12,4417000.0
4417,4417999,21.227533169622593,38.64256261946936,0.08751347466151793,670.2778506278992,287.50299644470215,657.9030570983887,16624,4408,12216,12216,0,12,4418000.0
4418,4418999,21.234638178740436,38.6606719780133,0.08761888691017716,670.5008256435394,287.5672118663788,657.8140182495117,16628,4410,12218,12218,0,12,4419000.0
4419,4419999,21.239669753975537,38.673546197028955,0.08770603707621594,670.6335835456848,287.6307010650635,657.9704742431641,16628,4410,12218,12218,0,12,4420000.0
4420,4420999,21.24003891451271,38.67413298472251,0.08768987442364917,670.764760017395,287.69464921951294,658.9685554504395,16642,4410,12232,12232,0,12,4421000.0
4421,4421999,21.23867191217436,38.671807646667,0.0876869599654787,670.8929221630096,287.7583558559418,659.413215637207,16645,4410,12235,12235,0,12,4422000.0
4422,4422999,21.23775160029394,38.66960136216938,0.0876803935809829,671.0089049339294,287.82137632369995,659.7248306274414,16646,4410,12236,12236,0,12,4423000.0
4423,4423999,21.237468991097476,38.67387724101986,0.08764791978309139,671.1662409305573,287.88454842567444,659.819953918457,16648,4411,12237,12237,0,12,4424000.0
4424,4424999,21.23703246715128,38.6735508220608,0.08763915146249168,671.3738298416138,287.9481942653656,659.9459571838379,16652,4413,12239,12239,0,12,4425000.0
4425,4425999,21.236414575534415,38.67246028723006,0.08762483234656926,671.5126385688782,288.0116949081421,660.1949615478516,16653,4413,12240,12240,0,12,4426000.0
4426,4426999,21.23558509992898,38.67037107372269,0.08762024692547044,671.657557964325,288.0748348236084,660.3931121826172,16653,4413,12240,12240,0,12,4427000.0
4427,4427999,21.235119381035446,38.66862949641866,0.08761707005330122,671.863673210144,288.13888597488403,660.4111709594727,16662,4415,12247,12247,0,12,4428000.0
4428,4428999,21.234797939582943,38.66734357718077,0.08760870588279257,672.0389664173126,288.2022850513458,660.5129356384277,16664,4416,12248,12248,0,12,4429000.0
4429,4429999,21.235155687194688,38.67115153585272,0.08758090348036729,672.2099845409393,288.2660245895386,660.6329612731934,16666,4417,12249,12249,0,12,4430000.0
4430,4430999,21.236085018900813,38.672466326512414,0.08756728843413408,672.3424260616302,288.32904076576233,660.7605094909668,16666,4417,12249,12249,0,12,4431000.0
4431,4431999,21.23711381949781,38.67389306584199,0.08756334601955029,672.4682095050812,288.392067193985,660.8909339904785,16666,4417,12249,12249,0,12,4432000.0
4432,4432999,21.23834377961323,38.675535787861065,0.08755575660253989,672.6117873191833,288.45536065101624,660.9985809326172,16666,4417,12249,12249,0,12,4433000.0
4433,4433999,21.239743377494705,38.67734865314551,0.08756001008360348,672.7948846817017,288.5194044113159,661.0444488525391,16668,4418,12250,12250,0,12,4434000.0
4434,4434999,21.24144394952643,38.680898159114065,0.08756243191634039,672.9154357910156,288.58440232276917,661.1798515319824,16668,4418,12250,12250,0,12,4435000.0
4435,4435999,21.243858318330965,38.684957927355796,0.08759618028757266,673.1396787166595,288.64820194244385,661.185131072998,16672,4420,12252,12252,0,12,4436000.0
4436,4436999,21.24588502223235,38.69200511640444,0.08758570180627578,673.2697684764862,288.7114357948303,661.3166961669922,16672,4420,12252,12252,0,12,4437000.0
4437,4437999,21.24800272351638,38.69490922099591,0.0875995998862632,673.5125937461853,288.7753520011902,661.2674140930176,16676,4422,12254,12254,0,12,4438000.0
4438,4438999,21.250408462472354,38.6996049701763,0.08760155989365004,673.6333553791046,288.8387851715088,661.4252815246582,16676,4422,12254,12254,0,12,4439000.0
4439,4439999,21.25312758301427,38.704612469222006,0.08762762214900033,673.856219291687,288.90257453918457,661.4003067016602,16692,4424,12268,12268,0,12,4440000.0
4440,4440999,21.254672315945065,38.70620599139294,0.08764942930570485,673.9960849285126,288.96806931495667,661.5253982543945,16692,4424,12268,12268,0,12,4441000.0
4441,4441999,21.25459471168631,38.70510435388954,0.08765454005280315,674.1223964691162,289.0316708087921,662.4583206176758,16708,4424,12284,12284,0,12,4442000.0
4442,4442999,21.25321687324267,38.703016751918476,0.08765819875086678,674.2391786575317,289.09443521499634,662.9877662658691,16711,4424,12287,12287,0,12,4443000.0
4443,4443999,21.251839561671037,38.70175174416183,0.08765834405974815,674.3574132919312,289.1576454639435,663.3005867004395,16712,4424,12288,12288,0,12,4444000.0
4444,4444999,21.250140050894434,38.69948340872101,0.08766420437348799,674.5199580192566,289.22015476226807,663.4091644287109,16714,4425,12289,12289,0,12,4445000.0
4445,4445999,21.248629515272302,38.697001550421376,0.08766784902876079,674.6381673812866,289.2833180427551,663.6254692077637,16714,4425,12289,12289,0,12,4446000.0
4446,4446999,21.24701680542592,38.69447206520165,0.08767386526926813,674.843542098999,289.3471405506134,663.6568984985352,16724,4427,12297,12297,0,12,4447000.0
4447,4447999,21.24550715893414,38.69222611199354,0.08767489351776392,675.0548577308655,289.4103171825409,663.8315162658691,16728,4429,12299,12299,0,12,4448000.0
4448,4448999,21.244091059479935,38.689613081968346,0.08768236921345518,675.2191371917725,289.4736144542694,664.0059204101562,16730,4430,12300,12300,0,12,4449000.0
4449,4449999,21.242730191887382,38.68714824109338,0.08768631214215461,675.4214925765991,289.53679370880127,664.0357437133789,16734,4432,12302,12302,0,12,4450000.0
4450,4450999,21.241594503095776,38.68525206136747,0.08768668456505924,675.5925052165985,289.60160422325134,664.1678428649902,16736,4433,12303,12303,0,12,4451000.0
4451,4451999,21.24075192114003,38.68309697701134,0.08768280436087794,675.7256348133087,289.6647961139679,664.3814163208008,16736,4433,12303,12303,0,12,4452000.0
4452,4452999,21.240019332343177,38.68176275018435,0.08767909484033676,675.8651721477509,289.7274549007416,664.496452331543,16736,4433,12303,12303,0,12,4453000.0
4453,4453999,21.238959946429006,38.67933019727807,0.08767984562061804,676.0261270999908,289.79042077064514,664.5629348754883,16738,4434,12304,12304,0,12,4454000.0
4454,4454999,21.238142287885086,38.677305703364524,0.08767956096611229,676.19300532341,289.8538410663605,664.6714096069336,16740,4435,12305,12305,0,12,4455000.0
4455,4455999,21.23732750845288,38.67507468888689,0.0876818935534237,676.3297259807587,289.9174816608429,664.7928047180176,16740,4435,12305,12305,0,12,4456000.0
4456,4456999,21.23661606907288,38.67321241347419,0.08768246067662466,676.5104320049286,289.9806020259857,664.8702735900879,16742,4436,12306,12306,0,12,4457000.0
4457,4457999,21.235832506516015,38.671226999459165,0.08768193382241463,676.7218611240387,290.0436692237854,664.8138885498047,16746,4438,12308,12308,0,12,4458000.0
4458,4458999,21.235050500339774,38.669078309965,0.08768331551779651,676.8438746929169,290.106520652771,664.9893074035645,16746,4438,12308,12308,0,12,4459000.0
4459,4459999,21.23424684034609,38.66734304920572,0.08768183549329733,676.9626522064209,290.1691949367523,665.1388206481934,16746,4438,12308,12308,0,12,4460000.0
4460,4460999,21.23449096086858,38.66706703823175,0.08762584559488518,677.0985763072968,290.23313546180725,666.0182800292969,16762,4438,12324,12324,0,12,4461000.0
4461,4461999,21.23390661471683,38.66526501852826,0.08759306605748496,677.3000524044037,290.2976064682007,666.2959098815918,16769,4440,12329,12329,0,12,4462000.0
4462,4462999,21.233489441384773,38.66446137053026,0.08756087776668298,677.5864231586456,290.361704826355,666.289981842041,16777,4444,12333,12333,0,12,4463000.0
4463,4463999,21.23215736818613,38.6621820005076,0.08755683207401155,677.6964728832245,290.42606949806213,666.6041030883789,16777,4444,12333,12333,0,12,4464000.0
4464,4464999,21.23106426431264,38.660429325887456,0.08755098802734718,677.8746676445007,290.48929500579834,666.7585678100586,16780,4445,12335,12335,0,12,4465000.0
4465,4465999,21.23012214825908,38.65893469376231,0.0875489823793475,678.0059015750885,290.55302333831787,666.9923286437988,16781,4445,12336,12336,0,12,4466000.0
4466,4466999,21.22917207055829,38.660727476299456,0.08752301540613505,678.1705968379974,290.61650371551514,667.1206817626953,16783,4446,12337,12337,0,12,4467000.0
4467,4467999,21.22788485612283,38.658221172213715,0.08751377440780417,678.4229609966278,290.68071699142456,667.0738487243652,16789,4449,12340,12340,0,12,4468000.0
4468,4468999,21.226801575995793,38.65590828010519,0.08750647682924584,678.6283886432648,290.74573612213135,667.1984252929688,16798,4451,12347,12347,0,12,4469000.0
4469,4469999,21.225662885870015,38.653593728953844,0.08750434264175577,678.7445449829102,290.80869221687317,667.3666152954102,16798,4451,12347,12347,0,12,4470000.0
4470,4470999,21.224847171546195,38.651769970133024,0.08749773954658668,678.9302515983582,290.873352766037,667.4978790283203,16800,4452,12348,12348,0,12,4471000.0
4471,4471999,21.22434218446012,38.650352258414195,0.08748467660637826,679.0893812179565,290.93686175346375,667.5864906311035,16802,4453,12349,12349,0,12,4472000.0
4472,4472999,21.223748666689026,38.64929213954597,0.08747727781119008,679.2101929187775,290.99967980384827,667.7171859741211,16802,4453,12349,12349,0,12,4473000.0
4473,4473999,21.223221221720575,38.64801491918589,0.08746884014028744,679.4153385162354,291.06334376335144,667.7434005737305,16806,4455,12351,12351,0,12,4474000.0
4474,4474999,21.222761994306694,38.64656431811015,0.0874633355454496,679.6290128231049,291.12735629081726,667.7453689575195,16810,4457,12353,12353,0,12,4475000.0
4475,4475999,21.22250847382461,38.645004657929974,0.08745861232025509,679.9159173965454,291.1930809020996,667.5964088439941,16818,4461,12357,12357,0,12,4476000.0
4476,4476999,21.222099189670228,38.643126446546816,0.08745887253457485,680.1410796642303,291.2585754394531,667.6936988830566,16822,4463,12359,12359,0,12,4477000.0
4477,4477999,21.222517073122606,38.642818807480836,0.08743295183596955,680.3161845207214,291.32227540016174,667.8245239257812,16824,4464,12360,12360,0,12,4478000.0
4478,4478999,21.22256525160111,38.64157476459195,0.08742494674807388,680.4313099384308,291.38576102256775,667.9795417785645,16824,4464,12360,12360,0,12,4479000.0
4479,4479999,21.22239504949272,38.640235145703045,0.0874162486411828,680.6085202693939,291.45177578926086,668.0587158203125,16826,4465,12361,12361,0,12,4480000.0
4480,4480999,21.22201130683852,38.63925721033671,0.08740007500489655,680.8096656799316,291.5163564682007,668.4113922119141,16835,4466,12369,12369,0,12,4481000.0
4481,4481999,21.221482740857475,38.63787844391601,0.08737296716092824,680.9309086799622,291.5796241760254,669.0295181274414,16842,4466,12376,12376,0,12,4482000.0
4482,4482999,21.22075978303296,38.63884787109685,0.08735109633982507,681.1401958465576,291.6429352760315,669.1488838195801,16847,4468,12379,12379,0,12,4483000.0
4483,4483999,21.219620471645342,38.63677955789762,0.08734264953236559,681.2694084644318,291.70594906806946,669.3926696777344,16848,4468,12380,12380,0,12,4484000.0
4484,4484999,21.218661264276413,38.63616275994899,0.08733394958341001,681.5183176994324,291.76992177963257,669.404541015625,16854,4471,12383,12383,0,12,4485000.0
4485,4485999,21.21725658523036,38.63370470336963,0.08733286375112814,681.6899683475494,291.8332722187042,669.4876556396484,16856,4472,12384,12384,0,12,4486000.0
4486,4486999,21.216097543781114,38.63139638580149,0.08732571919997723,681.8128159046173,291.8966965675354,669.6849555969238,16857,4472,12385,12385,0,12,4487000.0
4487,4487999,21.214657830049198,38.628779880077914,0.08732257052283598,681.9356055259705,291.96074056625366,669.8418235778809,16857,4472,12385,12385,0,12,4488000.0
4488,4488999,21.213682166068462,38.62686008786558,0.08731827027913874,682.1274027824402,292.0240316390991,669.9280967712402,16859,4473,12386,12386,0,12,4489000.0
4489,4489999,21.21262216442995,38.62432557930212,0.08730934169139981,682.4053790569305,292.08844780921936,669.7907218933105,16867,4477,12390,12390,0,12,4490000.0
4490,4490999,21.211521524249736,38.62194528262292,0.08730260730109629,682.5774273872375,292.15235328674316,669.8794403076172,16869,4478,12391,12391,0,12,4491000.0
4491,4491999,21.21093559992378,38.620320987005954,0.08729140422414738,682.7023692131042,292.21543312072754,670.0458602905273,16869,4478,12391,12391,0,12,4492000.0
4492,4492999,21.21065806531053,38.619782185285224,0.08727352171897285,682.8652591705322,292.27871012687683,670.0820503234863,16871,4479,12392,12392,0,12,4493000.0
4493,4493999,21.210428194955778,38.61885311436196,0.08726209459362622,683.0228719711304,292.3433904647827,670.1594924926758,16873,4480,12393,12393,0,12,4494000.0
4494,4494999,21.210105388813183,38.61783388910564,0.08724995617502795,683.2491767406464,292.407564163208,670.1554527282715,16877,4482,12395,12395,0,12,4495000.0
4495,4495999,21.210174120366293,38.61723983528498,0.08723398501810065,683.4193091392517,292.4715428352356,670.2450981140137,16879,4483,12396,12396,0,12,4496000.0
4496,4496999,21.21006538184038,38.61566907495216,0.08722227287878415,683.6204345226288,292.5355007648468,670.3340034484863,16881,4484,12397,12397,0,12,4497000.0
4497,4497999,21.209639001105053,38.614077388521785,0.08721871473692422,683.8005750179291,292.5995740890503,670.416259765625,16883,4485,12398,12398,0,12,4498000.0
4498,4498999,21.209682699893417,38.612975516386506,0.0872106213931586,683.9521048069,292.66359972953796,670.5229454040527,16883,4485,12398,12398,0,12,4499000.0
4499,4499999,21.20943084041829,38.61123790823789,0.08720117515046577,684.079288482666,292.72889161109924,670.617992401123,16883,4485,12398,12398,0,12,4500000.0
4500,4500999,21.209412119999893,38.61153435104034,0.08719144713831883,684.2170782089233,292.79260087013245,670.7093391418457,16883,4485,12398,12398,0,12,4501000.0
4501,4501999,21.2089861317478,38.6097634227897,0.08718714372062375,684.3388953208923,292.85649609565735,670.8142509460449,16883,4485,12398,12398,0,12,4502000.0
4502,4502999,21.208811642249746,38.60919868976816,0.08717254907836458,684.4656980037689,292.9210968017578,671.5547676086426,16897,4485,12412,12412,0,12,4503000.0
4503,4503999,21.20824733230014,38.609221626782094,0.08715571983733728,684.5850775241852,292.9843399524689,671.8981781005859,16898,4485,12413,12413,0,12,4504000.0
4504,4504999,21.20746860649595,38.60706108826258,0.08714535025406722,684.7625997066498,293.04746770858765,672.047981262207,16901,4486,12415,12415,0,12,4505000.0
4505,4505999,21.206700931985676,38.60512811503945,0.08714367966792591,684.8842625617981,293.1107020378113,672.228199005127,16901,4486,12415,12415,0,12,4506000.0
4506,4506999,21.20571547169821,38.60252632446657,0.08713902877121626,685.0972988605499,293.17461609840393,672.215015411377,16905,4488,12417,12417,0,12,4507000.0
4507,4507999,21.205224141375016,38.601223049545375,0.08713626956776321,685.3061079978943,293.23776626586914,672.2409782409668,16910,4490,12420,12420,0,12,4508000.0
4508,4508999,21.204898194406237,38.59950007580999,0.08713522433732135,685.5076334476471,293.30167055130005,672.3355522155762,16914,4492,12422,12422,0,12,4509000.0
4509,4509999,21.20448281566076,38.59777737002861,0.08713572131621727,685.6427369117737,293.3661389350891,672.5335121154785,16914,4492,12422,12422,0,12,4510000.0
4510,4510999,21.203915450225214,38.59573809866902,0.08713402382271385,685.9156484603882,293.43057203292847,672.5070953369141,16920,4495,12425,12425,0,12,4511000.0
4511,4511999,21.203587526525794,38.59449184437139,0.08712751407521901,686.0840773582458,293.4945480823517,672.6362571716309,16922,4496,12426,12426,0,12,4512000.0
4512,4512999,21.203410318768668,38.59281710381437,0.08712153254630128,686.2088706493378,293.5575511455536,672.7591361999512,16922,4496,12426,12426,0,12,4513000.0
4513,4513999,21.203368789555338,38.591843418017525,0.08711593133450568,686.398928642273,293.62117075920105,672.785026550293,16924,4497,12427,12427,0,12,4514000.0
4514,4514999,21.203349655338247,38.59086467503592,0.08710569066455276,686.5497944355011,293.69407200813293,672.9302749633789,16924,4497,12427,12427,0,12,4515000.0
4515,4515999,21.203379092574753,38.589860413378105,0.08709825363178003,686.7125444412231,293.75736570358276,672.964527130127,16926,4498,12428,12428,0,12,4516000.0
4516,4516999,21.203297411078786,38.58822718873446,0.08709183968941436,686.83398270607,293.8212080001831,673.0832214355469,16926,4498,12428,12428,0,12,4517000.0
4517,4517999,21.2034809472087,38.58703874041504,0.08708283368471392,687.1066830158234,293.8855867385864,672.9731864929199,16932,4501,12431,12431,0,12,4518000.0
4518,4518999,21.20342584318235,38.58548944742302,0.08707830929917926,687.232203245163,293.9488968849182,673.1076126098633,16932,4501,12431,12431,0,12,4519000.0
4519,4519999,21.203762078176382,38.584803868050344,0.0870662215523651,687.3929831981659,294.01250076293945,673.1371688842773,16934,4502,12432,12432,0,12,4520000.0
4520,4520999,21.204175602125204,38.583867101174,0.08705690888590822,687.5985608100891,294.076984167099,673.1800537109375,16936,4503,12433,12433,0,12,4521000.0
4521,4521999,21.204176349956423,38.5823715137317,0.08705019317643314,687.7550191879272,294.1471447944641,673.2602729797363,16936,4503,12433,12433,0,12,4522000.0
4522,4522999,21.204298064293294,38.58116769309986,0.08704229513597972,687.9612491130829,294.21134305000305,673.3041915893555,16938,4504,12434,12434,0,12,4523000.0
4523,4523999,21.20390326971701,38.57954895969556,0.0870248407906935,688.0824551582336,294.2751441001892,673.7952079772949,16950,4504,12446,12446,0,12,4524000.0
4524,4524999,21.20301006646313,38.57809323351934,0.08701288391180528,688.4299352169037,294.3405613899231,673.6994323730469,16963,4509,12454,12454,0,12,4525000.0
4525,4525999,21.20174321130021,38.57578436692987,0.08701077585904982,688.638370513916,294.4039559364319,673.8709945678711,16969,4511,12458,12458,0,12,4526000.0
4526,4526999,21.200228969359166,38.57322908764987,0.08701118988194934,688.7603538036346,294.46804571151733,674.181884765625,16969,4511,12458,12458,0,12,4527000.0
4527,4527999,21.19907127350508,38.57243893469874,0.08700467269935719,688.978040933609,294.53150057792664,674.2032203674316,16973,4513,12460,12460,0,12,4528000.0
4528,4528999,21.197777772065347,38.57018125305016,0.08700359960967952,689.1054463386536,294.59421730041504,674.4020729064941,16973,4513,12460,12460,0,12,4529000.0
4529,4529999,21.196460829949263,38.56745754153658,0.08699646847971432,689.2335002422333,294.6572172641754,674.5828742980957,16974,4513,12461,12461,0,12,4530000.0
4530,4530999,21.195116115946107,38.56478892416945,0.08699308278503304,689.4364051818848,294.7216227054596,674.5334625244141,16978,4515,12463,12463,0,12,4531000.0
4531,4531999,21.19389470194769,38.56273757187608,0.0869866366315486,689.6907470226288,294.785667181015,674.5024757385254,16984,4518,12466,12466,0,12,4532000.0
4532,4532999,21.192681899918306,38.560423673061166,0.086980003082198,689.9158270359039,294.8494658470154,674.6670265197754,16988,4520,12468,12468,0,12,4533000.0
4533,4533999,21.19175317566211,38.558411885758346,0.086962667397399,690.0424568653107,294.9127128124237,674.8283424377441,16988,4520,12468,12468,0,12,4534000.0
4534,4534999,21.190839332840078,38.55650408521759,0.08695749136694775,690.188708782196,294.97592878341675,674.9736518859863,16988,4520,12468,12468,0,12,4535000.0
4535,4535999,21.19049072707959,38.55642339439315,0.08694301916754499,690.3828382492065,295.03924107551575,674.9306030273438,16992,4522,12470,12470,0,12,4536000.0
4536,4536999,21.18974552844615,38.55497084195581,0.08693212613018408,690.5310206413269,295.1024248600006,675.0660820007324,16992,4522,12470,12470,0,12,4537000.0
4537,4537999,21.18918020840862,38.55344761101583,0.0869164800099872,690.6701459884644,295.1658706665039,675.1897087097168,16992,4522,12470,12470,0,12,4538000.0
4538,4538999,21.18880883138133,38.55203871553551,0.08690380906265371,690.919593334198,295.22955298423767,675.0657730102539,16998,4525,12473,12473,0,12,4539000.0
4539,4539999,21.188858038292523,38.55118496843375,0.08688490732270582,691.0593817234039,295.29267740249634,675.2576179504395,16998,4525,12473,12473,0,12,4540000.0
4540,4540999,21.189026404439556,38.55084203112442,0.08686160381718522,691.182825088501,295.3562636375427,675.3816947937012,16998,4525,12473,12473,0,12,4541000.0
4541,4541999,21.189547761003396,38.5507227248891,0.08684246339537038,691.3434658050537,295.41972255706787,675.4523658752441,16998,4525,12473,12473,0,12,4542000.0
4542,4542999,21.190302558400994,38.55107308858366,0.08681507585187298,691.4745216369629,295.48308420181274,675.533519744873,16998,4525,12473,12473,0,12,4543000.0
4543,4543999,21.191210455542272,38.55126468488188,0.08679141993951855,691.6251132488251,295.54740738868713,675.6232872009277,16998,4525,12473,12473,0,12,4544000.0
4544,4544999,21.190896173437913,38.54958294340278,0.08678239114361086,691.7447726726532,295.6099226474762,675.7466506958008,16998,4525,12473,12473,0,12,4545000.0
4545,4545999,21.18950513184095,38.54664016513012,0.08678124253306296,691.8619706630707,295.67443466186523,676.5668601989746,17015,4525,12490,12490,0,12,4546000.0
4546,4546999,21.18818946060087,38.54519928037819,0.08677180839357956,692.06138920784,295.73761796951294,676.7513198852539,17021,4527,12494,12494,0,12,4547000.0
4547,4547999,21.186956112995418,38.5447425285542,0.08676068761647293,692.2432518005371,295.8016378879547,677.0488815307617,17024,4528,12496,12496,0,12,4548000.0
4548,4548999,21.186015704840646,38.54320570745163,0.0867511512538558,692.3613016605377,295.86641240119934,677.2744903564453,17024,4528,12496,12496,0,12,4549000.0
4549,4549999,21.18566903484067,38.54320299280518,0.08673000185015234,692.528448343277,295.92999815940857,677.4079055786133,17026,4529,12497,12497,0,12,4550000.0
4550,4550999,21.18529934289678,38.54247276021069,0.08671172873460131,692.7970352172852,295.99416399002075,677.3845443725586,17033,4532,12501,12501,0,12,4551000.0
4551,4551999,21.184930674049983,38.542418752650285,0.08668854588532438,692.9545786380768,296.0575141906738,677.5742034912109,17036,4533,12503,12503,0,12,4552000.0
4552,4552999,21.184940028292733,38.5430756087357,0.0866820228357752,693.1977682113647,296.1210057735443,677.6492652893066,17047,4536,12511,12511,0,12,4553000.0
4553,4553999,21.18539867789764,38.544037684758834,0.08667476228245719,693.4651298522949,296.18796944618225,677.5964584350586,17053,4539,12514,12514,0,12,4554000.0
4554,4554999,21.186044170205513,38.545364350193665,0.08666100947570332,693.5979480743408,296.2510793209076,677.7981719970703,17053,4539,12514,12514,0,12,4555000.0
4555,4555999,21.18693437941447,38.547277428137285,0.08664506743778555,693.7224566936493,296.3142957687378,677.9452819824219,17053,4539,12514,12514,0,12,4556000.0
4556,4556999,21.18790353397886,38.54861518252455,0.08664304619286867,693.8653607368469,296.3778340816498,678.0653266906738,17053,4539,12514,12514,0,12,4557000.0
4557,4557999,21.1892344227169,38.55094294023888,0.0866385889080431,694.0760133266449,296.4415340423584,678.035472869873,17057,4541,12516,12516,0,12,4558000.0
4558,4558999,21.191426549417713,38.554868687277654,0.08663427726356954,694.2928969860077,296.50597405433655,678.0266799926758,17061,4543,12518,12518,0,12,4559000.0
4559,4559999,21.193489206989828,38.557793890872695,0.08665126801704937,694.425981760025,296.5696475505829,678.2189826965332,17061,4543,12518,12518,0,12,4560000.0
4560,4560999,21.19555079977856,38.560498684804934,0.08666871531464537,694.5920851230621,296.6328525543213,678.3210754394531,17063,4544,12519,12519,0,12,4561000.0
4561,4561999,21.198214301954444,38.56386096582999,0.08669034161938971,694.7670335769653,296.69633889198303,678.3600883483887,17065,4545,12520,12520,0,12,4562000.0
4562,4562999,21.200884378575623,38.568132618192635,0.08669964257525076,694.9398944377899,296.76012539863586,678.4077262878418,17067,4546,12521,12521,0,12,4563000.0
4563,4563999,21.2040840113864,38.57282792126602,0.08672119576466952,695.0958778858185,296.8240044116974,678.5202789306641,17067,4546,12521,12521,0,12,4564000.0
4564,4564999,21.207208692270886,38.576841957219706,0.08675778965889369,695.2367768287659,296.88751101493835,678.6155700683594,17067,4546,12521,12521,0,12,4565000.0
4565,4565999,21.209604777091265,38.57912146877116,0.08678625975446552,695.3566100597382,296.9512414932251,678.7673568725586,17067,4546,12521,12521,0,12,4566000.0
4566,4566999,21.20883758684848,38.576789472443515,0.0867744106885634,695.5286173820496,297.0159332752228,679.6039695739746,17109,4547,12562,12562,0,12,4567000.0
4567,4567999,21.207598997283775,38.57516802573219,0.0867721078607171,695.6521062850952,297.07872009277344,679.9678268432617,17112,4547,12565,12565,0,12,4568000.0
4568,4568999,21.20662664792491,38.57408743710158,0.08676125764804554,695.9055285453796,297.14257049560547,680.0343818664551,17124,4550,12574,12574,0,12,4569000.0
4569,4569999,21.205233997987246,38.5713408499441,0.0867611322532581,696.0198040008545,297.2053966522217,680.2716178894043,17124,4550,12574,12574,0,12,4570000.0
4570,4570999,21.20384833764603,38.568714343919865,0.08675591224743329,696.2120532989502,297.2691478729248,680.353214263916,17126,4551,12575,12575,0,12,4571000.0
4571,4571999,21.202643731755515,38.56661477941435,0.08675067735735076,696.423582315445,297.3323404788971,680.3284378051758,17131,4553,12578,12578,0,12,4572000.0
4572,4572999,21.201427435830844,38.56501190055862,0.08674110827007109,696.5386414527893,297.39550614356995,680.5168991088867,17131,4553,12578,12578,0,12,4573000.0
4573,4573999,21.20036732498815,38.56356611924531,0.08672632928996127,696.7141757011414,297.4598882198334,680.619873046875,17133,4554,12579,12579,0,12,4574000.0
4574,4574999,21.199337150986857,38.562154601980794,0.08670999211267394,697.0174741744995,297.52756810188293,680.5621528625488,17141,4558,12583,12583,0,12,4575000.0
4575,4575999,21.198760642926693,38.56149529834951,0.08668576871901668,697.1772274971008,297.5910325050354,680.7451591491699,17143,4559,12584,12584,0,12,4576000.0
4576,4576999,21.198860237811065,38.56636274177881,0.08663053056980219,697.3482737541199,297.65458059310913,680.8305168151855,17145,4560,12585,12585,0,12,4577000.0
4577,4577999,21.19974212674739,38.56924918378055,0.08662205245228549,697.4790861606598,297.7197856903076,680.9646759033203,17145,4560,12585,12585,0,12,4578000.0
4578,4578999,21.202104563596247,38.576362372200066,0.08660948424972748,697.6169285774231,297.78347420692444,681.1117324829102,17145,4560,12585,12585,0,12,4579000.0
4579,4579999,21.204784486592107,38.58320248824063,0.08661912483434908,697.8484392166138,297.848023891449,681.1372909545898,17149,4562,12587,12587,0,12,4580000.0
4580,4580999,21.20785334903003,38.5923861367605,0.08661999149304234,698.0096967220306,297.9121458530426,681.2489395141602,17151,4563,12588,12588,0,12,4581000.0
4581,4581999,21.21251090712005,38.604888329762474,0.08664970750947365,698.2247586250305,297.97590231895447,681.2709045410156,17155,4565,12590,12590,0,12,4582000.0
4582,4582999,21.21713565692474,38.61578104832512,0.08669639092854187,698.3964126110077,298.041588306427,681.4874725341797,17157,4566,12591,12591,0,12,4583000.0
4583,4583999,21.22239803266521,38.62986084372767,0.08672427804335414,698.5898351669312,298.10582637786865,681.531436920166,17159,4567,12592,12592,0,12,4584000.0
4584,4584999,21.226152406675137,38.6373289849122,0.0867864228235834,698.7736666202545,298.170761346817,681.5503082275391,17161,4568,12593,12593,0,12,4585000.0
4585,4585999,21.231003613747163,38.6459201523288,0.08686403080573546,698.9819483757019,298.2350227832794,681.5061912536621,17172,4570,12602,12602,0,12,4586000.0
4586,4586999,21.233173985851597,38.64893850050202,0.0868864382076292,699.1141345500946,298.29952573776245,682.0561676025391,17185,4570,12615,12615,0,12,4587000.0
4587,4587999,21.23199174416259,38.648243842536544,0.08687271782285388,699.243161201477,298.3625819683075,682.6128997802734,17192,4570,12622,12622,0,12,4588000.0
4588,4588999,21.230726839899763,38.647599808182115,0.08687038958285376,699.3763506412506,298.4254651069641,682.9337768554688,17194,4570,12624,12624,0,12,4589000.0
4589,4589999,21.22938506185653,38.645783761198615,0.08686972651506342,699.4849293231964,298.48799538612366,683.1537437438965,17194,4570,12624,12624,0,12,4590000.0
4590,4590999,21.228071143713578,38.643567682827346,0.08686853631516833,699.6632237434387,298.5513062477112,683.2659606933594,17196,4571,12625,12625,0,12,4591000.0
4591,4591999,21.22692701548362,38.642350065252394,0.08686159822277895,699.7935824394226,298.61504340171814,683.4285469055176,17197,4571,12626,12626,0,12,4592000.0
4592,4592999,21.225816178523516,38.641289602143544,0.0868505125372554,699.9735381603241,298.6784975528717,683.5352668762207,17199,4572,12627,12627,0,12,4593000.0
4593,4593999,21.22449317384857,38.63898428693597,0.0868479706631139,700.1367046833038,298.74169063568115,683.6434555053711,17201,4573,12628,12628,0,12,4594000.0
4594,4594999,21.223527060107422,38.637003526372496,0.08683728590866391,700.3740756511688,298.80498600006104,683.5815010070801,17207,4576,12631,12631,0,12,4595000.0
4595,4595999,21.222771042200648,38.6353516411801,0.08683070845168517,700.5616250038147,298.8691680431366,683.6809730529785,17209,4577,12632,12632,0,12,4596000.0
4596,4596999,21.222475055573835,38.63452665270099,0.08681275305399083,700.7276964187622,298.9335994720459,683.7495307922363,17211,4578,12633,12633,0,12,4597000.0
4597,4597999,21.22220996053784,38.634463054638964,0.08679734011689932,700.9552245140076,298.99740767478943,683.6999664306641,17220,4580,12640,12640,0,12,4598000.0
4598,4598999,21.2220051022357,38.633502926111134,0.0867821543405034,701.1375508308411,299.0612678527832,683.7500343322754,17222,4581,12641,12641,0,12,4599000.0
4599,4599999,21.222129284081237,38.63314443539022,0.08676928898595526,701.3067274093628,299.12428188323975,683.8369750976562,17224,4582,12642,12642,0,12,4600000.0
4600,4600999,21.22277837523705,38.63686800987479,0.08673634513661954,701.4760453701019,299.18760895729065,683.8412857055664,17227,4583,12644,12644,0,12,4601000.0
4601,4601999,21.223144151571834,38.637857121357534,0.08671984829235913,701.6580350399017,299.2513747215271,683.8984260559082,17229,4584,12645,12645,0,12,4602000.0
4602,4602999,21.22394662018589,38.63935407482359,0.08670200882334567,701.7975165843964,299.3156735897064,684.031494140625,17229,4584,12645,12645,0,12,4603000.0
4603,4603999,21.22443729065574,38.64071208325144,0.08668580058470143,701.9184257984161,299.3785059452057,684.1288528442383,17229,4584,12645,12645,0,12,4604000.0
4604,4604999,21.224851231742672,38.64003203849907,0.08667585358422714,702.0480213165283,299.44126057624817,684.2230224609375,17229,4584,12645,12645,0,12,4605000.0
4605,4605999,21.224846812905504,38.639426385600395,0.08664736218155378,702.1838147640228,299.5051553249359,685.0841217041016,17250,4584,12666,12666,0,12,4606000.0
4606,4606999,21.22398680643806,38.63911429124703,0.08665239351639509,702.3455717563629,299.5703535079956,685.6099967956543,17260,4585,12675,12675,0,12,4607000.0
4607,4607999,21.22294771992143,38.637604325901385,0.08664777433019266,702.4547638893127,299.63372707366943,685.9542007446289,17261,4585,12676,12676,0,12,4608000.0
4608,4608999,21.221875912711063,38.63574778198261,0.08664970259760973,702.609142780304,299.6969828605652,686.154972076416,17263,4586,12677,12677,0,12,4609000.0
4609,4609999,21.221878654929736,38.63742375227331,0.08662518277938824,702.7669620513916,299.76137495040894,686.3677520751953,17266,4587,12679,12679,0,12,4610000.0
4610,4610999,21.222604345938205,38.638633692409805,0.08662009063626153,702.9370760917664,299.82784032821655,686.5636253356934,17269,4588,12681,12681,0,12,4611000.0
4611,4611999,21.22339897218748,38.63931669124481,0.08662849076166057,703.171469449997,299.89206051826477,686.7032814025879,17274,4590,12684,12684,0,12,4612000.0
4612,4612999,21.224334527088136,38.64187919570114,0.086630310849801,703.3740720748901,299.9628162384033,686.7805824279785,17278,4592,12686,12686,0,12,4613000.0
4613,4613999,21.224957193258817,38.64190576032836,0.0866373802851077,703.6239802837372,300.02767992019653,686.855037689209,17284,4595,12689,12689,0,12,4614000.0
4614,4614999,21.22603101562024,38.64296059155695,0.0866723362821823,703.7943477630615,300.0923969745636,687.0026817321777,17292,4596,12696,12696,0,12,4615000.0
4615,4615999,21.227933726172697,38.64571057058328,0.0867144272098731,703.9467821121216,300.15637278556824,687.1796264648438,17294,4597,12697,12697,0,12,4616000.0
4616,4616999,21.230038392436278,38.648616805653354,0.08673325926090314,704.1277694702148,300.2296669483185,687.2563781738281,17296,4598,12698,12698,0,12,4617000.0
4617,4617999,21.23131572427261,38.64991296040369,0.08676097772375102,704.350953578949,300.29408740997314,687.2640113830566,17300,4600,12700,12700,0,12,4618000.0
4618,4618999,21.233010779693135,38.652288388708286,0.08679929926760621,704.5669629573822,300.3649160861969,687.3801765441895,17304,4602,12702,12702,0,12,4619000.0
4619,4619999,21.234971568657528,38.65636017153373,0.0868548316170773,704.7433722019196,300.4293842315674,687.5196228027344,17306,4603,12703,12703,0,12,4620000.0
4620,4620999,21.237011656487997,38.659001072375546,0.08691441192127103,704.9597930908203,300.4935748577118,687.5153656005859,17310,4605,12705,12705,0,12,4621000.0
4621,4621999,21.239257752510067,38.663233765042115,0.086981765872576,705.0808570384979,300.5575568675995,687.71875,17310,4605,12705,12705,0,12,4622000.0
4622,4622999,21.241830875596214,38.66703219721794,0.08704020620595354,705.2381126880646,300.62170219421387,687.814582824707,17312,4606,12706,12706,0,12,4623000.0
4623,4623999,21.243833594011296,38.669005778115746,0.08709650474721464,705.4556994438171,300.6891269683838,687.8812828063965,17314,4607,12707,12707,0,12,4624000.0
4624,4624999,21.245680437733952,38.67171840577462,0.08714147776470371,705.5978665351868,300.7556269168854,688.0316200256348,17314,4607,12707,12707,0,12,4625000.0
4625,4625999,21.24668088391377,38.67179121256604,0.08714169034969987,705.7320275306702,300.8212649822235,688.8411102294922,17336,4607,12729,12729,0,12,4626000.0
4626,4626999,21.245709784042184,38.67059859005271,0.08713830902612374,705.8494539260864,300.8847279548645,689.3569793701172,17339,4607,12732,12732,0,12,4627000.0
4627,4627999,21.244944094199056,38.66905547480989,0.0871371457699025,705.9755964279175,300.94869899749756,689.7375755310059,17342,4607,12735,12735,0,12,4628000.0
4628,4628999,21.244342356450687,38.667488803148586,0.08713328746964444,706.1394002437592,301.01248812675476,689.9738693237305,17344,4608,12736,12736,0,12,4629000.0
4629,4629999,21.244012140717857,38.666568728605014,0.08713172089695387,706.2972564697266,301.0763099193573,690.1353759765625,17346,4609,12737,12737,0,12,4630000.0
4630,4630999,21.244121835093054,38.667149293093566,0.08712462481757954,706.529593706131,301.13994669914246,690.1343955993652,17371,4612,12759,12759,0,12,4631000.0
4631,4631999,21.24416712706602,38.66685097070229,0.08712797107752568,706.7917153835297,301.2044243812561,690.1220512390137,17379,4615,12764,12764,0,12,4632000.0
4632,4632999,21.243968372518246,38.66564282871897,0.0871330456064775,706.9890224933624,301.26853036880493,690.3315620422363,17383,4617,12766,12766,0,12,4633000.0
4633,4633999,21.243983413202304,38.66476997273219,0.0871439614868561,707.3169729709625,301.33420038223267,690.2392082214355,17400,4622,12778,12778,0,12,4634000.0
4634,4634999,21.24450639682448,38.66741064758885,0.08715637644198893,707.6197557449341,301.4007725715637,690.3432159423828,17408,4626,12782,12782,0,12,4635000.0
4635,4635999,21.244987785409208,38.667641352538425,0.0871596222526001,707.7461044788361,301.4651608467102,690.5820159912109,17408,4626,12782,12782,0,12,4636000.0
4636,4636999,21.24660086163247,38.67093491103707,0.08717576753966305,707.9884264469147,301.5310664176941,690.5971717834473,17416,4629,12787,12787,0,12,4637000.0
4637,4637999,21.248504089108636,38.67445193135509,0.08721384230612461,708.1702630519867,301.59562039375305,690.7520980834961,17418,4630,12788,12788,0,12,4638000.0
4638,4638999,21.24985132594623,38.67606265589827,0.08725015814619674,708.4182331562042,301.6602973937988,690.7548789978027,17425,4633,12792,12792,0,12,4639000.0
4639,4639999,21.251921119331737,38.67917599800206,0.08728857716651872,708.5441927909851,301.7249655723572,690.9911231994629,17425,4633,12792,12792,0,12,4640000.0
4640,4640999,21.254550983168336,38.6828082783403,0.08732488023195462,708.7234473228455,301.7911615371704,691.0877380371094,17428,4634,12794,12794,0,12,4641000.0
4641,4641999,21.257253052520234,38.68639721135277,0.08737318765896285,709.0065956115723,301.85653281211853,691.0785903930664,17436,4638,12798,12798,0,12,4642000.0
4642,4642999,21.26025682462206,38.692570166169226,0.0874212454897706,709.1388425827026,301.9214861392975,691.3054237365723,17436,4638,12798,12798,0,12,4643000.0
4643,4643999,21.263660253535846,38.700758151853506,0.08745679259331696,709.365086555481,301.9868104457855,691.4118041992188,17440,4640,12800,12800,0,12,4644000.0
4644,4644999,21.26631178443696,38.70487369801183,0.08748442338830198,709.50585770607,302.0528213977814,691.5943298339844,17440,4640,12800,12800,0,12,4645000.0
4645,4645999,21.268473682695237,38.70683577445396,0.08752260960545422,709.7242932319641,302.1186571121216,691.5815124511719,17444,4642,12802,12802,0,12,4646000.0
4646,4646999,21.268910958014484,38.70719797936429,0.08750964175095599,709.862681388855,302.18384885787964,692.4251136779785,17463,4642,12821,12821,0,12,4647000.0
4647,4647999,21.267853082239043,38.70666776230702,0.08750031121441715,709.9820604324341,302.24756598472595,692.8750610351562,17467,4642,12825,12825,0,12,4648000.0
4648,4648999,21.266954143366537,38.705248533047836,0.08749664017329961,710.140608549118,302.3116731643677,693.1366920471191,17470,4643,12827,12827,0,12,4649000.0
4649,4649999,21.26640816282433,38.704065835848645,0.08749040732237234,710.2964873313904,302.3751976490021,693.3966979980469,17473,4644,12829,12829,0,12,4650000.0
4650,4650999,21.26598472370138,38.70381145862656,0.08747745180351363,710.421377658844,302.43862318992615,693.5893898010254,17473,4644,12829,12829,0,12,4651000.0
4651,4651999,21.26567018970554,38.70276650486801,0.08747380575767116,710.6738529205322,302.50369596481323,693.5936851501465,17481,4647,12834,12834,0,12,4652000.0
4652,4652999,21.265262514113996,38.70186384494377,0.08746935934284794,710.9259872436523,302.5685660839081,693.5880470275879,17489,4650,12839,12839,0,12,4653000.0
4653,4653999,21.264709220130005,38.700271967411986,0.08746907873936449,711.1289038658142,302.63299679756165,693.6813507080078,17493,4652,12841,12841,0,12,4654000.0
4654,4654999,21.264797720966136,38.70062923060376,0.08746303657824606,711.3349404335022,302.69934034347534,693.8544540405273,17497,4654,12843,12843,0,12,4655000.0
4655,4655999,21.265214485668054,38.70169325439331,0.08745259837007902,711.6346771717072,302.76512026786804,693.8623199462891,17505,4658,12847,12847,0,12,4656000.0
4656,4656999,21.265744779391547,38.70272870777075,0.08744412021208792,711.799887418747,302.83008337020874,694.0342597961426,17508,4659,12849,12849,0,12,4657000.0
4657,4657999,21.267071764670696,38.707518404224025,0.08742475654747428,712.0503633022308,302.89520716667175,694.0745849609375,17535,4662,12873,12873,0,12,4658000.0
4658,4658999,21.267957296879754,38.70957827220964,0.08741249257712624,712.2209901809692,302.95975637435913,694.1688766479492,17537,4663,12874,12874,0,12,4659000.0
4659,4659999,21.26883438740563,38.710296256416086,0.0874057514621438,712.3946223258972,303.0251567363739,694.2929306030273,17540,4664,12876,12876,0,12,4660000.0
4660,4660999,21.269886297458164,38.71135154575357,0.08740089434945741,712.5693588256836,303.09028935432434,694.3727989196777,17543,4665,12878,12878,0,12,4661000.0
4661,4661999,21.272049482332644,38.71443335256359,0.08740502993079646,712.8259997367859,303.155558347702,694.4610900878906,17549,4668,12881,12881,0,12,4662000.0
4662,4662999,21.274271453179317,38.71849349571001,0.08739801241364231,712.9563102722168,303.22015619277954,694.6684074401855,17549,4668,12881,12881,0,12,4663000.0
4663,4663999,21.275991938091977,38.719976661655366,0.08741437823908027,713.0931804180145,303.284720659256,694.8090476989746,17549,4668,12881,12881,0,12,4664000.0
4664,4664999,21.277716742031238,38.720826080952634,0.08741322038418342,713.2623662948608,303.34940576553345,694.8643188476562,17551,4669,12882,12882,0,12,4665000.0
4665,4665999,21.27934102453254,38.722069810494915,0.08742274455444565,713.4092171192169,303.41389322280884,694.9906387329102,17551,4669,12882,12882,0,12,4666000.0
4666,4666999,21.279978390851454,38.72150872416483,0.0874239553110433,713.5486118793488,303.4804792404175,695.5035247802734,17565,4669,12896,12896,0,12,4667000.0
4667,4667999,21.278956006040627,38.71984883613878,0.08741880871723395,713.6632175445557,303.54444432258606,696.1030044555664,17572,4669,12903,12903,0,12,4668000.0
4668,4668999,21.27758626127347,38.717740530192785,0.08741975736549135,713.7876756191254,303.60730266571045,696.4408302307129,17574,4669,12905,12905,0,12,4669000.0
4669,4669999,21.27635083307872,38.71536986101472,0.08741895729496019,713.9991707801819,303.67221570014954,696.6233329772949,17578,4671,12907,12907,0,12,4670000.0
4670,4670999,21.275329129097216,38.714257414614984,0.08741382848479173,714.1726369857788,303.7356379032135,696.7632064819336,17580,4672,12908,12908,0,12,4671000.0
4671,4671999,21.2740152222052,38.71179655442866,0.08741237434177296,714.3388867378235,303.7992641925812,696.9280395507812,17582,4673,12909,12909,0,12,4672000.0
4672,4672999,21.272737848291076,38.70903938033334,0.0874132564922192,714.5037388801575,303.86295104026794,697.137638092041,17587,4674,12913,12913,0,12,4673000.0
4673,4673999,21.272219570205873,38.70838505585367,0.08740334218199652,714.7450037002563,303.92745304107666,697.1584167480469,17593,4677,12916,12916,0,12,4674000.0
4674,4674999,21.27141428353051,38.706202485045054,0.08740158213108795,715.0058057308197,303.9923689365387,697.1688041687012,17600,4680,12920,12920,0,12,4675000.0
4675,4675999,21.270773477874457,38.70453937155384,0.08739752918367028,715.2244501113892,304.0563819408417,697.3003082275391,17604,4682,12922,12922,0,12,4676000.0
4676,4676999,21.2702045593229,38.70315912106599,0.08740062855680142,715.3569028377533,304.11984872817993,697.5002098083496,17604,4682,12922,12922,0,12,4677000.0
4677,4677999,21.269988752971663,38.70204614748672,0.08740554870689143,715.4762735366821,304.18319177627563,697.7023811340332,17604,4682,12922,12922,0,12,4678000.0
4678,4678999,21.270187242492057,38.70439692033985,0.08739476503578436,715.607709646225,304.24705600738525,697.8353881835938,17604,4682,12922,12922,0,12,4679000.0
4679,4679999,21.27008388249511,38.70371796007572,0.08738224020860474,715.7805118560791,304.31101632118225,697.8904800415039,17607,4683,12924,12924,0,12,4680000.0
4680,4680999,21.270453273279465,38.703640567960136,0.0873846198497964,715.9530036449432,304.3753685951233,698.0072746276855,17609,4684,12925,12925,0,12,4681000.0
4681,4681999,21.27119698737704,38.70450837265924,0.08737586499503358,716.2055497169495,304.4396152496338,697.8877029418945,17617,4687,12930,12930,0,12,4682000.0
4682,4682999,21.272127223775037,38.704784678911714,0.08738600550822762,716.3980641365051,304.5046195983887,698.0176734924316,17619,4688,12931,12931,0,12,4683000.0
4683,4683999,21.274278505823354,38.71697582027656,0.08735812872869786,716.6569409370422,304.5698838233948,698.0789642333984,17626,4691,12935,12935,0,12,4684000.0
4684,4684999,21.275414392364645,38.71827987274344,0.08736045903141276,716.8690400123596,304.6339726448059,698.0662956237793,17630,4693,12937,12937,0,12,4685000.0
4685,4685999,21.27668365673109,38.721418044382226,0.08736745220434383,717.0577187538147,304.69865345954895,698.1993980407715,17632,4694,12938,12938,0,12,4686000.0
4686,4686999,21.277955978666007,38.722705016730636,0.08737310822092492,717.1854236125946,304.7625823020935,698.3498611450195,17632,4694,12938,12938,0,12,4687000.0
4687,4687999,21.277884537879405,38.72184734139042,0.08736599346287999,717.3036978244781,304.82724237442017,699.0901069641113,17652,4694,12958,12958,0,12,4688000.0
4688,4688999,21.276920240728234,38.72095401501751,0.08736067351174392,717.4163479804993,304.8898503780365,699.6146469116211,17656,4694,12962,12962,0,12,4689000.0
4689,4689999,21.27625258927767,38.72171584616606,0.08735819518276633,717.5731885433197,304.9531717300415,699.8545188903809,17660,4695,12965,12965,0,12,4690000.0
4690,4690999,21.27566017069503,38.72073302391609,0.08735088891737275,717.7305529117584,305.01636958122253,700.0839958190918,17662,4696,12966,12966,0,12,4691000.0
4691,4691999,21.274641471353952,38.71852147460578,0.08734821231469203,717.9476096630096,305.07992672920227,700.1109237670898,17667,4698,12969,12969,0,12,4692000.0
4692,4692999,21.27389241468941,38.717028808958425,0.08734050537525151,718.1116936206818,305.14286637306213,700.3090286254883,17669,4699,12970,12970,0,12,4693000.0
4693,4693999,21.273656103712156,38.71744309801281,0.08729133063965477,718.316572189331,305.2063481807709,700.4097595214844,17674,4701,12973,12973,0,12,4694000.0
4694,4694999,21.27319355525314,38.71605787927654,0.08726645250126319,718.5290620326996,305.27027463912964,700.5088310241699,17678,4703,12975,12975,0,12,4695000.0
4695,4695999,21.273028877153404,38.71590220222702,0.08724591925140279,718.7307741641998,305.3348844051361,700.6167755126953,17682,4705,12977,12977,0,12,4696000.0
4696,4696999,21.273468461613817,38.716957772706984,0.0872226030301888,719.0260906219482,305.39924478530884,700.6449546813965,17696,4709,12987,12987,0,12,4697000.0
4697,4697999,21.27435129342122,38.719425107220665,0.08719721391371582,719.2036626338959,305.4639229774475,700.7333526611328,17698,4710,12988,12988,0,12,4698000.0
4698,4698999,21.27545985334466,38.72147450254883,0.0871915272485374,719.4698278903961,305.5286855697632,700.7201614379883,17705,4713,12992,12992,0,12,4699000.0
4699,4699999,21.277770355544092,38.72783610032396,0.08714925439317034,719.6410603523254,305.59271478652954,700.9357032775879,17707,4714,12993,12993,0,12,4700000.0
4700,4700999,21.280151382010185,38.7331232749628,0.08711381909844496,719.8066012859344,305.65650057792664,701.0766906738281,17709,4715,12994,12994,0,12,4701000.0
4701,4701999,21.283014292883035,38.74115390163783,0.08706870321185323,719.9790177345276,305.7213649749756,701.2434959411621,17711,4716,12995,12995,0,12,4702000.0
4702,4702999,21.286343942049204,38.74979123647472,0.08706148049437235,720.18634724617,305.78529953956604,701.3534278869629,17715,4718,12997,12997,0,12,4703000.0
4703,4703999,21.290303873865962,38.761307979170695,0.08703233314462722,720.4002931118011,305.84957909584045,701.4128112792969,17720,4720,13000,13000,0,12,4704000.0
4704,4704999,21.294615310359248,38.772222704685284,0.08702121316784328,720.5689296722412,305.9137146472931,701.5631256103516,17722,4721,13001,13001,0,12,4705000.0
4705,4705999,21.298390465746653,38.78274755845991,0.08701013064510921,720.8195359706879,305.97974729537964,701.5517921447754,17728,4724,13004,13004,0,12,4706000.0
4706,4706999,21.302940990769297,38.79398999674165,0.08700672297291245,721.0712189674377,306.04480361938477,701.5850372314453,17734,4727,13007,13007,0,12,4707000.0
4707,4707999,21.30544506584208,38.79801041542795,0.0870554806936471,721.214565038681,306.1108558177948,702.4197044372559,17755,4727,13028,13028,0,12,4708000.0
4708,4708999,21.3037808463141,38.79520336079606,0.08705698436840859,721.3765783309937,306.17573857307434,702.8609199523926,17763,4728,13035,13035,0,12,4709000.0
4709,4709999,21.303032280882302,38.795058287711164,0.08704316968480852,721.5517222881317,306.239177942276,703.1763534545898,17768,4729,13039,13039,0,12,4710000.0
4710,4710999,21.302289170420796,38.79446233412451,0.08703293023674286,721.7039625644684,306.3026177883148,703.4631576538086,17770,4730,13040,13040,0,12,4711000.0
4711,4711999,21.3014181802979,38.79304460887837,0.08702594590495505,721.9539153575897,306.3664085865021,703.4461135864258,17777,4733,13044,13044,0,12,4712000.0
4712,4712999,21.300787414258178,38.791677313895434,0.08701955105135362,722.0757610797882,306.43083453178406,703.7038230895996,17777,4733,13044,13044,0,12,4713000.0
4713,4713999,21.300033913737185,38.78945477951706,0.08701647433354354,722.2449460029602,306.49518609046936,703.8626899719238,17780,4734,13046,13046,0,12,4714000.0
4714,4714999,21.29938542384403,38.787594542385925,0.0870111245366525,722.4248569011688,306.5609538555145,704.021053314209,17782,4735,13047,13047,0,12,4715000.0
4715,4715999,21.298962460660643,38.78634735098754,0.08699452920575945,722.596214056015,306.6247093677521,704.0969314575195,17784,4736,13048,13048,0,12,4716000.0
4716,4716999,21.298668819854313,38.78676183820862,0.08697028991502653,722.8977293968201,306.6899082660675,704.1099624633789,17793,4740,13053,13053,0,12,4717000.0
4717,4717999,21.29906948915593,38.786954368995225,0.0869297046885198,723.0333814620972,306.7537705898285,704.3365898132324,17793,4740,13053,13053,0,12,4718000.0
4718,4718999,21.299512397253267,38.787111313445465,0.08691567984290716,723.201575756073,306.8187997341156,704.4558334350586,17796,4741,13055,13055,0,12,4719000.0
4719,4719999,21.300103765660705,38.787934669558396,0.08690289566358989,723.3174679279327,306.8822515010834,704.630802154541,17796,4741,13055,13055,0,12,4720000.0
4720,4720999,21.30125143752681,38.78970300493382,0.0868848339367313,723.5460705757141,306.9473533630371,704.6538009643555,17801,4743,13058,13058,0,12,4721000.0
4721,4721999,21.303158827745317,38.79330711431478,0.08687419043094236,723.6752595901489,307.01174449920654,704.8351898193359,17801,4743,13058,13058,0,12,4722000.0
4722,4722999,21.30602321477816,38.799637930773756,0.0868702282195346,723.9253921508789,307.0773015022278,704.7873878479004,17807,4746,13061,13061,0,12,4723000.0
4723,4723999,21.31013000360533,38.807651676480546,0.08688269625849487,724.0688939094543,307.1414837837219,704.9675445556641,17807,4746,13061,13061,0,12,4724000.0
4724,4724999,21.31370341708901,38.813074110131915,0.08690518847847395,724.2330124378204,307.2060179710388,705.1096878051758,17809,4747,13062,13062,0,12,4725000.0
4725,4725999,21.31752871368165,38.81978394825345,0.08694820693747429,724.3674635887146,307.2700891494751,705.2641754150391,17809,4747,13062,13062,0,12,4726000.0
4726,4726999,21.32218464020348,38.83032454708286,0.08699473208792663,724.5531504154205,307.3349771499634,705.3596458435059,17811,4748,13063,13063,0,12,4727000.0
4727,4727999,21.32578891861425,38.83714261876443,0.08705220986289941,724.6872062683105,307.3999705314636,705.4696884155273,17811,4748,13063,13063,0,12,4728000.0
4728,4728999,21.326802700800215,38.83753033545234,0.08707740218223914,724.8183722496033,307.4647762775421,706.1768798828125,17829,4748,13081,13081,0,12,4729000.0
4729,4729999,21.32630879754567,38.838143057653895,0.08706867354964354,724.9990222454071,307.52795243263245,706.5267143249512,17836,4749,13087,13087,0,12,4730000.0
4730,4730999,21.326084575624627,38.838284309922216,0.08705307985780375,725.1223230361938,307.59061789512634,706.8016777038574,17837,4749,13088,13088,0,12,4731000.0
4731,4731999,21.32607824401042,38.83859604551341,0.08705213683475843,725.2402358055115,307.6534945964813,707.0049705505371,17837,4749,13088,13088,0,12,4732000.0
4732,4732999,21.326235688251902,38.83952028209275,0.08703403185694913,725.4574558734894,307.7174286842346,707.0064697265625,17843,4751,13092,13092,0,12,4733000.0
4733,4733999,21.325742052400003,38.83863324732922,0.08702525708339659,725.5861032009125,307.78039503097534,707.2159576416016,17844,4751,13093,13093,0,12,4734000.0
4734,4734999,21.325363839973495,38.838058022474065,0.08702783986125162,725.8344240188599,307.8441219329834,707.1455688476562,17852,4754,13098,13098,0,12,4735000.0
4735,4735999,21.32484907339282,38.83715069530652,0.08702563910371974,726.0425539016724,307.90758299827576,707.1966743469238,17862,4756,13106,13106,0,12,4736000.0
4736,4736999,21.324736835541405,38.83691579607367,0.08702349040934199,726.2276270389557,307.97269201278687,707.3394622802734,17864,4757,13107,13107,0,12,4737000.0
4737,4737999,21.32496451162316,38.83716247427278,0.08701802233260125,726.4488589763641,308.0364234447479,707.3500595092773,17868,4759,13109,13109,0,12,4738000.0
4738,4738999,21.325044343633383,38.83665267919881,0.08701078836829401,726.6169497966766,308.099737405777,707.5064544677734,17870,4760,13110,13110,0,12,4739000.0
4739,4739999,21.325225702699175,38.836346043269515,0.08701605680246371,726.744815826416,308.16280341148376,707.6348495483398,17870,4760,13110,13110,0,12,4740000.0
4740,4740999,21.325412431503498,38.83630134713333,0.08701207238738029,726.862646818161,308.22645831108093,707.7782554626465,17870,4760,13110,13110,0,12,4741000.0
4741,4741999,21.326416558448066,38.83798911508273,0.08700399637643441,727.0344200134277,308.29003500938416,707.796314239502,17873,4761,13112,13112,0,12,4742000.0
4742,4742999,21.32793562991565,38.84128399385245,0.08700187138412196,727.2462983131409,308.35410928726196,707.8739128112793,17875,4762,13113,13113,0,12,4743000.0
4743,4743999,21.329509606329104,38.84310422130639,0.0869908206333474,727.4035468101501,308.41745257377625,707.9835815429688,17877,4763,13114,13114,0,12,4744000.0
4744,4744999,21.33071412064016,38.844781664110116,0.08699233775405557,727.6190605163574,308.48134875297546,707.9012985229492,17882,4765,13117,13117,0,12,4745000.0
4745,4745999,21.332214290478316,38.847901677517974,0.08697692406486668,727.8342401981354,308.54586839675903,707.8664855957031,17886,4767,13119,13119,0,12,4746000.0
4746,4746999,21.332923132259868,38.85083430633753,0.08693599971070876,727.9601850509644,308.61289620399475,708.8921089172363,17914,4767,13147,13147,0,12,4747000.0
4747,4747999,21.331511370102213,38.84955901934604,0.0869423078564755,728.0788812637329,308.6767153739929,709.4640045166016,17916,4767,13149,13149,0,12,4748000.0
4748,4748999,21.32985944354924,38.846804894053385,0.08695814999733642,728.2370684146881,308.74030804634094,709.7043075561523,17920,4768,13152,13152,0,12,4749000.0
4749,4749999,21.328330514005575,38.84515638024768,0.08696662303032643,728.4320476055145,308.8043267726898,709.8949241638184,17924,4770,13154,13154,0,12,4750000.0
4750,4750999,21.32682261721813,38.84284779624873,0.08697257065636099,728.6006691455841,308.8686842918396,710.1815872192383,17928,4771,13157,13157,0,12,4751000.0
4751,4751999,21.3256046203096,38.84106855921209,0.08697304902857683,728.7262256145477,308.9326891899109,710.4511528015137,17930,4771,13159,13159,0,12,4752000.0
4752,4752999,21.324044232786136,38.838228597606665,0.08698314867180401,728.9777565002441,308.9969038963318,710.5123062133789,17936,4774,13162,13162,0,12,4753000.0
4753,4753999,21.322608580143445,38.83584867183792,0.08698824448455678,729.1936709880829,309.061331987381,710.5752372741699,17940,4776,13164,13164,0,12,4754000.0
4754,4754999,21.321290897576684,38.83355183618571,0.08699178368407401,729.3542008399963,309.12603974342346,710.7209167480469,17942,4777,13165,13165,0,12,4755000.0
4755,4755999,21.31995499534121,38.83110336486009,0.08699317258880979,729.4934515953064,309.19007205963135,710.9239273071289,17942,4777,13165,13165,0,12,4756000.0
4756,4756999,21.31932709646138,38.82985417747893,0.08698132960389049,729.618191242218,309.2538628578186,711.0987434387207,17942,4777,13165,13165,0,12,4757000.0
4757,4757999,21.31871361355647,38.82847996228887,0.0869825534030928,729.7330439090729,309.31746459007263,711.2453804016113,17942,4777,13165,13165,0,12,4758000.0
4758,4758999,21.31803837151387,38.826754218255424,0.08698182768872831,729.9950044155121,309.3822853565216,711.2228927612305,17948,4780,13168,13168,0,12,4759000.0
4759,4759999,21.318437547040364,38.82684893086439,0.08697970999908289,730.1515793800354,309.44622802734375,711.3664283752441,17950,4781,13169,13169,0,12,4760000.0
4760,4760999,21.319044910457336,38.828557469632116,0.08697122087587583,730.2908191680908,309.5105085372925,711.5487442016602,17950,4781,13169,13169,0,12,4761000.0
4761,4761999,21.319839759890012,38.828774378209594,0.0869670076934197,730.5863223075867,309.57552790641785,711.3995780944824,17958,4785,13173,13173,0,12,4762000.0
4762,4762999,21.320881614571004,38.831501480322494,0.08696027330014622,730.7268681526184,309.6400730609894,711.6030616760254,17958,4785,13173,13173,0,12,4763000.0
4763,4763999,21.321432704287304,38.83173821887085,0.08697078196004648,730.8964273929596,309.7045011520386,711.6617660522461,17960,4786,13174,13174,0,12,4764000.0
4764,4764999,21.32153413741911,38.83052224048416,0.08698427998565195,731.0781819820404,309.76918601989746,711.7171859741211,17962,4787,13175,13175,0,12,4765000.0
4765,4765999,21.321622783733773,38.82921455354604,0.08699252336219021,731.2515499591827,309.834041595459,711.8006896972656,17964,4788,13176,13176,0,12,4766000.0
4766,4766999,21.321835503280408,38.83225368760144,0.08696400132734738,731.3769581317902,309.8997857570648,712.7064666748047,17991,4788,13203,13203,0,12,4767000.0
4767,4767999,21.32013953008523,38.8298717457235,0.08696383149835929,731.5828413963318,309.964720249176,713.2518501281738,18009,4790,13219,13219,0,12,4768000.0
4768,4768999,21.318396537769235,38.82720550938231,0.08697591876966959,731.6927926540375,310.02837014198303,713.7436828613281,18011,4790,13221,13221,0,12,4769000.0
4769,4769999,21.316883686843312,38.82476776359393,0.0869818646239976,731.8925065994263,310.0924823284149,713.9654579162598,18017,4792,13225,13225,0,12,4770000.0
4770,4770999,21.31539998608822,38.822561358422604,0.086986320284002,732.0547394752502,310.1569654941559,714.1708946228027,18019,4793,13226,13226,0,12,4771000.0
4771,4771999,21.314104084964846,38.82003884026063,0.08699065819594098,732.2068712711334,310.22065687179565,714.3436126708984,18021,4794,13227,13227,0,12,4772000.0
4772,4772999,21.312798642922544,38.817872613995696,0.08699397216582316,732.3765482902527,310.28527092933655,714.5830535888672,18025,4795,13230,13230,0,12,4773000.0
4773,4773999,21.311522526456077,38.81546215754335,0.08699910983581494,732.6327745914459,310.34992718696594,714.6357231140137,18031,4798,13233,13233,0,12,4774000.0
4774,4774999,21.310705127888145,38.81391129444858,0.08699687593864547,732.8476569652557,310.41643595695496,714.8102226257324,18035,4800,13235,13235,0,12,4775000.0
4775,4775999,21.309426447777494,38.81177979828766,0.08699954413002209,733.0665895938873,310.4808683395386,714.945240020752,18039,4802,13237,13237,0,12,4776000.0
4776,4776999,21.308194115073178,38.80928034954367,0.08699999150916937,733.2270662784576,310.54530096054077,715.1410446166992,18041,4803,13238,13238,0,12,4777000.0
4777,4777999,21.307346827915154,38.8074820398115,0.08699858051891352,733.4268493652344,310.61094665527344,715.2383346557617,18045,4805,13240,13240,0,12,4778000.0
4778,4778999,21.306209315828028,38.80501233095439,0.08700052802473524,733.6034746170044,310.67553305625916,715.3763465881348,18047,4806,13241,13241,0,12,4779000.0
4779,4779999,21.305584628408273,38.803699665373856,0.08699105433895216,733.7646090984344,310.7400529384613,715.5397758483887,18049,4807,13242,13242,0,12,4780000.0
4780,4780999,21.305022520284226,38.80210952051724,0.08698721261253217,733.922262430191,310.80460810661316,715.7095069885254,18051,4808,13243,13243,0,12,4781000.0
4781,4781999,21.304368005004854,38.800733222437295,0.08698414923234599,734.1027071475983,310.8704631328583,715.8040962219238,18053,4809,13244,13244,0,12,4782000.0
4782,4782999,21.30417287281139,38.79962572345717,0.08698177840623289,734.4332838058472,310.935986995697,715.6997451782227,18064,4814,13250,13250,0,12,4783000.0
4783,4783999,21.30388319295566,38.79870759043021,0.08697944030938731,734.6554193496704,311.00169587135315,715.7948341369629,18070,4816,13254,13254,0,12,4784000.0
4784,4784999,21.30395131039994,38.79829327632109,0.08697545111056615,734.8449020385742,311.0672676563263,715.877555847168,18072,4817,13255,13255,0,12,4785000.0
4785,4785999,21.303682867614192,38.79705511790628,0.08697038966184589,734.9713621139526,311.1323802471161,716.0681304931641,18072,4817,13255,13255,0,12,4786000.0
4786,4786999,21.303354675083593,38.795384526488185,0.08697165578433297,735.1418790817261,311.19714736938477,716.1857109069824,18079,4818,13261,13261,0,12,4787000.0
4787,4787999,21.30267618962258,38.79708396230626,0.08695017026268137,735.2694711685181,311.26162338256836,716.5311431884766,18082,4818,13264,13264,0,12,4788000.0
4788,4788999,21.301444285559498,38.79608830102326,0.08694235972235631,735.3923006057739,311.3271863460541,717.6146240234375,18109,4818,13291,13291,0,12,4789000.0
4789,4789999,21.299592416969446,38.792983007209266,0.08695721828503544,735.5072379112244,311.3909387588501,718.0635452270508,18111,4818,13293,13293,0,12,4790000.0
4790,4790999,21.298022479124224,38.79119715415105,0.08696381920590823,735.6648879051208,311.45462822914124,718.3256340026855,18113,4819,13294,13294,0,12,4791000.0
4791,4791999,21.296360239722716,38.788329640867374,0.08698182438486002,735.782844543457,311.5180141925812,718.5686912536621,18113,4819,13294,13294,0,12,4792000.0
4792,4792999,21.294714941099198,38.785941114889276,0.08699123061406278,735.9121377468109,311.5818326473236,718.7342567443848,18113,4819,13294,13294,0,12,4793000.0
4793,4793999,21.293231041819617,38.783665481528345,0.08700045931131772,736.1475210189819,311.6459515094757,718.7578964233398,18122,4822,13300,13300,0,12,4794000.0
4794,4794999,21.29155953370783,38.78086464252313,0.08701318563618476,736.2824189662933,311.70973467826843,718.9660377502441,18124,4822,13302,13302,0,12,4795000.0
4795,4795999,21.28979429935904,38.77792777609355,0.08702799380588677,736.502512216568,311.77448439598083,719.0470771789551,18128,4824,13304,13304,0,12,4796000.0
4796,4796999,21.288221804195157,38.775236770839,0.08703762526152348,736.8336956501007,311.8403239250183,719.0039405822754,18136,4828,13308,13308,0,12,4797000.0
4797,4797999,21.286759583168948,38.77288906045132,0.08704636889793482,737.0399050712585,311.90508222579956,719.1021423339844,18142,4830,13312,13312,0,12,4798000.0
4798,4798999,21.28540380958037,38.77036106827116,0.08705305196523294,737.1727385520935,311.9704945087433,719.3270606994629,18142,4830,13312,13312,0,12,4799000.0
4799,4799999,21.283910658894758,38.76776402778334,0.08706337168244438,737.3871202468872,312.03495240211487,719.3515815734863,18146,4832,13314,13314,0,12,4800000.0
4800,4800999,21.2826146301823,38.765662116566624,0.08706750693109477,737.5457696914673,312.10043358802795,719.4822654724121,18154,4833,13321,13321,0,12,4801000.0
4801,4801999,21.281419425206675,38.76378392653988,0.0870709498601211,737.7564771175385,312.16551661491394,719.5612297058105,18160,4835,13325,13325,0,12,4802000.0
4802,4802999,21.28056468056697,38.76219344754954,0.08707007108504672,737.9764883518219,312.2307367324829,719.6172294616699,18164,4837,13327,13327,0,12,4803000.0
4803,4803999,21.279773227357673,38.760216526218464,0.08707567928357884,738.1928324699402,312.29611563682556,719.7045555114746,18168,4839,13329,13329,0,12,4804000.0
4804,4804999,21.278902140860733,38.75821715895562,0.0870783227112959,738.3256225585938,312.3604609966278,719.9054260253906,18168,4839,13329,13329,0,12,4805000.0
4805,4805999,21.27849967172652,38.758182811032846,0.08706920805724605,738.5527234077454,312.4255509376526,719.9441871643066,18172,4841,13331,13331,0,12,4806000.0
4806,4806999,21.277524192354665,38.755846624341395,0.08707524781101494,738.6863489151001,312.49022030830383,720.0916023254395,18172,4841,13331,13331,0,12,4807000.0
4807,4807999,21.27629378710879,38.75335339645761,0.08708307849363006,738.7983994483948,312.55445289611816,720.2313652038574,18172,4841,13331,13331,0,12,4808000.0
4808,4808999,21.27516940984463,38.7529675948951,0.08708290851018607,738.926451921463,312.6201641559601,721.0448303222656,18196,4841,13355,13355,0,12,4809000.0
4809,4809999,21.273175021591946,38.75065626504497,0.08709808249869566,739.0905983448029,312.6839544773102,721.5198631286621,18204,4842,13362,13362,0,12,4810000.0
4810,4810999,21.271145638737988,38.7476784016644,0.08711663990716978,739.2494647502899,312.7480311393738,721.8365173339844,18207,4843,13364,13364,0,12,4811000.0
4811,4811999,21.26960326596011,38.74677775091539,0.08712255926967782,739.4024522304535,312.8112096786499,722.124683380127,18209,4844,13365,13365,0,12,4812000.0
4812,4812999,21.267811447833356,38.74409246187191,0.08713863725003734,739.5399210453033,312.87537574768066,722.3313903808594,18209,4844,13365,13365,0,12,4813000.0
4813,4813999,21.26600236060681,38.74166552895983,0.08715088120762826,739.6934397220612,312.9386167526245,722.501594543457,18216,4845,13371,13371,0,12,4814000.0
4814,4814999,21.26433278196115,38.73962041100058,0.08715764927020886,739.9200489521027,313.00319933891296,722.6002769470215,18223,4847,13376,13376,0,12,4815000.0
4815,4815999,21.262720789058903,38.7369987758561,0.08716915533309466,740.0858223438263,313.06680512428284,722.7021751403809,18225,4848,13377,13377,0,12,4816000.0
4816,4816999,21.261054587689696,38.73433302310545,0.08718067102374727,740.4039571285248,313.13276195526123,722.7029991149902,18233,4852,13381,13381,0,12,4817000.0
4817,4817999,21.259603149310106,38.73211436932438,0.08718336175506791,740.6720600128174,313.197918176651,722.8031883239746,18241,4855,13386,13386,0,12,4818000.0
4818,4818999,21.258415675027006,38.730237561302275,0.08718239925281446,740.7829165458679,313.2615830898285,723.0392951965332,18241,4855,13386,13386,0,12,4819000.0
4819,4819999,21.257522522770365,38.72885579840891,0.08717825516901145,740.9529991149902,313.3267285823822,723.1386833190918,18243,4856,13387,13387,0,12,4820000.0
4820,4820999,21.25838558100462,38.7307136164293,0.08716187130501984,741.1184346675873,313.3914988040924,723.3099021911621,18245,4857,13388,13388,0,12,4821000.0
4821,4821999,21.259711727036223,38.7326602696437,0.08716095789484901,741.3511645793915,313.45630145072937,723.3705787658691,18249,4859,13390,13390,0,12,4822000.0
4822,4822999,21.261545613739337,38.735886436788036,0.08716369866323581,741.4877049922943,313.5205521583557,723.5940437316895,18249,4859,13390,13390,0,12,4823000.0
4823,4823999,21.263168124236422,38.73840314786823,0.08716731194619165,741.6921715736389,313.5859751701355,723.5892143249512,18258,4861,13397,13397,0,12,4824000.0
4824,4824999,21.265098215921604,38.74122186983904,0.08717622133846348,741.9184975624084,313.65070700645447,723.6120681762695,18262,4863,13399,13399,0,12,4825000.0
4825,4825999,21.266643832002607,38.74279098877595,0.08719341654137525,742.0783987045288,313.7152523994446,723.8013038635254,18269,4864,13405,13405,0,12,4826000.0
4826,4826999,21.26839203947625,38.74480860717244,0.08721360800143607,742.3687045574188,313.7816114425659,723.7033920288086,18276,4867,13409,13409,0,12,4827000.0
4827,4827999,21.26965382346664,38.747103973897474,0.08722345503485207,742.4957687854767,313.84720063209534,723.9080467224121,18276,4867,13409,13409,0,12,4828000.0
4828,4828999,21.270527161649344,38.7470565851072,0.0872472139927657,742.7126476764679,313.91235160827637,723.9534873962402,18280,4869,13411,13411,0,12,4829000.0
4829,4829999,21.269929158288186,38.745733661491855,0.08724529814169635,742.931627035141,313.9788393974304,724.7834320068359,18316,4871,13445,13445,0,12,4830000.0
4830,4830999,21.267981332678517,38.74285130150107,0.08725896453098814,743.0517191886902,314.04278469085693,725.3741722106934,18319,4871,13448,13448,0,12,4831000.0
4831,4831999,21.266268257339053,38.740227033503395,0.08726733245643481,743.24787068367,314.1062879562378,725.6475524902344,18323,4873,13450,13450,0,12,4832000.0
4832,4832999,21.264779587350585,38.73788962316696,0.08727272826777799,743.3658952713013,314.1700484752655,725.9551620483398,18323,4873,13450,13450,0,12,4833000.0
4833,4833999,21.26361637006151,38.73651907960566,0.0872694708248758,743.5341360569,314.23325634002686,726.1030731201172,18325,4874,13451,13451,0,12,4834000.0
4834,4834999,21.262040671699104,38.734182368524294,0.0872735164051276,743.734482049942,314.2966117858887,726.2500114440918,18329,4876,13453,13453,0,12,4835000.0
4835,4835999,21.26067661654035,38.73178594727995,0.08727598701232164,744.033727645874,314.36165404319763,726.243465423584,18338,4880,13458,13458,0,12,4836000.0
4836,4836999,21.259308031775856,38.72960369455468,0.08727666925852906,744.2408635616302,314.425498008728,726.3979072570801,18342,4882,13460,13460,0,12,4837000.0
4837,4837999,21.258127239918586,38.72753079160344,0.08727680707693386,744.5483694076538,314.4921510219574,726.4546394348145,18350,4886,13464,13464,0,12,4838000.0
4838,4838999,21.256895675778864,38.724911251058224,0.0872776007617474,744.7958941459656,314.55698466300964,726.6305809020996,18357,4889,13468,13468,0,12,4839000.0
4839,4839999,21.2561102467677,38.72373808841374,0.08726425601138765,744.967652797699,314.62086725234985,726.8672218322754,18359,4890,13469,13469,0,12,4840000.0
4840,4840999,21.25529755562402,38.72187885061554,0.08725728984629133,745.084438085556,314.6855103969574,727.0809669494629,18359,4890,13469,13469,0,12,4841000.0
4841,4841999,21.255498188265225,38.7234683038653,0.08724112750760671,745.346586227417,314.7504069805145,727.0262451171875,18367,4893,13474,13474,0,12,4842000.0
4842,4842999,21.25627112855676,38.72515464780416,0.08726163938328524,745.5202972888947,314.8149175643921,727.1602249145508,18369,4894,13475,13475,0,12,4843000.0
4843,4843999,21.25755126695511,38.72685165798021,0.08728861576944502,745.6924278736115,314.87977385520935,727.3663368225098,18371,4895,13476,13476,0,12,4844000.0
4844,4844999,21.25916037107366,38.7290108923685,0.08733348200675384,745.8722958564758,314.94510889053345,727.4404067993164,18373,4896,13477,13477,0,12,4845000.0
4845,4845999,21.261622290130347,38.73757835064755,0.08737905621357234,745.9940581321716,315.0097076892853,727.5992660522461,18373,4896,13477,13477,0,12,4846000.0
4846,4846999,21.263467547619715,38.739807230914465,0.0874438766145128,746.1305134296417,315.07402086257935,727.7619514465332,18373,4896,13477,13477,0,12,4847000.0
4847,4847999,21.264968777844842,38.741301107307,0.0875002120015621,746.2695634365082,315.1381335258484,727.8931732177734,18373,4896,13477,13477,0,12,4848000.0
4848,4848999,21.266962163510513,38.74263816858869,0.08758605659342344,746.5680952072144,315.20310831069946,727.7605667114258,18381,4900,13481,13481,0,12,4849000.0
4849,4849999,21.267958593919605,38.74388113510161,0.08764304031203773,746.7027575969696,315.26875948905945,727.957103729248,18381,4900,13481,13481,0,12,4850000.0
4850,4850999,21.267754902214126,38.74355965487979,0.08765356678290748,746.8261668682098,315.3344702720642,728.8880577087402,18403,4900,13503,13503,0,12,4851000.0
4851,4851999,21.2660821468392,38.741214516995036,0.08766424588585753,746.9497430324554,315.39805579185486,729.4483375549316,18409,4900,13509,13509,0,12,4852000.0
4852,4852999,21.264473946207687,38.739155908186504,0.08766956903647971,747.1501474380493,315.46135115623474,729.6320648193359,18442,4902,13540,13540,0,12,4853000.0
4853,4853999,21.263122990955186,38.73799817578595,0.08766985459287902,747.266931772232,315.5243625640869,729.9254684448242,18442,4902,13540,13540,0,12,4854000.0
4854,4854999,21.261567035403566,38.73594441789664,0.08767680588325133,747.518800497055,315.5883598327637,729.9829711914062,18448,4905,13543,13543,0,12,4855000.0
4855,4855999,21.260134885621916,38.733901616728765,0.08767971026881505,747.6829855442047,315.6516864299774,730.1819038391113,18450,4906,13544,13544,0,12,4856000.0
4856,4856999,21.258659747267927,38.73147913331327,0.08768515306436475,747.943686246872,315.7171587944031,730.3056488037109,18458,4909,13549,13549,0,12,4857000.0
4857,4857999,21.257367002364703,38.730015976816226,0.08768632730336245,748.0667362213135,315.78070187568665,730.562126159668,18458,4909,13549,13549,0,12,4858000.0
4858,4858999,21.25616153741636,38.7284002594765,0.08767861586399261,748.3401207923889,315.8450882434845,730.542308807373,18464,4912,13552,13552,0,12,4859000.0
4859,4859999,21.254877029307053,38.725964450516315,0.08767839052497506,748.6062285900116,315.91020798683167,730.5552062988281,18472,4915,13557,13557,0,12,4860000.0
4860,4860999,21.254293061486326,38.72502560731044,0.08766752562176106,748.7425680160522,315.9744186401367,730.7841873168945,18472,4915,13557,13557,0,12,4861000.0
4861,4861999,21.25362117966292,38.723982390290715,0.08764795279081905,748.9060091972351,316.03934931755066,730.9120445251465,18476,4916,13560,13560,0,12,4862000.0
4862,4862999,21.25365849915547,38.72388774028216,0.08763597461520689,749.039576292038,316.1036820411682,731.0654830932617,18476,4916,13560,13560,0,12,4863000.0
4863,4863999,21.253603894764304,38.72343177226915,0.08762485192614988,749.2295436859131,316.1687400341034,731.1154899597168,18478,4917,13561,13561,0,12,4864000.0
4864,4864999,21.253897385177897,38.72318150214757,0.08761843851570128,749.3595454692841,316.23283863067627,731.2816390991211,18478,4917,13561,13561,0,12,4865000.0
4865,4865999,21.25492102043827,38.72452880898806,0.08761157863483227,749.5249934196472,316.2967276573181,731.345287322998,18480,4918,13562,13562,0,12,4866000.0
4866,4866999,21.25618528574731,38.72566333745197,0.08760221100364607,749.6778366565704,316.36219692230225,731.5064125061035,18480,4918,13562,13562,0,12,4867000.0
4867,4867999,21.25762910413461,38.72721881683156,0.08759620704706383,749.8559653759003,316.43057322502136,731.5577697753906,18482,4919,13563,13563,0,12,4868000.0
4868,4868999,21.258896713169126,38.72838322246868,0.0875999032664867,749.9978024959564,316.49446272850037,731.6670112609863,18482,4919,13563,13563,0,12,4869000.0
4869,4869999,21.259959973681784,38.72902665954635,0.0876098837290199,750.1264975070953,316.55846977233887,731.760082244873,18482,4919,13563,13563,0,12,4870000.0
4870,4870999,21.26087991909549,38.729200363188326,0.0876162980752827,750.3469483852386,316.62305879592896,731.6126174926758,18488,4921,13567,13567,0,12,4871000.0
4871,4871999,21.260753130002282,38.728149646736135,0.08762723091422764,750.479572057724,316.7038354873657,732.2074737548828,18499,4921,13578,13578,0,12,4872000.0
4872,4872999,21.259226848267986,38.72620726778702,0.08763531375867972,750.6473541259766,316.7634701728821,732.5846519470215,18505,4922,13583,13583,0,12,4873000.0
4873,4873999,21.257846175920236,38.72703224405633,0.0876351585645816,750.7754726409912,316.82370924949646,732.832103729248,18506,4922,13584,13584,0,12,4874000.0
4874,4874999,21.256800258595597,38.727715439781306,0.08762849171246945,750.9542870521545,316.8839554786682,733.2543029785156,18524,4923,13601,13601,0,12,4875000.0
4875,4875999,21.255535839270955,38.73267303974504,0.087606691924913,751.0608291625977,316.94477891921997,733.8007049560547,18527,4923,13604,13604,0,12,4876000.0
4876,4876999,21.254502440646792,38.7324623504551,0.08760717470891255,751.2132318019867,317.00537157058716,734.0121994018555,18529,4924,13605,13605,0,12,4877000.0
4877,4877999,21.25288743380825,38.72948217502649,0.08761378906434159,751.3307781219482,317.0666139125824,734.2969284057617,18529,4924,13605,13605,0,12,4878000.0
4878,4878999,21.251296025001416,38.726741629573354,0.08762678266585833,751.4759368896484,317.13319849967957,734.5279083251953,18530,4924,13606,13606,0,12,4879000.0
4879,4879999,21.249714347501982,38.72394266505624,0.08763695256264337,751.6496663093567,317.19359493255615,734.6579704284668,18532,4925,13607,13607,0,12,4880000.0
4880,4880999,21.248254135498936,38.721356334462584,0.08764586028155885,751.9184584617615,317.2549138069153,734.6291313171387,18538,4928,13610,13610,0,12,4881000.0
4881,4881999,21.24725157412545,38.721573731474514,0.08763356305073089,752.0925853252411,317.31601905822754,734.7973136901855,18540,4929,13611,13611,0,12,4882000.0
4882,4882999,21.246154537187408,38.71920881337979,0.08764150016886041,752.2094790935516,317.3764204978943,734.9262237548828,18540,4929,13611,13611,0,12,4883000.0
4883,4883999,21.24512216733737,38.71764783518277,0.08764505843565995,752.3711309432983,317.4373462200165,734.9439888000488,18543,4930,13613,13613,0,12,4884000.0
4884,4884999,21.244095807063726,38.71583382899982,0.08765142329492737,752.4892764091492,317.49771451950073,735.0915184020996,18543,4930,13613,13613,0,12,4885000.0
4885,4885999,21.243154543803097,38.71363178198962,0.08766494184169671,752.6383857727051,317.5587224960327,735.2192459106445,18543,4930,13613,13613,0,12,4886000.0
4886,4886999,21.24225602275822,38.71146538778889,0.0876788593408967,752.7642979621887,317.62007212638855,735.3427963256836,18544,4930,13614,13614,0,12,4887000.0
4887,4887999,21.24119259962398,38.70894061728586,0.0876972761454673,752.9907398223877,317.6810076236725,735.3092498779297,18549,4932,13617,13617,0,12,4888000.0
4888,4888999,21.240239524599534,38.70756873620679,0.08770621467652107,753.1119513511658,317.74265575408936,735.820556640625,18557,4932,13625,13625,0,12,4889000.0
4889,4889999,21.239202316538275,38.70797465559746,0.08771747789789297,753.2441711425781,317.8041925430298,736.1381187438965,18559,4932,13627,13627,0,12,4890000.0
4890,4890999,21.237912429173534,38.70625455643612,0.08774374663444562,753.3580658435822,317.8646385669708,736.3281593322754,18560,4932,13628,13628,0,12,4891000.0
4891,4891999,21.23647846711142,38.70466545650995,0.08776593890930706,753.4836957454681,317.92515802383423,736.4661827087402,18561,4932,13629,13629,0,12,4892000.0
4892,4892999,21.234705637734706,38.70166890826367,0.08779948109616131,753.6909129619598,317.98656392097473,736.4744758605957,18569,4933,13636,13636,0,12,4893000.0
4893,4893999,21.232723491989628,38.69839238480717,0.08783294885972148,753.8256049156189,318.0560784339905,736.5703582763672,18569,4933,13636,13636,0,12,4894000.0
4894,4894999,21.231068295325983,38.69581591749291,0.08785624744511056,753.9567947387695,318.116338968277,736.6361656188965,18569,4933,13636,13636,0,12,4895000.0
4895,4895999,21.22925844639921,38.6933113933575,0.08788187200371989,754.1256840229034,318.1769506931305,736.6079597473145,18577,4934,13643,13643,0,12,4896000.0
4896,4896999,21.22751447694783,38.69080514361732,0.08790547436903318,754.2845208644867,318.2375454902649,736.6799049377441,18577,4934,13643,13643,0,12,4897000.0
4897,4897999,21.225895887415984,38.68859262678582,0.08792759795542582,754.4544525146484,318.2979440689087,736.6822395324707,18579,4935,13644,13644,0,12,4898000.0
4898,4898999,21.224312538385266,38.68606384736563,0.08794877279262447,754.6296968460083,318.358624458313,736.7173767089844,18581,4936,13645,13645,0,12,4899000.0
4899,4899999,21.222810068715443,38.68335745942817,0.08797271636928938,754.754727602005,318.419228553772,736.791877746582,18581,4936,13645,13645,0,12,4900000.0
4900,4900999,21.221436056493754,38.6808609849653,0.08799649048078584,754.9257550239563,318.4796974658966,736.7854080200195,18583,4937,13646,13646,0,12,4901000.0
4901,4901999,21.2202359323013,38.678565185885596,0.0880296167915895,755.0636780261993,318.540287733078,736.8608131408691,18583,4937,13646,13646,0,12,4902000.0
4902,4902999,21.218954273644954,38.67596464690425,0.08805740087403946,755.2403247356415,318.6015408039093,736.878231048584,18585,4938,13647,13647,0,12,4903000.0
4903,4903999,21.21734974572887,38.67306953335133,0.08808857230542211,755.4546327590942,318.6637074947357,736.7728157043457,18589,4940,13649,13649,0,12,4904000.0
4904,4904999,21.216118748115846,38.67089448623174,0.08811896620476622,755.6540849208832,318.7245993614197,736.8044548034668,18591,4941,13650,13650,0,12,4905000.0
4905,4905999,21.214515537163496,38.66883973288182,0.08814051066464046,755.7901456356049,318.7864565849304,737.2945251464844,18601,4941,13660,13660,0,12,4906000.0
4906,4906999,21.212599716252473,38.66625505848426,0.08816418339135246,755.9167258739471,318.84691643714905,737.5635108947754,18601,4941,13660,13660,0,12,4907000.0
4907,4907999,21.21112516472854,38.66666559558004,0.08817595212532126,756.03813123703,318.907443523407,737.7296943664551,18602,4941,13661,13661,0,12,4908000.0
4908,4908999,21.209459843486005,38.66470269317787,0.08820075412324258,756.2564625740051,318.9687111377716,737.7519416809082,18612,4943,13669,13669,0,12,4909000.0
4909,4909999,21.207508604756345,38.661838199024395,0.08822924183392644,756.3823218345642,319.0294840335846,737.8628349304199,18612,4943,13669,13669,0,12,4910000.0
4910,4910999,21.205553602790523,38.65913972632938,0.08825718305858121,756.5701856613159,319.090482711792,737.9148101806641,18614,4944,13670,13670,0,12,4911000.0
4911,4911999,21.203716549703675,38.656748340362284,0.08827836011338874,756.7021074295044,319.15109181404114,738.0110321044922,18614,4944,13670,13670,0,12,4912000.0
4912,4912999,21.202106398998538,38.65496590880016,0.08828686375584183,756.8638234138489,319.2117729187012,738.0193367004395,18616,4945,13671,13671,0,12,4913000.0
4913,4913999,21.200596619473345,38.65365639828165,0.0882927546664255,757.0901389122009,319.27314281463623,737.9670104980469,18620,4947,13673,13673,0,12,4914000.0
4914,4914999,21.199708696115845,38.652960725059614,0.08828020219529076,757.218790769577,319.3340792655945,738.0868759155273,18620,4947,13673,13673,0,12,4915000.0
4915,4915999,21.198717035594242,38.651716551902595,0.08827230559295796,757.3978655338287,319.395220041275,738.0608291625977,18623,4948,13675,13675,0,12,4916000.0
4916,4916999,21.19820968617572,38.651206928698116,0.08825214442771001,757.6177802085876,319.45742440223694,737.9284210205078,18628,4950,13678,13678,0,12,4917000.0
4917,4917999,21.197612817702403,38.6504934476736,0.08823301077760037,757.7439141273499,319.5188527107239,738.0525665283203,18628,4950,13678,13678,0,12,4918000.0
4918,4918999,21.19749504941561,38.650684016926036,0.08820827777784956,757.944623708725,319.58087182044983,738.123104095459,18630,4951,13679,13679,0,12,4919000.0
4919,4919999,21.19709841336174,38.649568584547296,0.08819246281500281,758.0687589645386,319.64192152023315,738.2243118286133,18630,4951,13679,13679,0,12,4920000.0
4920,4920999,21.197105358132745,38.65092117072546,0.08816660148037225,758.1935977935791,319.7030756473541,738.3096504211426,18630,4951,13679,13679,0,12,4921000.0
4921,4921999,21.196941772801427,38.650420313751795,0.08814726157942188,758.3729650974274,319.7643811702728,738.3007736206055,18632,4952,13680,13680,0,12,4922000.0
4922,4922999,21.19653952572118,38.64952695853895,0.08813430375791276,758.555650472641,319.82581901550293,738.3180847167969,18634,4953,13681,13681,0,12,4923000.0
4923,4923999,21.195858858930784,38.647947459377995,0.08812962898532561,758.7458236217499,319.88739228248596,738.3085441589355,18637,4954,13683,13683,0,12,4924000.0
4924,4924999,21.195508134904003,38.64709792515697,0.08811872641441765,758.877610206604,319.9488196372986,738.4229888916016,18637,4954,13683,13683,0,12,4925000.0
4925,4925999,21.19395994824812,38.64449560414257,0.08812947214431899,761.8158075809479,320.01256370544434,738.8270606994629,18651,4955,13696,13696,0,12,4926000.0
4926,4926999,21.19204039480669,38.64255295307866,0.08814348133143557,761.949286699295,320.0747718811035,739.1830596923828,18652,4955,13697,13697,0,12,4927000.0
4927,4927999,21.189755051247197,38.63933279436086,0.08816422118010359,762.0701968669891,320.1357867717743,739.442985534668,18653,4955,13698,13698,0,12,4928000.0
4928,4928999,21.187798772564914,38.63687085353777,0.08817646810280222,762.2569150924683,320.1971507072449,739.5080337524414,18661,4956,13705,13705,0,12,4929000.0
4929,4929999,21.185956663824207,38.63404761364331,0.08819298510558793,762.5165655612946,320.2605369091034,739.5709571838379,18667,4959,13708,13708,0,12,4930000.0
4930,4930999,21.184048518871883,38.631097336624286,0.08820529857665338,762.6906998157501,320.3218550682068,739.6177444458008,18669,4960,13709,13709,0,12,4931000.0
4931,4931999,21.182469995522144,38.628776934649075,0.088217138684338,762.8665864467621,320.38402819633484,739.8008079528809,18671,4961,13710,13710,0,12,4932000.0
4932,4932999,21.180876862914438,38.6261528334432,0.08822904252953712,762.9884829521179,320.4459056854248,739.9157485961914,18671,4961,13710,13710,0,12,4933000.0
4933,4933999,21.179173053291652,38.6237692704254,0.08823901667376222,763.134783744812,320.50731897354126,740.0181312561035,18671,4961,13710,13710,0,12,4934000.0
4934,4934999,21.1777285357262,38.62158502247094,0.08824580801801285,763.3304057121277,320.5692687034607,740.0284385681152,18673,4962,13711,13711,0,12,4935000.0
4935,4935999,21.176365778980585,38.619334424462465,0.08825310042005474,763.5129849910736,320.6313245296478,740.0130386352539,18675,4963,13712,13712,0,12,4936000.0
4936,4936999,21.175024547300975,38.61715353966719,0.0882576226355356,763.6907660961151,320.69321608543396,740.0678825378418,18677,4964,13713,13713,0,12,4937000.0
4937,4937999,21.173793786116867,38.61482432639141,0.08826846956716905,763.8603296279907,320.755247592926,740.0931282043457,18679,4965,13714,13714,0,12,4938000.0
4938,4938999,21.17268856337852,38.61313592325316,0.08826652241491373,763.9974460601807,320.8171513080597,740.2118225097656,18679,4965,13714,13714,0,12,4939000.0
4939,4939999,21.17183684332587,38.61127119543773,0.0882703093803553,764.1825439929962,320.8795278072357,740.2013626098633,18681,4966,13715,13715,0,12,4940000.0
4940,4940999,21.170853431052176,38.60950096696865,0.08826820388119816,764.3697640895844,320.94151282310486,740.2547607421875,18704,4967,13737,13737,0,12,4941000.0
4941,4941999,21.169964698854635,38.607651013092784,0.08827272957089038,764.6467940807343,321.00517320632935,740.0649337768555,18718,4970,13748,13748,0,12,4942000.0
4942,4942999,21.169152949385367,38.60560486775876,0.08827559515395822,764.8228685855865,321.0678722858429,740.0930519104004,18720,4971,13749,13749,0,12,4943000.0
4943,4943999,21.168746981568347,38.60441349997349,0.0882708463985663,765.0917205810547,321.13081979751587,740.0156478881836,18726,4974,13752,13752,0,12,4944000.0
4944,4944999,21.16813557621,38.603308514603484,0.08826416752185606,765.2584886550903,321.1983983516693,740.1736221313477,18726,4974,13752,13752,0,12,4945000.0
4945,4945999,21.167413378623937,38.601450672583766,0.08826101518052609,765.3898677825928,321.260281085968,740.3094139099121,18726,4974,13752,13752,0,12,4946000.0
4946,4946999,21.1660892178622,38.599943936037015,0.08826317749575374,765.5075991153717,321.32476782798767,740.9087753295898,18738,4974,13764,13764,0,12,4947000.0
4947,4947999,21.165009515619765,38.59860587051589,0.08825854599273353,765.6245744228363,321.38683676719666,741.2475090026855,18739,4974,13765,13765,0,12,4948000.0
4948,4948999,21.16349090421355,38.59618342701815,0.08826626911701119,765.8571317195892,321.4485580921173,741.2107849121094,18752,4976,13776,13776,0,12,4949000.0
4949,4949999,21.16217364416421,38.593765441880734,0.08827933206415883,766.124089717865,321.51058745384216,741.2984924316406,18758,4979,13779,13779,0,12,4950000.0
4950,4950999,21.160867062536546,38.59163296232745,0.08829008281794071,766.2954511642456,321.57237672805786,741.4467697143555,18760,4980,13780,13780,0,12,4951000.0
4951,4951999,21.159426333370945,38.58900366567496,0.08829685188941028,766.4283781051636,321.63364481925964,741.6335868835449,18760,4980,13780,13780,0,12,4952000.0
4952,4952999,21.158305583508778,38.58695310939913,0.08830171982428525,766.5704379081726,321.695294380188,741.7712211608887,18760,4980,13780,13780,0,12,4953000.0
4953,4953999,21.15713211452895,38.58470258992573,0.08830249260793233,766.703045129776,321.75700402259827,741.8735008239746,18760,4980,13780,13780,0,12,4954000.0
4954,4954999,21.156357643138094,38.58926205517361,0.0882674523326491,766.964516878128,321.8190109729767,741.7725639343262,18766,4983,13783,13783,0,12,4955000.0
4955,4955999,21.15500853558002,38.58687430019193,0.08827394289814472,767.1868913173676,321.88131952285767,741.846492767334,18770,4985,13785,13785,0,12,4956000.0
4956,4956999,21.15389730816416,38.58510206397851,0.08827557225095439,767.3302986621857,321.94355630874634,742.0150566101074,18770,4985,13785,13785,0,12,4957000.0
4957,4957999,21.152735004698943,38.582918508509934,0.08827456219649887,767.4677073955536,322.00522899627686,742.118335723877,18770,4985,13785,13785,0,12,4958000.0
4958,4958999,21.151553300844032,38.58059871411727,0.08827534860869046,767.6570110321045,322.06735849380493,742.1168670654297,18775,4986,13789,13789,0,12,4959000.0
4959,4959999,21.150378904743192,38.57858495345001,0.08827361569480074,767.7833118438721,322.12892842292786,742.1915550231934,18775,4986,13789,13789,0,12,4960000.0
4960,4960999,21.149318009090184,38.57623687012504,0.08827509792728205,767.913501739502,322.192978143692,742.2930946350098,18775,4986,13789,13789,0,12,4961000.0
4961,4961999,21.14857166163937,38.57419127085595,0.08826995868429854,768.1130049228668,322.2551600933075,742.2524147033691,18780,4987,13793,13793,0,12,4962000.0
4962,4962999,21.14795840933518,38.5723175387006,0.08826489833462814,768.2922539710999,322.31723642349243,742.202880859375,18785,4988,13797,13797,0,12,4963000.0
4963,4963999,21.147703183892105,38.57111040707628,0.0882546700155108,768.4941167831421,322.37990951538086,742.1915130615234,18787,4989,13798,13798,0,12,4964000.0
4964,4964999,21.14703984162207,38.569266906952485,0.08825056447714874,768.6939358711243,322.44253945350647,742.2472496032715,18789,4990,13799,13799,0,12,4965000.0
4965,4965999,21.14610726715941,38.566872599253884,0.08825217726930312,768.812793970108,322.5044741630554,742.3449478149414,18789,4990,13799,13799,0,12,4966000.0
4966,4966999,21.144832571522006,38.56436520976984,0.0882571990074772,768.9539291858673,322.56800985336304,742.4785003662109,18789,4990,13799,13799,0,12,4967000.0
4967,4967999,21.143603734549206,38.56422321751407,0.08822383580663273,769.0714349746704,322.63231801986694,743.4575157165527,18809,4990,13819,13819,0,12,4968000.0
4968,4968999,21.14161787177579,38.56242721096935,0.08823852063171223,769.2395782470703,322.6942114830017,743.7232093811035,18818,4991,13827,13827,0,12,4969000.0
4969,4969999,21.139541022809986,38.559440250557195,0.08825692333093815,769.4649379253387,322.7564651966095,743.7739372253418,18823,4993,13830,13830,0,12,4970000.0
4970,4970999,21.13737413415222,38.55612918386276,0.08828622943024711,769.7644331455231,322.8188440799713,743.8724975585938,18852,4997,13855,13855,0,12,4971000.0
4971,4971999,21.135425503271186,38.55337181032584,0.08830309889025878,769.8801155090332,322.88059759140015,744.2353668212891,18852,4997,13855,13855,0,12,4972000.0
4972,4972999,21.13370292075005,38.55062939818142,0.08831919189225701,770.1482155323029,322.9444146156311,744.2556571960449,18858,5000,13858,13858,0,12,4973000.0
4973,4973999,21.131865514261555,38.54798361387175,0.08833405419402718,770.3122868537903,323.0070471763611,744.5274658203125,18860,5001,13859,13859,0,12,4974000.0
4974,4974999,21.13002498311944,38.54493439074469,0.08834826432866938,770.452339887619,323.0695152282715,744.7691345214844,18860,5001,13859,13859,0,12,4975000.0
4975,4975999,21.128217520928832,38.54216712111492,0.08836233680295857,770.7276875972748,323.1342329978943,744.7617225646973,18866,5004,13862,13862,0,12,4976000.0
4976,4976999,21.12642222929499,38.53984395661011,0.08837343001948805,770.9540541172028,323.1973693370819,744.8554153442383,18876,5006,13870,13870,0,12,4977000.0
4977,4977999,21.124955768618637,38.53753328659291,0.08837692490720672,771.0957636833191,323.2597756385803,745.0362930297852,18876,5006,13870,13870,0,12,4978000.0
4978,4978999,21.12335308817036,38.53477878907357,0.08838438222680334,771.2701697349548,323.32203364372253,745.1218910217285,18878,5007,13871,13871,0,12,4979000.0
4979,4979999,21.122014964282666,38.532580655513804,0.08838388783524609,771.500216960907,323.38490200042725,745.0988464355469,18882,5009,13873,13873,0,12,4980000.0
4980,4980999,21.12087493256876,38.53096785709458,0.08838050470596459,771.6807668209076,323.44793248176575,745.277515411377,18906,5010,13896,13896,0,12,4981000.0
4981,4981999,21.12042552462917,38.53087720590735,0.08836116747660772,771.8102428913116,323.510267496109,745.4267921447754,18906,5010,13896,13896,0,12,4982000.0
4982,4982999,21.12004541462316,38.530221380211934,0.08834668285367397,771.9873979091644,323.5728073120117,745.4774169921875,18912,5011,13901,13901,0,12,4983000.0
4983,4983999,21.12041519911807,38.530904791575914,0.08831832604161427,772.1749453544617,323.63558769226074,745.5626983642578,18914,5012,13902,13902,0,12,4984000.0
4984,4984999,21.12077323450019,38.53131433664217,0.08829911786671862,772.4118745326996,323.69932532310486,745.5299835205078,18918,5014,13904,13904,0,12,4985000.0
4985,4985999,21.120779837833258,38.53086276599033,0.08828919924863732,772.5571010112762,323.7623863220215,745.7056999206543,18918,5014,13904,13904,0,12,4986000.0
4986,4986999,21.1208931294679,38.53056202735685,0.0882741345685989,772.6763620376587,323.8248801231384,745.81689453125,18918,5014,13904,13904,0,12,4987000.0
4987,4987999,21.120529059246195,38.53038094527755,0.08825754559096533,772.9182868003845,323.8881013393402,745.8401031494141,18922,5016,13906,13906,0,12,4988000.0
4988,4988999,21.118938548425803,38.52839796935815,0.08826410958317232,773.0526349544525,323.95164251327515,746.9330177307129,18947,5016,13931,13931,0,12,4989000.0
4989,4989999,21.116888817874894,38.525233074805534,0.08828079937588518,773.2164959907532,324.0134632587433,747.2198257446289,18956,5017,13939,13939,0,12,4990000.0
4990,4990999,21.1152017842056,38.523504246040595,0.08828946320760744,773.4645233154297,324.07620549201965,747.3707084655762,18962,5020,13942,13942,0,12,4991000.0
4991,4991999,21.11361411184425,38.52082316829044,0.08830259057029799,773.6808784008026,324.13994240760803,747.6050796508789,18966,5022,13944,13944,0,12,4992000.0
4992,4992999,21.112216277260927,38.51877608792787,0.0883035698217971,773.8099842071533,324.20169258117676,747.8315277099609,18966,5022,13944,13944,0,12,4993000.0
4993,4993999,21.111353356209058,38.51718123468406,0.08830234772886802,773.9863777160645,324.2641324996948,747.9793434143066,18968,5023,13945,13945,0,12,4994000.0
4994,4994999,21.11051643751866,38.515494737879266,0.08830306841366076,774.2906258106232,324.32922410964966,747.9372749328613,18976,5027,13949,13949,0,12,4995000.0
4995,4995999,21.109636389555828,38.51398060874719,0.08830530549084625,774.4178607463837,324.3914678096771,748.1397399902344,18976,5027,13949,13949,0,12,4996000.0
4996,4996999,21.10903795760475,38.51262856665461,0.08830809540115903,774.7891640663147,324.4555633068085,747.997802734375,18991,5032,13959,13959,0,12,4997000.0
4997,4997999,21.108660952541506,38.51165630117699,0.08830744831447823,775.0104942321777,324.51983642578125,748.0854263305664,18995,5034,13961,13961,0,12,4998000.0
4998,4998999,21.10844629190918,38.510964061010206,0.08832098621446349,775.1824119091034,324.58308362960815,748.2837562561035,18997,5035,13962,13962,0,12,4999000.0
4999,4999999,21.108176682525507,38.51011553394378,0.08834705985314129,775.4476315975189,324.6467978954315,748.2494163513184,19003,5038,13965,13965,0,12,5000000.0
5000,5000999,21.107985677366585,38.50930941183827,0.08836318935521015,775.5837619304657,324.7097382545471,748.4489097595215,19003,5038,13965,13965,0,12,5001000.0
5001,5001999,21.1078637541556,38.50863259476687,0.0883986899939343,775.7303659915924,324.7745056152344,748.6262512207031,19003,5038,13965,13965,0,12,5002000.0
5002,5002999,21.108104191816796,38.5086559485198,0.0884188591965126,775.9073071479797,324.83754873275757,748.7210159301758,19005,5039,13966,13966,0,12,5003000.0
5003,5003999,21.108464494893195,38.51012003099247,0.08841282354078162,776.0996751785278,324.9009974002838,748.7431755065918,19007,5040,13967,13967,0,12,5004000.0
5004,5004999,21.10852524363669,38.50965904860617,0.08844752089102992,776.2234773635864,324.9641065597534,748.9464416503906,19007,5040,13967,13967,0,12,5005000.0
5005,5005999,21.108633135493655,38.50872108052736,0.08846887943905035,776.3557600975037,325.02741289138794,749.0454063415527,19007,5040,13967,13967,0,12,5006000.0
5006,5006999,21.10862510434301,38.507740155948014,0.08848077137452592,776.5478668212891,325.0906767845154,749.1288032531738,19009,5041,13968,13968,0,12,5007000.0
5007,5007999,21.108413521000116,38.50637593826247,0.08849102312787316,776.6765348911285,325.1557629108429,749.2637901306152,19009,5041,13968,13968,0,12,5008000.0
5008,5008999,21.10775467761978,38.50464637876511,0.08850007994101061,776.8347508907318,325.21957087516785,749.710147857666,19018,5041,13977,13977,0,12,5009000.0
5009,5009999,21.105986811023428,38.50197078162056,0.08852060676059925,776.9446425437927,325.28298568725586,750.5815124511719,19024,5041,13983,13983,0,12,5010000.0
5010,5010999,21.10454818079297,38.500318574370276,0.08853332689815163,777.1104166507721,325.3465642929077,750.8254127502441,19032,5042,13990,13990,0,12,5011000.0
5011,5011999,21.102773770372192,38.497362299096174,0.08855695283460974,777.2426619529724,325.4083869457245,751.0906791687012,19033,5042,13991,13991,0,12,5012000.0
5012,5012999,21.101551422746276,38.49622771798111,0.0885628622272574,777.3591575622559,325.47048449516296,751.2867774963379,19033,5042,13991,13991,0,12,5013000.0
5013,5013999,21.100012790552867,38.49403304896198,0.08857969910321073,777.4880933761597,325.53216457366943,751.4500885009766,19033,5042,13991,13991,0,12,5014000.0
5014,5014999,21.09867541931294,38.4919561944371,0.08858859395124297,777.8030798435211,325.5963668823242,751.338550567627,19041,5046,13995,13995,0,12,5015000.0
5015,5015999,21.09744306401957,38.48973108362794,0.0885979488508446,777.9823281764984,325.6588761806488,751.504280090332,19043,5047,13996,13996,0,12,5016000.0
5016,5016999,21.096037757036548,38.487223348391005,0.088607550726435,778.11781001091,325.7207362651825,751.6480827331543,19043,5047,13996,13996,0,12,5017000.0
5017,5017999,21.095156085355203,38.492923628535074,0.08857603790868063,778.3841757774353,325.7833797931671,751.5567626953125,19054,5050,14004,14004,0,12,5018000.0
5018,5018999,21.094001752285678,38.49070057241854,0.08857958789467979,778.5745520591736,325.846373796463,751.7177810668945,19056,5051,14005,14005,0,12,5019000.0
5019,5019999,21.092779481766907,38.48812023324273,0.08858941514220742,778.7526798248291,325.90874123573303,751.8066253662109,19058,5052,14006,14006,0,12,5020000.0
5020,5020999,21.091820736156937,38.488727082069886,0.08858297398131387,778.8943293094635,325.9711036682129,751.9195137023926,19058,5052,14006,14006,0,12,5021000.0
5021,5021999,21.090895476689408,38.486806854054834,0.08858541501747175,779.035382270813,326.03353786468506,752.0480308532715,19058,5052,14006,14006,0,12,5022000.0
5022,5022999,21.09003906653658,38.484887968925364,0.08858880839347749,779.1957921981812,326.09593296051025,752.0953330993652,19060,5053,14007,14007,0,12,5023000.0
5023,5023999,21.089146242336,38.48281646945431,0.08859678820222672,779.369392156601,326.1588490009308,752.1869125366211,19061,5054,14007,14007,0,12,5024000.0
5024,5024999,21.088247270911083,38.48136601076352,0.08860049368767053,779.5140550136566,326.22254610061646,752.2938537597656,19061,5054,14007,14007,0,12,5025000.0
5025,5025999,21.0873597832938,38.47924291316977,0.08860922773420443,779.7543511390686,326.2859628200531,752.4806938171387,19072,5056,14016,14016,0,12,5026000.0
5026,5026999,21.08575866562353,38.477591939369276,0.08861548909811734,779.873722076416,326.349191904068,753.4347267150879,19081,5056,14025,14025,0,12,5027000.0
5027,5027999,21.083904589646902,38.47484333663401,0.08863571745359478,779.9980807304382,326.41326928138733,753.8137168884277,19082,5056,14026,14026,0,12,5028000.0
5028,5028999,21.08219258807533,38.472579259336854,0.08865017112722018,780.1319601535797,326.47518134117126,754.0486679077148,19082,5056,14026,14026,0,12,5029000.0
5029,5029999,21.080750944597575,38.471192467687594,0.08865849626608491,780.2478947639465,326.537392616272,754.2927589416504,19083,5056,14027,14027,0,12,5030000.0
5030,5030999,21.079273081685784,38.469291392304,0.0886657058197503,780.370879650116,326.5991268157959,754.4698524475098,19083,5056,14027,14027,0,12,5031000.0
5031,5031999,21.07840471269229,38.4684866882253,0.08865533307025442,780.6823992729187,326.6638512611389,754.4187812805176,19091,5060,14031,14031,0,12,5032000.0
5032,5032999,21.077221246740407,38.466926305951596,0.08865494742281699,780.8158137798309,326.72600769996643,754.611988067627,19091,5060,14031,14031,0,12,5033000.0
5033,5033999,21.076063572151654,38.465061914275516,0.08865282122997231,781.0130348205566,326.7888402938843,754.7196731567383,19093,5061,14032,14032,0,12,5034000.0
5034,5034999,21.075217706818616,38.46338533241495,0.08864499716344942,781.1525602340698,326.85169744491577,754.8694801330566,19093,5061,14032,14032,0,12,5035000.0
5035,5035999,21.07485438272174,38.46332218221968,0.08862164140717754,781.3428733348846,326.9175214767456,754.9472312927246,19095,5062,14033,14033,0,12,5036000.0
5036,5036999,21.07498833807413,38.464030869982246,0.08859478776693219,781.5228435993195,326.98027777671814,755.0001983642578,19097,5063,14034,14034,0,12,5037000.0
5037,5037999,21.07507641823502,38.46429487691015,0.08857010597329718,781.6951644420624,327.04284834861755,755.0467643737793,19099,5064,14035,14035,0,12,5038000.0
5038,5038999,21.075443781297768,38.46463210616415,0.0885437738652638,781.8590610027313,327.10636353492737,755.1794242858887,19099,5064,14035,14035,0,12,5039000.0
5039,5039999,21.07556272514974,38.46469620091988,0.08852308544353782,781.989499092102,327.1692717075348,755.2681503295898,19099,5064,14035,14035,0,12,5040000.0
5040,5040999,21.075953031082758,38.4664114732414,0.08849564387339504,782.1434390544891,327.2319643497467,755.3662872314453,19099,5064,14035,14035,0,12,5041000.0
5041,5041999,21.076016968873642,38.46609275903361,0.08848079366132289,782.3034524917603,327.29451870918274,755.3378829956055,19101,5065,14036,14036,0,12,5042000.0
5042,5042999,21.076234376103557,38.46586441766216,0.0884683662637129,782.5912852287292,327.3582274913788,755.211799621582,19107,5068,14039,14039,0,12,5043000.0
5043,5043999,21.075980708064442,38.46456366831047,0.08846076596411856,782.830864906311,327.4219765663147,755.195182800293,19111,5070,14041,14041,0,12,5044000.0
5044,5044999,21.075823703512643,38.46326886311305,0.08845129355873582,782.9600048065186,327.4870321750641,755.3420066833496,19111,5070,14041,14041,0,12,5045000.0
5045,5045999,21.075244540523475,38.4620618499391,0.08844327901763893,783.1080784797668,327.5516948699951,756.0790176391602,19129,5070,14059,14059,0,12,5046000.0
5046,5046999,21.073652206656213,38.45981499628087,0.08844987314518837,783.2388956546783,327.61438512802124,756.6018981933594,19130,5070,14060,14060,0,12,5047000.0
5047,5047999,21.07315359278637,38.461581080659485,0.08842698330891108,783.363597869873,327.6767210960388,756.9191017150879,19130,5070,14060,14060,0,12,5048000.0
5048,5048999,21.072938728942255,38.46230882405443,0.0884066678538662,783.483008146286,327.7389657497406,757.1445388793945,19130,5070,14060,14060,0,12,5049000.0
5049,5049999,21.07263531838315,38.462915022246,0.08838854443140565,783.7020194530487,327.8017671108246,757.2230339050293,19134,5072,14062,14062,0,12,5050000.0
5050,5050999,21.07344758558056,38.47218544128166,0.08834667194603663,783.9708571434021,327.86552238464355,757.1925964355469,19140,5075,14065,14065,0,12,5051000.0
5051,5051999,21.073627945621165,38.472760951291164,0.08835553003527996,784.1622433662415,327.9306764602661,757.3609886169434,19142,5076,14066,14066,0,12,5052000.0
5052,5052999,21.073809427225875,38.47341299807707,0.08837762961171636,784.3224394321442,327.9932975769043,757.5017852783203,19144,5077,14067,14067,0,12,5053000.0
5053,5053999,21.07487151103595,38.47674218219636,0.08837378239952998,784.556859254837,328.05705666542053,757.5447463989258,19148,5079,14069,14069,0,12,5054000.0
5054,5054999,21.075780045823493,38.48356072426806,0.08834943118998517,784.7400155067444,328.1202163696289,757.6861190795898,19150,5080,14070,14070,0,12,5055000.0
5055,5055999,21.07647210920685,38.484060338830346,0.08835686180380486,785.009396314621,328.1838264465332,757.618293762207,19164,5083,14081,14081,0,12,5056000.0
5056,5056999,21.077037918676204,38.48451409127529,0.08837212643838088,785.2415609359741,328.2477431297302,757.7131690979004,19168,5085,14083,14083,0,12,5057000.0
5057,5057999,21.07792315763614,38.48569914926067,0.08838284681772557,785.3906946182251,328.31067657470703,757.8675231933594,19168,5085,14083,14083,0,12,5058000.0
5058,5058999,21.07833252735519,38.4854918871686,0.08839369201265335,785.673100233078,328.37475395202637,757.7945518493652,19174,5088,14086,14086,0,12,5059000.0
5059,5059999,21.07904334643316,38.48588395369172,0.08840731762777265,785.7984840869904,328.43751215934753,757.9480857849121,19174,5088,14086,14086,0,12,5060000.0
5060,5060999,21.07984871346112,38.48658755877116,0.08841722011977837,785.9277994632721,328.5021412372589,758.0998573303223,19174,5088,14086,14086,0,12,5061000.0
5061,5061999,21.08094354667181,38.48754776263866,0.08843071957945647,786.1147692203522,328.56538367271423,758.1686973571777,19176,5089,14087,14087,0,12,5062000.0
5062,5062999,21.081962824519238,38.487973454963175,0.08847183178394713,786.266441822052,328.62887692451477,758.2478332519531,19176,5089,14087,14087,0,12,5063000.0
5063,5063999,21.082881663744878,38.488251961532605,0.08849568451942258,786.4089300632477,328.6915924549103,758.3439788818359,19176,5089,14087,14087,0,12,5064000.0
5064,5064999,21.083681967208097,38.48800255716103,0.08851456571673921,786.5304861068726,328.7540121078491,758.4463157653809,19176,5089,14087,14087,0,12,5065000.0
5065,5065999,21.083569065870087,38.48687821919766,0.08852813328100861,786.7301177978516,328.81954550743103,758.8148956298828,19192,5090,14102,14102,0,12,5066000.0
5066,5066999,21.082171353403652,38.48574856055256,0.08852601414151462,786.8638708591461,328.88436794281006,759.547191619873,19196,5090,14106,14106,0,12,5067000.0
5067,5067999,21.080546586534975,38.4833958554969,0.08853021783241921,786.9805092811584,328.9468529224396,759.9131889343262,19197,5090,14107,14107,0,12,5068000.0
5068,5068999,21.079121281734224,38.482180635729435,0.08852571429222755,787.1405675411224,329.009117603302,760.098991394043,19200,5091,14109,14109,0,12,5069000.0
5069,5069999,21.077603200373158,38.47969902788348,0.0885302968264412,787.3628015518188,329.0733609199524,760.1320266723633,19204,5093,14111,14111,0,12,5070000.0
5070,5070999,21.076300658725334,38.47744738693764,0.0885330189154323,787.6178240776062,329.1365990638733,760.1924171447754,19210,5096,14114,14114,0,12,5071000.0
5071,5071999,21.075105348852908,38.47537944061923,0.08853577442422844,787.8320362567902,329.2001156806946,760.3838157653809,19214,5098,14116,14116,0,12,5072000.0
5072,5072999,21.07447293708813,38.474930978748446,0.08852906150817808,787.9739832878113,329.2635385990143,760.634464263916,19214,5098,14116,14116,0,12,5073000.0
5073,5073999,21.074223205241317,38.475048524670676,0.08851636982575062,788.1791996955872,329.32618141174316,760.6395645141602,19218,5100,14118,14118,0,12,5074000.0
5074,5074999,21.074240885399668,38.4751818415349,0.08850815176692428,788.3687942028046,329.3899519443512,760.8261756896973,19220,5101,14119,14119,0,12,5075000.0
5075,5075999,21.07446649447854,38.47576206463518,0.08849391817078045,788.5415782928467,329.45346331596375,760.937385559082,19222,5102,14120,14120,0,12,5076000.0
5076,5076999,21.07499140155481,38.476926237559624,0.08847458626036597,788.6705286502838,329.5185878276825,761.114444732666,19222,5102,14120,14120,0,12,5077000.0
5077,5077999,21.07553789321713,38.47831644898804,0.08846106215109029,788.8222770690918,329.581906080246,761.2512245178223,19222,5102,14120,14120,0,12,5078000.0
5078,5078999,21.076162913022152,38.47933435362291,0.08844908147399733,789.0955591201782,329.6456182003021,761.1511001586914,19234,5105,14129,14129,0,12,5079000.0
5079,5079999,21.076769386481956,38.480024277662444,0.08844242484639253,789.3176825046539,329.70994091033936,761.1870079040527,19238,5107,14131,14131,0,12,5080000.0
5080,5080999,21.077660663902723,38.480717457701466,0.08845708809787911,789.4809548854828,329.7734479904175,761.2900886535645,19240,5108,14132,14132,0,12,5081000.0
5081,5081999,21.078239787198267,38.48067030782176,0.08845824808314362,789.6596772670746,329.8371090888977,761.4123001098633,19249,5109,14140,14140,0,12,5082000.0
5082,5082999,21.0788746416656,38.48070204681156,0.08845929421472476,789.849609375,329.9030137062073,761.4536209106445,19251,5110,14141,14141,0,12,5083000.0
5083,5083999,21.079024503925503,38.48002182969305,0.08845590357688304,790.036777973175,329.96684527397156,761.5193290710449,19253,5111,14142,14142,0,12,5084000.0
5084,5084999,21.07960401505218,38.47961068535134,0.08843686512025051,790.2024796009064,330.03077697753906,761.5730323791504,19255,5112,14143,14143,0,12,5085000.0
5085,5085999,21.07940250141613,38.478741750325604,0.08842386265625624,790.3848371505737,330.0959703922272,762.1093940734863,19273,5113,14160,14160,0,12,5086000.0
5086,5086999,21.078223188318088,38.47881993066126,0.08841958764650659,790.5123512744904,330.1583082675934,762.6052589416504,19275,5113,14162,14162,0,12,5087000.0
5087,5087999,21.076542569026763,38.47582206393132,0.08843454203937073,790.6771125793457,330.22135615348816,762.762752532959,19277,5114,14163,14163,0,12,5088000.0
5088,5088999,21.074935367839224,38.4734411720485,0.08844757389427749,790.8049581050873,330.2839386463165,763.0041046142578,19278,5114,14164,14164,0,12,5089000.0
5089,5089999,21.073252756857954,38.47085186576369,0.08846153261535283,791.0667390823364,330.34712529182434,762.9414672851562,19284,5117,14167,14167,0,12,5090000.0
5090,5090999,21.071889206557252,38.46848699891617,0.08846394405724434,791.2319159507751,330.4108600616455,763.1209526062012,19286,5118,14168,14168,0,12,5091000.0
5091,5091999,21.070364818876637,38.46605802159607,0.08846982069195031,791.4466016292572,330.4736850261688,763.2192192077637,19290,5120,14170,14170,0,12,5092000.0
5092,5092999,21.068704517398956,38.46351098363927,0.08847979721484389,791.723482131958,330.5373525619507,763.2751045227051,19296,5123,14173,14173,0,12,5093000.0
5093,5093999,21.06734529605742,38.461471615224404,0.08848938928140326,791.8794786930084,330.5996718406677,763.3684234619141,19298,5124,14174,14174,0,12,5094000.0
5094,5094999,21.066029201923502,38.4592699953618,0.08850330493582925,792.1601886749268,330.66459107398987,763.4098129272461,19304,5127,14177,14177,0,12,5095000.0
5095,5095999,21.0649010664963,38.45732249847505,0.08851004122978257,792.4299485683441,330.72820830345154,763.4194030761719,19316,5130,14186,14186,0,12,5096000.0
5096,5096999,21.063594515418973,38.454924503216056,0.08851629582648923,792.5493755340576,330.7910475730896,763.6148567199707,19316,5130,14186,14186,0,12,5097000.0
5097,5097999,21.062436111182542,38.45283051869681,0.08852475320090702,792.690024137497,330.85389471054077,763.766471862793,19316,5130,14186,14186,0,12,5098000.0
5098,5098999,21.06122938138033,38.45113979129815,0.08852674703589891,792.8957660198212,330.91808462142944,763.7300987243652,19326,5132,14194,14194,0,12,5099000.0
5099,5099999,21.060170149045152,38.4489391312557,0.0885301459538772,793.0452635288239,330.98116660118103,763.8938064575195,19326,5132,14194,14194,0,12,5100000.0
5100,5100999,21.059255653563287,38.44721266193779,0.08853177034569093,793.1644313335419,331.04396414756775,764.0237121582031,19326,5132,14194,14194,0,12,5101000.0
5101,5101999,21.05827135309442,38.445291630414296,0.08853132792078078,793.299911737442,331.10707902908325,764.1299858093262,19326,5132,14194,14194,0,12,5102000.0
5102,5102999,21.057533715358712,38.443941771143656,0.08853248980090589,793.4285974502563,331.1696996688843,764.2072868347168,19326,5132,14194,14194,0,12,5103000.0
5103,5103999,21.05639451689188,38.441464878753806,0.08853521405617226,793.6846475601196,331.23342394828796,764.1405067443848,19330,5134,14196,14196,0,12,5104000.0
5104,5104999,21.055560262268237,38.43951429780204,0.08853729529709287,793.827577829361,331.2966561317444,764.2552299499512,19330,5134,14196,14196,0,12,5105000.0
5105,5105999,21.054411964303114,38.43775347491991,0.08854239195614533,793.9562046527863,331.35929775238037,764.3633728027344,19330,5134,14196,14196,0,12,5106000.0
5106,5106999,21.052896591369304,38.434994990320085,0.08855235983357546,794.0723414421082,331.4241397380829,765.279411315918,19346,5134,14212,14212,0,12,5107000.0
5107,5107999,21.051167964554764,38.432907460626225,0.08855857185468774,794.1947202682495,331.4862127304077,765.6589889526367,19347,5134,14213,14213,0,12,5108000.0
5108,5108999,21.049542057160426,38.43029641188082,0.08856342936108297,794.3126504421234,331.5482864379883,765.8857727050781,19348,5134,14214,14214,0,12,5109000.0
5109,5109999,21.047930627128775,38.42773447160886,0.08857078473044899,794.4584131240845,331.61104917526245,766.0842895507812,19348,5134,14214,14214,0,12,5110000.0
5110,5110999,21.046048040093808,38.424734957042475,0.08858177148359425,794.7085914611816,331.6745846271515,766.0115737915039,19354,5137,14217,14217,0,12,5111000.0
5111,5111999,21.04430571955815,38.42187558090277,0.08858832455812504,794.962278842926,331.7380962371826,766.0354766845703,19360,5140,14220,14220,0,12,5112000.0
5112,5112999,21.04258731835112,38.41905317120829,0.08859432881261053,795.0882952213287,331.8007333278656,766.225040435791,19360,5140,14220,14220,0,12,5113000.0
5113,5113999,21.04096464781823,38.41678967498799,0.08859901039543772,795.3203413486481,331.8640787601471,766.2742118835449,19364,5142,14222,14222,0,12,5114000.0
5114,5114999,21.039528607411125,38.414853342456674,0.08859749920284499,795.6028492450714,331.92771339416504,766.2732353210449,19376,5145,14231,14231,0,12,5115000.0
5115,5115999,21.037955143978348,38.412159671413676,0.08860584324500376,795.7696976661682,331.99061584472656,766.4318580627441,19378,5146,14232,14232,0,12,5116000.0
5116,5116999,21.03691487450871,38.41036843863051,0.08860110545081556,795.9387879371643,332.0549018383026,766.565486907959,19386,5147,14239,14239,0,12,5117000.0
5117,5117999,21.036464235860297,38.40964265785585,0.08859255577194214,796.1646637916565,332.11974906921387,766.4922676086426,19390,5149,14241,14241,0,12,5118000.0
5118,5118999,21.03648448138395,38.40914654026977,0.08858179324544313,796.2996263504028,332.18336963653564,766.6553916931152,19390,5149,14241,14241,0,12,5119000.0
5119,5119999,21.037176624779327,38.41272217615642,0.08855621936009883,796.4721977710724,332.24701404571533,766.7283020019531,19392,5150,14242,14242,0,12,5120000.0
5120,5120999,21.03742026718536,38.413383534422465,0.08854820865444646,796.6094017028809,332.3107590675354,766.8619613647461,19392,5150,14242,14242,0,12,5121000.0
5121,5121999,21.037790122445166,38.413940695349105,0.0885429657602439,796.7843313217163,332.3744287490845,766.9573211669922,19394,5151,14243,14243,0,12,5122000.0
5122,5122999,21.03860757706757,38.41522375938475,0.08854549640724163,797.0559899806976,332.4384808540344,766.836742401123,19407,5154,14253,14253,0,12,5123000.0
5123,5123999,21.038725062109226,38.4152932988491,0.08856132642224579,797.2397854328156,332.50191855430603,766.8753242492676,19409,5155,14254,14254,0,12,5124000.0
5124,5124999,21.038307716052266,38.41388125308955,0.08856654949517262,797.3854129314423,332.5659863948822,767.0191459655762,19409,5155,14254,14254,0,12,5125000.0
5125,5125999,21.03833758932214,38.41318682494668,0.0885802675588514,797.5088789463043,332.629182100296,767.1310806274414,19409,5155,14254,14254,0,12,5126000.0
5126,5126999,21.038188517293925,38.41225831485264,0.0886103704886545,797.6610543727875,332.6925072669983,767.3120040893555,19409,5155,14254,14254,0,12,5127000.0
5127,5127999,21.03761137959668,38.41105304965371,0.08857336674944427,797.7943892478943,332.757262468338,768.1888961791992,19428,5155,14273,14273,0,12,5128000.0
5128,5128999,21.036443288199894,38.40928195732925,0.08856121993727195,797.9541718959808,332.8205032348633,768.4520645141602,19431,5156,14275,14275,0,12,5129000.0
5129,5129999,21.03542096501465,38.40723080543192,0.08855062942586844,798.1188158988953,332.8833432197571,768.584903717041,19433,5157,14276,14276,0,12,5130000.0
5130,5130999,21.03437335346806,38.40584403022453,0.08854336938112073,798.380833864212,332.9466321468353,768.4937629699707,19445,5160,14285,14285,0,12,5131000.0
5131,5131999,21.03317414930373,38.403721858931334,0.08853505014803842,798.5581452846527,333.01021218299866,768.7221221923828,19447,5161,14286,14286,0,12,5132000.0
5132,5132999,21.032304524977057,38.40204538961406,0.08852778415912366,798.7697038650513,333.0752694606781,768.788890838623,19451,5163,14288,14288,0,12,5133000.0
5133,5133999,21.031162548294052,38.39993249590929,0.08852815406314352,798.9453594684601,333.1387014389038,768.9311027526855,19453,5164,14289,14289,0,12,5134000.0
5134,5134999,21.030162087705286,38.39788295607995,0.08852528455395103,799.1734571456909,333.20260405540466,768.9966049194336,19457,5166,14291,14291,0,12,5135000.0
5135,5135999,21.029058483808353,38.398069783018336,0.08851622634602285,799.435789346695,333.26657223701477,769.0014877319336,19463,5169,14294,14294,0,12,5136000.0
5136,5136999,21.028253195798133,38.3967740750921,0.08851636560029852,799.6537597179413,333.3316786289215,769.1428146362305,19467,5171,14296,14296,0,12,5137000.0
5137,5137999,21.02780753866768,38.396306198658145,0.08851845338945308,799.85040974617,333.39625310897827,769.2629661560059,19469,5172,14297,14297,0,12,5138000.0
5138,5138999,21.02764064965893,38.3985762094206,0.08851815521655737,799.9750325679779,333.4595546722412,769.3629608154297,19469,5172,14297,14297,0,12,5139000.0
5139,5139999,21.028229729562156,38.40258557444131,0.08851294870967841,800.1087396144867,333.522833108902,769.4850921630859,19469,5172,14297,14297,0,12,5140000.0
5140,5140999,21.029049862038608,38.40412493470412,0.08853704426636988,800.2465925216675,333.5862636566162,769.5886192321777,19469,5172,14297,14297,0,12,5141000.0
5141,5141999,21.03047533646682,38.40716699110256,0.08853907098965919,800.3773245811462,333.6497275829315,769.6642265319824,19469,5172,14297,14297,0,12,5142000.0
5142,5142999,21.031825066673424,38.40961976490077,0.08857559025558903,800.5977675914764,333.7141387462616,769.6396713256836,19482,5174,14308,14308,0,12,5143000.0
5143,5143999,21.033758110601646,38.4137305440731,0.08861725933976439,800.7478260993958,333.7777621746063,769.7626914978027,19482,5174,14308,14308,0,12,5144000.0
5144,5144999,21.0355235159452,38.41710691507141,0.08863967738889023,800.9648158550262,333.84145307540894,769.6632690429688,19486,5176,14310,14310,0,12,5145000.0
5145,5145999,21.036500241641882,38.418255222951274,0.08866184094805374,801.1519117355347,333.9054193496704,769.6778106689453,19488,5177,14311,14311,0,12,5146000.0
5146,5146999,21.037565335445258,38.41929776198684,0.08869506697571627,801.2897548675537,333.96922993659973,769.7746276855469,19488,5177,14311,14311,0,12,5147000.0
5147,5147999,21.03888891871166,38.421237698728675,0.08873364962802399,801.5260918140411,334.0340852737427,769.8924331665039,19499,5179,14320,14320,0,12,5148000.0
5148,5148999,21.03732412257242,38.41901066783337,0.08874619180064502,801.6522586345673,334.0970323085785,770.5675964355469,19511,5179,14332,14332,0,12,5149000.0
5149,5149999,21.03588580455442,38.417408755700656,0.08875265456499226,801.793829202652,334.1595706939697,770.8196029663086,19511,5179,14332,14332,0,12,5150000.0
5150,5150999,21.03438880429811,38.41516315061956,0.08876232695125619,801.9061179161072,334.2210946083069,771.0065040588379,19512,5179,14333,14333,0,12,5151000.0
5151,5151999,21.03312119392797,38.41511674015167,0.08875824381446717,802.0779802799225,334.28320264816284,771.0309219360352,19514,5180,14334,14334,0,12,5152000.0
5152,5152999,21.03168963879275,38.41627527779517,0.08875051265025269,802.2598798274994,334.34520268440247,771.0778923034668,19516,5181,14335,14335,0,12,5153000.0
5153,5153999,21.03007418995661,38.413523095060675,0.08876174497275147,802.4659976959229,334.4075856208801,771.1267776489258,19520,5183,14337,14337,0,12,5154000.0
5154,5154999,21.028855930502992,38.411650842286846,0.08876494517038536,802.6550140380859,334.470951795578,771.1797752380371,19522,5184,14338,14338,0,12,5155000.0
5155,5155999,21.027516236642587,38.40997746821932,0.0887679703106905,802.8335909843445,334.5332033634186,771.2626495361328,19524,5185,14339,14339,0,12,5156000.0
5156,5156999,21.02610033059958,38.40797875364789,0.08877562076866474,803.1148011684418,334.596346616745,771.0827293395996,19530,5188,14342,14342,0,12,5157000.0
5157,5157999,21.024939626816955,38.405999558272065,0.08878309877913837,803.2436943054199,334.6591091156006,771.2784805297852,19530,5188,14342,14342,0,12,5158000.0
5158,5158999,21.023946941520148,38.406398838748785,0.08877751772763909,803.3674046993256,334.7214982509613,771.3959426879883,19530,5188,14342,14342,0,12,5159000.0
5159,5159999,21.022603960019428,38.403938688551456,0.0887924873784689,803.6542789936066,334.7844455242157,771.2431678771973,19536,5191,14345,14345,0,12,5160000.0
5160,5160999,21.02150451438797,38.40215592934935,0.08879959754067546,803.7798914909363,334.8484878540039,771.4281730651855,19536,5191,14345,14345,0,12,5161000.0
5161,5161999,21.020432321246282,38.40215628974112,0.08880616900036431,803.9559698104858,334.9113256931305,771.5267524719238,19538,5192,14346,14346,0,12,5162000.0
5162,5162999,21.01928875707533,38.39984538997876,0.08882069603341802,804.0942633152008,334.97416520118713,771.6477012634277,19538,5192,14346,14346,0,12,5163000.0
5163,5163999,21.01792390183592,38.39717802810576,0.0888388487706313,804.2204883098602,335.03642225265503,771.7406234741211,19538,5192,14346,14346,0,12,5164000.0
5164,5164999,21.01645743308007,38.39545789676956,0.08885565141962015,804.4164879322052,335.0992705821991,771.8514099121094,19541,5193,14348,14348,0,12,5165000.0
5165,5165999,21.01457453781609,38.39238324577771,0.08887822717648675,804.5461280345917,335.1625289916992,772.6727066040039,19560,5193,14367,14367,0,12,5166000.0
5166,5166999,21.012802616109354,38.389990573030545,0.08889554154696488,804.7116193771362,335.2243857383728,772.8718605041504,19564,5194,14370,14370,0,12,5167000.0
5167,5167999,21.011192608419584,38.38855951783561,0.08890329485445891,804.929773569107,335.286572933197,772.9239883422852,19582,5196,14386,14386,0,12,5168000.0
5168,5168999,21.009361016726427,38.38569398155296,0.08891966738648649,805.0871315002441,335.3489239215851,773.1528511047363,19585,5197,14388,14388,0,12,5169000.0
5169,5169999,21.007766072053286,38.38363740598333,0.08893200073671548,805.2755424976349,335.41151571273804,773.2555999755859,19587,5198,14389,14389,0,12,5170000.0
5170,5170999,21.006424529345455,38.381845477024285,0.08893663102098959,805.5425815582275,335.47449469566345,773.3141784667969,19594,5201,14393,14393,0,12,5171000.0
5171,5171999,21.00504831567338,38.38087143210485,0.08893802374406479,805.6635849475861,335.53736448287964,773.538646697998,19594,5201,14393,14393,0,12,5172000.0
5172,5172999,21.003632027503592,38.37889812995013,0.08894150100955023,805.8454892635345,335.6005234718323,773.5803909301758,19596,5202,14394,14394,0,12,5173000.0
5173,5173999,21.00257275238917,38.37763432027583,0.08893915034862654,806.0200729370117,335.6645984649658,773.653751373291,19598,5203,14395,14395,0,12,5174000.0
5174,5174999,21.001257690492245,38.37568654447955,0.08894062150917559,806.2990338802338,335.72849917411804,773.6157073974609,19604,5206,14398,14398,0,12,5175000.0
5175,5175999,21.00035192755455,38.37424798310862,0.08893432622462694,806.481632232666,335.7916796207428,773.6964302062988,19606,5207,14399,14399,0,12,5176000.0
5176,5176999,20.999790092191933,38.37393133828906,0.08892466489053619,806.5993003845215,335.8549556732178,773.8350524902344,19606,5207,14399,14399,0,12,5177000.0
5177,5177999,20.999278128320633,38.37303992499843,0.08891529795217823,806.8450331687927,335.918438911438,773.7678680419922,19616,5209,14407,14407,0,12,5178000.0
5178,5178999,20.998352604811696,38.37134829463553,0.08891149789860187,807.0053176879883,335.982460975647,773.79736328125,19618,5210,14408,14408,0,12,5179000.0
5179,5179999,20.99800531194304,38.370815431751495,0.08890012993797847,807.1859495639801,336.0454001426697,773.8931007385254,19620,5211,14409,14409,0,12,5180000.0
5180,5180999,20.997209567599473,38.36916079893736,0.08889756428897522,807.3246042728424,336.1084942817688,774.0329093933105,19620,5211,14409,14409,0,12,5181000.0
5181,5181999,20.99637248331134,38.3674545291697,0.0888925685316827,807.5112051963806,336.17168951034546,774.0168266296387,19622,5212,14410,14410,0,12,5182000.0
5182,5182999,20.995716316227263,38.366077181937506,0.08888346729956276,807.7064008712769,336.23474764823914,774.060863494873,19624,5213,14411,14411,0,12,5183000.0
5183,5183999,20.99542074732967,38.36848158077934,0.08885569309770358,807.8316657543182,336.297815322876,774.185962677002,19624,5213,14411,14411,0,12,5184000.0
5184,5184999,20.99472319029108,38.369031625523,0.0888401633090603,808.0144522190094,336.36233735084534,774.6663131713867,19645,5214,14431,14431,0,12,5185000.0
5185,5185999,20.993035444783114,38.36711474672389,0.08884739620293236,808.121452331543,336.4251620769501,775.2939033508301,19650,5214,14436,14436,0,12,5186000.0
5186,5186999,20.991373828826898,38.3656351677582,0.0888530725520873,808.2319822311401,336.48733925819397,775.6385269165039,19651,5214,14437,14437,0,12,5187000.0
5187,5187999,20.990022408867976,38.36476520110511,0.0888497756795239,808.4534792900085,336.5507616996765,775.820384979248,19655,5216,14439,14439,0,12,5188000.0
5188,5188999,20.9887645386027,38.36294379367123,0.08884989363235596,808.6681571006775,336.6134650707245,775.9223136901855,19659,5218,14441,14441,0,12,5189000.0
5189,5189999,20.987874905222853,38.36206312771727,0.08884213310924782,808.7880759239197,336.6761019229889,776.144962310791,19659,5218,14441,14441,0,12,5190000.0
5190,5190999,20.986784469599076,38.36028789749169,0.08884394627239123,809.067170381546,336.7406439781189,776.1506195068359,19665,5221,14444,14444,0,12,5191000.0
5191,5191999,20.985620078078693,38.358254876670415,0.08884626550036567,809.2446417808533,336.80456376075745,776.3288536071777,19667,5222,14445,14445,0,12,5192000.0
5192,5192999,20.98443687597212,38.356057693636316,0.08884679139766538,809.3682744503021,336.86717987060547,776.4823989868164,19667,5222,14445,14445,0,12,5193000.0
5193,5193999,20.98349698982083,38.35430116312825,0.08884183930954459,809.6899454593658,336.93067932128906,776.4539794921875,19675,5226,14449,14449,0,12,5194000.0
5194,5194999,20.982823059319728,38.35373578958076,0.08884008978448188,809.8117845058441,336.9936110973358,776.601619720459,19675,5226,14449,14449,0,12,5195000.0
5195,5195999,20.981992054702037,38.35177675886258,0.08883749218482428,810.000729560852,337.056911945343,776.6810150146484,19677,5227,14450,14450,0,12,5196000.0
5196,5196999,20.98134633853814,38.35050197141758,0.08883444103857008,810.1656968593597,337.1198434829712,776.7095909118652,19679,5228,14451,14451,0,12,5197000.0
5197,5197999,20.980417308772335,38.348742276844995,0.0888350769082934,810.3945608139038,337.1833782196045,776.7132606506348,19683,5230,14453,14453,0,12,5198000.0
5198,5198999,20.979966802196767,38.35000566364557,0.08881895124604067,810.5449578762054,337.24736642837524,776.9269714355469,19683,5230,14453,14453,0,12,5199000.0
5199,5199999,20.97909291611052,38.34793264693659,0.08882533443919571,810.6606686115265,337.3102881908417,777.0473709106445,19683,5230,14453,14453,0,12,5200000.0
5200,5200999,20.978194623362167,38.34588462971354,0.08882938685663444,810.8870749473572,337.3735535144806,777.0023803710938,19687,5232,14455,14455,0,12,5201000.0
5201,5201999,20.97764882160043,38.344837237102816,0.08882772520351634,811.0702369213104,337.43866324424744,777.1329002380371,19690,5233,14457,14457,0,12,5202000.0
5202,5202999,20.97687829282256,38.34295300878148,0.08883148205401636,811.2390961647034,337.5019509792328,777.1741485595703,19692,5234,14458,14458,0,12,5203000.0
5203,5203999,20.97586477393893,38.34063838669741,0.08883351496011138,811.4285805225372,337.56601667404175,777.241584777832,19694,5235,14459,14459,0,12,5204000.0
5204,5204999,20.97472019469351,38.338249356068786,0.08883574404399697,811.5774989128113,337.62934398651123,777.3669586181641,19694,5235,14459,14459,0,12,5205000.0
5205,5205999,20.973814990683554,38.336134087910224,0.0888382961339842,811.7650122642517,337.6952254772186,778.0992774963379,19721,5236,14485,14485,0,12,5206000.0
5206,5206999,20.97192621361401,38.33338002872554,0.08885673419159101,811.8811283111572,337.75823521614075,778.6665573120117,19723,5236,14487,14487,0,12,5207000.0
5207,5207999,20.9701018893373,38.33061123125535,0.08887007652509515,811.9950449466705,337.8204538822174,779.014087677002,19723,5236,14487,14487,0,12,5208000.0
5208,5208999,20.968410450634053,38.32784418810987,0.08888513568940581,812.2502191066742,337.88397574424744,779.1251106262207,19730,5239,14491,14491,0,12,5209000.0
5209,5209999,20.96679963800723,38.32527790244484,0.08889734478270606,812.5123496055603,337.94739723205566,779.239688873291,19737,5242,14495,14495,0,12,5210000.0
5210,5210999,20.965479524164028,38.3241819461444,0.08889799417168576,812.684844493866,338.0105378627777,779.4428253173828,19740,5243,14497,14497,0,12,5211000.0
5211,5211999,20.963797242655595,38.32156297382783,0.08891018550656415,812.8526453971863,338.0746400356293,779.5773658752441,19742,5244,14498,14498,0,12,5212000.0
5212,5212999,20.96213989104726,38.31898600817043,0.08892183254649333,812.9762208461761,338.1388213634491,779.8243179321289,19742,5244,14498,14498,0,12,5213000.0
5213,5213999,20.960840797791462,38.31664344209855,0.0889273187822881,813.2288370132446,338.2022898197174,779.6991195678711,19748,5247,14501,14501,0,12,5214000.0
5214,5214999,20.95964622616659,38.31488966806086,0.08893432210818097,813.3582100868225,338.2654173374176,779.9340934753418,19748,5247,14501,14501,0,12,5215000.0
5215,5215999,20.95842970097269,38.31303899974312,0.08893921929530713,813.6022942066193,338.32969880104065,779.943660736084,19752,5249,14503,14503,0,12,5216000.0
5216,5216999,20.956885772160376,38.31040548213691,0.08895270694284785,813.8267598152161,338.3934247493744,779.9528999328613,19756,5251,14505,14505,0,12,5217000.0
5217,5217999,20.95553626351459,38.30789736238807,0.08896189626594464,814.0483841896057,338.45744371414185,779.9861335754395,19760,5253,14507,14507,0,12,5218000.0
5218,5218999,20.954450299475734,38.3061296809917,0.08896534823500424,814.2706809043884,338.5214521884918,779.9321327209473,19764,5255,14509,14509,0,12,5219000.0
5219,5219999,20.953394768634265,38.30432150363669,0.08896937206624522,814.5076518058777,338.5856649875641,779.9843559265137,19768,5257,14511,14511,0,12,5220000.0
5220,5220999,20.952732023123005,38.30352112797541,0.08896881369639409,814.7199490070343,338.65089654922485,780.0647926330566,19785,5259,14526,14526,0,12,5221000.0
5221,5221999,20.951972519420668,38.30196947111021,0.08896815140339653,814.8518533706665,338.714670419693,780.2736282348633,19785,5259,14526,14526,0,12,5222000.0
5222,5222999,20.95127107084501,38.30080179030325,0.08896521118892231,814.9929533004761,338.7787654399872,780.3980865478516,19785,5259,14526,14526,0,12,5223000.0
5223,5223999,20.95056973185637,38.300406869414815,0.08895608699466362,815.1774849891663,338.8426990509033,780.471378326416,19787,5260,14527,14527,0,12,5224000.0
5224,5224999,20.949412964667406,38.29925987297751,0.08895423040333328,815.2940902709961,338.90645003318787,780.6326484680176,19787,5260,14527,14527,0,12,5225000.0
5225,5225999,20.948343880776836,38.29707925621368,0.08895787501540797,815.4906747341156,338.9715976715088,781.1757125854492,19807,5261,14546,14546,0,12,5226000.0
5226,5226999,20.946759655495924,38.295902831684714,0.08896941343251519,815.5981786251068,339.03535771369934,781.8115158081055,19813,5261,14552,14552,0,12,5227000.0
5227,5227999,20.944904310596385,38.29314219649023,0.08898405242834873,815.7131681442261,339.09804010391235,782.2166862487793,19817,5261,14556,14556,0,12,5228000.0
5228,5228999,20.943000412210132,38.290164753093215,0.08900028337296628,815.8845176696777,339.160845041275,782.4076728820801,19819,5262,14557,14557,0,12,5229000.0
5229,5229999,20.941387301200592,38.287572994022106,0.08900978831617934,816.1641190052032,339.2247815132141,782.5047607421875,19825,5265,14560,14560,0,12,5230000.0
5230,5230999,20.94004201441169,38.285755474852046,0.08901106863021124,816.2855985164642,339.28797149658203,782.7265853881836,19825,5265,14560,14560,0,12,5231000.0
5231,5231999,20.938400808050705,38.28301406223904,0.08902349138707,816.5437717437744,339.3516294956207,782.8250350952148,19838,5268,14570,14570,0,12,5232000.0
5232,5232999,20.936989644427104,38.281013412201325,0.08902881777625504,816.716374874115,339.41480255126953,782.9397773742676,19840,5269,14571,14571,0,12,5233000.0
5233,5233999,20.93566128671355,38.27916453574853,0.08903363726196323,816.8529331684113,339.48776268959045,783.0835456848145,19840,5269,14571,14571,0,12,5234000.0
5234,5234999,20.9342685948956,38.276695136481166,0.08903947436808468,817.1699163913727,339.5526943206787,783.0075149536133,19848,5273,14575,14575,0,12,5235000.0
5235,5235999,20.932832904363508,38.274191863221965,0.08904844611098406,817.3536717891693,339.61606454849243,783.1460494995117,19850,5274,14576,14576,0,12,5236000.0
5236,5236999,20.931563480776454,38.272263266312024,0.08905363601995542,817.4827270507812,339.6789343357086,783.3105812072754,19850,5274,14576,14576,0,12,5237000.0
5237,5237999,20.93022037091682,38.2701985066684,0.08905926313418921,817.6084299087524,339.74247670173645,783.44140625,19850,5274,14576,14576,0,12,5238000.0
5238,5238999,20.928762765105912,38.26783547977188,0.08906800209868737,817.7966454029083,339.80573892593384,783.4988594055176,19852,5275,14577,14577,0,12,5239000.0
5239,5239999,20.92761515899662,38.26558769213476,0.08906939613754128,817.9242212772369,339.8698558807373,783.6355667114258,19852,5275,14577,14577,0,12,5240000.0
5240,5240999,20.926436616320103,38.26460573714874,0.08906681115666815,818.0495562553406,339.93272638320923,783.7540550231934,19852,5275,14577,14577,0,12,5241000.0
5241,5241999,20.925156138142015,38.26218819861168,0.08907550118964436,818.1900231838226,339.99656414985657,783.840747833252,19852,5275,14577,14577,0,12,5242000.0
5242,5242999,20.924114324802293,38.26016381350144,0.08907730937869074,818.4181938171387,340.061075925827,783.8449325561523,19856,5277,14579,14579,0,12,5243000.0
5243,5243999,20.922874118926757,38.25774539974797,0.08908148026067475,818.5998501777649,340.1250410079956,783.8918228149414,19858,5278,14580,14580,0,12,5244000.0
5244,5244999,20.921419566483145,38.25510743016812,0.08908910105725887,818.829740524292,340.1890814304352,784.3141975402832,19922,5280,14642,14642,0,12,5245000.0
5245,5245999,20.919936003465374,38.25260487219748,0.08909777370834882,818.9636468887329,340.25274109840393,784.8099365234375,19922,5280,14642,14642,0,12,5246000.0
5246,5246999,20.918281410077416,38.24982911472555,0.08911454976039135,819.1012744903564,340.3182990550995,785.9165382385254,19950,5280,14670,14670,0,12,5247000.0
5247,5247999,20.916215747091663,38.24690861690644,0.08913192471951137,819.2124836444855,340.3812918663025,786.3693809509277,19952,5280,14672,14672,0,12,5248000.0
5248,5248999,20.914359272721324,38.24418459068909,0.08914635193852627,819.3316159248352,340.44538164138794,786.6745147705078,19952,5280,14672,14672,0,12,5249000.0
5249,5249999,20.9126825294214,38.24151387141615,0.08916144512121038,819.5860297679901,340.50929975509644,786.7784309387207,19960,5283,14677,14677,0,12,5250000.0
5250,5250999,20.911037736224372,38.23904334301924,0.08917026795704186,819.8510212898254,340.57316064834595,786.92626953125,19966,5286,14680,14680,0,12,5251000.0
5251,5251999,20.90975441027966,38.23776703916884,0.08917373381738936,820.0342636108398,340.63694882392883,787.1290473937988,19968,5287,14681,14681,0,12,5252000.0
5252,5252999,20.908216578629517,38.23587335786951,0.08918038350963742,820.2446241378784,340.700697183609,787.2029609680176,19972,5289,14683,14683,0,12,5253000.0
5253,5253999,20.90689098710032,38.23409417286093,0.08918555116796056,820.4577515125275,340.76470923423767,787.3233680725098,19976,5291,14685,14685,0,12,5254000.0
5254,5254999,20.905536522898846,38.23207096722746,0.08918988076549716,820.8241229057312,340.8313341140747,787.1892318725586,20004,5296,14708,14708,0,12,5255000.0
5255,5255999,20.904250616077984,38.22993117494438,0.08919639937743362,820.9919335842133,340.89547395706177,787.4270706176758,20006,5297,14709,14709,0,12,5256000.0
5256,5256999,20.9031015189509,38.22783209988086,0.08920054949707912,821.1287069320679,340.95905804634094,787.6417541503906,20006,5297,14709,14709,0,12,5257000.0
5257,5257999,20.901840110975236,38.22582923371316,0.08920484727686429,821.2624459266663,341.0227870941162,787.7898178100586,20006,5297,14709,14709,0,12,5258000.0
5258,5258999,20.90077510435618,38.22412573141262,0.089205382459148,821.3945016860962,341.08641839027405,787.9196968078613,20006,5297,14709,14709,0,12,5259000.0
5259,5259999,20.899575930351777,38.22203343235005,0.08920831554901232,821.6200156211853,341.1510534286499,787.950267791748,20051,5299,14752,14752,0,12,5260000.0
5260,5260999,20.898892482723223,38.22278552329301,0.08919453089162932,821.7438383102417,341.2152762413025,788.2293472290039,20051,5299,14752,14752,0,12,5261000.0
5261,5261999,20.898204916362538,38.22219250685119,0.08919010674581329,821.931746006012,341.27954745292664,788.3507232666016,20053,5300,14753,14753,0,12,5262000.0
5262,5262999,20.897566566110328,38.2224578401389,0.08918061698822044,822.0657351016998,341.343469619751,788.5591583251953,20053,5300,14753,14753,0,12,5263000.0
5263,5263999,20.897230592770278,38.221659529192955,0.0891753990547608,822.2476918697357,341.40780448913574,788.6022148132324,20055,5301,14754,14754,0,12,5264000.0
5264,5264999,20.896802890483592,38.22157332618521,0.08916709375721377,822.3977372646332,341.4722592830658,788.747501373291,20055,5301,14754,14754,0,12,5265000.0
5265,5265999,20.89600023857676,38.21981809584055,0.089164436555351,822.51052069664,341.53637957572937,788.8911819458008,20055,5301,14754,14754,0,12,5266000.0
5266,5266999,20.894928460128003,38.21781902357201,0.08916669721864956,822.7882113456726,341.60138511657715,788.8284912109375,20061,5304,14757,14757,0,12,5267000.0
5267,5267999,20.893810466292944,38.21731083123489,0.08915984162309776,822.9263641834259,341.6735599040985,790.0396919250488,20091,5304,14787,14787,0,12,5268000.0
5268,5268999,20.89219583912436,38.214973281469916,0.08916514264404496,823.0804505348206,341.73650097846985,790.4406890869141,20095,5305,14790,14790,0,12,5269000.0
5269,5269999,20.89107491391549,38.21385275285717,0.08916483740875969,823.1972899436951,341.7992787361145,790.7283096313477,20095,5305,14790,14790,0,12,5270000.0
5270,5270999,20.889930549221127,38.212129756197896,0.08916810415764309,823.4593591690063,341.862761259079,790.7801551818848,20103,5308,14795,14795,0,12,5271000.0
5271,5271999,20.889046687355943,38.210738996213884,0.08916254915410382,823.6822865009308,341.92659878730774,791.0398712158203,20115,5310,14805,14805,0,12,5272000.0
5272,5272999,20.88790528670325,38.208494478916265,0.08916571329806788,823.8531167507172,341.9911894798279,791.2430038452148,20117,5311,14806,14806,0,12,5273000.0
5273,5273999,20.886848815626255,38.20715229707873,0.08916354414586913,824.1551852226257,342.05551171302795,791.2369651794434,20126,5315,14811,14811,0,12,5274000.0
5274,5274999,20.8857697778457,38.20529791511735,0.08916082015733517,824.3385467529297,342.11975383758545,791.4840774536133,20128,5316,14812,14812,0,12,5275000.0
5275,5275999,20.884678116863064,38.20317630344562,0.08916617410604566,824.609569311142,342.18432092666626,791.5434188842773,20134,5319,14815,14815,0,12,5276000.0
5276,5276999,20.88401030315587,38.20426731062391,0.08915415595339204,824.7737808227539,342.24838280677795,791.7897262573242,20136,5320,14816,14816,0,12,5277000.0
5277,5277999,20.883003255858945,38.20213503224441,0.08915127032237724,824.9057829380035,342.31307649612427,791.9943428039551,20136,5320,14816,14816,0,12,5278000.0
5278,5278999,20.882416000313547,38.20091056399059,0.08915334962662025,825.0294206142426,342.37681889533997,792.1574897766113,20136,5320,14816,14816,0,12,5279000.0
5279,5279999,20.8818352576912,38.19940933879747,0.08915403305336012,825.2160224914551,342.44153118133545,792.2288703918457,20139,5321,14818,14818,0,12,5280000.0
5280,5280999,20.881711889305087,38.200755040440114,0.08914344215945447,825.3966045379639,342.5060443878174,792.2526664733887,20141,5322,14819,14819,0,12,5281000.0
5281,5281999,20.88157484833148,38.200121806621304,0.08913815584564877,825.5758533477783,342.5706913471222,792.3346328735352,20143,5323,14820,14820,0,12,5282000.0
5282,5282999,20.88149571179481,38.19946650841949,0.08913451068659184,825.8059287071228,342.63503313064575,792.4251747131348,20147,5325,14822,14822,0,12,5283000.0
5283,5283999,20.881448087355803,38.20016271864167,0.08912365816211498,825.9993538856506,342.69923663139343,792.5174102783203,20149,5326,14823,14823,0,12,5284000.0
5284,5284999,20.88150967710321,38.199382146814735,0.08912046730697898,826.2107119560242,342.7635295391083,792.4885597229004,20154,5328,14826,14826,0,12,5285000.0
5285,5285999,20.881496727633735,38.198441650266474,0.08911085628752446,826.3344633579254,342.8277325630188,792.6546936035156,20154,5328,14826,14826,0,12,5286000.0
5286,5286999,20.88136910832842,38.19707913671818,0.08910348662261414,826.4620926380157,342.8921203613281,792.7891807556152,20154,5328,14826,14826,0,12,5287000.0
5287,5287999,20.881086203395096,38.19554438898929,0.08909610042407934,826.6141681671143,342.9562044143677,792.9745140075684,20154,5328,14826,14826,0,12,5288000.0
5288,5288999,20.879885960935013,38.19419329276753,0.08909025158222295,826.7396116256714,343.0204863548279,793.9933776855469,20177,5328,14849,14849,0,12,5289000.0
5289,5289999,20.878291685764093,38.19197615947588,0.08910258350348332,826.8464999198914,343.0823974609375,794.3689041137695,20178,5328,14850,14850,0,12,5290000.0
5290,5290999,20.87669116623944,38.18947137604785,0.08911923038720826,827.1081125736237,343.1463670730591,794.5353240966797,20186,5331,14855,14855,0,12,5291000.0
5291,5291999,20.875371106963414,38.187448317031816,0.08912447239262888,827.3188824653625,343.2099220752716,794.6050643920898,20191,5333,14858,14858,0,12,5292000.0
5292,5292999,20.87406945948898,38.185282409392194,0.08913079762435272,827.4938058853149,343.27308440208435,794.7490730285645,20193,5334,14859,14859,0,12,5293000.0
5293,5293999,20.872693221168465,38.18347365306252,0.0891294523585654,827.6639428138733,343.33655762672424,795.0089530944824,20197,5335,14862,14862,0,12,5294000.0
5294,5294999,20.87167186269843,38.181820361928416,0.08913009429612162,827.8940320014954,343.40112137794495,795.147632598877,20201,5337,14864,14864,0,12,5295000.0
5295,5295999,20.870666533523547,38.18000020320938,0.08912934246653481,828.0231535434723,343.46405386924744,795.3385314941406,20201,5337,14864,14864,0,12,5296000.0
5296,5296999,20.869663283488002,38.17801811137266,0.08912886238982787,828.2073459625244,343.5273082256317,795.4460945129395,20203,5338,14865,14865,0,12,5297000.0
5297,5297999,20.86893368924312,38.176882953956614,0.08912437167574738,828.3800358772278,343.5906798839569,795.550422668457,20205,5339,14866,14866,0,12,5298000.0
5298,5298999,20.868451237961544,38.175581090164,0.08912126208995119,828.5509102344513,343.6547918319702,795.597728729248,20207,5340,14867,14867,0,12,5299000.0
5299,5299999,20.867688785979045,38.17390502547573,0.08912441989801478,828.7798233032227,343.718896150589,795.5748062133789,20213,5342,14871,14871,0,12,5300000.0
5300,5300999,20.86732806872476,38.17342674922753,0.08912109882968466,828.9039871692657,343.78201508522034,795.7492790222168,20213,5342,14871,14871,0,12,5301000.0
5301,5301999,20.86691264741455,38.172272755737886,0.08911968396508951,829.0468349456787,343.84559392929077,795.8990898132324,20213,5342,14871,14871,0,12,5302000.0
5302,5302999,20.866263134548856,38.170752409309756,0.08912763660424106,829.3203601837158,343.90967178344727,795.849781036377,20220,5345,14875,14875,0,12,5303000.0
5303,5303999,20.86572197173834,38.169198298482186,0.08913533047391586,829.5950198173523,343.9736068248749,795.7308807373047,20226,5348,14878,14878,0,12,5304000.0
5304,5304999,20.864761278779106,38.16687259308045,0.08915143144393234,829.7844362258911,344.0376763343811,795.9548149108887,20228,5349,14879,14879,0,12,5305000.0
5305,5305999,20.863389360585913,38.1664672058174,0.08915271810539482,829.9088816642761,344.1025426387787,797.1981544494629,20257,5349,14908,14908,0,12,5306000.0
5306,5306999,20.861886880022755,38.165787046713504,0.08916226569564423,830.031040430069,344.1648733615875,797.6698303222656,20258,5349,14909,14909,0,12,5307000.0
5307,5307999,20.860226953251768,38.163186321605224,0.08918443366093531,830.3261127471924,344.22859168052673,797.807788848877,20267,5353,14914,14914,0,12,5308000.0
5308,5308999,20.858728584646443,38.16166142421779,0.08920211318753835,830.4403705596924,344.29116892814636,798.163459777832,20268,5353,14915,14915,0,12,5309000.0
5309,5309999,20.85710939474275,38.159072828898815,0.08922340679449858,830.5581018924713,344.35411310195923,798.4017295837402,20268,5353,14915,14915,0,12,5310000.0
5310,5310999,20.85547863705608,38.156905110720096,0.08923803195369007,830.8389708995819,344.4178297519684,798.4133338928223,20274,5356,14918,14918,0,12,5311000.0
5311,5311999,20.854022117938634,38.155273751130125,0.08924227494343284,830.9548735618591,344.48031759262085,798.6648445129395,20274,5356,14918,14918,0,12,5312000.0
5312,5312999,20.852595272791106,38.153243437917,0.0892463192613262,831.1195187568665,344.5430438518524,798.7999038696289,20276,5357,14919,14919,0,12,5313000.0
5313,5313999,20.85142484403075,38.15136040334954,0.08924668804632585,831.3087158203125,344.60633420944214,798.9040031433105,20278,5358,14920,14920,0,12,5314000.0
5314,5314999,20.850381228543817,38.14991331631279,0.0892422975051067,831.4901607036591,344.66947889328003,799.0010108947754,20280,5359,14921,14921,0,12,5315000.0
5315,5315999,20.849516619119303,38.14950392093852,0.08923415730869133,831.662623167038,344.7338709831238,799.1073112487793,20282,5360,14922,14922,0,12,5316000.0
5316,5316999,20.848706236818177,38.14894971394096,0.08922696247803397,831.8323545455933,344.7970914840698,799.1598129272461,20284,5361,14923,14923,0,12,5317000.0
5317,5317999,20.848079093202337,38.14796022228605,0.08921225498100693,832.0547709465027,344.8607666492462,799.2334327697754,20288,5363,14925,14925,0,12,5318000.0
5318,5318999,20.847153982429244,38.14634730828087,0.08920653057014638,832.2340092658997,344.9242250919342,799.2631721496582,20291,5364,14927,14927,0,12,5319000.0
5319,5319999,20.84637091622981,38.14476312728648,0.08919852371059867,832.3713088035583,344.9874999523163,799.4381141662598,20291,5364,14927,14927,0,12,5320000.0
5320,5320999,20.846007658268682,38.14400115700272,0.08918509742318204,832.5587348937988,345.0518305301666,799.4348907470703,20293,5365,14928,14928,0,12,5321000.0
5321,5321999,20.845488999623836,38.142909539196154,0.08917843835780415,832.7376070022583,345.11545157432556,799.4812507629395,20295,5366,14929,14929,0,12,5322000.0
5322,5322999,20.84468690208616,38.141100008259784,0.08917127332979657,832.9156155586243,345.17922139167786,799.5800628662109,20297,5367,14930,14930,0,12,5323000.0
5323,5323999,20.843988557712766,38.13955386393772,0.08916617089365952,833.103964805603,345.24256563186646,799.6125373840332,20299,5368,14931,14931,0,12,5324000.0
5324,5324999,20.843008767511115,38.13789577433675,0.08916536814279585,833.2946081161499,345.3075361251831,800.0528755187988,20314,5369,14945,14945,0,12,5325000.0
5325,5325999,20.841622805554557,38.13706528546683,0.08916429133759096,833.4036600589752,345.37084794044495,800.959789276123,20329,5369,14960,14960,0,12,5326000.0
5326,5326999,20.840218278974568,38.13532008629035,0.08916906331346819,833.5104415416718,345.43310952186584,801.3542976379395,20330,5369,14961,14961,0,12,5327000.0
5327,5327999,20.838787313757052,38.13332193999843,0.08917750382678113,833.7294678688049,345.49663186073303,801.5249252319336,20334,5371,14963,14963,0,12,5328000.0
5328,5328999,20.837501529319923,38.13150819340342,0.08918275039485113,834.0795865058899,345.5605776309967,801.5741958618164,20345,5376,14969,14969,0,12,5329000.0
5329,5329999,20.836143043154916,38.129664164627975,0.08918705251737669,834.1977736949921,345.62377405166626,801.8701171875,20345,5376,14969,14969,0,12,5330000.0
5330,5330999,20.83478908283064,38.12725040440245,0.08919453230878416,834.4713065624237,345.68929958343506,801.9551162719727,20351,5379,14972,14972,0,12,5331000.0
5331,5331999,20.833411302333413,38.12544615130913,0.08919776681107405,834.6524138450623,345.7527449131012,802.0730133056641,20354,5380,14974,14974,0,12,5332000.0
5332,5332999,20.832061690432084,38.123175231799834,0.08920146075981705,834.8255300521851,345.8161084651947,802.2133293151855,20356,5381,14975,14975,0,12,5333000.0
5333,5333999,20.83089840524137,38.12092871342061,0.08920513053573653,835.0044832229614,345.88075709342957,802.4037055969238,20359,5382,14977,14977,0,12,5334000.0
5334,5334999,20.829862902701553,38.119178249096045,0.08920677207717986,835.222086429596,345.9443323612213,802.4923515319824,20363,5384,14979,14979,0,12,5335000.0
5335,5335999,20.828653307490917,38.11725270266588,0.08920880874048942,835.3559036254883,346.00720405578613,802.6736755371094,20363,5384,14979,14979,0,12,5336000.0
5336,5336999,20.827719346962528,38.115337856656815,0.0892120111319823,835.4872312545776,346.0704336166382,802.7657127380371,20363,5384,14979,14979,0,12,5337000.0
5337,5337999,20.826502496469395,38.11311254922859,0.08921771594558581,835.614669084549,346.1333556175232,802.8897705078125,20363,5384,14979,14979,0,12,5338000.0
5338,5338999,20.825653880217974,38.11186781465453,0.08921755615819649,835.7473530769348,346.1966018676758,803.0155715942383,20363,5384,14979,14979,0,12,5339000.0
5339,5339999,20.824731660141758,38.11014051859387,0.08921672294142835,835.8807678222656,346.25973296165466,803.0868377685547,20363,5384,14979,14979,0,12,5340000.0
5340,5340999,20.82402190234505,38.10875894918674,0.08921907976142118,836.0277144908905,346.32293605804443,803.2049102783203,20363,5384,14979,14979,0,12,5341000.0
5341,5341999,20.82321633665371,38.10720518617844,0.08922033313266386,836.1623556613922,346.38640785217285,803.2923736572266,20363,5384,14979,14979,0,12,5342000.0
5342,5342999,20.822972004870394,38.10784133212204,0.08920697856019433,836.436336517334,346.4506437778473,803.1182060241699,20369,5387,14982,14982,0,12,5343000.0
5343,5343999,20.822241660340275,38.10611671351976,0.08920652276253838,836.5949556827545,346.51401114463806,803.265064239502,20369,5387,14982,14982,0,12,5344000.0
5344,5344999,20.820953957217487,38.10364347452565,0.08921607393880182,836.7544574737549,346.5774722099304,803.3415756225586,20371,5388,14983,14983,0,12,5345000.0
5345,5345999,20.819873786760883,38.101404388262594,0.08922295528312363,836.9408347606659,346.64276218414307,804.0887870788574,20398,5389,15009,15009,0,12,5346000.0
5346,5346999,20.818095615807316,38.099272890907855,0.08923592339697473,837.0495185852051,346.7058939933777,804.8111228942871,20403,5389,15014,15014,0,12,5347000.0
5347,5347999,20.816123537997065,38.09621983151673,0.08925032119963994,837.1593327522278,346.76919054985046,805.2244300842285,20404,5389,15015,15015,0,12,5348000.0
5348,5348999,20.814303681307646,38.09347375773206,0.08926390900587156,837.417573928833,346.83281564712524,805.3666725158691,20412,5392,15020,15020,0,12,5349000.0
5349,5349999,20.812847600527903,38.09156576867292,0.08926715392063844,837.7386791706085,346.8970732688904,805.4935073852539,20420,5396,15024,15024,0,12,5350000.0
5350,5350999,20.811387686765286,38.08959507903769,0.08927096689927994,837.8972404003143,346.9601764678955,805.7513961791992,20422,5397,15025,15025,0,12,5351000.0
5351,5351999,20.81011077561337,38.08734246283713,0.08927931740783324,838.0726270675659,347.0238733291626,805.9586372375488,20424,5398,15026,15026,0,12,5352000.0
5352,5352999,20.808798008508575,38.08556672234447,0.0892836371363952,838.2358396053314,347.08812618255615,806.1716003417969,20426,5399,15027,15027,0,12,5353000.0
5353,5353999,20.809254327695005,38.088804129670855,0.08924368964703566,838.5515053272247,347.15281081199646,806.0572128295898,20434,5403,15031,15031,0,12,5354000.0
5354,5354999,20.8094569835023,38.08974987634289,0.08922742156425856,838.8260614871979,347.2175097465515,806.2297325134277,20440,5406,15034,15034,0,12,5355000.0
5355,5355999,20.809875338983314,38.0910249096664,0.08921098756373835,839.0020596981049,347.2820088863373,806.4732246398926,20449,5407,15042,15042,0,12,5356000.0
5356,5356999,20.810898935725415,38.0932540007223,0.08918475129106296,839.18567943573,347.34598112106323,806.5937919616699,20451,5408,15043,15043,0,12,5357000.0
5357,5357999,20.81211759796069,38.09580768317535,0.08915694221584369,839.408294916153,347.41037917137146,806.686164855957,20455,5410,15045,15045,0,12,5358000.0
5358,5358999,20.813897105647527,38.09895088704475,0.08913917288002604,839.5846235752106,347.47471141815186,806.7984657287598,20457,5411,15046,15046,0,12,5359000.0
5359,5359999,20.81574137228031,38.10251903621621,0.08910893246610974,839.7085299491882,347.5388536453247,806.999095916748,20457,5411,15046,15046,0,12,5360000.0
5360,5360999,20.817487103448908,38.10509972493966,0.08909447679620597,839.8816921710968,347.6027081012726,807.0609245300293,20460,5412,15048,15048,0,12,5361000.0
5361,5361999,20.819125310732552,38.10774994835241,0.08907272362621466,840.1157417297363,347.6670353412628,807.0733757019043,20464,5414,15050,15050,0,12,5362000.0
5362,5362999,20.821133670712793,38.110459612152425,0.08905389958659071,840.4103391170502,347.7321808338165,806.9383506774902,20471,5417,15054,15054,0,12,5363000.0
5363,5363999,20.822257007420685,38.11150542251231,0.08905419479998977,840.5502192974091,347.7983121871948,807.1480331420898,20471,5417,15054,15054,0,12,5364000.0
5364,5364999,20.822754159320837,38.11098134364393,0.08905583987369092,840.6615386009216,347.8622827529907,807.3546104431152,20471,5417,15054,15054,0,12,5365000.0
5365,5365999,20.822250145211065,38.109442443189835,0.08905083180985052,840.7800681591034,347.92720007896423,808.3265151977539,20495,5417,15078,15078,0,12,5366000.0
5366,5366999,20.82056761240303,38.10729822236853,0.0890604791801971,840.9460711479187,347.9915564060211,808.8832893371582,20501,5418,15083,15083,0,12,5367000.0
5367,5367999,20.8189626465677,38.10492785310936,0.08906941328459395,841.064569234848,348.05404353141785,809.2590522766113,20501,5418,15083,15083,0,12,5368000.0
5368,5368999,20.8174989131315,38.10286198388855,0.08908020939397199,841.1985478401184,348.1173231601715,809.5885772705078,20502,5418,15084,15084,0,12,5369000.0
5369,5369999,20.81611962816386,38.101146179463385,0.08908101347799624,841.318118095398,348.17999720573425,809.8271865844727,20503,5418,15085,15085,0,12,5370000.0
5370,5370999,20.814782968025305,38.09893127708046,0.08908427299124089,841.5380821228027,348.24327206611633,809.9439659118652,20507,5420,15087,15087,0,12,5371000.0
5371,5371999,20.81338229722507,38.09667433918039,0.08909106894771746,841.7677023410797,348.3067901134491,810.0352516174316,20511,5422,15089,15089,0,12,5372000.0
5372,5372999,20.81196045106626,38.09443956745091,0.0890973906861583,841.9762718677521,348.3711450099945,810.103458404541,20517,5424,15093,15093,0,12,5373000.0
5373,5373999,20.81047725676617,38.091951313076954,0.08910591444754001,842.2528038024902,348.43503189086914,810.1829071044922,20523,5427,15096,15096,0,12,5374000.0
5374,5374999,20.809295521873093,38.09048670817871,0.08910648442320535,842.5264279842377,348.50047874450684,810.2798652648926,20529,5430,15099,15099,0,12,5375000.0
5375,5375999,20.807925749110286,38.088185202186324,0.08911119989954208,842.661943435669,348.5641632080078,810.555103302002,20529,5430,15099,15099,0,12,5376000.0
5376,5376999,20.806772682313376,38.086244881823035,0.08911305626237254,842.777684211731,348.6272642612457,810.7435531616211,20529,5430,15099,15099,0,12,5377000.0
5377,5377999,20.805840695791524,38.08475923813741,0.08911066200440731,842.9029388427734,348.6905708312988,810.9426002502441,20529,5430,15099,15099,0,12,5378000.0
5378,5378999,20.80476078992476,38.08270405517451,0.08911155551351213,843.0720314979553,348.7547833919525,811.0759735107422,20531,5431,15100,15100,0,12,5379000.0
5379,5379999,20.803844693637515,38.08073079380225,0.08910798339865478,843.2634584903717,348.81919384002686,811.1889953613281,20533,5432,15101,15101,0,12,5380000.0
5380,5380999,20.803141556709107,38.07948587622023,0.08910243496753123,843.4852030277252,348.8835391998291,811.2204818725586,20539,5434,15105,15105,0,12,5381000.0
5381,5381999,20.802644486620483,38.078362770290674,0.08909366703480437,843.6294507980347,348.94713401794434,811.4629173278809,20539,5434,15105,15105,0,12,5382000.0
5382,5382999,20.80230434043845,38.07725507637823,0.08908404034232087,843.8113698959351,349.0119528770447,811.528450012207,20541,5435,15106,15106,0,12,5383000.0
5383,5383999,20.80204317713464,38.0759865549113,0.08907545998421385,844.000926733017,349.0761182308197,811.6343231201172,20543,5436,15107,15107,0,12,5384000.0
5384,5384999,20.80171409946324,38.0748912078535,0.08907188211951889,844.1176645755768,349.139790058136,811.7741737365723,20543,5436,15107,15107,0,12,5385000.0
5385,5385999,20.800931376117262,38.07310582288771,0.08907428097505621,844.2634217739105,349.2052798271179,812.6193618774414,20570,5436,15134,15134,0,12,5386000.0
5386,5386999,20.79946445832687,38.07155238610971,0.08907906433305379,844.3759877681732,349.2685499191284,813.2848510742188,20574,5436,15138,15138,0,12,5387000.0
5387,5387999,20.797889079031886,38.06981939803772,0.08908073719041965,844.5364685058594,349.3316071033478,813.5856666564941,20576,5437,15139,15139,0,12,5388000.0
5388,5388999,20.79691340922541,38.072964546830036,0.08905662975631101,844.693740606308,349.39552664756775,813.8383674621582,20579,5438,15141,15141,0,12,5389000.0
5389,5389999,20.795508053539173,38.07071560274539,0.08905763395801836,845.0521168708801,349.4600076675415,813.8925399780273,20590,5443,15147,15147,0,12,5390000.0
5390,5390999,20.794474564128652,38.06871321083736,0.0890509606012948,845.2114067077637,349.5241632461548,814.1989936828613,20592,5444,15148,15148,0,12,5391000.0
5391,5391999,20.7933169877114,38.06649405524352,0.08905139384123273,845.4380729198456,349.5886857509613,814.3818283081055,20596,5446,15150,15150,0,12,5392000.0
5392,5392999,20.79237026226696,38.06483023460329,0.08904514429068,845.6520023345947,349.6527919769287,814.5546264648438,20600,5448,15152,15152,0,12,5393000.0
5393,5393999,20.791378154163755,38.06290048337065,0.08904042985220528,845.9224650859833,349.7171492576599,814.5907287597656,20606,5451,15155,15155,0,12,5394000.0
5394,5394999,20.790426143901072,38.060921878831046,0.08903547237331222,846.1534407138824,349.7818765640259,814.7616233825684,20610,5453,15157,15157,0,12,5395000.0
5395,5395999,20.79010685988958,38.05987252233008,0.08901951868009361,846.3244452476501,349.8459265232086,814.9667167663574,20613,5454,15159,15159,0,12,5396000.0
5396,5396999,20.789729721229953,38.059230837766734,0.08900388885902999,846.4476308822632,349.9099588394165,815.1861915588379,20613,5454,15159,15159,0,12,5397000.0
5397,5397999,20.789547648021482,38.0583148045562,0.08898989355817466,846.6207022666931,349.9744498729706,815.2756195068359,20615,5455,15160,15160,0,12,5398000.0
5398,5398999,20.78957377599003,38.05743174458423,0.08897485976136077,846.805285692215,350.0389621257782,815.3728942871094,20617,5456,15161,15161,0,12,5399000.0
5399,5399999,20.78998744744098,38.05813801590037,0.08895530431974674,846.9286437034607,350.10302543640137,815.5427551269531,20617,5456,15161,15161,0,12,5400000.0
5400,5400999,20.790974564291172,38.06244316907396,0.08892091777490962,847.1321785449982,350.1676297187805,815.6510276794434,20619,5457,15162,15162,0,12,5401000.0
5401,5401999,20.793363071334966,38.07407712224401,0.08886237477139403,847.2725210189819,350.2322425842285,815.7972297668457,20619,5457,15162,15162,0,12,5402000.0
5402,5402999,20.795324939224006,38.07801783369292,0.08885361592249952,847.3989307880402,350.2960443496704,815.9673614501953,20620,5457,15163,15163,0,12,5403000.0
5403,5403999,20.79763103355963,38.0829137541432,0.08884221645338342,847.6207721233368,350.360435962677,815.9761428833008,20624,5459,15165,15165,0,12,5404000.0
5404,5404999,20.799462953339916,38.085483617347286,0.08883801186622897,847.7460408210754,350.4245719909668,816.1010932922363,20624,5459,15165,15165,0,12,5405000.0
5405,5405999,20.800886126668512,38.087288329026855,0.08886164633325855,847.884085893631,350.48883748054504,816.2603988647461,20624,5459,15165,15165,0,12,5406000.0
5406,5406999,20.801050756374483,38.088215704826425,0.0888495053761944,848.065263748169,350.556565284729,817.3803825378418,20667,5460,15207,15207,0,12,5407000.0
5407,5407999,20.799401772467792,38.09220596212641,0.08882710863713106,848.1847541332245,350.62043714523315,818.0691261291504,20671,5460,15211,15211,0,12,5408000.0
5408,5408999,20.79794870389269,38.0908557377045,0.08882469699003748,848.3441321849823,350.6837205886841,818.4287757873535,20673,5461,15212,15212,0,12,5409000.0
5409,5409999,20.796333162532868,38.0884665720022,0.08883264866097529,848.4569952487946,350.74680638313293,818.728401184082,20674,5461,15213,15213,0,12,5410000.0
5410,5410999,20.7949126775411,38.08645819807552,0.08883259342454819,848.7369322776794,350.8112099170685,818.8462791442871,20680,5464,15216,15216,0,12,5411000.0
5411,5411999,20.793480322959624,38.08425193944684,0.08883565790720926,848.8506898880005,350.8745741844177,819.0976486206055,20680,5464,15216,15216,0,12,5412000.0
5412,5412999,20.791914596159955,38.081633160787554,0.0888398040639079,849.0749416351318,350.9399507045746,819.1653633117676,20684,5466,15218,15218,0,12,5413000.0
5413,5413999,20.790619741583942,38.08008190983249,0.08883797004336491,849.2929751873016,351.0044033527374,819.3538970947266,20688,5468,15220,15220,0,12,5414000.0
5414,5414999,20.78944240267436,38.078407318545516,0.08883458242116726,849.6651284694672,351.06933879852295,819.1918640136719,20700,5473,15227,15227,0,12,5415000.0
5415,5415999,20.788139570438474,38.076178713473674,0.0888342810138717,849.893171787262,351.1342685222626,819.4401321411133,20704,5475,15229,15229,0,12,5416000.0
5416,5416999,20.787099676454876,38.07454581849087,0.08882895806562552,850.1260361671448,351.1990509033203,819.5502700805664,20708,5477,15231,15231,0,12,5417000.0
5417,5417999,20.78606109070432,38.07244808541032,0.08882638294028833,850.2462737560272,351.2635176181793,819.8191299438477,20708,5477,15231,15231,0,12,5418000.0
5418,5418999,20.78513860326758,38.07067380370252,0.08882183308957858,850.3867130279541,351.3277397155762,820.0051193237305,20708,5477,15231,15231,0,12,5419000.0
5419,5419999,20.784492336281257,38.0698554990506,0.08881126705896703,850.5036642551422,351.39254450798035,820.147045135498,20708,5477,15231,15231,0,12,5420000.0
5420,5420999,20.783967017274662,38.068481612191626,0.08880281831436021,850.6270499229431,351.4567291736603,820.3083152770996,20708,5477,15231,15231,0,12,5421000.0
5421,5421999,20.783833743171026,38.068536649945415,0.08878624570740279,850.8537178039551,351.52123403549194,820.4100112915039,20714,5479,15235,15235,0,12,5422000.0
5422,5422999,20.78367659998901,38.06803200839619,0.08877063010425046,851.0407745838165,351.5857357978821,820.4873390197754,20716,5480,15236,15236,0,12,5423000.0
5423,5423999,20.783698640848385,38.0678396444545,0.0887557175103707,851.2510516643524,351.6509442329407,820.495979309082,20720,5482,15238,15238,0,12,5424000.0
5424,5424999,20.783739332150365,38.06718507811545,0.08874294965184948,851.4380693435669,351.7158057689667,820.6307334899902,20722,5483,15239,15239,0,12,5425000.0
5425,5425999,20.78423980371151,38.06731565969324,0.08872461147666222,851.574535369873,351.78021693229675,820.7536544799805,20722,5483,15239,15239,0,12,5426000.0
5426,5426999,20.783771058319896,38.06592945929324,0.08871961194263922,851.7428014278412,351.84470653533936,820.829231262207,20724,5484,15240,15240,0,12,5427000.0
5427,5427999,20.78281063188256,38.06399881493127,0.08872484702170946,851.877895116806,351.91092324256897,821.8702087402344,20751,5484,15267,15267,0,12,5428000.0
5428,5428999,20.781255537012566,38.06243993626349,0.08873450816546025,851.9844055175781,351.9733066558838,822.494197845459,20755,5484,15271,15271,0,12,5429000.0
5429,5429999,20.779585752736676,38.0603810493553,0.08874917225280177,852.1463203430176,352.0358920097351,822.7972755432129,20759,5485,15274,15274,0,12,5430000.0
5430,5430999,20.77798676391914,38.05824971413717,0.0887623005817183,852.312849521637,352.09877848625183,823.0346832275391,20762,5486,15276,15276,0,12,5431000.0
5431,5431999,20.776511550582168,38.055896749488326,0.08877015264813326,852.5205397605896,352.16180753707886,823.1922836303711,20766,5488,15278,15278,0,12,5432000.0
5432,5432999,20.775007674924133,38.05326735158904,0.08878115671771536,852.7839004993439,352.2257385253906,823.2216262817383,20772,5491,15281,15281,0,12,5433000.0
5433,5433999,20.773669391553366,38.05177728407986,0.08878405709884885,853.0103297233582,352.28951835632324,823.3492164611816,20778,5493,15285,15285,0,12,5434000.0
5434,5434999,20.77233560309916,38.049496195025995,0.08879105310508117,853.1466243267059,352.3532750606537,823.5903587341309,20778,5493,15285,15285,0,12,5435000.0
5435,5435999,20.771264474052533,38.05146633018487,0.08877882421968519,853.2734797000885,352.41627168655396,823.8163566589355,20778,5493,15285,15285,0,12,5436000.0
5436,5436999,20.76994206186806,38.04927615467326,0.08878646935487011,853.5460650920868,352.4800901412964,823.7622566223145,20790,5496,15294,15294,0,12,5437000.0
5437,5437999,20.768854900780664,38.047273973280646,0.08879193645039829,853.7726674079895,352.5442671775818,823.8678169250488,20794,5498,15296,15296,0,12,5438000.0
5438,5438999,20.76760568353444,38.04484304268432,0.08880199114937681,853.9355697631836,352.6074867248535,823.9688491821289,20796,5499,15297,15297,0,12,5439000.0
5439,5439999,20.766519399884057,38.04277915618973,0.08880616647866513,854.1152477264404,352.67267060279846,824.0935516357422,20798,5500,15298,15298,0,12,5440000.0
5440,5440999,20.765372263213475,38.04062548274953,0.08881333409628023,854.3020946979523,352.73671865463257,824.2497406005859,20800,5501,15299,15299,0,12,5441000.0
5441,5441999,20.764190433450732,38.03826964067509,0.0888234841325698,854.4921400547028,352.80856466293335,824.3705062866211,20802,5502,15300,15300,0,12,5442000.0
5442,5442999,20.76290924246297,38.03578970452063,0.08883587061165432,854.7191379070282,352.8727385997772,824.3757476806641,20808,5504,15304,15304,0,12,5443000.0
5443,5443999,20.761536735663647,38.03329120295036,0.08885181757908767,854.9512867927551,352.93738532066345,824.3810348510742,20812,5506,15306,15306,0,12,5444000.0
5444,5444999,20.760303395892272,38.031484860095006,0.08886202328868509,855.1713781356812,353.00308871269226,825.3388175964355,20846,5508,15338,15338,0,12,5445000.0
5445,5445999,20.758609599625174,38.02897326581531,0.08887686790247773,855.2802169322968,353.06627655029297,826.0116729736328,20847,5508,15339,15339,0,12,5446000.0
5446,5446999,20.757151908089398,38.02717007409373,0.08888896654302858,855.4950249195099,353.1290194988251,826.2924957275391,20852,5510,15342,15342,0,12,5447000.0
5447,5447999,20.756122259885153,38.03126689684439,0.08886886932848181,855.7090656757355,353.19262528419495,826.4622192382812,20857,5512,15345,15345,0,12,5448000.0
5448,5448999,20.754974077500357,38.030731906678895,0.08887184047167673,855.8208866119385,353.2554888725281,826.7934341430664,20858,5512,15346,15346,0,12,5449000.0
5449,5449999,20.75345176645374,38.02805549376359,0.08888385542059629,856.0441801548004,353.3186287879944,826.8736381530762,20862,5514,15348,15348,0,12,5450000.0
5450,5450999,20.751942645348613,38.025774252958186,0.08889170703175231,856.2670958042145,353.38205122947693,827.0579643249512,20866,5516,15350,15350,0,12,5451000.0
5451,5451999,20.750613546050246,38.024098101240156,0.08889206928185378,856.4390244483948,353.45071268081665,827.2111167907715,20869,5517,15352,15352,0,12,5452000.0
5452,5452999,20.74924153155933,38.021802680599855,0.08889527341859205,856.6222302913666,353.51383876800537,827.349292755127,20871,5518,15353,15353,0,12,5453000.0
5453,5453999,20.747958236836677,38.019871509209835,0.08889496460932955,856.8456172943115,353.5770626068115,827.4072265625,20875,5520,15355,15355,0,12,5454000.0
5454,5454999,20.747003646868524,38.01845438385326,0.08888819150270655,857.0424921512604,353.6443555355072,827.541919708252,20877,5521,15356,15356,0,12,5455000.0
5455,5455999,20.74620420914722,38.01685806753777,0.08888587252277091,857.1571776866913,353.7076518535614,827.7292823791504,20877,5521,15356,15356,0,12,5456000.0
5456,5456999,20.745504116714642,38.01531665543919,0.08888060070847803,857.3825705051422,353.7717671394348,827.6419830322266,20883,5523,15360,15360,0,12,5457000.0
5457,5457999,20.744778644879034,38.013879553571854,0.08887763563564743,857.5245158672333,353.8354709148407,827.8303756713867,20883,5523,15360,15360,0,12,5458000.0
5458,5458999,20.744572127615886,38.01474786309081,0.08886341471977754,857.6498379707336,353.898490190506,828.0104026794434,20883,5523,15360,15360,0,12,5459000.0
5459,5459999,20.744171081230345,38.01516791038318,0.08885698891826721,857.7855327129364,353.96205592155457,828.121265411377,20883,5523,15360,15360,0,12,5460000.0
5460,5460999,20.743970256572595,38.01490130789759,0.08884626913868021,857.9582827091217,354.0254137516022,828.1948432922363,20885,5524,15361,15361,0,12,5461000.0
5461,5461999,20.743899924431396,38.01425205056933,0.08884039408923572,858.1786940097809,354.0900275707245,828.2417640686035,20895,5526,15369,15369,0,12,5462000.0
5462,5462999,20.74354069299724,38.01312892864424,0.08882959035022331,858.3360531330109,354.1533741950989,828.3293418884277,20895,5526,15369,15369,0,12,5463000.0
5463,5463999,20.743051013193767,38.01189862077383,0.08882336975409544,858.525158405304,354.22185730934143,828.4349403381348,20897,5527,15370,15370,0,12,5464000.0
5464,5464999,20.742194428183257,38.013140399534414,0.08881596525936375,858.6498799324036,354.3021330833435,829.0997581481934,20909,5527,15382,15382,0,12,5465000.0
5465,5465999,20.740464763298547,38.01090279359123,0.08882348028163822,858.8260118961334,354.3612017631531,829.315975189209,20912,5528,15384,15384,0,12,5466000.0
5466,5466999,20.73893782950074,38.00881932172229,0.08882625528239341,858.9509210586548,354.42053270339966,829.5447959899902,20913,5528,15385,15385,0,12,5467000.0
5467,5467999,20.737659946147158,38.00750307098626,0.08882621828118575,859.154456615448,354.4850699901581,829.7630996704102,20932,5529,15403,15403,0,12,5468000.0
5468,5468999,20.736217639303714,38.004987275203206,0.08883175283016542,859.2627716064453,354.5453407764435,830.4329528808594,20933,5529,15404,15404,0,12,5469000.0
5469,5469999,20.734969396335757,38.002920756594165,0.08883395857829157,859.3704981803894,354.6063289642334,830.78466796875,20935,5529,15406,15406,0,12,5470000.0
5470,5470999,20.733810420154242,38.00101592912606,0.08883416039880665,859.4881973266602,354.66652250289917,831.0305786132812,20936,5529,15407,15407,0,12,5471000.0
5471,5471999,20.732504668520967,37.9987927516366,0.08883766413860994,859.6047310829163,354.72658038139343,831.2160263061523,20936,5529,15407,15407,0,12,5472000.0
5472,5472999,20.73135679912174,37.99678260758449,0.08883707773093785,859.7879004478455,354.7869734764099,831.3207321166992,20940,5530,15410,15410,0,12,5473000.0
5473,5473999,20.730376620102827,37.99509838285906,0.08883630615536564,859.9629573822021,354.84749007225037,831.4221267700195,20942,5531,15411,15411,0,12,5474000.0
5474,5474999,20.729113608381013,37.99277831506538,0.08883910629825209,860.1308028697968,354.90791845321655,831.4540061950684,20949,5532,15417,15417,0,12,5475000.0
5475,5475999,20.728322186526587,37.990974626591715,0.08883811143380227,860.4054610729218,354.96899223327637,831.4069709777832,20955,5535,15420,15420,0,12,5476000.0
5476,5476999,20.72719101144884,37.98890184587919,0.08884451990698705,860.5832371711731,355.02976274490356,831.5054588317871,20957,5536,15421,15421,0,12,5477000.0
5477,5477999,20.72628489547671,37.98794310745612,0.08884217040317988,860.7211928367615,355.0908875465393,831.6469039916992,20957,5536,15421,15421,0,12,5478000.0
5478,5478999,20.725336173554737,37.98591488614683,0.08884818243574166,860.8441081047058,355.1516664028168,831.7893753051758,20957,5536,15421,15421,0,12,5479000.0
5479,5479999,20.724222216867634,37.9840465066338,0.08885426803129681,860.9753863811493,355.2123501300812,831.8997917175293,20957,5536,15421,15421,0,12,5480000.0
5480,5480999,20.723232517589935,37.982112178961415,0.08886000414893169,861.100414276123,355.2729253768921,831.9885063171387,20957,5536,15421,15421,0,12,5481000.0
5481,5481999,20.722154421725804,37.97995820206137,0.08886693598220863,861.2378842830658,355.3335225582123,832.0875091552734,20957,5536,15421,15421,0,12,5482000.0
5482,5482999,20.721218700999405,37.97811506396608,0.08887109999381582,861.4220225811005,355.39434242248535,832.0905952453613,20959,5537,15422,15422,0,12,5483000.0
5483,5483999,20.71992166271099,37.975720874149125,0.08888037197537679,861.548985004425,355.4547827243805,832.1817588806152,20960,5537,15423,15423,0,12,5484000.0
5484,5484999,20.718474894242593,37.97310660225851,0.08889014857670818,861.6852757930756,355.51535987854004,832.2698669433594,20960,5537,15423,15423,0,12,5485000.0
5485,5485999,20.71751162014618,37.971317146052606,0.08889703624275669,861.857091665268,355.5777916908264,832.7365951538086,20973,5538,15435,15435,0,12,5486000.0
5486,5486999,20.715788047956906,37.968611377849946,0.08890979407463517,861.9725863933563,355.6381685733795,832.9667778015137,20974,5538,15436,15436,0,12,5487000.0
5487,5487999,20.714583457379202,37.96910352674716,0.08890157233354412,862.1244723796844,355.69976711273193,833.1401748657227,20974,5538,15436,15436,0,12,5488000.0
5488,5488999,20.713271228931138,37.96682471449778,0.08890879393429185,862.2465169429779,355.76033663749695,833.2488441467285,20975,5538,15437,15437,0,12,5489000.0
5489,5489999,20.71232083980069,37.96520564511325,0.08890741646546474,862.4364006519318,355.82695150375366,833.2904968261719,20977,5539,15438,15438,0,12,5490000.0
5490,5490999,20.711761577564022,37.96438208685347,0.08889896568403677,862.6122505664825,355.88741850852966,833.243782043457,20979,5540,15439,15439,0,12,5491000.0
5491,5491999,20.71074257202528,37.96229051323765,0.08890021631971157,862.8383841514587,355.9484751224518,833.2907028198242,20983,5542,15441,15441,0,12,5492000.0
5492,5492999,20.709962839995317,37.96086407024478,0.088901014937388,862.9723250865936,356.00904083251953,833.4243812561035,20983,5542,15441,15441,0,12,5493000.0
5493,5493999,20.70912471485973,37.95908693913688,0.08890241403291244,863.2532186508179,356.0713791847229,833.3269157409668,20989,5545,15444,15444,0,12,5494000.0
5494,5494999,20.708516858101202,37.957431547318734,0.0889044386654676,863.3831164836884,356.1322901248932,833.495677947998,20989,5545,15444,15444,0,12,5495000.0
5495,5495999,20.70799504091586,37.95618307337601,0.08889897267154756,863.5783870220184,356.19343400001526,833.4765701293945,20998,5546,15452,15452,0,12,5496000.0
5496,5496999,20.707706641319017,37.955307907462725,0.0888941991333625,863.7512805461884,356.2545862197876,833.538761138916,21000,5547,15453,15453,0,12,5497000.0
5497,5497999,20.707087487222953,37.95406856702096,0.08889190191690666,863.9875786304474,356.31629967689514,833.4956359863281,21004,5549,15455,15455,0,12,5498000.0
5498,5498999,20.706521601153895,37.95277016179484,0.08889065365912108,864.1223487854004,356.377384185791,833.6405982971191,21004,5549,15455,15455,0,12,5499000.0
5499,5499999,20.70631274900842,37.95469200392601,0.08887569273166374,864.2452080249786,356.4384560585022,833.7196655273438,21004,5549,15455,15455,0,12,5500000.0
5500,5500999,20.705968856903596,37.961027912779485,0.08884372091298764,864.3683624267578,356.500403881073,833.8123397827148,21004,5549,15455,15455,0,12,5501000.0
5501,5501999,20.705305264695117,37.95969634005954,0.08884358842184303,864.5200242996216,356.5614128112793,833.8802642822266,21004,5549,15455,15455,0,12,5502000.0
5502,5502999,20.704792785348783,37.95812332830847,0.0888445010611213,864.7145435810089,356.6230294704437,833.8034248352051,21006,5550,15456,15456,0,12,5503000.0
5503,5503999,20.70400913063564,37.956240869790065,0.0888432711710222,864.8957879543304,356.68425703048706,833.8236923217773,21008,5551,15457,15457,0,12,5504000.0
5504,5504999,20.70311940237068,37.954010341378186,0.08884749508991852,865.0324282646179,356.7454137802124,833.8986625671387,21008,5551,15457,15457,0,12,5505000.0
5505,5505999,20.702096091629507,37.951875775787606,0.08885424118956742,865.1973764896393,356.80778193473816,834.2733268737793,21021,5552,15469,15469,0,12,5506000.0
5506,5506999,20.70048263407484,37.9497459692853,0.08886193471739201,865.3332281112671,356.8696081638336,834.5573883056641,21021,5552,15469,15469,0,12,5507000.0
5507,5507999,20.698931628998746,37.94793472143775,0.08886645594996978,865.5146336555481,356.93045687675476,834.6538581848145,21024,5553,15471,15471,0,12,5508000.0
5508,5508999,20.697535362552095,37.945806344911965,0.08887606079526156,865.6362040042877,356.9914724826813,834.8388404846191,21025,5553,15472,15472,0,12,5509000.0
5509,5509999,20.696177523224215,37.9435809588967,0.08888561540948758,865.8173191547394,357.0525212287903,834.920841217041,21027,5554,15473,15473,0,12,5510000.0
5510,5510999,20.694693835485715,37.940945726564514,0.08889325019543826,865.9451072216034,357.1133162975311,835.0378265380859,21027,5554,15473,15473,0,12,5511000.0
5511,5511999,20.69320586201448,37.93835841250492,0.08890051283826339,866.1194353103638,357.1742522716522,835.0067863464355,21030,5555,15475,15475,0,12,5512000.0
5512,5512999,20.691777655463355,37.93616461584284,0.08890844401428932,866.3004286289215,357.23554706573486,834.9751586914062,21032,5556,15476,15476,0,12,5513000.0
5513,5513999,20.690315926944564,37.93362117365812,0.08891431771042357,866.4451093673706,357.2969880104065,835.0768241882324,21032,5556,15476,15476,0,12,5514000.0
5514,5514999,20.688968876919056,37.93102998952379,0.08892280318484169,866.6748578548431,357.3585090637207,835.0571784973145,21036,5558,15478,15478,0,12,5515000.0
5515,5515999,20.688332772377915,37.945321985147125,0.08885423059624631,866.7935800552368,357.4194588661194,835.1871795654297,21036,5558,15478,15478,0,12,5516000.0
5516,5516999,20.687238238189156,37.94307716480058,0.08885556669987738,867.0177068710327,357.4811062812805,835.127254486084,21040,5560,15480,15480,0,12,5517000.0
5517,5517999,20.68623563197334,37.94104670870923,0.08885579012589784,867.332088470459,357.5435540676117,835.0540351867676,21046,5563,15483,15483,0,12,5518000.0
5518,5518999,20.685041314820438,37.93885358300155,0.08885802533007936,867.4582035541534,357.6047785282135,835.1786079406738,21046,5563,15483,15483,0,12,5519000.0
5519,5519999,20.68413729942132,37.938475384643986,0.08885271030728736,867.5938522815704,357.6661150455475,835.3076133728027,21046,5563,15483,15483,0,12,5520000.0
5520,5520999,20.68346958768944,37.93734848533481,0.08884327783643609,867.7710373401642,357.72735810279846,835.3476142883301,21059,5564,15495,15495,0,12,5521000.0
5521,5521999,20.68285722268476,37.9363995761963,0.08883544085806427,867.943689584732,357.7892339229584,835.3454475402832,21061,5565,15496,15496,0,12,5522000.0
5522,5522999,20.682094757421723,37.934831615303224,0.08883041942096137,868.1342158317566,357.8511140346527,835.4255790710449,21063,5566,15497,15497,0,12,5523000.0
5523,5523999,20.681571015421287,37.93353166397205,0.08882211133904527,868.3216083049774,357.91293382644653,835.5106773376465,21065,5567,15498,15498,0,12,5524000.0
5524,5524999,20.680837026897343,37.931961327004714,0.08881625947034777,868.4394850730896,357.97451400756836,835.6320648193359,21065,5567,15498,15498,0,12,5525000.0
5525,5525999,20.67987063296548,37.92983454938464,0.08881667844775687,868.6025800704956,358.03763031959534,835.7392272949219,21065,5567,15498,15498,0,12,5526000.0
5526,5526999,20.678643972248892,37.92785698939615,0.08882307577687643,868.7337985038757,358.1003270149231,836.4027557373047,21078,5567,15511,15511,0,12,5527000.0
5527,5527999,20.677102622142062,37.92560166180651,0.08883003982551141,868.8578114509583,358.1615688800812,836.714771270752,21079,5567,15512,15512,0,12,5528000.0
5528,5528999,20.675847572807214,37.92379028977676,0.08883176331725617,869.0166382789612,358.22249603271484,836.8261947631836,21081,5568,15513,15513,0,12,5529000.0
5529,5529999,20.674675127504074,37.92174665123995,0.08883863925928115,869.1538195610046,358.2839558124542,837.0629081726074,21082,5568,15514,15514,0,12,5530000.0
5530,5530999,20.673555667753913,37.92161930026101,0.08882986147890504,869.3111879825592,358.3451178073883,837.1698226928711,21084,5569,15515,15515,0,12,5531000.0
5531,5531999,20.67238419355777,37.9195673719354,0.08883100061453209,869.4478795528412,358.4065570831299,837.3116569519043,21084,5569,15515,15515,0,12,5532000.0
5532,5532999,20.671182530762824,37.917307962592204,0.0888332010666516,869.615161895752,358.4680120944977,837.3953971862793,21086,5570,15516,15516,0,12,5533000.0
5533,5533999,20.669966983508896,37.91539352701421,0.08883482529404796,869.7505722045898,358.5303943157196,837.5031089782715,21086,5570,15516,15516,0,12,5534000.0
5534,5534999,20.66879926895829,37.913130600304626,0.08883712759598306,870.0804898738861,358.59283566474915,837.3231086730957,21094,5574,15520,15520,0,12,5535000.0
5535,5535999,20.667959714538416,37.911295539911535,0.08883678283011687,870.2647426128387,358.6546666622162,837.4850730895996,21096,5575,15521,15521,0,12,5536000.0
5536,5536999,20.667195877316793,37.90964002172756,0.08883281345163696,870.391092300415,358.7179653644562,837.6093940734863,21096,5575,15521,15521,0,12,5537000.0
5537,5537999,20.66628775009482,37.90770171484618,0.08883287082726143,870.6511859893799,358.78039026260376,837.5646209716797,21102,5577,15525,15525,0,12,5538000.0
5538,5538999,20.665619568736034,37.90621545913486,0.08882782765518338,870.771782875061,358.84248447418213,837.6803665161133,21102,5577,15525,15525,0,12,5539000.0
5539,5539999,20.664806938742387,37.904814673414116,0.08882296656975508,870.9346632957458,358.90452218055725,837.7239685058594,21104,5578,15526,15526,0,12,5540000.0
5540,5540999,20.664293772269485,37.90386809759164,0.0888144552978033,871.1297943592072,358.96673250198364,837.7441711425781,21107,5579,15528,15528,0,12,5541000.0
5541,5541999,20.663635938073337,37.90239575021826,0.08880894838978115,871.2615919113159,359.0287501811981,837.8566589355469,21107,5579,15528,15528,0,12,5542000.0
5542,5542999,20.66307105597732,37.900923882427435,0.08880276014550936,871.4117527008057,359.09529638290405,837.9136390686035,21107,5579,15528,15528,0,12,5543000.0
5543,5543999,20.662820182780777,37.89984639418344,0.08879152252166544,871.5515038967133,359.1568396091461,837.9877433776855,21107,5579,15528,15528,0,12,5544000.0
5544,5544999,20.66231180192033,37.8985869494453,0.08878268068058492,871.665137052536,359.21946024894714,838.0489845275879,21107,5579,15528,15528,0,12,5545000.0
5545,5545999,20.661716382147677,37.89707940517563,0.088773342890207,871.7985754013062,359.2811632156372,838.1027755737305,21107,5579,15528,15528,0,12,5546000.0
5546,5546999,20.660886721229055,37.89532219094289,0.08876767757930681,871.983891248703,359.34344577789307,838.0860748291016,21109,5580,15529,15529,0,12,5547000.0
5547,5547999,20.659908060811688,37.89333111603481,0.08876710171929636,872.1715040206909,359.40608763694763,838.5983657836914,21125,5581,15544,15544,0,12,5548000.0
5548,5548999,20.658610576733057,37.89223261836047,0.0887642864011986,872.2901124954224,359.46897530555725,838.9967727661133,21127,5581,15546,15546,0,12,5549000.0
5549,5549999,20.657428884000343,37.890069891385984,0.08876370080952345,872.4193155765533,359.5307767391205,839.2038841247559,21127,5581,15546,15546,0,12,5550000.0
5550,5550999,20.656317396399427,37.88785373192403,0.08876401915877763,872.5977849960327,359.59262204170227,839.3377304077148,21129,5582,15547,15547,0,12,5551000.0
5551,5551999,20.655242432234946,37.88583740166073,0.08876220783917455,872.8112316131592,359.65466952323914,839.4286231994629,21133,5584,15549,15549,0,12,5552000.0
5552,5552999,20.65406739437288,37.88350009168181,0.08876418953309961,873.0879032611847,359.71740317344666,839.4223442077637,21146,5587,15559,15559,0,12,5553000.0
5553,5553999,20.653020568027593,37.881402053867966,0.08876313250738255,873.2714350223541,359.77981519699097,839.5746002197266,21148,5588,15560,15560,0,12,5554000.0
5554,5554999,20.651982876036662,37.879494384376194,0.0887607839995257,873.3797988891602,359.84149074554443,839.7372970581055,21148,5588,15560,15560,0,12,5555000.0
5555,5555999,20.650961477171435,37.87742182613611,0.08875748723415933,873.672122001648,359.9045739173889,839.619930267334,21161,5591,15570,15570,0,12,5556000.0
5556,5556999,20.650354164447158,37.87588384016962,0.08874868585773021,873.8626065254211,359.9672498703003,839.7661552429199,21163,5592,15571,15571,0,12,5557000.0
5557,5557999,20.649960268658425,37.8748290032764,0.08873596353236923,874.0571098327637,360.02981185913086,839.7612190246582,21168,5593,15575,15575,0,12,5558000.0
5558,5558999,20.650102277652504,37.875181214168215,0.08871474441745075,874.2271418571472,360.0928614139557,839.8429756164551,21170,5594,15576,15576,0,12,5559000.0
5559,5559999,20.65006692939663,37.87430027176957,0.08869878418817323,874.3683390617371,360.1553008556366,839.9722900390625,21170,5594,15576,15576,0,12,5560000.0
5560,5560999,20.649928602618388,37.87348171835243,0.08868591622639765,874.4781360626221,360.21753334999084,840.0632705688477,21170,5594,15576,15576,0,12,5561000.0
5561,5561999,20.65020009639635,37.87376391055209,0.08866404108576931,874.6166317462921,360.28133845329285,840.1603202819824,21170,5594,15576,15576,0,12,5562000.0
5562,5562999,20.650998009464075,37.87470323831469,0.08863783839135131,874.751442193985,360.34349846839905,840.2594718933105,21170,5594,15576,15576,0,12,5563000.0
5563,5563999,20.651405606184273,37.874534147042844,0.0886211456145175,874.9534134864807,360.4064700603485,840.2417984008789,21172,5595,15577,15577,0,12,5564000.0
5564,5564999,20.652238067831053,37.87501256952646,0.0885986283231539,875.1182329654694,360.4694175720215,840.2618637084961,21174,5596,15578,15578,0,12,5565000.0
5565,5565999,20.65261391341697,37.87461324893462,0.08858628189959539,875.2609684467316,360.53220677375793,840.3586082458496,21174,5596,15578,15578,0,12,5566000.0
5566,5566999,20.652903744118284,37.87407334564477,0.0885727129562136,875.3997447490692,360.5947380065918,840.4495811462402,21174,5596,15578,15578,0,12,5567000.0
5567,5567999,20.65295372274971,37.873044000883425,0.08856020633343076,875.581508398056,360.6573507785797,840.4353065490723,21179,5597,15582,15582,0,12,5568000.0
5568,5568999,20.652181555501013,37.87130173091365,0.08855928783258171,875.719536781311,360.7206082344055,841.3106002807617,21200,5597,15603,15603,0,12,5569000.0
5569,5569999,20.65115440490651,37.869762033303864,0.08855791902856558,875.8270103931427,360.782351732254,841.8618965148926,21201,5597,15604,15604,0,12,5570000.0
5570,5570999,20.64994418949864,37.86772349119478,0.08856354717015724,876.0121555328369,360.8444037437439,842.1266174316406,21203,5598,15605,15605,0,12,5571000.0
5571,5571999,20.649203527533775,37.86627760779417,0.08856314172770552,876.1188671588898,360.9065582752228,842.3678092956543,21203,5598,15605,15605,0,12,5572000.0
5572,5572999,20.648483061420073,37.86463635303243,0.088559060115727,876.2823710441589,360.96830558776855,842.5219230651855,21205,5599,15606,15606,0,12,5573000.0
5573,5573999,20.64758811741896,37.86294547671446,0.08855859424907231,876.5558657646179,361.03065824508667,842.4377021789551,21211,5602,15609,15609,0,12,5574000.0
5574,5574999,20.6465589134481,37.861074235526296,0.08855802664242163,876.6860249042511,361.0933427810669,842.6990509033203,21211,5602,15609,15609,0,12,5575000.0
5575,5575999,20.6456091688812,37.8592039506653,0.08855462559245353,876.9931890964508,361.1570167541504,842.5375823974609,21221,5606,15615,15615,0,12,5576000.0
5576,5576999,20.644668246331094,37.85710966205867,0.0885563993768046,877.2424314022064,361.2201256752014,842.6916694641113,21229,5608,15621,15621,0,12,5577000.0
5577,5577999,20.643660035744315,37.855274729685846,0.088554664340175,877.4713380336761,361.28305435180664,842.7975883483887,21233,5610,15623,15623,0,12,5578000.0
5578,5578999,20.642964912592408,37.85571539736364,0.0885445664431348,877.6501302719116,361.3456482887268,842.9285049438477,21235,5611,15624,15624,0,12,5579000.0
5579,5579999,20.641892009295535,37.85338390829802,0.08854928367638748,877.9337732791901,361.4093518257141,842.8911666870117,21241,5614,15627,15627,0,12,5580000.0
5580,5580999,20.641063125308005,37.85161114359952,0.08855076198092149,878.0575938224792,361.4727523326874,843.1176719665527,21241,5614,15627,15627,0,12,5581000.0
5581,5581999,20.640283476395677,37.84946210091726,0.08855756858625341,878.1893343925476,361.5353274345398,843.297306060791,21241,5614,15627,15627,0,12,5582000.0
5582,5582999,20.639713313138078,37.848156236954985,0.08856650774428687,878.3212199211121,361.59935569763184,843.4409446716309,21241,5614,15627,15627,0,12,5583000.0
5583,5583999,20.638730974671653,37.84582644912673,0.08858047817103554,878.5000736713409,361.6632807254791,843.5276489257812,21243,5615,15628,15628,0,12,5584000.0
5584,5584999,20.63776057211341,37.843570568322306,0.08858864016076162,878.7336130142212,361.7264280319214,843.4794006347656,21252,5617,15635,15635,0,12,5585000.0
5585,5585999,20.636828520063116,37.84219589138489,0.08859090135029046,878.970942735672,361.7899968624115,844.3898086547852,21343,5619,15724,15724,0,12,5586000.0
5586,5586999,20.63577678980085,37.84125987359087,0.08858997626003995,879.0820815563202,361.8520941734314,845.2011985778809,21343,5619,15724,15724,0,12,5587000.0
5587,5587999,20.634553974857365,37.83928279447813,0.08860519718637816,879.1957902908325,361.91448974609375,845.7143402099609,21343,5619,15724,15724,0,12,5588000.0
5588,5588999,20.63329919565339,37.837237970634085,0.08861611982872675,879.4687185287476,361.9775457382202,845.8850746154785,21356,5622,15734,15734,0,12,5589000.0
5589,5589999,20.63241098564833,37.83575620210822,0.08861700362865299,879.627032995224,362.04039478302,846.2074127197266,21359,5623,15736,15736,0,12,5590000.0
5590,5590999,20.631223370598786,37.83400919684492,0.08862163305150828,879.7599687576294,362.10278964042664,846.5156707763672,21359,5623,15736,15736,0,12,5591000.0
5591,5591999,20.6301236095535,37.83199872687893,0.08862474851056612,879.8756716251373,362.1646637916565,846.8168182373047,21360,5623,15737,15737,0,12,5592000.0
5592,5592999,20.62905020924868,37.83000491745383,0.08862505356980566,880.109956741333,362.2281892299652,846.9265670776367,21364,5625,15739,15739,0,12,5593000.0
5593,5593999,20.62811261640465,37.8281142296842,0.08862346165357804,880.3573772907257,362.2914037704468,847.0119323730469,21368,5627,15741,15741,0,12,5594000.0
5594,5594999,20.627436325587375,37.82720614750849,0.08861495768616823,880.5338714122772,362.35442566871643,847.122371673584,21370,5628,15742,15742,0,12,5595000.0
5595,5595999,20.626662967404954,37.8254066633231,0.08861112602621013,880.7012407779694,362.4178133010864,847.2256927490234,21372,5629,15743,15743,0,12,5596000.0
5596,5596999,20.625979723581022,37.82413621216271,0.08860274183751538,880.9305047988892,362.48147082328796,847.2613143920898,21376,5631,15745,15745,0,12,5597000.0
5597,5597999,20.625516716699288,37.82318123508051,0.08859060902040106,881.0547087192535,362.54395723342896,847.4793891906738,21376,5631,15745,15745,0,12,5598000.0
5598,5598999,20.62518728670476,37.821903512562535,0.08857731871865027,881.2491886615753,362.6076753139496,847.6417465209961,21378,5632,15746,15746,0,12,5599000.0
5599,5599999,20.624591224342268,37.82073619625577,0.08856698754468217,881.3778920173645,362.6700220108032,847.8078956604004,21378,5632,15746,15746,0,12,5600000.0
5600,5600999,20.624138607399594,37.81941992479958,0.08855854897191395,881.5030248165131,362.73270058631897,847.9914436340332,21378,5632,15746,15746,0,12,5601000.0
5601,5601999,20.62410396259044,37.820013731598415,0.08853711906158968,881.6968262195587,362.795401096344,848.0083618164062,21385,5633,15752,15752,0,12,5602000.0
5602,5602999,20.623618333875697,37.818475607614104,0.08852915368451186,881.8811340332031,362.8579909801483,848.0276260375977,21392,5634,15758,15758,0,12,5603000.0
5603,5603999,20.62309585779923,37.816950270611244,0.0885230297592704,881.9993185997009,362.920214176178,848.1433448791504,21392,5634,15758,15758,0,12,5604000.0
5604,5604999,20.622712361085245,37.81567496046333,0.08851309039889843,882.2490811347961,362.9835317134857,848.1924629211426,21396,5636,15760,15760,0,12,5605000.0
5605,5605999,20.62193550005064,37.81598505460507,0.08847797357439913,882.373076915741,363.0481426715851,849.3316345214844,21404,5636,15768,15768,0,12,5606000.0
5606,5606999,20.620628429830916,37.81434921654682,0.08847791500354163,882.4841268062592,363.11018538475037,849.7873268127441,21405,5636,15769,15769,0,12,5607000.0
5607,5607999,20.619671991289003,37.812805636751165,0.08848112195146818,882.6498577594757,363.17256689071655,849.9800338745117,21407,5637,15770,15770,0,12,5608000.0
5608,5608999,20.618699076713295,37.81096070883296,0.08848404538738264,882.8322494029999,363.2391483783722,850.1027641296387,21416,5638,15778,15778,0,12,5609000.0
5609,5609999,20.617920277593143,37.80936049648595,0.08848011323755,882.9485430717468,363.3012833595276,850.3314056396484,21416,5638,15778,15778,0,12,5610000.0
5610,5610999,20.61719679683911,37.80788363740209,0.08847904094982806,883.227114200592,363.3639278411865,850.3458557128906,21422,5641,15781,15781,0,12,5611000.0
5611,5611999,20.616380834331096,37.80625200967578,0.08847949220515072,883.3568415641785,363.42610788345337,850.5466766357422,21422,5641,15781,15781,0,12,5612000.0
5612,5612999,20.61575720999149,37.8049465612007,0.0884801504585071,883.482017993927,363.48815846443176,850.6944580078125,21422,5641,15781,15781,0,12,5613000.0
5613,5613999,20.615357667552846,37.80401442604579,0.08847870093583343,883.6256506443024,363.5503976345062,850.7976455688477,21422,5641,15781,15781,0,12,5614000.0
5614,5614999,20.615155858996964,37.80315358288945,0.08847251526184452,883.7455897331238,363.61207461357117,850.9019546508789,21422,5641,15781,15781,0,12,5615000.0
5615,5615999,20.614807988330373,37.801952141409394,0.08846837198639046,883.9241552352905,363.67437505722046,850.8985595703125,21424,5642,15782,15782,0,12,5616000.0
5616,5616999,20.61468477102275,37.801593106069845,0.08846457237065608,884.1005432605743,363.7364206314087,850.9311637878418,21426,5643,15783,15783,0,12,5617000.0
5617,5617999,20.614636818955564,37.8030928443591,0.08844665420158127,884.2904980182648,363.7990822792053,851.0077018737793,21428,5644,15784,15784,0,12,5618000.0
5618,5618999,20.615055362071793,37.80420305689802,0.08843648321696995,884.4197328090668,363.86125469207764,851.1455039978027,21428,5644,15784,15784,0,12,5619000.0
5619,5619999,20.615295514769365,37.80397345788903,0.08842612934602057,884.5496511459351,363.9231677055359,851.2353897094727,21428,5644,15784,15784,0,12,5620000.0
5620,5620999,20.615861094303785,37.80370339240481,0.08841277134366221,884.6720561981201,363.98555517196655,851.3397445678711,21428,5644,15784,15784,0,12,5621000.0
5621,5621999,20.616530334231673,37.80387708577991,0.08840473976573826,884.8501310348511,364.0476987361908,851.38134765625,21429,5645,15784,15784,0,12,5622000.0
5622,5622999,20.617206563306528,37.80414122840335,0.08838890879831363,885.0072767734528,364.1100959777832,851.4503479003906,21429,5645,15784,15784,0,12,5623000.0
5623,5623999,20.61771025552839,37.80397404016882,0.08837144804436081,885.1449065208435,364.1723656654358,851.5244636535645,21429,5645,15784,15784,0,12,5624000.0
5624,5624999,20.61816233502629,37.80353373029014,0.08836258631344629,885.2659499645233,364.2345128059387,851.5775375366211,21429,5645,15784,15784,0,12,5625000.0
5625,5625999,20.61763996716113,37.801693254134044,0.08835730277686904,885.3912906646729,364.2972867488861,851.669002532959,21429,5645,15784,15784,0,12,5626000.0
5626,5626999,20.616483100738414,37.80057774908843,0.0883602059094436,885.5094966888428,364.360068321228,852.6922721862793,21434,5645,15789,15789,0,12,5627000.0
5627,5627999,20.614992511378308,37.79806882613747,0.08836862091131048,885.6255393028259,364.4219779968262,853.0860862731934,21435,5645,15790,15790,0,12,5628000.0
5628,5628999,20.6138020756285,37.79644580508667,0.08837573288128364,885.7476322650909,364.48444390296936,853.3365097045898,21436,5645,15791,15791,0,12,5629000.0
5629,5629999,20.61250237238384,37.79400208629788,0.08838679319047793,885.8630349636078,364.5462040901184,853.5405616760254,21436,5645,15791,15791,0,12,5630000.0
5630,5630999,20.61141574043047,37.792298094421554,0.08838783151320018,885.9833271503448,364.6083674430847,853.7091865539551,21436,5645,15791,15791,0,12,5631000.0
5631,5631999,20.61022628967556,37.790002725610826,0.08839467434800508,886.2289776802063,364.67118430137634,853.7329139709473,21440,5647,15793,15793,0,12,5632000.0
5632,5632999,20.608789294272697,37.787374901371784,0.08840394002809049,886.3545031547546,364.7328016757965,853.8810081481934,21440,5647,15793,15793,0,12,5633000.0
5633,5633999,20.607459165344792,37.78481620982122,0.088411555450426,886.5238778591156,364.79501032829285,853.9850845336914,21450,5648,15802,15802,0,12,5634000.0
5634,5634999,20.606532325990933,37.78302255027343,0.08841129721945296,886.7392385005951,364.8578507900238,854.0484275817871,21452,5649,15803,15803,0,12,5635000.0
5635,5635999,20.606141388343794,37.78248371599576,0.0884029225517794,886.8547761440277,364.9181225299835,854.1560974121094,21452,5649,15803,15803,0,12,5636000.0
5636,5636999,20.60628575429448,37.783798699102604,0.08837708637858077,886.9732849597931,364.97684955596924,854.2492485046387,21452,5649,15803,15803,0,12,5637000.0
5637,5637999,20.60656437685859,37.78454827575609,0.08835743901937132,887.2578017711639,365.03938364982605,854.177921295166,21464,5652,15812,15812,0,12,5638000.0
5638,5638999,20.60771328433883,37.78962449045869,0.08831996702205547,887.3739967346191,365.10017132759094,854.2950859069824,21464,5652,15812,15812,0,12,5639000.0
5639,5639999,20.60969793284759,37.79694542956531,0.08827239212601601,887.5636327266693,365.1599175930023,854.3533782958984,21473,5653,15820,15820,0,12,5640000.0
5640,5640999,20.611764801137454,37.80425937395953,0.08823421338114523,887.7319712638855,365.2192590236664,854.4032020568848,21475,5654,15821,15821,0,12,5641000.0
5641,5641999,20.613747639655738,37.8099830909413,0.08819392503621548,887.8441452980042,365.2818853855133,854.5090713500977,21475,5654,15821,15821,0,12,5642000.0
5642,5642999,20.616923105203064,37.820313044754805,0.08814499521111097,888.0001425743103,365.3409833908081,854.6024436950684,21475,5654,15821,15821,0,12,5643000.0
5643,5643999,20.619417812080137,37.82772064263417,0.08810676298801479,888.1737079620361,365.4005560874939,854.5976486206055,21485,5655,15830,15830,0,12,5644000.0
5644,5644999,20.621529866752716,37.8327047386393,0.08809792414712114,888.3028733730316,365.4609339237213,854.692684173584,21485,5655,15830,15830,0,12,5645000.0
5645,5645999,20.62268410462868,37.834946317505825,0.08808839438292926,888.4903793334961,365.5232951641083,854.7172546386719,21487,5656,15831,15831,0,12,5646000.0
5646,5646999,20.621887660272954,37.83444773215352,0.0881079521424154,888.6580138206482,365.58501958847046,855.6471252441406,21497,5657,15840,15840,0,12,5647000.0
5647,5647999,20.620555700866838,37.833352348538334,0.08810902343660132,888.7765665054321,365.64738869667053,856.0686874389648,21498,5657,15841,15841,0,12,5648000.0
5648,5648999,20.61919552347309,37.831696077633104,0.08811601779417344,888.9046466350555,365.7062838077545,856.2924613952637,21498,5657,15841,15841,0,12,5649000.0
5649,5649999,20.617736366899294,37.82943826340989,0.08812710189980588,889.0197324752808,365.76575112342834,856.4959487915039,21498,5657,15841,15841,0,12,5650000.0
5650,5650999,20.616460698925994,37.82796242448554,0.08812845459391205,889.1350395679474,365.8280692100525,856.6595840454102,21498,5657,15841,15841,0,12,5651000.0
5651,5651999,20.615089799930008,37.825873281276294,0.0881340222338749,889.3194539546967,365.8878684043884,856.7163887023926,21500,5658,15842,15842,0,12,5652000.0
5652,5652999,20.613804663932175,37.82759148938957,0.08812318686199228,889.4409103393555,365.94708347320557,856.8511734008789,21500,5658,15842,15842,0,12,5653000.0
5653,5653999,20.61259588856256,37.82540303841863,0.08812749751386983,889.5722901821136,366.00607109069824,856.9430084228516,21500,5658,15842,15842,0,12,5654000.0
5654,5654999,20.611465928120644,37.82333274789514,0.08813212235321954,889.7127559185028,366.0670208930969,857.0390434265137,21500,5658,15842,15842,0,12,5655000.0
5655,5655999,20.610588745881547,37.821621245526906,0.08813115144397954,889.8340911865234,366.12578225135803,857.1089134216309,21500,5658,15842,15842,0,12,5656000.0
5656,5656999,20.60995039063116,37.82067866461821,0.08812337911551127,889.9736318588257,366.1876242160797,857.1861610412598,21500,5658,15842,15842,0,12,5657000.0
5657,5657999,20.60921253286603,37.81903813411198,0.08812284343284504,890.0860247612,366.2467613220215,857.2367744445801,21500,5658,15842,15842,0,12,5658000.0
5658,5658999,20.608439707705415,37.817301950181225,0.0881193546602217,890.2146909236908,366.30547428131104,857.3021583557129,21500,5658,15842,15842,0,12,5659000.0
5659,5659999,20.60802773284049,37.81612437054154,0.08811387371931356,890.3951253890991,366.36694622039795,857.3247222900391,21502,5659,15843,15843,0,12,5660000.0
5660,5660999,20.60779232743972,37.81513100311808,0.0881019610551973,890.5228669643402,366.42590522766113,857.3765335083008,21502,5659,15843,15843,0,12,5661000.0
5661,5661999,20.60756153109789,37.81412680717083,0.08809188742562157,890.6676788330078,366.48750591278076,857.4591293334961,21502,5659,15843,15843,0,12,5662000.0
5662,5662999,20.607686262421325,37.81529383147919,0.08807452848006503,890.7869553565979,366.54779982566833,857.5186462402344,21502,5659,15843,15843,0,12,5663000.0
5663,5663999,20.607974507954992,37.81525309247577,0.088057443715161,890.9206676483154,366.60747718811035,857.5445213317871,21502,5659,15843,15843,0,12,5664000.0
5664,5664999,20.607892357543424,37.81422838026687,0.08805042503002214,891.1124613285065,366.6677153110504,857.4959335327148,21504,5660,15844,15844,0,12,5665000.0
5665,5665999,20.608010846768163,37.813619479457024,0.08804030404491481,891.2712812423706,366.7273278236389,857.4939346313477,21506,5661,15845,15845,0,12,5666000.0
5666,5666999,20.607106146889144,37.811871061614774,0.0880399049748799,891.4630107879639,366.7872667312622,858.1005210876465,21517,5662,15855,15855,0,12,5667000.0
5667,5667999,20.60602970956849,37.80993641092583,0.08803922478162052,891.5706963539124,366.8469979763031,858.5855560302734,21517,5662,15855,15855,0,12,5668000.0
5668,5668999,20.60462447274352,37.80727806489724,0.08804493178789385,894.8704879283905,366.90736508369446,858.9104804992676,21517,5662,15855,15855,0,12,5669000.0
5669,5669999,20.603404577487506,37.80486943985888,0.08805203140319429,895.1021101474762,366.96889328956604,859.0062484741211,21522,5664,15858,15858,0,12,5670000.0
5670,5670999,20.60227939403064,37.803393863947434,0.08805733316165631,895.2106363773346,367.0284638404846,859.2091674804688,21522,5664,15858,15858,0,12,5671000.0
5671,5671999,20.600930584523837,37.80092923839163,0.08806120925779637,895.3827896118164,367.0884065628052,859.263988494873,21524,5665,15859,15859,0,12,5672000.0
5672,5672999,20.59958737656665,37.798514938319464,0.08806626692978747,895.5114889144897,367.14945888519287,859.4265823364258,21524,5665,15859,15859,0,12,5673000.0
5673,5673999,20.598533320530578,37.79674906572036,0.08806476059862733,895.6375534534454,367.209689617157,859.5464973449707,21524,5665,15859,15859,0,12,5674000.0
5674,5674999,20.597697356255328,37.79575638069178,0.08805956884636135,895.7787911891937,367.27100706100464,859.666919708252,21524,5665,15859,15859,0,12,5675000.0
5675,5675999,20.59730146595214,37.79643672371719,0.0880418018618796,895.9062623977661,367.3333466053009,859.7718162536621,21524,5665,15859,15859,0,12,5676000.0
5676,5676999,20.597608272118105,37.79895025267501,0.08801106470088504,896.0345947742462,367.393639087677,859.8453521728516,21524,5665,15859,15859,0,12,5677000.0
5677,5677999,20.5981809296511,37.80189323586983,0.08797917012449485,896.256867647171,367.4540321826935,859.7344627380371,21528,5667,15861,15861,0,12,5678000.0
5678,5678999,20.598835371865558,37.8042703150121,0.08795579068887915,896.434921503067,367.51441264152527,859.7703552246094,21530,5668,15862,15862,0,12,5679000.0
5679,5679999,20.59951116164072,37.80688414924103,0.08792808762594373,896.6642203330994,367.57729387283325,859.7678031921387,21534,5670,15864,15864,0,12,5680000.0
5680,5680999,20.60049409713477,37.81035860555148,0.0879035669641337,896.7903780937195,367.63911294937134,859.9512825012207,21534,5670,15864,15864,0,12,5681000.0
5681,5681999,20.601704783154283,37.81418489145095,0.0878856671689986,896.9626052379608,367.699419260025,860.0102500915527,21536,5671,15865,15865,0,12,5682000.0
5682,5682999,20.602438563066123,37.81611618730371,0.08789457291679859,897.1394536495209,367.76242327690125,860.0363388061523,21538,5672,15866,15866,0,12,5683000.0
5683,5683999,20.603912112140797,37.819455866650685,0.08788504238986705,897.3449282646179,367.82595801353455,860.0756149291992,21540,5673,15867,15867,0,12,5684000.0
5684,5684999,20.605302756045614,37.82272431011588,0.08787959854941818,897.4862267971039,367.8870179653168,860.2042808532715,21540,5673,15867,15867,0,12,5685000.0
5685,5685999,20.606826870114595,37.82827077010693,0.087839224299743,897.6043355464935,367.946980714798,860.2599716186523,21540,5673,15867,15867,0,12,5686000.0
5686,5686999,20.607569605620334,37.82935043512492,0.08783725810669396,897.7984116077423,368.0076103210449,860.3094100952148,21542,5674,15868,15868,0,12,5687000.0
5687,5687999,20.607657318458376,37.82955008834889,0.08783053906347116,898.0292506217957,368.0683352947235,860.8936653137207,21558,5676,15882,15882,0,12,5688000.0
5688,5688999,20.607025155573417,37.82778003970508,0.08781815797232728,898.1545603275299,368.13225531578064,861.3383102416992,21559,5676,15883,15883,0,12,5689000.0
5689,5689999,20.606086310565665,37.82602102694992,0.08781311462434349,898.3314893245697,368.1925024986267,861.5793266296387,21561,5677,15884,15884,0,12,5690000.0
5690,5690999,20.60525514564057,37.824418198596135,0.08780911964180949,898.4994580745697,368.25304651260376,861.7125778198242,21564,5678,15886,15886,0,12,5691000.0
5691,5691999,20.60451928424274,37.82272278718236,0.08780547457315335,898.6747140884399,368.31333112716675,861.8098945617676,21566,5679,15887,15887,0,12,5692000.0
5692,5692999,20.603866542433085,37.821156816718656,0.0877977710822786,898.8479645252228,368.37341046333313,861.8819808959961,21568,5680,15888,15888,0,12,5693000.0
5693,5693999,20.603044133285675,37.819419120079374,0.08779257642722504,898.9784145355225,368.4334526062012,862.0398445129395,21568,5680,15888,15888,0,12,5694000.0
5694,5694999,20.602615337957452,37.81828423590983,0.08778559059023705,899.208479642868,368.4948856830597,862.0475196838379,21572,5682,15890,15890,0,12,5695000.0
5695,5695999,20.602007785174198,37.81713132957127,0.0877837830728182,899.3354361057281,368.55783104896545,862.1835289001465,21572,5682,15890,15890,0,12,5696000.0
5696,5696999,20.60179394184023,37.816343498194954,0.08778419537773519,899.5321071147919,368.61894392967224,862.3098373413086,21574,5683,15891,15891,0,12,5697000.0
5697,5697999,20.601474223295064,37.815930193452964,0.08778836504527687,899.7480571269989,368.679842710495,862.3038368225098,21578,5685,15893,15893,0,12,5698000.0
5698,5698999,20.601166270354987,37.81505038355615,0.08778412693322679,899.8610141277313,368.74007296562195,862.4573287963867,21578,5685,15893,15893,0,12,5699000.0
5699,5699999,20.601127656319807,37.817077781803604,0.08779653045916735,900.0047032833099,368.8018136024475,862.563606262207,21578,5685,15893,15893,0,12,5700000.0
5700,5700999,20.601194354243106,37.81679716103612,0.08778848460223776,900.1315169334412,368.86292576789856,862.6533584594727,21578,5685,15893,15893,0,12,5701000.0
5701,5701999,20.6012776079997,37.816476206962435,0.08780438501457355,900.270879983902,368.92397141456604,862.7451362609863,21578,5685,15893,15893,0,12,5702000.0
5702,5702999,20.601343460873895,37.815847004086216,0.08780036794246626,900.4153649806976,368.9855215549469,862.8251838684082,21578,5685,15893,15893,0,12,5703000.0
5703,5703999,20.601420189775787,37.81545775582565,0.08780084894052709,900.5457954406738,369.0478615760803,862.9016075134277,21578,5685,15893,15893,0,12,5704000.0
5704,5704999,20.60163881943224,37.81477427470586,0.08780768033255759,900.6780230998993,369.1097013950348,862.9685897827148,21578,5685,15893,15893,0,12,5705000.0
5705,5705999,20.601822679153017,37.815703765311646,0.08779304573261992,900.8903090953827,369.17126274108887,862.9464378356934,21580,5686,15894,15894,0,12,5706000.0
5706,5706999,20.601962726733294,37.815071564727376,0.08779316545992855,901.027750492096,369.234482049942,863.0166015625,21580,5686,15894,15894,0,12,5707000.0
5707,5707999,20.60214667538923,37.81440434323684,0.08777710313353282,901.1510453224182,369.29540824890137,863.1028747558594,21580,5686,15894,15894,0,12,5708000.0
5708,5708999,20.601504351019116,37.81279269403035,0.08777334041640095,901.2848570346832,369.358984708786,863.7853393554688,21588,5686,15902,15902,0,12,5709000.0
5709,5709999,20.600292559703018,37.811229901063136,0.08777876961533315,901.4135842323303,369.4207305908203,864.2196884155273,21588,5686,15902,15902,0,12,5710000.0
5710,5710999,20.599149463933685,37.81052677571611,0.08778290217190465,901.5405492782593,369.4829270839691,864.4413604736328,21588,5686,15902,15902,0,12,5711000.0
5711,5711999,20.59814504993561,37.80921863065917,0.08778500966204472,901.7154002189636,369.54578280448914,864.5849876403809,21590,5687,15903,15903,0,12,5712000.0
5712,5712999,20.59707726752867,37.8078454271385,0.08778587091836598,901.839840888977,369.6074712276459,864.7719802856445,21590,5687,15903,15903,0,12,5713000.0
5713,5713999,20.59566225292388,37.80530457122996,0.08779679923469608,901.9852030277252,369.67108631134033,864.889461517334,21590,5687,15903,15903,0,12,5714000.0
5714,5714999,20.59447224849396,37.803214296759805,0.08780351832065958,902.1059277057648,369.73137617111206,865.0138778686523,21590,5687,15903,15903,0,12,5715000.0
5715,5715999,20.593475969513168,37.801782540082236,0.08780440096906794,902.2376198768616,369.79125595092773,865.0827484130859,21590,5687,15903,15903,0,12,5716000.0
5716,5716999,20.592272219994772,37.7998185404419,0.08781325632931736,902.3826415538788,369.85302472114563,865.1781616210938,21590,5687,15903,15903,0,12,5717000.0
5717,5717999,20.591004747493646,37.797477123185146,0.0878255945973414,902.5203311443329,369.9131917953491,865.245792388916,21590,5687,15903,15903,0,12,5718000.0
5718,5718999,20.5897298752533,37.79509529619858,0.08783504916799068,902.6472599506378,369.9737334251404,865.2931442260742,21590,5687,15903,15903,0,12,5719000.0
5719,5719999,20.588617159720393,37.79319247915581,0.08784486788141499,902.8835487365723,370.0345973968506,865.1775665283203,21602,5689,15913,15913,0,12,5720000.0
5720,5720999,20.587625435406817,37.791232557188984,0.0878553369289573,903.0213334560394,370.1013894081116,865.2513732910156,21602,5689,15913,15913,0,12,5721000.0
5721,5721999,20.586823983887395,37.78946754610291,0.08786488928821634,903.1931879520416,370.16167998313904,865.2963104248047,21604,5690,15914,15914,0,12,5722000.0
5722,5722999,20.585929936157925,37.787565150711885,0.0878757325692906,903.3412673473358,370.2218382358551,865.3811950683594,21604,5690,15914,15914,0,12,5723000.0
5723,5723999,20.585155291995434,37.78567465512394,0.08788906482399772,903.4841732978821,370.2818613052368,865.4443855285645,21604,5690,15914,15914,0,12,5724000.0
5724,5724999,20.583952391781327,37.78319236491455,0.0879073911931848,903.5969662666321,370.3455331325531,865.5118408203125,21604,5690,15914,15914,0,12,5725000.0
5725,5725999,20.58297791291531,37.782158702980965,0.08791363271366759,903.7384605407715,370.407497882843,865.985237121582,21610,5690,15920,15920,0,12,5726000.0
5726,5726999,20.58183319008142,37.78016492014697,0.08791693432604675,903.9379024505615,370.4709177017212,866.2422027587891,21612,5691,15921,15921,0,12,5727000.0
5727,5727999,20.58116658140582,37.77968276297697,0.08791108393451452,904.0697033405304,370.5316619873047,866.4565544128418,21612,5691,15921,15921,0,12,5728000.0
5728,5728999,20.58036092238635,37.779539383742346,0.08790596898237713,904.2960138320923,370.59348368644714,866.4821548461914,21616,5693,15923,15923,0,12,5729000.0
5729,5729999,20.57965430946716,37.77827310367069,0.08790405393410328,904.4739334583282,370.65552973747253,866.5571212768555,21618,5694,15924,15924,0,12,5730000.0
5730,5730999,20.57918315694009,37.777769755631375,0.0878983271890964,904.6576368808746,370.7164924144745,866.5928344726562,21620,5695,15925,15925,0,12,5731000.0
5731,5731999,20.578563550188278,37.776358082550196,0.08790029983070613,904.9886260032654,370.77763533592224,866.347053527832,21628,5699,15929,15929,0,12,5732000.0
5732,5732999,20.57767287896671,37.77454570805886,0.08789783571741305,905.1058268547058,370.84033465385437,866.5589179992676,21628,5699,15929,15929,0,12,5733000.0
5733,5733999,20.576855211595266,37.77267185274187,0.08789849756813617,905.2397029399872,370.9007742404938,866.7087669372559,21628,5699,15929,15929,0,12,5734000.0
5734,5734999,20.57653394136559,37.77237228278533,0.08788901577623554,905.4162294864655,370.96368288993835,866.7206916809082,21630,5700,15930,15930,0,12,5735000.0
5735,5735999,20.576060856361334,37.77115721874952,0.0878807402587134,905.6599707603455,371.0258557796478,866.7822341918945,21646,5702,15944,15944,0,12,5736000.0
5736,5736999,20.575424934783488,37.76979208541594,0.08787727064785944,905.8511765003204,371.09291791915894,866.770206451416,21655,5703,15952,15952,0,12,5737000.0
5737,5737999,20.574874898100855,37.768339348151,0.08786988958373354,906.0229535102844,371.1550898551941,866.8559646606445,21657,5704,15953,15953,0,12,5738000.0
5738,5738999,20.574720941120933,37.76812954031385,0.08785961465814851,906.1519339084625,371.215384721756,866.9667320251465,21657,5704,15953,15953,0,12,5739000.0
5739,5739999,20.574631298248363,37.76823329626749,0.08784594716243721,906.2911205291748,371.27780652046204,867.079231262207,21657,5704,15953,15953,0,12,5740000.0
5740,5740999,20.574088567349445,37.766660120840406,0.08784264930438968,906.4661018848419,371.33731746673584,867.0813522338867,21659,5705,15954,15954,0,12,5741000.0
5741,5741999,20.57402640992632,37.765842451725575,0.08783305906440542,906.6510915756226,371.3964822292328,867.1302642822266,21661,5706,15955,15955,0,12,5742000.0
5742,5742999,20.574197201803873,37.765409785402746,0.08782186882215326,906.8029527664185,371.4633147716522,867.2228317260742,21661,5706,15955,15955,0,12,5743000.0
5743,5743999,20.574364550930383,37.76475116073304,0.08781648655320728,906.9238498210907,371.5283715724945,867.2984924316406,21661,5706,15955,15955,0,12,5744000.0
5744,5744999,20.574483686980297,37.766468212877534,0.08780018498456033,907.0651524066925,371.5897521972656,867.3930549621582,21661,5706,15955,15955,0,12,5745000.0
5745,5745999,20.57395701240257,37.76480685446484,0.0877863107511605,907.1965591907501,371.6495752334595,867.8115158081055,21668,5706,15962,15962,0,12,5746000.0
5746,5746999,20.57425457968391,37.76599658540818,0.08776061210240016,907.3379049301147,371.7095606327057,867.9783935546875,21668,5706,15962,15962,0,12,5747000.0
5747,5747999,20.574923939783826,37.76802041819311,0.08772615889965263,907.5164606571198,371.7693474292755,868.0487670898438,21670,5707,15963,15963,0,12,5748000.0
5748,5748999,20.575466188683126,37.7685680365479,0.08770174087663274,907.6856808662415,371.82861161231995,868.1155204772949,21672,5708,15964,15964,0,12,5749000.0
5749,5749999,20.57590581085407,37.76906014635318,0.08768766503794723,907.8205649852753,371.8883275985718,868.2158966064453,21672,5708,15964,15964,0,12,5750000.0
5750,5750999,20.576150973190384,37.76854558679811,0.08767271801888321,908.0107214450836,371.9479775428772,868.1331443786621,21674,5709,15965,15965,0,12,5751000.0
5751,5751999,20.57657386691905,37.76843665758656,0.08765226642696433,908.123368024826,372.0072581768036,868.2459754943848,21674,5709,15965,15965,0,12,5752000.0
5752,5752999,20.577381698448814,37.76917836166303,0.08764889959213695,908.2892353534698,372.0682256221771,868.2823028564453,21687,5710,15977,15977,0,12,5753000.0
5753,5753999,20.577682008255568,37.76874424731712,0.08764132756318277,908.4793956279755,372.1302559375763,868.2411231994629,21689,5711,15978,15978,0,12,5754000.0
5754,5754999,20.578367385718565,37.769327712579816,0.0876421905068705,908.6565644741058,372.18897581100464,868.2434692382812,21691,5712,15979,15979,0,12,5755000.0
5755,5755999,20.57885468456281,37.77041195018503,0.08763829255207212,908.8532671928406,372.24967217445374,868.2480087280273,21693,5713,15980,15980,0,12,5756000.0
5756,5756999,20.579944678429598,37.77166003631365,0.08764128381897174,908.9727878570557,372.3097994327545,868.3085403442383,21693,5713,15980,15980,0,12,5757000.0
5757,5757999,20.581377044785697,37.775057782339246,0.08762434229444171,909.1285500526428,372.37331771850586,868.379222869873,21693,5713,15980,15980,0,12,5758000.0
5758,5758999,20.58272745035852,37.777971710777884,0.087631356528728,909.3170344829559,372.4349317550659,868.3992652893066,21694,5714,15980,15980,0,12,5759000.0
5759,5759999,20.58479331964164,37.783616081084816,0.08760489440083452,909.4351303577423,372.4935050010681,868.4634628295898,21694,5714,15980,15980,0,12,5760000.0
5760,5760999,20.586621786957597,37.78748419048988,0.08760238781949192,909.6764254570007,372.55582785606384,868.3666076660156,21698,5716,15982,15982,0,12,5761000.0
5761,5761999,20.588944528049442,37.794762386036865,0.08759449502362215,909.8973045349121,372.6165223121643,868.3277359008789,21702,5718,15984,15984,0,12,5762000.0
5762,5762999,20.591050226624716,37.798465836381,0.08762918855995161,910.0362558364868,372.67960572242737,868.3932991027832,21702,5718,15984,15984,0,12,5763000.0
5763,5763999,20.592217873874144,37.7998590796336,0.08767363612914492,910.1730139255524,372.7398717403412,868.4589691162109,21702,5718,15984,15984,0,12,5764000.0
5764,5764999,20.592853950383077,37.79970735485544,0.0876927157973052,910.3496286869049,372.80330753326416,868.4211463928223,21704,5719,15985,15985,0,12,5765000.0
5765,5765999,20.593217476024837,37.79970722220859,0.08770783035926222,910.5323970317841,372.8653600215912,868.7143211364746,21715,5720,15995,15995,0,12,5766000.0
5766,5766999,20.592962815713374,37.79991915273916,0.08767010282846532,910.6544597148895,372.92635202407837,869.094066619873,21716,5720,15996,15996,0,12,5767000.0
5767,5767999,20.592465609766915,37.798878837680036,0.08765173805821269,910.7911999225616,372.98753595352173,869.3416900634766,21717,5720,15997,15997,0,12,5768000.0
5768,5768999,20.591790506387426,37.797320542014454,0.08763660766881542,911.0230574607849,373.0478298664093,869.4158096313477,21734,5722,16012,16012,0,12,5769000.0
5769,5769999,20.591345340835584,37.79608984304845,0.08762336418653349,911.1908655166626,373.1081917285919,869.5338554382324,21736,5723,16013,16013,0,12,5770000.0
5770,5770999,20.590586751183196,37.79439088249947,0.08761766015723726,911.3669848442078,373.1660192012787,869.5474090576172,21738,5724,16014,16014,0,12,5771000.0
5771,5771999,20.59004620016201,37.79290439978093,0.08760046420810186,911.5396509170532,373.2266516685486,869.5941162109375,21741,5725,16016,16016,0,12,5772000.0
5772,5772999,20.589421121150668,37.79119002636744,0.0875895392640903,911.6765446662903,373.2887909412384,869.7528686523438,21741,5725,16016,16016,0,12,5773000.0
5773,5773999,20.588720207553845,37.789300001349375,0.08758400264813226,911.8164937496185,373.3486294746399,869.8576354980469,21741,5725,16016,16016,0,12,5774000.0
5774,5774999,20.587987737259944,37.787480751341604,0.0875786885931652,911.9340431690216,373.40793895721436,869.9593734741211,21741,5725,16016,16016,0,12,5775000.0
5775,5775999,20.587314260811738,37.78561784948728,0.08757034839114619,912.157833814621,373.46894884109497,869.8577270507812,21745,5727,16018,16018,0,12,5776000.0
5776,5776999,20.586869316777015,37.78407254308682,0.08756018259934206,912.2954983711243,373.5291893482208,869.9693412780762,21745,5727,16018,16018,0,12,5777000.0
5777,5777999,20.586322366763863,37.78251123169171,0.08755304351104476,912.4696431159973,373.59205627441406,869.9833602905273,21747,5728,16019,16019,0,12,5778000.0
5778,5778999,20.585900267070365,37.78115765030675,0.08754693564840621,912.7548925876617,373.6527557373047,869.8905296325684,21753,5731,16022,16022,0,12,5779000.0
5779,5779999,20.585746435037258,37.780386180027115,0.08753319603922738,912.936398267746,373.7158920764923,869.9506607055664,21755,5732,16023,16023,0,12,5780000.0
5780,5780999,20.585339468294706,37.77907055016167,0.08752560844934631,913.1159765720367,373.77790427207947,870.011402130127,21757,5733,16024,16024,0,12,5781000.0
5781,5781999,20.58501401323819,37.77775772502318,0.08752038866781808,913.2643778324127,373.84342861175537,870.1612510681152,21757,5733,16024,16024,0,12,5782000.0
5782,5782999,20.584934830598286,37.77674876866373,0.08750726411691445,913.449684381485,373.9057946205139,870.139476776123,21759,5734,16025,16025,0,12,5783000.0
5783,5783999,20.584547000772236,37.77531439392209,0.0875029446306107,913.6336195468903,373.96635031700134,870.1240196228027,21761,5735,16026,16026,0,12,5784000.0
5784,5784999,20.5839974186713,37.77360843333738,0.08750032476122815,913.7662212848663,374.02991104125977,870.2772789001465,21761,5735,16026,16026,0,12,5785000.0
5785,5785999,20.583414983618123,37.77237927619686,0.08749958162451488,913.8906235694885,374.0901310443878,870.4720153808594,21762,5735,16027,16027,0,12,5786000.0
5786,5786999,20.58210261879501,37.76993995494862,0.08750355929470643,914.0174179077148,374.1504774093628,871.067268371582,21774,5735,16039,16039,0,12,5787000.0
5787,5787999,20.58096428956108,37.76804944980932,0.08749967409833537,914.1410055160522,374.2124230861664,871.3029708862305,21774,5735,16039,16039,0,12,5788000.0
5788,5788999,20.57982982097657,37.76590804399221,0.08749597710777213,914.3234307765961,374.27259588241577,871.386302947998,21776,5736,16040,16040,0,12,5789000.0
5789,5789999,20.578970658306286,37.76492384694408,0.08748564271771353,914.5373301506042,374.3324246406555,871.4029502868652,21781,5738,16043,16043,0,12,5790000.0
5790,5790999,20.578088828263734,37.76365568050278,0.08747549388506082,914.7325694561005,374.39614057540894,871.5112457275391,21783,5739,16044,16044,0,12,5791000.0
5791,5791999,20.577114368323006,37.761813700639884,0.08746937550455647,914.8633325099945,374.4561824798584,871.6279335021973,21783,5739,16044,16044,0,12,5792000.0
5792,5792999,20.576237527576406,37.75978514497429,0.0874632673856709,914.9845085144043,374.517041683197,871.737979888916,21783,5739,16044,16044,0,12,5793000.0
5793,5793999,20.57555773551897,37.75855750082654,0.08745166323129183,915.1054608821869,374.5770218372345,871.8229484558105,21783,5739,16044,16044,0,12,5794000.0
5794,5794999,20.57498646218753,37.75690013126928,0.08744468297908314,915.3041517734528,374.6374077796936,871.8304824829102,21785,5740,16045,16045,0,12,5795000.0
5795,5795999,20.5744761506963,37.7560050857189,0.08743241110829347,915.4391188621521,374.6973328590393,871.9330673217773,21785,5740,16045,16045,0,12,5796000.0
5796,5796999,20.5739085050909,37.75439084186263,0.08742408018199077,915.6242697238922,374.759069442749,871.9134788513184,21787,5741,16046,16046,0,12,5797000.0
5797,5797999,20.573803172119355,37.75397847972166,0.0874108318093213,915.7493665218353,374.8188593387604,871.9773597717285,21787,5741,16046,16046,0,12,5798000.0
5798,5798999,20.573503451516498,37.75305920011637,0.08739738064971747,915.9690365791321,374.8789827823639,871.9285621643066,21791,5743,16048,16048,0,12,5799000.0
5799,5799999,20.57353215714918,37.75256629735038,0.08738160935562023,916.1030843257904,374.9391276836395,872.0480842590332,21791,5743,16048,16048,0,12,5800000.0
5800,5800999,20.57306159575287,37.751169170588945,0.08737345832975607,916.242959022522,374.99954080581665,872.1196823120117,21791,5743,16048,16048,0,12,5801000.0
5801,5801999,20.572898856376064,37.750306837001595,0.08736361556759165,916.3683598041534,375.059387922287,872.1818389892578,21791,5743,16048,16048,0,12,5802000.0
5802,5802999,20.57270829582259,37.74923224624778,0.08735197790291271,916.5042374134064,375.1203889846802,872.246696472168,21791,5743,16048,16048,0,12,5803000.0
5803,5803999,20.572641749374885,37.74855809007189,0.08733797438156543,916.6331720352173,375.1825544834137,872.2831001281738,21791,5743,16048,16048,0,12,5804000.0
5804,5804999,20.572322528024568,37.7471619726682,0.08732978847614292,916.9016246795654,375.24562096595764,872.0999717712402,21795,5745,16050,16050,0,12,5805000.0
5805,5805999,20.571736304488432,37.745218789401925,0.0873245361005498,917.0238881111145,375.3057210445404,872.1896324157715,21795,5745,16050,16050,0,12,5806000.0
5806,5806999,20.570949663812907,37.74309028521189,0.08732003068457539,917.1617255210876,375.36617255210876,872.8898735046387,21811,5745,16066,16066,0,12,5807000.0
5807,5807999,20.570059891674962,37.74193156552292,0.0873093753168096,917.2842125892639,375.42800283432007,873.258243560791,21811,5745,16066,16066,0,12,5808000.0
5808,5808999,20.569528401155154,37.74116397015509,0.08729166409800526,917.3954932689667,375.48760509490967,873.5356140136719,21811,5745,16066,16066,0,12,5809000.0
5809,5809999,20.569065727698998,37.739800118038815,0.08728634830377224,917.6655428409576,375.54833984375,873.6326484680176,21818,5748,16070,16070,0,12,5810000.0
5810,5810999,20.568486846870393,37.73835448973842,0.08728149072994429,917.8859553337097,375.6092267036438,873.7022819519043,21822,5750,16072,16072,0,12,5811000.0
5811,5811999,20.567782639388966,37.73732608725083,0.08727128260707928,918.1574544906616,375.67131185531616,873.6083335876465,21830,5753,16077,16077,0,12,5812000.0
5812,5812999,20.567237987175186,37.73645112058386,0.08725951667978193,918.3376085758209,375.7323172092438,873.7746849060059,21832,5754,16078,16078,0,12,5813000.0
5813,5813999,20.56666288014178,37.73510523919702,0.08725146162456221,918.4607663154602,375.7930920124054,873.9544906616211,21832,5754,16078,16078,0,12,5814000.0
5814,5814999,20.566310648457215,37.73407489470391,0.08724289650534012,918.5830225944519,375.85374999046326,874.0733299255371,21832,5754,16078,16078,0,12,5815000.0
5815,5815999,20.565761058565677,37.73307110702699,0.08723749825636218,918.7251672744751,375.9147925376892,874.1892318725586,21832,5754,16078,16078,0,12,5816000.0
5816,5816999,20.565804708452603,37.73265916452466,0.08722870130917137,918.8549950122833,375.9773771762848,874.2792358398438,21832,5754,16078,16078,0,12,5817000.0
5817,5817999,20.566155213057854,37.73336343023889,0.0872235182546387,919.1338727474213,376.0388865470886,874.2003326416016,21838,5757,16081,16081,0,12,5818000.0
5818,5818999,20.566513699857598,37.73372469194359,0.08722098597387395,919.2554864883423,376.0995969772339,874.3127784729004,21838,5757,16081,16081,0,12,5819000.0
5819,5819999,20.567186486306476,37.734824767670005,0.08722664800896707,919.5027453899384,376.1635596752167,874.1976051330566,21842,5759,16083,16083,0,12,5820000.0
5820,5820999,20.568187731786022,37.73712946818502,0.08722925381343971,919.7870790958405,376.2258687019348,874.1029167175293,21848,5762,16086,16086,0,12,5821000.0
5821,5821999,20.569497858927466,37.73986210974214,0.08723854279011611,919.9102215766907,376.28682017326355,874.2932319641113,21848,5762,16086,16086,0,12,5822000.0
5822,5822999,20.570996374113598,37.74303679173289,0.08725237878556569,920.077653169632,376.3503987789154,874.4024543762207,21850,5763,16087,16087,0,12,5823000.0
5823,5823999,20.5734981802499,37.74862701747216,0.0872645874846647,920.2427570819855,376.4220688343048,874.5308685302734,21850,5763,16087,16087,0,12,5824000.0
5824,5824999,20.57612287490435,37.756134053267246,0.08726070752204618,920.4844286441803,376.486323595047,874.4562149047852,21854,5765,16089,16089,0,12,5825000.0
5825,5825999,20.578791389767513,37.76283664514787,0.08727514742606746,920.6133651733398,376.5477030277252,874.5971260070801,21854,5765,16089,16089,0,12,5826000.0
5826,5826999,20.580807480165394,37.766216238293985,0.08729017114717141,920.8408179283142,376.60935497283936,874.608455657959,21858,5767,16091,16091,0,12,5827000.0
5827,5827999,20.580706768410973,37.765670865360384,0.08726952094860263,921.0152764320374,376.67308616638184,875.4019775390625,21881,5768,16113,16113,0,12,5828000.0
5828,5828999,20.57979759915856,37.76457097712656,0.08725779222657504,921.1534016132355,376.7342040538788,875.8042793273926,21883,5768,16115,16115,0,12,5829000.0
5829,5829999,20.57894512677262,37.763824814213976,0.08724769010305844,921.3301870822906,376.79555344581604,876.033275604248,21886,5769,16117,16117,0,12,5830000.0
5830,5830999,20.57812178490173,37.76222570439751,0.08724370742223486,921.4604246616364,376.8568022251129,876.233211517334,21886,5769,16117,16117,0,12,5831000.0
5831,5831999,20.577526533950707,37.76078149317181,0.0872369399184354,921.6745665073395,376.91741728782654,876.255126953125,21895,5771,16124,16124,0,12,5832000.0
5832,5832999,20.57683093655233,37.75953770847751,0.08723037198944972,921.9067845344543,376.9796633720398,876.3039665222168,21900,5773,16127,16127,0,12,5833000.0
5833,5833999,20.5762374243825,37.758044104346446,0.08722262972369199,922.0911386013031,377.043461561203,876.4264030456543,21903,5774,16129,16129,0,12,5834000.0
5834,5834999,20.575970050995256,37.75712336185017,0.08721635999600574,922.210618019104,377.10753774642944,876.6143836975098,21903,5774,16129,16129,0,12,5835000.0
5835,5835999,20.576253718005926,37.76009953731471,0.08719487778880053,922.3563306331635,377.16983819007874,876.7142944335938,21903,5774,16129,16129,0,12,5836000.0
5836,5836999,20.576844492485282,37.76116371946744,0.08718299779845562,922.610833644867,377.2356667518616,876.6543006896973,21908,5776,16132,16132,0,12,5837000.0
5837,5837999,20.577962875815462,37.76288117254701,0.08718214731557294,922.7825839519501,377.29641914367676,876.7579956054688,21910,5777,16133,16133,0,12,5838000.0
5838,5838999,20.5793649565606,37.76536472932328,0.08718558360119422,923.0610778331757,377.36080527305603,876.7135047912598,21928,5780,16148,16148,0,12,5839000.0
5839,5839999,20.580604574152648,37.766895907471465,0.08719313735744638,923.2441136837006,377.42509150505066,876.8174667358398,21930,5781,16149,16149,0,12,5840000.0
5840,5840999,20.58213883532,37.7688387684186,0.08719986951867498,923.3721623420715,377.48705410957336,876.936695098877,21930,5781,16149,16149,0,12,5841000.0
5841,5841999,20.584117371769263,37.77368165706662,0.08720405360314165,923.67027592659,377.5494284629822,876.7709617614746,21937,5784,16153,16153,0,12,5842000.0
5842,5842999,20.58639593218102,37.77927246793876,0.08722209601588593,923.8968620300293,377.611355304718,876.8645324707031,21941,5786,16155,16155,0,12,5843000.0
5843,5843999,20.58834825208102,37.7820312705295,0.0872461415280692,924.0804419517517,377.6728913784027,876.9929084777832,21943,5787,16156,16156,0,12,5844000.0
5844,5844999,20.591039542035663,37.788417671097186,0.08727216815769989,924.3140897750854,377.73510813713074,877.0312385559082,21947,5789,16158,16158,0,12,5845000.0
5845,5845999,20.593269992477104,37.79236225700425,0.08729581495847505,924.4453847408295,377.796790599823,877.2117347717285,21947,5789,16158,16158,0,12,5846000.0
5846,5846999,20.59621847569536,37.79707889011537,0.0873426612358329,924.6319720745087,377.8588938713074,877.2458534240723,21949,5790,16159,16159,0,12,5847000.0
5847,5847999,20.597617036402365,37.798341045193844,0.0873528449344192,924.7760901451111,377.92094326019287,877.674919128418,21958,5790,16168,16168,0,12,5848000.0
5848,5848999,20.596697369154366,37.79842997301417,0.0873451415030676,924.9536833763123,377.9819641113281,878.1529350280762,21980,5791,16189,16189,0,12,5849000.0
5849,5849999,20.59569198501885,37.79737243989929,0.08734426433149023,925.1424870491028,378.04291892051697,878.3712425231934,21984,5792,16192,16192,0,12,5850000.0
5850,5850999,20.59461874225854,37.79563017333595,0.08734754741747253,925.3604288101196,378.105441570282,878.4573593139648,21989,5794,16195,16195,0,12,5851000.0
5851,5851999,20.593610947356275,37.7937765390844,0.08734863645122626,925.4874970912933,378.16596817970276,878.636417388916,21989,5794,16195,16195,0,12,5852000.0
5852,5852999,20.592560816096963,37.795366059705955,0.08733566804125747,925.6488814353943,378.236536026001,878.7383079528809,21989,5794,16195,16195,0,12,5853000.0
5853,5853999,20.591374765938113,37.79321612281741,0.08734160664570656,925.7862079143524,378.29716634750366,878.8715362548828,21989,5794,16195,16195,0,12,5854000.0
5854,5854999,20.590140007759608,37.790927205316244,0.08734928282980958,925.9169647693634,378.3578667640686,878.9629936218262,21989,5794,16195,16195,0,12,5855000.0
5855,5855999,20.588937523247147,37.7891030568128,0.08735367328254473,926.0954113006592,378.4193477630615,879.0268936157227,21992,5795,16197,16197,0,12,5856000.0
5856,5856999,20.587764507175322,37.787104323521234,0.08735895360485713,926.288313627243,378.4802656173706,879.0274429321289,21994,5796,16198,16198,0,12,5857000.0
5857,5857999,20.586795844179512,37.78540247657852,0.08736019735405176,926.4238376617432,378.5412986278534,879.16943359375,21994,5796,16198,16198,0,12,5858000.0
5858,5858999,20.585883253243924,37.78378040249832,0.0873605270282044,926.6129217147827,378.6021547317505,879.1951484680176,21996,5797,16199,16199,0,12,5859000.0
5859,5859999,20.584765658758812,37.78165466849638,0.0873687934603562,926.7431433200836,378.6624081134796,879.3110885620117,21996,5797,16199,16199,0,12,5860000.0
5860,5860999,20.58393674137837,37.77992618769484,0.0873717878964605,926.9136946201324,378.72152757644653,879.3078765869141,21999,5798,16201,16201,0,12,5861000.0
5861,5861999,20.583111207368773,37.77852294433237,0.087373191629593,927.1387889385223,378.7826654911041,879.2209014892578,22004,5800,16204,16204,0,12,5862000.0
5862,5862999,20.582264436341156,37.77655547565991,0.08738066034463754,927.2763977050781,378.8453986644745,879.3790130615234,22004,5800,16204,16204,0,12,5863000.0
5863,5863999,20.581489326292548,37.77482110902899,0.08738363959113749,927.3962161540985,378.90602684020996,879.4921646118164,22004,5800,16204,16204,0,12,5864000.0
5864,5864999,20.58054392175029,37.77276281241734,0.08739051433359613,927.6445863246918,378.97028946876526,879.5961723327637,22014,5802,16212,16212,0,12,5865000.0
5865,5865999,20.57958014045092,37.77146953267813,0.08738709671264999,927.7591710090637,379.0309612751007,880.1616592407227,22022,5802,16220,16220,0,12,5866000.0
5866,5866999,20.578822002920113,37.771000682994824,0.08738165018690214,927.8963849544525,379.09362840652466,880.394645690918,22022,5802,16220,16220,0,12,5867000.0
5867,5867999,20.577826369892403,37.76893219299524,0.08738423802995632,928.1286263465881,379.15407490730286,880.4657325744629,22036,5804,16232,16232,0,12,5868000.0
5868,5868999,20.57734179291867,37.769132808404656,0.08736083036210551,928.2875375747681,379.21339106559753,880.6141548156738,22038,5805,16233,16233,0,12,5869000.0
5869,5869999,20.57705295329535,37.768660385611234,0.08734030362309941,928.4180641174316,379.2752523422241,880.8076705932617,22038,5805,16233,16233,0,12,5870000.0
5870,5870999,20.576539805671278,37.76713250642134,0.08733079941378741,928.5765688419342,379.3344371318817,880.8579292297363,22040,5806,16234,16234,0,12,5871000.0
5871,5871999,20.57606756707205,37.767370075004024,0.08731344661279905,928.9349484443665,379.40347695350647,880.5876655578613,22048,5810,16238,16238,0,12,5872000.0
5872,5872999,20.575375186551803,37.76600626258825,0.08730519818300286,929.1051344871521,379.4654610157013,880.7062759399414,22051,5811,16240,16240,0,12,5873000.0
5873,5873999,20.574911634259763,37.764808279046726,0.08729352493008136,929.322190284729,379.5288486480713,880.7235641479492,22055,5813,16242,16242,0,12,5874000.0
5874,5874999,20.574453897696884,37.76382295482798,0.08728326332205572,929.5366673469543,379.5906274318695,880.8093376159668,22076,5815,16261,16261,0,12,5875000.0
5875,5875999,20.574024179513884,37.76267358716681,0.08727573911019748,929.7427673339844,379.6550261974335,880.865837097168,22078,5816,16262,16262,0,12,5876000.0
5876,5876999,20.573708983762263,37.76213722655272,0.08726214663325149,929.8811020851135,379.7160429954529,880.9940567016602,22078,5816,16262,16262,0,12,5877000.0
5877,5877999,20.573737568106154,37.76156152748417,0.08725025902218408,930.0537898540497,379.78969168663025,881.1079559326172,22078,5816,16262,16262,0,12,5878000.0
5878,5878999,20.573743804970256,37.76133557699923,0.0872409614545826,930.1729865074158,379.85415482521057,881.2129974365234,22078,5816,16262,16262,0,12,5879000.0
5879,5879999,20.573856038666026,37.760815109441914,0.08723182451062939,930.342280626297,379.9156639575958,881.2546234130859,22080,5817,16263,16263,0,12,5880000.0
5880,5880999,20.57445543413751,37.76130401965886,0.08721397118795848,930.582332611084,379.97906470298767,881.2244453430176,22085,5819,16266,16266,0,12,5881000.0
5881,5881999,20.57475233189427,37.76077616809289,0.08720368193494532,930.7353482246399,380.0413956642151,881.313793182373,22085,5819,16266,16266,0,12,5882000.0
5882,5882999,20.574943337951996,37.7601443011958,0.08719687404680843,930.9040293693542,380.10335874557495,881.322639465332,22087,5820,16267,16267,0,12,5883000.0
5883,5883999,20.575330279006877,37.76068433845995,0.08717885291500416,931.0983662605286,380.16483449935913,881.3766784667969,22089,5821,16268,16268,0,12,5884000.0
5884,5884999,20.57505000106887,37.76125680710129,0.08716812352709158,931.2353317737579,380.2312808036804,881.9707374572754,22103,5821,16282,16282,0,12,5885000.0
5885,5885999,20.573986096224015,37.75900763652497,0.08716092454199464,931.3737378120422,380.2927567958832,882.3509750366211,22106,5821,16285,16285,0,12,5886000.0
5886,5886999,20.573160853294933,37.75720815233754,0.08715231647019783,931.4961743354797,380.3530924320221,882.546215057373,22106,5821,16285,16285,0,12,5887000.0
5887,5887999,20.572396940939147,37.75546199171005,0.0871444547291309,931.6232953071594,380.4152829647064,882.7149124145508,22106,5821,16285,16285,0,12,5888000.0
5888,5888999,20.57171995676694,37.75409707181476,0.08713946456572863,931.813579082489,380.4760773181915,882.7981567382812,22108,5822,16286,16286,0,12,5889000.0
5889,5889999,20.571443186470415,37.753046583438504,0.0871322608823456,931.937557220459,380.53665232658386,882.954273223877,22109,5822,16287,16287,0,12,5890000.0
5890,5890999,20.571483903287564,37.75602601516672,0.08710880761746809,932.1185266971588,380.5981822013855,883.1249504089355,22113,5823,16290,16290,0,12,5891000.0
5891,5891999,20.5709679410567,37.75465618141727,0.08710549816067525,932.2415177822113,380.66104531288147,883.2751884460449,22113,5823,16290,16290,0,12,5892000.0
5892,5892999,20.570585213576233,37.75345133716134,0.08710452913392397,932.552060842514,380.7225937843323,883.1495056152344,22121,5827,16294,16294,0,12,5893000.0
5893,5893999,20.57026617330121,37.75224506038658,0.08711098508077664,932.7263717651367,380.7842104434967,883.2662620544434,22123,5828,16295,16295,0,12,5894000.0
5894,5894999,20.569915601223975,37.75088085267843,0.0871209554862109,932.9187893867493,380.84597730636597,883.3899993896484,22125,5829,16296,16296,0,12,5895000.0
5895,5895999,20.569442790817238,37.74919216633752,0.08712433437753608,933.0912561416626,380.90962839126587,883.4231910705566,22128,5830,16298,16298,0,12,5896000.0
5896,5896999,20.569488357682708,37.7486846341419,0.08712984182065864,933.275191783905,380.97424697875977,883.5137825012207,22144,5831,16313,16313,0,12,5897000.0
5897,5897999,20.569623072590023,37.750949639973996,0.08713297918913088,933.4230051040649,381.0381352901459,883.6149444580078,22144,5831,16313,16313,0,12,5898000.0
5898,5898999,20.569743956033204,37.750598296773,0.08713725976495856,933.6188855171204,381.1025631427765,883.6229591369629,22146,5832,16314,16314,0,12,5899000.0
5899,5899999,20.569934379148172,37.7498930510801,0.08714187600712708,933.7392416000366,381.16357016563416,883.7497024536133,22146,5832,16314,16314,0,12,5900000.0
5900,5900999,20.571164283463894,37.75131861588699,0.0871642031333959,933.8603827953339,381.22718334198,883.8373222351074,22146,5832,16314,16314,0,12,5901000.0
5901,5901999,20.571943474161085,37.751795894993094,0.08716961098865594,934.0349071025848,381.28833770751953,883.8537750244141,22148,5833,16315,16315,0,12,5902000.0
5902,5902999,20.572503826216415,37.75129172676772,0.08718895008512295,934.2235488891602,381.34996819496155,883.8728675842285,22150,5834,16316,16316,0,12,5903000.0
5903,5903999,20.5729230844008,37.751044764010615,0.0871862343915093,934.4007687568665,381.4121379852295,883.9048538208008,22152,5835,16317,16317,0,12,5904000.0
5904,5904999,20.573425072582836,37.75066949419733,0.08719242105692038,934.5427162647247,381.4750018119812,884.0132675170898,22152,5835,16317,16317,0,12,5905000.0
5905,5905999,20.572827910707804,37.74899675868533,0.08719918461890808,934.6752603054047,381.5346796512604,884.8273849487305,22172,5835,16337,16337,0,12,5906000.0
5906,5906999,20.571468963995066,37.74766680473386,0.08719888917781227,934.8481390476227,381.5973093509674,885.1823120117188,22176,5836,16340,16340,0,12,5907000.0
5907,5907999,20.570273049452375,37.74595244834623,0.08719991583188713,935.0099949836731,381.6575801372528,885.4271469116211,22178,5837,16341,16341,0,12,5908000.0
5908,5908999,20.56948816486028,37.74506802713404,0.08719499702689659,935.2355978488922,381.7180185317993,885.5690956115723,22183,5839,16344,16344,0,12,5909000.0
5909,5909999,20.56847833419392,37.74309166440869,0.08719490057806067,935.3476614952087,381.7777609825134,885.7392501831055,22183,5839,16344,16344,0,12,5910000.0
5910,5910999,20.567551678866636,37.741055150802325,0.0871956179888117,935.5795660018921,381.8379738330841,885.7399253845215,22188,5841,16347,16347,0,12,5911000.0
5911,5911999,20.566513589761747,37.738991546366314,0.0871954472085198,935.7204594612122,381.898788690567,885.9222183227539,22188,5841,16347,16347,0,12,5912000.0
5912,5912999,20.56579346612976,37.73758082934745,0.087190611730951,935.8385684490204,381.95974588394165,886.0668411254883,22188,5841,16347,16347,0,12,5913000.0
5913,5913999,20.564926999751385,37.73584723223661,0.08718971511344542,935.9798817634583,382.0228579044342,886.1499824523926,22188,5841,16347,16347,0,12,5914000.0
5914,5914999,20.56444630715667,37.73699782579256,0.08717526984754254,936.1601703166962,382.0831882953644,886.2453575134277,22190,5842,16348,16348,0,12,5915000.0
5915,5915999,20.563833071759394,37.73580962006506,0.08717686440518968,936.2923753261566,382.143563747406,886.3430862426758,22190,5842,16348,16348,0,12,5916000.0
5916,5916999,20.5634823882763,37.73514312076048,0.08717370647735234,936.477771282196,382.2039542198181,886.3314056396484,22192,5843,16349,16349,0,12,5917000.0
5917,5917999,20.563206668756838,37.73414601683741,0.08716870246770558,936.5942351818085,382.2639753818512,886.4365425109863,22192,5843,16349,16349,0,12,5918000.0
5918,5918999,20.563115649953644,37.733940171415085,0.0871698830390899,936.8369958400726,382.32460260391235,886.3390083312988,22197,5845,16352,16352,0,12,5919000.0
5919,5919999,20.563337346155265,37.735445852347866,0.0871558808945786,936.9555356502533,382.38482689857483,886.4444999694824,22197,5845,16352,16352,0,12,5920000.0
5920,5920999,20.56368770542456,37.73552785895053,0.08715854334202489,937.069108247757,382.44466042518616,886.5748443603516,22197,5845,16352,16352,0,12,5921000.0
5921,5921999,20.564210988853937,37.73581803335775,0.08715932597159604,937.3128340244293,382.5052082538605,886.5299949645996,22201,5847,16354,16354,0,12,5922000.0
5922,5922999,20.564573359487014,37.73569419512213,0.08716540350607915,937.4367518424988,382.5651397705078,886.6091003417969,22201,5847,16354,16354,0,12,5923000.0
5923,5923999,20.564647327442533,37.73537367208312,0.08717370818173387,937.5813567638397,382.62521028518677,886.7041435241699,22201,5847,16354,16354,0,12,5924000.0
5924,5924999,20.564889317427575,37.73494520706865,0.08717120495773589,937.8038039207458,382.68600511550903,886.5956649780273,22205,5849,16356,16356,0,12,5925000.0
5925,5925999,20.564519388214432,37.733606710591424,0.08717772177768435,937.9232392311096,382.74765038490295,887.256649017334,22222,5849,16373,16373,0,12,5926000.0
5926,5926999,20.563045814093844,37.73117179718322,0.08718377734671168,938.045895576477,382.8074519634247,887.6935768127441,22225,5849,16376,16376,0,12,5927000.0
5927,5927999,20.56188906631231,37.72944742377536,0.08718299764651838,938.1608600616455,382.8671383857727,887.9362297058105,22225,5849,16376,16376,0,12,5928000.0
5928,5928999,20.560799809741713,37.72775623252468,0.08718284164406753,938.3835763931274,382.9299273490906,887.9572296142578,22231,5851,16380,16380,0,12,5929000.0
5929,5929999,20.55991466554283,37.72708597051449,0.0871784053214898,938.5500385761261,382.9901645183563,888.1164474487305,22233,5852,16381,16381,0,12,5930000.0
5930,5930999,20.55908107233417,37.7253148702071,0.08717450034478014,938.7228116989136,383.0498957633972,888.21728515625,22235,5853,16382,16382,0,12,5931000.0
5931,5931999,20.558067519758087,37.723387915147235,0.08717460260292031,938.9119238853455,383.11010694503784,888.2531280517578,22238,5854,16384,16384,0,12,5932000.0
5932,5932999,20.557274718316602,37.721926028763924,0.08717050299915885,939.0293338298798,383.1709797382355,888.4009475708008,22238,5854,16384,16384,0,12,5933000.0
5933,5933999,20.556439864177662,37.72003890171513,0.0871681821693947,939.2564604282379,383.2314786911011,888.3428573608398,22242,5856,16386,16386,0,12,5934000.0
5934,5934999,20.55606111984133,37.71892477605424,0.08716122068184873,939.5075182914734,383.2921166419983,888.3490753173828,22248,5858,16390,16390,0,12,5935000.0
5935,5935999,20.556058414823198,37.71840214697432,0.08715547952846336,939.6362223625183,383.3566679954529,888.5220794677734,22248,5858,16390,16390,0,12,5936000.0
5936,5936999,20.55635049923394,37.71886474143508,0.08714964741158626,939.8407893180847,383.42962741851807,888.6168441772461,22250,5859,16391,16391,0,12,5937000.0
5937,5937999,20.556891812229146,37.71935271131717,0.0871431910432563,940.0134534835815,383.49292254447937,888.7179756164551,22252,5860,16392,16392,0,12,5938000.0
5938,5938999,20.557407957702605,37.71960177388852,0.08714425201369824,940.1868226528168,383.55635619163513,888.7285995483398,22255,5861,16394,16394,0,12,5939000.0
5939,5939999,20.557957597025343,37.71991663924177,0.08714542682148874,940.5656599998474,383.61967515945435,888.5577278137207,22286,5866,16420,16420,0,12,5940000.0
5940,5940999,20.55868397724286,37.72051470363059,0.08715152346193833,940.7888679504395,383.68120193481445,888.6050682067871,22291,5868,16423,16423,0,12,5941000.0
5941,5941999,20.559914787085805,37.72179251038099,0.08714605625029603,940.9114425182343,383.7426028251648,888.7927856445312,22291,5868,16423,16423,0,12,5942000.0
5942,5942999,20.560781692148943,37.722332475784135,0.08714746523729844,941.0348253250122,383.8033504486084,888.9682960510254,22291,5868,16423,16423,0,12,5943000.0
5943,5943999,20.561441312912113,37.72246669739891,0.08714820993984829,941.2302615642548,383.86428809165955,889.0141487121582,22294,5869,16425,16425,0,12,5944000.0
5944,5944999,20.561977522582612,37.72234566633789,0.08715196445891105,941.3552749156952,383.92511677742004,889.1447525024414,22294,5869,16425,16425,0,12,5945000.0
5945,5945999,20.562415628470564,37.72178984441463,0.08715156390637468,941.5392863750458,383.9857180118561,889.1893692016602,22296,5870,16426,16426,0,12,5946000.0
5946,5946999,20.56163160622661,37.72021200817775,0.0871464847186868,941.6613202095032,384.04800748825073,890.3677597045898,22324,5870,16454,16454,0,12,5947000.0
5947,5947999,20.56058753105655,37.71858682867715,0.08714351909631368,941.7611908912659,384.10624289512634,890.8062286376953,22324,5870,16454,16454,0,12,5948000.0
5948,5948999,20.559861854563813,37.717664141489294,0.08713890748495723,941.9872360229492,384.1700131893158,890.9663963317871,22329,5872,16457,16457,0,12,5949000.0
5949,5949999,20.559105145781743,37.715947566078,0.08714026831110755,942.1503188610077,384.2302179336548,891.1872406005859,22331,5873,16458,16458,0,12,5950000.0
5950,5950999,20.558373199197273,37.71422347450904,0.08713828428154347,942.2702960968018,384.29042387008667,891.4547462463379,22331,5873,16458,16458,0,12,5951000.0
5951,5951999,20.557917423170732,37.713863428189306,0.08713015695227322,942.597573518753,384.3521087169647,891.4474906921387,22339,5877,16462,16462,0,12,5952000.0
5952,5952999,20.55707466407552,37.71220620545002,0.08712592272117003,942.8217425346375,384.4156403541565,891.5491561889648,22343,5879,16464,16464,0,12,5953000.0
5953,5953999,20.55645007762887,37.71058121833821,0.08712602908253975,942.9424638748169,384.4844813346863,891.7828063964844,22343,5879,16464,16464,0,12,5954000.0
5954,5954999,20.556082127488125,37.7099039721746,0.0871203508903079,943.1284203529358,384.5455758571625,891.8847503662109,22352,5880,16472,16472,0,12,5955000.0
5955,5955999,20.555711184894033,37.70866887014955,0.0871191672845617,943.4552540779114,384.60750341415405,891.7987442016602,22362,5884,16478,16478,0,12,5956000.0
5956,5956999,20.555220658140147,37.70760364518859,0.08712033354008131,943.6249568462372,384.6714723110199,891.9688606262207,22364,5885,16479,16479,0,12,5957000.0
5957,5957999,20.55504423406852,37.706521813517554,0.08712226714642979,943.8747804164886,384.7333605289459,892.0698432922363,22368,5887,16481,16481,0,12,5958000.0
5958,5958999,20.55492217085786,37.70644041663707,0.0871254922503687,943.9968049526215,384.79554533958435,892.247127532959,22368,5887,16481,16481,0,12,5959000.0
5959,5959999,20.555054782927638,37.70641761221943,0.08713479988320305,944.1650137901306,384.8568048477173,892.3335571289062,22370,5888,16482,16482,0,12,5960000.0
5960,5960999,20.55490277385442,37.70567375750582,0.08713800546213357,944.3438782691956,384.91806197166443,892.3551864624023,22372,5889,16483,16483,0,12,5961000.0
5961,5961999,20.555286752356366,37.70620156836635,0.08714089535027869,944.5112550258636,384.97914242744446,892.4916572570801,22374,5890,16484,16484,0,12,5962000.0
5962,5962999,20.555422694289984,37.70570875113234,0.08714619088112951,944.6263015270233,385.04000067710876,892.6438255310059,22374,5890,16484,16484,0,12,5963000.0
5963,5963999,20.55551640349064,37.705051430036654,0.08715177575026378,944.8268582820892,385.1012108325958,892.6972961425781,22376,5891,16485,16485,0,12,5964000.0
5964,5964999,20.55571190723569,37.70468631389549,0.08714692112649214,944.9685513973236,385.1635100841522,892.8161468505859,22376,5891,16485,16485,0,12,5965000.0
5965,5965999,20.55631658661396,37.704582218731865,0.08714105882788947,945.0940892696381,385.224648475647,892.9131050109863,22376,5891,16485,16485,0,12,5966000.0
5966,5966999,20.55603570434033,37.70328180423599,0.08713515027211838,945.2700781822205,385.28723311424255,892.9723739624023,22378,5892,16486,16486,0,12,5967000.0
5967,5967999,20.555794496025904,37.70335045590084,0.08709763395581549,945.3920269012451,385.34890818595886,894.0656394958496,22403,5892,16511,16511,0,12,5968000.0
5968,5968999,20.554814774302432,37.701254893732475,0.08709674953358049,945.4959967136383,385.4098000526428,894.5013236999512,22404,5892,16512,16512,0,12,5969000.0
5969,5969999,20.55381650392784,37.699211008067905,0.08709619103506105,945.7794392108917,385.4741463661194,894.6179046630859,22412,5895,16517,16517,0,12,5970000.0
5970,5970999,20.55326032580912,37.69780677125242,0.08709319136789684,945.9926879405975,385.53496742248535,894.7858772277832,22416,5897,16519,16519,0,12,5971000.0
5971,5971999,20.55264702435931,37.69664582474261,0.08708797069250818,946.1614942550659,385.59632420539856,894.9332466125488,22419,5898,16521,16521,0,12,5972000.0
5972,5972999,20.552174208283645,37.69560228231187,0.08708003210352488,946.3818352222443,385.65623807907104,895.026912689209,22423,5900,16523,16523,0,12,5973000.0
5973,5973999,20.551716923360658,37.69733312346929,0.08706514360173068,946.6671488285065,385.7291786670685,895.0296058654785,22431,5903,16528,16528,0,12,5974000.0
5974,5974999,20.55108656967487,37.695716739540345,0.08706294136540449,946.8946449756622,385.7933349609375,895.2506523132324,22435,5905,16530,16530,0,12,5975000.0
5975,5975999,20.550791027658274,37.694612639494146,0.08705797759450651,947.0687820911407,385.85476756095886,895.377197265625,22438,5906,16532,16532,0,12,5976000.0
5976,5976999,20.550847712649407,37.69467982587881,0.08704399810513785,947.2019486427307,385.9163842201233,895.5739631652832,22438,5906,16532,16532,0,12,5977000.0
5977,5977999,20.5511046197484,37.695381462379935,0.08704260466758618,947.3280465602875,385.9776773452759,895.7263336181641,22438,5906,16532,16532,0,12,5978000.0
5978,5978999,20.551382169335785,37.69745288962637,0.08703705722475141,947.560045003891,386.0395812988281,895.6440124511719,22449,5908,16541,16541,0,12,5979000.0
5979,5979999,20.551859677837676,37.698147570938374,0.08702916828717744,947.7793004512787,386.10107016563416,895.6820030212402,22461,5910,16551,16551,0,12,5980000.0
5980,5980999,20.55265430581215,37.69998169636898,0.08701924531622007,947.9490294456482,386.1623373031616,895.7978744506836,22463,5911,16552,16552,0,12,5981000.0
5981,5981999,20.55335348004409,37.70094909309596,0.08701037157210356,948.0798237323761,386.22351908683777,895.9708213806152,22463,5911,16552,16552,0,12,5982000.0
5982,5982999,20.554248542332065,37.702493052461854,0.08700881869127064,948.2519447803497,386.2848131656647,896.0723648071289,22465,5912,16553,16553,0,12,5983000.0
5983,5983999,20.555114799572564,37.70364496985987,0.08700507192402229,948.4832308292389,386.34651350975037,896.105598449707,22469,5914,16555,16555,0,12,5984000.0
5984,5984999,20.556018585012925,37.704843584287936,0.0870121973903848,948.6694905757904,386.4080731868744,896.1342086791992,22471,5915,16556,16556,0,12,5985000.0
5985,5985999,20.557155291689742,37.70642218311407,0.08701161710750394,948.8025374412537,386.46979665756226,896.2842826843262,22471,5915,16556,16556,0,12,5986000.0
5986,5986999,20.558616329384176,37.70872495968626,0.08701777457836113,949.0277445316315,386.53270292282104,896.334644317627,22475,5917,16558,16558,0,12,5987000.0
5987,5987999,20.558968397198683,37.70846565497516,0.08701846935324153,949.146406173706,386.59517002105713,896.5709533691406,22475,5917,16558,16558,0,12,5988000.0
5988,5988999,20.55794133216348,37.706985133690566,0.08701290704241238,949.2622225284576,386.6565852165222,897.6926498413086,22499,5917,16582,16582,0,12,5989000.0
5989,5989999,20.556455262553467,37.70513659534015,0.0870192933346311,949.3872547149658,386.7167146205902,898.0593490600586,22499,5917,16582,16582,0,12,5990000.0
5990,5990999,20.55530472398213,37.703927611511034,0.08702082843898606,949.6113212108612,386.77799820899963,898.275562286377,22503,5919,16584,16584,0,12,5991000.0
5991,5991999,20.554152486438245,37.70209972526113,0.08702560591040309,949.7212536334991,386.8381404876709,898.5026054382324,22503,5919,16584,16584,0,12,5992000.0
5992,5992999,20.553009326162975,37.7003909665004,0.08702681777774568,949.8321647644043,386.89798641204834,898.6844177246094,22503,5919,16584,16584,0,12,5993000.0
5993,5993999,20.551790379201922,37.69838016682608,0.08703238884027487,949.9969866275787,386.9584574699402,898.7596702575684,22505,5920,16585,16585,0,12,5994000.0
5994,5994999,20.550594623631618,37.696213637087595,0.08703737634794795,950.1363747119904,387.0192494392395,898.9365310668945,22505,5920,16585,16585,0,12,5995000.0
5995,5995999,20.549936376496355,37.69546081284002,0.08703120069421888,950.3054521083832,387.0804793834686,898.9620132446289,22507,5921,16586,16586,0,12,5996000.0
5996,5996999,20.549033863538284,37.69419469250234,0.08703303725404576,950.5320250988007,387.1417384147644,898.9558067321777,22513,5923,16590,16590,0,12,5997000.0
5997,5997999,20.548459224140935,37.693392013262475,0.08702550418576216,950.7561836242676,387.20303201675415,898.9897613525391,22517,5925,16592,16592,0,12,5998000.0
5998,5998999,20.54790975254151,37.69250604167393,0.08702126390835119,950.8742814064026,387.26362919807434,899.1534004211426,22517,5925,16592,16592,0,12,5999000.0
5999,5999999,20.547286385250626,37.6916337478618,0.08701827518870264,951.070814371109,387.3280975818634,899.1965370178223,22519,5926,16593,16593,0,12,6000000.0
6000,6000999,20.546835899751404,37.690876625757454,0.08702149513358814,951.2371492385864,387.390353679657,899.2922744750977,22522,5927,16595,16595,0,12,6001000.0
6001,6001999,20.546269108562047,37.68963917206652,0.08702408868947276,951.4273269176483,387.4541652202606,899.3758087158203,22524,5928,16596,16596,0,12,6002000.0
6002,6002999,20.545418232953345,37.68775029001157,0.08703366879390817,951.6119465827942,387.5187249183655,899.4776916503906,22527,5929,16598,16598,0,12,6003000.0
6003,6003999,20.544621010630728,37.68604351814781,0.08704108210729988,951.7944543361664,387.582927942276,899.5429306030273,22531,5930,16601,16601,0,12,6004000.0
6004,6004999,20.54360722051533,37.68385476213884,0.0870512933370986,951.9865713119507,387.64393043518066,899.6377220153809,22535,5931,16604,16604,0,12,6005000.0
6005,6005999,20.542751256617624,37.68262960840463,0.08705277814293388,952.110348701477,387.70634269714355,900.4751930236816,22556,5931,16625,16625,0,12,6006000.0
6006,6006999,20.54149735541431,37.68096785011805,0.0870620097624406,952.2202205657959,387.76654028892517,900.7740631103516,22556,5931,16625,16625,0,12,6007000.0
6007,6007999,20.54075717112616,37.687429677321916,0.08703010742838235,952.4513747692108,387.82714223861694,900.8727684020996,22561,5933,16628,16628,0,12,6008000.0
6008,6008999,20.540286494180418,37.69004886236915,0.08701825697114762,952.565506696701,387.8858528137207,901.1225395202637,22561,5933,16628,16628,0,12,6009000.0
6009,6009999,20.539382715776966,37.68836690187753,0.08701833094855682,952.7448744773865,387.95004391670227,901.2571144104004,22563,5934,16629,16629,0,12,6010000.0
6010,6010999,20.538495450784197,37.68673295464662,0.08701825947552033,952.9226379394531,388.01090264320374,901.3653411865234,22568,5935,16633,16633,0,12,6011000.0
6011,6011999,20.537518920923983,37.68487126468523,0.08701988396412053,953.1435837745667,388.07272148132324,901.4388580322266,22572,5937,16635,16635,0,12,6012000.0
6012,6012999,20.53675930342762,37.68352778908698,0.08701633152825428,953.2679052352905,388.13314604759216,901.5949440002441,22572,5937,16635,16635,0,12,6013000.0
6013,6013999,20.53616216864553,37.682298860326796,0.08701358934013004,953.460283279419,388.19376587867737,901.6670150756836,22574,5938,16636,16636,0,12,6014000.0
6014,6014999,20.53561351242549,37.68116085561522,0.0870053086214887,953.6496961116791,388.25808572769165,901.7512512207031,22576,5939,16637,16637,0,12,6015000.0
6015,6015999,20.534955523978308,37.67994939927039,0.08699875949747538,953.8171200752258,388.3189470767975,901.7438468933105,22578,5940,16638,16638,0,12,6016000.0
6016,6016999,20.534296252575505,37.67844803827681,0.08699397835976896,953.9321665763855,388.37927746772766,901.8709716796875,22578,5940,16638,16638,0,12,6017000.0
6017,6017999,20.533931046356308,37.677680530141195,0.08698420393175799,954.1033909320831,388.44131088256836,901.9221878051758,22581,5941,16640,16640,0,12,6018000.0
6018,6018999,20.533666475639762,37.67833757386389,0.08696837893065779,954.2952923774719,388.5015518665314,901.9152984619141,22585,5942,16643,16643,0,12,6019000.0
6019,6019999,20.533354493513432,37.677287169225096,0.08696203274897829,954.4257423877716,388.56385374069214,902.0369262695312,22585,5942,16643,16643,0,12,6020000.0
6020,6020999,20.533381861020416,37.67711517898097,0.08695096056100093,954.7177815437317,388.6272597312927,901.9221000671387,22593,5945,16648,16648,0,12,6021000.0
6021,6021999,20.533118833266155,37.6764535610404,0.08694332329164434,954.8494453430176,388.6883463859558,902.0358200073242,22593,5945,16648,16648,0,12,6022000.0
6022,6022999,20.532695879098757,37.675186726937184,0.08694002359527164,955.1313772201538,388.750301361084,901.8664283752441,22607,5948,16659,16659,0,12,6023000.0
6023,6023999,20.532110871070063,37.67347092717084,0.08693998657597446,955.2518873214722,388.81007504463196,902.0265808105469,22607,5948,16659,16659,0,12,6024000.0
6024,6024999,20.53136707731016,37.671862959860164,0.08694092453418689,955.4837427139282,388.87440967559814,902.5147933959961,22628,5950,16678,16678,0,12,6025000.0
6025,6025999,20.5306088429962,37.67142492261614,0.0869308650260866,955.5966210365295,388.9354889392853,903.1271896362305,22638,5950,16688,16688,0,12,6026000.0
6026,6026999,20.529316884405723,37.66907892222002,0.08693591478182616,955.7694561481476,388.9956052303314,903.4188690185547,22641,5951,16690,16690,0,12,6027000.0
6027,6027999,20.528093991615194,37.66745918002745,0.0869371636388171,955.8821918964386,389.05577325820923,903.6896896362305,22641,5951,16690,16690,0,12,6028000.0
6028,6028999,20.526957528975974,37.665409658496415,0.08694108618346563,956.1113016605377,389.1172218322754,903.7552452087402,22645,5953,16692,16692,0,12,6029000.0
6029,6029999,20.525907442096553,37.66375586488421,0.08693898236502118,956.3321900367737,389.1782011985779,903.7852592468262,22654,5955,16699,16699,0,12,6030000.0
6030,6030999,20.524977317724137,37.662823317376095,0.08693794621303674,956.5261287689209,389.24076747894287,903.9469337463379,22656,5956,16700,16700,0,12,6031000.0
6031,6031999,20.523974237412638,37.66083323721613,0.08694062254072132,956.7327923774719,389.3017363548279,903.9832954406738,22661,5958,16703,16703,0,12,6032000.0
6032,6032999,20.52278410035803,37.65863780384851,0.08694605889265761,956.998236656189,389.3621370792389,903.970401763916,22668,5961,16707,16707,0,12,6033000.0
6033,6033999,20.52189070524965,37.65691067245146,0.08694736706934347,957.1717190742493,389.4232943058014,904.1265640258789,22670,5962,16708,16708,0,12,6034000.0
6034,6034999,20.520955986556352,37.65544025211627,0.08694942663318483,957.3399565219879,389.48426842689514,904.2359962463379,22672,5963,16709,16709,0,12,6035000.0
6035,6035999,20.52006181856298,37.653652430530535,0.08695255635870547,957.5622327327728,389.5455279350281,904.2252388000488,22678,5965,16713,16713,0,12,6036000.0
6036,6036999,20.519327735118782,37.65207158632992,0.08695938089228983,957.6932356357574,389.60826301574707,904.3947525024414,22678,5965,16713,16713,0,12,6037000.0
6037,6037999,20.51862522996814,37.65078132109282,0.0869655087940544,957.9141829013824,389.66943860054016,904.4498519897461,22682,5967,16715,16715,0,12,6038000.0
6038,6038999,20.51793883635365,37.64916336311616,0.08697419005266904,958.136430978775,389.7316086292267,904.5966415405273,22707,5969,16738,16738,0,12,6039000.0
6039,6039999,20.517081243161996,37.647512305743966,0.08698089589243185,958.2632956504822,389.7927973270416,904.7437019348145,22707,5969,16738,16738,0,12,6040000.0
6040,6040999,20.51613910114784,37.645631215271926,0.0869910044920521,958.4447553157806,389.8538167476654,904.830249786377,22709,5970,16739,16739,0,12,6041000.0
6041,6041999,20.515545315077905,37.64434454613375,0.08699083576825073,958.6179964542389,389.9148941040039,904.8716773986816,22711,5971,16740,16740,0,12,6042000.0
6042,6042999,20.51467145839128,37.64246156387724,0.08700009752159632,958.781756401062,389.9746584892273,904.9207611083984,22713,5972,16741,16741,0,12,6043000.0
6043,6043999,20.51387550702465,37.640773945682966,0.0870049851371264,958.9274983406067,390.0389621257782,905.0310020446777,22713,5972,16741,16741,0,12,6044000.0
6044,6044999,20.513104653189234,37.63909268543245,0.08701122885312862,959.0615742206573,390.1035532951355,905.1598472595215,22713,5972,16741,16741,0,12,6045000.0
6045,6045999,20.51200951014025,37.63690857825235,0.08702202349650956,959.3428499698639,390.16969323158264,905.8102989196777,22738,5975,16763,16763,0,12,6046000.0
6046,6046999,20.510678049605563,37.635953081806704,0.08702949353570688,959.457492351532,390.22989678382874,906.4319114685059,22743,5975,16768,16768,0,12,6047000.0
6047,6047999,20.509211351081596,37.63438296355571,0.08703881412101344,959.5693616867065,390.29062247276306,906.7732315063477,22744,5975,16769,16769,0,12,6048000.0
6048,6048999,20.507738026897652,37.63204627432273,0.0870519752355412,959.9066116809845,390.35733342170715,906.8264389038086,22759,5979,16780,16780,0,12,6049000.0
6049,6049999,20.50638583624955,37.630011130088484,0.0870637348450154,960.1264591217041,390.4204857349396,906.9894943237305,22763,5981,16782,16782,0,12,6050000.0
6050,6050999,20.505096681174688,37.627672248877154,0.08707288590916618,960.3068912029266,390.48517298698425,907.1597862243652,22765,5982,16783,16783,0,12,6051000.0
6051,6051999,20.503755465697946,37.62546041324435,0.08708834150665445,960.5368320941925,390.5462558269501,907.2260780334473,22771,5984,16787,16787,0,12,6052000.0
6052,6052999,20.50234072673347,37.62309096814606,0.0871057985566428,960.7130227088928,390.6069040298462,907.3285522460938,22775,5985,16790,16790,0,12,6053000.0
6053,6053999,20.50100284128175,37.62085958289072,0.08711719729868872,960.8824734687805,390.6673400402069,907.4296340942383,22777,5986,16791,16791,0,12,6054000.0
6054,6054999,20.499857694160287,37.618846429483064,0.08712919250439921,961.1250984668732,390.7293231487274,907.4361839294434,22781,5988,16793,16793,0,12,6055000.0
6055,6055999,20.498600220966793,37.61665879146972,0.08714590435661096,961.2392776012421,390.7900264263153,907.6290588378906,22781,5988,16793,16793,0,12,6056000.0
6056,6056999,20.497253680961272,37.61448024101456,0.08716161649686693,961.4175646305084,390.85137939453125,907.7052803039551,22783,5989,16794,16794,0,12,6057000.0
6057,6057999,20.495980629891935,37.6123547249726,0.08717748466245456,961.6022870540619,390.9128386974335,907.7376136779785,22787,5990,16797,16797,0,12,6058000.0
6058,6058999,20.494486505788583,37.60988963814869,0.08719564294038062,961.7616980075836,390.9736452102661,907.8335571289062,22811,5991,16820,16820,0,12,6059000.0
6059,6059999,20.49322154347251,37.60803631435197,0.0872064887790247,961.9043323993683,391.03812313079834,908.0004501342773,22811,5991,16820,16820,0,12,6060000.0
6060,6060999,20.49204954584542,37.60633939078468,0.0872195372188379,962.1016833782196,391.1005964279175,908.0933647155762,22813,5992,16821,16821,0,12,6061000.0
6061,6061999,20.490937457940973,37.60433975905946,0.08722827437453895,962.2635674476624,391.16167521476746,908.1270065307617,22815,5993,16822,16822,0,12,6062000.0
6062,6062999,20.490111314754653,37.603176722476505,0.08723608260280813,962.3891785144806,391.2241349220276,908.243350982666,22815,5993,16822,16822,0,12,6063000.0
6063,6063999,20.489254296868545,37.601958847007246,0.08724166203600603,962.5321335792542,391.2876136302948,908.354362487793,22815,5993,16822,16822,0,12,6064000.0
6064,6064999,20.48828522854383,37.600365815391264,0.08725435987207908,962.7100067138672,391.34868478775024,908.3706474304199,22817,5994,16823,16823,0,12,6065000.0
6065,6065999,20.4870467102619,37.59809303023379,0.08727138590498829,962.889092206955,391.4097406864166,908.4727096557617,22819,5995,16824,16824,0,12,6066000.0
6066,6066999,20.485641065129716,37.59582618618102,0.08728547391391617,963.0102779865265,391.47454476356506,909.556713104248,22843,5995,16848,16848,0,12,6067000.0
6067,6067999,20.48405473142803,37.5934441771961,0.08729803100759692,963.146071434021,391.5449779033661,909.9159851074219,22843,5995,16848,16848,0,12,6068000.0
6068,6068999,20.482813359352733,37.59176095500563,0.0873053438972704,963.3591406345367,391.60543060302734,910.0062980651855,22850,5997,16853,16853,0,12,6069000.0
6069,6069999,20.481565709124137,37.589668376776274,0.08731568963146341,963.5248460769653,391.6690332889557,910.2080078125,22852,5998,16854,16854,0,12,6070000.0
6070,6070999,20.480526563100575,37.58802132262326,0.08732277624576323,963.7453825473785,391.7323794364929,910.3110847473145,22856,6000,16856,16856,0,12,6071000.0
6071,6071999,20.47926199730881,37.58593665674286,0.08733280898616702,964.2197606563568,391.7943263053894,910.1366653442383,22870,6007,16863,16863,0,12,6072000.0
6072,6072999,20.47818551736258,37.584223682430114,0.0873398037734705,964.4368517398834,391.85745573043823,910.3441047668457,22879,6009,16870,16870,0,12,6073000.0
6073,6073999,20.477052226098944,37.582410670216596,0.08735212923798918,964.6186957359314,391.9237439632416,910.5118446350098,22885,6010,16875,16875,0,12,6074000.0
6074,6074999,20.476188800633633,37.58094125829324,0.08736077446282098,964.8568484783173,391.98582911491394,910.638671875,22889,6012,16877,16877,0,12,6075000.0
6075,6075999,20.475152652669998,37.579542447211516,0.08736975470184272,964.9770426750183,392.04653000831604,910.7959403991699,22889,6012,16877,16877,0,12,6076000.0
6076,6076999,20.474113103295174,37.57781248459952,0.08737718165761255,965.110132932663,392.11109137535095,910.9500732421875,22889,6012,16877,16877,0,12,6077000.0
6077,6077999,20.473153526747762,37.57598118982908,0.08738661361432143,965.347719669342,392.1720516681671,910.9451789855957,22894,6014,16880,16880,0,12,6078000.0
6078,6078999,20.472040820579505,37.57404876598093,0.0873982705836136,965.5197122097015,392.2333426475525,910.9198799133301,22898,6015,16883,16883,0,12,6079000.0
6079,6079999,20.47093507406851,37.572092888754504,0.08741024743967507,965.697984457016,392.2946500778198,910.9887733459473,22902,6016,16886,16886,0,12,6080000.0
6080,6080999,20.469919563838506,37.57020700867706,0.08742389542566809,965.9358260631561,392.35681223869324,911.0252838134766,22906,6018,16888,16888,0,12,6081000.0
6081,6081999,20.468742984635238,37.568101709761734,0.08743692396485314,966.0537016391754,392.41916251182556,911.1814651489258,22906,6018,16888,16888,0,12,6082000.0
6082,6082999,20.46767259147822,37.566190787274415,0.0874489940051949,966.1794393062592,392.4803726673126,911.3180847167969,22906,6018,16888,16888,0,12,6083000.0
6083,6083999,20.466711544181223,37.56517413213214,0.08745626838761456,966.346275806427,392.541455745697,911.3539352416992,22908,6019,16889,16889,0,12,6084000.0
6084,6084999,20.46553333914094,37.56307346155766,0.08747260138560298,966.4697232246399,392.60240602493286,911.4652709960938,22908,6019,16889,16889,0,12,6085000.0
6085,6085999,20.464169406029086,37.56081866533838,0.08748947701537613,966.6127359867096,392.6631910800934,911.6107292175293,22908,6019,16889,16889,0,12,6086000.0
6086,6086999,20.462821817037348,37.55865768202063,0.08749899203369782,966.7844114303589,392.7416846752167,912.210994720459,22919,6020,16899,16899,0,12,6087000.0
6087,6087999,20.461089054543383,37.55635383695052,0.08750805126552608,966.908239364624,392.7995970249176,912.4847564697266,22921,6020,16901,16901,0,12,6088000.0
6088,6088999,20.45948362104014,37.55469874056453,0.08751096463122854,967.0786144733429,392.8575415611267,913.0732650756836,22940,6021,16919,16919,0,12,6089000.0
6089,6089999,20.458188779719798,37.55293573226299,0.08751423790185131,967.1834239959717,392.9182255268097,913.5418510437012,22941,6021,16920,16920,0,12,6090000.0
6090,6090999,20.456873131327,37.55072060724605,0.08751872376154657,967.2973299026489,392.9761872291565,913.863956451416,22944,6021,16923,16923,0,12,6091000.0
6091,6091999,20.455489573373537,37.54852323677557,0.0875224579130447,967.4147844314575,393.03458976745605,914.0723571777344,22944,6021,16923,16923,0,12,6092000.0
6092,6092999,20.454156603363593,37.54772736872574,0.08752063078376171,967.5355522632599,393.094069480896,914.2655372619629,22944,6021,16923,16923,0,12,6093000.0
6093,6093999,20.453029401851786,37.5458789950981,0.0875232479238014,967.6564130783081,393.15241861343384,914.4282569885254,22945,6021,16924,16924,0,12,6094000.0
6094,6094999,20.4518629278461,37.5437442134248,0.08752601324156939,967.8802480697632,393.2107973098755,914.4545631408691,22950,6023,16927,16927,0,12,6095000.0
6095,6095999,20.45088125990212,37.54193628066218,0.08752643199664101,967.9906423091888,393.2686011791229,914.6420707702637,22950,6023,16927,16927,0,12,6096000.0
6096,6096999,20.449886373865162,37.54004049027659,0.08752936103484565,968.2198524475098,393.3271143436432,914.647647857666,22954,6025,16929,16929,0,12,6097000.0
6097,6097999,20.44881248204821,37.53793800910316,0.08753825382899283,968.4314942359924,393.3855137825012,914.6971168518066,22958,6027,16931,16931,0,12,6098000.0
6098,6098999,20.44768763067553,37.536216220323965,0.08754512752927601,968.6422944068909,393.453031539917,914.8154830932617,22960,6028,16932,16932,0,12,6099000.0
6099,6099999,20.446696345409897,37.534626423888454,0.08754791049888822,968.8108477592468,393.511234998703,914.8668594360352,22962,6029,16933,16933,0,12,6100000.0
6100,6100999,20.445628376325715,37.53273389312977,0.08755115000551272,969.0235538482666,393.58076095581055,914.9456977844238,22965,6030,16935,16935,0,12,6101000.0
6101,6101999,20.444647463721587,37.53083099105967,0.08756067310466675,969.1463711261749,393.6393804550171,915.0743103027344,22965,6030,16935,16935,0,12,6102000.0
6102,6102999,20.443651647137155,37.528942161331564,0.08756309670266693,969.2767913341522,393.6990313529968,915.200065612793,22965,6030,16935,16935,0,12,6103000.0
6103,6103999,20.4430034006737,37.52759566584229,0.08756271492862067,969.3989894390106,393.757052898407,915.2784652709961,22965,6030,16935,16935,0,12,6104000.0
6104,6104999,20.442089750739946,37.5268477496014,0.08755906557939352,969.5188500881195,393.8149199485779,915.3817672729492,22966,6030,16936,16936,0,12,6105000.0
6105,6105999,20.44108875637634,37.52487199393521,0.08756279804449751,969.701464176178,393.87378764152527,915.3903121948242,22968,6031,16937,16937,0,12,6106000.0
6106,6106999,20.44002572084449,37.52287164144135,0.08756879338581569,969.9353704452515,393.93267726898193,915.4364852905273,22972,6033,16939,16939,0,12,6107000.0
6107,6107999,20.439088898348103,37.52135019962232,0.08756843117878288,970.1094515323639,393.99133110046387,915.8562164306641,22982,6034,16948,16948,0,12,6108000.0
6108,6108999,20.438118831934442,37.52035989676323,0.08755747987847207,970.2949106693268,394.0503509044647,916.0291633605957,22985,6035,16950,16950,0,12,6109000.0
6109,6109999,20.436782982890307,37.5181405345981,0.08756236124804928,970.4085631370544,394.11111092567444,916.180778503418,22985,6035,16950,16950,0,12,6110000.0
6110,6110999,20.435732212781893,37.51599267603177,0.08756552745503432,970.5409471988678,394.1697289943695,916.2965393066406,22985,6035,16950,16950,0,12,6111000.0
6111,6111999,20.43487723188821,37.5144678768909,0.08756108943349616,970.7243037223816,394.2289366722107,916.3245887756348,22987,6036,16951,16951,0,12,6112000.0
6112,6112999,20.43401960247141,37.51289764068616,0.08755946192230568,970.9564731121063,394.2873969078064,916.320499420166,22992,6038,16954,16954,0,12,6113000.0
6113,6113999,20.43317199894087,37.51130345381864,0.0875575022423154,971.134580373764,394.3456826210022,916.253044128418,22994,6039,16955,16955,0,12,6114000.0
6114,6114999,20.432206973328373,37.509437147652406,0.08755926949650816,971.3470773696899,394.4045145511627,916.3324851989746,22998,6041,16957,16957,0,12,6115000.0
6115,6115999,20.431208406540254,37.50744754792789,0.08756161190384759,971.4584286212921,394.462993144989,916.4631729125977,22998,6041,16957,16957,0,12,6116000.0
6116,6116999,20.43048107184271,37.506090698160875,0.08756008322687747,971.7669413089752,394.52336835861206,916.2686195373535,23004,6044,16960,16960,0,12,6117000.0
6117,6117999,20.429479181817342,37.50421884573216,0.08756396787788756,971.9022660255432,394.58468079566956,916.4730834960938,23004,6044,16960,16960,0,12,6118000.0
6118,6118999,20.428664192338463,37.50265940577751,0.08756240585310315,972.1191051006317,394.64379477500916,916.4201431274414,23008,6046,16962,16962,0,12,6119000.0
6119,6119999,20.42782661357042,37.501196093085085,0.08756384209775492,972.3497533798218,394.7034339904785,916.4486503601074,23012,6048,16964,16964,0,12,6120000.0
6120,6120999,20.42703183452753,37.49963710223293,0.08756033138897257,972.4707198143005,394.76494431495667,916.575927734375,23012,6048,16964,16964,0,12,6121000.0
6121,6121999,20.426383705631057,37.49839074252847,0.08755714877595311,972.6030049324036,394.82590770721436,916.7059555053711,23012,6048,16964,16964,0,12,6122000.0
6122,6122999,20.425582401066368,37.49710169065526,0.08755574098776653,972.7592713832855,394.88617610931396,916.8138580322266,23012,6048,16964,16964,0,12,6123000.0
6123,6123999,20.424924598690744,37.49578769665289,0.08755263691305559,972.8662219047546,394.94607424736023,916.9138870239258,23012,6048,16964,16964,0,12,6124000.0
6124,6124999,20.424304639911416,37.49442144501219,0.08755046002247169,973.0556993484497,395.0079610347748,916.9241333007812,23015,6049,16966,16966,0,12,6125000.0
6125,6125999,20.42363991382176,37.492908171020254,0.08754861159166705,973.2374265193939,395.0672719478607,916.9281539916992,23017,6050,16967,16967,0,12,6126000.0
6126,6126999,20.42301830888237,37.491467100495036,0.08754654457424593,973.3542230129242,395.12578225135803,917.0084838867188,23017,6050,16967,16967,0,12,6127000.0
6127,6127999,20.422248893930014,37.49023380646581,0.08754376149237941,973.5433573722839,395.18472623825073,917.0509262084961,23019,6051,16968,16968,0,12,6128000.0
6128,6128999,20.421304604032986,37.4884371792174,0.08755057642095121,973.6697716712952,395.24412298202515,917.4428558349609,23024,6051,16973,16973,0,12,6129000.0
6129,6129999,20.42019123309562,37.486697002972896,0.08755665333130236,973.8530237674713,395.30303597450256,917.5100059509277,23026,6052,16974,16974,0,12,6130000.0
6130,6130999,20.41906313338679,37.484503944016744,0.08756621853899405,974.016339302063,395.3619382381439,917.6559524536133,23028,6053,16975,16975,0,12,6131000.0
6131,6131999,20.418273798363046,37.48346012463098,0.08756464024501098,974.1400835514069,395.4203999042511,917.7510147094727,23028,6053,16975,16975,0,12,6132000.0
6132,6132999,20.41722520192922,37.48204369641251,0.08756913464925575,974.2796108722687,395.47880601882935,917.8312797546387,23028,6053,16975,16975,0,12,6133000.0
6133,6133999,20.41611390120705,37.479959819117866,0.08757754972866771,974.4013004302979,395.53729581832886,917.9189605712891,23028,6053,16975,16975,0,12,6134000.0
6134,6134999,20.415099344698838,37.478351923872,0.08758261190704375,974.5530245304108,395.5961515903473,917.9747581481934,23028,6053,16975,16975,0,12,6135000.0
6135,6135999,20.414041671888853,37.47613145040845,0.08759146673720752,974.7211937904358,395.65506172180176,917.9608688354492,23030,6054,16976,16976,0,12,6136000.0
6136,6136999,20.412904475390036,37.47391396382442,0.0876008190780384,974.8386878967285,395.71371579170227,918.0186386108398,23030,6054,16976,16976,0,12,6137000.0
6137,6137999,20.411914769191846,37.471823863250755,0.08761069627674434,974.975109577179,395.7723846435547,918.0650405883789,23030,6054,16976,16976,0,12,6138000.0
6138,6138999,20.411082428063576,37.47002406009319,0.0876190867024833,975.1158781051636,395.831111907959,918.1147346496582,23030,6054,16976,16976,0,12,6139000.0
6139,6139999,20.410010545882848,37.467909067090446,0.0876313593209459,975.2577567100525,395.8896863460541,918.1486663818359,23030,6054,16976,16976,0,12,6140000.0
6140,6140999,20.409060197761285,37.465777934747834,0.08764559750714118,975.5093410015106,395.94994950294495,918.2641372680664,23055,6056,16999,16999,0,12,6141000.0
6141,6141999,20.408173940539264,37.46383662163248,0.0876603408678881,975.6169543266296,396.00937962532043,918.3808937072754,23055,6056,16999,16999,0,12,6142000.0
6142,6142999,20.407188224655574,37.461740305061404,0.08767327958480164,975.7519483566284,396.0684804916382,918.5309867858887,23055,6056,16999,16999,0,12,6143000.0
6143,6143999,20.40609213542051,37.45949325002348,0.08768871172435544,975.9350817203522,396.12829852104187,918.456787109375,23057,6057,17000,17000,0,12,6144000.0
6144,6144999,20.40519883863464,37.4591777998549,0.08769400344337341,976.1179282665253,396.18811869621277,918.6030387878418,23063,6058,17005,17005,0,12,6145000.0
6145,6145999,20.404018904288254,37.457438570160456,0.08770581384455112,976.2915649414062,396.2465980052948,918.8010177612305,23069,6059,17010,17010,0,12,6146000.0
6146,6146999,20.402715533643516,37.45566998633339,0.08772261092308509,976.418438911438,396.30588960647583,918.9833564758301,23069,6059,17010,17010,0,12,6147000.0
6147,6147999,20.401684115635046,37.45438431614043,0.08773044483548054,976.6485526561737,396.36660075187683,919.0392074584961,23073,6061,17012,17012,0,12,6148000.0
6148,6148999,20.400523335357132,37.452444321440794,0.08774307014847926,976.7591426372528,396.42562913894653,919.1765174865723,23073,6061,17012,17012,0,12,6149000.0
6149,6149999,20.39940017853742,37.45059561235729,0.08775371309932078,976.9572765827179,396.48529052734375,919.1791915893555,23076,6062,17014,17014,0,12,6150000.0
6150,6150999,20.398192520816817,37.448522606887245,0.08776364434827344,977.0848338603973,396.5461325645447,919.2573318481445,23076,6062,17014,17014,0,12,6151000.0
6151,6151999,20.39697409123711,37.446392142306934,0.08777276876190976,977.2117946147919,396.6047911643982,919.3422508239746,23077,6062,17015,17015,0,12,6152000.0
6152,6152999,20.39602167892351,37.4453428902063,0.08777484274740044,977.3541071414948,396.6639003753662,919.4067840576172,23077,6062,17015,17015,0,12,6153000.0
6153,6153999,20.394894535917032,37.44330635629471,0.08778136453151286,977.5290858745575,396.72504115104675,919.3656463623047,23079,6063,17016,17016,0,12,6154000.0
6154,6154999,20.39413198260361,37.44221890633492,0.08778209858770258,977.7597160339355,396.7846796512604,919.2957038879395,23085,6065,17020,17020,0,12,6155000.0
6155,6155999,20.393147410026693,37.4406707754828,0.08778408357348277,977.9370312690735,396.84525418281555,919.3166770935059,23095,6066,17029,17029,0,12,6156000.0
6156,6156999,20.3919363199829,37.43850326995542,0.08779019618549977,978.1749994754791,396.90790009498596,919.2557754516602,23100,6068,17032,17032,0,12,6157000.0
6157,6157999,20.391149609312293,37.43704881979399,0.08779086453731144,978.3669602870941,396.96735858917236,919.3365020751953,23102,6069,17033,17033,0,12,6158000.0
6158,6158999,20.390374648971715,37.43554964205527,0.0877902064850774,978.4969277381897,397.02674770355225,919.4163436889648,23102,6069,17033,17033,0,12,6159000.0
6159,6159999,20.389553003194465,37.43395440942178,0.08778985237912906,978.6356673240662,397.08686208724976,919.5027198791504,23102,6069,17033,17033,0,12,6160000.0
6160,6160999,20.388950875799164,37.432658507289595,0.08778747270333642,978.75577044487,397.1484522819519,919.5699462890625,23102,6069,17033,17033,0,12,6161000.0
6161,6161999,20.38824076595014,37.431006648868475,0.08778323687515743,978.9376316070557,397.208411693573,919.5657653808594,23106,6070,17036,17036,0,12,6162000.0
6162,6162999,20.387545514872826,37.429491040103535,0.08778112303963514,979.0645208358765,397.2704815864563,919.6195259094238,23106,6070,17036,17036,0,12,6163000.0
6163,6163999,20.386742670993367,37.4277960299483,0.0877806234674472,979.2070310115814,397.3302869796753,919.6842994689941,23106,6070,17036,17036,0,12,6164000.0
6164,6164999,20.38570920457816,37.425641234961994,0.08778713546248973,979.3594698905945,397.3926067352295,919.9891052246094,23114,6070,17044,17044,0,12,6165000.0
6165,6165999,20.384578690437703,37.42497158917353,0.08779043465315406,979.4805808067322,397.4511229991913,920.377872467041,23117,6070,17047,17047,0,12,6166000.0
6166,6166999,20.383451005781083,37.423173175992645,0.08779719311652867,979.6419425010681,397.5106346607208,920.5532455444336,23120,6071,17049,17049,0,12,6167000.0
6167,6167999,20.38218420474618,37.42113235284675,0.08780500779417388,979.810221195221,397.5698809623718,920.6760673522949,23122,6072,17050,17050,0,12,6168000.0
6168,6168999,20.381236487183035,37.419532207046664,0.08780753169199862,979.9768302440643,397.6289656162262,920.7767028808594,23124,6073,17051,17051,0,12,6169000.0
6169,6169999,20.380217092073742,37.41822807516214,0.08780985097591554,980.3380644321442,397.69024205207825,920.5653190612793,23137,6077,17060,17060,0,12,6170000.0
6170,6170999,20.378985992842324,37.41611174867287,0.08781891442136891,980.4595353603363,397.75021862983704,920.8283462524414,23137,6077,17060,17060,0,12,6171000.0
6171,6171999,20.377860293762954,37.41426743359484,0.08782425752146739,980.588552236557,397.8092694282532,920.9532051086426,23137,6077,17060,17060,0,12,6172000.0
6172,6172999,20.376791157702737,37.41241236605123,0.08782969698351906,980.7616748809814,397.8709554672241,920.9899978637695,23139,6078,17061,17061,0,12,6173000.0
6173,6173999,20.375565991226566,37.41026665430541,0.08783353618592415,980.9337680339813,397.93042063713074,921.0442276000977,23141,6079,17062,17062,0,12,6174000.0
6174,6174999,20.374764480619664,37.41101899697511,0.08782463482745562,981.0700192451477,397.9903709888458,921.1647491455078,23141,6079,17062,17062,0,12,6175000.0
6175,6175999,20.373809927420233,37.40920252707444,0.08782686665221184,981.1945827007294,398.0501186847687,921.2460632324219,23141,6079,17062,17062,0,12,6176000.0
6176,6176999,20.373211133383904,37.40808606301139,0.08782065725996402,981.3759217262268,398.1100149154663,921.2190856933594,23143,6080,17063,17063,0,12,6177000.0
6177,6177999,20.37241044496113,37.40671792970518,0.08781578707205562,981.570371389389,398.1697063446045,921.210865020752,23145,6081,17064,17064,0,12,6178000.0
6178,6178999,20.372386647788648,37.406405709591155,0.08780050495450797,981.7533857822418,398.2302634716034,921.2682952880859,23147,6082,17065,17065,0,12,6179000.0
6179,6179999,20.372223120196068,37.40594372982309,0.08778837433793363,981.9359683990479,398.29044461250305,921.2627639770508,23149,6083,17066,17066,0,12,6180000.0
6180,6180999,20.37228119532624,37.405840352855364,0.08777325140682835,982.1115243434906,398.350793838501,921.2484359741211,23154,6084,17070,17070,0,12,6181000.0
6181,6181999,20.37268915565773,37.406531547537114,0.08775192009016097,982.261950969696,398.41221022605896,921.3279876708984,23154,6084,17070,17070,0,12,6182000.0
6182,6182999,20.37294127920962,37.40655910099817,0.087742561767858,982.4913573265076,398.47281646728516,921.1985626220703,23161,6086,17075,17075,0,12,6183000.0
6183,6183999,20.37280180864327,37.405614375375386,0.08773652007750354,982.6757543087006,398.5330114364624,921.2434616088867,23163,6087,17076,17076,0,12,6184000.0
6184,6184999,20.37245325668412,37.40443357827205,0.08773072927291525,982.8025102615356,398.59308528900146,921.3586463928223,23163,6087,17076,17076,0,12,6185000.0
6185,6185999,20.371806521855635,37.40282354772454,0.0877295651723764,982.9284837245941,398.6541259288788,921.940502166748,23180,6087,17093,17093,0,12,6186000.0
6186,6186999,20.370356274535887,37.400470954368686,0.08773864800857623,983.0961410999298,398.71798825263977,922.3756980895996,23189,6088,17101,17101,0,12,6187000.0
6187,6187999,20.369114666911315,37.399095628376934,0.08773990809055232,983.259269952774,398.77782249450684,922.6746673583984,23191,6089,17102,17102,0,12,6188000.0
6188,6188999,20.367971918674108,37.39777823672977,0.08773956606707012,983.43057513237,398.8375618457794,922.9123153686523,23193,6090,17103,17103,0,12,6189000.0
6189,6189999,20.366676537725272,37.395486930933636,0.08774716239934177,983.6610102653503,398.8985812664032,923.0421752929688,23197,6092,17105,17105,0,12,6190000.0
6190,6190999,20.36545320399191,37.39339408013566,0.08775064130577659,983.9034972190857,398.95937752723694,923.0727081298828,23204,6094,17110,17110,0,12,6191000.0
6191,6191999,20.36425323926543,37.39133895032868,0.08775542176847462,984.1255564689636,399.0205502510071,923.2059440612793,23208,6096,17112,17112,0,12,6192000.0
6192,6192999,20.363151161046268,37.38935215743657,0.08776160402386146,984.3067762851715,399.0845332145691,923.3924293518066,23210,6097,17113,17113,0,12,6193000.0
6193,6193999,20.362041526701162,37.38728641339973,0.08776592477537426,984.4802625179291,399.14486837387085,923.4557647705078,23212,6098,17114,17114,0,12,6194000.0
6194,6194999,20.36109126546059,37.38552812505327,0.08776858081152639,984.5974900722504,399.20479345321655,923.6573944091797,23212,6098,17114,17114,0,12,6195000.0
6195,6195999,20.360292825117085,37.383883994501815,0.08777018746441101,984.7709188461304,399.2644000053406,923.685489654541,23214,6099,17115,17115,0,12,6196000.0
6196,6196999,20.35978233140074,37.38260430249409,0.0877665750175256,984.9518918991089,399.32359743118286,923.7633056640625,23216,6100,17116,17116,0,12,6197000.0
6197,6197999,20.359081409210383,37.381050932244946,0.08776505845170968,985.1975176334381,399.3841769695282,923.739315032959,23224,6102,17122,17122,0,12,6198000.0
6198,6198999,20.35834674495769,37.37940913568435,0.08776444265771821,985.3677184581757,399.44414710998535,923.8481597900391,23226,6103,17123,17123,0,12,6199000.0
6199,6199999,20.35795597166519,37.37841888452905,0.08776078101878615,985.5981929302216,399.5037884712219,923.8449554443359,23230,6105,17125,17125,0,12,6200000.0
6200,6200999,20.357652598984995,37.37741668967582,0.08775922264091185,985.706702709198,399.56385946273804,924.0387573242188,23230,6105,17125,17125,0,12,6201000.0
6201,6201999,20.357371428281514,37.37741833814265,0.08776120566306445,985.8869383335114,399.6253230571747,924.1015167236328,23232,6106,17126,17126,0,12,6202000.0
6202,6202999,20.356894264372162,37.37606089384763,0.08776942118119146,986.1287305355072,399.6859061717987,924.0482139587402,23236,6108,17128,17128,0,12,6203000.0
6203,6203999,20.35667089838593,37.37496734476207,0.0877705244429069,986.2595808506012,399.74650049209595,924.213809967041,23236,6108,17128,17128,0,12,6204000.0
6204,6204999,20.35620205567184,37.37343504374692,0.08777509173665654,986.3828356266022,399.813702583313,924.340030670166,23236,6108,17128,17128,0,12,6205000.0
6205,6205999,20.35544231317253,37.37152929837147,0.08777879031644142,986.5005860328674,399.87197518348694,924.4763145446777,23236,6108,17128,17128,0,12,6206000.0
6206,6206999,20.354219092105836,37.369187449048574,0.08779138811689091,986.6121094226837,399.9304258823395,925.4021415710449,23255,6108,17147,17147,0,12,6207000.0
6207,6207999,20.35287257605271,37.36690132564051,0.08780216992441581,986.7216649055481,399.9903635978699,925.7249450683594,23255,6108,17147,17147,0,12,6208000.0
6208,6208999,20.3515768348537,37.36491391227917,0.08780906117802934,986.8916087150574,400.04940819740295,925.9389457702637,23258,6109,17149,17149,0,12,6209000.0
6209,6209999,20.35025449955955,37.36258473634284,0.08782116522526084,987.177125453949,400.1092526912689,925.9453811645508,23265,6112,17153,17153,0,12,6210000.0
6210,6210999,20.349159116485627,37.360831607612454,0.08782520811162464,987.2937664985657,400.1715672016144,926.1737937927246,23265,6112,17153,17153,0,12,6211000.0
6211,6211999,20.34807340425649,37.359027536959665,0.08783172966658148,987.6728808879852,400.23309874534607,926.1268424987793,23275,6117,17158,17158,0,12,6212000.0
6212,6212999,20.34689289345242,37.35723326238683,0.08784143171587955,987.8587167263031,400.2930226325989,926.2689170837402,23277,6118,17159,17159,0,12,6213000.0
6213,6213999,20.345779037130516,37.355601370444326,0.08784646896236825,988.024840593338,400.3527822494507,926.4279899597168,23279,6119,17160,17160,0,12,6214000.0
6214,6214999,20.34462433462339,37.35361737040419,0.08785470126419526,988.1887769699097,400.4140250682831,926.516902923584,23281,6120,17161,17161,0,12,6215000.0
6215,6215999,20.343431075722073,37.351778646246196,0.08786209975251436,988.3647651672363,400.4748330116272,926.5947151184082,23283,6121,17162,17162,0,12,6216000.0
6216,6216999,20.34261647432126,37.35085044607543,0.08786170746366928,988.5422208309174,400.5346899032593,926.6221923828125,23289,6122,17167,17167,0,12,6217000.0
6217,6217999,20.3414523287786,37.34884506981706,0.08786952108583623,988.7785604000092,400.5953872203827,926.5618515014648,23293,6124,17169,17169,0,12,6218000.0
6218,6218999,20.340343799028176,37.346922977781944,0.08787413717417014,989.0153820514679,400.6561133861542,926.7252349853516,23345,6126,17219,17219,0,12,6219000.0
6219,6219999,20.339183209760133,37.344977990934986,0.08787948221511832,989.1836960315704,400.71729588508606,926.8516426086426,23347,6127,17220,17220,0,12,6220000.0
6220,6220999,20.33801981726738,37.343109489636596,0.08788499439406983,989.3555448055267,400.7774004936218,927.0336227416992,23350,6128,17222,17222,0,12,6221000.0
6221,6221999,20.33699638845587,37.34162286169319,0.08788706183374084,989.5902032852173,400.8378882408142,927.0240440368652,23359,6130,17229,17229,0,12,6222000.0
6222,6222999,20.33600201711764,37.34007987996182,0.08788758555259057,989.720552444458,400.8999342918396,927.3097915649414,23359,6130,17229,17229,0,12,6223000.0
6223,6223999,20.334968685783966,37.3382554073291,0.08789084932261215,989.8526360988617,400.96240162849426,927.4649467468262,23359,6130,17229,17229,0,12,6224000.0
6224,6224999,20.3339692325616,37.33655012800156,0.08789284412484899,989.990026473999,401.0253269672394,927.6113700866699,23359,6130,17229,17229,0,12,6225000.0
6225,6225999,20.33283609684162,37.33449988675618,0.08789954842153513,990.1695969104767,401.08561849594116,927.6340789794922,23361,6131,17230,17230,0,12,6226000.0
6226,6226999,20.331549104991478,37.332222232535564,0.08790977513703169,990.3346288204193,401.1456456184387,927.819709777832,23364,6132,17232,17232,0,12,6227000.0
6227,6227999,20.330495518368366,37.33121133479527,0.08791232419727446,990.5114378929138,401.2095265388489,928.887882232666,23381,6133,17248,17248,0,12,6228000.0
6228,6228999,20.3292529750526,37.329219608686934,0.08792079236431849,990.6775274276733,401.26890301704407,929.253101348877,23389,6134,17255,17255,0,12,6229000.0
6229,6229999,20.32792702333268,37.326898663540966,0.08793083563082815,990.837306022644,401.32918310165405,929.4864044189453,23391,6135,17256,17256,0,12,6230000.0
6230,6230999,20.3269812577826,37.326629811580574,0.08793488341948197,991.0608923435211,401.3884108066559,929.6257858276367,23395,6137,17258,17258,0,12,6231000.0
6231,6231999,20.325638293108025,37.324362974054594,0.08794407231309898,991.1731600761414,401.44801020622253,929.8823127746582,23395,6137,17258,17258,0,12,6232000.0
6232,6232999,20.324730201662568,37.32261850980163,0.0879471018300031,991.3583705425262,401.5083465576172,930.0539360046387,23397,6138,17259,17259,0,12,6233000.0
6233,6233999,20.32374486444505,37.321030699247764,0.08795220213133359,991.5848240852356,401.56930661201477,930.1305236816406,23401,6140,17261,17261,0,12,6234000.0
6234,6234999,20.322966762645336,37.319641610958556,0.0879528669916273,991.7085773944855,401.62892842292786,930.2924652099609,23401,6140,17261,17261,0,12,6235000.0
6235,6235999,20.322236761225106,37.31819682796851,0.08795642029578443,991.9253487586975,401.6889922618866,930.2881889343262,23405,6142,17263,17263,0,12,6236000.0
6236,6236999,20.321745776588124,37.3175123077659,0.08795175061298921,992.0501964092255,401.74883484840393,930.4869575500488,23405,6142,17263,17263,0,12,6237000.0
6237,6237999,20.32117014256942,37.31665475508729,0.08794778076937937,992.2193694114685,401.8087821006775,930.5878753662109,23413,6143,17270,17270,0,12,6238000.0
6238,6238999,20.320585024508645,37.31617034471078,0.08794311703812918,992.3527321815491,401.86856269836426,930.6925086975098,23413,6143,17270,17270,0,12,6239000.0
6239,6239999,20.320072464458395,37.31503432211927,0.08794066024227876,992.5379581451416,401.9286391735077,930.7714080810547,23415,6144,17271,17271,0,12,6240000.0
6240,6240999,20.319460947718575,37.31387345684717,0.08794000980876904,992.8143212795258,401.98918437957764,930.686840057373,23421,6147,17274,17274,0,12,6241000.0
6241,6241999,20.318859727555655,37.31253368773507,0.08793796719801439,992.9460005760193,402.0494906902313,930.8494682312012,23421,6147,17274,17274,0,12,6242000.0
6242,6242999,20.318376833588175,37.3120217399015,0.08792966265053814,993.0616064071655,402.1090979576111,930.9542388916016,23421,6147,17274,17274,0,12,6243000.0
6243,6243999,20.317897836429808,37.31090903691975,0.0879290137445432,993.2565400600433,402.1699695587158,931.0028457641602,23423,6148,17275,17275,0,12,6244000.0
6244,6244999,20.317470336414445,37.31003423869388,0.08792403674631577,993.392991065979,402.233008146286,931.0820960998535,23423,6148,17275,17275,0,12,6245000.0
6245,6245999,20.316886495219986,37.30855950627115,0.08791954561661264,993.5721731185913,402.2935481071472,931.0996780395508,23425,6149,17276,17276,0,12,6246000.0
6246,6246999,20.316329272130893,37.30715307467677,0.08792216900928629,993.7563025951385,402.3537039756775,931.1289749145508,23427,6150,17277,17277,0,12,6247000.0
6247,6247999,20.31559707505937,37.30563113084898,0.08792027932964763,993.8829786777496,402.41360449790955,931.2915802001953,23427,6150,17277,17277,0,12,6248000.0
6248,6248999,20.314449112669358,37.30365603142741,0.08792648518535962,993.9971158504486,402.47355818748474,932.325325012207,23438,6150,17288,17288,0,12,6249000.0
6249,6249999,20.313080087076415,37.301698694764056,0.087933652159776,994.206850528717,402.5342848300934,932.6135101318359,23451,6152,17299,17299,0,12,6250000.0
6250,6250999,20.311942294387954,37.30028357568733,0.08793737172967264,994.3198754787445,402.59332847595215,932.8795127868652,23451,6152,17299,17299,0,12,6251000.0
6251,6251999,20.311095275688363,37.29891624544184,0.08794080546623417,994.549147605896,402.653094291687,932.928050994873,23456,6154,17302,17302,0,12,6252000.0
6252,6252999,20.309967745623542,37.29692274132229,0.08794535584160479,994.755478143692,402.7125566005707,933.0232543945312,23468,6156,17312,17312,0,12,6253000.0
6253,6253999,20.3087846069708,37.294709339134016,0.08795422554599264,994.8991289138794,402.7721462249756,933.2020225524902,23468,6156,17312,17312,0,12,6254000.0
6254,6254999,20.30760366099629,37.29302121934871,0.08795815604790425,995.0713913440704,402.832403421402,933.2884292602539,23471,6157,17314,17314,0,12,6255000.0
6255,6255999,20.306939622831788,37.292269198868,0.08795311324888366,995.3010852336884,402.8919324874878,933.2895393371582,23475,6159,17316,17316,0,12,6256000.0
6256,6256999,20.30615947775734,37.29076258750032,0.08794946675593318,995.4721920490265,402.95263719558716,933.3838806152344,23477,6160,17317,17317,0,12,6257000.0
6257,6257999,20.305644714928263,37.289592674687,0.08794037472001648,995.6408162117004,403.0124878883362,933.5,23487,6161,17326,17326,0,12,6258000.0
6258,6258999,20.305394531923273,37.288661809285294,0.08793013504039315,995.7876195907593,403.07249569892883,933.6397171020508,23487,6161,17326,17326,0,12,6259000.0
6259,6259999,20.305198085930336,37.288429848992465,0.08791726799183575,995.9080872535706,403.1317310333252,933.7337455749512,23487,6161,17326,17326,0,12,6260000.0
6260,6260999,20.304981996510065,37.28752003149374,0.08790844876867299,996.0442798137665,403.19192910194397,933.8327369689941,23487,6161,17326,17326,0,12,6261000.0
6261,6261999,20.304774244032288,37.28688273428634,0.08789967374999208,996.1738376617432,403.25184965133667,933.9169044494629,23487,6161,17326,17326,0,12,6262000.0
6262,6262999,20.305127503160715,37.28732483176234,0.08787962903236624,996.3557152748108,403.3118724822998,933.9364738464355,23489,6162,17327,17327,0,12,6263000.0
6263,6263999,20.305373165948897,37.287532711792565,0.08787362052201586,996.5322413444519,403.3716826438904,933.9763565063477,23491,6163,17328,17328,0,12,6264000.0
6264,6264999,20.305550987311445,37.287249454977164,0.08786496517509523,996.6622841358185,403.4314925670624,934.0746955871582,23491,6163,17328,17328,0,12,6265000.0
6265,6265999,20.30599775957126,37.287493189113846,0.08785356121805044,996.7909731864929,403.49137330055237,934.1327171325684,23491,6163,17328,17328,0,12,6266000.0
6266,6266999,20.306349121500865,37.28749275167257,0.08784600744912885,996.9223127365112,403.55128026008606,934.1957702636719,23491,6163,17328,17328,0,12,6267000.0
6267,6267999,20.306435586223305,37.28660200034203,0.08784304643962748,997.0886068344116,403.61117601394653,934.2399826049805,23499,6164,17335,17335,0,12,6268000.0
6268,6268999,20.306156180004287,37.28551276468879,0.08783915738724268,997.3350045681,403.6714975833893,934.2057991027832,23512,6166,17346,17346,0,12,6269000.0
6269,6269999,20.30507667744258,37.28366893197221,0.08784725296282425,997.4616932868958,403.7306604385376,935.2416877746582,23524,6166,17358,17358,0,12,6270000.0
6270,6270999,20.303796466586952,37.28159804216811,0.08786028031465298,997.5691890716553,403.79059982299805,935.637565612793,23525,6166,17359,17359,0,12,6271000.0
6271,6271999,20.302591204611794,37.28020338402447,0.08786955672729457,997.7771625518799,403.8496687412262,935.7189292907715,23536,6168,17368,17368,0,12,6272000.0
6272,6272999,20.301265738479728,37.278088065281466,0.0878791996489483,997.9042398929596,403.90973114967346,935.9409484863281,23536,6168,17368,17368,0,12,6273000.0
6273,6273999,20.299962140363576,37.27592948327946,0.08789304472800197,998.0327014923096,403.9693179130554,936.1334571838379,23536,6168,17368,17368,0,12,6274000.0
6274,6274999,20.29895838644849,37.27483977968174,0.08789539830641124,998.2568111419678,404.02899956703186,936.1299514770508,23540,6170,17370,17370,0,12,6275000.0
6275,6275999,20.297739125079293,37.272964960662506,0.08790295753941313,998.3869795799255,404.08834075927734,936.3111877441406,23540,6170,17370,17370,0,12,6276000.0
6276,6276999,20.296656160455814,37.271356262351745,0.0879089804816432,998.617889881134,404.1485114097595,936.3876152038574,23544,6172,17372,17372,0,12,6277000.0
6277,6277999,20.295511366663387,37.26942493232949,0.0879164601304605,998.8004851341248,404.20890522003174,936.4778480529785,23546,6173,17373,17373,0,12,6278000.0
6278,6278999,20.294481785634385,37.26775948513195,0.08792364831743193,998.9159359931946,404.26862597465515,936.6221656799316,23546,6173,17373,17373,0,12,6279000.0
6279,6279999,20.293545378461822,37.26620868455225,0.08792912301807876,999.0375266075134,404.32836079597473,936.7285614013672,23546,6173,17373,17373,0,12,6280000.0
6280,6280999,20.292542538830755,37.26439239480937,0.08793868881904132,999.2213418483734,404.38825154304504,936.7203369140625,23548,6174,17374,17374,0,12,6281000.0
6281,6281999,20.291729274609434,37.26290320514399,0.08794879741703543,999.4430687427521,404.4487552642822,936.7563858032227,23552,6176,17376,17376,0,12,6282000.0
6282,6282999,20.290892928651072,37.26144184409002,0.08795964285613089,999.5716028213501,404.5095841884613,936.9128684997559,23552,6176,17376,17376,0,12,6283000.0
6283,6283999,20.28986244651697,37.25962772900916,0.08797424025004752,999.764740228653,404.57020902633667,936.9611549377441,23554,6177,17377,17377,0,12,6284000.0
6284,6284999,20.28870566270653,37.257460741711796,0.08798915869310298,999.8848237991333,404.63012409210205,937.0804290771484,23554,6177,17377,17377,0,12,6285000.0
6285,6285999,20.287519674556755,37.25518793904553,0.08800795429341857,1000.0055994987488,404.6896824836731,937.2018928527832,23554,6177,17377,17377,0,12,6286000.0
6286,6286999,20.286579868923003,37.25368509086796,0.08801304441120927,1000.1288583278656,404.7507812976837,938.0547409057617,23566,6177,17389,17389,0,12,6287000.0
6287,6287999,20.28561246767899,37.252193876052964,0.0880236770287256,1000.2533864974976,404.81073236465454,938.4194068908691,23566,6177,17389,17389,0,12,6288000.0
6288,6288999,20.28481905325125,37.25349464991326,0.08802026440304456,1000.3715815544128,404.87025928497314,938.6671981811523,23567,6177,17390,17390,0,12,6289000.0
6289,6289999,20.283818671541372,37.25221762177373,0.08803194229296263,1000.5478036403656,404.9310462474823,938.772647857666,23574,6178,17396,17396,0,12,6290000.0
6290,6290999,20.282902716747763,37.2507614836408,0.0880404572997402,1000.7294492721558,404.9916422367096,938.8819274902344,23576,6179,17397,17397,0,12,6291000.0
6291,6291999,20.281707674957413,37.2488473941491,0.08805078397317945,1000.8791558742523,405.0517692565918,939.027172088623,23576,6179,17397,17397,0,12,6292000.0
6292,6292999,20.280574917140555,37.247026355073935,0.08806040955678973,1001.0478637218475,405.1121172904968,939.1023025512695,23578,6180,17398,17398,0,12,6293000.0
6293,6293999,20.27939695535358,37.24521712529284,0.08806780357754451,1001.2172977924347,405.172345161438,939.1641235351562,23580,6181,17399,17399,0,12,6294000.0
6294,6294999,20.278281249341646,37.24320637834845,0.088075938412712,1001.4115521907806,405.23328828811646,939.216739654541,23582,6182,17400,17400,0,12,6295000.0
6295,6295999,20.27714988840839,37.24116196967452,0.088080128252773,1001.5307469367981,405.2953248023987,939.3627052307129,23582,6182,17400,17400,0,12,6296000.0
6296,6296999,20.27632428275804,37.23989085727606,0.08807973572044359,1001.6598792076111,405.3556158542633,939.4385375976562,23582,6182,17400,17400,0,12,6297000.0
6297,6297999,20.275512518736814,37.23837099843055,0.08807757650522208,1001.7880432605743,405.41554379463196,939.5301856994629,23582,6182,17400,17400,0,12,6298000.0
6298,6298999,20.274777149301258,37.23716708030649,0.08807401163422968,1002.0771663188934,405.47613549232483,939.3533210754395,23588,6185,17403,17403,0,12,6299000.0
6299,6299999,20.274097784128102,37.23591743579037,0.08807140081523746,1002.1977589130402,405.5362448692322,939.507984161377,23588,6185,17403,17403,0,12,6300000.0
6300,6300999,20.273443252550827,37.23452050004156,0.08806777020794376,1002.3249533176422,405.59471249580383,939.6220932006836,23588,6185,17403,17403,0,12,6301000.0
6301,6301999,20.272953436817936,37.23339707760309,0.08806084089702204,1002.5229403972626,405.6559362411499,939.6294021606445,23590,6186,17404,17404,0,12,6302000.0
6302,6302999,20.27240334804511,37.23220985529224,0.08805895305641598,1002.6472194194794,405.7157373428345,939.7221260070801,23590,6186,17404,17404,0,12,6303000.0
6303,6303999,20.27213997643256,37.232137215172465,0.08804534299558842,1002.7879040241241,405.77748370170593,939.8072662353516,23590,6186,17404,17404,0,12,6304000.0
6304,6304999,20.271707424032638,37.23105233258882,0.08804025846743657,1002.9143006801605,405.838515996933,939.9014167785645,23590,6186,17404,17404,0,12,6305000.0
6305,6305999,20.27113367819443,37.23020742789808,0.08803167459754835,1003.1702609062195,405.89896750450134,939.8919143676758,23594,6188,17406,17406,0,12,6306000.0
6306,6306999,20.270800627490676,37.230313962392025,0.08802145899290548,1003.307665348053,405.9594225883484,940.6797294616699,23608,6188,17420,17420,0,12,6307000.0
6307,6307999,20.269943543951918,37.22940603738679,0.08801939846718954,1003.4268999099731,406.02218079566956,940.9997825622559,23608,6188,17420,17420,0,12,6308000.0
6308,6308999,20.268947490034915,37.22747030689744,0.08802510219449722,1003.5954988002777,406.08213996887207,941.1092796325684,23611,6189,17422,17422,0,12,6309000.0
6309,6309999,20.268226826872283,37.22660326090824,0.08802687194996228,1003.8282425403595,406.1427249908447,941.1686248779297,23617,6191,17426,17426,0,12,6310000.0
6310,6310999,20.267539950052193,37.22514291309028,0.08802592999987602,1004.0663466453552,406.20373702049255,941.1741523742676,23623,6193,17430,17430,0,12,6311000.0
6311,6311999,20.26655657314478,37.223050460577085,0.0880314910162876,1004.2410042285919,406.26424050331116,941.322883605957,23626,6194,17432,17432,0,12,6312000.0
6312,6312999,20.26555776903797,37.22107332512345,0.08803494532153044,1004.4295272827148,406.3276164531708,941.4154891967773,23628,6195,17433,17433,0,12,6313000.0
6313,6313999,20.264900799734104,37.21990989245253,0.08803131046428336,1004.6001052856445,406.38941287994385,941.4947357177734,23630,6196,17434,17434,0,12,6314000.0
6314,6314999,20.263954998416303,37.2179942374816,0.08803275268525335,1004.9058837890625,406.45287013053894,941.2741584777832,23641,6199,17442,17442,0,12,6315000.0
6315,6315999,20.26329705597048,37.21709013510985,0.08802661665823652,1005.0417971611023,406.516615152359,941.5159683227539,23641,6199,17442,17442,0,12,6316000.0
6316,6316999,20.262527883506856,37.21581877268338,0.08802182883749188,1005.1682274341583,406.5776484012604,941.6781005859375,23641,6199,17442,17442,0,12,6317000.0
6317,6317999,20.261931624819244,37.21451442981963,0.08801572090385157,1005.2897853851318,406.6410884857178,941.7958030700684,23641,6199,17442,17442,0,12,6318000.0
6318,6318999,20.261378975109704,37.21464200496095,0.08800451827076194,1005.4393076896667,406.7045040130615,941.9012680053711,23641,6199,17442,17442,0,12,6319000.0
6319,6319999,20.26076650160149,37.21335353718968,0.08799820890519572,1005.5649809837341,406.76501083374023,941.9867782592773,23641,6199,17442,17442,0,12,6320000.0
6320,6320999,20.260102214352564,37.21175218649295,0.08799523795463049,1005.6799986362457,406.8269398212433,942.0766334533691,23641,6199,17442,17442,0,12,6321000.0
6321,6321999,20.259592657862875,37.210338105637206,0.08799276033639813,1005.8069043159485,406.88778376579285,942.1681251525879,23641,6199,17442,17442,0,12,6322000.0
6322,6322999,20.259168936724652,37.209014082247315,0.08798731440260243,1006.0614945888519,406.9499032497406,942.0987930297852,23645,6201,17444,17444,0,12,6323000.0
6323,6323999,20.25888181825008,37.2079219833194,0.08798015150713145,1006.2341725826263,407.0104148387909,942.0988121032715,23647,6202,17445,17445,0,12,6324000.0
6324,6324999,20.25819412524896,37.20632234445549,0.08797967626980308,1006.3851215839386,407.07095551490784,942.2096786499023,23647,6202,17445,17445,0,12,6325000.0
6325,6325999,20.257484008568248,37.2045570264454,0.08797902655251544,1006.5071842670441,407.1315107345581,942.2980766296387,23647,6202,17445,17445,0,12,6326000.0
6326,6326999,20.25682620204932,37.20345523621553,0.08797475412617473,1006.6258780956268,407.19204664230347,942.4182891845703,23647,6202,17445,17445,0,12,6327000.0
6327,6327999,20.255818332949374,37.20170454017983,0.08797488620080951,1006.8246953487396,407.2622034549713,943.2045936584473,23666,6203,17463,17463,0,12,6328000.0
6328,6328999,20.255242852899485,37.200873988467656,0.08796432503536811,1006.9373021125793,407.3230381011963,943.5994415283203,23666,6203,17463,17463,0,12,6329000.0
6329,6329999,20.254444381361505,37.20006839641988,0.08796213565079769,1007.0732574462891,407.3862166404724,943.831657409668,23666,6203,17463,17463,0,12,6330000.0
6330,6330999,20.253562575752085,37.198127176813735,0.08796633087229855,1007.2029821872711,407.4466438293457,944.023380279541,23666,6203,17463,17463,0,12,6331000.0
6331,6331999,20.252572740061506,37.19609125703691,0.08796880117736816,1007.3137381076813,407.5064709186554,944.1752281188965,23666,6203,17463,17463,0,12,6332000.0
6332,6332999,20.251945498979225,37.1945580633338,0.08796425687753762,1007.4434468746185,407.56961131095886,944.291431427002,23666,6203,17463,17463,0,12,6333000.0
6333,6333999,20.25102221897714,37.19268109929657,0.08796504814187223,1007.5761337280273,407.6299545764923,944.4091758728027,23666,6203,17463,17463,0,12,6334000.0
6334,6334999,20.250284668429725,37.19104018579022,0.08796350449522417,1007.7989401817322,407.6908733844757,944.3818054199219,23670,6205,17465,17465,0,12,6335000.0
6335,6335999,20.24941070536097,37.190095108508594,0.0879618618724819,1008.056654214859,407.75210881233215,944.3822708129883,23674,6207,17467,17467,0,12,6336000.0
6336,6336999,20.248654684159426,37.188431289730644,0.08796066059518715,1008.2311871051788,407.8125870227814,944.4753265380859,23676,6208,17468,17468,0,12,6337000.0
6337,6337999,20.247753576720125,37.18647873016935,0.08796422692833261,1008.4215898513794,407.8734862804413,944.5714340209961,23678,6209,17469,17469,0,12,6338000.0
6338,6338999,20.246816486347235,37.184626436539176,0.08796701185069211,1008.5361297130585,407.9336290359497,944.6860237121582,23678,6209,17469,17469,0,12,6339000.0
6339,6339999,20.24594397771187,37.1833450251478,0.08796962353553839,1008.8377547264099,407.9972896575928,944.5780754089355,23684,6212,17472,17472,0,12,6340000.0
6340,6340999,20.245154056284143,37.18158699093167,0.08797113952448787,1009.0737314224243,408.05919909477234,944.5821952819824,23689,6214,17475,17475,0,12,6341000.0
6341,6341999,20.244181216281234,37.17959123648534,0.08797544506081112,1009.3006038665771,408.1216287612915,944.5748291015625,23693,6216,17477,17477,0,12,6342000.0
6342,6342999,20.2435960338583,37.178256771902944,0.08797392177537766,1009.4987313747406,408.1835560798645,944.6409378051758,23695,6217,17478,17478,0,12,6343000.0
6343,6343999,20.242863263316277,37.176520256226944,0.08797536352026813,1009.6903457641602,408.24753427505493,944.7674865722656,23697,6218,17479,17479,0,12,6344000.0
6344,6344999,20.242107067003573,37.17484714782322,0.08797824207619831,1009.8156208992004,408.3097987174988,944.8834800720215,23697,6218,17479,17479,0,12,6345000.0
6345,6345999,20.24142902992187,37.17317653511772,0.08797899197098868,1009.932044506073,408.3705143928528,944.9795761108398,23697,6218,17479,17479,0,12,6346000.0
6346,6346999,20.240490835753846,37.1712103896317,0.08798578477954666,1010.1200835704803,408.43162512779236,944.9793739318848,23699,6219,17480,17480,0,12,6347000.0
6347,6347999,20.239390803940786,37.16910233648044,0.08799296292426007,1010.2648029327393,408.49274230003357,945.5198631286621,23711,6219,17492,17492,0,12,6348000.0
6348,6348999,20.238390209154858,37.16905847528978,0.08798981458982402,1010.3938210010529,408.552695274353,945.9137573242188,23714,6219,17495,17495,0,12,6349000.0
6349,6349999,20.237257839101552,37.168584037815265,0.08799077748232687,1010.5155053138733,408.6140697002411,946.173698425293,23714,6219,17495,17495,0,12,6350000.0
6350,6350999,20.23611366616851,37.166964663011896,0.08799772604525813,1010.6903960704803,408.6748058795929,946.2680244445801,23716,6220,17496,17496,0,12,6351000.0
6351,6351999,20.235109464588575,37.165287001930764,0.08800688798863898,1010.8273229598999,408.73545241355896,946.4087905883789,23716,6220,17496,17496,0,12,6352000.0
6352,6352999,20.233992201912933,37.16352174842057,0.08801848080292152,1010.9705917835236,408.79621291160583,946.5344696044922,23716,6220,17496,17496,0,12,6353000.0
6353,6353999,20.232915315756582,37.16160027571765,0.08802690771801192,1011.1931054592133,408.85774064064026,946.4704627990723,23720,6222,17498,17498,0,12,6354000.0
6354,6354999,20.23189303111075,37.15984611360753,0.08803931129224007,1011.3630454540253,408.9200930595398,946.5772972106934,23722,6223,17499,17499,0,12,6355000.0
6355,6355999,20.230995331202255,37.158527218097774,0.08804238696315325,1011.6007616519928,408.98072814941406,946.5395584106445,23726,6225,17501,17501,0,12,6356000.0
6356,6356999,20.230302794970353,37.15782185684721,0.08804393926794607,1011.7894823551178,409.042338848114,946.6722106933594,23728,6226,17502,17502,0,12,6357000.0
6357,6357999,20.229595214994653,37.15649916063577,0.08804717016831676,1011.9284088611603,409.10349011421204,946.7823677062988,23728,6226,17502,17502,0,12,6358000.0
6358,6358999,20.229167689574062,37.155822500794805,0.08806098799958006,1012.0524246692657,409.16389179229736,946.8909072875977,23728,6226,17502,17502,0,12,6359000.0
6359,6359999,20.229530058884443,37.15687659504619,0.08805186670532161,1012.1837286949158,409.22452425956726,946.9723587036133,23728,6226,17502,17502,0,12,6360000.0
6360,6360999,20.229700818369615,37.15750443815903,0.0880377588659772,1012.4128997325897,409.2870807647705,946.9380493164062,23732,6228,17504,17504,0,12,6361000.0
6361,6361999,20.22999673706253,37.15788931528361,0.08804217598086495,1012.5520753860474,409.3527328968048,947.046501159668,23732,6228,17504,17504,0,12,6362000.0
6362,6362999,20.23042895265256,37.158383205572406,0.08804035802272336,1012.7820630073547,409.4136748313904,946.9198417663574,23736,6230,17506,17506,0,12,6363000.0
6363,6363999,20.23140489911812,37.160794323292656,0.08801929336812875,1013.0175249576569,409.47541189193726,946.846508026123,23740,6232,17508,17508,0,12,6364000.0
6364,6364999,20.232196224153256,37.161747096745934,0.08800563469386591,1013.1506729125977,409.5371208190918,947.0055351257324,23740,6232,17508,17508,0,12,6365000.0
6365,6365999,20.233048371704427,37.16266057157721,0.08799933983629082,1013.4063155651093,409.59903049468994,947.1816711425781,23791,6234,17557,17557,0,12,6366000.0
6366,6366999,20.233585172337445,37.16295041396886,0.08799272404962633,1013.6919896602631,409.6606431007385,947.0257720947266,23797,6237,17560,17560,0,12,6367000.0
6367,6367999,20.23383853013396,37.162503087005135,0.0879914704380701,1013.9353694915771,409.7242867946625,947.2237968444824,23801,6239,17562,17562,0,12,6368000.0
6368,6368999,20.233108107316543,37.16088098846544,0.0879951774171911,1014.0536303520203,409.78512239456177,947.9389152526855,23817,6239,17578,17578,0,12,6369000.0
6369,6369999,20.232189968299444,37.162524000777196,0.08797933992696616,1014.1769232749939,409.8470320701599,948.2761001586914,23817,6239,17578,17578,0,12,6370000.0
6370,6370999,20.23150189743415,37.16287844314959,0.08796325629355228,1014.3054213523865,409.90710067749023,948.5054397583008,23817,6239,17578,17578,0,12,6371000.0
6371,6371999,20.230705825852393,37.16139500149335,0.08795890545217633,1014.5410358905792,409.96789956092834,948.5378799438477,23833,6241,17592,17592,0,12,6372000.0
6372,6372999,20.230023166694018,37.159928865098735,0.08795455779019579,1014.6677143573761,410.029417514801,948.7640838623047,23833,6241,17592,17592,0,12,6373000.0
6373,6373999,20.22926249880944,37.159787352827216,0.08794682524958441,1014.7749419212341,410.0899283885956,948.9709167480469,23833,6241,17592,17592,0,12,6374000.0
6374,6374999,20.228467972938414,37.158238627942836,0.0879448993338039,1015.0500466823578,410.15095496177673,948.9620590209961,23839,6244,17595,17595,0,12,6375000.0
6375,6375999,20.227729437351567,37.1569484613955,0.08794537264372859,1015.1846072673798,410.2119333744049,949.1377601623535,23839,6244,17595,17595,0,12,6376000.0
6376,6376999,20.22708060751157,37.155584779117326,0.08794110161651503,1015.5349950790405,410.2735130786896,949.0034942626953,23848,6248,17600,17600,0,12,6377000.0
6377,6377999,20.22648828606976,37.154231072955675,0.08793803489043517,1015.6690278053284,410.3341588973999,949.2112770080566,23848,6248,17600,17600,0,12,6378000.0
6378,6378999,20.226302786933655,37.15422226492504,0.08793579396055218,1015.9059731960297,410.39638447761536,949.1919975280762,23852,6250,17602,17602,0,12,6379000.0
6379,6379999,20.226071864773505,37.15342453419555,0.087936184563288,1016.0227937698364,410.463392496109,949.3319816589355,23852,6250,17602,17602,0,12,6380000.0
6380,6380999,20.226239912805937,37.15311736143662,0.08793017987735685,1016.2216248512268,410.5248489379883,949.368522644043,23854,6251,17603,17603,0,12,6381000.0
6381,6381999,20.22633505056449,37.152803378271024,0.08792780292894875,1016.5135772228241,410.5871295928955,949.3059387207031,23868,6254,17614,17614,0,12,6382000.0
6382,6382999,20.226755281683,37.15319448201574,0.08791927658297927,1016.6589753627777,410.6533806324005,949.4952507019043,23868,6254,17614,17614,0,12,6383000.0
6383,6383999,20.227417980422217,37.15401916949887,0.08791898515795904,1016.7724406719208,410.71424984931946,949.6457710266113,23868,6254,17614,17614,0,12,6384000.0
6384,6384999,20.22787691096204,37.1542541301011,0.08790955812110057,1016.9106123447418,410.77498412132263,949.7568473815918,23868,6254,17614,17614,0,12,6385000.0
6385,6385999,20.228799824926767,37.155149282943135,0.08790638625184743,1017.1410939693451,410.83622765541077,949.6970672607422,23872,6256,17616,17616,0,12,6386000.0
6386,6386999,20.229372292305953,37.156347988753474,0.08790770066510534,1017.3856189250946,410.8976035118103,949.6426277160645,23876,6258,17618,17618,0,12,6387000.0
6387,6387999,20.230102826652764,37.1566554798053,0.08790991885620181,1017.566043138504,410.95856523513794,949.7070465087891,23890,6259,17631,17631,0,12,6388000.0
6388,6388999,20.23034863581785,37.15628346464482,0.08790960082569266,1017.7502641677856,411.0217242240906,949.8681488037109,23921,6260,17661,17661,0,12,6389000.0
6389,6389999,20.22973997632623,37.15492444088986,0.0879060393300024,1018.0478804111481,411.08683609962463,950.3455963134766,23952,6263,17689,17689,0,12,6390000.0
6390,6390999,20.228743849611984,37.153762521274984,0.0879045317323669,1018.1574988365173,411.14642786979675,950.6930351257324,23953,6263,17690,17690,0,12,6391000.0
6391,6391999,20.227704355003265,37.15169530108222,0.08790713116303173,1018.3899557590485,411.20685338974,950.6875801086426,23967,6265,17702,17702,0,12,6392000.0
6392,6392999,20.22690835125574,37.150206730109986,0.08790654851621038,1018.5335454940796,411.2685534954071,950.9024505615234,23968,6265,17703,17703,0,12,6393000.0
6393,6393999,20.226590462775867,37.14992477607342,0.08789520628696934,1018.8044919967651,411.3303050994873,950.9147644042969,23974,6268,17706,17706,0,12,6394000.0
6394,6394999,20.225743776273397,37.148538774938274,0.08789467960607922,1018.9704685211182,411.3904209136963,951.0647926330566,23977,6269,17708,17708,0,12,6395000.0
6395,6395999,20.225161156661304,37.14747521104197,0.08788981881149027,1019.1396877765656,411.4504418373108,951.1531524658203,23980,6270,17710,17710,0,12,6396000.0
6396,6396999,20.22477774182649,37.1465855260327,0.08788550663276895,1019.2673740386963,411.51047539711,951.3157806396484,23980,6270,17710,17710,0,12,6397000.0
6397,6397999,20.224224572207195,37.14535544920684,0.08788458034122093,1019.5705435276031,411.57256293296814,951.1342658996582,23996,6273,17723,17723,0,12,6398000.0
6398,6398999,20.22404275021559,37.14579396669457,0.08787540871356159,1019.7491624355316,411.6334927082062,951.2774848937988,23998,6274,17724,17724,0,12,6399000.0
6399,6399999,20.223866754274432,37.145009006666,0.08787339937825378,1019.8715362548828,411.69393134117126,951.4231185913086,23998,6274,17724,17724,0,12,6400000.0
6400,6400999,20.22362825988477,37.14428261260976,0.08787201565911862,1020.0455887317657,411.75401425361633,951.4782638549805,24000,6275,17725,17725,0,12,6401000.0
6401,6401999,20.22369591979294,37.14384400681289,0.08787210029801806,1020.1843109130859,411.8155105113983,951.6148567199707,24000,6275,17725,17725,0,12,6402000.0
6402,6402999,20.223710701921668,37.14332178427317,0.08786512970950155,1020.4047112464905,411.8743815422058,951.5899238586426,24012,6277,17735,17735,0,12,6403000.0
6403,6403999,20.22356107866603,37.142712228943935,0.08786052598204241,1020.6205725669861,411.94345903396606,951.6568870544434,24014,6278,17736,17736,0,12,6404000.0
6404,6404999,20.223574720373136,37.14225083216248,0.08785633782145985,1020.7625942230225,412.0124247074127,951.7772789001465,24014,6278,17736,17736,0,12,6405000.0
6405,6405999,20.223498020429236,37.14150299128602,0.08785112380145266,1020.8891959190369,412.07259011268616,951.8784141540527,24014,6278,17736,17736,0,12,6406000.0
6406,6406999,20.22362750693126,37.141148665635654,0.08784347801074577,1021.0736343860626,412.13311219215393,951.904052734375,24016,6279,17737,17737,0,12,6407000.0
6407,6407999,20.22371749649975,37.140574970990635,0.08783636204091794,1021.2038729190826,412.196280002594,952.0109481811523,24016,6279,17737,17737,0,12,6408000.0
6408,6408999,20.22374501056005,37.139762206790415,0.08783046674341011,1021.333687543869,412.25667333602905,952.0835723876953,24016,6279,17737,17737,0,12,6409000.0
6409,6409999,20.22362277680355,37.13881305167705,0.08782256939351896,1021.5121350288391,412.3175449371338,952.1276435852051,24018,6280,17738,17738,0,12,6410000.0
6410,6410999,20.222801994156583,37.13709039421761,0.0878224991144747,1021.7220759391785,412.3789277076721,952.6230659484863,24043,6281,17762,17762,0,12,6411000.0
6411,6411999,20.221981387491972,37.13674863049132,0.0878205495932467,1021.8499121665955,412.43904089927673,953.0382080078125,24047,6281,17766,17766,0,12,6412000.0
6412,6412999,20.22092976244193,37.135857768338454,0.08782503061905655,1021.9581804275513,412.500696182251,953.2582092285156,24048,6281,17767,17767,0,12,6413000.0
6413,6413999,20.219982881743082,37.13583528957421,0.08782228777563272,1022.0864737033844,412.5616042613983,953.424186706543,24048,6281,17767,17767,0,12,6414000.0
6414,6414999,20.21887287451182,37.133973281836894,0.08782714764046351,1022.2029004096985,412.6211805343628,953.5917663574219,24048,6281,17767,17767,0,12,6415000.0
6415,6415999,20.217945719544492,37.13314847530116,0.0878265181162674,1022.3517796993256,412.69023728370667,953.7102661132812,24048,6281,17767,17767,0,12,6416000.0
6416,6416999,20.21692835139408,37.13144408226121,0.08783036059875204,1022.5495569705963,412.75105905532837,953.745979309082,24050,6282,17768,17768,0,12,6417000.0
6417,6417999,20.21605921019088,37.13078073221155,0.08783110050873544,1022.6820633411407,412.8116638660431,953.8403854370117,24050,6282,17768,17768,0,12,6418000.0
6418,6418999,20.215052647737433,37.1290414244377,0.08783581308057575,1022.8654720783234,412.87239146232605,953.8871612548828,24052,6283,17769,17769,0,12,6419000.0
6419,6419999,20.21421272045795,37.1275329947044,0.08783893222049755,1023.0458281040192,412.93470549583435,953.84765625,24055,6284,17771,17771,0,12,6420000.0
6420,6420999,20.213292225684636,37.12604763754728,0.08783994994114608,1023.1618840694427,412.99496603012085,953.9594841003418,24055,6284,17771,17771,0,12,6421000.0
6421,6421999,20.21237562080163,37.124614237124796,0.08784245747427699,1023.3114190101624,413.0547025203705,954.0453071594238,24055,6284,17771,17771,0,12,6422000.0
6422,6422999,20.211565467631583,37.1231394869236,0.0878458985842635,1023.4315028190613,413.1159782409668,954.1184768676758,24055,6284,17771,17771,0,12,6423000.0
6423,6423999,20.210767480633027,37.12152718117015,0.08784952393667522,1023.6739404201508,413.1797676086426,954.0866432189941,24059,6286,17773,17773,0,12,6424000.0
6424,6424999,20.20995943677368,37.11976905714062,0.087856218307793,1023.8567750453949,413.2422502040863,954.1272354125977,24061,6287,17774,17774,0,12,6425000.0
6425,6425999,20.209169635616355,37.11894613921062,0.0878628906127471,1024.1523056030273,413.30358934402466,953.9516525268555,24068,6290,17778,17778,0,12,6426000.0
6426,6426999,20.208384406574776,37.11819391887943,0.08786951734164106,1024.2699394226074,413.36360788345337,954.1001892089844,24068,6290,17778,17778,0,12,6427000.0
6427,6427999,20.207470327402863,37.11628808791072,0.08787656299927515,1024.396882534027,413.42434000968933,954.6453552246094,24083,6290,17793,17793,0,12,6428000.0
6428,6428999,20.206441353802,37.11481951056348,0.08788371036662401,1024.5208275318146,413.48496413230896,955.1196250915527,24087,6290,17797,17797,0,12,6429000.0
6429,6429999,20.20528265001345,37.113002348925356,0.08789689164131531,1024.632916688919,413.54536628723145,955.3783645629883,24088,6290,17798,17798,0,12,6430000.0
6430,6430999,20.204444266142303,37.111816500812,0.08790001201833142,1024.8202528953552,413.60828971862793,955.5515670776367,24106,6291,17815,17815,0,12,6431000.0
6431,6431999,20.203462432488205,37.110167890626755,0.08790735186477616,1025.0020208358765,413.6687159538269,955.6781921386719,24108,6292,17816,17816,0,12,6432000.0
6432,6432999,20.2027764185868,37.10939700526866,0.08790870951160068,1025.1878459453583,413.7291874885559,955.7779235839844,24110,6293,17817,17817,0,12,6433000.0
6433,6433999,20.202076605133065,37.10833401715861,0.08791102821326247,1025.3595666885376,413.7898941040039,955.8341293334961,24113,6294,17819,17819,0,12,6434000.0
6434,6434999,20.20146728295829,37.1075677368851,0.08790863502849677,1025.6466472148895,413.8507981300354,955.7937126159668,24120,6297,17823,17823,0,12,6435000.0
6435,6435999,20.200916075927534,37.10658116676594,0.08791526939360894,1025.761355638504,413.91175627708435,955.9570388793945,24120,6297,17823,17823,0,12,6436000.0
6436,6436999,20.200563808145457,37.10581273748135,0.08791857720205298,1025.9694337844849,413.97285413742065,956.0468215942383,24122,6298,17824,17824,0,12,6437000.0
6437,6437999,20.200400285315297,37.10520155795529,0.08791723029419352,1026.0786473751068,414.0310935974121,956.1527557373047,24122,6298,17824,17824,0,12,6438000.0
6438,6438999,20.19996681132931,37.10415062253244,0.08792136221566949,1026.3211507797241,414.09087324142456,956.0788154602051,24127,6300,17827,17827,0,12,6439000.0
6439,6439999,20.19983121806465,37.103546846447834,0.08792382898130313,1026.5398604869843,414.1504657268524,956.0690383911133,24131,6302,17829,17829,0,12,6440000.0
6440,6440999,20.199923881996963,37.1039598931578,0.08792384356789484,1026.6816017627716,414.2114701271057,956.2441177368164,24131,6302,17829,17829,0,12,6441000.0
6441,6441999,20.199769477775277,37.10331253208726,0.08792255423363915,1026.8729257583618,414.2726080417633,956.2249984741211,24133,6303,17830,17830,0,12,6442000.0
6442,6442999,20.200022405687584,37.10323364942716,0.08792735948897801,1026.9976489543915,414.33392238616943,956.3506278991699,24133,6303,17830,17830,0,12,6443000.0
6443,6443999,20.200350137212514,37.103611305170176,0.08792292884328357,1027.12819314003,414.3971779346466,956.4712829589844,24133,6303,17830,17830,0,12,6444000.0
6444,6444999,20.200404796957873,37.10319118023847,0.08792078287405769,1027.304371356964,414.457888841629,956.5011367797852,24135,6304,17831,17831,0,12,6445000.0
6445,6445999,20.200630827976457,37.10391198651073,0.08791378193710653,1027.4995839595795,414.5216290950775,956.5160102844238,24136,6305,17831,17831,0,12,6446000.0
6446,6446999,20.200716091220045,37.1033955051978,0.08790767603115524,1027.6705613136292,414.5827167034149,956.5867462158203,24138,6306,17832,17832,0,12,6447000.0
6447,6447999,20.200423949612375,37.10219480467071,0.08789815897940645,1027.8171195983887,414.6425132751465,957.3738479614258,24160,6306,17854,17854,0,12,6448000.0
6448,6448999,20.200167771746862,37.10232230490316,0.08788044163517528,1027.9229350090027,414.7030875682831,957.865421295166,24164,6306,17858,17858,0,12,6449000.0
6449,6449999,20.20054423885497,37.103259502450875,0.0878647351672317,1028.1510853767395,414.76395177841187,957.9948806762695,24168,6308,17860,17860,0,12,6450000.0
6450,6450999,20.20090193188259,37.10406263969277,0.08782742379938457,1028.273928642273,414.8252136707306,958.2877807617188,24170,6308,17862,17862,0,12,6451000.0
6451,6451999,20.201612967314716,37.104677398344926,0.08781951415869194,1028.3955690860748,414.887469291687,958.4731826782227,24170,6308,17862,17862,0,12,6452000.0
6452,6452999,20.202494400448693,37.10682191711705,0.08780459753566316,1028.6092972755432,414.9483251571655,958.5720672607422,24174,6310,17864,17864,0,12,6453000.0
6453,6453999,20.203323012419236,37.107451890456495,0.08779750902506323,1028.8377976417542,415.00980043411255,958.6556167602539,24180,6312,17868,17868,0,12,6454000.0
6454,6454999,20.204658931744678,37.109065733965544,0.08779409614395361,1029.064974308014,415.07213830947876,958.6279106140137,24185,6314,17871,17871,0,12,6455000.0
6455,6455999,20.205831636666904,37.11039790332409,0.08781713294506999,1029.5035462379456,415.1430575847626,958.5308952331543,24198,6319,17879,17879,0,12,6456000.0
6456,6456999,20.206994060641065,37.11120429542883,0.08784406623970098,1029.6282577514648,415.20418977737427,958.7673492431641,24198,6319,17879,17879,0,12,6457000.0
6457,6457999,20.20845772541872,37.11299373066554,0.08787443575284615,1029.8558948040009,415.26573514938354,958.8410835266113,24205,6321,17884,17884,0,12,6458000.0
6458,6458999,20.209774858309192,37.11433006911766,0.08790374765539322,1030.109296321869,415.3305082321167,958.7835540771484,24209,6323,17886,17886,0,12,6459000.0
6459,6459999,20.211097469057727,37.11547913041762,0.08792242435566855,1030.2761793136597,415.3920748233795,958.9187202453613,24211,6324,17887,17887,0,12,6460000.0
6460,6460999,20.212436345056116,37.11672941002913,0.08796340952982862,1030.4405755996704,415.45350193977356,959.0374526977539,24213,6325,17888,17888,0,12,6461000.0
6461,6461999,20.21394038829727,37.118062525291556,0.08799183953840684,1030.5829825401306,415.51749420166016,959.2024421691895,24213,6325,17888,17888,0,12,6462000.0
6462,6462999,20.215195706642977,37.118653575326604,0.08802978628530322,1030.7150735855103,415.58049058914185,959.3630867004395,24213,6325,17888,17888,0,12,6463000.0
6463,6463999,20.216576695447774,37.119687032780895,0.08805810799503366,1030.9598696231842,415.64274048805237,959.3597106933594,24218,6327,17891,17891,0,12,6464000.0
6464,6464999,20.217666555263214,37.12009986708962,0.08808077725351648,1031.2090198993683,415.7050497531891,959.386157989502,24231,6329,17902,17902,0,12,6465000.0
6465,6465999,20.21879511965049,37.12042973156408,0.0881035181144082,1031.3824670314789,415.766539812088,959.4294776916504,24233,6330,17903,17903,0,12,6466000.0
6466,6466999,20.21943796040847,37.119921662271636,0.0881157974736404,1031.501545906067,415.8305821418762,959.6050148010254,24233,6330,17903,17903,0,12,6467000.0
6467,6467999,20.21943471791805,37.119055778494825,0.08810571866735561,1031.6763610839844,415.89203453063965,960.2360382080078,24253,6331,17922,17922,0,12,6468000.0
6468,6468999,20.218385527797828,37.117495170349656,0.08810832654370959,1031.786758184433,415.95326256752014,960.6678924560547,24258,6331,17927,17927,0,12,6469000.0
6469,6469999,20.217439294814568,37.116240297841735,0.08810813929723293,1031.9684767723083,416.01714634895325,960.8702812194824,24261,6332,17929,17929,0,12,6470000.0
6470,6470999,20.21650078379759,37.11487413557752,0.0881130634117987,1032.085359096527,416.0782825946808,961.1525497436523,24262,6332,17930,17930,0,12,6471000.0
6471,6471999,20.215743713413357,37.113769005730006,0.08811009461268038,1032.2840192317963,416.1430730819702,961.2640914916992,24265,6333,17932,17932,0,12,6472000.0
6472,6472999,20.21479722313632,37.11233207195242,0.08810945126550185,1032.4165604114532,416.2147524356842,961.437370300293,24265,6333,17932,17932,0,12,6473000.0
6473,6473999,20.214304107102528,37.11180151622391,0.08809959881667973,1032.6607892513275,416.27856183052063,961.4490776062012,24269,6335,17934,17934,0,12,6474000.0
6474,6474999,20.213825908344496,37.111024697679966,0.08809146733534878,1032.7937729358673,416.34279465675354,961.5853004455566,24269,6335,17934,17934,0,12,6475000.0
6475,6475999,20.213388724191905,37.11001850040575,0.08808787506989879,1032.9287824630737,416.40345573425293,961.7102432250977,24269,6335,17934,17934,0,12,6476000.0
6476,6476999,20.21301287871839,37.10895265059527,0.08808361267082054,1033.166990995407,416.4645848274231,961.7463493347168,24273,6337,17936,17936,0,12,6477000.0
6477,6477999,20.213172860832906,37.1090418472186,0.08807993325629904,1033.2914412021637,416.5274040699005,961.8649559020996,24273,6337,17936,17936,0,12,6478000.0
6478,6478999,20.213620749982102,37.10928936388573,0.08807923767553416,1033.5295119285583,416.5889298915863,961.8164825439453,24279,6339,17940,17940,0,12,6479000.0
6479,6479999,20.214096850066543,37.10985674884001,0.08808361366581907,1033.6549651622772,416.6501741409302,961.9580764770508,24279,6339,17940,17940,0,12,6480000.0
6480,6480999,20.214713159991977,37.11077011520425,0.08807760042369939,1033.9454936981201,416.7123692035675,961.8123245239258,24286,6342,17944,17944,0,12,6481000.0
6481,6481999,20.215563178727344,37.11152307543312,0.08808320817913351,1034.1226615905762,416.7742099761963,961.8984985351562,24288,6343,17945,17945,0,12,6482000.0
6482,6482999,20.216468810958638,37.1128291019953,0.08808751087657918,1034.3679540157318,416.8368706703186,961.8661499023438,24294,6345,17949,17949,0,12,6483000.0
6483,6483999,20.217337734213636,37.11361559720091,0.08810535663658536,1034.6610326766968,416.9008765220642,961.8020515441895,24302,6348,17954,17954,0,12,6484000.0
6484,6484999,20.21851156650711,37.115575216249454,0.08811447097011282,1034.9142694473267,416.96341848373413,961.8293304443359,24308,6350,17958,17958,0,12,6485000.0
6485,6485999,20.21936264360633,37.11635277433405,0.08813081560804115,1035.1438477039337,417.0259132385254,961.8955383300781,24312,6352,17960,17960,0,12,6486000.0
6486,6486999,20.220216719340804,37.11671610513269,0.08814056965017081,1035.3692474365234,417.0881042480469,961.927806854248,24316,6354,17962,17962,0,12,6487000.0
6487,6487999,20.220688708190178,37.116398742593205,0.08814419418140274,1035.4884793758392,417.15126156806946,962.0929641723633,24316,6354,17962,17962,0,12,6488000.0
6488,6488999,20.220502209683026,37.11593376952918,0.08812540473038266,1035.617600440979,417.21361565589905,962.9453239440918,24338,6354,17984,17984,0,12,6489000.0
6489,6489999,20.21947771618047,37.11454904142831,0.0881247751263472,1035.7268636226654,417.27427673339844,963.4314079284668,24340,6354,17986,17986,0,12,6490000.0
6490,6490999,20.218728549116918,37.11366731252835,0.0881211532927837,1036.0067369937897,417.33912539482117,963.5207786560059,24356,6357,17999,17999,0,12,6491000.0
6491,6491999,20.21790605995927,37.112429454548945,0.08812129143686898,1036.1354179382324,417.40272974967957,963.8544883728027,24358,6357,18001,18001,0,12,6492000.0
6492,6492999,20.217185070429387,37.11087593337223,0.08812138198694552,1036.3582327365875,417.464120388031,964.0109519958496,24362,6359,18003,18003,0,12,6493000.0
6493,6493999,20.216240537936404,37.10932892513251,0.08812051306123114,1036.4789736270905,417.52834844589233,964.2259826660156,24362,6359,18003,18003,0,12,6494000.0
6494,6494999,20.215577554281932,37.107761018961156,0.0881157011153042,1036.6302304267883,417.59795904159546,964.3856010437012,24362,6359,18003,18003,0,12,6495000.0
6495,6495999,20.21477608439881,37.108706451582556,0.08810373377482006,1036.8143393993378,417.66169142723083,964.4660949707031,24365,6360,18005,18005,0,12,6496000.0
6496,6496999,20.213838810288042,37.10697429100622,0.08810508201590872,1037.0523648262024,417.72976183891296,964.4690017700195,24369,6362,18007,18007,0,12,6497000.0
6497,6497999,20.213148000700137,37.10563314926985,0.08810142700130363,1037.2730708122253,417.79138445854187,964.5032539367676,24374,6364,18010,18010,0,12,6498000.0
6498,6498999,20.212973362126814,37.10526768721934,0.08808855340629318,1037.4792711734772,417.853004693985,964.5957069396973,24376,6365,18011,18011,0,12,6499000.0
6499,6499999,20.21292159016834,37.104764320425986,0.08807935341783069,1037.6511616706848,417.91591143608093,964.6818771362305,24378,6366,18012,18012,0,12,6500000.0
6500,6500999,20.21293176691102,37.10419910722626,0.08807086640537842,1037.7863478660583,417.9787940979004,964.8069229125977,24378,6366,18012,18012,0,12,6501000.0
6501,6501999,20.212864219659252,37.10344446006186,0.0880675865067645,1038.142874956131,418.0410544872284,964.6172218322754,24387,6370,18017,18017,0,12,6502000.0
6502,6502999,20.213619809449764,37.10397220051874,0.08805667804171524,1038.3200554847717,418.1027617454529,964.7739028930664,24408,6371,18037,18037,0,12,6503000.0
6503,6503999,20.214302361785325,37.105258595505255,0.08804291013897136,1038.4893689155579,418.164514541626,964.8865242004395,24410,6372,18038,18038,0,12,6504000.0
6504,6504999,20.215445657920807,37.10685037107313,0.08803274626526825,1038.6167957782745,418.22892594337463,965.0030212402344,24410,6372,18038,18038,0,12,6505000.0
6505,6505999,20.21680482803636,37.10873304834667,0.08801871845425913,1038.7936046123505,418.2906641960144,965.0822105407715,24413,6373,18040,18040,0,12,6506000.0
6506,6506999,20.21836605787602,37.11202909348767,0.0880080586724371,1039.0360097885132,418.35308599472046,965.1407127380371,24417,6375,18042,18042,0,12,6507000.0
6507,6507999,20.219882475911177,37.115855771871196,0.08800400911590545,1039.3275322914124,418.4151532649994,965.0259246826172,24424,6378,18046,18046,0,12,6508000.0
6508,6508999,20.220701368317833,37.116401373340345,0.08800266233935683,1039.4641644954681,418.4804832935333,965.2766075134277,24424,6378,18046,18046,0,12,6509000.0
6509,6509999,20.220969935106243,37.11661422496799,0.08798538635092645,1039.586450099945,418.54292488098145,965.9745407104492,24444,6378,18066,18066,0,12,6510000.0
6510,6510999,20.22035819703416,37.1158413518121,0.0879742650968709,1039.6967206001282,418.6031210422516,966.4931335449219,24448,6378,18070,18070,0,12,6511000.0
6511,6511999,20.219643482471774,37.11419926801111,0.0879687858536935,1039.8778207302094,418.6669936180115,966.7409400939941,24451,6379,18072,18072,0,12,6512000.0
6512,6512999,20.219045078756377,37.1129340970903,0.08796359283315647,1040.0579035282135,418.730516910553,966.9082946777344,24454,6380,18074,18074,0,12,6513000.0
6513,6513999,20.21851310902577,37.11163700211666,0.08795585297249209,1040.2323899269104,418.7942576408386,967.0835075378418,24456,6381,18075,18075,0,12,6514000.0
6514,6514999,20.217655296288875,37.10975444584145,0.08795271681107053,1040.5234444141388,418.85578441619873,967.0696067810059,24463,6384,18079,18079,0,12,6515000.0
6515,6515999,20.217077024534685,37.10828496393747,0.08794870904143837,1040.7646629810333,418.9174106121063,967.2294044494629,24470,6386,18084,18084,0,12,6516000.0
6516,6516999,20.21633039209539,37.10667222268169,0.0879473909653824,1040.9951145648956,418.980553150177,967.3506088256836,24474,6388,18086,18086,0,12,6517000.0
6517,6517999,20.215669972755162,37.10511985627935,0.08794577161040273,1041.1693079471588,419.04210233688354,967.5149574279785,24476,6389,18087,18087,0,12,6518000.0
6518,6518999,20.215097550706673,37.10397912630024,0.08794680897407203,1041.3648781776428,419.1071219444275,967.6692428588867,24478,6390,18088,18088,0,12,6519000.0
6519,6519999,20.214602666055736,37.10250902452521,0.0879478654950967,1041.5886743068695,419.1686861515045,967.7128639221191,24483,6392,18091,18091,0,12,6520000.0
6520,6520999,20.213982790551324,37.101005552984105,0.0879525267621224,1041.7160081863403,419.2298758029938,967.8465843200684,24483,6392,18091,18091,0,12,6521000.0
6521,6521999,20.21336223444738,37.09934908489497,0.0879588838574501,1042.0550048351288,419.2931191921234,967.711856842041,24499,6396,18103,18103,0,12,6522000.0
6522,6522999,20.212875670146392,37.097691788094,0.08797298501144168,1042.2421033382416,419.3554382324219,967.8001022338867,24500,6397,18103,18103,0,12,6523000.0
6523,6523999,20.212487102408648,37.096150946888756,0.08798863252733824,1042.4128646850586,419.4181423187256,967.9459342956543,24503,6398,18105,18105,0,12,6524000.0
6524,6524999,20.211706113718215,37.09429485357757,0.08800109661951583,1042.7631990909576,419.48259830474854,968.5126724243164,24532,6402,18130,18130,0,12,6525000.0
6525,6525999,20.211024858530955,37.09346481892926,0.08799902959956962,1042.879299879074,419.5448007583618,968.9861755371094,24537,6402,18135,18135,0,12,6526000.0
6526,6526999,20.210244906339657,37.09232945033308,0.08800193047785831,1043.119883298874,419.6090624332428,969.1956329345703,24552,6404,18148,18148,0,12,6527000.0
6527,6527999,20.209267464955715,37.09039900152308,0.08800642544832371,1043.2887682914734,419.6701273918152,969.4468688964844,24554,6405,18149,18149,0,12,6528000.0
6528,6528999,20.208385152757824,37.088456242219415,0.08801385015823282,1043.5358493328094,419.73271012306213,969.5790481567383,24559,6407,18152,18152,0,12,6529000.0
6529,6529999,20.20739378718435,37.08650582719877,0.08801966877379352,1043.648093700409,419.7950656414032,969.7699241638184,24559,6407,18152,18152,0,12,6530000.0
6530,6530999,20.20649509847698,37.08468926383956,0.0880267714117754,1043.829609155655,419.85580801963806,969.8672561645508,24562,6408,18154,18154,0,12,6531000.0
6531,6531999,20.20547283150758,37.082771830322834,0.08803528873067612,1044.1788737773895,419.91781759262085,969.7032661437988,24572,6412,18160,18160,0,12,6532000.0
6532,6532999,20.20445275391034,37.08072600529164,0.08804223656854337,1044.4218225479126,419.97913122177124,969.7050971984863,24577,6414,18163,18163,0,12,6533000.0
6533,6533999,20.20346375431424,37.07917319603672,0.08804765087078215,1044.7038745880127,420.0409815311432,969.6875610351562,24584,6417,18167,18167,0,12,6534000.0
6534,6534999,20.202321490152613,37.077119460420846,0.08805877523443872,1044.8195357322693,420.10223841667175,969.9220657348633,24584,6417,18167,18167,0,12,6535000.0
6535,6535999,20.201387791199867,37.07541869825164,0.088070052791825,1045.008998632431,420.1637315750122,969.9870986938477,24587,6418,18169,18169,0,12,6536000.0
6536,6536999,20.20042656279429,37.073821493353485,0.08808288724570368,1045.1885693073273,420.2250437736511,970.0906143188477,24590,6419,18171,18171,0,12,6537000.0
6537,6537999,20.19931972168136,37.07171787842706,0.088097548891517,1045.3116505146027,420.287171125412,970.2793960571289,24590,6419,18171,18171,0,12,6538000.0
6538,6538999,20.198351272720515,37.06982337789118,0.08811043029198784,1045.4323806762695,420.3488681316376,970.4036521911621,24590,6419,18171,18171,0,12,6539000.0
6539,6539999,20.197156610830994,37.067707048371766,0.08812681688742463,1045.556256532669,420.4097135066986,970.5321846008301,24590,6419,18171,18171,0,12,6540000.0
6540,6540999,20.19589801681388,37.06555943595461,0.08814462864426786,1045.749115228653,420.471004486084,970.6093063354492,24593,6420,18173,18173,0,12,6541000.0
6541,6541999,20.195101821922403,37.06540028348497,0.08813591911813701,1045.8781020641327,420.53221893310547,971.3411102294922,24611,6420,18191,18191,0,12,6542000.0
6542,6542999,20.194166780373056,37.063619643342044,0.08813719958627131,1046.0013489723206,420.59534311294556,971.7182922363281,24614,6420,18194,18194,0,12,6543000.0
6543,6543999,20.193581575094438,37.06414760632831,0.08812565106837489,1046.1769428253174,420.65632939338684,971.8656272888184,24618,6421,18197,18197,0,12,6544000.0
6544,6544999,20.192811377981695,37.062653113451034,0.08812580539331027,1046.2989332675934,420.71671748161316,972.073299407959,24618,6421,18197,18197,0,12,6545000.0
6545,6545999,20.192143816627276,37.06145767470036,0.0881249721096411,1046.4298639297485,420.7769088745117,972.2518348693848,24618,6421,18197,18197,0,12,6546000.0
6546,6546999,20.191519047903913,37.06009825144614,0.08812399978806651,1046.676766872406,420.8394365310669,972.2083625793457,24623,6423,18200,18200,0,12,6547000.0
6547,6547999,20.190748372367885,37.058780674235294,0.08812293042908759,1046.8508462905884,420.9000024795532,972.2716674804688,24634,6424,18210,18210,0,12,6548000.0
6548,6548999,20.190054133102997,37.05721834995888,0.08812415346917157,1047.0226805210114,420.9624629020691,972.2855491638184,24637,6425,18212,18212,0,12,6549000.0
6549,6549999,20.189295596978194,37.05590744137621,0.0881204303454246,1047.317078113556,421.0240099430084,972.1877708435059,24645,6428,18217,18217,0,12,6550000.0
6550,6550999,20.188672019168713,37.054688124601796,0.08811533289084905,1047.450041294098,421.085408449173,972.3940277099609,24645,6428,18217,18217,0,12,6551000.0
6551,6551999,20.188188246355715,37.05424705203259,0.0881111183132024,1047.5677943229675,421.1487491130829,972.5109977722168,24645,6428,18217,18217,0,12,6552000.0
6552,6552999,20.18760182510819,37.05292223759659,0.08810902959849143,1047.8224306106567,421.20984172821045,972.4383506774902,24650,6430,18220,18220,0,12,6553000.0
6553,6553999,20.18715179880043,37.052250173116384,0.08810280096125123,1048.0233850479126,421.2847800254822,972.5442924499512,24654,6431,18223,18223,0,12,6554000.0
6554,6554999,20.18660640415301,37.051026221858955,0.08810065957946,1048.141141653061,421.3463830947876,972.7195091247559,24654,6431,18223,18223,0,12,6555000.0
6555,6555999,20.18609932171203,37.04966214748705,0.08809977623375553,1048.3398115634918,421.4110493659973,972.7366600036621,24656,6432,18224,18224,0,12,6556000.0
6556,6556999,20.185661514371066,37.04837516045166,0.08810078012690514,1048.574392080307,421.47304606437683,972.7438316345215,24665,6434,18231,18231,0,12,6557000.0
6557,6557999,20.184966564296623,37.04686764705337,0.08810159180210175,1048.7610371112823,421.53590536117554,972.8142929077148,24669,6435,18234,18234,0,12,6558000.0
6558,6558999,20.1844159736387,37.04533760016392,0.08810262593139984,1048.9621360301971,421.6040976047516,972.894889831543,24671,6436,18235,18235,0,12,6559000.0
6559,6559999,20.183766394419745,37.04472569420831,0.08806993574963051,1049.1419868469238,421.66877579689026,973.4175720214844,24690,6437,18253,18253,0,12,6560000.0
6560,6560999,20.18369136765262,37.04984530449075,0.08801916784734864,1049.2609198093414,421.7295141220093,973.9093322753906,24695,6437,18258,18258,0,12,6561000.0
6561,6561999,20.182885404012904,37.048310478183744,0.08801844093487976,1049.439171552658,421.79122018814087,974.1193084716797,24699,6438,18261,18261,0,12,6562000.0
6562,6562999,20.1822863457021,37.04776065904349,0.08801115132123538,1049.6307933330536,421.8535850048065,974.2507553100586,24704,6439,18265,18265,0,12,6563000.0
6563,6563999,20.181606649307955,37.04626599623854,0.08800970647964179,1049.7535285949707,421.9150722026825,974.4548797607422,24705,6439,18266,18266,0,12,6564000.0
6564,6564999,20.18083748011889,37.045083720319276,0.08800759561510485,1049.8808946609497,421.97611451148987,974.6948890686035,24706,6439,18267,18267,0,12,6565000.0
6565,6565999,20.17997372634643,37.04390349176169,0.08800375092835888,1050.1107711791992,422.0371310710907,974.7388381958008,24711,6441,18270,18270,0,12,6566000.0
6566,6566999,20.179213619510435,37.04235674899895,0.08800319935674117,1050.2333402633667,422.09830379486084,974.8766136169434,24711,6441,18270,18270,0,12,6567000.0
6567,6567999,20.178855335390274,37.041802090653285,0.08799463252134565,1050.5260474681854,422.1591453552246,974.7767486572266,24721,6444,18277,18277,0,12,6568000.0
6568,6568999,20.17845988291615,37.04091512630145,0.08798556695462545,1050.7158675193787,422.2213246822357,974.9389305114746,24723,6445,18278,18278,0,12,6569000.0
6569,6569999,20.177904626137593,37.039659924985365,0.08797913503639232,1050.8893775939941,422.28201723098755,975.0374374389648,24725,6446,18279,18279,0,12,6570000.0
6570,6570999,20.177608661270497,37.039054746986494,0.08796901738341656,1051.0053474903107,422.34293484687805,975.1589736938477,24725,6446,18279,18279,0,12,6571000.0
6571,6571999,20.17766774350238,37.03895374401796,0.08795297585537376,1051.1992585659027,422.4047565460205,975.1696434020996,24727,6447,18280,18280,0,12,6572000.0
6572,6572999,20.177895107968876,37.038654772728336,0.08793894774719657,1051.3783175945282,422.46589756011963,975.2116928100586,24729,6448,18281,18281,0,12,6573000.0
6573,6573999,20.178356359935556,37.03906813433831,0.0879303657707019,1051.6365461349487,422.5299696922302,975.1911544799805,24739,6450,18289,18289,0,12,6574000.0
6574,6574999,20.178970003003805,37.03966980676551,0.0879234383265447,1051.7740256786346,422.59284925460815,975.3352394104004,24739,6450,18289,18289,0,12,6575000.0
6575,6575999,20.180695636782417,37.04289220050181,0.08791362260928803,1051.9474549293518,422.6539602279663,975.3734130859375,24742,6451,18291,18291,0,12,6576000.0
6576,6576999,20.181741066655647,37.04386869384951,0.0879192095925645,1052.1371874809265,422.72035813331604,975.437442779541,24746,6452,18294,18294,0,12,6577000.0
6577,6577999,20.18343649593833,37.04782430134447,0.08790749800257136,1052.3240642547607,422.7827081680298,975.4961357116699,24748,6453,18295,18295,0,12,6578000.0
6578,6578999,20.18519725870822,37.05010756723657,0.08790462585201675,1052.4649558067322,422.84631609916687,975.6115493774414,24748,6453,18295,18295,0,12,6579000.0
6579,6579999,20.186120846800367,37.05070592190735,0.08791102964766773,1052.5872366428375,422.90834522247314,975.7276878356934,24748,6453,18295,18295,0,12,6580000.0
6580,6580999,20.18631093645414,37.05069781391757,0.08791645235314405,1052.9399032592773,422.97104120254517,976.3520812988281,24784,6457,18327,18327,0,12,6581000.0
6581,6581999,20.18562244377842,37.04969835528609,0.08790861756252166,1053.1076967716217,423.0333774089813,976.9475440979004,24792,6458,18334,18334,0,12,6582000.0
6582,6582999,20.1852469562034,37.049442668084716,0.08789821388528751,1053.272183418274,423.09582233428955,977.2927513122559,24795,6459,18336,18336,0,12,6583000.0
6583,6583999,20.185243616109826,37.05154707837945,0.08787985892730288,1053.3879170417786,423.15875029563904,977.708366394043,24798,6459,18339,18339,0,12,6584000.0
6584,6584999,20.185085263820195,37.05061620124596,0.08787560259523786,1053.6069197654724,423.2205386161804,977.9366683959961,24802,6461,18341,18341,0,12,6585000.0
6585,6585999,20.185113724977214,37.05051438540088,0.08786811538081574,1053.893283367157,423.2840175628662,978.0146675109863,24809,6464,18345,18345,0,12,6586000.0
6586,6586999,20.185183581948035,37.04974580206419,0.08786464197037291,1054.1345043182373,423.3472435474396,978.1842308044434,24815,6466,18349,18349,0,12,6587000.0
6587,6587999,20.185232203919927,37.04963531777125,0.08786876210348493,1054.3650357723236,423.4113085269928,978.2699127197266,24820,6468,18352,18352,0,12,6588000.0
6588,6588999,20.185507064251844,37.04993421172585,0.08787160109021785,1054.5427749156952,423.47588634490967,978.4467697143555,24822,6469,18353,18353,0,12,6589000.0
6589,6589999,20.18586371197914,37.05013348621468,0.08787727511101828,1054.772877216339,423.54021167755127,978.5822677612305,24826,6471,18355,18355,0,12,6590000.0
6590,6590999,20.18641266736394,37.05079943515765,0.08789164719290765,1055.0791573524475,423.6044588088989,978.6233787536621,24832,6474,18358,18358,0,12,6591000.0
6591,6591999,20.187225277691695,37.05184355642708,0.08792093924869371,1055.2009398937225,423.6673128604889,978.8838844299316,24832,6474,18358,18358,0,12,6592000.0
6592,6592999,20.188253006995804,37.05332727690214,0.0879546379682814,1055.3309073448181,423.7298073768616,979.0890007019043,24832,6474,18358,18358,0,12,6593000.0
6593,6593999,20.189882860010254,37.05800109522913,0.08798975262358388,1055.5064766407013,423.79241132736206,979.1537590026855,24834,6475,18359,18359,0,12,6594000.0
6594,6594999,20.191047887399925,37.05918776302236,0.08801427598968836,1055.6229166984558,423.8531172275543,979.3248558044434,24834,6475,18359,18359,0,12,6595000.0
6595,6595999,20.19296049086577,37.064354793421245,0.08807033248680851,1055.8476300239563,423.9154989719391,979.3368682861328,24840,6477,18363,18363,0,12,6596000.0
6596,6596999,20.19496650771782,37.0707389697123,0.08811463374990858,1055.975254535675,423.97825026512146,979.4801902770996,24840,6477,18363,18363,0,12,6597000.0
6597,6597999,20.197034925547598,37.07421094676629,0.0881733117991308,1056.2093868255615,424.04168939590454,979.5264053344727,24844,6479,18365,18365,0,12,6598000.0
6598,6598999,20.1988673571392,37.07797851028552,0.0882347923175566,1056.4181246757507,424.10469245910645,979.6360549926758,24846,6480,18366,18366,0,12,6599000.0
6599,6599999,20.200995184509296,37.081421470187394,0.0882979436148128,1056.641794204712,424.1671426296234,979.5995407104492,24850,6482,18368,18368,0,12,6600000.0
6600,6600999,20.20249204447425,37.08319246526742,0.08834624598201413,1056.8242464065552,424.2289876937866,979.8515548706055,24861,6483,18378,18378,0,12,6601000.0
6601,6601999,20.20242650234839,37.08229701177948,0.08833928505411093,1057.0028417110443,424.29285860061646,980.7448883056641,24890,6484,18406,18406,0,12,6602000.0
6602,6602999,20.201366419522355,37.080833870396646,0.08833983702186898,1057.171605348587,424.3575873374939,981.2287864685059,24896,6485,18411,18411,0,12,6603000.0
6603,6603999,20.200594270284704,37.07979069084972,0.08833239015978656,1057.286075592041,424.42019534111023,981.6232986450195,24898,6485,18413,18413,0,12,6604000.0
6604,6604999,20.199758076017996,37.078474509902236,0.08832980413087843,1057.4116480350494,424.48088240623474,981.9323234558105,24899,6485,18414,18414,0,12,6605000.0
6605,6605999,20.199067208026047,37.0773490656307,0.0883282886181751,1057.7555696964264,424.5440640449524,981.8572769165039,24912,6489,18423,18423,0,12,6606000.0
6606,6606999,20.19812345304317,37.07572966613877,0.08833032384456563,1057.9198083877563,424.6062741279602,982.0556297302246,24914,6490,18424,18424,0,12,6607000.0
6607,6607999,20.197164277549064,37.07397689691322,0.08833064435374027,1058.209424495697,424.67069602012634,982.1131248474121,24921,6493,18428,18428,0,12,6608000.0
6608,6608999,20.19629330967061,37.07229207181707,0.08832997014716149,1058.4364008903503,424.7340977191925,982.2938652038574,24925,6495,18430,18430,0,12,6609000.0
6609,6609999,20.195436241065213,37.07046498988381,0.08833070119236763,1058.73295378685,424.79654240608215,982.3285293579102,24933,6498,18435,18435,0,12,6610000.0
6610,6610999,20.194787903188114,37.06921496562248,0.08832697389111288,1059.0249614715576,424.85951137542725,982.371997833252,24941,6501,18440,18440,0,12,6611000.0
6611,6611999,20.194204961097125,37.067787851980604,0.0883232258662523,1059.20028090477,424.9223430156708,982.5960464477539,24943,6502,18441,18441,0,12,6612000.0
6612,6612999,20.193835901662762,37.06719010973894,0.08832051197575508,1059.382596731186,424.98714208602905,982.7009201049805,24945,6503,18442,18442,0,12,6613000.0
6613,6613999,20.193235165450144,37.06568375685935,0.08832113436125122,1059.6159188747406,425.0504515171051,982.7610397338867,24949,6505,18444,18444,0,12,6614000.0
6614,6614999,20.192861269410496,37.06460746938549,0.08831883339832025,1059.8122735023499,425.11332058906555,982.9015846252441,24951,6506,18445,18445,0,12,6615000.0
6615,6615999,20.1923970821145,37.06311557417955,0.0883191929671252,1059.9399070739746,425.17496061325073,983.1099853515625,24951,6506,18445,18445,0,12,6616000.0
6616,6616999,20.19228570178068,37.06240936987225,0.08831858937361425,1060.0592021942139,425.24055194854736,983.2820587158203,24951,6506,18445,18445,0,12,6617000.0
6617,6617999,20.192127006685638,37.06161864065717,0.08831709320914527,1060.1798152923584,425.302193403244,983.4454345703125,24952,6506,18446,18446,0,12,6618000.0
6618,6618999,20.191768256079605,37.060312221883564,0.08831816822883753,1060.3514358997345,425.3639826774597,983.4974479675293,24954,6507,18447,18447,0,12,6619000.0
6619,6619999,20.191499962692625,37.059082679079104,0.08831991665925276,1060.5009582042694,425.42592310905457,983.6887054443359,24954,6507,18447,18447,0,12,6620000.0
6620,6620999,20.191036513487763,37.0575920883785,0.0883207782893608,1060.6966049671173,425.48827934265137,983.7690963745117,24956,6508,18448,18448,0,12,6621000.0
6621,6621999,20.190522408960984,37.05606247673208,0.08831961268898858,1060.8754234313965,425.55097699165344,983.9196662902832,24959,6509,18450,18450,0,12,6622000.0
6622,6622999,20.18979305604126,37.055375601333864,0.08831539336117811,1060.9991319179535,425.61369490623474,985.0107269287109,24987,6509,18478,18478,0,12,6623000.0
6623,6623999,20.188866965599633,37.054001651063246,0.08831254342857664,1061.1125273704529,425.67550444602966,985.4926567077637,24990,6509,18481,18481,0,12,6624000.0
6624,6624999,20.187667451675544,37.051865411718786,0.08832122188614744,1061.3325216770172,425.7374532222748,985.6753578186035,24997,6511,18486,18486,0,12,6625000.0
6625,6625999,20.186797604106786,37.05010238187855,0.08832139447581389,1061.6190099716187,425.8013377189636,985.7696876525879,25003,6514,18489,18489,0,12,6626000.0
6626,6626999,20.18592101823213,37.04857278645202,0.0883226116827932,1061.7382636070251,425.8647620677948,986.0929145812988,25003,6514,18489,18489,0,12,6627000.0
6627,6627999,20.185168588694363,37.04714185727002,0.0883205248821125,1061.9304404258728,425.92810344696045,986.2732048034668,25006,6515,18491,18491,0,12,6628000.0
6628,6628999,20.184201235389345,37.045382798414735,0.08832252051703227,1062.2237994670868,425.9898684024811,986.2832946777344,25013,6518,18495,18495,0,12,6629000.0
6629,6629999,20.18323101564084,37.043699664139595,0.08832577459447699,1062.3352634906769,426.0508050918579,986.5108909606934,25013,6518,18495,18495,0,12,6630000.0
6630,6630999,20.182329596624346,37.04200556849412,0.08832838711901225,1062.6345641613007,426.1131911277771,986.5182037353516,25020,6521,18499,18499,0,12,6631000.0
6631,6631999,20.181330025390096,37.04003608956319,0.08833337289705567,1062.804085969925,426.1745607852936,986.6591720581055,25022,6522,18500,18500,0,12,6632000.0
6632,6632999,20.18029683965723,37.038226491721694,0.08833543996994164,1062.985894203186,426.23790740966797,986.7836990356445,25024,6523,18501,18501,0,12,6633000.0
6633,6633999,20.179351215926925,37.03654223689879,0.08833589116080309,1063.2323248386383,426.3029115200043,986.8465995788574,25037,6525,18512,18512,0,12,6634000.0
6634,6634999,20.178575684161718,37.03549327611262,0.08833228393048032,1063.530802488327,426.3672728538513,986.753475189209,25044,6528,18516,18516,0,12,6635000.0
6635,6635999,20.177864201956915,37.03402952981025,0.08833330962743857,1063.8398704528809,426.43023347854614,986.7768058776855,25050,6531,18519,18519,0,12,6636000.0
6636,6636999,20.177110225203506,37.0328512760699,0.08833014780831627,1064.0203220844269,426.4924147129059,986.9762115478516,25052,6532,18520,18520,0,12,6637000.0
6637,6637999,20.17646095518216,37.03133318261267,0.08832767299311284,1064.2007217407227,426.55739665031433,987.1203994750977,25056,6533,18523,18523,0,12,6638000.0
6638,6638999,20.175772217227355,37.02981887677957,0.0883254400772201,1064.383377313614,426.6201808452606,987.2501106262207,25058,6534,18524,18524,0,12,6639000.0
6639,6639999,20.17509391496765,37.028335331850364,0.08832471231291772,1064.7014977931976,426.68324613571167,987.171012878418,25064,6537,18527,18527,0,12,6640000.0
6640,6640999,20.174507981509954,37.02895627104132,0.08831704862126566,1064.8234190940857,426.74590277671814,987.3710556030273,25064,6537,18527,18527,0,12,6641000.0
6641,6641999,20.17367292757731,37.02719319055513,0.08832079311132901,1065.006115436554,426.80856823921204,987.4487380981445,25067,6538,18529,18529,0,12,6642000.0
6642,6642999,20.172971001038675,37.025466789069654,0.08832520292106583,1065.2102448940277,426.87454104423523,988.2542991638184,25098,6539,18559,18559,0,12,6643000.0
6643,6643999,20.17208800243073,37.024318367766696,0.08832328944081613,1065.3208706378937,426.9368007183075,988.8219146728516,25102,6539,18563,18563,0,12,6644000.0
6644,6644999,20.171072718485124,37.02255183144058,0.08832624114814425,1065.4339287281036,426.9972770214081,989.2133445739746,25104,6539,18565,18565,0,12,6645000.0
6645,6645999,20.170098510679463,37.020868849101745,0.08833002200244522,1065.5484132766724,427.0582745075226,989.5182456970215,25105,6539,18566,18566,0,12,6646000.0
6646,6646999,20.169518009297022,37.01946497567614,0.0883268014552524,1065.839283466339,427.1194021701813,989.6097030639648,25111,6542,18569,18569,0,12,6647000.0
6647,6647999,20.168800110848736,37.01786619753483,0.08831787601783736,1066.0646920204163,427.18123960494995,989.7328567504883,25115,6544,18571,18571,0,12,6648000.0
6648,6648999,20.168123122116985,37.0161732266673,0.08831460295588267,1066.3001658916473,427.242582321167,989.8514556884766,25119,6546,18573,18573,0,12,6649000.0
6649,6649999,20.16760504851393,37.01479171534946,0.08830481209477403,1066.4635162353516,427.3031532764435,990.0484848022461,25121,6547,18574,18574,0,12,6650000.0
6650,6650999,20.167092758947973,37.013475138816716,0.08829711744328772,1066.5966053009033,427.36443734169006,990.251277923584,25121,6547,18574,18574,0,12,6651000.0
6651,6651999,20.16660567842695,37.012365403473225,0.08829030075762545,1066.886750459671,427.4287054538727,990.2184143066406,25127,6550,18577,18577,0,12,6652000.0
6652,6652999,20.166259041293042,37.011319281587724,0.08828529915866423,1067.0782988071442,427.4915101528168,990.2313117980957,25131,6551,18580,18580,0,12,6653000.0
6653,6653999,20.165724833996247,37.010292049262176,0.08828212347237552,1067.21288895607,427.5526428222656,990.4161376953125,25131,6551,18580,18580,0,12,6654000.0
6654,6654999,20.165188667832087,37.00920659570031,0.08828193702451637,1067.3908154964447,427.614040851593,990.4790725708008,25133,6552,18581,18581,0,12,6655000.0
6655,6655999,20.164747790923006,37.00881604822804,0.08827744918128477,1067.622897386551,427.6763458251953,990.4318199157715,25137,6554,18583,18583,0,12,6656000.0
6656,6656999,20.16413958857065,37.00748442163894,0.0882809476223343,1067.8092150688171,427.740909576416,990.5995788574219,25139,6555,18584,18584,0,12,6657000.0
6657,6657999,20.16405349678812,37.007380260487196,0.08827813075576918,1067.936294555664,431.54406571388245,990.7676467895508,25139,6555,18584,18584,0,12,6658000.0
6658,6658999,20.163699096216057,37.006416201767166,0.0882807451897335,1068.1437754631042,431.609486579895,990.8124198913574,25141,6556,18585,18585,0,12,6659000.0
6659,6659999,20.163303481601297,37.00533581197743,0.08827738442830535,1068.3329029083252,431.6737394332886,990.9004020690918,25143,6557,18586,18586,0,12,6660000.0
6660,6660999,20.162878551883935,37.00410486376323,0.08827926822390453,1068.5160083770752,431.73637199401855,990.9162483215332,25145,6558,18587,18587,0,12,6661000.0
6661,6661999,20.16245258042609,37.00271999178115,0.0882836172345518,1068.6406631469727,431.7991533279419,991.0767250061035,25145,6558,18587,18587,0,12,6662000.0
6662,6662999,20.161844214831998,37.00106479364046,0.08828782745161012,1068.8280546665192,431.86295104026794,991.1556854248047,25147,6559,18588,18588,0,12,6663000.0
6663,6663999,20.161815256703058,37.00095368896803,0.08829537806096388,1069.0807478427887,431.9260609149933,991.9519538879395,25178,6561,18617,18617,0,12,6664000.0
6664,6664999,20.161582271663047,37.00042643366405,0.08830405821116183,1069.1971192359924,431.98752641677856,992.5198402404785,25180,6561,18619,18619,0,12,6665000.0
6665,6665999,20.161106614066636,36.99934037099645,0.08829940391413671,1069.369277715683,432.04925537109375,992.8431968688965,25183,6562,18621,18621,0,12,6666000.0
6666,6666999,20.160753534406794,36.99828559365038,0.08829433510652973,1069.5456330776215,432.11153984069824,993.1246643066406,25186,6563,18623,18623,0,12,6667000.0
6667,6667999,20.160679841261818,36.99779928332575,0.08829440204921224,1069.7287781238556,432.17278361320496,993.3201065063477,25188,6564,18624,18624,0,12,6668000.0
6668,6668999,20.16050493568084,36.99715590660218,0.08828651062812787,1069.9090750217438,432.23399925231934,993.4605102539062,25190,6565,18625,18625,0,12,6669000.0
6669,6669999,20.16051644688868,36.99659904948844,0.08829514732065791,1070.155181646347,432.2979109287262,993.5364112854004,25194,6567,18627,18627,0,12,6670000.0
6670,6670999,20.16049267142198,36.99603533150627,0.08830431547644912,1070.4603562355042,432.3601257801056,993.5699119567871,25200,6570,18630,18630,0,12,6671000.0
6671,6671999,20.160514501590796,36.9954538675005,0.08828661361792822,1070.6401994228363,432.4224967956543,993.7109603881836,25202,6571,18631,18631,0,12,6672000.0
6672,6672999,20.160481907857317,36.994735675398665,0.08829159087047433,1070.8148303031921,432.48646068573,993.8856086730957,25204,6572,18632,18632,0,12,6673000.0
6673,6673999,20.160583010628738,36.995023090608036,0.08828160742626023,1071.189379453659,432.54968786239624,993.8050498962402,25212,6576,18636,18636,0,12,6674000.0
6674,6674999,20.160754573603235,36.99506325241334,0.08826686065115563,1071.434735774994,432.6129095554352,993.8818321228027,25224,6578,18646,18646,0,12,6675000.0
6675,6675999,20.160883023910806,36.99498529933534,0.08825446345379873,1071.744266986847,432.67775225639343,993.8700180053711,25230,6581,18649,18649,0,12,6676000.0
6676,6676999,20.161423858259372,36.996079774044816,0.08824991161581908,1071.9945023059845,432.7435817718506,993.9262313842773,25234,6583,18651,18651,0,12,6677000.0
6677,6677999,20.162316959882354,36.99783294115739,0.08824178682637551,1072.1257112026215,432.8062119483948,994.1348724365234,25234,6583,18651,18651,0,12,6678000.0
6678,6678999,20.16295895431427,36.99866470999516,0.08823351193765994,1072.3122699260712,432.86855697631836,994.2822074890137,25236,6584,18652,18652,0,12,6679000.0
6679,6679999,20.163939397765432,37.0004413395173,0.08825461966530224,1072.4268403053284,432.9321527481079,994.4566955566406,25236,6584,18652,18652,0,12,6680000.0
6680,6680999,20.164974323702673,37.00226441404876,0.08826502446411588,1072.618584394455,432.99489092826843,994.4801559448242,25240,6585,18655,18655,0,12,6681000.0
6681,6681999,20.166067255913262,37.004106368280304,0.08828603086665032,1072.827666759491,433.0606451034546,994.5824165344238,25242,6586,18656,18656,0,12,6682000.0
6682,6682999,20.16755127684437,37.00686976370833,0.08832668235908736,1072.9526813030243,433.12605023384094,994.7341499328613,25242,6586,18656,18656,0,12,6683000.0
6683,6683999,20.168654199950776,37.009561352525374,0.08833578289665833,1073.2194731235504,433.1887803077698,994.7319259643555,25248,6588,18660,18660,0,12,6684000.0
6684,6684999,20.169234719106605,37.011943882813426,0.08832151074370043,1073.42999958992,433.2778444290161,995.2480888366699,25256,6589,18667,18667,0,12,6685000.0
6685,6685999,20.169589206896624,37.02211801286037,0.0882674136674585,1073.6270689964294,433.33778381347656,995.4012069702148,25258,6590,18668,18668,0,12,6686000.0
6686,6686999,20.169516458472646,37.02271925733581,0.08825559827594343,1073.8133053779602,433.3987820148468,996.193244934082,25277,6591,18686,18686,0,12,6687000.0
6687,6687999,20.1695362249998,37.02560019102023,0.08823089679522522,1073.9310052394867,433.46025371551514,996.6769065856934,25281,6591,18690,18690,0,12,6688000.0
6688,6688999,20.169108676039492,37.02487813537196,0.0882251759207775,1074.0468389987946,433.52052569389343,996.9330139160156,25282,6591,18691,18691,0,12,6689000.0
6689,6689999,20.169100945481063,37.02748940088144,0.0882049383850928,1074.1722974777222,433.5807685852051,997.1608543395996,25283,6591,18692,18692,0,12,6690000.0
6690,6690999,20.169204835839974,37.02788721612196,0.08819915215717533,1074.4144032001495,433.642427444458,997.2980918884277,25288,6593,18695,18695,0,12,6691000.0
6691,6691999,20.16902845825746,37.02703209932705,0.088194567645828,1074.5552978515625,433.7046196460724,997.5088844299316,25289,6593,18696,18696,0,12,6692000.0
6692,6692999,20.169697032404116,37.029129999664626,0.08817697070882102,1074.687628030777,433.7641956806183,997.6616516113281,25289,6593,18696,18696,0,12,6693000.0
6693,6693999,20.170061299297267,37.03006008105471,0.08816049808879989,1074.821712255478,433.8232328891754,997.7484359741211,25289,6593,18696,18696,0,12,6694000.0
6694,6694999,20.171166502675938,37.03278784960566,0.08814320124846253,1074.955323934555,433.88519167900085,997.8755493164062,25289,6593,18696,18696,0,12,6695000.0
6695,6695999,20.172321376325726,37.03941543804226,0.08810895151340581,1075.2118935585022,433.94498801231384,997.8403358459473,25294,6595,18699,18699,0,12,6696000.0
6696,6696999,20.17340607473001,37.041660442360644,0.08810547371244248,1075.5203931331635,434.0051357746124,997.8619499206543,25306,6598,18708,18708,0,12,6697000.0
6697,6697999,20.174327775739677,37.044254611758454,0.08809834853143528,1075.7010791301727,434.06494665145874,997.937572479248,25308,6599,18709,18709,0,12,6698000.0
6698,6698999,20.17600738278889,37.05056779003206,0.08808890852274198,1075.8306782245636,434.1251382827759,998.1131019592285,25309,6599,18710,18710,0,12,6699000.0
6699,6699999,20.17643984019724,37.05059008749538,0.08809016837540518,1075.9627497196198,434.18512058258057,998.4884147644043,25314,6599,18715,18715,0,12,6700000.0
6700,6700999,20.17685969589454,37.052817132962986,0.08804010737624057,1076.1445174217224,434.2442502975464,998.7171249389648,25317,6600,18717,18717,0,12,6701000.0
6701,6701999,20.176885432260402,37.05275330886238,0.08802467905086842,1076.299660205841,434.3036832809448,998.8928184509277,25317,6600,18717,18717,0,12,6702000.0
6702,6702999,20.17741791204069,37.05377611252679,0.08800108467613521,1076.4874858856201,434.36317682266235,998.9935760498047,25319,6601,18718,18718,0,12,6703000.0
6703,6703999,20.177629592249005,37.05415427659011,0.08796207238905462,1076.7418913841248,434.4231481552124,998.9598541259766,25323,6603,18720,18720,0,12,6704000.0
6704,6704999,20.177989854212036,37.05442851012722,0.08793556183914142,1076.916502714157,434.4816553592682,999.0267219543457,25325,6604,18721,18721,0,12,6705000.0
6705,6705999,20.178473152638702,37.054812436862974,0.0879287290072106,1077.0467381477356,434.54128336906433,999.1519165039062,25326,6604,18722,18722,0,12,6706000.0
6706,6706999,20.17897483456754,37.05530284390072,0.08791403747078863,1077.1970853805542,434.6022069454193,999.2378311157227,25326,6604,18722,18722,0,12,6707000.0
6707,6707999,20.17994842992175,37.05714161085175,0.08790251333811216,1077.3188695907593,434.6609923839569,999.3096008300781,25326,6604,18722,18722,0,12,6708000.0
6708,6708999,20.18081727401394,37.05825465741575,0.0878960779624951,1077.4604995250702,434.7204463481903,999.384693145752,25326,6604,18722,18722,0,12,6709000.0
6709,6709999,20.181982796351896,37.05958364125635,0.0878902264816277,1077.5996344089508,434.7796981334686,999.431884765625,25326,6604,18722,18722,0,12,6710000.0
6710,6710999,20.182772050909474,37.06056968187121,0.08788477016259966,1077.797370672226,434.8394696712494,999.3889961242676,25339,6605,18734,18734,0,12,6711000.0
6711,6711999,20.183856539208943,37.06225325941373,0.08787450694332233,1078.004653930664,434.89931297302246,999.4559631347656,25341,6606,18735,18735,0,12,6712000.0
6712,6712999,20.18532500631511,37.06511786508654,0.08786440492532488,1078.211029291153,434.9600739479065,999.4967575073242,25343,6607,18736,18736,0,12,6713000.0
6713,6713999,20.186700137469273,37.066682818346614,0.08785927679732919,1078.5056955814362,435.02029061317444,999.4127311706543,25349,6610,18739,18739,0,12,6714000.0
6714,6714999,20.18829955700602,37.06964806201321,0.08784883156739498,1078.6536221504211,435.0806522369385,999.5993385314941,25349,6610,18739,18739,0,12,6715000.0
6715,6715999,20.18930214248255,37.070700566427746,0.08784837964685432,1078.7891337871552,435.1403076648712,999.7238883972168,25349,6610,18739,18739,0,12,6716000.0
6716,6716999,20.190829998497353,37.07237723561472,0.08783481195422238,1078.9186305999756,435.19979596138,999.7867202758789,25349,6610,18739,18739,0,12,6717000.0
6717,6717999,20.1920830882158,37.07349192373029,0.08783026167004637,1079.1409969329834,435.25951170921326,999.8066558837891,25351,6611,18740,18740,0,12,6718000.0
6718,6718999,20.192743558760274,37.07460383868932,0.08780385952352154,1079.312621831894,435.31931614875793,1000.0425491333008,25356,6612,18744,18744,0,12,6719000.0
6719,6719999,20.192940132515314,37.07607548131332,0.08777763953418505,1079.507408618927,435.37908959388733,1000.1348342895508,25359,6613,18746,18746,0,12,6720000.0
6720,6720999,20.192712493503876,37.07514417534752,0.08776457461247611,1079.631510734558,435.4389843940735,1000.371467590332,25361,6613,18748,18748,0,12,6721000.0
6721,6721999,20.192597154589585,37.074286084290485,0.0877489678932204,1079.8305869102478,435.4986081123352,1000.4231643676758,25363,6614,18749,18749,0,12,6722000.0
6722,6722999,20.19272021937943,37.0743757392634,0.08773240986464159,1079.9592366218567,435.55928349494934,1000.5517501831055,25364,6614,18750,18750,0,12,6723000.0
6723,6723999,20.19277609123989,37.07368503073591,0.0877166071733686,1080.1512923240662,435.6189765930176,1000.6161651611328,25366,6615,18751,18751,0,12,6724000.0
6724,6724999,20.192744841822417,37.072806730336,0.08770547447271693,1080.2940843105316,435.6777763366699,1000.7175979614258,25366,6615,18751,18751,0,12,6725000.0
6725,6725999,20.19288892295255,37.07245622517163,0.08769661912702176,1080.4366087913513,435.73734855651855,1000.796516418457,25366,6615,18751,18751,0,12,6726000.0
6726,6726999,20.19305329815631,37.07195104215902,0.08768476252353374,1080.569419145584,435.7960023880005,1000.8576011657715,25366,6615,18751,18751,0,12,6727000.0
6727,6727999,20.19364690410026,37.0726184359062,0.08766614505855619,1080.7651779651642,435.8582139015198,1000.7770042419434,25369,6616,18753,18753,0,12,6728000.0
6728,6728999,20.194156616355,37.0727631271931,0.08764901656439872,1080.9042012691498,435.91839599609375,1000.8542594909668,25369,6616,18753,18753,0,12,6729000.0
6729,6729999,20.194628526237416,37.072672986039585,0.08763841068276268,1081.1726341247559,435.9784803390503,1000.7556228637695,25373,6618,18755,18755,0,12,6730000.0
6730,6730999,20.19531591492844,37.07318450271883,0.08762491368100367,1081.3815343379974,436.0425136089325,1000.7776641845703,25375,6619,18756,18756,0,12,6731000.0
6731,6731999,20.19586422099875,37.07324534378785,0.08761088842976128,1081.507395029068,436.10242319107056,1000.8657455444336,25375,6619,18756,18756,0,12,6732000.0
6732,6732999,20.196280206678164,37.072973343402026,0.08760115674839708,1081.71515750885,436.1621747016907,1000.8330917358398,25378,6620,18758,18758,0,12,6733000.0
6733,6733999,20.19717728984152,37.073558542518924,0.08759137094896752,1081.8260660171509,436.22248911857605,1000.9063911437988,25378,6620,18758,18758,0,12,6734000.0
6734,6734999,20.19755553673705,37.07310488436858,0.08758618702794263,1081.9645028114319,436.2825927734375,1000.9781913757324,25378,6620,18758,18758,0,12,6735000.0
6735,6735999,20.19805980456956,37.07270788961001,0.08757712509334015,1082.1016120910645,436.34335470199585,1001.0132904052734,25378,6620,18758,18758,0,12,6736000.0
6736,6736999,20.198499200205127,37.07235131729794,0.0875690825601324,1082.3152797222137,436.40262246131897,1000.9204177856445,25380,6621,18759,18759,0,12,6737000.0
6737,6737999,20.198927058833345,37.07176577726717,0.08756300787037508,1082.5823085308075,436.4639792442322,1000.8523902893066,25385,6623,18762,18762,0,12,6738000.0
6738,6738999,20.199029321805423,37.070580393792824,0.0875565188181302,1082.7023015022278,436.5244925022125,1001.1225700378418,25391,6623,18768,18768,0,12,6739000.0
6739,6739999,20.198551270248746,37.06908140293769,0.0875516608559157,1082.82111120224,436.5841181278229,1001.5373153686523,25394,6623,18771,18771,0,12,6740000.0
6740,6740999,20.19798444335346,37.06811981158219,0.08754507171658199,1083.0117073059082,436.6472098827362,1001.6640892028809,25396,6624,18772,18772,0,12,6741000.0
6741,6741999,20.19740156970983,37.06683066839553,0.08754366244097944,1083.2076587677002,436.70745182037354,1001.8592109680176,25398,6625,18773,18773,0,12,6742000.0
6742,6742999,20.196975432799885,37.065426128667,0.08754054327381844,1083.3844771385193,436.76890110969543,1002.0037841796875,25400,6626,18774,18774,0,12,6743000.0
6743,6743999,20.196655731410065,37.063991811561394,0.08753327412282574,1083.5259282588959,436.8279318809509,1002.1394805908203,25400,6626,18774,18774,0,12,6744000.0
6744,6744999,20.196213760133652,37.062491477511664,0.08753277730150588,1083.7037987709045,436.88848185539246,1002.2201919555664,25402,6627,18775,18775,0,12,6745000.0
6745,6745999,20.195960738949278,37.06147829373153,0.08752984979095535,1083.9016363620758,436.9490396976471,1002.2455863952637,25404,6628,18776,18776,0,12,6746000.0
6746,6746999,20.195756737244057,37.06068415724302,0.08752364413146019,1084.039802789688,437.00959300994873,1002.3417816162109,25404,6628,18776,18776,0,12,6747000.0
6747,6747999,20.195639965038072,37.05976843883438,0.08751536151233119,1084.1747462749481,437.0707416534424,1002.4375801086426,25404,6628,18776,18776,0,12,6748000.0
6748,6748999,20.195606286572342,37.05950325046225,0.08750960111719197,1084.3633348941803,437.1332788467407,1002.377124786377,25406,6629,18777,18777,0,12,6749000.0
6749,6749999,20.1953963157122,37.0584405104583,0.08750787809748373,1084.5547688007355,437.1941044330597,1002.4228515625,25408,6630,18778,18778,0,12,6750000.0
6750,6750999,20.19546802065043,37.05775616173035,0.0875034049818334,1084.7516400814056,437.2551691532135,1002.453052520752,25410,6631,18779,18779,0,12,6751000.0
6751,6751999,20.195712714776896,37.059230287623855,0.08749181626649316,1085.0008881092072,437.3160893917084,1002.4260177612305,25414,6633,18781,18781,0,12,6752000.0
6752,6752999,20.1960658191836,37.05911213288312,0.0874858305023497,1085.14861536026,437.3767828941345,1002.5231513977051,25414,6633,18781,18781,0,12,6753000.0
6753,6753999,20.196789200128336,37.05981477869513,0.08747533186069989,1085.2760150432587,437.4373531341553,1002.6310653686523,25414,6633,18781,18781,0,12,6754000.0
6754,6754999,20.197528481256168,37.061923264020194,0.08746149591725594,1085.4068365097046,437.497704744339,1002.701057434082,25414,6633,18781,18781,0,12,6755000.0
6755,6755999,20.198537672008023,37.062920750048306,0.08745843422728339,1085.5932083129883,437.5585379600525,1002.6748275756836,25416,6634,18782,18782,0,12,6756000.0
6756,6756999,20.199333633369655,37.06374806135174,0.08745082659356529,1085.746065378189,437.624951839447,1002.7547836303711,25416,6634,18782,18782,0,12,6757000.0
6757,6757999,20.200098401714932,37.06445942711128,0.08744548309274869,1086.0045154094696,437.6864151954651,1002.6737861633301,25422,6636,18786,18786,0,12,6758000.0
6758,6758999,20.200373083070858,37.06392219936054,0.08743641690563309,1086.1894352436066,437.74734449386597,1003.1059989929199,25436,6637,18799,18799,0,12,6759000.0
6759,6759999,20.20025670146143,37.06376402235629,0.08742742950649396,1086.3045880794525,437.81070733070374,1003.4020500183105,25436,6637,18799,18799,0,12,6760000.0
6760,6760999,20.200575857719084,37.06488580841396,0.08741298178047141,1086.4713623523712,437.8708839416504,1003.5655822753906,25438,6638,18800,18800,0,12,6761000.0
6761,6761999,20.201077809350263,37.0657985751753,0.08740266022691179,1086.7390892505646,437.9332957267761,1003.6765594482422,25443,6640,18803,18803,0,12,6762000.0
6762,6762999,20.20190193591981,37.066751797600006,0.08740565848935156,1087.1019237041473,437.9942467212677,1003.6040992736816,25460,6644,18816,18816,0,12,6763000.0
6763,6763999,20.20295143307865,37.068193657847544,0.08741569748171052,1087.3461499214172,438.05725026130676,1003.679859161377,25470,6646,18824,18824,0,12,6764000.0
6764,6764999,20.20373283575144,37.068837511816625,0.08742499228371592,1087.5511224269867,438.1192514896393,1003.8304901123047,25472,6647,18825,18825,0,12,6765000.0
6765,6765999,20.205051370869004,37.07082891922231,0.08742577310008659,1087.7311687469482,438.1820192337036,1003.8783340454102,25477,6648,18829,18829,0,12,6766000.0
6766,6766999,20.206005405603047,37.07175518848677,0.08743523221736382,1087.919591665268,438.2431025505066,1003.8956451416016,25482,6649,18833,18833,0,12,6767000.0
6767,6767999,20.20702080220154,37.07254317739285,0.0874471170848603,1088.1081812381744,438.30608201026917,1003.9778137207031,25484,6650,18834,18834,0,12,6768000.0
6768,6768999,20.208498279061114,37.07408636508964,0.08747717646841047,1088.297913312912,438.36758732795715,1004.0184745788574,25486,6651,18835,18835,0,12,6769000.0
6769,6769999,20.209820786069997,37.07586956593371,0.08750279156667273,1088.5597343444824,438.4288513660431,1004.0263519287109,25490,6653,18837,18837,0,12,6770000.0
6770,6770999,20.210886676145055,37.07716916007167,0.08752149777859852,1088.7481005191803,438.4904935359955,1004.0912933349609,25492,6654,18838,18838,0,12,6771000.0
6771,6771999,20.211954908561218,37.078444220062785,0.08753269977940525,1088.8904769420624,438.55082869529724,1004.2700004577637,25492,6654,18838,18838,0,12,6772000.0
6772,6772999,20.213462021327434,37.0805485896869,0.08754428498867262,1089.021595954895,438.6107051372528,1004.389045715332,25492,6654,18838,18838,0,12,6773000.0
6773,6773999,20.214927914695025,37.08225767339043,0.08754184153301103,1089.1615426540375,438.6728479862213,1004.496021270752,25492,6654,18838,18838,0,12,6774000.0
6774,6774999,20.21650247347143,37.083816660127226,0.08754606980111868,1089.2948515415192,438.7333827018738,1004.5723762512207,25492,6654,18838,18838,0,12,6775000.0
6775,6775999,20.21796781509086,37.08558387020226,0.08753757536476403,1089.537594795227,438.79404878616333,1004.5011749267578,25496,6656,18840,18840,0,12,6776000.0
6776,6776999,20.219157922529554,37.08644790709605,0.08754551141227052,1089.6786592006683,438.85549759864807,1004.5953598022461,25496,6656,18840,18840,0,12,6777000.0
6777,6777999,20.21987588662863,37.086456333940916,0.08753700685993626,1089.7977273464203,438.91572737693787,1004.7123260498047,25496,6656,18840,18840,0,12,6778000.0
6778,6778999,20.219571255094024,37.08565522963033,0.08752766454766736,1089.9195575714111,438.97594118118286,1005.5014190673828,25510,6656,18854,18854,0,12,6779000.0
6779,6779999,20.218740705013943,37.084650042283215,0.0875253327666713,1090.03728723526,439.03562235832214,1005.7799339294434,25510,6656,18854,18854,0,12,6780000.0
6780,6780999,20.217945796716855,37.08299665236733,0.08752323609023482,1090.3883621692657,439.0980498790741,1005.7821998596191,25524,6660,18864,18864,0,12,6781000.0
6781,6781999,20.21744876118807,37.08297527929186,0.087511080641823,1090.6877472400665,439.1591901779175,1005.8432922363281,25531,6663,18868,18868,0,12,6782000.0
6782,6782999,20.216759207809655,37.08129823870134,0.0875090430817248,1090.8887794017792,439.22352933883667,1006.0172500610352,25533,6664,18869,18869,0,12,6783000.0
6783,6783999,20.215960598884315,37.07952493881717,0.087509555810945,1091.0836582183838,439.2873089313507,1006.1761283874512,25535,6665,18870,18870,0,12,6784000.0
6784,6784999,20.215358357224932,37.07827304664983,0.0875066788756842,1091.2584874629974,439.3483781814575,1006.2865829467773,25537,6666,18871,18871,0,12,6785000.0
6785,6785999,20.214799358965283,37.07681289850628,0.08750460018170414,1091.3927779197693,439.4095666408539,1006.4159317016602,25537,6666,18871,18871,0,12,6786000.0
6786,6786999,20.214433424097702,37.076169157435665,0.08749728831052739,1091.5452253818512,439.47301054000854,1006.5032653808594,25537,6666,18871,18871,0,12,6787000.0
6787,6787999,20.21406301853821,37.0749309240581,0.08749035662773175,1091.7350375652313,439.53614258766174,1006.4831275939941,25539,6667,18872,18872,0,12,6788000.0
6788,6788999,20.213709884750042,37.07377098219209,0.0874868563610558,1091.9388036727905,439.59749364852905,1006.4714202880859,25541,6668,18873,18873,0,12,6789000.0
6789,6789999,20.213486550875064,37.073068575581395,0.0874820570768935,1092.1982915401459,439.66039276123047,1006.4745178222656,25545,6670,18875,18875,0,12,6790000.0
6790,6790999,20.213408726393613,37.072319809358035,0.08747989003616652,1092.4364728927612,439.72190737724304,1006.4932479858398,25549,6672,18877,18877,0,12,6791000.0
6791,6791999,20.213306369887796,37.07150614598069,0.08747889465282366,1092.6978561878204,439.78676652908325,1006.5051498413086,25553,6674,18879,18879,0,12,6792000.0
6792,6792999,20.213356758293113,37.070889492584826,0.08747601754814138,1092.8368406295776,439.8508331775665,1006.6743927001953,25553,6674,18879,18879,0,12,6793000.0
6793,6793999,20.21377367740938,37.070852087983425,0.08747562239593476,1093.0276637077332,439.91303062438965,1006.7619552612305,25555,6675,18880,18880,0,12,6794000.0
6794,6794999,20.214154999880318,37.070866500403056,0.08747179355599177,1093.2182297706604,439.9759237766266,1006.7885932922363,25561,6676,18885,18885,0,12,6795000.0
6795,6795999,20.214967085916644,37.071286508741906,0.0874689848562541,1093.4187228679657,440.04046630859375,1006.802562713623,25567,6677,18890,18890,0,12,6796000.0
6796,6796999,20.215685258870355,37.071439045898394,0.08746009311419556,1093.610868215561,440.1012020111084,1006.8587608337402,25569,6678,18891,18891,0,12,6797000.0
6797,6797999,20.216524645331276,37.071796681030534,0.08745159933141244,1093.8058211803436,440.1626560688019,1006.8925743103027,25571,6679,18892,18892,0,12,6798000.0
6798,6798999,20.21689866079541,37.071365957084595,0.08744154288432371,1093.9924476146698,440.2241835594177,1007.536075592041,25589,6680,18909,18909,0,12,6799000.0
6799,6799999,20.216254125487506,37.07027098332122,0.0874331347642261,1094.0985991954803,440.2860095500946,1008.0328254699707,25590,6680,18910,18910,0,12,6800000.0
6800,6800999,20.215772085251007,37.06917114694826,0.08742622199733063,1094.2187850475311,440.3479599952698,1008.3596534729004,25590,6680,18910,18910,0,12,6801000.0
6801,6801999,20.21562234508579,37.06852128295502,0.08742165988628392,1094.4039857387543,440.4111592769623,1008.5535316467285,25592,6681,18911,18911,0,12,6802000.0
6802,6802999,20.21578006837729,37.06818365681059,0.08741444500264495,1094.6400628089905,440.4740037918091,1008.5766410827637,25596,6683,18913,18913,0,12,6803000.0
6803,6803999,20.21574817445368,37.06762512009109,0.08740835076648912,1094.8826940059662,440.5352861881256,1008.7011032104492,25600,6685,18915,18915,0,12,6804000.0
6804,6804999,20.21579207828839,37.06678831078957,0.08740622778744034,1095.024719953537,440.59658670425415,1008.9183692932129,25600,6685,18915,18915,0,12,6805000.0
6805,6805999,20.215643169554824,37.06612553122932,0.08739940074421493,1095.335123538971,440.65868282318115,1008.939826965332,25606,6688,18918,18918,0,12,6806000.0
6806,6806999,20.215735024685852,37.06571045637196,0.08738927420004439,1095.5134427547455,440.72231101989746,1009.0620765686035,25608,6689,18919,18919,0,12,6807000.0
6807,6807999,20.215964247819347,37.06543245827253,0.08738368309577016,1095.6659893989563,440.78645181655884,1009.2028045654297,25608,6689,18919,18919,0,12,6808000.0
6808,6808999,20.216113193597067,37.06471299379,0.08737561491108925,1095.9088366031647,440.8487741947174,1009.1581268310547,25612,6691,18921,18921,0,12,6809000.0
6809,6809999,20.216219681439416,37.0639248779133,0.08736371303655222,1096.1101868152618,440.9123332500458,1009.2161674499512,25614,6692,18922,18922,0,12,6810000.0
6810,6810999,20.2169781450574,37.06448183697006,0.08735672288515062,1096.413083076477,440.97471261024475,1009.1675071716309,25620,6695,18925,18925,0,12,6811000.0
6811,6811999,20.21756789679073,37.06453096160603,0.08734464034541833,1096.6130814552307,441.0398542881012,1009.2713851928711,25622,6696,18926,18926,0,12,6812000.0
6812,6812999,20.2185650486101,37.06525756445025,0.08733455827132952,1096.8939743041992,441.10176134109497,1009.2745780944824,25626,6698,18928,18928,0,12,6813000.0
6813,6813999,20.219560680089494,37.06582032012757,0.08733441649467777,1097.0434527397156,441.1661341190338,1009.4597969055176,25626,6698,18928,18928,0,12,6814000.0
6814,6814999,20.220463718307546,37.06628198788626,0.08733099577251169,1097.2381439208984,441.22778272628784,1009.5221099853516,25628,6699,18929,18929,0,12,6815000.0
6815,6815999,20.221473531896592,37.066491111001135,0.08732678177702613,1097.425747871399,441.2891252040863,1009.5525856018066,25630,6700,18930,18930,0,12,6816000.0
6816,6816999,20.222681553439784,37.06704851687494,0.08732558518810662,1097.6201684474945,441.35114336013794,1009.6490898132324,25638,6701,18937,18937,0,12,6817000.0
6817,6817999,20.22380075853056,37.067386975615776,0.08732513475352821,1097.7485980987549,441.4152190685272,1009.7425880432129,25638,6701,18937,18937,0,12,6818000.0
6818,6818999,20.224676166373385,37.06755425640746,0.08732313086519095,1097.9509530067444,441.47651624679565,1009.82666015625,25640,6702,18938,18938,0,12,6819000.0
6819,6819999,20.224653789097225,37.06704355913203,0.08730742633594057,1098.1369724273682,441.5376513004303,1010.4649505615234,25654,6703,18951,18951,0,12,6820000.0
6820,6820999,20.22425198788802,37.0662234018311,0.08730038495773484,1098.2552134990692,441.5981237888336,1010.8664741516113,25654,6703,18951,18951,0,12,6821000.0
6821,6821999,20.223819758093455,37.06489275439057,0.08729619745200556,1098.43958902359,441.65807151794434,1010.9896659851074,25660,6704,18956,18956,0,12,6822000.0
6822,6822999,20.22333084123897,37.063421245259384,0.08729730209253661,1098.6337060928345,441.72231364250183,1011.1723213195801,25662,6705,18957,18957,0,12,6823000.0
6823,6823999,20.222877121694587,37.06222105453935,0.08729541244194339,1098.812936782837,441.78295636177063,1011.2744293212891,25664,6706,18958,18958,0,12,6824000.0
6824,6824999,20.222630663497117,37.06143763472719,0.08729509218439657,1099.123731136322,441.84442019462585,1011.3006134033203,25670,6709,18961,18961,0,12,6825000.0
6825,6825999,20.222349262781684,37.060430390591094,0.0872919657316249,1099.2522959709167,441.905326128006,1011.4831886291504,25670,6709,18961,18961,0,12,6826000.0
6826,6826999,20.222029200197614,37.05928350933684,0.08729004082589831,1099.3860447406769,441.96563267707825,1011.6181983947754,25670,6709,18961,18961,0,12,6827000.0
6827,6827999,20.22166679574143,37.05820705074473,0.08729114271827343,1099.5408790111542,442.0337028503418,1011.7094802856445,25670,6709,18961,18961,0,12,6828000.0
6828,6828999,20.221472408515396,37.057435695215645,0.08728862061372267,1099.7158162593842,442.093873500824,1011.7473754882812,25672,6710,18962,18962,0,12,6829000.0
6829,6829999,20.221571131922612,37.05706256318937,0.0872820523807486,1099.9240453243256,442.15666341781616,1011.7640190124512,25674,6711,18963,18963,0,12,6830000.0
6830,6830999,20.221930358108587,37.05910506306055,0.0872765980363307,1100.107786655426,442.216712474823,1011.8050346374512,25681,6712,18969,18969,0,12,6831000.0
6831,6831999,20.22233386888844,37.06047857626184,0.08726859797333497,1100.3070769309998,442.2767632007599,1011.834156036377,25683,6713,18970,18970,0,12,6832000.0
6832,6832999,20.222677333236177,37.060829486688206,0.0872641935298124,1100.4335942268372,442.3371880054474,1011.9247207641602,25683,6713,18970,18970,0,12,6833000.0
6833,6833999,20.22278886576723,37.060223172453824,0.08726639099514,1100.6180460453033,442.3983519077301,1011.9269104003906,25685,6714,18971,18971,0,12,6834000.0
6834,6834999,20.22290056122967,37.06052297391152,0.08726520693585837,1100.765277147293,442.4600954055786,1012.0221748352051,25685,6714,18971,18971,0,12,6835000.0
6835,6835999,20.223150918517035,37.06085776904014,0.08725375166774885,1100.9003810882568,442.5221974849701,1012.7957420349121,25696,6714,18982,18982,0,12,6836000.0
6836,6836999,20.22338181579299,37.06096181545943,0.08723898089288862,1101.0112838745117,442.5851969718933,1013.4229125976562,25696,6714,18982,18982,0,12,6837000.0
6837,6837999,20.224123094153853,37.067102300782864,0.0872095856121804,1101.207813501358,442.65263390541077,1013.7460861206055,25698,6715,18983,18983,0,12,6838000.0
6838,6838999,20.224421677914684,37.06669918018887,0.0872031069912359,1101.5639913082123,442.7141888141632,1013.7541198730469,25722,6719,19003,19003,0,12,6839000.0
6839,6839999,20.22501013677987,37.06834971914932,0.08719269879811886,1101.6809194087982,442.7767188549042,1014.0683708190918,25722,6719,19003,19003,0,12,6840000.0
6840,6840999,20.225345984076412,37.067868280948275,0.08719162385532564,1101.892802476883,442.842924118042,1014.2068901062012,25724,6720,19004,19004,0,12,6841000.0
6841,6841999,20.22568300554322,37.06749704124824,0.08718610602266763,1102.0077195167542,442.90330839157104,1014.4126091003418,25724,6720,19004,19004,0,12,6842000.0
6842,6842999,20.22614316394865,37.06982692847019,0.08717681385097187,1102.203515291214,442.96577548980713,1014.474666595459,25726,6721,19005,19005,0,12,6843000.0
6843,6843999,20.2266097964671,37.0695331015467,0.087180716768544,1102.3862822055817,443.02659583091736,1014.5419235229492,25735,6722,19013,19013,0,12,6844000.0
6844,6844999,20.227132049963934,37.06966066591137,0.08718462723932818,1102.5955045223236,443.09143114089966,1014.5923080444336,25737,6723,19014,19014,0,12,6845000.0
6845,6845999,20.228125048628392,37.07253963400826,0.08717757472816923,1102.787091255188,443.15185284614563,1014.6110382080078,25739,6724,19015,19015,0,12,6846000.0
6846,6846999,20.228762789012123,37.073169142186465,0.08717917368436412,1102.911295890808,443.2129135131836,1014.7263221740723,25739,6724,19015,19015,0,12,6847000.0
6847,6847999,20.229870815748683,37.074336343147685,0.0871887103327943,1103.1069481372833,443.27339148521423,1014.7731132507324,25741,6725,19016,19016,0,12,6848000.0
6848,6848999,20.230915523292403,37.07554323480257,0.08719566022684277,1103.241641998291,443.33375787734985,1014.887882232666,25741,6725,19016,19016,0,12,6849000.0
6849,6849999,20.23211359702375,37.07720252032785,0.08720573476020343,1103.4853847026825,443.3940896987915,1014.8030052185059,25751,6727,19024,19024,0,12,6850000.0
6850,6850999,20.23310222151621,37.07778139889176,0.08721544286373062,1103.6328721046448,443.456289768219,1014.9321746826172,25751,6727,19024,19024,0,12,6851000.0
6851,6851999,20.234505045300036,37.08037046798738,0.08721873875058361,1103.7768054008484,443.517831325531,1015.0245704650879,25751,6727,19024,19024,0,12,6852000.0
6852,6852999,20.235591713960215,37.082028518145016,0.0872283669984667,1103.904842376709,443.5781018733978,1015.0979919433594,25751,6727,19024,19024,0,12,6853000.0
6853,6853999,20.236339292456616,37.082056152329116,0.08723737838741508,1104.0424830913544,443.6390731334686,1015.198127746582,25751,6727,19024,19024,0,12,6854000.0
6854,6854999,20.236595544535717,37.08244078305382,0.08722452580800488,1104.1545116901398,443.70128107070923,1015.990104675293,25762,6727,19035,19035,0,12,6855000.0
6855,6855999,20.236570153690696,37.08227220055573,0.08721764090770634,1104.2812814712524,443.7639684677124,1016.3826713562012,25763,6727,19036,19036,0,12,6856000.0
6856,6856999,20.236820530703085,37.08341028247485,0.08720192193304244,1104.46972823143,443.8253927230835,1016.5804405212402,25765,6728,19037,19037,0,12,6857000.0
6857,6857999,20.236966717276555,37.08405112493973,0.08718760267014203,1104.6666181087494,443.8871669769287,1016.7618026733398,25767,6729,19038,19038,0,12,6858000.0
6858,6858999,20.23714659475396,37.084068715556626,0.08718155862147181,1104.8490557670593,443.9486880302429,1016.9181823730469,25769,6730,19039,19039,0,12,6859000.0
6859,6859999,20.237457143338005,37.084761416610164,0.08717562442717564,1105.0386044979095,444.01001167297363,1016.9681205749512,25771,6731,19040,19040,0,12,6860000.0
6860,6860999,20.237525173004823,37.08429687638773,0.08717211946840353,1105.1709899902344,444.0703067779541,1017.1483497619629,25771,6731,19040,19040,0,12,6861000.0
6861,6861999,20.237838261936197,37.08449883477033,0.0871713305410271,1105.3656876087189,444.13278341293335,1017.2283210754395,25773,6732,19041,19041,0,12,6862000.0
6862,6862999,20.238307852324805,37.08478559485663,0.08717306536086988,1105.5800495147705,444.195396900177,1017.2294387817383,25775,6733,19042,19042,0,12,6863000.0
6863,6863999,20.2388300769796,37.08496961631759,0.08717713971637431,1105.7029016017914,444.2565121650696,1017.3480415344238,25775,6733,19042,19042,0,12,6864000.0
6864,6864999,20.239690110472672,37.085490219010126,0.08718648827225262,1105.8355150222778,444.31682205200195,1017.456470489502,25775,6733,19042,19042,0,12,6865000.0
6865,6865999,20.240500347423197,37.08625972174157,0.08719906447793024,1106.0261814594269,444.3772120475769,1017.469898223877,25777,6734,19043,19043,0,12,6866000.0
6866,6866999,20.24108571394236,37.08644442838311,0.08720991339969897,1106.1531434059143,444.4401490688324,1017.5620079040527,25777,6734,19043,19043,0,12,6867000.0
6867,6867999,20.242098051122518,37.08740457947326,0.0872248394576769,1106.3712458610535,444.500830411911,1017.5762748718262,25779,6735,19044,19044,0,12,6868000.0
6868,6868999,20.243180292462526,37.088328487555,0.08724408744836198,1106.6147737503052,444.56230330467224,1017.4957809448242,25792,6737,19055,19055,0,12,6869000.0
6869,6869999,20.244102403582684,37.08870594673841,0.08726118359421187,1106.8706414699554,444.62313508987427,1017.3948593139648,25796,6739,19057,19057,0,12,6870000.0
6870,6870999,20.24497848505696,37.089986293134785,0.08727830302112805,1106.9975736141205,444.6836316585541,1017.519889831543,25796,6739,19057,19057,0,12,6871000.0
6871,6871999,20.245855755289107,37.09032825167993,0.08729702052679689,1107.1220543384552,444.7450954914093,1017.6264533996582,25796,6739,19057,19057,0,12,6872000.0
6872,6872999,20.246738059474424,37.09067990524781,0.08731831502231413,1107.2707154750824,444.8056938648224,1017.6974449157715,25796,6739,19057,19057,0,12,6873000.0
6873,6873999,20.246807618744015,37.089620491032086,0.08731895766925035,1107.4093248844147,444.86599230766296,1017.7999076843262,25796,6739,19057,19057,0,12,6874000.0
6874,6874999,20.247279800357624,37.09167501564598,0.08729890237027005,1107.5285470485687,444.92714953422546,1018.7348937988281,25809,6739,19070,19070,0,12,6875000.0
6875,6875999,20.247072168091222,37.09279881142076,0.0872897374199415,1107.6444211006165,444.9902677536011,1019.1472587585449,25809,6739,19070,19070,0,12,6876000.0
6876,6876999,20.246681209957018,37.09190105466443,0.08728696396798385,1107.8301072120667,445.0506491661072,1019.3350715637207,25811,6740,19071,19071,0,12,6877000.0
6877,6877999,20.246454822460628,37.090801327365234,0.08728362873921269,1107.9511246681213,445.11068296432495,1019.5106773376465,25811,6740,19071,19071,0,12,6878000.0
6878,6878999,20.246173889088737,37.08983546466292,0.08728114131554277,1108.1862125396729,445.17153668403625,1019.6413421630859,25820,6742,19078,19078,0,12,6879000.0
6879,6879999,20.246021556006536,37.089257402739065,0.08727960314101801,1108.3784928321838,445.2323896884918,1019.7528381347656,25822,6743,19079,19079,0,12,6880000.0
6880,6880999,20.24579435639805,37.088246631111296,0.08727867281406965,1108.5649843215942,445.29349660873413,1019.8262367248535,25824,6744,19080,19080,0,12,6881000.0
6881,6881999,20.245666913145275,37.08784323817686,0.08727498212566775,1108.6843304634094,445.3540849685669,1020.0097465515137,25824,6744,19080,19080,0,12,6882000.0
6882,6882999,20.245629089677802,37.08742891713151,0.08727124539903441,1108.9360783100128,445.41473293304443,1019.9691543579102,25828,6746,19082,19082,0,12,6883000.0
6883,6883999,20.245702956026882,37.087257528083825,0.08726439322964097,1109.1344208717346,445.48249197006226,1020.0216751098633,25830,6747,19083,19083,0,12,6884000.0
6884,6884999,20.24635874823569,37.088458425006856,0.08725672890420533,1109.2768795490265,445.55275201797485,1020.1706008911133,25830,6747,19083,19083,0,12,6885000.0
6885,6885999,20.24750109317841,37.090814105670056,0.08724460605410089,1109.4773457050323,445.61409878730774,1020.2108573913574,25832,6748,19084,19084,0,12,6886000.0
6886,6886999,20.248478031730432,37.092125182144486,0.08724098608295205,1109.67453956604,445.67509484291077,1020.2913017272949,25834,6749,19085,19085,0,12,6887000.0
6887,6887999,20.249984280707505,37.09532857087042,0.0872432313877145,1109.8594126701355,445.7368514537811,1020.2981719970703,25836,6750,19086,19086,0,12,6888000.0
6888,6888999,20.25130040439797,37.09736700131337,0.08724799563300989,1109.9992504119873,445.79807019233704,1020.4090461730957,25836,6750,19086,19086,0,12,6889000.0
6889,6889999,20.25286818059897,37.09941082982489,0.0872475810159894,1110.2336554527283,445.86090421676636,1020.4284477233887,25840,6752,19088,19088,0,12,6890000.0
6890,6890999,20.254192123722667,37.100943242763904,0.0872599393794502,1110.3591277599335,445.92157435417175,1020.5152626037598,25840,6752,19088,19088,0,12,6891000.0
6891,6891999,20.254953444949578,37.101306398458185,0.08726765702626216,1110.5066087245941,445.9835979938507,1020.6355628967285,25840,6752,19088,19088,0,12,6892000.0
6892,6892999,20.255648391063637,37.10190633560836,0.0872385897682113,1110.6950280666351,446.04600739479065,1021.3087158203125,25852,6753,19099,19099,0,12,6893000.0
6893,6893999,20.255871091582186,37.10239835280528,0.08721207712941403,1110.8724699020386,446.1077301502228,1021.657958984375,25860,6754,19106,19106,0,12,6894000.0
6894,6894999,20.255774450666806,37.101582188366606,0.08718901681513525,1111.108366727829,446.17182421684265,1021.8203773498535,25864,6756,19108,19108,0,12,6895000.0
6895,6895999,20.25572534376159,37.10073555732736,0.0871719369233892,1111.2950220108032,446.23272681236267,1022.0515289306641,25867,6757,19110,19110,0,12,6896000.0
6896,6896999,20.255652530441754,37.09975842261227,0.08715793769287106,1111.4822232723236,446.29712867736816,1022.204402923584,25869,6758,19111,19111,0,12,6897000.0
6897,6897999,20.255727738507854,37.098748183149326,0.08713983049150675,1111.7134547233582,446.3586091995239,1022.2437438964844,25873,6760,19113,19113,0,12,6898000.0
6898,6898999,20.255599918942412,37.097959207204376,0.08712194714089383,1111.857840538025,446.41933393478394,1022.4211654663086,25873,6760,19113,19113,0,12,6899000.0
6899,6899999,20.25561545594759,37.09678225327578,0.08710258589221365,1112.0335521697998,446.4795594215393,1022.523120880127,25875,6761,19114,19114,0,12,6900000.0
6900,6900999,20.255478514609454,37.09559520973662,0.08708982440263102,1112.2947726249695,446.54204630851746,1022.4529724121094,25879,6763,19116,19116,0,12,6901000.0
6901,6901999,20.25526895370661,37.09420061889709,0.08708181211940291,1112.4906883239746,446.60309195518494,1022.5050926208496,25881,6764,19117,19117,0,12,6902000.0
6902,6902999,20.25504677581192,37.09324884607077,0.08707461921680126,1112.6672031879425,446.66392064094543,1022.5954246520996,25891,6765,19126,19126,0,12,6903000.0
6903,6903999,20.25495064823556,37.092240849638266,0.08706083411295806,1112.7843115329742,446.7251434326172,1022.6990127563477,25891,6765,19126,19126,0,12,6904000.0
6904,6904999,20.254827530702304,37.09125410097247,0.08705851961294431,1113.050624370575,446.7877902984619,1022.7246437072754,25905,6767,19138,19138,0,12,6905000.0
6905,6905999,20.25479198104339,37.090268451552824,0.08705541317930199,1113.2310540676117,446.84898567199707,1022.8039016723633,25907,6768,19139,19139,0,12,6906000.0
6906,6906999,20.254745161614675,37.08937979463094,0.08705308239028964,1113.4312183856964,446.9096710681915,1022.8457374572754,25909,6769,19140,19140,0,12,6907000.0
6907,6907999,20.254953194657563,37.08880060159419,0.08704844167028614,1113.5562298297882,446.9707260131836,1022.9599800109863,25909,6769,19140,19140,0,12,6908000.0
6908,6908999,20.25488443968423,37.08769892882708,0.08704634711294879,1113.8069112300873,447.0322802066803,1022.9421768188477,25923,6771,19152,19152,0,12,6909000.0
6909,6909999,20.254858170269642,37.086666771577654,0.08704477230756702,1114.0033104419708,447.0929477214813,1022.9065170288086,25925,6772,19153,19153,0,12,6910000.0
6910,6910999,20.25471893432918,37.08558080069783,0.0870427934764968,1114.379364490509,447.1575195789337,1022.8047866821289,25944,6776,19168,19168,0,12,6911000.0
6911,6911999,20.254205009904506,37.08394853606429,0.08704729938504996,1114.5063498020172,447.21924090385437,1022.9559478759766,25944,6776,19168,19168,0,12,6912000.0
6912,6912999,20.253748257381304,37.08268349141206,0.08704113316452233,1114.6605932712555,447.2842364311218,1023.6032676696777,25956,6776,19180,19180,0,12,6913000.0
6913,6913999,20.25304245671525,37.08132924288143,0.08703095249559178,1114.782318353653,447.34730195999146,1024.0761833190918,25959,6776,19183,19183,0,12,6914000.0
6914,6914999,20.252344849821252,37.080301710942734,0.08702456543612869,1114.95263338089,447.4079678058624,1024.3279190063477,25961,6777,19184,19184,0,12,6915000.0
6915,6915999,20.25174335895636,37.0790064330155,0.08701739853439094,1115.065016746521,447.4694149494171,1024.600658416748,25961,6777,19184,19184,0,12,6916000.0
6916,6916999,20.251096484365497,37.07741653219954,0.0870110111329303,1115.3186042308807,447.5304307937622,1024.6771278381348,25965,6779,19186,19186,0,12,6917000.0
6917,6917999,20.25062182431162,37.07668445437195,0.08700090019104145,1115.5738897323608,447.5923914909363,1024.6564826965332,25969,6781,19188,19188,0,12,6918000.0
6918,6918999,20.250229421997354,37.07596040946611,0.08699373016391654,1115.6982958316803,447.6562457084656,1024.867877960205,25969,6781,19188,19188,0,12,6919000.0
6919,6919999,20.24981348239806,37.07538232308572,0.08698325541260388,1115.8791751861572,447.7177348136902,1024.9650535583496,25971,6782,19189,19189,0,12,6920000.0
6920,6920999,20.2494459385594,37.07507477767133,0.08697169098944646,1116.069343805313,447.7791738510132,1025.0245971679688,25973,6783,19190,19190,0,12,6921000.0
6921,6921999,20.249751691936446,37.076530578612875,0.08695238377273473,1116.1955828666687,447.8432242870331,1025.1916999816895,25973,6783,19190,19190,0,12,6922000.0
6922,6922999,20.25019658239319,37.080182856146585,0.08692554048426504,1116.4405262470245,447.90303468704224,1025.1535911560059,25977,6785,19192,19192,0,12,6923000.0
6923,6923999,20.250782462496424,37.08184683591712,0.08690796291706204,1116.5813598632812,447.9640829563141,1025.2859992980957,25977,6785,19192,19192,0,12,6924000.0
6924,6924999,20.251573863223065,37.084765086910004,0.086887128196528,1116.8339402675629,448.0257933139801,1025.31831741333,25981,6787,19194,19194,0,12,6925000.0
6925,6925999,20.25204275528141,37.08532017394929,0.0868785804325296,1117.0270020961761,448.0880308151245,1025.3301582336426,25983,6788,19195,19195,0,12,6926000.0
6926,6926999,20.253015094013712,37.08756410121281,0.08687458879475451,1117.1396040916443,448.14825773239136,1025.4618034362793,25983,6788,19195,19195,0,12,6927000.0
6927,6927999,20.253994263576207,37.08972951518857,0.086867559704638,1117.2654285430908,448.20938062667847,1025.5583992004395,25983,6788,19195,19195,0,12,6928000.0
6928,6928999,20.254920415713574,37.09148557595475,0.0868628379788029,1117.397486448288,448.26936650276184,1025.660171508789,25983,6788,19195,19195,0,12,6929000.0
6929,6929999,20.255667951851162,37.09242735871268,0.0868598915022436,1117.659256219864,448.3330223560333,1025.6342163085938,25988,6790,19198,19198,0,12,6930000.0
6930,6930999,20.256285798194874,37.092837146067595,0.08685398135104039,1117.7936391830444,448.39416003227234,1025.7404670715332,25988,6790,19198,19198,0,12,6931000.0
6931,6931999,20.256756021066955,37.09296683274801,0.08684792152143428,1117.9091954231262,448.45506715774536,1025.879795074463,25988,6790,19198,19198,0,12,6932000.0
6932,6932999,20.25710932454923,37.093419697965714,0.0868348804597261,1118.036346912384,448.5156898498535,1026.7243576049805,26001,6790,19211,19211,0,12,6933000.0
6933,6933999,20.25695873490824,37.09257681512281,0.08682665653309696,1118.148349761963,448.5761580467224,1027.0353355407715,26001,6790,19211,19211,0,12,6934000.0
6934,6934999,20.256869798047436,37.09162039023772,0.08681585176729611,1118.4001171588898,448.63740706443787,1027.049331665039,26005,6792,19213,19213,0,12,6935000.0
6935,6935999,20.25689470136679,37.090881846815094,0.08680580689148198,1118.5817630290985,448.7002520561218,1027.2541389465332,26007,6793,19214,19214,0,12,6936000.0
6936,6936999,20.25683990292445,37.09013980813658,0.08680433449358926,1118.7695362567902,448.76066732406616,1027.3819389343262,26009,6794,19215,19215,0,12,6937000.0
6937,6937999,20.25655555597224,37.0888265205593,0.08679674807870008,1119.0651035308838,448.823326587677,1027.3316764831543,26027,6797,19230,19230,0,12,6938000.0
6938,6938999,20.256439565031894,37.08768558230288,0.08679265516517531,1119.182383298874,448.88449883461,1027.523281097412,26027,6797,19230,19230,0,12,6939000.0
6939,6939999,20.256447371055263,37.086885241409036,0.0867901967054987,1119.4361279010773,448.948753118515,1027.5693855285645,26045,6799,19246,19246,0,12,6940000.0
6940,6940999,20.25637804736153,37.0860812591177,0.08678274371056305,1119.635033607483,449.01002311706543,1027.6539840698242,26047,6800,19247,19247,0,12,6941000.0
6941,6941999,20.256450492313927,37.087665942450464,0.08677346818162979,1119.762044429779,449.07261991500854,1027.7672653198242,26048,6800,19248,19248,0,12,6942000.0
6942,6942999,20.256802024090817,37.08772643138801,0.08676736299741594,1119.8952777385712,449.13360500335693,1027.8638801574707,26048,6800,19248,19248,0,12,6943000.0
6943,6943999,20.257054055773256,37.08732494861375,0.08676250697986043,1120.1973195075989,449.1952815055847,1027.7142906188965,26054,6803,19251,19251,0,12,6944000.0
6944,6944999,20.257445335244984,37.087400428604504,0.0867602043258372,1120.3857107162476,449.2572934627533,1027.8067779541016,26056,6804,19252,19252,0,12,6945000.0
6945,6945999,20.2580298759363,37.08760390857392,0.08676244837530489,1120.6435716152191,449.31979274749756,1027.7877388000488,26060,6806,19254,19254,0,12,6946000.0
6946,6946999,20.258607666937888,37.08759389864971,0.08676970591908828,1120.766663312912,449.3812336921692,1027.9433937072754,26060,6806,19254,19254,0,12,6947000.0
6947,6947999,20.259273183563167,37.087989203548126,0.08677080399946102,1120.8910338878632,449.44227600097656,1028.0529098510742,26060,6806,19254,19254,0,12,6948000.0
6948,6948999,20.259866680274424,37.088028784160166,0.08677818313096752,1121.0389096736908,449.50370621681213,1028.146312713623,26060,6806,19254,19254,0,12,6949000.0
6949,6949999,20.260611689956228,37.08813453321441,0.08678025723100646,1121.227345943451,449.56427812576294,1028.1677513122559,26062,6807,19255,19255,0,12,6950000.0
6950,6950999,20.261231837738308,37.08804245153556,0.08679126008753923,1121.3634178638458,449.62521266937256,1028.2442474365234,26062,6807,19255,19255,0,12,6951000.0
6951,6951999,20.261609169516618,37.087464254788145,0.08679606008156815,1121.4832527637482,449.68528747558594,1028.3221244812012,26062,6807,19255,19255,0,12,6952000.0
6952,6952999,20.261832869321655,37.08777359930551,0.08678384593632704,1121.623687028885,449.7473247051239,1028.8159484863281,26073,6807,19266,19266,0,12,6953000.0
6953,6953999,20.262178564926447,37.088049979624685,0.08676507181736592,1121.8253831863403,449.8086597919464,1029.1211967468262,26079,6808,19271,19271,0,12,6954000.0
6954,6954999,20.262147536480033,37.087730313316676,0.08675789689532387,1121.9382498264313,449.86974596977234,1029.4186897277832,26080,6808,19272,19272,0,12,6955000.0
6955,6955999,20.26221682985533,37.08764181314933,0.08674963659119084,1122.1706409454346,449.9297528266907,1029.512866973877,26084,6810,19274,19274,0,12,6956000.0
6956,6956999,20.26243390297154,37.0875849337963,0.08674499265269353,1122.4185514450073,449.98997688293457,1029.596752166748,26088,6812,19276,19276,0,12,6957000.0
6957,6957999,20.262944236599512,37.08803352447094,0.08674943765442222,1122.5308651924133,450.05092215538025,1029.8026580810547,26088,6812,19276,19276,0,12,6958000.0
6958,6958999,20.263330829269773,37.08818101675966,0.08675031923941623,1122.7828485965729,450.1138336658478,1029.7842178344727,26092,6814,19278,19278,0,12,6959000.0
6959,6959999,20.26382544715942,37.08882179928286,0.08675321465450081,1123.2101964950562,450.17667508125305,1029.5582847595215,26102,6819,19283,19283,0,12,6960000.0
6960,6960999,20.264958736092847,37.09240955041459,0.08675676088908768,1123.3238549232483,450.23821783065796,1029.796859741211,26102,6819,19283,19283,0,12,6961000.0
6961,6961999,20.266079490683065,37.09371132501712,0.0867694225039165,1123.523772239685,450.30163836479187,1029.8734703063965,26104,6820,19284,19284,0,12,6962000.0
6962,6962999,20.26772693970886,37.09934663320325,0.08677745493665401,1123.7003846168518,450.3613860607147,1029.906349182129,26106,6821,19285,19285,0,12,6963000.0
6963,6963999,20.269016668635576,37.10081379361925,0.08680425697236849,1124.020501613617,450.42298340797424,1029.8621673583984,26112,6824,19288,19288,0,12,6964000.0
6964,6964999,20.27058196540411,37.10352238545211,0.08684069132676842,1124.1441543102264,450.4827582836151,1030.0287246704102,26112,6824,19288,19288,0,12,6965000.0
6965,6965999,20.27282214582282,37.1074886475929,0.08688276418046625,1124.430941104889,450.5448589324951,1029.9899597167969,26125,6827,19298,19298,0,12,6966000.0
6966,6966999,20.27448276160791,37.10939055791479,0.08692918557543272,1124.6843509674072,450.6064851284027,1030.036937713623,26129,6829,19300,19300,0,12,6967000.0
6967,6967999,20.276670133592336,37.11259652857472,0.08698063673332668,1124.8634712696075,450.6671302318573,1030.1763305664062,26131,6830,19301,19301,0,12,6968000.0
6968,6968999,20.278704733833827,37.117120823740485,0.08701792213293602,1125.11474442482,450.73006534576416,1030.1969108581543,26135,6832,19303,19303,0,12,6969000.0
6969,6969999,20.280210782034402,37.12109748172023,0.08699135340541975,1125.3035748004913,450.79223370552063,1030.8554496765137,26154,6833,19321,19321,0,12,6970000.0
6970,6970999,20.281371348480008,37.126585827772615,0.08696741241676087,1125.4370143413544,450.8555545806885,1031.2837829589844,26156,6833,19323,19323,0,12,6971000.0
6971,6971999,20.282624090251623,37.13115343065943,0.08694986678409333,1125.6457569599152,450.9192593097687,1031.5145072937012,26158,6834,19324,19324,0,12,6972000.0
6972,6972999,20.283426507274857,37.133428919218375,0.08693750373606746,1125.8768038749695,450.980272769928,1031.5282974243164,26162,6836,19326,19326,0,12,6973000.0
6973,6973999,20.284495776855618,37.136425249088916,0.0869231930784613,1125.987720489502,451.03962087631226,1031.699722290039,26162,6836,19326,19326,0,12,6974000.0
6974,6974999,20.2855278395919,37.139571436150895,0.08690357126033799,1126.3620669841766,451.1009798049927,1031.7336387634277,26185,6840,19345,19345,0,12,6975000.0
6975,6975999,20.286325080406712,37.14142416820361,0.08689013333974338,1126.483782529831,451.1611371040344,1031.93696975708,26185,6840,19345,19345,0,12,6976000.0
6976,6976999,20.288124743807852,37.14979094035308,0.08686479571066796,1126.720514535904,451.2223539352417,1031.926513671875,26198,6842,19356,19356,0,12,6977000.0
6977,6977999,20.28954366644378,37.15215656642766,0.08686685755756274,1126.8527178764343,451.2824230194092,1032.0812759399414,26198,6842,19356,19356,0,12,6978000.0
6978,6978999,20.290685069551547,37.15322219989118,0.08687765026757188,1126.9830174446106,451.34205651283264,1032.1658554077148,26198,6842,19356,19356,0,12,6979000.0
6979,6979999,20.29207671150592,37.15526296421572,0.08688313302485373,1127.1204710006714,451.40327882766724,1032.2857666015625,26198,6842,19356,19356,0,12,6980000.0
6980,6980999,20.293486731217577,37.1583853720948,0.08688170106943316,1127.3597011566162,451.46573090553284,1032.2216911315918,26202,6844,19358,19358,0,12,6981000.0
6981,6981999,20.2949197029294,37.160004768224056,0.08689985367771147,1127.6118032932281,451.5271031856537,1032.1537170410156,26206,6846,19360,19360,0,12,6982000.0
6982,6982999,20.297047809802965,37.16468125832008,0.08693170496899816,1127.8403105735779,451.58873295783997,1032.131462097168,26210,6848,19362,19362,0,12,6983000.0
6983,6983999,20.298709595695918,37.16777360438822,0.0869443066433988,1128.0302302837372,451.6494255065918,1032.2070121765137,26212,6849,19363,19363,0,12,6984000.0
6984,6984999,20.30036079679216,37.17068568228666,0.08697965996843415,1128.2891817092896,451.71047472953796,1032.1674537658691,26216,6851,19365,19365,0,12,6985000.0
6985,6985999,20.301979724827703,37.172273769445056,0.08699943174498681,1128.3968713283539,451.77147912979126,1032.3342399597168,26216,6851,19365,19365,0,12,6986000.0
6986,6986999,20.303257921592575,37.173114345734064,0.08701061995497628,1128.599901676178,451.83118438720703,1032.4264945983887,26231,6852,19379,19379,0,12,6987000.0
6987,6987999,20.303713925288957,37.173676001912625,0.08700388420933591,1128.727000951767,451.89375257492065,1033.0947074890137,26247,6852,19395,19395,0,12,6988000.0
6988,6988999,20.303155508646345,37.17295299631701,0.08700049041277558,1128.9049022197723,451.95531845092773,1033.3012619018555,26252,6853,19399,19399,0,12,6989000.0
6989,6989999,20.30284773750892,37.172421810539234,0.08699560171739651,1129.086831331253,452.0185344219208,1033.4804573059082,26254,6854,19400,19400,0,12,6990000.0
6990,6990999,20.302508804488685,37.17144078290815,0.08698988048876177,1129.3871693611145,452.0800588130951,1033.5419960021973,26270,6857,19413,19413,0,12,6991000.0
6991,6991999,20.302313927524747,37.170605937215456,0.08698573060891912,1129.5716910362244,452.1427409648895,1033.73193359375,26272,6858,19414,19414,0,12,6992000.0
6992,6992999,20.30218962277046,37.1698334996635,0.08698200532606748,1129.7535264492035,452.20358872413635,1033.85355758667,26274,6859,19415,19415,0,12,6993000.0
6993,6993999,20.30189246079055,37.16863001954006,0.08697893992337447,1129.8861320018768,452.2653651237488,1034.0299186706543,26274,6859,19415,19415,0,12,6994000.0
6994,6994999,20.30197846700755,37.168240184507745,0.08697199407451517,1130.0291101932526,452.3259046077728,1034.1728248596191,26274,6859,19415,19415,0,12,6995000.0
6995,6995999,20.30206981640604,37.16830643424172,0.08696757781958975,1130.1536040306091,452.38711404800415,1034.2757835388184,26274,6859,19415,19415,0,12,6996000.0
6996,6996999,20.302218150609125,37.167988671116106,0.08697099785884466,1130.3997123241425,452.448744058609,1034.244483947754,26278,6861,19417,19417,0,12,6997000.0
6997,6997999,20.302508346059167,37.16786654811303,0.08697175824268,1130.57235455513,452.51144552230835,1034.3182983398438,26289,6862,19427,19427,0,12,6998000.0
6998,6998999,20.30273267850751,37.16753478137052,0.08697221360333363,1130.7656030654907,452.5725965499878,1034.3543090820312,26291,6863,19428,19428,0,12,6999000.0
6999,6999999,20.303173782910132,37.16785919465581,0.08697746279301355,1131.13431930542,452.63391041755676,1034.197666168213,26299,6867,19432,19432,0,12,7000000.0
7000,7000999,20.30341698130798,37.1676678678855,0.08697791863576176,1131.2474868297577,452.69483518600464,1034.3613929748535,26299,6867,19432,19432,0,12,7001000.0
7001,7001999,20.303651129387287,37.16737613553295,0.08698373278128813,1131.4495973587036,452.75598978996277,1034.4589920043945,26301,6868,19433,19433,0,12,7002000.0
7002,7002999,20.304081617709585,37.16760754549109,0.0869891165327834,1131.70134973526,452.82062125205994,1034.4782257080078,26308,6870,19438,19438,0,12,7003000.0
7003,7003999,20.304177262607997,37.16719985918895,0.08698676388624305,1131.8358640670776,452.88267374038696,1034.6192245483398,26308,6870,19438,19438,0,12,7004000.0
7004,7004999,20.30467291057827,37.16705801014017,0.08698729727011645,1132.0429337024689,452.9451467990875,1034.6286582946777,26310,6871,19439,19439,0,12,7005000.0
7005,7005999,20.304816326136773,37.166255124787384,0.08698609713021133,1132.1729888916016,453.0072479248047,1034.695140838623,26310,6871,19439,19439,0,12,7006000.0
7006,7006999,20.30459473907645,37.165165477914194,0.08698406923658775,1132.3661103248596,453.0687208175659,1034.7011947631836,26312,6872,19440,19440,0,12,7007000.0
7007,7007999,20.30419200761383,37.163816226844645,0.0869794683844769,1132.490909576416,453.1306457519531,1035.3499298095703,26326,6872,19454,19454,0,12,7008000.0
7008,7008999,20.303496007833076,37.162425471309064,0.08697464346543993,1132.6068992614746,453.19329953193665,1035.773582458496,26330,6872,19458,19458,0,12,7009000.0
7009,7009999,20.302566493455853,37.16080930530796,0.08697126385682641,1132.747405052185,453.25306940078735,1035.9768600463867,26330,6872,19458,19458,0,12,7010000.0
7010,7010999,20.30195661831641,37.15978338297949,0.08696404891827925,1132.861486196518,453.31271386146545,1036.1666870117188,26330,6872,19458,19458,0,12,7011000.0
7011,7011999,20.301460536558707,37.15903255778594,0.0869554218192965,1133.0379238128662,453.37309169769287,1036.215476989746,26332,6873,19459,19459,0,12,7012000.0
7012,7012999,20.30108342773383,37.15820240896263,0.08695050898794277,1133.290046453476,453.4346318244934,1036.2638702392578,26337,6875,19462,19462,0,12,7013000.0
7013,7013999,20.300672555660125,37.15776678172886,0.08694363542159411,1133.4681341648102,453.49563932418823,1036.417121887207,26339,6876,19463,19463,0,12,7014000.0
7014,7014999,20.300339124356906,37.15676967066278,0.08694045788542626,1133.7233743667603,453.55726623535156,1036.479404449463,26352,6878,19474,19474,0,12,7015000.0
7015,7015999,20.29988008313925,37.155646083334965,0.08694005682645634,1133.8627982139587,453.61770248413086,1036.6401252746582,26352,6878,19474,19474,0,12,7016000.0
7016,7016999,20.299658958327992,37.155091311712575,0.08693703428252186,1134.1602206230164,453.6799142360687,1036.5699729919434,26369,6881,19488,19488,0,12,7017000.0
7017,7017999,20.299480913902762,37.15434133077392,0.08693339936528255,1134.2852582931519,453.74102878570557,1036.69771194458,26369,6881,19488,19488,0,12,7018000.0
7018,7018999,20.299271156869466,37.15391667684727,0.08692658643598572,1134.5392966270447,453.8036575317383,1036.6128768920898,26373,6883,19490,19490,0,12,7019000.0
7019,7019999,20.29887332959877,37.1531523728216,0.08692287897345441,1134.7265067100525,453.8654911518097,1036.7130584716797,26375,6884,19491,19491,0,12,7020000.0
7020,7020999,20.298805611165125,37.152683599764686,0.08692120895937061,1134.9204552173615,453.9274220466614,1036.7922286987305,26377,6885,19492,19492,0,12,7021000.0
7021,7021999,20.298806709755464,37.153649896139875,0.0869095972212055,1135.157240152359,453.989022731781,1036.8041763305664,26387,6887,19500,19500,0,12,7022000.0
7022,7022999,20.298553146016225,37.15281730017013,0.08690541146826236,1135.29638504982,454.04926323890686,1036.9616584777832,26387,6887,19500,19500,0,12,7023000.0
7023,7023999,20.298398453546763,37.15183406960863,0.08689786425343349,1135.5521557331085,454.1103274822235,1036.8773765563965,26391,6889,19502,19502,0,12,7024000.0
7024,7024999,20.298395267448445,37.151253376549256,0.08689173512149018,1135.6803801059723,454.17076587677,1037.0056190490723,26391,6889,19502,19502,0,12,7025000.0
7025,7025999,20.29831192374601,37.150447556617166,0.08688405299168822,1135.7966301441193,454.23578548431396,1037.109920501709,26391,6889,19502,19502,0,12,7026000.0
7026,7026999,20.29816219498182,37.14966995714472,0.08687760949093215,1135.9334132671356,454.29940581321716,1037.2178268432617,26391,6889,19502,19502,0,12,7027000.0
7027,7027999,20.298134011382878,37.15034043891923,0.08686196092344978,1136.06183552742,454.3593044281006,1037.4303588867188,26395,6889,19506,19506,0,12,7028000.0
7028,7028999,20.297641442917794,37.14975533912099,0.08684543302667214,1136.170839548111,454.42084407806396,1038.2734260559082,26413,6889,19524,19524,0,12,7029000.0
7029,7029999,20.29687259863478,37.14856573170364,0.08683978516545965,1136.2806334495544,454.4834523200989,1038.5818939208984,26415,6889,19526,19526,0,12,7030000.0
7030,7030999,20.296357569204265,37.14930635970958,0.08682592785881527,1136.4827823638916,454.5458126068115,1038.78275680542,26418,6890,19528,19528,0,12,7031000.0
7031,7031999,20.295668168461926,37.14777540941503,0.08682090598953984,1136.6650133132935,454.6071677207947,1038.9543571472168,26420,6891,19529,19529,0,12,7032000.0
7032,7032999,20.295148783440094,37.146575427372184,0.08681411712008147,1136.7868905067444,454.6706807613373,1039.1328010559082,26420,6891,19529,19529,0,12,7033000.0
7033,7033999,20.294716533458708,37.14570163157091,0.08680691324562628,1137.1689462661743,454.7345507144928,1039.0568313598633,26429,6895,19534,19534,0,12,7034000.0
7034,7034999,20.294205189981813,37.14456513692293,0.086800952941399,1137.3603842258453,454.79657888412476,1039.153907775879,26432,6896,19536,19536,0,12,7035000.0
7035,7035999,20.293668525973068,37.14324544070322,0.08679375674987566,1137.607765197754,454.8592834472656,1039.249095916748,26445,6898,19547,19547,0,12,7036000.0
7036,7036999,20.29336028007847,37.142463068935854,0.08678630822105637,1137.7319741249084,454.9206190109253,1039.4281044006348,26445,6898,19547,19547,0,12,7037000.0
7037,7037999,20.292761734014334,37.14099006998335,0.08678064834023402,1137.858365058899,454.9816677570343,1039.5831756591797,26445,6898,19547,19547,0,12,7038000.0
7038,7038999,20.292361470702037,37.13996343361308,0.08677375716691371,1138.0434744358063,455.0421016216278,1039.6367454528809,26447,6899,19548,19548,0,12,7039000.0
7039,7039999,20.292074675546107,37.13910168259287,0.0867663818436396,1138.1594462394714,455.1040287017822,1039.7473907470703,26447,6899,19548,19548,0,12,7040000.0
7040,7040999,20.291725094612413,37.13801880208618,0.08676014587522951,1138.3013105392456,455.16490960121155,1039.8548011779785,26447,6899,19548,19548,0,12,7041000.0
7041,7041999,20.291616630741604,37.138681476282784,0.08674462384827764,1138.5014944076538,455.2264711856842,1039.9034271240234,26449,6900,19549,19549,0,12,7042000.0
7042,7042999,20.291554868106175,37.13813413051771,0.08673786372115433,1138.8088920116425,455.28879022598267,1039.8468704223633,26462,6903,19559,19559,0,12,7043000.0
7043,7043999,20.291648737148098,37.13783641147589,0.08672982117278472,1139.0088334083557,455.35170459747314,1039.9016075134277,26464,6904,19560,19560,0,12,7044000.0
7044,7044999,20.29152346402029,37.13682360086033,0.08672334021213401,1139.2074370384216,455.41239762306213,1040.0128555297852,26466,6905,19561,19561,0,12,7045000.0
7045,7045999,20.291836988036916,37.13638518548499,0.08671875754729219,1139.3794331550598,455.47403860092163,1040.0763854980469,26468,6906,19562,19562,0,12,7046000.0
7046,7046999,20.292014689896607,37.13575790652065,0.08671380362153791,1139.500714302063,455.53531646728516,1040.1860122680664,26468,6906,19562,19562,0,12,7047000.0
7047,7047999,20.29218000419456,37.13500792921801,0.08671082318893575,1139.6441395282745,455.5969626903534,1040.28959274292,26468,6906,19562,19562,0,12,7048000.0
7048,7048999,20.292176533434116,37.13430325902167,0.08669905208104578,1139.77374958992,455.65807271003723,1040.8786659240723,26483,6906,19577,19577,0,12,7049000.0
7049,7049999,20.29184684250608,37.13421456316957,0.08668300401814955,1139.9506933689117,455.71942687034607,1041.3374633789062,26490,6907,19583,19583,0,12,7050000.0
7050,7050999,20.29129300765629,37.133346809268374,0.08667742010748902,1140.1848690509796,455.78087067604065,1041.513771057129,26500,6909,19591,19591,0,12,7051000.0
7051,7051999,20.290833880277297,37.13270385908674,0.08666804801753758,1140.4278740882874,455.8428075313568,1041.7240142822266,26504,6911,19593,19593,0,12,7052000.0
7052,7052999,20.290403789578065,37.132396520949634,0.08665862348589382,1140.6151237487793,455.9051978588104,1041.9440536499023,26506,6912,19594,19594,0,12,7053000.0
7053,7053999,20.29030801615578,37.132903803674374,0.08664330267557607,1140.7454833984375,455.96715354919434,1042.1845359802246,26506,6912,19594,19594,0,12,7054000.0
7054,7054999,20.290083869099085,37.13205485133285,0.08663599670657174,1140.9819629192352,456.029100894928,1042.3073120117188,26510,6914,19596,19596,0,12,7055000.0
7055,7055999,20.290152216895944,37.13302367051125,0.08662459297770375,1141.1702568531036,456.09111428260803,1042.4288940429688,26512,6915,19597,19597,0,12,7056000.0
7056,7056999,20.29001109168612,37.132652976381905,0.08662012928437657,1141.2772979736328,456.15329456329346,1042.6127395629883,26512,6915,19597,19597,0,12,7057000.0
7057,7057999,20.290163467784193,37.13257504275083,0.08660960466806311,1141.4160478115082,456.21614170074463,1042.7490272521973,26512,6915,19597,19597,0,12,7058000.0
7058,7058999,20.290195919734032,37.13214310012339,0.08660138774947868,1141.6676278114319,456.2786567211151,1042.7231254577637,26517,6917,19600,19600,0,12,7059000.0
7059,7059999,20.2907287405512,37.13371286384431,0.08659116997655536,1141.9304413795471,456.340291261673,1042.7176246643066,26521,6919,19602,19602,0,12,7060000.0
7060,7060999,20.291065774780048,37.133898411001404,0.0865892163825035,1142.1122732162476,456.40298771858215,1042.7953834533691,26523,6920,19603,19603,0,12,7061000.0
7061,7061999,20.291680954076327,37.13534834839713,0.08658131240172173,1142.2470676898956,456.46477007865906,1042.9275665283203,26523,6920,19603,19603,0,12,7062000.0
7062,7062999,20.292388954730296,37.13644551138045,0.086576868587939,1142.4394509792328,456.52838373184204,1043.012825012207,26525,6921,19604,19604,0,12,7063000.0
7063,7063999,20.293717982012776,37.13917312568962,0.08657529098177585,1142.6188807487488,456.5895719528198,1043.073886871338,26527,6922,19605,19605,0,12,7064000.0
7064,7064999,20.29465388844287,37.14109535286989,0.08657362645763722,1142.75972366333,456.6538088321686,1043.1781463623047,26527,6922,19605,19605,0,12,7065000.0
7065,7065999,20.295897977728217,37.14360562395253,0.08658201435354929,1142.9495697021484,456.7159149646759,1043.2432403564453,26529,6923,19606,19606,0,12,7066000.0
7066,7066999,20.297193060285075,37.14596078662995,0.08659719973271018,1143.0958428382874,456.7787628173828,1043.3637771606445,26529,6923,19606,19606,0,12,7067000.0
7067,7067999,20.298748646542236,37.149645513352446,0.08662866119331736,1143.2848918437958,456.8435752391815,1043.4066276550293,26531,6924,19607,19607,0,12,7068000.0
7068,7068999,20.300283743809562,37.15175422688604,0.086644630730357,1143.4771502017975,456.9062900543213,1043.4467697143555,26533,6925,19608,19608,0,12,7069000.0
7069,7069999,20.30064740057268,37.15155980045078,0.0866376327769286,1143.7321832180023,456.9697217941284,1043.882667541504,26550,6927,19623,19623,0,12,7070000.0
7070,7070999,20.300518224830515,37.15163521228073,0.08662621413623472,1143.8470795154572,457.0310034751892,1044.227596282959,26553,6927,19626,19626,0,12,7071000.0
7071,7071999,20.300470645650208,37.15146004823057,0.08661142745690309,1143.9818131923676,457.09143471717834,1044.3964462280273,26553,6927,19626,19626,0,12,7072000.0
7072,7072999,20.300724779116514,37.152510736024375,0.08659929520789189,1144.2262308597565,457.15279960632324,1044.4206085205078,26557,6929,19628,19628,0,12,7073000.0
7073,7073999,20.301233781101608,37.15426066783923,0.08659124120835304,1144.473925113678,457.21478486061096,1044.484130859375,26562,6931,19631,19631,0,12,7074000.0
7074,7074999,20.301391615582887,37.154026725586384,0.08658627841688038,1144.7186396121979,457.27631163597107,1044.5152168273926,26567,6933,19634,19634,0,12,7075000.0
7075,7075999,20.302514201468053,37.156131760034846,0.08659126362361425,1144.9236936569214,457.3416931629181,1044.6201477050781,26569,6934,19635,19635,0,12,7076000.0
7076,7076999,20.303464882839794,37.157906581159686,0.08659635744045269,1145.1042778491974,457.40138816833496,1044.7187881469727,26572,6935,19637,19637,0,12,7077000.0
7077,7077999,20.304198372267862,37.15847769102021,0.08660454214774949,1145.284996509552,457.4629604816437,1044.7654342651367,26574,6936,19638,19638,0,12,7078000.0
7078,7078999,20.3052937568305,37.159673027322214,0.08661651477680132,1145.46999168396,457.5278842449188,1044.8362274169922,26576,6937,19639,19639,0,12,7079000.0
7079,7079999,20.307078891053333,37.16286034482696,0.08664101216677977,1145.6020920276642,457.59202885627747,1044.977481842041,26576,6937,19639,19639,0,12,7080000.0
7080,7080999,20.30883384151195,37.165482782178096,0.08666678536055272,1145.8671188354492,457.6544237136841,1044.9492454528809,26580,6939,19641,19641,0,12,7081000.0
7081,7081999,20.31063567687811,37.16852920062389,0.08669775094825094,1145.98886179924,457.71846055984497,1045.0778732299805,26580,6939,19641,19641,0,12,7082000.0
7082,7082999,20.3125421788613,37.17113457917304,0.08673563187386069,1146.193792104721,457.78083753585815,1045.1344528198242,26582,6940,19642,19642,0,12,7083000.0
7083,7083999,20.31474626675148,37.17485275998656,0.08678291737646071,1146.5131258964539,457.84337425231934,1045.0439758300781,26594,6943,19651,19651,0,12,7084000.0
7084,7084999,20.317191481466796,37.17838561374485,0.08686069724018675,1146.6895191669464,457.9047808647156,1045.1249237060547,26596,6944,19652,19652,0,12,7085000.0
7085,7085999,20.319241251913404,37.18075149120824,0.0869331685324175,1146.8717646598816,457.9670407772064,1045.1896018981934,26599,6945,19654,19654,0,12,7086000.0
7086,7086999,20.32184752129431,37.18515218315405,0.08699816249381243,1147.133098602295,458.03143882751465,1045.1541862487793,26603,6947,19656,19656,0,12,7087000.0
7087,7087999,20.324276774072832,37.18882506900833,0.08708457550174764,1147.2550501823425,458.09357166290283,1045.2876930236816,26603,6947,19656,19656,0,12,7088000.0
7088,7088999,20.326498471396903,37.192301284508034,0.0871564193903942,1147.383455991745,458.1552450656891,1045.3991813659668,26603,6947,19656,19656,0,12,7089000.0
7089,7089999,20.3284251536573,37.19667513550769,0.08719175476915009,1147.575752735138,458.2170350551605,1045.486240386963,26605,6948,19657,19657,0,12,7090000.0
7090,7090999,20.32823916838202,37.19684077262497,0.08717342154855112,1147.8262927532196,458.2796537876129,1046.1121940612793,26628,6950,19678,19678,0,12,7091000.0
7091,7091999,20.328406650663894,37.19801223900645,0.08716064885825514,1147.936367034912,458.3397681713104,1046.518955230713,26631,6950,19681,19681,0,12,7092000.0
7092,7092999,20.328682639244644,37.2008099910954,0.08713883557748536,1148.1198086738586,458.4011495113373,1046.6686630249023,26633,6951,19682,19682,0,12,7093000.0
7093,7093999,20.328989950513932,37.201016409884645,0.08712587584186304,1148.36328458786,458.46274423599243,1046.8433456420898,26646,6953,19693,19693,0,12,7094000.0
7094,7094999,20.329330154588625,37.20122957753089,0.08712080195326188,1148.6030950546265,458.52423787117004,1046.9184188842773,26650,6955,19695,19695,0,12,7095000.0
7095,7095999,20.329770650819928,37.20166514636473,0.0871181492199159,1149.0233540534973,458.5886731147766,1046.926197052002,26663,6960,19703,19703,0,12,7096000.0
7096,7096999,20.330600562396956,37.203014660896486,0.08711506793017876,1149.2141201496124,458.65154814720154,1047.2183532714844,26665,6961,19704,19704,0,12,7097000.0
7097,7097999,20.33155603560815,37.203828733405594,0.08712566866641813,1149.3843958377838,458.7136330604553,1047.4208145141602,26667,6962,19705,19705,0,12,7098000.0
7098,7098999,20.332920816559266,37.2060905121836,0.0871403660457607,1149.640418767929,458.7776894569397,1047.5151901245117,26671,6964,19707,19707,0,12,7099000.0
7099,7099999,20.33562643564158,37.21425582114633,0.0871601316566234,1149.7649428844452,458.8393964767456,1047.731819152832,26671,6964,19707,19707,0,12,7100000.0
7100,7100999,20.33799323737408,37.218279559704264,0.08721021790682482,1150.006268978119,458.9004588127136,1047.75004196167,26676,6966,19710,19710,0,12,7101000.0
7101,7101999,20.340032324963918,37.2219275216964,0.08725513532004792,1150.3046412467957,458.96311354637146,1047.7836456298828,26682,6969,19713,19713,0,12,7102000.0
7102,7102999,20.342926627473407,37.228279079788095,0.08731479427236855,1150.4909682273865,459.027592420578,1047.9295692443848,26684,6970,19714,19714,0,12,7103000.0
7103,7103999,20.345501442892406,37.23414626037565,0.08740116245754803,1150.6772689819336,459.0911433696747,1048.073429107666,26692,6971,19721,19721,0,12,7104000.0
7104,7104999,20.348148877730218,37.24077359580594,0.08748338197970251,1150.8680171966553,459.15320348739624,1048.1507034301758,26694,6972,19722,19722,0,12,7105000.0
7105,7105999,20.350769839897453,37.24463732028596,0.0875677338234423,1151.0670084953308,459.2151951789856,1048.253749847412,26706,6973,19733,19733,0,12,7106000.0
7106,7106999,20.353120944135963,37.248201137924866,0.0876363777756437,1151.3092391490936,459.2797739505768,1048.2899284362793,26710,6975,19735,19735,0,12,7107000.0
7107,7107999,20.354877009134302,37.250769332926346,0.08768376132273636,1151.6151320934296,459.34197998046875,1048.2770957946777,26717,6978,19739,19739,0,12,7108000.0
7108,7108999,20.35567135043721,37.25398221873978,0.08765960691852714,1151.7402367591858,459.4040107727051,1049.2251014709473,26738,6978,19760,19760,0,12,7109000.0
7109,7109999,20.356130641247255,37.259554311434286,0.08763156501593705,1151.9234914779663,459.46777987480164,1049.5499839782715,26750,6979,19771,19771,0,12,7110000.0
7110,7110999,20.356539072659153,37.26018138086144,0.08762970122152014,1152.1578419208527,459.5320975780487,1049.6786270141602,26754,6981,19773,19773,0,12,7111000.0
7111,7111999,20.35704133000874,37.26152634965598,0.08763331986509748,1152.4599387645721,459.595844745636,1049.8572082519531,26760,6984,19776,19776,0,12,7112000.0
7112,7112999,20.35780170293591,37.263009891630844,0.08764401408377664,1152.5662205219269,459.656720161438,1050.1204071044922,26760,6984,19776,19776,0,12,7113000.0
7113,7113999,20.358942827354866,37.26466330182442,0.08767733932685828,1152.9284796714783,459.72067523002625,1050.0982933044434,26769,6988,19781,19781,0,12,7114000.0
7114,7114999,20.36041076876155,37.26809158581435,0.08771896589611461,1153.235277891159,459.78203320503235,1050.1279106140137,26775,6991,19784,19784,0,12,7115000.0
7115,7115999,20.362226894682497,37.271900305542054,0.08774553112932004,1153.4872958660126,459.84593749046326,1050.253776550293,26788,6993,19795,19795,0,12,7116000.0
7116,7116999,20.36451446686221,37.28038507098579,0.08779248591349276,1153.6681520938873,459.9086048603058,1050.4319610595703,26790,6994,19796,19796,0,12,7117000.0
7117,7117999,20.367450412868035,37.28936579090424,0.08786075564994211,1153.8517005443573,459.9700689315796,1050.565586090088,26792,6995,19797,19797,0,12,7118000.0
7118,7118999,20.370518091461072,37.29688402369208,0.08799753503503271,1154.033777475357,460.0318946838379,1050.666217803955,26794,6996,19798,19798,0,12,7119000.0
7119,7119999,20.37345261609343,37.30365973375559,0.08810352150535783,1154.2668986320496,460.09454584121704,1050.7183799743652,26798,6998,19800,19800,0,12,7120000.0
7120,7120999,20.376281790305573,37.31259958677428,0.08817506574203504,1154.698889017105,460.1587989330292,1050.5543022155762,26816,7003,19813,19813,0,12,7121000.0
7121,7121999,20.379760755783465,37.3208024088275,0.0883750427190958,1154.8844437599182,460.221200466156,1050.8069763183594,26818,7004,19814,19814,0,12,7122000.0
7122,7122999,20.383958205763943,37.33269468375891,0.08857361375099526,1155.2213861942291,460.2835841178894,1050.7333335876465,26826,7007,19819,19819,0,12,7123000.0
7123,7123999,20.387507162625894,37.3417695946069,0.08872290820588735,1155.3966784477234,460.34544944763184,1050.8856201171875,26828,7008,19820,19820,0,12,7124000.0
7124,7124999,20.39171987772587,37.351228907238465,0.08886659985771861,1155.576978445053,460.40790343284607,1051.020450592041,26830,7009,19821,19821,0,12,7125000.0
7125,7125999,20.395341144454544,37.359882604140104,0.089008270871339,1155.8254511356354,460.4706621170044,1051.0133590698242,26834,7011,19823,19823,0,12,7126000.0
7126,7126999,20.39867463144011,37.366816418450135,0.08914858193487785,1156.0089526176453,460.53164744377136,1051.211597442627,26836,7012,19824,19824,0,12,7127000.0
7127,7127999,20.400644006994778,37.37008417989901,0.08914584405166492,1156.186142206192,460.5936551094055,1051.9103507995605,26854,7013,19841,19841,0,12,7128000.0
7128,7128999,20.401359018367156,37.371373615514145,0.08912984330506413,1156.2915530204773,460.6546232700348,1052.296646118164,26857,7013,19844,19844,0,12,7129000.0
7129,7129999,20.40198958464001,37.373682078112324,0.08912499953914121,1156.579216003418,460.7144503593445,1052.2728843688965,26863,7016,19847,19847,0,12,7130000.0
7130,7130999,20.4021849980292,37.37419316317548,0.08911972053353234,1156.83034491539,460.7746584415436,1052.4389457702637,26867,7018,19849,19849,0,12,7131000.0
7131,7131999,20.40250235641299,37.37465403412231,0.08911695294502997,1156.9529919624329,460.83492851257324,1052.6596565246582,26867,7018,19849,19849,0,12,7132000.0
7132,7132999,20.402767765416467,37.37507658521412,0.08911165837736268,1157.1431245803833,460.8955898284912,1052.767864227295,26869,7019,19850,19850,0,12,7133000.0
7133,7133999,20.402762150384127,37.37527756795051,0.08910915282516452,1157.3409674167633,460.957462310791,1052.8935737609863,26871,7020,19851,19851,0,12,7134000.0
7134,7134999,20.403031896646503,37.3760531159592,0.08910595050184977,1157.6042277812958,461.0204050540924,1052.9310417175293,26885,7022,19863,19863,0,12,7135000.0
7135,7135999,20.4032950397829,37.375981012741285,0.08910434121054867,1157.7138895988464,461.0804195404053,1053.0809440612793,26885,7022,19863,19863,0,12,7136000.0
7136,7136999,20.40364826746985,37.3762655405258,0.0890915626892701,1157.9064393043518,461.1401081085205,1053.1236457824707,26887,7023,19864,19864,0,12,7137000.0
7137,7137999,20.40378658434365,37.37603139915625,0.08909288169036078,1158.0311603546143,461.2019019126892,1053.232219696045,26887,7023,19864,19864,0,12,7138000.0
7138,7138999,20.403973869765892,37.37563642711365,0.08909180309376075,1158.2158405780792,461.263418674469,1053.2904891967773,26889,7024,19865,19865,0,12,7139000.0
7139,7139999,20.404206237908245,37.37512119352819,0.08908734943107521,1158.3477621078491,461.3232355117798,1053.4050559997559,26889,7024,19865,19865,0,12,7140000.0
7140,7140999,20.404815626683256,37.37517350014072,0.08908179473973321,1158.472023010254,461.38414788246155,1053.509048461914,26889,7024,19865,19865,0,12,7141000.0
7141,7141999,20.4050642715529,37.37564484766871,0.08907531283420766,1158.6843059062958,461.4449956417084,1053.541591644287,26892,7025,19867,19867,0,12,7142000.0
7142,7142999,20.40528944232004,37.37488472643578,0.08907019166427177,1158.819632768631,461.50832080841064,1053.6221466064453,26892,7025,19867,19867,0,12,7143000.0
7143,7143999,20.40523907591867,37.37364559572852,0.08906937280484606,1159.0082654953003,461.56870579719543,1053.6561546325684,26895,7026,19869,19869,0,12,7144000.0
7144,7144999,20.40491641006673,37.37244796974296,0.08906414119906492,1159.1301324367523,461.63088965415955,1054.490608215332,26914,7026,19888,19888,0,12,7145000.0
7145,7145999,20.404691876436807,37.37222002541145,0.08905684344643083,1159.2643175125122,461.6934292316437,1054.8008499145508,26915,7026,19889,19889,0,12,7146000.0
7146,7146999,20.40475421493521,37.37256080648113,0.08904575297145911,1159.3871381282806,461.75694155693054,1055.0164794921875,26915,7026,19889,19889,0,12,7147000.0
7147,7147999,20.404304677583053,37.37109403289057,0.08904745624484933,1159.640738248825,461.81859016418457,1055.0245475769043,26920,7028,19892,19892,0,12,7148000.0
7148,7148999,20.404311397267335,37.371722279032696,0.08904223384412158,1159.8213126659393,461.88301277160645,1055.1386528015137,26922,7029,19893,19893,0,12,7149000.0
7149,7149999,20.40449522412018,37.37209853115102,0.08904502274845782,1160.1210083961487,461.94448804855347,1055.1497039794922,26928,7032,19896,19896,0,12,7150000.0
7150,7150999,20.404416075123184,37.37187433347433,0.08904817960911637,1160.49880027771,462.0093421936035,1055.0979232788086,26936,7036,19900,19900,0,12,7151000.0
7151,7151999,20.404359217872354,37.37197636663703,0.08905925096177436,1160.7047531604767,462.074013710022,1055.2400169372559,26939,7037,19902,19902,0,12,7152000.0
7152,7152999,20.4045027615469,37.372088764549346,0.08906330772338222,1160.9586853981018,462.1365556716919,1055.28857421875,26943,7039,19904,19904,0,12,7153000.0
7153,7153999,20.40503942712453,37.37520611017401,0.08906186249650982,1161.077035665512,462.1979510784149,1055.4889297485352,26943,7039,19904,19904,0,12,7154000.0
7154,7154999,20.40548989069259,37.376140069184075,0.08907304700523122,1161.256337404251,462.2581117153168,1055.5600891113281,26945,7040,19905,19905,0,12,7155000.0
7155,7155999,20.405839176969554,37.37649336816987,0.08907889220852738,1161.3857452869415,462.31980419158936,1055.6832962036133,26945,7040,19905,19905,0,12,7156000.0
7156,7156999,20.406284370040456,37.37653832461313,0.08909093431114101,1161.5362224578857,462.3859488964081,1055.8135375976562,26945,7040,19905,19905,0,12,7157000.0
7157,7157999,20.406643956282895,37.376624918947776,0.08909551547255579,1161.7222533226013,462.4483103752136,1055.8638801574707,26947,7041,19906,19906,0,12,7158000.0
7158,7158999,20.407609274633344,37.37955719000794,0.08910221391322126,1161.9799933433533,462.5103528499603,1055.7907676696777,26952,7043,19909,19909,0,12,7159000.0
7159,7159999,20.407743864764786,37.37895510161704,0.08912357039211505,1162.1057331562042,462.57083320617676,1055.9024505615234,26952,7043,19909,19909,0,12,7160000.0
7160,7160999,20.407996247631907,37.37854345741394,0.08913452127399857,1162.4086182117462,462.6326551437378,1055.977928161621,26964,7046,19918,19918,0,12,7161000.0
7161,7161999,20.40899684050316,37.38874175070859,0.08907675041448215,1162.584305047989,462.69398069381714,1056.774658203125,26982,7047,19935,19935,0,12,7162000.0
7162,7162999,20.409034746231768,37.392906730716085,0.0890504571251407,1162.70103931427,462.75466442108154,1057.1145286560059,26983,7047,19936,19936,0,12,7163000.0
7163,7163999,20.4088355331507,37.39275849776461,0.08904178731541668,1162.8776218891144,462.8171899318695,1057.2736473083496,26986,7048,19938,19938,0,12,7164000.0
7164,7164999,20.409050801124682,37.394032903368206,0.08902591318801023,1163.1205987930298,462.8780951499939,1057.427375793457,26990,7050,19940,19940,0,12,7165000.0
7165,7165999,20.40951919035974,37.39490212154767,0.08901703874144395,1163.3028361797333,462.9413802623749,1057.6383476257324,26993,7051,19942,19942,0,12,7166000.0
7166,7166999,20.40996460591813,37.39553563734813,0.08899637535342864,1163.6230459213257,463.00329327583313,1057.6403770446777,27000,7054,19946,19946,0,12,7167000.0
7167,7167999,20.410363469311182,37.39601004432067,0.08899904612214438,1163.7544457912445,463.0652861595154,1057.8168716430664,27000,7054,19946,19946,0,12,7168000.0
7168,7168999,20.4111209295436,37.39676814573102,0.08897680597122848,1164.0181238651276,463.1304371356964,1057.7960815429688,27005,7056,19949,19949,0,12,7169000.0
7169,7169999,20.411802647911767,37.39717510131075,0.08897525926483885,1164.1423897743225,463.1908309459686,1057.9743576049805,27005,7056,19949,19949,0,12,7170000.0
7170,7170999,20.41287086536846,37.400602157065805,0.08897030310895537,1164.3126356601715,463.25145411491394,1058.0450630187988,27007,7057,19950,19950,0,12,7171000.0
7171,7171999,20.4137322522838,37.401825958133706,0.0889794927602865,1164.4463047981262,463.31408524513245,1058.184326171875,27007,7057,19950,19950,0,12,7172000.0
7172,7172999,20.414646381810115,37.402557068985345,0.08897586775718525,1164.5682909488678,463.37632608413696,1058.2980613708496,27007,7057,19950,19950,0,12,7173000.0
7173,7173999,20.415694543539427,37.40376733476614,0.08898506257840832,1164.8633275032043,463.4383714199066,1058.1477966308594,27023,7060,19963,19963,0,12,7174000.0
7174,7174999,20.41687726689304,37.406581682480635,0.08899172027393343,1165.1903471946716,463.5033450126648,1058.0664749145508,27031,7063,19968,19968,0,12,7175000.0
7175,7175999,20.41818793738529,37.40788723870618,0.0890090435955061,1165.3908908367157,463.56648421287537,1058.1935272216797,27033,7064,19969,19969,0,12,7176000.0
7176,7176999,20.419180027024037,37.408387257618,0.08901062647086544,1165.5802114009857,463.62830424308777,1058.272891998291,27035,7065,19970,19970,0,12,7177000.0
7177,7177999,20.420272442994516,37.40941792751118,0.08901643780428625,1165.8796288967133,463.69000220298767,1058.2462348937988,27041,7068,19973,19973,0,12,7178000.0
7178,7178999,20.421399576751096,37.410020279432544,0.08903202747298333,1166.066808462143,463.7517719268799,1058.2791786193848,27044,7069,19975,19975,0,12,7179000.0
7179,7179999,20.422234765275793,37.410076641792806,0.08903750946792222,1166.1888737678528,463.8142125606537,1058.462028503418,27044,7069,19975,19975,0,12,7180000.0
7180,7180999,20.42328731421792,37.411344820469196,0.08905587230617995,1166.3869533538818,463.87637186050415,1058.571117401123,27055,7070,19985,19985,0,12,7181000.0
7181,7181999,20.423526632898444,37.412053837658384,0.08904327074077512,1166.505865573883,463.94060468673706,1059.4323654174805,27074,7070,20004,20004,0,12,7182000.0
7182,7182999,20.42318579982403,37.4118880996534,0.08903051115357652,1166.685070991516,464.00131034851074,1059.7153968811035,27078,7071,20007,20007,0,12,7183000.0
7183,7183999,20.42300195730835,37.412064850387665,0.0890121196119188,1166.867038011551,464.0635242462158,1059.833885192871,27081,7072,20009,20009,0,12,7184000.0
7184,7184999,20.422967614545296,37.411770564286854,0.0889979140412479,1167.058242559433,464.12429332733154,1060.0808143615723,27083,7073,20010,20010,0,12,7185000.0
7185,7185999,20.422998808247936,37.41122490327122,0.08898944470690073,1167.298086643219,464.18532943725586,1060.1414947509766,27089,7075,20014,20014,0,12,7186000.0
7186,7186999,20.423015243919384,37.41156480182072,0.08897882632256549,1167.5399062633514,464.24991106987,1060.2162437438965,27093,7077,20016,20016,0,12,7187000.0
7187,7187999,20.42356260470736,37.41173149324519,0.08898451715710354,1167.7971410751343,464.31184244155884,1060.2678108215332,27099,7079,20020,20020,0,12,7188000.0
7188,7188999,20.424195686686396,37.41238181586729,0.08898380417974261,1167.9839725494385,464.3740932941437,1060.41508102417,27101,7080,20021,20021,0,12,7189000.0
7189,7189999,20.424811653074528,37.41294322785023,0.08898491815073983,1168.156533241272,464.4361526966095,1060.4982833862305,27103,7081,20022,20022,0,12,7190000.0
7190,7190999,20.425830432343652,37.41420546034436,0.08899029946114267,1168.4078035354614,464.4978139400482,1060.5158958435059,27107,7083,20024,20024,0,12,7191000.0
7191,7191999,20.4271407444598,37.41581748118122,0.08900363403400358,1168.601806640625,464.5620300769806,1060.6131439208984,27109,7084,20025,20025,0,12,7192000.0
7192,7192999,20.428649692884598,37.418278141852234,0.08901882129128336,1168.8687953948975,464.6239619255066,1060.585765838623,27114,7086,20028,20028,0,12,7193000.0
7193,7193999,20.430306172057666,37.421914180388235,0.08904393785204767,1169.052931547165,464.68529868125916,1060.6809921264648,27116,7087,20029,20029,0,12,7194000.0
7194,7194999,20.431803567571713,37.423607516033435,0.08907462731859606,1169.369951248169,464.7487242221832,1060.6518020629883,27137,7090,20047,20047,0,12,7195000.0
7195,7195999,20.433635217998688,37.426313976256,0.08911077162939818,1169.511677980423,464.823783159256,1060.8233489990234,27137,7090,20047,20047,0,12,7196000.0
7196,7196999,20.435477951229082,37.42881509351665,0.08915139605405198,1169.6902582645416,464.8856053352356,1060.9047355651855,27139,7091,20048,20048,0,12,7197000.0
7197,7197999,20.43718933337199,37.43107326350127,0.08919787443465332,1169.8226046562195,464.9465811252594,1061.054401397705,27140,7091,20049,20049,0,12,7198000.0
7198,7198999,20.438963697346352,37.433184340139235,0.08925493924488748,1170.033237695694,465.0152714252472,1061.0579414367676,27143,7092,20051,20051,0,12,7199000.0
7199,7199999,20.44090517008595,37.43649135015751,0.08932324114029433,1170.157668352127,465.0768723487854,1061.170124053955,27143,7092,20051,20051,0,12,7200000.0
7200,7200999,20.442784581110637,37.438801448804924,0.08940131089604497,1170.3042368888855,465.13857984542847,1061.2818984985352,27143,7092,20051,20051,0,12,7201000.0
7201,7201999,20.44407341782502,37.44113968249356,0.08943097420707902,1170.490957736969,465.20185947418213,1061.6989288330078,27157,7093,20064,20064,0,12,7202000.0
7202,7202999,20.444273597837448,37.441250795466665,0.0894207399819058,1170.6666052341461,465.26646089553833,1062.266700744629,27171,7094,20077,20077,0,12,7203000.0
7203,7203999,20.444111532355752,37.44034403494112,0.08941759992837506,1170.779522895813,465.32786989212036,1062.5738830566406,27171,7094,20077,20077,0,12,7204000.0
7204,7204999,20.444251981868945,37.44011380583655,0.08941579768461638,1171.0763120651245,465.38906264305115,1062.705825805664,27177,7097,20080,20080,0,12,7205000.0
7205,7205999,20.444870031137782,37.441109612833166,0.08941221774992325,1171.3210999965668,465.4507043361664,1062.8466453552246,27181,7099,20082,20082,0,12,7206000.0
7206,7206999,20.445936608723237,37.442801540448656,0.08941560795375358,1171.5043578147888,465.5114412307739,1063.0300827026367,27183,7100,20083,20083,0,12,7207000.0
7207,7207999,20.44754126636975,37.445325684765976,0.08942691246614631,1171.8025255203247,465.5736906528473,1063.121883392334,27190,7103,20087,20087,0,12,7208000.0
7208,7208999,20.44973053655719,37.44955386004361,0.08945189547645949,1172.1120853424072,465.63549065589905,1063.0732116699219,27196,7106,20090,20090,0,12,7209000.0
7209,7209999,20.451646735522356,37.45273086376693,0.08948920932172821,1172.2885496616364,465.6978073120117,1063.240135192871,27200,7107,20093,20093,0,12,7210000.0
7210,7210999,20.454032261040833,37.45686467999933,0.08954810044258987,1172.5422484874725,465.7684738636017,1063.3494033813477,27204,7109,20095,20095,0,12,7211000.0
7211,7211999,20.456370059071908,37.4604775702463,0.08962355392616828,1172.8561851978302,465.833411693573,1063.3607711791992,27211,7112,20099,20099,0,12,7212000.0
7212,7212999,20.45859059271313,37.46394339559403,0.08971332722568859,1173.105217218399,465.8992238044739,1063.393455505371,27215,7114,20101,20101,0,12,7213000.0
7213,7213999,20.460687790493072,37.466552698630686,0.08978815534159312,1173.3582475185394,465.9621443748474,1063.488998413086,27219,7116,20103,20103,0,12,7214000.0
7214,7214999,20.462911794691223,37.46964899442998,0.08989397365543483,1173.7905795574188,466.02572798728943,1063.4734001159668,27235,7121,20114,20114,0,12,7215000.0
7215,7215999,20.465449216004426,37.47753554306729,0.08996749457487896,1173.9770865440369,466.08888697624207,1063.6491928100586,27237,7122,20115,20115,0,12,7216000.0
7216,7216999,20.467460162137556,37.479903560717005,0.09006567010513189,1174.0948152542114,466.15098762512207,1063.8593940734863,27237,7122,20115,20115,0,12,7217000.0
7217,7217999,20.47003945013172,37.484499974466836,0.09015117205238277,1174.3400316238403,466.214346408844,1063.9101753234863,27241,7124,20117,20117,0,12,7218000.0
7218,7218999,20.472375776359815,37.48720114362398,0.09022692945395028,1174.5306289196014,466.27748823165894,1064.045021057129,27243,7125,20118,20118,0,12,7219000.0
7219,7219999,20.474905396553197,37.49058951913662,0.09031993879337197,1174.6582293510437,466.3406193256378,1064.2068672180176,27243,7125,20118,20118,0,12,7220000.0
7220,7220999,20.476858391066532,37.492273583363925,0.09039859102490155,1174.7923383712769,466.4026403427124,1064.367919921875,27243,7125,20118,20118,0,12,7221000.0
7221,7221999,20.47725606751769,37.492245756708684,0.09038744624846884,1174.982530593872,466.4660339355469,1065.397762298584,27294,7126,20168,20168,0,12,7222000.0
7222,7222999,20.476907219021598,37.49166090697053,0.09037546155703036,1175.0990555286407,466.53042793273926,1065.9955940246582,27299,7126,20173,20173,0,12,7223000.0
7223,7223999,20.47645443718012,37.49076939544295,0.09036879388787133,1175.3424017429352,466.5923206806183,1066.2102890014648,27303,7128,20175,20175,0,12,7224000.0
7224,7224999,20.476248782689908,37.49007038266344,0.09035990031417851,1175.5737054347992,466.65443205833435,1066.42387008667,27307,7130,20177,20177,0,12,7225000.0
7225,7225999,20.476004980487716,37.48927567371715,0.0903533764945792,1175.7659766674042,466.7207627296448,1066.671043395996,27309,7131,20178,20178,0,12,7226000.0
7226,7226999,20.47606295454116,37.489096071358446,0.09034154830224339,1176.0081470012665,466.7831652164459,1066.8191757202148,27313,7133,20180,20180,0,12,7227000.0
7227,7227999,20.475999375355343,37.48855840720615,0.09033489532187033,1176.1209557056427,466.84360098838806,1067.0720901489258,27313,7133,20180,20180,0,12,7228000.0
7228,7228999,20.476056410965192,37.48811598375335,0.09032977042829782,1176.3069350719452,466.90579319000244,1067.2287139892578,27315,7134,20181,20181,0,12,7229000.0
7229,7229999,20.47636186895225,37.488818572479246,0.09031643912041687,1176.5515825748444,466.9664418697357,1067.2235527038574,27319,7136,20183,20183,0,12,7230000.0
7230,7230999,20.476558608861115,37.488357884220584,0.09031103169140398,1176.86465382576,467.0291657447815,1067.2580947875977,27325,7139,20186,20186,0,12,7231000.0
7231,7231999,20.47692294674795,37.488277470867324,0.09030825955431421,1177.106913805008,467.0919291973114,1067.3479499816895,27329,7141,20188,20188,0,12,7232000.0
7232,7232999,20.47708028480482,37.48781478876056,0.09030918343802075,1177.283846616745,467.1542971134186,1067.5004539489746,27331,7142,20189,20189,0,12,7233000.0
7233,7233999,20.47728627017342,37.487378341731365,0.09030742590445051,1177.4783246517181,467.2179596424103,1067.641056060791,27333,7143,20190,20190,0,12,7234000.0
7234,7234999,20.47769212342588,37.487447227129316,0.09030413481663291,1177.6520245075226,467.27984595298767,1067.7669944763184,27341,7144,20197,20197,0,12,7235000.0
7235,7235999,20.477951908243238,37.48685424214562,0.09029565155158659,1177.845056772232,467.34270000457764,1067.8932838439941,27344,7145,20199,20199,0,12,7236000.0
7236,7236999,20.47860508673111,37.48700998968187,0.09028935821776962,1178.1659948825836,467.40487003326416,1067.8668403625488,27350,7148,20202,20202,0,12,7237000.0
7237,7237999,20.47895051503061,37.486477265611796,0.09028216410184364,1178.2979922294617,467.4672338962555,1068.0751609802246,27350,7148,20202,20202,0,12,7238000.0
7238,7238999,20.479163957884058,37.485679717085674,0.09028153273223771,1178.5988578796387,467.5296404361725,1068.1006202697754,27356,7151,20205,20205,0,12,7239000.0
7239,7239999,20.479115680848974,37.4851364590009,0.0902535018027818,1178.7149415016174,467.59255027770996,1069.191390991211,27380,7151,20229,20229,0,12,7240000.0
7240,7240999,20.478790060211026,37.48520318122839,0.09023951460869806,1178.946221113205,467.65473675727844,1069.631607055664,27391,7153,20238,20238,0,12,7241000.0
7241,7241999,20.478194149542777,37.4845147879326,0.09023419601786553,1179.1828842163086,467.7162444591522,1069.871841430664,27395,7155,20240,20240,0,12,7242000.0
7242,7242999,20.47786815429759,37.48422806980905,0.09022345646787844,1179.4771695137024,467.7774815559387,1070.1115837097168,27401,7158,20243,20243,0,12,7243000.0
7243,7243999,20.477567962706942,37.484030162278636,0.09021337366167315,1179.649158000946,467.83977365493774,1070.3250999450684,27403,7159,20244,20244,0,12,7244000.0
7244,7244999,20.477332530032662,37.48331912279952,0.0902115384374561,1180.0108001232147,467.9020607471466,1070.3403663635254,27411,7163,20248,20248,0,12,7245000.0
7245,7245999,20.477093764089897,37.48263498377814,0.0902066141728447,1180.2028908729553,467.96675753593445,1070.5614700317383,27413,7164,20249,20249,0,12,7246000.0
7246,7246999,20.477096835097115,37.48239361154246,0.09020030485535402,1180.4507908821106,468.0305988788605,1070.6478424072266,27425,7166,20259,20259,0,12,7247000.0
7247,7247999,20.476978677009683,37.48171597729122,0.09020006720964924,1180.5668530464172,468.092022895813,1070.8609352111816,27425,7166,20259,20259,0,12,7248000.0
7248,7248999,20.47731140771823,37.48201215700986,0.0901956168076703,1180.7039818763733,468.15376806259155,1071.0172958374023,27425,7166,20259,20259,0,12,7249000.0
7249,7249999,20.477583669930297,37.48226966812156,0.09019695512083592,1180.823776960373,468.21568775177,1071.1204223632812,27425,7166,20259,20259,0,12,7250000.0
7250,7250999,20.477936746962623,37.483832215926775,0.0901932406525866,1181.003657579422,468.2776200771332,1071.1663703918457,27427,7167,20260,20260,0,12,7251000.0
7251,7251999,20.478099262777924,37.48354787581929,0.09019757467247813,1181.1981995105743,468.33885312080383,1071.2249145507812,27429,7168,20261,20261,0,12,7252000.0
7252,7252999,20.478559135710267,37.48363234789544,0.09020014289733791,1181.4611160755157,468.4014756679535,1071.2194023132324,27433,7170,20263,20263,0,12,7253000.0
7253,7253999,20.47894757139541,37.483309334390626,0.09020531251431607,1181.5819084644318,468.4637498855591,1071.3891105651855,27433,7170,20263,20263,0,12,7254000.0
7254,7254999,20.479598363771846,37.48360823501293,0.09021327987333039,1181.701197385788,468.5265953540802,1071.5175857543945,27433,7170,20263,20263,0,12,7255000.0
7255,7255999,20.480173471617523,37.48357041079041,0.0902195692518275,1181.9745948314667,468.59083247184753,1071.5751914978027,27464,7172,20292,20292,0,12,7256000.0
7256,7256999,20.480933188556072,37.48432677832682,0.09021858333182786,1182.0951194763184,468.6524991989136,1071.7155303955078,27464,7172,20292,20292,0,12,7257000.0
7257,7257999,20.4817404476729,37.48524849622713,0.09021802215670582,1182.2080681324005,468.7144341468811,1071.8669700622559,27464,7172,20292,20292,0,12,7258000.0
7258,7258999,20.482274105679195,37.48624070126648,0.09020403948297961,1182.3230097293854,468.7807102203369,1072.874568939209,27487,7172,20315,20315,0,12,7259000.0
7259,7259999,20.482628269731983,37.48742380073753,0.09020615694488743,1182.4319260120392,468.8412263393402,1073.3200149536133,27490,7172,20318,20318,0,12,7260000.0
7260,7260999,20.48265666564266,37.488200299406266,0.09020110023710548,1182.622239112854,468.9036250114441,1073.5949745178223,27493,7173,20320,20320,0,12,7261000.0
7261,7261999,20.48256798403249,37.48742061893706,0.09019498411666982,1182.802327156067,468.9639506340027,1073.7929153442383,27495,7174,20321,20321,0,12,7262000.0
7262,7262999,20.482679566526937,37.487257692802864,0.09019036310214623,1183.049310684204,469.02288579940796,1073.8759536743164,27501,7176,20325,20325,0,12,7263000.0
7263,7263999,20.482756804890155,37.486684589677914,0.09018676439612261,1183.289731502533,469.0824933052063,1073.9384269714355,27505,7178,20327,20327,0,12,7264000.0
7264,7264999,20.48277208687103,37.48632609726788,0.09018849948948493,1183.6531767845154,469.1430027484894,1073.8620071411133,27518,7182,20336,20336,0,12,7265000.0
7265,7265999,20.482764671685462,37.48627212805151,0.09018161559412707,1183.774579524994,469.2067313194275,1074.1478462219238,27519,7182,20337,20337,0,12,7266000.0
7266,7266999,20.483172003630642,37.48844737366577,0.09017192029800192,1184.017409324646,469.2683963775635,1074.2407493591309,27523,7184,20339,20339,0,12,7267000.0
7267,7267999,20.48357704929976,37.48853787525117,0.09016533172764307,1184.2068617343903,469.3294267654419,1074.3384323120117,27525,7185,20340,20340,0,12,7268000.0
7268,7268999,20.484087984702487,37.48912378570229,0.09015799525652402,1184.3222250938416,469.3902819156647,1074.5138664245605,27525,7185,20340,20340,0,12,7269000.0
7269,7269999,20.48458083521471,37.489378404293994,0.0901563604210438,1184.4502696990967,469.4509081840515,1074.6281700134277,27525,7185,20340,20340,0,12,7270000.0
7270,7270999,20.485211143667723,37.489668882401226,0.09016202688900266,1184.704106092453,469.51192712783813,1074.6838912963867,27529,7187,20342,20342,0,12,7271000.0
7271,7271999,20.48582806043806,37.48985270701089,0.09016603683397173,1184.8863241672516,469.5731270313263,1074.8000144958496,27531,7188,20343,20343,0,12,7272000.0
7272,7272999,20.486718403311784,37.49114189430681,0.09016756784685753,1185.0820496082306,469.6330966949463,1074.910701751709,27533,7189,20344,20344,0,12,7273000.0
7273,7273999,20.488049872304323,37.49300038848262,0.09016482548309745,1185.2701103687286,469.6952373981476,1074.975902557373,27535,7190,20345,20345,0,12,7274000.0
7274,7274999,20.489110246518432,37.494271854508895,0.09015468497566914,1185.526866197586,469.75718092918396,1074.9390296936035,27541,7192,20349,20349,0,12,7275000.0
7275,7275999,20.489540933285117,37.4943362567713,0.09012523749147261,1185.6584787368774,469.82170724868774,1076.5558471679688,27559,7192,20367,20367,0,12,7276000.0
7276,7276999,20.490130103191717,37.49628006950618,0.09009229828680887,1185.7705733776093,469.8826940059662,1077.7874641418457,27563,7192,20371,20371,0,12,7277000.0
7277,7277999,20.49028527026252,37.49640970903634,0.09007445573853778,1186.010070323944,469.9430456161499,1078.2979583740234,27567,7194,20373,20373,0,12,7278000.0
7278,7278999,20.490552020509192,37.49646271347116,0.09005812007725378,1186.3280022144318,470.00493836402893,1078.734474182129,27581,7197,20384,20384,0,12,7279000.0
7279,7279999,20.490909583408158,37.49671069824176,0.09004502686462168,1186.5715103149414,470.06588411331177,1079.1345672607422,27586,7199,20387,20387,0,12,7280000.0
7280,7280999,20.491231556957786,37.49697863225764,0.0900339699166044,1186.8307120800018,470.127197265625,1079.3647117614746,27591,7201,20390,20390,0,12,7281000.0
7281,7281999,20.491475744559345,37.497051891655104,0.09002507973071339,1187.0868890285492,470.18904209136963,1079.6381912231445,27595,7203,20392,20392,0,12,7282000.0
7282,7282999,20.491873400869387,37.49727570434064,0.09001798502883773,1187.2866122722626,470.2504713535309,1080.0624961853027,27598,7204,20394,20394,0,12,7283000.0
7283,7283999,20.4927816534191,37.498681800578815,0.09000573972637149,1187.4959833621979,470.31199836730957,1080.3242149353027,27600,7205,20395,20395,0,12,7284000.0
7284,7284999,20.49370060141621,37.50004377111682,0.0899976823116092,1187.6238071918488,470.3745038509369,1080.7430305480957,27600,7205,20395,20395,0,12,7285000.0
7285,7285999,20.494407246632374,37.50086647829913,0.08999458516299885,1187.7612116336823,470.43608045578003,1081.1506805419922,27601,7205,20396,20396,0,12,7286000.0
7286,7286999,20.495492916764945,37.502408788904255,0.0899892576150817,1187.9774594306946,470.4975187778473,1081.3171348571777,27603,7206,20397,20397,0,12,7287000.0
7287,7287999,20.496670648676638,37.50379596593779,0.08999595569450847,1188.1671516895294,470.5612187385559,1081.5117835998535,27605,7207,20398,20398,0,12,7288000.0
7288,7288999,20.498221773892322,37.50609869475069,0.08999247526584353,1188.5512499809265,470.62290620803833,1081.08052444458,27613,7211,20402,20402,0,12,7289000.0
7289,7289999,20.49988343063428,37.509754790934245,0.08999654210481256,1188.6919391155243,470.6858525276184,1081.4921493530273,27613,7211,20402,20402,0,12,7290000.0
7290,7290999,20.50127786198631,37.51099457812786,0.08999475742018526,1188.9588708877563,470.74851059913635,1081.4418487548828,27617,7213,20404,20404,0,12,7291000.0
7291,7291999,20.50293530095467,37.51308330965759,0.09001125292066181,1189.110676765442,470.8106589317322,1081.7763404846191,27618,7213,20405,20405,0,12,7292000.0
7292,7292999,20.504493689103782,37.51469852694799,0.09001985456455874,1189.2308888435364,470.8711075782776,1082.0256538391113,27618,7213,20405,20405,0,12,7293000.0
7293,7293999,20.504980753608823,37.5144756980007,0.09002932672572261,1189.3825707435608,470.93382930755615,1082.691795349121,27632,7213,20419,20419,0,12,7294000.0
7294,7294999,20.504738162895332,37.51428231223007,0.0900156438633033,1189.4927270412445,470.9951124191284,1083.5106773376465,27638,7213,20425,20425,0,12,7295000.0
7295,7295999,20.504520751214557,37.51408304034439,0.09001242307221824,1189.600440979004,471.0550353527069,1083.954330444336,27639,7213,20426,20426,0,12,7296000.0
7296,7296999,20.50427425177034,37.513762889156325,0.09000614806985019,1189.8953893184662,471.1159505844116,1084.1704711914062,27646,7216,20430,20430,0,12,7297000.0
7297,7297999,20.504225071055423,37.51296989583346,0.08999783275492768,1190.2586653232574,471.1776864528656,1084.1813468933105,27657,7220,20437,20437,0,12,7298000.0
7298,7298999,20.504374447179416,37.513216081185696,0.08999775932852316,1190.3659207820892,471.23874592781067,1084.5408172607422,27657,7220,20437,20437,0,12,7299000.0
7299,7299999,20.504468936316286,37.51276106173905,0.08999119530849908,1190.6860709190369,471.3004972934723,1084.6243438720703,27663,7223,20440,20440,0,12,7300000.0
7300,7300999,20.50453479382009,37.51210715280508,0.0899917278947805,1190.8808913230896,471.3628454208374,1084.7858352661133,27665,7224,20441,20441,0,12,7301000.0
7301,7301999,20.504828948351243,37.511895360081944,0.08998997567883493,1191.1827113628387,471.42491579055786,1084.880241394043,27680,7227,20453,20453,0,12,7302000.0
7302,7302999,20.50542832802143,37.512511092763404,0.08998585156976058,1191.2995007038116,471.4865391254425,1085.1812934875488,27680,7227,20453,20453,0,12,7303000.0
7303,7303999,20.50606090497258,37.51305934162309,0.0899860245610562,1191.4846868515015,471.54809165000916,1085.2944030761719,27682,7228,20454,20454,0,12,7304000.0
7304,7304999,20.506735181583505,37.513092372858836,0.08998924966067523,1191.6699833869934,471.6103370189667,1085.395263671875,27688,7229,20459,20459,0,12,7305000.0
7305,7305999,20.50751621719695,37.51373919337839,0.08999114577952116,1192.0679392814636,471.67292976379395,1085.2486839294434,27696,7233,20463,20463,0,12,7306000.0
7306,7306999,20.508299033114366,37.514286463958186,0.0899897603219516,1192.197369813919,471.73470091819763,1085.4946670532227,27696,7233,20463,20463,0,12,7307000.0
7307,7307999,20.509211737976266,37.514930317521305,0.08999415275652956,1192.3190348148346,471.79641938209534,1085.7219886779785,27696,7233,20463,20463,0,12,7308000.0
7308,7308999,20.510539146735955,37.51603086812176,0.09000634216164494,1192.4996485710144,471.85696721076965,1085.8901901245117,27698,7234,20464,20464,0,12,7309000.0
7309,7309999,20.51156521798754,37.51652916449946,0.09001807650864213,1192.694458246231,471.91835045814514,1086.0153694152832,27700,7235,20465,20465,0,12,7310000.0
7310,7310999,20.512878504760568,37.51844210299128,0.0900310040608504,1192.886331319809,471.979101896286,1086.0779724121094,27702,7236,20466,20466,0,12,7311000.0
7311,7311999,20.514028504913888,37.51944038078561,0.09005417003597882,1193.05095911026,472.0413043498993,1086.3211135864258,27702,7236,20466,20466,0,12,7312000.0
7312,7312999,20.515523519019162,37.52177102412966,0.09008435308309737,1193.1750276088715,472.10244846343994,1086.5220069885254,27702,7236,20466,20466,0,12,7313000.0
7313,7313999,20.51655420024057,37.52251404588172,0.09010937195149638,1193.294106721878,472.1632032394409,1086.7117805480957,27702,7236,20466,20466,0,12,7314000.0
7314,7314999,20.516231141730074,37.522266232294086,0.09009623646662446,1193.417421579361,472.2269060611725,1087.6523361206055,27718,7236,20482,20482,0,12,7315000.0
7315,7315999,20.51572776681712,37.52147756263235,0.09008754728245016,1193.5365970134735,472.28784561157227,1088.0673942565918,27718,7236,20482,20482,0,12,7316000.0
7316,7316999,20.51523859571277,37.520869374876106,0.09007834982079632,1193.6446378231049,472.3479063510895,1088.3987503051758,27719,7236,20483,20483,0,12,7317000.0
7317,7317999,20.51463770736958,37.51950542072293,0.09007304897268609,1193.8805425167084,472.4086034297943,1088.6178970336914,27723,7238,20485,20485,0,12,7318000.0
7318,7318999,20.51431991313453,37.519547034657755,0.09006088843669835,1194.0664417743683,472.4690787792206,1088.856357574463,27725,7239,20486,20486,0,12,7319000.0
7319,7319999,20.514186340466175,37.51872562662703,0.09005325684957233,1194.3731803894043,472.53110218048096,1088.839469909668,27733,7242,20491,20491,0,12,7320000.0
7320,7320999,20.513757175270122,37.51768751042014,0.09004873946653402,1194.6852102279663,472.5948398113251,1088.8301086425781,27739,7245,20494,20494,0,12,7321000.0
7321,7321999,20.5135632684248,37.51693709493022,0.09004156863386237,1194.9384717941284,472.6586802005768,1089.0389518737793,27752,7247,20505,20505,0,12,7322000.0
7322,7322999,20.513698882185203,37.51681239118404,0.09003643997215605,1195.1838202476501,472.7198076248169,1089.1755638122559,27756,7249,20507,20507,0,12,7323000.0
7323,7323999,20.51385445061055,37.51652788601179,0.09003025450586177,1195.4437129497528,472.78187680244446,1089.2709770202637,27760,7251,20509,20509,0,12,7324000.0
7324,7324999,20.51422984241826,37.5175389247757,0.09003295828079827,1195.5618305206299,472.8436632156372,1089.5219650268555,27760,7251,20509,20509,0,12,7325000.0
7325,7325999,20.51429108809226,37.51870054090598,0.09002066140455645,1195.7605967521667,472.90542674064636,1089.639274597168,27762,7252,20510,20510,0,12,7326000.0
7326,7326999,20.514595980287044,37.518452387202636,0.09002173225869414,1195.948441028595,472.97039270401,1089.7880096435547,27764,7253,20511,20511,0,12,7327000.0
7327,7327999,20.515045379098495,37.52061740863194,0.09000947138097559,1196.0807611942291,473.0323529243469,1089.9892578125,27764,7253,20511,20511,0,12,7328000.0
7328,7328999,20.5154517018679,37.52059447022701,0.0900092856468433,1196.383160829544,473.09416818618774,1089.8956756591797,27770,7256,20514,20514,0,12,7329000.0
7329,7329999,20.515740908459946,37.52044501556991,0.09000711526929972,1196.6324653625488,473.1567163467407,1089.9585609436035,27774,7258,20516,20516,0,12,7330000.0
7330,7330999,20.51634253752046,37.52168817152944,0.09000202619205322,1196.7432737350464,473.2178726196289,1090.2197761535645,27774,7258,20516,20516,0,12,7331000.0
7331,7331999,20.517050909132454,37.52235435493716,0.09000033637247162,1197.0043365955353,473.28060364723206,1090.250644683838,27781,7260,20521,20521,0,12,7332000.0
7332,7332999,20.517583600867408,37.522468487622696,0.08999867070826462,1197.190307378769,473.34280586242676,1090.3488807678223,27783,7261,20522,20522,0,12,7333000.0
7333,7333999,20.51805086704285,37.52215636510279,0.09000462792414055,1197.4402213096619,473.4057123661041,1090.4190711975098,27787,7263,20524,20524,0,12,7334000.0
7334,7334999,20.518454995992414,37.52250813107167,0.0899976957357036,1197.6391205787659,473.467969417572,1091.077163696289,27815,7264,20551,20551,0,12,7335000.0
7335,7335999,20.51774566844844,37.52167338923768,0.08999127697790876,1197.7492775917053,473.5281894207001,1091.6039276123047,27816,7264,20552,20552,0,12,7336000.0
7336,7336999,20.517475063557324,37.52315617084561,0.08997385057443308,1197.8694405555725,473.5906836986542,1091.94771194458,27818,7264,20554,20554,0,12,7337000.0
7337,7337999,20.51741746879177,37.524544993579795,0.08995579143794241,1198.0433163642883,473.6527433395386,1092.1490440368652,27820,7265,20555,20555,0,12,7338000.0
7338,7338999,20.51737527868463,37.52560046227283,0.08994775790148457,1198.365868806839,473.7151622772217,1092.2541847229004,27827,7268,20559,20559,0,12,7339000.0
7339,7339999,20.51762347278668,37.527815802142314,0.08993006962981487,1198.5584971904755,473.7765381336212,1092.438144683838,27831,7269,20562,20562,0,12,7340000.0
7340,7340999,20.51786963612627,37.52865183901922,0.08990800303672908,1198.9307477474213,473.8391799926758,1092.4980926513672,27839,7273,20566,20566,0,12,7341000.0
7341,7341999,20.517911595869617,37.52873198818668,0.08990310864749562,1199.2901573181152,473.90192675590515,1092.5377235412598,27850,7277,20573,20573,0,12,7342000.0
7342,7342999,20.518247654258317,37.529410327009295,0.0898913094438275,1199.4756088256836,473.96483969688416,1092.753074645996,27852,7278,20574,20574,0,12,7343000.0
7343,7343999,20.518756346005652,37.53063117152367,0.0898862105223015,1199.7309272289276,474.03129982948303,1092.9557418823242,27856,7280,20576,20576,0,12,7344000.0
7344,7344999,20.519154514740215,37.53130971064386,0.08989911614130297,1199.99324965477,474.0979859828949,1093.1108283996582,27862,7282,20580,20580,0,12,7345000.0
7345,7345999,20.519632816481103,37.532114283751326,0.08991219305389253,1200.1185693740845,474.1598184108734,1093.3246612548828,27862,7282,20580,20580,0,12,7346000.0
7346,7346999,20.51977125517318,37.531818650064125,0.08991207762029985,1200.4160947799683,474.22365736961365,1093.3594055175781,27877,7285,20592,20592,0,12,7347000.0
7347,7347999,20.52031680427993,37.532736290579464,0.08992827092160993,1200.7423169612885,474.2856214046478,1093.2849044799805,27885,7288,20597,20597,0,12,7348000.0
7348,7348999,20.52099729389107,37.5338042731246,0.08991701506299998,1200.989162683487,474.3484480381012,1093.434970855713,27889,7290,20599,20599,0,12,7349000.0
7349,7349999,20.5213061961233,37.53384459442804,0.08992076683093764,1201.122804403305,474.4124376773834,1093.6385498046875,27889,7290,20599,20599,0,12,7350000.0
7350,7350999,20.52198498914023,37.534643245433394,0.08992122718200468,1201.316696882248,474.47578597068787,1093.678165435791,27893,7291,20602,20602,0,12,7351000.0
7351,7351999,20.52275859160515,37.53524989728601,0.08991089275321917,1201.4414093494415,474.53826379776,1093.8677406311035,27893,7291,20602,20602,0,12,7352000.0
7352,7352999,20.52346602888713,37.53590280736261,0.08991358349892509,1201.5781438350677,474.6017634868622,1094.0378913879395,27893,7291,20602,20602,0,12,7353000.0
7353,7353999,20.52420688616525,37.53637526577665,0.08991134905379727,1201.77858543396,474.6647787094116,1094.115867614746,27905,7292,20613,20613,0,12,7354000.0
7354,7354999,20.525184419064143,37.53753781579541,0.0898954089463212,1201.9041607379913,474.72834968566895,1094.7074089050293,27917,7292,20625,20625,0,12,7355000.0
7355,7355999,20.525134369144943,37.53761456988594,0.08986968774273407,1202.019728899002,474.78883051872253,1095.4142303466797,27920,7292,20628,20628,0,12,7356000.0
7356,7356999,20.525317276196986,37.53849095462488,0.08984738656323166,1202.1329038143158,474.8499004840851,1095.8170166015625,27922,7292,20630,20630,0,12,7357000.0
7357,7357999,20.52548945318837,37.53888368359877,0.089835651467841,1202.3189144134521,474.910441160202,1096.0507774353027,27925,7293,20632,20632,0,12,7358000.0
7358,7358999,20.525605833527738,37.539398869698026,0.0898216836487733,1202.503919839859,474.9710228443146,1096.280387878418,27927,7294,20633,20633,0,12,7359000.0
7359,7359999,20.52538395400171,37.538965639196185,0.08982356582563311,1202.8063292503357,475.03423404693604,1096.396484375,27933,7297,20636,20636,0,12,7360000.0
7360,7360999,20.52598416149963,37.543657589274844,0.0898114646980025,1203.0572011470795,475.09504222869873,1096.5277099609375,27937,7299,20638,20638,0,12,7361000.0
7361,7361999,20.52668112166388,37.54449349849232,0.08980758328313099,1203.249650478363,475.1627149581909,1096.7143859863281,27949,7300,20649,20649,0,12,7362000.0
7362,7362999,20.527299496088013,37.54561792415562,0.08979885957593836,1203.5025036334991,475.22517251968384,1096.8340606689453,27953,7302,20651,20651,0,12,7363000.0
7363,7363999,20.527920070477546,37.54612698585513,0.08979609034835112,1203.758606672287,475.28749918937683,1096.8104209899902,27959,7304,20655,20655,0,12,7364000.0
7364,7364999,20.528853761515204,37.54796896102025,0.08979954785283228,1203.8853595256805,475.3489713668823,1097.0225677490234,27959,7304,20655,20655,0,12,7365000.0
7365,7365999,20.529460163861327,37.54812700082004,0.0898023278644059,1204.2165279388428,475.4123148918152,1096.953987121582,27968,7307,20661,20661,0,12,7366000.0
7366,7366999,20.530376763413408,37.54964676626976,0.08980521761317717,1204.4040892124176,475.47459149360657,1097.1231956481934,27970,7308,20662,20662,0,12,7367000.0
7367,7367999,20.531448365181788,37.55081291274278,0.08981504322871892,1204.5277216434479,475.53576469421387,1097.305950164795,27970,7308,20662,20662,0,12,7368000.0
7368,7368999,20.53252796965497,37.55163927357034,0.08981748473816176,1204.7339344024658,475.6028079986572,1097.3172454833984,27975,7309,20666,20666,0,12,7369000.0
7369,7369999,20.53413631587713,37.554050270413036,0.08982957300461614,1204.8729946613312,475.6709327697754,1097.4937057495117,27975,7309,20666,20666,0,12,7370000.0
7370,7370999,20.535385117559656,37.55511316164793,0.08984646195993917,1205.0031995773315,475.7326714992523,1097.6845512390137,27975,7309,20666,20666,0,12,7371000.0
7371,7371999,20.53638362411356,37.55568559196666,0.08986053719221465,1205.2001893520355,475.79433727264404,1097.8078575134277,27983,7310,20673,20673,0,12,7372000.0
7372,7372999,20.536815628131386,37.556058182504096,0.08984881399089084,1205.3929903507233,475.85701394081116,1098.7188758850098,28007,7311,20696,20696,0,12,7373000.0
7373,7373999,20.53672680034452,37.55782326288175,0.08983154658991499,1205.503999710083,475.91913056373596,1099.2220268249512,28007,7311,20696,20696,0,12,7374000.0
7374,7374999,20.536577392119955,37.55709203431834,0.08982773355259466,1205.6194937229156,475.97977232933044,1099.5803718566895,28008,7311,20697,20697,0,12,7375000.0
7375,7375999,20.536566520788735,37.55691903610988,0.08981930816998096,1205.9309208393097,476.0424180030823,1099.729793548584,28016,7314,20702,20702,0,12,7376000.0
7376,7376999,20.536592636226093,37.557075992952456,0.08981291995080665,1206.2339460849762,476.10492491722107,1099.8809051513672,28022,7317,20705,20705,0,12,7377000.0
7377,7377999,20.537082448924167,37.55889130356408,0.08979579885224565,1206.3530161380768,476.16679310798645,1100.2018356323242,28022,7317,20705,20705,0,12,7378000.0
7378,7378999,20.537445097388176,37.55912490017777,0.08979139211341292,1206.5368030071259,476.22981238365173,1100.4025421142578,28024,7318,20706,20706,0,12,7379000.0
7379,7379999,20.5379490825297,37.559409391180104,0.08978943949428442,1206.716232061386,476.29076504707336,1100.597068786621,28026,7319,20707,20707,0,12,7380000.0
7380,7380999,20.53840522159901,37.55967509751314,0.08979535665113136,1206.9713008403778,476.3535497188568,1100.721523284912,28030,7321,20709,20709,0,12,7381000.0
7381,7381999,20.539154630063358,37.5617504010547,0.08979593534598285,1207.1625821590424,476.4158365726471,1100.8765335083008,28032,7322,20710,20710,0,12,7382000.0
7382,7382999,20.53972722788664,37.56204786085713,0.08979852096728125,1207.2828440666199,476.4769549369812,1101.1232795715332,28032,7322,20710,20710,0,12,7383000.0
7383,7383999,20.540216206994508,37.564056953774354,0.08979596748696406,1207.5843753814697,476.53979992866516,1101.1211204528809,28038,7325,20713,20713,0,12,7384000.0
7384,7384999,20.540877060465785,37.564298523007345,0.08979760898006306,1207.8307211399078,476.60162925720215,1101.148525238037,28042,7327,20715,20715,0,12,7385000.0
7385,7385999,20.541474025039637,37.564488305356996,0.08980267182313095,1208.029382944107,476.6651017665863,1101.2996444702148,28044,7328,20716,20716,0,12,7386000.0
7386,7386999,20.541961664551142,37.56436317387527,0.08980850830835774,1208.2122550010681,476.7274160385132,1101.39164352417,28046,7329,20717,20717,0,12,7387000.0
7387,7387999,20.5426741484223,37.5645838452149,0.08981150398072102,1208.4043056964874,476.78957629203796,1101.4960441589355,28048,7330,20718,20718,0,12,7388000.0
7388,7388999,20.54330429584554,37.56646950182484,0.08981047964488487,1208.5391623973846,476.851815700531,1101.689151763916,28048,7330,20718,20718,0,12,7389000.0
7389,7389999,20.544137043781312,37.5668222002127,0.08981780367527581,1208.662626028061,476.91419196128845,1101.8471794128418,28048,7330,20718,20718,0,12,7390000.0
7390,7390999,20.544862686757018,37.56684613281033,0.08982189178010158,1208.7858300209045,476.976181268692,1101.9995079040527,28048,7330,20718,20718,0,12,7391000.0
7391,7391999,20.54508565655189,37.56755549891806,0.08981771161851715,1208.9399235248566,477.05018520355225,1103.0291748046875,28069,7330,20739,20739,0,12,7392000.0
7392,7392999,20.544591096571533,37.56766562989229,0.08981089196616943,1209.0469686985016,477.1109721660614,1103.58549118042,28069,7330,20739,20739,0,12,7393000.0
7393,7393999,20.543908438005356,37.56653368726807,0.08980846476525017,1209.2195880413055,477.17202067375183,1103.8493118286133,28080,7331,20749,20749,0,12,7394000.0
7394,7394999,20.543366828113562,37.5664750487618,0.08980491848084826,1209.337490081787,477.2328884601593,1104.1133499145508,28080,7331,20749,20749,0,12,7395000.0
7395,7395999,20.543107966132858,37.56638354448304,0.08979897660764857,1209.5103781223297,477.29273200035095,1104.3129653930664,28082,7332,20750,20750,0,12,7396000.0
7396,7396999,20.542751953704588,37.56567175583641,0.08979405870834012,1209.6968131065369,477.3536162376404,1104.532470703125,28084,7333,20751,20751,0,12,7397000.0
7397,7397999,20.542443793971383,37.56463685301029,0.08979326915602082,1209.9508678913116,477.41594099998474,1104.624526977539,28088,7335,20753,20753,0,12,7398000.0
7398,7398999,20.542178344513342,37.56379930243453,0.08979103274498634,1210.3308625221252,477.4832639694214,1104.6260986328125,28096,7339,20757,20757,0,12,7399000.0
7399,7399999,20.54204194029215,37.56333383112253,0.08978647476571189,1210.587646484375,477.5462734699249,1104.6490440368652,28100,7341,20759,20759,0,12,7400000.0
7400,7400999,20.54220926584099,37.563449771420345,0.08978687457304557,1210.772006034851,477.6077392101288,1104.8692893981934,28102,7342,20760,20760,0,12,7401000.0
7401,7401999,20.542404705076752,37.563657117051555,0.08980115168413916,1210.89457821846,477.6692099571228,1105.1097602844238,28102,7342,20760,20760,0,12,7402000.0
7402,7402999,20.542645321547116,37.56404098058014,0.08981767209666436,1211.0303587913513,477.73078751564026,1105.2465476989746,28102,7342,20760,20760,0,12,7403000.0
7403,7403999,20.54270640799259,37.56400884764179,0.08981984127210474,1211.2321755886078,477.79391169548035,1105.3468284606934,28104,7343,20761,20761,0,12,7404000.0
7404,7404999,20.543284657426145,37.56583314851076,0.08982548817478109,1211.478509902954,477.85553216934204,1105.4641647338867,28108,7345,20763,20763,0,12,7405000.0
7405,7405999,20.544142546410175,37.56816298445115,0.08981194266900494,1211.672610282898,477.9170744419098,1105.58939743042,28112,7346,20766,20766,0,12,7406000.0
7406,7406999,20.545213841443825,37.571728089614666,0.08981097037498131,1211.8451545238495,477.9775490760803,1105.6279258728027,28114,7347,20767,20767,0,12,7407000.0
7407,7407999,20.546479433450575,37.57436384088114,0.08981834971645608,1212.10688829422,478.03875041007996,1105.5959014892578,28118,7349,20769,20769,0,12,7408000.0
7408,7408999,20.548239365690833,37.58106055461934,0.08979097190564478,1212.3011846542358,478.10142946243286,1105.703945159912,28120,7350,20770,20770,0,12,7409000.0
7409,7409999,20.54923507763644,37.583009664683665,0.0897942611057756,1212.4905569553375,478.1651451587677,1105.7187156677246,28122,7351,20771,20771,0,12,7410000.0
7410,7410999,20.549777535467754,37.583874996671106,0.08979044436039585,1212.7428169250488,478.22664880752563,1105.7195892333984,28126,7353,20773,20773,0,12,7411000.0
7411,7411999,20.549769656734306,37.58517199473385,0.08977033510238619,1212.8590757846832,478.2878670692444,1106.7836990356445,28142,7353,20789,20789,0,12,7412000.0
7412,7412999,20.54903179612588,37.5838676999729,0.08976915524375306,1213.0407750606537,478.351699590683,1107.1387939453125,28144,7354,20790,20790,0,12,7413000.0
7413,7413999,20.548443387533098,37.582885772181044,0.08976546634415594,1213.2802217006683,478.41325521469116,1107.3964767456055,28153,7356,20797,20797,0,12,7414000.0
7414,7414999,20.547925811583728,37.58193961636043,0.0897598047060364,1213.4658639431,478.47530484199524,1107.6394081115723,28155,7357,20798,20798,0,12,7415000.0
7415,7415999,20.54767410747745,37.582519891482335,0.08975004485373561,1213.6514008045197,478.5373115539551,1107.8191986083984,28157,7358,20799,20799,0,12,7416000.0
7416,7416999,20.54740638352385,37.58157976253497,0.08974574408069091,1213.9801559448242,478.5997323989868,1107.8221855163574,28163,7361,20802,20802,0,12,7417000.0
7417,7417999,20.54731553468116,37.58114427157755,0.08973658080204072,1214.3111851215363,478.664235830307,1107.8619499206543,28169,7364,20805,20805,0,12,7418000.0
7418,7418999,20.547123314068735,37.58040596524896,0.08973359848323426,1214.5276951789856,478.7292757034302,1108.134349822998,28171,7365,20806,20806,0,12,7419000.0
7419,7419999,20.54694607731641,37.57954172273358,0.08974179137517102,1214.712017774582,478.7915518283844,1108.2997283935547,28173,7366,20807,20807,0,12,7420000.0
7420,7420999,20.54708608292298,37.57945883396157,0.08974071018544538,1214.8936700820923,478.85400652885437,1108.4530639648438,28175,7367,20808,20808,0,12,7421000.0
7421,7421999,20.547037559272532,37.578790246020205,0.08974105951410793,1215.0886452198029,478.9168016910553,1108.512851715088,28177,7368,20809,20809,0,12,7422000.0
7422,7422999,20.547324835875,37.5789128579903,0.0897384573087655,1215.3411347866058,478.97798013687134,1108.5698280334473,28181,7370,20811,20811,0,12,7423000.0
7423,7423999,20.547781399597103,37.58095012274482,0.08973766935025806,1215.4682531356812,479.0402841567993,1108.7642211914062,28181,7370,20811,20811,0,12,7424000.0
7424,7424999,20.548321874762966,37.581281579640574,0.08974293853609194,1215.7329623699188,479.10333371162415,1108.7325172424316,28185,7372,20813,20813,0,12,7425000.0
7425,7425999,20.5486471035,37.58112992719201,0.08975501808689568,1215.8569102287292,479.1647787094116,1108.9244003295898,28185,7372,20813,20813,0,12,7426000.0
7426,7426999,20.549466555257414,37.58212512674436,0.08975686023764395,1215.9922788143158,479.22593092918396,1109.071620941162,28185,7372,20813,20813,0,12,7427000.0
7427,7427999,20.549829728955494,37.58210248380405,0.08976640882349485,1216.1183023452759,479.28825855255127,1109.209873199463,28185,7372,20813,20813,0,12,7428000.0
7428,7428999,20.550288774655538,37.5830422959719,0.08976649371490342,1216.3177666664124,479.3495421409607,1109.2169151306152,28187,7373,20814,20814,0,12,7429000.0
7429,7429999,20.55052026013183,37.58279987047983,0.08977060684758376,1216.441636800766,479.4110600948334,1109.3367347717285,28187,7373,20814,20814,0,12,7430000.0
7430,7430999,20.550304893899444,37.58260646009924,0.08975771028075319,1216.549873828888,479.4728264808655,1110.4053688049316,28207,7373,20834,20834,0,12,7431000.0
7431,7431999,20.549268678133497,37.58068068537363,0.08976356495249682,1216.659470319748,479.53422689437866,1110.8775825500488,28208,7373,20835,20835,0,12,7432000.0
7432,7432999,20.548507375257312,37.58119884553114,0.08975545714115463,1216.9526889324188,479.59507942199707,1111.0216445922852,28221,7376,20845,20845,0,12,7433000.0
7433,7433999,20.547707331150594,37.580158005489494,0.08975629826985321,1217.1928629875183,479.6561007499695,1111.258201599121,28225,7378,20847,20847,0,12,7434000.0
7434,7434999,20.547093964484922,37.57923293166994,0.08975381767029211,1217.3019587993622,479.71783089637756,1111.5935745239258,28225,7378,20847,20847,0,12,7435000.0
7435,7435999,20.546490917265274,37.577857014757846,0.08975340962579736,1217.6124937534332,479.77974128723145,1111.7135734558105,28231,7381,20850,20850,0,12,7436000.0
7436,7436999,20.545734179738265,37.57638197326809,0.08975407849115091,1217.9309899806976,479.84171056747437,1111.7632331848145,28237,7384,20853,20853,0,12,7437000.0
7437,7437999,20.545125704978883,37.57521344209866,0.08975472215694924,1218.178272485733,479.9030821323395,1111.9983940124512,28241,7386,20855,20855,0,12,7438000.0
7438,7438999,20.544600698663608,37.57414978783079,0.08975483891228431,1218.3603615760803,479.9650864601135,1112.181957244873,28243,7387,20856,20856,0,12,7439000.0
7439,7439999,20.544095406272053,37.57318973146952,0.08975715264971629,1218.4865186214447,480.02790665626526,1112.400188446045,28243,7387,20856,20856,0,12,7440000.0
7440,7440999,20.543343783671645,37.57156488530195,0.0897644038900487,1218.6005728244781,480.0919976234436,1112.59867477417,28243,7387,20856,20856,0,12,7441000.0
7441,7441999,20.54277830800404,37.5703575106721,0.0897648597393137,1218.7906897068024,480.15162563323975,1112.6764869689941,28245,7388,20857,20857,0,12,7442000.0
7442,7442999,20.542325615132437,37.56944190009348,0.08976311225248301,1218.910652399063,480.21149945259094,1112.8003463745117,28245,7388,20857,20857,0,12,7443000.0
7443,7443999,20.541651079779143,37.56791404291156,0.08976868440694541,1219.0964603424072,480.27221870422363,1112.8965873718262,28247,7389,20858,20858,0,12,7444000.0
7444,7444999,20.541092700322245,37.56653367122208,0.08976992919362037,1219.3603584766388,480.333518743515,1112.9203262329102,28251,7391,20860,20860,0,12,7445000.0
7445,7445999,20.540408802024405,37.564986228173154,0.0897715792347954,1219.4950060844421,480.3986232280731,1113.0876159667969,28251,7391,20860,20860,0,12,7446000.0
7446,7446999,20.53987015775004,37.56363983111766,0.08977493166917672,1219.624985218048,480.463214635849,1113.2151565551758,28251,7391,20860,20860,0,12,7447000.0
7447,7447999,20.539098884678584,37.56196918689147,0.08977971638575166,1219.8218824863434,480.5243501663208,1113.2824478149414,28253,7392,20861,20861,0,12,7448000.0
7448,7448999,20.538381649783066,37.56050016261123,0.08978454161089378,1219.9414801597595,480.5878937244415,1113.4251594543457,28253,7392,20861,20861,0,12,7449000.0
7449,7449999,20.53777813951017,37.5596552404492,0.0897764515392454,1220.081823348999,480.649977684021,1114.1709899902344,28270,7392,20878,20878,0,12,7450000.0
7450,7450999,20.537039468744826,37.558150258408695,0.0897763486473383,1220.198989391327,480.71363162994385,1114.6655006408691,28271,7392,20879,20879,0,12,7451000.0
7451,7451999,20.536366349422682,37.55684812727249,0.08977662817628373,1220.3758969306946,480.7742831707001,1114.8718490600586,28276,7393,20883,20883,0,12,7452000.0
7452,7452999,20.535677360535644,37.55571490943927,0.089776540723701,1220.755342245102,480.83698654174805,1114.9632759094238,28291,7397,20894,20894,0,12,7453000.0
7453,7453999,20.53499254446415,37.554347060485405,0.0897766197820975,1220.9949848651886,480.8976843357086,1115.127784729004,28295,7399,20896,20896,0,12,7454000.0
7454,7454999,20.53449321232138,37.55336305571875,0.08977800773951472,1221.1848936080933,480.95914602279663,1115.3031463623047,28297,7400,20897,20897,0,12,7455000.0
7455,7455999,20.534004229659306,37.552066279497346,0.08977792954028119,1221.4952263832092,481.0207118988037,1115.3128089904785,28303,7403,20900,20900,0,12,7456000.0
7456,7456999,20.533573267300632,37.551236387700285,0.08977760661216727,1221.7482075691223,481.08235120773315,1115.5211563110352,28307,7405,20902,20902,0,12,7457000.0
7457,7457999,20.53325713723726,37.55131031945019,0.08976728082222929,1221.9903373718262,481.1445472240448,1115.5814476013184,28311,7407,20904,20904,0,12,7458000.0
7458,7458999,20.533064341098715,37.5510880702491,0.08976833578389976,1222.1725857257843,481.2066547870636,1115.706714630127,28313,7408,20905,20905,0,12,7459000.0
7459,7459999,20.532582193772992,37.54994199756274,0.08977080620918854,1222.3728795051575,481.2694754600525,1115.83931350708,28315,7409,20906,20906,0,12,7460000.0
7460,7460999,20.532354383999603,37.54929272142315,0.08977107194139589,1222.6895735263824,481.3318700790405,1115.7523918151855,28324,7412,20912,20912,0,12,7461000.0
7461,7461999,20.531968001412785,37.54823886836988,0.08977445186503119,1222.9391984939575,481.39390540122986,1115.8768005371094,28328,7414,20914,20914,0,12,7462000.0
7462,7462999,20.531807589891763,37.54771022879781,0.08977740205175277,1223.0637774467468,481.4557056427002,1116.1038513183594,28328,7414,20914,20914,0,12,7463000.0
7463,7463999,20.53177713565935,37.54719793542124,0.08978119651024108,1223.2520141601562,481.51814126968384,1116.2167739868164,28330,7415,20915,20915,0,12,7464000.0
7464,7464999,20.53170849006318,37.54683096840342,0.08977484934066338,1223.374531030655,481.58264565467834,1116.384365081787,28330,7415,20915,20915,0,12,7465000.0
7465,7465999,20.532005265707195,37.54681549985203,0.08976872088413845,1223.6218099594116,481.64512610435486,1116.4241561889648,28334,7417,20917,20917,0,12,7466000.0
7466,7466999,20.532484248230453,37.54800575326132,0.08975969523495719,1223.749008178711,481.7073278427124,1116.5666122436523,28334,7417,20917,20917,0,12,7467000.0
7467,7467999,20.53271888948621,37.54788701104394,0.08975505367221925,1223.888031244278,481.7709393501282,1116.685806274414,28334,7417,20917,20917,0,12,7468000.0
7468,7468999,20.532620200948386,37.54713203820657,0.08975355130877183,1224.0743217468262,481.8335485458374,1116.7240753173828,28336,7418,20918,20918,0,12,7469000.0
7469,7469999,20.53235066814827,37.54611627354426,0.0897492611426065,1224.2550168037415,481.8965606689453,1117.4748420715332,28357,7419,20938,20938,0,12,7470000.0
7470,7470999,20.531814686879358,37.54714951378472,0.08974190358441836,1224.4351301193237,481.9612925052643,1117.9501342773438,28365,7420,20945,20945,0,12,7471000.0
7471,7471999,20.531057490023382,37.546042742906444,0.08973983519126538,1224.6048171520233,482.02373027801514,1118.2938194274902,28375,7421,20954,20954,0,12,7472000.0
7472,7472999,20.530547894872544,37.54495552791074,0.08973757917232039,1224.8393375873566,482.0860879421234,1118.478183746338,28379,7423,20956,20956,0,12,7473000.0
7473,7473999,20.530247494880403,37.545196406491534,0.08973049618980355,1225.1456611156464,482.14963245391846,1118.6123008728027,28386,7426,20960,20960,0,12,7474000.0
7474,7474999,20.529786425229794,37.5440818458244,0.08973192142102637,1225.5779943466187,482.211238861084,1118.6347122192383,28396,7431,20965,20965,0,12,7475000.0
7475,7475999,20.52946465778518,37.543538472009025,0.08973004372383875,1225.9566926956177,482.27492475509644,1118.7489585876465,28404,7435,20969,20969,0,12,7476000.0
7476,7476999,20.52925805729827,37.542917047971336,0.08972976528404852,1226.3543164730072,482.34211826324463,1118.9071350097656,28412,7439,20973,20973,0,12,7477000.0
7477,7477999,20.529417848686265,37.54335510051837,0.08973843293745432,1226.4704186916351,482.40423011779785,1119.2485961914062,28412,7439,20973,20973,0,12,7478000.0
7478,7478999,20.529479230985878,37.543279761667094,0.08973676107075623,1226.8469789028168,482.46793699264526,1119.312915802002,28420,7443,20977,20977,0,12,7479000.0
7479,7479999,20.529730348111638,37.54334525539374,0.08974604194664182,1227.0285875797272,482.530127286911,1119.5638236999512,28422,7444,20978,20978,0,12,7480000.0
7480,7480999,20.52993238737562,37.54349218401673,0.08975106822842782,1227.2116451263428,482.5921621322632,1119.700771331787,28424,7445,20979,20979,0,12,7481000.0
7481,7481999,20.530050301170057,37.54326717603082,0.08975609542083085,1227.4027390480042,482.65527391433716,1119.8063507080078,28426,7446,20980,20980,0,12,7482000.0
7482,7482999,20.530155424760917,37.543175705098164,0.0897603659555638,1227.5359301567078,482.7199718952179,1120.0343551635742,28426,7446,20980,20980,0,12,7483000.0
7483,7483999,20.53028507615162,37.54283135270895,0.08976563699742501,1227.802499294281,482.7839913368225,1120.0997161865234,28430,7448,20982,20982,0,12,7484000.0
7484,7484999,20.530560452197744,37.542815127889334,0.08976405687005129,1228.0640666484833,482.84740018844604,1120.2006301879883,28438,7450,20988,20988,0,12,7485000.0
7485,7485999,20.530564690662946,37.54218282787815,0.08976394660252929,1228.188110113144,482.9099078178406,1120.4122619628906,28438,7450,20988,20988,0,12,7486000.0
7486,7486999,20.53092431379331,37.54232010083912,0.08975582067011623,1228.31493806839,482.9729082584381,1120.5805778503418,28438,7450,20988,20988,0,12,7487000.0
7487,7487999,20.530881975010576,37.54147742251913,0.08975059290999965,1228.4463365077972,483.0360550880432,1120.7046394348145,28438,7450,20988,20988,0,12,7488000.0
7488,7488999,20.530638675966834,37.54053825035671,0.08974688129183894,1228.566906929016,483.0995020866394,1120.842300415039,28438,7450,20988,20988,0,12,7489000.0
7489,7489999,20.530385818839726,37.53950894000512,0.08974167291025004,1228.6922953128815,483.16128516197205,1121.6973114013672,28453,7450,21003,21003,0,12,7490000.0
7490,7490999,20.529660683693958,37.5379178804346,0.08974703452752031,1228.8057715892792,483.2225184440613,1122.2213096618652,28455,7450,21005,21005,0,12,7491000.0
7491,7491999,20.528767951284248,37.536141179161326,0.0897582223152219,1228.920482158661,483.2828543186188,1122.5529708862305,28455,7450,21005,21005,0,12,7492000.0
7492,7492999,20.5280272584603,37.53486158525926,0.08976937595964318,1229.159640789032,483.3438403606415,1122.7345428466797,28461,7452,21009,21009,0,12,7493000.0
7493,7493999,20.527137139230106,37.53324152425512,0.08977619276529625,1229.47216963768,483.40863370895386,1122.7809257507324,28470,7455,21015,21015,0,12,7494000.0
7494,7494999,20.5262779437536,37.53175835938064,0.08978098395450385,1229.5962872505188,483.46988582611084,1123.0948219299316,28470,7455,21015,21015,0,12,7495000.0
7495,7495999,20.525294757792054,37.529936025292976,0.08979118515392082,1229.8477895259857,483.53218269348145,1123.2226829528809,28474,7457,21017,21017,0,12,7496000.0
7496,7496999,20.524415737822423,37.528254929729854,0.089801207572893,1230.1686611175537,483.5940842628479,1123.292881011963,28480,7460,21020,21020,0,12,7497000.0
7497,7497999,20.523587423082375,37.526781804297904,0.08980998066768242,1230.4215033054352,483.65694546699524,1123.3932838439941,28488,7462,21026,21026,0,12,7498000.0
7498,7498999,20.522692344814143,37.52504484439398,0.08982015000684007,1230.6019728183746,483.71865487098694,1123.5444145202637,28490,7463,21027,21027,0,12,7499000.0
7499,7499999,20.521844757205145,37.52341933696199,0.0898321941519925,1230.921375989914,483.7833273410797,1123.5597457885742,28496,7466,21030,21030,0,12,7500000.0
7500,7500999,20.52087909548967,37.521806044215076,0.08984523274116996,1231.0437364578247,483.84547686576843,1123.7552642822266,28496,7466,21030,21030,0,12,7501000.0
7501,7501999,20.520173881677866,37.52047172003731,0.08985778891193985,1231.1720495224,483.9085166454315,1123.9114112854004,28496,7466,21030,21030,0,12,7502000.0
7502,7502999,20.519464047828798,37.519718636918014,0.08987063918750293,1231.3586881160736,483.97025179862976,1123.9671096801758,28498,7467,21031,21031,0,12,7503000.0
7503,7503999,20.518825961184742,37.519277884852464,0.08987890964440892,1231.5643384456635,484.0334572792053,1124.0560493469238,28500,7468,21032,21032,0,12,7504000.0
7504,7504999,20.517931462986027,37.517517061615386,0.08989422950138182,1231.6931128501892,484.09741377830505,1124.2247848510742,28500,7468,21032,21032,0,12,7505000.0
7505,7505999,20.517244934284655,37.51667398513913,0.08989928960718574,1231.884575843811,484.1591103076935,1124.9210243225098,28523,7469,21054,21054,0,12,7506000.0
7506,7506999,20.51671156710236,37.51660917642688,0.08989369622510579,1232.0618312358856,484.2201840877533,1125.5319938659668,28527,7470,21057,21057,0,12,7507000.0
7507,7507999,20.51586593877566,37.51500233666067,0.08990314221565665,1232.165551662445,484.28027987480164,1125.896743774414,28528,7470,21058,21058,0,12,7508000.0
7508,7508999,20.515055569621662,37.513696048853475,0.08991084110813341,1232.4731459617615,484.3429436683655,1126.0425758361816,28535,7473,21062,21062,0,12,7509000.0
7509,7509999,20.51423703062817,37.512453824454596,0.08991749066830268,1232.7192823886871,484.40451288223267,1126.247402191162,28542,7475,21067,21067,0,12,7510000.0
7510,7510999,20.513449674592806,37.51090136680014,0.0899190872125174,1232.9012224674225,484.4685552120209,1126.4416580200195,28544,7476,21068,21068,0,12,7511000.0
7511,7511999,20.51246595092708,37.509105544224994,0.08992480125679658,1233.1404392719269,484.5298671722412,1126.5190925598145,28548,7478,21070,21070,0,12,7512000.0
7512,7512999,20.511775236752612,37.50787492666649,0.08992454481667678,1233.5190205574036,484.5929174423218,1126.497299194336,28556,7482,21074,21074,0,12,7513000.0
7513,7513999,20.5112995881954,37.50716685622728,0.08991916596057326,1233.7699422836304,484.657187461853,1126.6085739135742,28560,7484,21076,21076,0,12,7514000.0
7514,7514999,20.510676320511262,37.50595685203486,0.08991415955282944,1234.0826494693756,484.7217266559601,1126.6503791809082,28566,7487,21079,21079,0,12,7515000.0
7515,7515999,20.510174054546717,37.504914873607305,0.08990913251800237,1234.2696301937103,484.7833375930786,1126.8624992370605,28571,7488,21083,21083,0,12,7516000.0
7516,7516999,20.5096146403645,37.50380476639434,0.08990372179879813,1234.4559397697449,484.8462016582489,1127.0186729431152,28573,7489,21084,21084,0,12,7517000.0
7517,7517999,20.50929768781557,37.50285738316434,0.0898974370757486,1234.5800333023071,484.90911388397217,1127.224033355713,28573,7489,21084,21084,0,12,7518000.0
7518,7518999,20.508890435424654,37.50177511636204,0.0898925480627758,1234.8533573150635,484.9725968837738,1127.278823852539,28577,7491,21086,21086,0,12,7519000.0
7519,7519999,20.50871902582558,37.50184769723317,0.08988254237212434,1235.0389647483826,485.03412675857544,1127.4203567504883,28589,7492,21097,21097,0,12,7520000.0
7520,7520999,20.5084497902812,37.501001957155566,0.08987534215820048,1235.2322075366974,485.0972650051117,1127.569248199463,28591,7493,21098,21098,0,12,7521000.0
7521,7521999,20.508039141755244,37.50004609243696,0.08986922399895803,1235.374213218689,485.1587555408478,1127.7231712341309,28591,7493,21098,21098,0,12,7522000.0
7522,7522999,20.50770848926139,37.498832143648166,0.08986295167159208,1235.4981625080109,485.2202641963959,1127.8297004699707,28591,7493,21098,21098,0,12,7523000.0
7523,7523999,20.50717260747794,37.497447060580285,0.08986188106646276,1235.6144678592682,485.28250646591187,1127.9548225402832,28591,7493,21098,21098,0,12,7524000.0
7524,7524999,20.506791388156504,37.497110752660966,0.08984340409345315,1235.797468662262,485.3435695171356,1128.8813705444336,28611,7494,21117,21117,0,12,7525000.0
7525,7525999,20.506227829969593,37.496353359720224,0.0898384572434725,1235.9092445373535,485.40428614616394,1129.3033752441406,28612,7494,21118,21118,0,12,7526000.0
7526,7526999,20.505635855116495,37.49547940693511,0.08983721166878456,1236.090610742569,485.46548795700073,1129.451747894287,28614,7495,21119,21119,0,12,7527000.0
7527,7527999,20.504918161709472,37.49396660311722,0.08983814515956257,1236.3273196220398,485.52558517456055,1129.6671333312988,28618,7497,21121,21121,0,12,7528000.0
7528,7528999,20.504445447341727,37.49294595204605,0.08983547958695659,1236.4445717334747,485.5857050418854,1129.9061088562012,28618,7497,21121,21121,0,12,7529000.0
7529,7529999,20.503938483667277,37.49174621619904,0.08983230904071149,1236.9039239883423,485.6474025249481,1129.8021240234375,28628,7502,21126,21126,0,12,7530000.0
7530,7530999,20.503195074671734,37.490123772862766,0.08983031358783289,1237.0227382183075,485.7085180282593,1130.0266914367676,28628,7502,21126,21126,0,12,7531000.0
7531,7531999,20.502551956335893,37.48872771104283,0.08983318160561926,1237.4079732894897,485.77246594429016,1129.9357299804688,28636,7506,21130,21130,0,12,7532000.0
7532,7532999,20.50185906703606,37.48726560536114,0.08983530819361718,1237.6647806167603,485.8352065086365,1130.0466842651367,28640,7508,21132,21132,0,12,7533000.0
7533,7533999,20.50134287151544,37.48602349722898,0.08983505557708948,1237.8662531375885,485.89774203300476,1130.2264671325684,28642,7509,21133,21133,0,12,7534000.0
7534,7534999,20.500822467968334,37.484857331368275,0.0898332647845912,1238.0347516536713,485.95706725120544,1130.368091583252,28654,7510,21144,21144,0,12,7535000.0
7535,7535999,20.50044670066744,37.48389829506688,0.08983309442091736,1238.3550896644592,486.0197730064392,1130.2414321899414,28660,7513,21147,21147,0,12,7536000.0
7536,7536999,20.50037402027093,37.484737746504116,0.08981945988613516,1238.5519714355469,486.0796926021576,1130.3451080322266,28662,7514,21148,21148,0,12,7537000.0
7537,7537999,20.50028630382021,37.484460967830834,0.08981099156975203,1238.6755557060242,486.14337730407715,1130.5166244506836,28662,7514,21148,21148,0,12,7538000.0
7538,7538999,20.50020791570755,37.48367451454338,0.08980541075824144,1238.8735835552216,486.20431566238403,1130.6092529296875,28664,7515,21149,21149,0,12,7539000.0
7539,7539999,20.500236684621967,37.48319068452902,0.08979835301664796,1239.0542249679565,486.26433849334717,1130.793529510498,28675,7516,21159,21159,0,12,7540000.0
7540,7540999,20.500492763299658,37.48308723073741,0.08979152829597825,1239.239243030548,486.3237679004669,1130.8245887756348,28677,7517,21160,21160,0,12,7541000.0
7541,7541999,20.50042701211586,37.48248830792746,0.08979027537716211,1239.5036823749542,486.3846502304077,1130.8091201782227,28681,7519,21162,21162,0,12,7542000.0
7542,7542999,20.500140834667196,37.48148374175373,0.08979149758182714,1239.61598610878,486.4442081451416,1130.9933280944824,28681,7519,21162,21162,0,12,7543000.0
7543,7543999,20.49977803599069,37.48040749686146,0.08978310976222204,1239.7351167201996,486.5036795139313,1131.9151229858398,28697,7519,21178,21178,0,12,7544000.0
7544,7544999,20.499834316370574,37.48193500908606,0.08975522215915444,1239.8384289741516,486.5625088214874,1132.4216842651367,28699,7519,21180,21180,0,12,7545000.0
7545,7545999,20.49960756933467,37.481242205869634,0.08974118088497463,1240.0038256645203,486.62251472473145,1132.7511024475098,28701,7520,21181,21181,0,12,7546000.0
7546,7546999,20.499535583925713,37.48147426669829,0.08972027771853075,1240.2469232082367,486.68321204185486,1132.946475982666,28705,7522,21183,21183,0,12,7547000.0
7547,7547999,20.499288018669294,37.48060647993832,0.08970667814276678,1240.4267523288727,486.7441318035126,1133.1958847045898,28707,7523,21184,21184,0,12,7548000.0
7548,7548999,20.499049125002866,37.48005610745531,0.08969481364136689,1240.734994649887,486.80498909950256,1133.183609008789,28713,7526,21187,21187,0,12,7549000.0
7549,7549999,20.498907278012332,37.47931575318827,0.08968494090196977,1241.1789708137512,486.8682351112366,1133.1047592163086,28723,7531,21192,21192,0,12,7550000.0
7550,7550999,20.4987100719714,37.47895034229873,0.0896802322275837,1241.368076324463,486.9332082271576,1133.3424644470215,28725,7532,21193,21193,0,12,7551000.0
7551,7551999,20.498501714051645,37.47800453004469,0.08967757657368858,1241.5694472789764,486.9952929019928,1133.526481628418,28727,7533,21194,21194,0,12,7552000.0
7552,7552999,20.498384773506242,37.47756242621808,0.08966908092876336,1241.8452937602997,487.0584671497345,1133.6025924682617,28731,7535,21196,21196,0,12,7553000.0
7553,7553999,20.49817613635833,37.47665308320279,0.08966126618706294,1241.9520099163055,487.12047243118286,1133.8237380981445,28731,7535,21196,21196,0,12,7554000.0
7554,7554999,20.49794364084202,37.47576862828263,0.08965718857381688,1242.082592010498,487.18263959884644,1133.974754333496,28731,7535,21196,21196,0,12,7555000.0
7555,7555999,20.497522641250246,37.47445103861274,0.08965408241988371,1242.2728083133698,487.2446320056915,1134.0464897155762,28733,7536,21197,21197,0,12,7556000.0
7556,7556999,20.497304399750657,37.47367126241777,0.08964417563011684,1242.4728405475616,487.3076391220093,1134.0938873291016,28735,7537,21198,21198,0,12,7557000.0
7557,7557999,20.496964325519208,37.47255412142722,0.08964025402004994,1242.5971059799194,487.3698003292084,1134.2518424987793,28735,7537,21198,21198,0,12,7558000.0
7558,7558999,20.496420686744074,37.471049054218064,0.0896384754807329,1242.7174425125122,487.4317207336426,1134.40140914917,28735,7537,21198,21198,0,12,7559000.0
7559,7559999,20.49613766387017,37.47009262599772,0.08963392655850533,1242.8581426143646,487.49351620674133,1134.4923248291016,28735,7537,21198,21198,0,12,7560000.0
7560,7560999,20.495564022956316,37.46859078842554,0.08963301145418412,1242.9779379367828,487.5554668903351,1134.5811958312988,28735,7537,21198,21198,0,12,7561000.0
7561,7561999,20.49491520380534,37.466980832303506,0.08963475473784588,1243.108493566513,487.61711597442627,1134.6735649108887,28735,7537,21198,21198,0,12,7562000.0
7562,7562999,20.494335607321517,37.46566622432053,0.08963049090909714,1243.3096203804016,487.6792402267456,1135.3736534118652,28754,7538,21216,21216,0,12,7563000.0
7563,7563999,20.4936827745574,37.46496094178879,0.08961576413909444,1243.4132120609283,487.74103903770447,1135.9457626342773,28756,7538,21218,21218,0,12,7564000.0
7564,7564999,20.492768804001166,37.46373991955807,0.0896143191396368,1243.5920913219452,487.8049433231354,1136.2475204467773,28758,7539,21219,21219,0,12,7565000.0
7565,7565999,20.492060941651232,37.46236212129189,0.0896111254688694,1243.8960845470428,487.8667821884155,1136.4612655639648,28765,7542,21223,21223,0,12,7566000.0
7566,7566999,20.49127767748375,37.46089945444868,0.08961096135045821,1244.0739614963531,487.9281690120697,1136.7739219665527,28767,7543,21224,21224,0,12,7567000.0
7567,7567999,20.49054431291315,37.45949279213625,0.08960987344134885,1244.256878376007,487.990505695343,1136.9343528747559,28769,7544,21225,21225,0,12,7568000.0
7568,7568999,20.489632494637444,37.457749379410245,0.08961381163806381,1244.462664604187,488.0518333911896,1137.1457214355469,28772,7545,21227,21227,0,12,7569000.0
7569,7569999,20.488842438084227,37.456392312326315,0.08961446729126465,1244.7223126888275,488.11424231529236,1137.1705131530762,28776,7547,21229,21229,0,12,7570000.0
7570,7570999,20.488040925166768,37.45520306095067,0.0896136049358125,1244.96835398674,488.1752369403839,1137.2168273925781,28780,7549,21231,21231,0,12,7571000.0
7571,7571999,20.487120087660184,37.453407891836505,0.08961863163911932,1245.0853147506714,488.23684787750244,1137.4274673461914,28780,7549,21231,21231,0,12,7572000.0
7572,7572999,20.48646271760398,37.45223226155651,0.08961626093243791,1245.2002737522125,488.3011040687561,1137.6060485839844,28780,7549,21231,21231,0,12,7573000.0
7573,7573999,20.485569668567184,37.450609255987665,0.08961787771102125,1245.4673690795898,488.3648798465729,1137.639331817627,28784,7551,21233,21233,0,12,7574000.0
7574,7574999,20.484745495976323,37.449390504689774,0.08961644922267509,1245.6550574302673,488.4265432357788,1137.7334632873535,28786,7552,21234,21234,0,12,7575000.0
7575,7575999,20.484147403217456,37.44818006499806,0.08961536094563471,1246.036316871643,488.4884970188141,1137.6313095092773,28794,7556,21238,21238,0,12,7576000.0
7576,7576999,20.484035025850357,37.4493536019194,0.08959982885828222,1246.2431223392487,488.55389499664307,1137.745288848877,28796,7557,21239,21239,0,12,7577000.0
7577,7577999,20.484595477219052,37.451452552668094,0.0895802391795445,1246.4336879253387,488.6173677444458,1137.8861122131348,28798,7558,21240,21240,0,12,7578000.0
7578,7578999,20.48501268242437,37.4543617524672,0.08956144820023915,1246.6964507102966,488.67933893203735,1137.9305038452148,28809,7560,21249,21249,0,12,7579000.0
7579,7579999,20.485762289994593,37.46074014361048,0.08953072644276383,1247.0098066329956,488.74357318878174,1137.8493003845215,28815,7563,21252,21252,0,12,7580000.0
7580,7580999,20.485726504130486,37.46214832796302,0.08952407821308284,1247.2585213184357,488.80635809898376,1137.9035301208496,28819,7565,21254,21254,0,12,7581000.0
7581,7581999,20.48600096382025,37.46359113913721,0.08952586902377857,1247.3918969631195,488.868145942688,1138.4751510620117,28830,7565,21265,21265,0,12,7582000.0
7582,7582999,20.48549875499706,37.46244364708719,0.08951982450027707,1247.6298065185547,488.93074202537537,1139.1337661743164,28846,7567,21279,21279,0,12,7583000.0
7583,7583999,20.485157672140087,37.46215027387931,0.08951545154958329,1247.8091747760773,488.99325704574585,1139.4177360534668,28848,7568,21280,21280,0,12,7584000.0
7584,7584999,20.484932164862165,37.46169812672884,0.08951452196598675,1248.0541489124298,489.0540871620178,1139.5893325805664,28852,7570,21282,21282,0,12,7585000.0
7585,7585999,20.48458436789749,37.46100543301184,0.08951364487307589,1248.2410218715668,489.1170425415039,1139.845802307129,28854,7571,21283,21283,0,12,7586000.0
7586,7586999,20.484296381618393,37.45999763099132,0.08950949116065621,1248.5639107227325,489.17911100387573,1139.9301223754883,28860,7574,21286,21286,0,12,7587000.0
7587,7587999,20.484262785537698,37.4595178307005,0.08950122366443425,1248.7473528385162,489.24254035949707,1140.1150932312012,28862,7575,21287,21287,0,12,7588000.0
7588,7588999,20.484336277003973,37.45932440534176,0.08949596396467763,1249.118344783783,489.3054745197296,1140.0857887268066,28870,7579,21291,21291,0,12,7589000.0
7589,7589999,20.48477079102967,37.45984804410281,0.08948854015420304,1249.3154096603394,489.3675193786621,1140.2130546569824,28872,7580,21292,21292,0,12,7590000.0
7590,7590999,20.485737072699223,37.46163452168046,0.08948454269879624,1249.564759016037,489.43554067611694,1140.314826965332,28876,7582,21294,21294,0,12,7591000.0
7591,7591999,20.486710740713654,37.463238953852006,0.0894945574173398,1249.8825795650482,489.49981904029846,1140.3462409973145,28882,7585,21297,21297,0,12,7592000.0
7592,7592999,20.487581195053465,37.46482696482837,0.08951220634600765,1249.9925165176392,489.56108927726746,1140.5247688293457,28882,7585,21297,21297,0,12,7593000.0
7593,7593999,20.488877110029094,37.46723218305504,0.0895204780118255,1250.1302466392517,489.6229214668274,1140.69677734375,28882,7585,21297,21297,0,12,7594000.0
7594,7594999,20.490456417936514,37.46998723010006,0.08953397952316555,1250.3903274536133,489.68586444854736,1140.6878089904785,28886,7587,21299,21299,0,12,7595000.0
7595,7595999,20.49241291926824,37.47389835798383,0.08955238522595654,1250.5168569087982,489.7472105026245,1140.8721809387207,28886,7587,21299,21299,0,12,7596000.0
7596,7596999,20.494462834712873,37.477696301766244,0.08957969683944722,1250.7601318359375,489.8099443912506,1140.893814086914,28890,7589,21301,21301,0,12,7597000.0
7597,7597999,20.496141453507715,37.48013005667417,0.08960745050633456,1251.0822117328644,494.14942598342896,1140.9820022583008,28896,7592,21304,21304,0,12,7598000.0
7598,7598999,20.49764998991335,37.48214054715364,0.08962794508614558,1251.2141525745392,494.21381640434265,1141.2400093078613,28896,7592,21304,21304,0,12,7599000.0
7599,7599999,20.49949396552833,37.484528756514614,0.0896466395747274,1251.3403601646423,494.27729511260986,1141.3927040100098,28896,7592,21304,21304,0,12,7600000.0
7600,7600999,20.500566017689078,37.48562291375501,0.08966034093316555,1251.66188955307,494.34074091911316,1141.3748817443848,28902,7595,21307,21307,0,12,7601000.0
7601,7601999,20.500869558525565,37.48639129632843,0.0896248478764935,1251.9202604293823,494.40663266181946,1142.2703590393066,28932,7597,21335,21335,0,12,7602000.0
7602,7602999,20.50046453308424,37.48562413444941,0.08960861853298341,1252.0296173095703,494.46992540359497,1142.7917938232422,28934,7597,21337,21337,0,12,7603000.0
7603,7603999,20.500070802485045,37.48463055109552,0.08959986492201943,1252.2084398269653,494.5311641693115,1143.0639457702637,28937,7598,21339,21339,0,12,7604000.0
7604,7604999,20.49992493260188,37.48459584815817,0.0895881890839606,1252.3348138332367,494.5940487384796,1143.4101486206055,28938,7598,21340,21340,0,12,7605000.0
7605,7605999,20.499564771292544,37.4835977259205,0.08958007502305398,1252.6463499069214,494.6559054851532,1143.4900741577148,28952,7601,21351,21351,0,12,7606000.0
7606,7606999,20.49914668941078,37.48227547992874,0.08957366394230726,1252.968107700348,494.71806955337524,1143.5636940002441,28958,7604,21354,21354,0,12,7607000.0
7607,7607999,20.498682937146597,37.48092645116555,0.08956664947665627,1253.3638694286346,494.7834007740021,1143.6382217407227,28966,7608,21358,21358,0,12,7608000.0
7608,7608999,20.4983387266072,37.48012526002466,0.08955919595939377,1253.7512044906616,494.84677934646606,1143.7495193481445,28974,7612,21362,21362,0,12,7609000.0
7609,7609999,20.498013193611584,37.478977046101704,0.08955309068613526,1254.0866994857788,494.9124732017517,1143.8744621276855,28980,7615,21365,21365,0,12,7610000.0
7610,7610999,20.49753871088152,37.47774989741124,0.08955030720966561,1254.272346496582,494.97830533981323,1144.1230964660645,28982,7616,21366,21366,0,12,7611000.0
7611,7611999,20.49710344814361,37.4764954671544,0.08954777243043588,1254.400396823883,495.0429356098175,1144.36527633667,28982,7616,21366,21366,0,12,7612000.0
7612,7612999,20.49680786682255,37.475670430791126,0.08954329053915988,1254.5905585289001,495.10624051094055,1144.4431648254395,28984,7617,21367,21367,0,12,7613000.0
7613,7613999,20.496589211163492,37.47483473255857,0.08953835271927058,1254.7909808158875,495.17023849487305,1144.5997734069824,28986,7618,21368,21368,0,12,7614000.0
7614,7614999,20.49640268145542,37.47404099437269,0.08953433313082337,1254.932284116745,495.2349805831909,1144.7639198303223,28986,7618,21368,21368,0,12,7615000.0
7615,7615999,20.496406181498905,37.47332937583929,0.08953164373853661,1255.0792198181152,495.29886865615845,1144.9357719421387,28986,7618,21368,21368,0,12,7616000.0
7616,7616999,20.496521306721856,37.47274135431091,0.08953204387441971,1255.2118480205536,495.36202907562256,1145.0536003112793,28986,7618,21368,21368,0,12,7617000.0
7617,7617999,20.49701198707677,37.47293996398677,0.08952474920157372,1255.39763879776,495.4255712032318,1145.1549949645996,28998,7619,21379,21379,0,12,7618000.0
7618,7618999,20.497364136349102,37.473755403118304,0.08951526233773344,1255.5460629463196,495.48936653137207,1145.27787399292,28998,7619,21379,21379,0,12,7619000.0
7619,7619999,20.497819080634542,37.47368333229867,0.08950899242727894,1255.6796884536743,495.55543088912964,1145.364833831787,28998,7619,21379,21379,0,12,7620000.0
7620,7620999,20.497792274537733,37.47279110086846,0.08950559694341531,1255.808289527893,495.6180021762848,1145.4914207458496,28998,7619,21379,21379,0,12,7621000.0
7621,7621999,20.497567931404152,37.47205585141166,0.08949080062718884,1255.9956276416779,495.6810178756714,1146.3145904541016,29019,7620,21399,21399,0,12,7622000.0
7622,7622999,20.497280172287073,37.471732650580805,0.08947667619282962,1256.119666337967,495.7455060482025,1146.8658142089844,29023,7620,21403,21403,0,12,7623000.0
7623,7623999,20.49685769266324,37.47052340096048,0.08946906105900165,1256.251396894455,495.80911350250244,1147.2435493469238,29025,7620,21405,21405,0,12,7624000.0
7624,7624999,20.49672258827448,37.47030729087756,0.08945646298979637,1256.3651688098907,495.8717155456543,1147.4939880371094,29026,7620,21406,21406,0,12,7625000.0
7625,7625999,20.496403250486487,37.470004623185375,0.08944603920199412,1256.5638363361359,495.9330642223358,1147.5681228637695,29032,7621,21411,21411,0,12,7626000.0
7626,7626999,20.49625487329653,37.46948842081649,0.08943422017714475,1256.8894865512848,495.9965019226074,1147.614086151123,29039,7624,21415,21415,0,12,7627000.0
7627,7627999,20.4960686273089,37.46869538746611,0.08942531669595133,1257.1438817977905,496.05861926078796,1147.7948112487793,29043,7626,21417,21417,0,12,7628000.0
7628,7628999,20.496259185070677,37.468771763837005,0.0894127148474303,1257.4586458206177,496.12200593948364,1147.936321258545,29049,7629,21420,21420,0,12,7629000.0
7629,7629999,20.49638547826755,37.4685370268285,0.08940258055057937,1257.6614964008331,496.1842188835144,1148.1266555786133,29051,7630,21421,21421,0,12,7630000.0
7630,7630999,20.49693712695077,37.46917130829473,0.08939406733354183,1257.8438637256622,496.24604415893555,1148.2682609558105,29053,7631,21422,21422,0,12,7631000.0
7631,7631999,20.49724043992495,37.4690958115118,0.08939676771374006,1258.1054916381836,496.3106827735901,1148.231601715088,29062,7633,21429,21429,0,12,7632000.0
7632,7632999,20.497913079342986,37.47010259691459,0.08941088684243437,1258.233186006546,496.3733048439026,1148.4416427612305,29062,7633,21429,21429,0,12,7633000.0
7633,7633999,20.498447148549918,37.47046055518746,0.08942401592798155,1258.636870622635,496.43734335899353,1148.2778129577637,29070,7637,21433,21433,0,12,7634000.0
7634,7634999,20.499003840291287,37.47093610005497,0.08944207934708603,1258.7662229537964,496.50307989120483,1148.6485137939453,29070,7637,21433,21433,0,12,7635000.0
7635,7635999,20.499380295284475,37.47085412582018,0.08946103525181182,1258.9574928283691,496.5660798549652,1148.8113174438477,29072,7638,21434,21434,0,12,7636000.0
7636,7636999,20.499965640362266,37.47130550541351,0.08945371536232383,1259.1001105308533,496.631507396698,1149.6788177490234,29090,7638,21452,21452,0,12,7637000.0
7637,7637999,20.49961726612965,37.471663484601784,0.08944366480785648,1259.2822654247284,496.6953978538513,1150.2862510681152,29094,7639,21455,21455,0,12,7638000.0
7638,7638999,20.49934736508633,37.4716464729519,0.08944060067226978,1259.466556072235,496.75816535949707,1150.6371116638184,29102,7640,21462,21462,0,12,7639000.0
7639,7639999,20.498894206149973,37.47174343249947,0.08943467937251881,1259.6569180488586,496.820184469223,1150.898120880127,29105,7641,21464,21464,0,12,7640000.0
7640,7640999,20.49823833831886,37.47033615326637,0.08943650275589865,1259.9080684185028,496.88315200805664,1151.0517616271973,29109,7643,21466,21466,0,12,7641000.0
7641,7641999,20.49779921981374,37.4692916975928,0.08943344727897884,1260.162501335144,496.9459092617035,1151.238136291504,29113,7645,21468,21468,0,12,7642000.0
7642,7642999,20.497162909588493,37.4679332946911,0.08943576800425368,1260.3588948249817,497.0086097717285,1151.4427680969238,29115,7646,21469,21469,0,12,7643000.0
7643,7643999,20.496586204272962,37.46655603026183,0.08943697947243745,1260.6800212860107,497.07218980789185,1151.4977188110352,29121,7649,21472,21472,0,12,7644000.0
7644,7644999,20.49613420853238,37.46559796936613,0.08943722040187385,1261.0125505924225,497.1375300884247,1151.5603485107422,29127,7652,21475,21475,0,12,7645000.0
7645,7645999,20.495501938827843,37.46417325825151,0.08943696290344494,1261.2044310569763,497.2013187408447,1151.7464714050293,29129,7653,21476,21476,0,12,7646000.0
7646,7646999,20.49510612960853,37.46348880288858,0.0894334977033916,1261.3403537273407,497.265873670578,1151.9608840942383,29129,7653,21476,21476,0,12,7647000.0
7647,7647999,20.494527797903665,37.462255939793735,0.08943080792831237,1261.5368356704712,497.3280508518219,1152.100341796875,29131,7654,21477,21477,0,12,7648000.0
7648,7648999,20.493847872574197,37.46073437991075,0.08943250356852628,1261.7338364124298,497.39329838752747,1152.2111740112305,29133,7655,21478,21478,0,12,7649000.0
7649,7649999,20.49337169614076,37.459635256267745,0.08943265081514173,1261.882336616516,497.4561972618103,1152.378002166748,29133,7655,21478,21478,0,12,7650000.0
7650,7650999,20.492914165268107,37.458575101563994,0.08943050666989161,1262.0883922576904,497.52255630493164,1152.4371719360352,29135,7656,21479,21479,0,12,7651000.0
7651,7651999,20.492312697084095,37.45732399992358,0.08943044081726725,1262.2899188995361,497.58528780937195,1152.5742149353027,29137,7657,21480,21480,0,12,7652000.0
7652,7652999,20.491845647839252,37.45629358917453,0.08942934268160663,1262.4223659038544,497.6471371650696,1152.7120552062988,29137,7657,21480,21480,0,12,7653000.0
7653,7653999,20.491389491422304,37.45534313891529,0.089428925052221,1262.6073489189148,497.7106628417969,1152.7912864685059,29139,7658,21481,21481,0,12,7654000.0
7654,7654999,20.490855952546912,37.45413121136069,0.08942877623811851,1262.8013935089111,497.7727270126343,1152.8374214172363,29150,7659,21491,21491,0,12,7655000.0
7655,7655999,20.491368558547116,37.457928787672415,0.08938394054909815,1262.9133305549622,497.8365685939789,1153.8753204345703,29166,7659,21507,21507,0,12,7656000.0
7656,7656999,20.491347766092357,37.45799686165077,0.08936615711761764,1263.103562116623,497.90091037750244,1154.259506225586,29169,7660,21509,21509,0,12,7657000.0
7657,7657999,20.491183328031536,37.458115652520604,0.089357768065634,1263.3472797870636,497.96277689933777,1154.3930625915527,29173,7662,21511,21511,0,12,7658000.0
7658,7658999,20.490998706389792,37.457352530773214,0.08934990027873257,1263.6089162826538,498.0243241786957,1154.5951614379883,29177,7664,21513,21513,0,12,7659000.0
7659,7659999,20.491147673959905,37.457175035142136,0.08936318881635297,1263.796334028244,498.08669924736023,1154.7683410644531,29179,7665,21514,21514,0,12,7660000.0
7660,7660999,20.491719425247407,37.4574969720386,0.08936960068093314,1263.9878675937653,498.15036273002625,1154.9691200256348,29181,7666,21515,21515,0,12,7661000.0
7661,7661999,20.492317942477637,37.45798474413889,0.08937521427365269,1264.3232836723328,498.2119617462158,1154.9050559997559,29187,7669,21518,21518,0,12,7662000.0
7662,7662999,20.493062593528784,37.45860128064924,0.08940341309188138,1264.6565935611725,498.27416229248047,1154.9049530029297,29193,7672,21521,21521,0,12,7663000.0
7663,7663999,20.493594905418707,37.45897572376843,0.08941761944963544,1264.7710065841675,498.33772230148315,1155.1211738586426,29193,7672,21521,21521,0,12,7664000.0
7664,7664999,20.49448422045027,37.45953683920422,0.08943692701891848,1264.9710054397583,498.3988287448883,1155.1736488342285,29195,7673,21522,21522,0,12,7665000.0
7665,7665999,20.495346378701065,37.4606634556291,0.08946316424771261,1265.1011500358582,498.45992612838745,1155.3507652282715,29195,7673,21522,21522,0,12,7666000.0
7666,7666999,20.49669856480227,37.46286937801056,0.08948227549191634,1265.43097448349,498.5223927497864,1155.2609786987305,29201,7676,21525,21525,0,12,7667000.0
7667,7667999,20.497541008547223,37.46347307760333,0.0895103570689908,1265.5603849887848,498.5838825702667,1155.4136085510254,29201,7676,21525,21525,0,12,7668000.0
7668,7668999,20.49941590005071,37.4665227839495,0.08952809128430672,1265.7730493545532,498.6466565132141,1155.5303955078125,29203,7677,21526,21526,0,12,7669000.0
7669,7669999,20.50068639584485,37.46802553897651,0.089559159055706,1265.9758608341217,498.7086763381958,1155.6704444885254,29205,7678,21527,21527,0,12,7670000.0
7670,7670999,20.502383384525583,37.47056354531024,0.08958786889345771,1266.1743743419647,498.77060985565186,1155.7947082519531,29207,7679,21528,21528,0,12,7671000.0
7671,7671999,20.504391401562778,37.47438169325149,0.08960787916806601,1266.2899460792542,498.8315234184265,1155.9002990722656,29207,7679,21528,21528,0,12,7672000.0
7672,7672999,20.50628610744279,37.47699257233186,0.08963849167551408,1266.4141590595245,498.8925178050995,1156.0339736938477,29207,7679,21528,21528,0,12,7673000.0
7673,7673999,20.508138486781007,37.47949744495068,0.0896477220718096,1266.5541322231293,498.95513558387756,1156.1515731811523,29207,7679,21528,21528,0,12,7674000.0
7674,7674999,20.50946241060649,37.481845501366,0.08957891652384153,1266.7030427455902,499.0192551612854,1156.8696022033691,29222,7679,21543,21543,0,12,7675000.0
7675,7675999,20.509402907466242,37.481456732928464,0.08956469293751956,1266.807189464569,499.0795741081238,1157.3728561401367,29223,7679,21544,21544,0,12,7676000.0
7676,7676999,20.50934184320055,37.481176005874104,0.08956299144972146,1266.99218583107,499.14163184165955,1157.6976051330566,29226,7680,21546,21546,0,12,7677000.0
7677,7677999,20.509423063784062,37.48124295618248,0.0895569540524096,1267.3747518062592,499.20345997810364,1157.7802276611328,29234,7684,21550,21550,0,12,7678000.0
7678,7678999,20.509307218253227,37.48052464836836,0.08955392624156056,1267.5644323825836,499.2653913497925,1158.0667266845703,29236,7685,21551,21551,0,12,7679000.0
7679,7679999,20.509581399862622,37.48042477408848,0.08956118836725668,1267.8909392356873,499.32727432250977,1158.1394844055176,29242,7688,21554,21554,0,12,7680000.0
7680,7680999,20.509854567946046,37.47999040660042,0.0895661166835574,1268.157100200653,499.38920164108276,1158.3093910217285,29248,7690,21558,21558,0,12,7681000.0
7681,7681999,20.51010512465513,37.48004396916245,0.0895697127119155,1268.2798862457275,499.45281291007996,1158.5961799621582,29248,7690,21558,21558,0,12,7682000.0
7682,7682999,20.51058703713251,37.48034826480516,0.08957642182389258,1268.4186420440674,499.5150797367096,1158.8035125732422,29248,7690,21558,21558,0,12,7683000.0
7683,7683999,20.511425317260258,37.481474345631426,0.0895874105721991,1268.6760816574097,499.5766921043396,1158.7987518310547,29252,7692,21560,21560,0,12,7684000.0
7684,7684999,20.512096197150104,37.481895064113324,0.08961219674339838,1268.8108472824097,499.6406993865967,1158.9786987304688,29252,7692,21560,21560,0,12,7685000.0
7685,7685999,20.512830170650147,37.48239497781909,0.08963597391847278,1268.935622215271,499.70200657844543,1159.1346321105957,29252,7692,21560,21560,0,12,7686000.0
7686,7686999,20.51346658266468,37.482641251355666,0.08965892112693896,1269.2591750621796,499.76376938819885,1159.000659942627,29264,7695,21569,21569,0,12,7687000.0
7687,7687999,20.51458031270643,37.48376660981696,0.089699519289828,1269.5436437129974,499.82655787467957,1158.9683647155762,29268,7697,21571,21571,0,12,7688000.0
7688,7688999,20.51568959129183,37.48466674340174,0.08973882105037179,1269.8090062141418,499.88862919807434,1159.062915802002,29272,7699,21573,21573,0,12,7689000.0
7689,7689999,20.516577234146677,37.485507823737386,0.08977512079000505,1270.0586159229279,499.9514157772064,1159.1214218139648,29276,7701,21575,21575,0,12,7690000.0
7690,7690999,20.5175511681938,37.48632745083738,0.08980216246484518,1270.1902740001678,500.01640343666077,1159.2968559265137,29276,7701,21575,21575,0,12,7691000.0
7691,7691999,20.5182422198056,37.4864621763622,0.08982735958582977,1270.4579594135284,500.08186984062195,1159.3613090515137,29280,7703,21577,21577,0,12,7692000.0
7692,7692999,20.518629431640754,37.48606955792146,0.089839300708762,1270.7273333072662,500.1456117630005,1159.339012145996,29284,7705,21579,21579,0,12,7693000.0
7693,7693999,20.518465232296485,37.48544951552494,0.08983004290983909,1270.9217371940613,500.20781564712524,1160.2908744812012,29303,7706,21597,21597,0,12,7694000.0
7694,7694999,20.517718737071515,37.485811099181156,0.08982237215053146,1271.0334086418152,500.2725591659546,1160.8444023132324,29306,7706,21600,21600,0,12,7695000.0
7695,7695999,20.51716188936007,37.485526751334504,0.08981908095030267,1271.2890419960022,500.3371248245239,1161.1428985595703,29310,7708,21602,21602,0,12,7696000.0
7696,7696999,20.516416853931833,37.48426849726982,0.08981770665584188,1271.541333913803,500.3987808227539,1161.4139251708984,29314,7710,21604,21604,0,12,7697000.0
7697,7697999,20.515832467633437,37.48322309702996,0.08981236794045122,1271.874549150467,500.4611384868622,1161.5615692138672,29326,7713,21613,21613,0,12,7698000.0
7698,7698999,20.515422077568555,37.48209834819967,0.08980857811768528,1272.2416632175446,500.53553891181946,1161.596450805664,29332,7716,21616,21616,0,12,7699000.0
7699,7699999,20.51502204451331,37.48091316137442,0.08980493507079945,1272.4972195625305,500.59812593460083,1161.6873359680176,29336,7718,21618,21618,0,12,7700000.0
7700,7700999,20.514652022418865,37.47979701352924,0.08980259524870748,1272.7675371170044,500.66098260879517,1161.863525390625,29340,7720,21620,21620,0,12,7701000.0
7701,7701999,20.51458836500077,37.47979520604414,0.08979973538791852,1272.96595287323,500.72366881370544,1162.0626106262207,29342,7721,21621,21621,0,12,7702000.0
7702,7702999,20.5147918503358,37.47955898539375,0.08979768593578397,1273.159963130951,500.7867193222046,1162.1834030151367,29344,7722,21622,21622,0,12,7703000.0
7703,7703999,20.514724701613563,37.479261786313195,0.08979401605284043,1273.5542047023773,500.8502449989319,1162.157356262207,29352,7726,21626,21626,0,12,7704000.0
7704,7704999,20.514862439254394,37.479514476282425,0.08978845440410332,1273.6945583820343,500.9216787815094,1162.4173469543457,29352,7726,21626,21626,0,12,7705000.0
7705,7705999,20.515085403185697,37.479657146809444,0.08978297476067465,1273.9525372982025,500.9837324619293,1162.4247283935547,29356,7728,21628,21628,0,12,7706000.0
7706,7706999,20.515884220171614,37.48094252048459,0.08977472084342686,1274.0855231285095,501.04510259628296,1162.6470375061035,29356,7728,21628,21628,0,12,7707000.0
7707,7707999,20.516480324043467,37.481662308678004,0.08976918429354175,1274.2788248062134,501.1068584918976,1162.7531929016113,29358,7729,21629,21629,0,12,7708000.0
7708,7708999,20.517350495819432,37.48265102798108,0.08976542242287688,1274.5416357517242,501.1688492298126,1162.8419723510742,29362,7731,21631,21631,0,12,7709000.0
7709,7709999,20.51841280847466,37.483867926961146,0.089758757278534,1274.7509765625,501.2338774204254,1162.9432525634766,29364,7732,21632,21632,0,12,7710000.0
7710,7710999,20.518883662887735,37.483938496134314,0.08975918705158059,1275.0233569145203,501.2964825630188,1162.934986114502,29368,7734,21634,21634,0,12,7711000.0
7711,7711999,20.519573715531724,37.48465799902916,0.0897466701294054,1275.2284705638885,501.3703284263611,1163.0090827941895,29370,7735,21635,21635,0,12,7712000.0
7712,7712999,20.519685930405537,37.483964234414884,0.08973176112999393,1275.360095024109,501.431458234787,1163.9272384643555,29389,7735,21654,21654,0,12,7713000.0
7713,7713999,20.519380091065173,37.48411336013962,0.08971481847890417,1275.4689586162567,501.49518370628357,1164.4858016967773,29390,7735,21655,21655,0,12,7714000.0
7714,7714999,20.51918626736277,37.4837900339181,0.08969438106283056,1275.57834815979,501.555104970932,1164.7836112976074,29390,7735,21655,21655,0,12,7715000.0
7715,7715999,20.518872363211436,37.483101648509,0.08968046791770778,1276.0295579433441,501.6189351081848,1164.8228302001953,29400,7740,21660,21660,0,12,7716000.0
7716,7716999,20.518377909531594,37.481968795872774,0.08966960146194136,1276.3119041919708,501.6867334842682,1164.9742393493652,29404,7742,21662,21662,0,12,7717000.0
7717,7717999,20.518273087831975,37.48179222238829,0.08965382151141876,1276.578367948532,501.7515695095062,1165.102668762207,29408,7744,21664,21664,0,12,7718000.0
7718,7718999,20.517885735293873,37.48062782342257,0.08964122854052603,1276.8410601615906,501.81573581695557,1165.2201232910156,29418,7746,21672,21672,0,12,7719000.0
7719,7719999,20.517795258240586,37.47996351719966,0.08962600372073637,1277.1142823696136,501.8787341117859,1165.319507598877,29422,7748,21674,21674,0,12,7720000.0
7720,7720999,20.517539101414542,37.47900109985105,0.08961162390962463,1277.2429633140564,501.941458940506,1165.5417823791504,29422,7748,21674,21674,0,12,7721000.0
7721,7721999,20.51737534248658,37.47811107163187,0.08959878627901918,1277.5063872337341,502.0050106048584,1165.622631072998,29426,7750,21676,21676,0,12,7722000.0
7722,7722999,20.517282458284658,37.47724003394147,0.08958282052225941,1277.7625615596771,502.0699374675751,1165.6641006469727,29430,7752,21678,21678,0,12,7723000.0
7723,7723999,20.51704182509828,37.47626465552488,0.0895694263973803,1277.9582252502441,502.13287472724915,1165.7297477722168,29432,7753,21679,21679,0,12,7724000.0
7724,7724999,20.51676694118183,37.4753624940914,0.08955817219875739,1278.1498193740845,502.194265127182,1165.875114440918,29434,7754,21680,21680,0,12,7725000.0
7725,7725999,20.516731783759855,37.474799786872246,0.08955423376613592,1278.351240158081,502.2567341327667,1165.9463119506836,29436,7755,21681,21681,0,12,7726000.0
7726,7726999,20.51668420161905,37.47458204350607,0.0895430282611327,1278.5436806678772,502.3217339515686,1166.063850402832,29438,7756,21682,21682,0,12,7727000.0
7727,7727999,20.516705809109553,37.47392186278353,0.0895354506547843,1278.8066477775574,502.3850619792938,1166.103645324707,29442,7758,21684,21684,0,12,7728000.0
7728,7728999,20.51661535877298,37.47327852003281,0.08952816862277635,1278.9614088535309,502.45420598983765,1166.2657279968262,29442,7758,21684,21684,0,12,7729000.0
7729,7729999,20.516727918110018,37.47280800456057,0.08952112449783856,1279.1749002933502,502.5197424888611,1166.3560066223145,29444,7759,21685,21685,0,12,7730000.0
7730,7730999,20.516557227264315,37.47190003370575,0.08951340010662456,1279.4385058879852,502.5842032432556,1166.3973236083984,29455,7761,21694,21694,0,12,7731000.0
7731,7731999,20.51632250110336,37.47080502218252,0.08950468236042042,1279.6943156719208,502.6468720436096,1166.4597778320312,29459,7763,21696,21696,0,12,7732000.0
7732,7732999,20.5159595659171,37.469690515514664,0.08950045850479049,1279.8780505657196,502.71033906936646,1167.3538093566895,29489,7764,21725,21725,0,12,7733000.0
7733,7733999,20.51507169244972,37.46795210117689,0.08950295467170966,1280.054499387741,502.7738425731659,1167.7753677368164,29492,7765,21727,21727,0,12,7734000.0
7734,7734999,20.514194391450033,37.46637638487783,0.08950287403502444,1280.2331097126007,502.83649373054504,1168.0821838378906,29495,7766,21729,21729,0,12,7735000.0
7735,7735999,20.513607553395456,37.4656728234848,0.08950126299515704,1280.420173883438,502.9011273384094,1168.32958984375,29497,7767,21730,21730,0,12,7736000.0
7736,7736999,20.513241971867988,37.464867775829674,0.08949522346167371,1280.6827545166016,502.96379709243774,1168.4893531799316,29502,7769,21733,21733,0,12,7737000.0
7737,7737999,20.512849333108548,37.46446253336771,0.08949490099264534,1280.948308467865,503.02723693847656,1168.5564918518066,29506,7771,21735,21735,0,12,7738000.0
7738,7738999,20.512518854108727,37.46398250246457,0.08949388900321498,1281.3579819202423,503.09118247032166,1168.6411819458008,29514,7775,21739,21739,0,12,7739000.0
7739,7739999,20.512359678240948,37.463892665956266,0.08949801383958045,1281.678100824356,503.154997587204,1168.7563819885254,29520,7778,21742,21742,0,12,7740000.0
7740,7740999,20.512172203583866,37.463526929831716,0.08950691016374257,1282.0123183727264,503.2203838825226,1168.8413619995117,29526,7781,21745,21745,0,12,7741000.0
7741,7741999,20.512156485791476,37.46433197694975,0.08951038114067389,1282.4311246871948,503.28434324264526,1168.8804931640625,29534,7785,21749,21749,0,12,7742000.0
7742,7742999,20.512455758190985,37.46556746801544,0.08951194392645467,1282.5537974834442,503.34698390960693,1169.1402473449707,29534,7785,21749,21749,0,12,7743000.0
7743,7743999,20.512435893025277,37.465298709222004,0.08951852521978043,1282.6766638755798,503.40932726860046,1169.317855834961,29534,7785,21749,21749,0,12,7744000.0
7744,7744999,20.512450541553747,37.46524262285959,0.0895277730288434,1282.8048255443573,503.47159075737,1169.511947631836,29534,7785,21749,21749,0,12,7745000.0
7745,7745999,20.513008801762737,37.46701376393426,0.08953750187429232,1282.9426770210266,503.53549218177795,1169.6544761657715,29534,7785,21749,21749,0,12,7746000.0
7746,7746999,20.513380489218104,37.46878582789714,0.08953751435147173,1283.1443629264832,503.5997700691223,1169.776767730713,29546,7786,21760,21760,0,12,7747000.0
7747,7747999,20.513814841324056,37.469152053707944,0.08952988344082347,1283.2783744335175,503.6627857685089,1169.8811111450195,29546,7786,21760,21760,0,12,7748000.0
7748,7748999,20.51452276298563,37.4700481451986,0.08952595383882056,1283.5583667755127,503.73439049720764,1169.9067764282227,29550,7788,21762,21762,0,12,7749000.0
7749,7749999,20.515121305675823,37.47033446818216,0.08952541585870599,1283.6967959403992,503.7961893081665,1170.0626525878906,29550,7788,21762,21762,0,12,7750000.0
7750,7750999,20.515796162905424,37.47063200827655,0.08952872078085183,1284.0419976711273,503.8601267337799,1169.8793296813965,29562,7791,21771,21771,0,12,7751000.0
7751,7751999,20.51615669823046,37.47055340756741,0.08952901620983456,1284.1654660701752,503.92396783828735,1170.1248092651367,29562,7791,21771,21771,0,12,7752000.0
7752,7752999,20.51616658712734,37.47023746679122,0.08951713184337251,1284.2870678901672,503.9863278865814,1171.1491050720215,29583,7791,21792,21792,0,12,7753000.0
7753,7753999,20.5158479442507,37.46966901872294,0.0895137461838672,1284.466623544693,504.0476145744324,1171.6117553710938,29593,7792,21801,21801,0,12,7754000.0
7754,7754999,20.515407328077217,37.468569181073406,0.08951283271524813,1284.6535258293152,504.1133680343628,1171.9215049743652,29595,7793,21802,21802,0,12,7755000.0
7755,7755999,20.515096113292767,37.46767032062935,0.08950777969144985,1284.834501504898,504.1764051914215,1172.2879219055176,29598,7794,21804,21804,0,12,7756000.0
7756,7756999,20.514617648556552,37.46645526256209,0.089505735567035,1285.1468160152435,504.24004769325256,1172.4061813354492,29610,7797,21813,21813,0,12,7757000.0
7757,7757999,20.5142078784593,37.465387012825424,0.08950393022213998,1285.2845702171326,504.30477118492126,1172.6916542053223,29610,7797,21813,21813,0,12,7758000.0
7758,7758999,20.51364481220332,37.464058532693144,0.08950275981957845,1285.7381236553192,504.36761379241943,1172.6004028320312,29620,7802,21818,21818,0,12,7759000.0
7759,7759999,20.51326164577005,37.46300687166052,0.08949952289429952,1286.0674545764923,504.43076944351196,1172.839542388916,29626,7805,21821,21821,0,12,7760000.0
7760,7760999,20.51308488676796,37.462279945416405,0.08949516349746367,1286.3296647071838,504.49502825737,1172.9945755004883,29630,7807,21823,21823,0,12,7761000.0
7761,7761999,20.51285161514053,37.46120472864541,0.08949125478340081,1286.6077282428741,504.56551814079285,1173.096622467041,29634,7809,21825,21825,0,12,7762000.0
7762,7762999,20.512592229846092,37.460151250537756,0.08948628136399339,1286.8921835422516,504.6358485221863,1173.2033920288086,29638,7811,21827,21827,0,12,7763000.0
7763,7763999,20.512508372787003,37.45936661840169,0.08948182774688462,1287.0822372436523,504.6994125843048,1173.3498039245605,29640,7812,21828,21828,0,12,7764000.0
7764,7764999,20.512221120963254,37.45820507572658,0.08947905542487977,1287.217060804367,504.7631299495697,1173.5624656677246,29640,7812,21828,21828,0,12,7765000.0
7765,7765999,20.511885584657037,37.456984317626855,0.08947761905160756,1287.4118626117706,504.8265676498413,1173.6600456237793,29642,7813,21829,21829,0,12,7766000.0
7766,7766999,20.511562924738232,37.45568383769793,0.08947668171621048,1287.5412764549255,504.88927245140076,1173.8851280212402,29642,7813,21829,21829,0,12,7767000.0
7767,7767999,20.51111078707192,37.455183042373996,0.08947555371254134,1287.7594270706177,504.95165967941284,1174.0337867736816,29644,7814,21830,21830,0,12,7768000.0
7768,7768999,20.51162284882309,37.45728934266412,0.08950126208836129,1287.9584748744965,505.0221333503723,1175.128677368164,29672,7815,21857,21857,0,12,7769000.0
7769,7769999,20.51195894105131,37.45806253964425,0.0895188616765048,1288.1374008655548,505.08347177505493,1175.488941192627,29674,7816,21858,21858,0,12,7770000.0
7770,7770999,20.51195639294221,37.45792080178399,0.0895087463703228,1288.3350195884705,505.1536729335785,1175.7679824829102,29677,7817,21860,21860,0,12,7771000.0
7771,7771999,20.512681207094317,37.45928628237645,0.08951305298552559,1288.5216460227966,505.21500301361084,1176.075481414795,29680,7818,21862,21862,0,12,7772000.0
7772,7772999,20.513463507724783,37.461150900631964,0.08949319528777355,1288.6399056911469,505.27691769599915,1176.327407836914,29680,7818,21862,21862,0,12,7773000.0
7773,7773999,20.51399966124672,37.46172995866541,0.089498943341072,1288.9516952037811,505.3395221233368,1176.285545349121,29686,7821,21865,21865,0,12,7774000.0
7774,7774999,20.51479432758128,37.46285886152212,0.08951216877274903,1289.3482027053833,505.4033749103546,1176.379093170166,29694,7825,21869,21869,0,12,7775000.0
7775,7775999,20.51601234566779,37.466713262086536,0.08950330394682271,1289.5615758895874,505.4699761867523,1176.6386108398438,29696,7826,21870,21870,0,12,7776000.0
7776,7776999,20.516937579150493,37.46830516807491,0.08950348838229671,1289.8834640979767,505.5357458591461,1176.6832466125488,29702,7829,21873,21873,0,12,7777000.0
7777,7777999,20.518214252627352,37.46993110582644,0.08951492162085717,1290.0160038471222,505.59881138801575,1176.8925590515137,29702,7829,21873,21873,0,12,7778000.0
7778,7778999,20.519805854744014,37.472865207892376,0.08949855265809636,1290.1291313171387,505.6616497039795,1177.0796699523926,29702,7829,21873,21873,0,12,7779000.0
7779,7779999,20.521324549966558,37.475409831858954,0.0895047753257413,1290.4645459651947,505.7260687351227,1177.099521636963,29708,7832,21876,21876,0,12,7780000.0
7780,7780999,20.523003790528165,37.47838357397923,0.08950678793870759,1290.8007514476776,505.79237699508667,1177.1981925964355,29722,7835,21887,21887,0,12,7781000.0
7781,7781999,20.524222442516958,37.48021440638599,0.08953017719643286,1290.9943988323212,505.854829788208,1177.2808837890625,29724,7836,21888,21888,0,12,7782000.0
7782,7782999,20.526109304780803,37.48333042460505,0.08954052130597001,1291.1266465187073,505.91662979125977,1177.4776496887207,29725,7836,21889,21889,0,12,7783000.0
7783,7783999,20.52754122564564,37.48484938310561,0.08955872358490335,1291.3235023021698,505.9803931713104,1177.577838897705,29727,7837,21890,21890,0,12,7784000.0
7784,7784999,20.52931055762359,37.487007201346024,0.08960293287395393,1291.609407901764,506.0434687137604,1177.5505332946777,29737,7839,21898,21898,0,12,7785000.0
7785,7785999,20.530495673432185,37.48819330427021,0.0896301480026841,1291.7287945747375,506.108323097229,1177.7326126098633,29737,7839,21898,21898,0,12,7786000.0
7786,7786999,20.530310484760232,37.48720976607495,0.0896338863003513,1291.8443722724915,506.1698307991028,1178.683479309082,29754,7839,21915,21915,0,12,7787000.0
7787,7787999,20.529767455816643,37.48627043532357,0.08962864178702612,1292.031525850296,506.23329734802246,1179.0156517028809,29767,7840,21927,21927,0,12,7788000.0
7788,7788999,20.529157431380128,37.48532261886252,0.08962557705769714,1292.2047247886658,506.294056892395,1179.2314682006836,29769,7841,21928,21928,0,12,7789000.0
7789,7789999,20.528787673607592,37.4847657960142,0.08962146878878541,1292.5311012268066,506.35540747642517,1179.3799476623535,29775,7844,21931,21931,0,12,7790000.0
7790,7790999,20.528254703180412,37.483505201506865,0.08961935288767975,1292.647206544876,506.41602087020874,1179.6521110534668,29775,7844,21931,21931,0,12,7791000.0
7791,7791999,20.528099254456684,37.482861407907684,0.08961371456970169,1292.960100889206,506.4774272441864,1179.7297172546387,29781,7847,21934,21934,0,12,7792000.0
7792,7792999,20.528333686648196,37.48290713632726,0.08960974758106421,1293.2914476394653,506.5399823188782,1179.838581085205,29787,7850,21937,21937,0,12,7793000.0
7793,7793999,20.528805675793503,37.484323068097865,0.08960586867833009,1293.5552530288696,506.6029577255249,1180.0222473144531,29791,7852,21939,21939,0,12,7794000.0
7794,7794999,20.529051387492547,37.48442213668726,0.08961221717617296,1293.749208688736,506.6641547679901,1180.2144088745117,29793,7853,21940,21940,0,12,7795000.0
7795,7795999,20.52973108785291,37.48550914233936,0.08961315876121523,1294.007673740387,506.726007938385,1180.316074371338,29797,7855,21942,21942,0,12,7796000.0
7796,7796999,20.53063621659193,37.488635208600705,0.08960766535494935,1294.1233658790588,506.78936529159546,1180.568790435791,29797,7855,21942,21942,0,12,7797000.0
7797,7797999,20.53110089313333,37.48932006168729,0.08961501917526482,1294.3278045654297,506.8525574207306,1180.6691932678223,29799,7856,21943,21943,0,12,7798000.0
7798,7798999,20.531538057267255,37.489866282646716,0.08962524763041924,1294.4488017559052,506.91362595558167,1180.8412475585938,29799,7856,21943,21943,0,12,7799000.0
7799,7799999,20.531887256198885,37.49022180779658,0.08963645685048383,1294.8508324623108,506.97688007354736,1180.6821556091309,29807,7860,21947,21947,0,12,7800000.0
7800,7800999,20.532678320222345,37.49165347067757,0.08964649774714151,1294.9754242897034,507.03957438468933,1180.9551010131836,29807,7860,21947,21947,0,12,7801000.0
7801,7801999,20.53313824017021,37.492289860797115,0.08965619935145863,1295.1020531654358,507.10092091560364,1181.1379013061523,29807,7860,21947,21947,0,12,7802000.0
7802,7802999,20.533503952544024,37.492139727606286,0.08966554384583181,1295.228357553482,507.1658341884613,1181.2603874206543,29807,7860,21947,21947,0,12,7803000.0
7803,7803999,20.534066458484972,37.49324349885737,0.08966518574666371,1295.5059902668,507.22927355766296,1181.2218627929688,29811,7862,21949,21949,0,12,7804000.0
7804,7804999,20.534358586075932,37.492916802612356,0.0896581061950561,1295.7026631832123,507.2920289039612,1181.3117942810059,29813,7863,21950,21950,0,12,7805000.0
7805,7805999,20.53448033872401,37.492960720415155,0.08964693946805102,1295.8353464603424,507.35357642173767,1182.0886421203613,29827,7863,21964,21964,0,12,7806000.0
7806,7806999,20.53406523105791,37.4945139306319,0.08962569589417257,1296.0065569877625,507.4138512611389,1182.642189025879,29836,7864,21972,21972,0,12,7807000.0
7807,7807999,20.533516403245226,37.493788254430726,0.08961706695634009,1296.182136774063,507.47376799583435,1183.026538848877,29838,7865,21973,21973,0,12,7808000.0
7808,7808999,20.532833928555664,37.49233839445697,0.08961621731474079,1296.4339084625244,507.53508138656616,1183.2330627441406,29842,7867,21975,21975,0,12,7809000.0
7809,7809999,20.532246376072816,37.49100866121564,0.08960310290690254,1296.6872186660767,507.5963878631592,1183.3375511169434,29846,7869,21977,21977,0,12,7810000.0
7810,7810999,20.53188140089614,37.490208388019106,0.08959554276241066,1296.9988162517548,507.65834522247314,1183.4466133117676,29881,7872,22009,22009,0,12,7811000.0
7811,7811999,20.531829209790647,37.48966921815259,0.08957708591064462,1297.2633411884308,507.7189862728119,1183.5306549072266,29885,7874,22011,22011,0,12,7812000.0
7812,7812999,20.532234496016915,37.48996727029155,0.08955919761100051,1297.37735247612,507.78063321113586,1183.7551460266113,29885,7874,22011,22011,0,12,7813000.0
7813,7813999,20.532578498372075,37.490685289812966,0.08955297437301413,1297.8449783325195,507.8442614078522,1183.6813468933105,29895,7879,22016,22016,0,12,7814000.0
7814,7814999,20.533225846758032,37.49159616218441,0.08956129997762552,1298.026475906372,507.90575981140137,1183.8592414855957,29897,7880,22017,22017,0,12,7815000.0
7815,7815999,20.533972391503543,37.49321957423502,0.08956913519880094,1298.212577342987,507.9688892364502,1183.995517730713,29899,7881,22018,22018,0,12,7816000.0
7816,7816999,20.53457654701047,37.49433200026911,0.08957193961803744,1298.4200274944305,508.03270506858826,1184.1230850219727,29901,7882,22019,22019,0,12,7817000.0
7817,7817999,20.53514237772905,37.49519714122823,0.08957385992855016,1298.533870458603,508.0944890975952,1184.2944564819336,29901,7882,22019,22019,0,12,7818000.0
7818,7818999,20.53580643966444,37.49720919319317,0.0895826407051391,1298.7371599674225,508.1596739292145,1184.3396911621094,29903,7883,22020,22020,0,12,7819000.0
7819,7819999,20.53670327935205,37.49891564818769,0.08958959220013663,1298.8685188293457,508.2209837436676,1184.5642852783203,29903,7883,22020,22020,0,12,7820000.0
7820,7820999,20.53734715120659,37.49947714313304,0.08958361240868795,1298.996571302414,508.283038854599,1184.6970329284668,29903,7883,22020,22020,0,12,7821000.0
7821,7821999,20.538046819351447,37.50095683349133,0.08958172825649546,1299.2631237506866,508.3457295894623,1184.687427520752,29907,7885,22022,22022,0,12,7822000.0
7822,7822999,20.538887220619205,37.502548878450106,0.08958617674609637,1299.3791501522064,508.40660214424133,1184.7998352050781,29907,7885,22022,22022,0,12,7823000.0
7823,7823999,20.539597706777133,37.50419212525081,0.08957268124417372,1299.5833904743195,508.4690639972687,1184.8699760437012,29909,7886,22023,22023,0,12,7824000.0
7824,7824999,20.53968784297593,37.50511355383823,0.08953410150626329,1299.6995005607605,508.53184509277344,1185.9489860534668,29931,7886,22045,22045,0,12,7825000.0
7825,7825999,20.53945816787044,37.50454498608971,0.08952750701845102,1299.8079273700714,508.59373211860657,1186.4555015563965,29932,7886,22046,22046,0,12,7826000.0
7826,7826999,20.53915200270207,37.50355680840493,0.08952300924007761,1300.065779209137,508.6570727825165,1186.6153717041016,29936,7888,22048,22048,0,12,7827000.0
7827,7827999,20.538868897061455,37.50283488791403,0.08951363491173736,1300.313591003418,508.7187530994415,1186.7952728271484,29940,7890,22050,22050,0,12,7828000.0
7828,7828999,20.538651050033923,37.50220496976241,0.08950689503692466,1300.6254324913025,508.7814702987671,1186.8722190856934,29946,7893,22053,22053,0,12,7829000.0
7829,7829999,20.53832965147246,37.50102305064368,0.0895056523147949,1301.001567363739,508.8437294960022,1186.9820098876953,29954,7897,22057,22057,0,12,7830000.0
7830,7830999,20.537935053331793,37.49983706801981,0.089502385068576,1301.375733613968,508.90606594085693,1187.008529663086,29988,7901,22087,22087,0,12,7831000.0
7831,7831999,20.53766964996176,37.498904141264106,0.08949653756674203,1301.6997509002686,508.97130036354065,1187.058277130127,29994,7904,22090,22090,0,12,7832000.0
7832,7832999,20.53753610647107,37.49824391936394,0.08949010314982442,1301.8166913986206,509.03231143951416,1187.4288635253906,29994,7904,22090,22090,0,12,7833000.0
7833,7833999,20.53745682858382,37.49755440107643,0.08948802928468491,1301.9945406913757,509.09365582466125,1187.583625793457,29996,7905,22091,22091,0,12,7834000.0
7834,7834999,20.537078249542095,37.49652614985803,0.08948648839460815,1302.128077507019,509.1553318500519,1187.7360534667969,29996,7905,22091,22091,0,12,7835000.0
7835,7835999,20.536707486187137,37.495394077932666,0.0894844769405011,1302.2575633525848,509.2163841724396,1187.936336517334,29996,7905,22091,22091,0,12,7836000.0
7836,7836999,20.53643812742136,37.494352405058706,0.08948521334569903,1302.3809230327606,509.2810733318329,1188.0779037475586,29996,7905,22091,22091,0,12,7837000.0
7837,7837999,20.536028191459923,37.49316841152888,0.0894853704401728,1302.7832810878754,509.3451147079468,1187.962661743164,30019,7909,22110,22110,0,12,7838000.0
7838,7838999,20.535792228233298,37.49229679887518,0.08948083187803535,1302.9807255268097,509.40816140174866,1188.0713844299316,30021,7910,22111,22111,0,12,7839000.0
7839,7839999,20.535529093066366,37.49121430875913,0.0894772841537198,1303.1164960861206,509.480242729187,1188.2432594299316,30021,7910,22111,22111,0,12,7840000.0
7840,7840999,20.535128541150673,37.49001148914613,0.08947621490501123,1303.3397207260132,509.5490629673004,1188.3179512023926,30023,7911,22112,22112,0,12,7841000.0
7841,7841999,20.534668706951262,37.48877989537109,0.08947360589294917,1303.4790256023407,509.61013412475586,1188.4212226867676,30023,7911,22112,22112,0,12,7842000.0
7842,7842999,20.534245656295692,37.48811012700629,0.08946705794730159,1303.5969581604004,509.6709339618683,1188.5706825256348,30023,7911,22112,22112,0,12,7843000.0
7843,7843999,20.534245414516885,37.48983415723145,0.08944601636870486,1303.7906427383423,509.7383098602295,1189.459342956543,30042,7912,22130,22130,0,12,7844000.0
7844,7844999,20.533849707999146,37.48921678138151,0.0894407992355154,1303.904414176941,509.79892349243164,1189.8683471679688,30043,7912,22131,22131,0,12,7845000.0
7845,7845999,20.533659510822375,37.489227598655106,0.08943454571418441,1304.0814588069916,509.8608543872833,1190.1074180603027,30045,7913,22132,22132,0,12,7846000.0
7846,7846999,20.533700031143198,37.489833658866715,0.08942841622022257,1304.390350818634,509.92278957366943,1190.1996955871582,30051,7916,22135,22135,0,12,7847000.0
7847,7847999,20.534178664699716,37.49098586794184,0.08942912956226878,1304.5075645446777,509.9837110042572,1190.4880180358887,30051,7916,22135,22135,0,12,7848000.0
7848,7848999,20.534528486960376,37.491416446946985,0.08942503597959628,1304.7065987586975,510.0460126399994,1190.6324043273926,30053,7917,22136,22136,0,12,7849000.0
7849,7849999,20.535364879961882,37.493187182569486,0.08942740027197671,1305.032884836197,510.1075930595398,1190.6310501098633,30059,7920,22139,22139,0,12,7850000.0
7850,7850999,20.536271174908205,37.494990419118274,0.08943700523433218,1305.4350097179413,510.17040395736694,1190.6801223754883,30073,7924,22149,22149,0,12,7851000.0
7851,7851999,20.537434422849557,37.49741359896939,0.08944286664316914,1305.7529151439667,510.23328852653503,1190.7147026062012,30079,7927,22152,22152,0,12,7852000.0
7852,7852999,20.53909133458476,37.50149418766955,0.08946329550304144,1306.0035164356232,510.29508352279663,1190.733627319336,30083,7929,22154,22154,0,12,7853000.0
7853,7853999,20.54140786746244,37.5098872713554,0.0894919642425751,1306.277110338211,510.35804438591003,1190.8175163269043,30087,7931,22156,22156,0,12,7854000.0
7854,7854999,20.543512251338363,37.51498374288339,0.08952121103575406,1306.3922011852264,510.4207196235657,1191.0301971435547,30087,7931,22156,22156,0,12,7855000.0
7855,7855999,20.544590690216786,37.51619876852368,0.0895628786140582,1306.663388967514,510.4854006767273,1191.0460166931152,30091,7933,22158,22158,0,12,7856000.0
7856,7856999,20.54662451859306,37.52056780434436,0.0896281005711389,1306.8549146652222,510.5483400821686,1191.1858177185059,30093,7934,22159,22159,0,12,7857000.0
7857,7857999,20.548330550348844,37.52456063964296,0.08965598098471095,1307.1287024021149,510.6135218143463,1191.1949462890625,30097,7936,22161,22161,0,12,7858000.0
7858,7858999,20.549993502732185,37.526974688728,0.08968252841641755,1307.3307313919067,510.67957639694214,1191.3741416931152,30104,7937,22167,22167,0,12,7859000.0
7859,7859999,20.5521558270113,37.53073711308997,0.08971898331698702,1307.471685409546,510.74648427963257,1191.5536918640137,30104,7937,22167,22167,0,12,7860000.0
7860,7860999,20.554083960628493,37.533829514418166,0.08976360173720943,1307.6658101081848,510.8095324039459,1191.6162719726562,30106,7938,22168,22168,0,12,7861000.0
7861,7861999,20.55579727971183,37.53629356580588,0.08981274886790347,1307.941167831421,510.87590408325195,1191.6975593566895,30117,7940,22177,22177,0,12,7862000.0
7862,7862999,20.55663896119266,37.53717498350915,0.08979889107555727,1308.0639202594757,510.9411232471466,1192.9672813415527,30137,7940,22197,22197,0,12,7863000.0
7863,7863999,20.557871978489743,37.53996927229189,0.08978657318827066,1308.1754207611084,511.00303053855896,1193.6379737854004,30141,7940,22201,22201,0,12,7864000.0
7864,7864999,20.558842812182412,37.541952708953374,0.08978422485652171,1308.2888827323914,511.0660169124603,1194.071086883545,30142,7940,22202,22202,0,12,7865000.0
7865,7865999,20.560057825996918,37.54377482465153,0.08977678190660665,1308.5362734794617,511.12859773635864,1194.3148155212402,30146,7942,22204,22204,0,12,7866000.0
7866,7866999,20.560837221811674,37.54471319098087,0.08977486473409912,1308.7193233966827,511.1912088394165,1194.6985702514648,30149,7943,22206,22206,0,12,7867000.0
7867,7867999,20.56195871008928,37.54656072743671,0.08977089453314413,1308.8337087631226,511.25486993789673,1195.0177955627441,30150,7943,22207,22207,0,12,7868000.0
7868,7868999,20.56275875341999,37.5468814593452,0.08977475723444095,1308.9492409229279,511.3165829181671,1195.2967338562012,30151,7943,22208,22208,0,12,7869000.0
7869,7869999,20.56377152655751,37.54758970721792,0.08978020734367553,1309.0741701126099,511.3768277168274,1195.589672088623,30151,7943,22208,22208,0,12,7870000.0
7870,7870999,20.565073474582736,37.549011050736354,0.08979230093188906,1309.2597155570984,511.4374694824219,1195.8054580688477,30153,7944,22209,22209,0,12,7871000.0
7871,7871999,20.566483565206482,37.550845595078314,0.08980801719610632,1309.5128769874573,511.49835991859436,1195.9931640625,30159,7946,22213,22213,0,12,7872000.0
7872,7872999,20.56804874194799,37.55267707484287,0.08982263462004692,1309.643515586853,511.56235241889954,1196.1939582824707,30159,7946,22213,22213,0,12,7873000.0
7873,7873999,20.569643810768042,37.55465215390056,0.08983620635609102,1309.8995823860168,511.6235456466675,1196.282512664795,30163,7948,22215,22215,0,12,7874000.0
7874,7874999,20.571591100675008,37.55957802862869,0.08984563145800206,1310.233074426651,511.6873891353607,1196.2825736999512,30169,7951,22218,22218,0,12,7875000.0
7875,7875999,20.573516597812255,37.56362336899867,0.08985259164289827,1310.6264202594757,511.7497606277466,1196.1681900024414,30182,7955,22227,22227,0,12,7876000.0
7876,7876999,20.57537190259586,37.566204602048764,0.08988244862894568,1310.8868324756622,511.811861038208,1196.3325805664062,30186,7957,22229,22229,0,12,7877000.0
7877,7877999,20.577145489210935,37.56824457089583,0.08991368124720933,1311.1018896102905,511.8814449310303,1196.551856994629,30188,7958,22230,22230,0,12,7878000.0
7878,7878999,20.579108032010144,37.57097562726662,0.08994180542166297,1311.2990872859955,511.9470491409302,1196.7470626831055,30191,7959,22232,22232,0,12,7879000.0
7879,7879999,20.58087871184319,37.57312387583106,0.08996646533833497,1311.420007944107,512.0088398456573,1196.9126930236816,30191,7959,22232,22232,0,12,7880000.0
7880,7880999,20.582026568298417,37.57394500856566,0.08997742690464894,1311.5331830978394,512.0716903209686,1197.1159858703613,30191,7959,22232,22232,0,12,7881000.0
7881,7881999,20.58271335698643,37.57440289011904,0.08995251405198679,1311.6550390720367,512.1337502002716,1198.41410446167,30207,7959,22248,22248,0,12,7882000.0
7882,7882999,20.582632049280292,37.573722552924565,0.08993923632524103,1311.7642822265625,512.1952419281006,1199.0613555908203,30210,7959,22251,22251,0,12,7883000.0
7883,7883999,20.582507783351506,37.573610734249584,0.08993197741557724,1311.8758206367493,512.2558269500732,1199.488468170166,30210,7959,22251,22251,0,12,7884000.0
7884,7884999,20.5822194742721,37.57285566812248,0.08992511705016026,1312.072457075119,512.3232336044312,1199.7434120178223,30212,7960,22252,22252,0,12,7885000.0
7885,7885999,20.581921465611664,37.57200597240627,0.08991692156835873,1312.2584097385406,512.3861768245697,1200.025203704834,30215,7961,22254,22254,0,12,7886000.0
7886,7886999,20.58167991418503,37.57101182851479,0.08991292426933595,1312.4381580352783,512.4499001502991,1200.25297164917,30217,7962,22255,22255,0,12,7887000.0
7887,7887999,20.58189048584262,37.571222109502926,0.0899023704156251,1312.6969270706177,512.5101897716522,1200.3877029418945,30222,7964,22258,22258,0,12,7888000.0
7888,7888999,20.581759918939575,37.57050665529478,0.08989406718241655,1312.9489107131958,512.5718741416931,1200.5192565917969,30226,7966,22260,22260,0,12,7889000.0
7889,7889999,20.58199016058947,37.57023297944717,0.08988725902626904,1313.2626283168793,512.6335709095001,1200.5633392333984,30242,7969,22273,22273,0,12,7890000.0
7890,7890999,20.582151807701575,37.571498471721135,0.0898726160984088,1313.4615790843964,512.698409318924,1200.786277770996,30244,7970,22274,22274,0,12,7891000.0
7891,7891999,20.58233419226054,37.57102307572509,0.08986981322522136,1313.669161081314,512.7612645626068,1200.9478073120117,30246,7971,22275,22275,0,12,7892000.0
7892,7892999,20.582499121965228,37.5704973270943,0.08986638855432094,1313.9222149848938,512.8224995136261,1201.0728302001953,30260,7973,22287,22287,0,12,7893000.0
7893,7893999,20.582515148277228,37.56965741045892,0.08986122696667875,1314.052538394928,512.8866631984711,1201.2642631530762,30260,7973,22287,22287,0,12,7894000.0
7894,7894999,20.58251771855381,37.56883304023217,0.08985843045935715,1314.3161778450012,512.9482567310333,1201.2125434875488,30264,7975,22289,22289,0,12,7895000.0
7895,7895999,20.582396106430735,37.56769006005404,0.08985518780435564,1314.4410636425018,513.0126430988312,1201.4469604492188,30264,7975,22289,22289,0,12,7896000.0
7896,7896999,20.582230217632738,37.56646220961121,0.08985291132041184,1314.648473739624,513.0761907100677,1201.5923919677734,30266,7976,22290,22290,0,12,7897000.0
7897,7897999,20.582271849672,37.56603923939338,0.08984006232519115,1314.8305642604828,513.1373262405396,1202.9261322021484,30288,7977,22311,22311,0,12,7898000.0
7898,7898999,20.581969402966074,37.5658579388528,0.08982643169175153,1314.9392845630646,513.1973052024841,1203.489200592041,30288,7977,22311,22311,0,12,7899000.0
7899,7899999,20.58166710628149,37.564821505489114,0.08981644658253751,1315.1070663928986,513.2563953399658,1203.8550567626953,30292,7978,22314,22314,0,12,7900000.0
7900,7900999,20.58158940384222,37.56438264213805,0.08980446697605604,1315.2815055847168,513.317421913147,1204.1386070251465,30294,7979,22315,22315,0,12,7901000.0
7901,7901999,20.581455818507756,37.56341150170394,0.0897959222895115,1315.524451494217,513.3786821365356,1204.442554473877,30298,7981,22317,22317,0,12,7902000.0
7902,7902999,20.58163668118272,37.56316561454298,0.08978329267131935,1315.710016965866,513.4386553764343,1204.6597862243652,30301,7982,22319,22319,0,12,7903000.0
7903,7903999,20.581863164596662,37.562965070761834,0.08977365334234877,1315.8294794559479,513.4995031356812,1204.9216995239258,30301,7982,22319,22319,0,12,7904000.0
7904,7904999,20.582511771764658,37.56379900570605,0.0897584816115291,1316.017606973648,513.5602960586548,1205.1075897216797,30303,7983,22320,22320,0,12,7905000.0
7905,7905999,20.583624565198207,37.56527938151939,0.08975662705333465,1316.2916295528412,513.6313457489014,1205.253818511963,30307,7985,22322,22322,0,12,7906000.0
7906,7906999,20.584634992903204,37.56923279550196,0.08975297032621066,1316.4067101478577,513.6927492618561,1205.459789276123,30307,7985,22322,22322,0,12,7907000.0
7907,7907999,20.58582424537465,37.57294956645317,0.08975972617088623,1316.6128532886505,513.7553524971008,1205.5188331604004,30309,7986,22323,22323,0,12,7908000.0
7908,7908999,20.586698568307455,37.57404001364717,0.08976302283579474,1316.8863544464111,513.8231089115143,1205.5822296142578,30322,7988,22334,22334,0,12,7909000.0
7909,7909999,20.587885285273405,37.57610990222414,0.08977657283284146,1317.1594161987305,513.8876965045929,1205.6728858947754,30326,7990,22336,22336,0,12,7910000.0
7910,7910999,20.5890172449736,37.57775214208426,0.08978446974558707,1317.4886989593506,513.9500739574432,1205.7968711853027,30351,7993,22358,22358,0,12,7911000.0
7911,7911999,20.590965680861405,37.590760491725284,0.08976738018092756,1317.6137235164642,514.0151922702789,1206.0083198547363,30351,7993,22358,22358,0,12,7912000.0
7912,7912999,20.592779428598163,37.59389247348071,0.08977184944204397,1318.088666677475,514.0785932540894,1205.879566192627,30382,7998,22384,22384,0,12,7913000.0
7913,7913999,20.595024042939855,37.59792012096831,0.08979196358929997,1318.1999411582947,514.1388871669769,1206.0669898986816,30382,7998,22384,22384,0,12,7914000.0
7914,7914999,20.596745726115856,37.6006443840311,0.08980706652931092,1318.3251557350159,514.200352191925,1206.2901458740234,30382,7998,22384,22384,0,12,7915000.0
7915,7915999,20.596868634012782,37.60056552898901,0.08980118403096748,1318.4438118934631,514.2615096569061,1207.7705078125,30398,7998,22400,22400,0,12,7916000.0
7916,7916999,20.596506388718524,37.59993052931848,0.08979487650233353,1318.624310016632,514.322347164154,1208.2566413879395,30401,7999,22402,22402,0,12,7917000.0
7917,7917999,20.596237554543617,37.599263064846895,0.08978601326656266,1318.8771123886108,514.3847467899323,1208.5135383605957,30408,8001,22407,22407,0,12,7918000.0
7918,7918999,20.596480214974875,37.599731363294545,0.08977279733773302,1318.990117073059,514.448539018631,1208.907371520996,30408,8001,22407,22407,0,12,7919000.0
7919,7919999,20.596674268432622,37.599742006908194,0.08976498479075423,1319.1683795452118,514.5090909004211,1209.1840438842773,30410,8002,22408,22408,0,12,7920000.0
7920,7920999,20.59692535335852,37.59965919295294,0.08976205902782808,1319.416151046753,514.5701730251312,1209.392219543457,30414,8004,22410,22410,0,12,7921000.0
7921,7921999,20.59736995011437,37.59967182451058,0.08976070991017682,1319.5321731567383,514.6305003166199,1209.688735961914,30415,8004,22411,22411,0,12,7922000.0
7922,7922999,20.598222632830783,37.60078075662451,0.08976353459172082,1319.6462769508362,514.6917767524719,1209.9263763427734,30415,8004,22411,22411,0,12,7923000.0
7923,7923999,20.599223751261302,37.60214438466088,0.08975566679752678,1319.7620074748993,514.752364397049,1210.1584854125977,30415,8004,22411,22411,0,12,7924000.0
7924,7924999,20.59999636370586,37.60289442768729,0.08976676289155028,1319.8886814117432,514.8132131099701,1210.3620948791504,30415,8004,22411,22411,0,12,7925000.0
7925,7925999,20.600950439339687,37.603872277077755,0.08977623613580665,1320.0181996822357,514.8757727146149,1210.502872467041,30415,8004,22411,22411,0,12,7926000.0
7926,7926999,20.602192568541405,37.607710045820575,0.08977263409741054,1320.293559551239,514.9381053447723,1210.4945526123047,30419,8006,22413,22413,0,12,7927000.0
7927,7927999,20.60333859260838,37.60883903365021,0.08978927672925774,1320.4289956092834,515.0024194717407,1210.7059364318848,30419,8006,22413,22413,0,12,7928000.0
7928,7928999,20.604601202323508,37.610280755293005,0.08980046061394098,1320.6174046993256,515.0650825500488,1210.801555633545,30421,8007,22414,22414,0,12,7929000.0
7929,7929999,20.605828395526956,37.61284794252192,0.08980161854377833,1320.8718037605286,515.1274979114532,1210.8665580749512,30430,8009,22421,22421,0,12,7930000.0
7930,7930999,20.606961278710923,37.61392384172916,0.08981184988231339,1321.0261900424957,515.2011480331421,1211.037441253662,30430,8009,22421,22421,0,12,7931000.0
7931,7931999,20.60834068599212,37.616742649318276,0.08981314055790379,1321.1597728729248,515.2623805999756,1211.1922416687012,30430,8009,22421,22421,0,12,7932000.0
7932,7932999,20.609234949026437,37.61688268458466,0.08982121352808636,1321.3381061553955,515.3228676319122,1211.2850646972656,30442,8010,22432,22432,0,12,7933000.0
7933,7933999,20.609818241133972,37.6179086375504,0.08979136945092903,1321.462870836258,515.3848385810852,1212.439281463623,30456,8010,22446,22446,0,12,7934000.0
7934,7934999,20.609571413078534,37.61729999348539,0.08978353473999212,1321.5733850002289,515.4471728801727,1213.2343101501465,30462,8010,22452,22452,0,12,7935000.0
7935,7935999,20.609234715729613,37.61671921439412,0.08977751380002041,1321.6899321079254,515.5089678764343,1213.6436653137207,30462,8010,22452,22452,0,12,7936000.0
7936,7936999,20.609305880224042,37.61650827815305,0.08976825271048872,1321.874886751175,515.5697557926178,1213.924575805664,30464,8011,22453,22453,0,12,7937000.0
7937,7937999,20.609187143973184,37.61589913976433,0.0897626380618407,1322.1327681541443,515.6340990066528,1214.157814025879,30468,8013,22455,22455,0,12,7938000.0
7938,7938999,20.60922382468058,37.615696887085655,0.08975682295737142,1322.251326084137,515.6993999481201,1214.4558410644531,30468,8013,22455,22455,0,12,7939000.0
7939,7939999,20.60909427388793,37.614877362615765,0.08975222371293645,1322.3644559383392,515.763512134552,1214.6777305603027,30468,8013,22455,22455,0,12,7940000.0
7940,7940999,20.609045490893482,37.61413887263949,0.08975159946804245,1322.575773715973,515.8329420089722,1214.9112434387207,30471,8014,22457,22457,0,12,7941000.0
7941,7941999,20.60927927115846,37.616818896903816,0.08973590522819785,1322.7208561897278,515.9065370559692,1215.1367988586426,30471,8014,22457,22457,0,12,7942000.0
7942,7942999,20.609659404041192,37.61672787796608,0.08973321447115656,1322.83549118042,515.9685354232788,1215.327262878418,30471,8014,22457,22457,0,12,7943000.0
7943,7943999,20.61025640012265,37.61868452504914,0.08972243558163884,1322.9786567687988,516.0418508052826,1215.490379333496,30471,8014,22457,22457,0,12,7944000.0
7944,7944999,20.611113884912868,37.62134885273988,0.08971109229791552,1323.184017419815,516.1035916805267,1215.6066780090332,30473,8015,22458,22458,0,12,7945000.0
7945,7945999,20.612391048711512,37.62309237869045,0.08971155628846317,1323.3026812076569,516.165256023407,1215.788173675537,30473,8015,22458,22458,0,12,7946000.0
7946,7946999,20.61353436601365,37.62457397639803,0.08971858662496479,1323.437091588974,516.2277748584747,1215.9321632385254,30473,8015,22458,22458,0,12,7947000.0
7947,7947999,20.61514590351996,37.62660651377969,0.08972751855473271,1323.7695207595825,516.2900078296661,1215.8506393432617,30486,8018,22468,22468,0,12,7948000.0
7948,7948999,20.61662012688452,37.62805252799998,0.0897407970207641,1324.0338113307953,516.3524196147919,1215.9031448364258,30490,8020,22470,22470,0,12,7949000.0
7949,7949999,20.61826220620887,37.63141236410997,0.08974415728917584,1324.2881157398224,516.4157345294952,1216.0306205749512,30507,8022,22485,22485,0,12,7950000.0
7950,7950999,20.61926420364093,37.6319863963194,0.08975175207653174,1324.409303188324,516.4778904914856,1216.1876983642578,30507,8022,22485,22485,0,12,7951000.0
7951,7951999,20.61948296563337,37.63123700850418,0.08974954647185329,1324.6683838367462,516.5401957035065,1216.5362014770508,30520,8024,22496,22496,0,12,7952000.0
7952,7952999,20.619509509721524,37.630994099582885,0.08973594751982228,1324.7830402851105,516.6029706001282,1217.8534126281738,30529,8024,22505,22505,0,12,7953000.0
7953,7953999,20.61948961183968,37.631198775003874,0.08973570297352795,1324.9569272994995,516.6632690429688,1218.302822113037,30532,8025,22507,22507,0,12,7954000.0
7954,7954999,20.619653637357597,37.631175324218745,0.08972605782424448,1325.0634591579437,516.7255265712738,1218.818244934082,30532,8025,22507,22507,0,12,7955000.0
7955,7955999,20.620019694190077,37.63177035936266,0.0897184222129016,1325.1708295345306,516.7874567508698,1219.1852912902832,30532,8025,22507,22507,0,12,7956000.0
7956,7956999,20.62054882087393,37.63292206024134,0.08972314574049534,1325.2880148887634,516.8487951755524,1219.4287872314453,30532,8025,22507,22507,0,12,7957000.0
7957,7957999,20.62141258346946,37.634399337151294,0.0897231869529892,1325.4725794792175,516.910295009613,1219.6828231811523,30534,8026,22508,22508,0,12,7958000.0
7958,7958999,20.62201775880751,37.635094406733295,0.08972881734734006,1325.7598905563354,516.9782440662384,1219.9043045043945,30540,8028,22512,22512,0,12,7959000.0
7959,7959999,20.62239669257113,37.63518162770904,0.08973035916529715,1325.8795719146729,517.0421259403229,1220.1871757507324,30540,8028,22512,22512,0,12,7960000.0
7960,7960999,20.62314090099175,37.63637383440538,0.08974162309374978,1326.198825597763,517.1026575565338,1220.2640914916992,30546,8031,22515,22515,0,12,7961000.0
7961,7961999,20.623758066992128,37.63858248223624,0.0897329124849664,1326.3267557621002,517.173618555069,1220.510181427002,30546,8031,22515,22515,0,12,7962000.0
7962,7962999,20.62446466901314,37.64019729130865,0.0897268534007798,1326.4810738563538,517.2441775798798,1220.725513458252,30546,8031,22515,22515,0,12,7963000.0
7963,7963999,20.624826957628088,37.64079255263428,0.08972612570816496,1326.6031188964844,517.3058512210846,1220.931568145752,30546,8031,22515,22515,0,12,7964000.0
7964,7964999,20.62589963351144,37.64465957665701,0.08972602211944425,1326.7353332042694,517.3702864646912,1221.2006378173828,30546,8031,22515,22515,0,12,7965000.0
7965,7965999,20.626622166592977,37.64570552871625,0.08971914258189995,1326.922850370407,517.4323039054871,1221.33296585083,30548,8032,22516,22516,0,12,7966000.0
7966,7966999,20.627635813076928,37.6468930652676,0.08971294734010116,1327.0428261756897,517.4948909282684,1221.494785308838,30548,8032,22516,22516,0,12,7967000.0
7967,7967999,20.628809177175217,37.649775101224364,0.08970311526193264,1327.3132338523865,517.5571594238281,1221.6122093200684,30552,8034,22518,22518,0,12,7968000.0
7968,7968999,20.62968179404763,37.65085321238385,0.08969206100985927,1327.5141627788544,517.6195600032806,1221.7160034179688,30554,8035,22519,22519,0,12,7969000.0
7969,7969999,20.62980379467591,37.65152199740803,0.08967609412822353,1327.649320602417,517.689995765686,1222.9645309448242,30560,8035,22525,22525,0,12,7970000.0
7970,7970999,20.629627478941863,37.65106056658858,0.08966703214931893,1327.839148759842,517.7568640708923,1223.549545288086,30566,8036,22530,22530,0,12,7971000.0
7971,7971999,20.629302440348564,37.65069880971779,0.08965798759181387,1327.9458236694336,517.8178341388702,1223.9596099853516,30566,8036,22530,22530,0,12,7972000.0
7972,7972999,20.628937719608217,37.64946226578259,0.08965390410476548,1328.1439189910889,517.8851008415222,1224.317455291748,30568,8037,22531,22531,0,12,7973000.0
7973,7973999,20.628541287931103,37.64830334249785,0.08964926629810033,1328.4018912315369,517.9473233222961,1224.5262603759766,30572,8039,22533,22533,0,12,7974000.0
7974,7974999,20.628217847197007,37.64739160782904,0.08964679916051277,1328.5064535140991,518.0072989463806,1224.786964416504,30572,8039,22533,22533,0,12,7975000.0
7975,7975999,20.62790689590823,37.64651020562204,0.08964206044241574,1328.7013161182404,518.0710699558258,1224.933048248291,30574,8040,22534,22534,0,12,7976000.0
7976,7976999,20.627576190946183,37.64541957082975,0.08963963258069862,1328.9754810333252,518.1348631381989,1225.0431022644043,30580,8042,22538,22538,0,12,7977000.0
7977,7977999,20.627364589101276,37.64653223310548,0.08962579579592311,1329.1584103107452,518.1987900733948,1225.2358283996582,30582,8043,22539,22539,0,12,7978000.0
7978,7978999,20.626988852252648,37.645573832429484,0.08962231707441237,1329.3496742248535,518.2595274448395,1225.4599533081055,30586,8044,22542,22542,0,12,7979000.0
7979,7979999,20.626541208547998,37.64424078281945,0.08961944645984166,1329.6055450439453,518.3225338459015,1225.6741256713867,30590,8046,22544,22544,0,12,7980000.0
7980,7980999,20.626482091342094,37.64386564904153,0.08961121497584201,1329.7241649627686,518.3848607540131,1225.8577728271484,30590,8046,22544,22544,0,12,7981000.0
7981,7981999,20.62639668840199,37.64483741259444,0.08959895473517354,1330.0025475025177,518.452939748764,1225.9182090759277,30594,8048,22546,22546,0,12,7982000.0
7982,7982999,20.62611795453696,37.64363081158898,0.08959604074054739,1330.133490562439,518.514760017395,1226.1220207214355,30594,8048,22546,22546,0,12,7983000.0
7983,7983999,20.62607470616884,37.64304099618467,0.08959153882118509,1330.325407743454,518.5755000114441,1226.2524948120117,30596,8049,22547,22547,0,12,7984000.0
7984,7984999,20.625890995982505,37.64210068987577,0.08958850552211561,1330.4687271118164,518.6454658508301,1226.4043884277344,30596,8049,22547,22547,0,12,7985000.0
7985,7985999,20.62570402000132,37.641050186782955,0.0895846845760847,1330.7345764636993,518.7076644897461,1226.4968643188477,30610,8051,22559,22559,0,12,7986000.0
7986,7986999,20.62536681290043,37.639657375904754,0.089583136861064,1330.8598854541779,518.7685115337372,1226.673599243164,30610,8051,22559,22559,0,12,7987000.0
7987,7987999,20.62520190403338,37.63859486121134,0.08958213528545,1331.0092396736145,518.8379492759705,1226.809944152832,30610,8051,22559,22559,0,12,7988000.0
7988,7988999,20.624780969048487,37.637260347935936,0.08958332643630407,1331.127118587494,518.8984575271606,1226.957691192627,30610,8051,22559,22559,0,12,7989000.0
7989,7989999,20.624422898583312,37.63590153250794,0.08957633514850227,1331.253722667694,518.9618480205536,1228.1675148010254,30617,8051,22566,22566,0,12,7990000.0
7990,7990999,20.62417379603935,37.63489928649754,0.08956117887256576,1331.3657383918762,519.0267343521118,1228.7059059143066,30619,8051,22568,22568,0,12,7991000.0
7991,7991999,20.623693441429673,37.63353020276432,0.08955554223148765,1331.54425406456,519.0882058143616,1228.9867973327637,30624,8052,22572,22572,0,12,7992000.0
7992,7992999,20.623622980459842,37.63262316848405,0.08954351456456422,1331.7993786334991,519.1507539749146,1229.1914100646973,30628,8054,22574,22574,0,12,7993000.0
7993,7993999,20.623396166655247,37.631837833685395,0.08953544083652198,1331.9808881282806,519.2112152576447,1229.459529876709,30630,8055,22575,22575,0,12,7994000.0
7994,7994999,20.623336730522748,37.63109122044093,0.08953153285662685,1332.1919782161713,519.2747983932495,1229.6295928955078,30632,8056,22576,22576,0,12,7995000.0
7995,7995999,20.623416419447498,37.6305706632319,0.0895267468445714,1332.3076491355896,519.3398461341858,1229.8388862609863,30632,8056,22576,22576,0,12,7996000.0
7996,7996999,20.62337713219471,37.62977446192975,0.08951992783409812,1332.5255756378174,519.4107413291931,1230.036392211914,30635,8057,22578,22578,0,12,7997000.0
7997,7997999,20.62380181220604,37.629927285175114,0.08949934077225796,1332.638091802597,519.4714539051056,1230.232292175293,30635,8057,22578,22578,0,12,7998000.0
7998,7998999,20.624012367108474,37.62952452502832,0.08948441922637751,1332.9695265293121,519.5338287353516,1230.2073135375977,30643,8060,22583,22583,0,12,7999000.0
7999,7999999,20.6242185431997,37.6289263143548,0.08947503838437043,1333.1608047485352,519.5980644226074,1230.3622207641602,30645,8061,22584,22584,0,12,8000000.0
8000,8000999,20.62453482245306,37.62862624713463,0.08946326294504969,1333.4337530136108,519.6627717018127,1230.3997192382812,30649,8063,22586,22586,0,12,8001000.0
8001,8001999,20.624742206649042,37.6283905300145,0.0894534482216437,1333.6999187469482,519.7245888710022,1230.4210929870605,30661,8065,22596,22596,0,12,8002000.0
8002,8002999,20.625049921716304,37.62819466881298,0.08944435530437622,1333.8250408172607,519.7859411239624,1230.619270324707,30661,8065,22596,22596,0,12,8003000.0
8003,8003999,20.625076646143746,37.62746873386866,0.08943223226715225,1334.0369036197662,519.8476722240448,1230.7184219360352,30663,8066,22597,22597,0,12,8004000.0
8004,8004999,20.625350881030485,37.62696664123121,0.08942200785092802,1334.1708416938782,519.9108455181122,1230.8550033569336,30663,8066,22597,22597,0,12,8005000.0
8005,8005999,20.625647669076045,37.62646405585823,0.08941171856540053,1334.2832961082458,519.9723162651062,1231.0041122436523,30663,8066,22597,22597,0,12,8006000.0
8006,8006999,20.625722306724086,37.62566924382302,0.0894039698800686,1334.556791305542,520.034262418747,1230.9594345092773,30669,8068,22601,22601,0,12,8007000.0
8007,8007999,20.625859199262965,37.6248604663496,0.08939553357075603,1334.6827974319458,520.0967516899109,1231.097370147705,30669,8068,22601,22601,0,12,8008000.0
8008,8008999,20.625761916076584,37.623826659193355,0.08938766980150414,1334.802635192871,520.1584270000458,1231.218132019043,30669,8068,22601,22601,0,12,8009000.0
8009,8009999,20.62536180581079,37.62250211639391,0.08938319168612663,1334.9201076030731,520.2211661338806,1232.3176155090332,30676,8068,22608,22608,0,12,8010000.0
8010,8010999,20.624758000019597,37.62126387338976,0.08938242764924675,1335.1215398311615,520.2903611660004,1232.8399353027344,30683,8069,22614,22614,0,12,8011000.0
8011,8011999,20.62420183301508,37.62017649924965,0.08938320999903504,1335.306310415268,520.3517270088196,1233.1589584350586,30690,8070,22620,22620,0,12,8012000.0
8012,8012999,20.623553820665965,37.6187511863271,0.08938573227339608,1335.56813955307,520.4143459796906,1233.3741416931152,30694,8072,22622,22622,0,12,8013000.0
8013,8013999,20.622800460994004,37.617428922371374,0.08938881755317885,1335.7567234039307,520.4768471717834,1233.5968780517578,30696,8073,22623,22623,0,12,8014000.0
8014,8014999,20.622060787475718,37.61601236430947,0.08939106407391229,1336.0290219783783,520.5466492176056,1233.731113433838,30700,8075,22625,22625,0,12,8015000.0
8015,8015999,20.621435902851267,37.614864927098346,0.08939144496628493,1336.2252609729767,520.6083874702454,1233.9517364501953,30703,8076,22627,22627,0,12,8016000.0
8016,8016999,20.621044395084205,37.61413336455609,0.08938944984161723,1336.3466579914093,520.6716449260712,1234.170394897461,30703,8076,22627,22627,0,12,8017000.0
8017,8017999,20.620576439304816,37.61308181605554,0.08938970758376952,1336.6148734092712,520.7364926338196,1234.182518005371,30707,8078,22629,22629,0,12,8018000.0
8018,8018999,20.620136954853066,37.61216605046917,0.08938729900610565,1336.8228087425232,520.8086218833923,1234.2837715148926,30709,8079,22630,22630,0,12,8019000.0
8019,8019999,20.619679726018028,37.611117228155926,0.08938648361877954,1337.0182983875275,520.8715283870697,1234.4597854614258,30711,8080,22631,22631,0,12,8020000.0
8020,8020999,20.619519905608,37.61223199669574,0.08937509162959856,1337.1504497528076,520.9330351352692,1234.669765472412,30711,8080,22631,22631,0,12,8021000.0
8021,8021999,20.618936064816165,37.61079349304816,0.08937741578072833,1337.280740737915,520.9941384792328,1234.8185653686523,30711,8080,22631,22631,0,12,8022000.0
8022,8022999,20.6187930997555,37.61244099355138,0.0893689628744263,1337.4098365306854,521.0548574924469,1234.9858016967773,30711,8080,22631,22631,0,12,8023000.0
8023,8023999,20.618488198849068,37.61170678733505,0.08936714155220904,1337.6054818630219,521.1171190738678,1235.0681610107422,30713,8081,22632,22632,0,12,8024000.0
8024,8024999,20.617998421666456,37.61025609110656,0.0893727541525825,1337.7652127742767,521.1878170967102,1235.257308959961,30713,8081,22632,22632,0,12,8025000.0
8025,8025999,20.617341601112912,37.60976748066723,0.089371035713398,1337.9574282169342,521.2498407363892,1236.3575248718262,30724,8082,22642,22642,0,12,8026000.0
8026,8026999,20.61662299242674,37.609010398739116,0.08937174611627052,1338.0717978477478,521.3110766410828,1236.892734527588,30724,8082,22642,22642,0,12,8027000.0
8027,8027999,20.615876552639186,37.608046269979084,0.08937159594901789,1338.2644336223602,521.3817071914673,1237.2419929504395,30732,8083,22649,22649,0,12,8028000.0
8028,8028999,20.615106206474053,37.606771102853095,0.08937513548293574,1338.5760107040405,521.4439222812653,1237.367259979248,30738,8086,22652,22652,0,12,8029000.0
8029,8029999,20.61449183795657,37.60585234428857,0.08937384278134475,1338.6924619674683,521.5062186717987,1237.684658050537,30738,8086,22652,22652,0,12,8030000.0
8030,8030999,20.61373977163206,37.604497803848204,0.08937440733625257,1338.8230564594269,521.5699763298035,1237.9631118774414,30739,8086,22653,22653,0,12,8031000.0
8031,8031999,20.613302661872204,37.60442065529841,0.0893654495366838,1339.0736272335052,521.6312975883484,1237.9987487792969,30743,8088,22655,22655,0,12,8032000.0
8032,8032999,20.61312351262294,37.604627378832525,0.08935308399170128,1339.1888711452484,521.6929051876068,1238.2194709777832,30743,8088,22655,22655,0,12,8033000.0
8033,8033999,20.612987046262244,37.60486760980359,0.08934151360481135,1339.4536435604095,521.7554714679718,1238.2766227722168,30747,8090,22657,22657,0,12,8034000.0
8034,8034999,20.612910977728333,37.60459193920518,0.08933319317679167,1339.6663436889648,521.8225574493408,1238.4345588684082,30749,8091,22658,22658,0,12,8035000.0
8035,8035999,20.61309500028048,37.60512383399138,0.0893191139026458,1340.013657093048,521.8856036663055,1238.3702507019043,30755,8094,22661,22661,0,12,8036000.0
8036,8036999,20.61350122939277,37.60550302809842,0.08930564393340346,1340.2302453517914,521.958663225174,1238.5373840332031,30783,8095,22688,22688,0,12,8037000.0
8037,8037999,20.613979881024203,37.60630508891968,0.0892933476398815,1340.4397525787354,522.027538061142,1238.661190032959,30785,8096,22689,22689,0,12,8038000.0
8038,8038999,20.615211232383363,37.60929801122781,0.08926993350985779,1340.7079541683197,522.0910952091217,1238.6200904846191,30789,8098,22691,22691,0,12,8039000.0
8039,8039999,20.61596632294736,37.61028870359303,0.08925500031083822,1340.9047601222992,522.1536509990692,1238.782470703125,30801,8099,22702,22702,0,12,8040000.0
8040,8040999,20.617136135457223,37.611924372555535,0.08924098544206438,1341.1076498031616,522.2185564041138,1238.8925552368164,30803,8100,22703,22703,0,12,8041000.0
8041,8041999,20.618011681044674,37.61275822413929,0.08923150345392927,1341.3033590316772,522.2804021835327,1238.9409713745117,30805,8101,22704,22704,0,12,8042000.0
8042,8042999,20.618688481619564,37.61317448525939,0.08922947294739458,1341.428245306015,522.3426151275635,1239.1223030090332,30805,8101,22704,22704,0,12,8043000.0
8043,8043999,20.618796832463495,37.61305831039836,0.08922289863416044,1341.5502965450287,522.4044041633606,1240.0355644226074,30817,8101,22716,22716,0,12,8044000.0
8044,8044999,20.6187062463279,37.61507518484625,0.08920373706419149,1341.665769815445,522.4659805297852,1240.5925750732422,30818,8101,22717,22717,0,12,8045000.0
8045,8045999,20.61821853410468,37.6154116316356,0.08919282031525566,1341.9143302440643,522.527539730072,1240.854362487793,30822,8103,22719,22719,0,12,8046000.0
8046,8046999,20.618029749347635,37.61645755098696,0.08917897870002212,1342.1028816699982,522.5900032520294,1241.1103744506836,30824,8104,22720,22720,0,12,8047000.0
8047,8047999,20.61757920954974,37.61589577901128,0.08917418187846482,1342.3613240718842,522.6512117385864,1241.2454833984375,30828,8106,22722,22722,0,12,8048000.0
8048,8048999,20.61726157711238,37.61494661436982,0.0891693068695113,1342.7577788829803,522.7149484157562,1241.3105926513672,30836,8110,22726,22726,0,12,8049000.0
8049,8049999,20.616972630516532,37.61426846266264,0.0891587014491586,1342.9515874385834,522.7774958610535,1241.4772758483887,30838,8111,22727,22727,0,12,8050000.0
8050,8050999,20.616678106170834,37.61347535595643,0.08915833481351931,1343.2145047187805,522.8416621685028,1241.659023284912,30843,8113,22730,22730,0,12,8051000.0
8051,8051999,20.616486754364683,37.6130174598865,0.08914930548492117,1343.4115092754364,522.9054827690125,1241.8448867797852,30845,8114,22731,22731,0,12,8052000.0
8052,8052999,20.616268892649064,37.612619933852095,0.08914527958609242,1343.6409139633179,522.9761486053467,1242.057472229004,30873,8115,22758,22758,0,12,8053000.0
8053,8053999,20.616107673729587,37.612117255429865,0.08914312347394593,1343.7570519447327,523.0378925800323,1242.2916145324707,30873,8115,22758,22758,0,12,8054000.0
8054,8054999,20.61620048971072,37.612445845899984,0.08913501749259423,1343.9519951343536,523.1019375324249,1242.3582305908203,30875,8116,22759,22759,0,12,8055000.0
8055,8055999,20.616567152889218,37.61300287901651,0.08912286286338678,1344.1465857028961,523.1637074947357,1242.508071899414,30877,8117,22760,22760,0,12,8056000.0
8056,8056999,20.616744243635235,37.612851354569614,0.08911957469798226,1344.2725985050201,523.2252945899963,1242.726791381836,30877,8117,22760,22760,0,12,8057000.0
8057,8057999,20.61713365004398,37.61312583919054,0.08911417956508516,1344.5376570224762,523.2894895076752,1242.782356262207,30881,8119,22762,22762,0,12,8058000.0
8058,8058999,20.617762788855167,37.61466984979709,0.08911085319502254,1344.8118343353271,523.352979183197,1242.8197174072266,30885,8121,22764,22764,0,12,8059000.0
8059,8059999,20.618716724984033,37.61779048425311,0.08909381828093355,1345.078085899353,523.414740562439,1242.900592803955,30889,8123,22766,22766,0,12,8060000.0
8060,8060999,20.619274868705862,37.61819965589242,0.0890922719682703,1345.2641327381134,523.4749155044556,1242.981544494629,30891,8124,22767,22767,0,12,8061000.0
8061,8061999,20.619786910594676,37.61835487670964,0.08909276784114117,1345.5309901237488,523.5378332138062,1243.0308647155762,30895,8126,22769,22769,0,12,8062000.0
8062,8062999,20.619909245383194,37.617799442668286,0.08908875999777333,1345.6575405597687,523.6002173423767,1243.230525970459,30895,8126,22769,22769,0,12,8063000.0
8063,8063999,20.620163702450377,37.61817815233855,0.08906895219621147,1345.8489258289337,523.6631507873535,1244.379306793213,30909,8127,22782,22782,0,12,8064000.0
8064,8064999,20.620430961841883,37.61888058400593,0.08905307632181803,1346.0383620262146,523.7255136966705,1244.8290786743164,30913,8128,22785,22785,0,12,8065000.0
8065,8065999,20.62049434049749,37.61864559254761,0.0890468442897353,1346.3105745315552,523.790938615799,1245.168342590332,30917,8130,22787,22787,0,12,8066000.0
8066,8066999,20.62066857327799,37.61812652303617,0.08904150887226514,1346.6545059680939,523.8612861633301,1245.2242431640625,30923,8133,22790,22790,0,12,8067000.0
8067,8067999,20.621109525458312,37.61832552306108,0.08904871893907018,1346.8336653709412,523.9245834350586,1245.5010032653809,30925,8134,22791,22791,0,12,8068000.0
8068,8068999,20.621856942975544,37.619880840108664,0.08905184905154573,1347.037736415863,523.9873743057251,1245.7241706848145,30927,8135,22792,22792,0,12,8069000.0
8069,8069999,20.62300508736465,37.62218135857739,0.08907158615456101,1347.305058479309,524.0509667396545,1245.9122161865234,30955,8137,22818,22818,0,12,8070000.0
8070,8070999,20.624150654207188,37.624266672397056,0.08910548874894553,1347.4350953102112,524.1129260063171,1246.1515007019043,30955,8137,22818,22818,0,12,8071000.0
8071,8071999,20.625801930376298,37.62805559439502,0.08914668632131229,1347.6506893634796,524.187025308609,1246.3009338378906,30957,8138,22819,22819,0,12,8072000.0
8072,8072999,20.627882389827896,37.63219487222601,0.08919762643923235,1347.8433799743652,524.2519941329956,1246.4930953979492,30959,8139,22820,22820,0,12,8073000.0
8073,8073999,20.6300829426858,37.63647121333337,0.0892425101949228,1348.1088907718658,524.3155627250671,1246.5660018920898,30963,8141,22822,22822,0,12,8074000.0
8074,8074999,20.63200693589139,37.64052828528714,0.08927025278026923,1348.3073670864105,524.3802270889282,1246.6479682922363,30965,8142,22823,22823,0,12,8075000.0
8075,8075999,20.634221473238654,37.64586597525811,0.0893040112746023,1348.5030717849731,524.4427361488342,1246.7574882507324,30967,8143,22824,22824,0,12,8076000.0
8076,8076999,20.63679038334594,37.65255129848779,0.08933621738495334,1348.7742211818695,524.507238149643,1246.8179206848145,30971,8145,22826,22826,0,12,8077000.0
8077,8077999,20.639508696311662,37.658192899818296,0.08937788834578464,1348.9937241077423,524.5773856639862,1246.9784202575684,30973,8146,22827,22827,0,12,8078000.0
8078,8078999,20.642533400981165,37.66671658537795,0.08943641060754426,1349.1958327293396,524.6401672363281,1247.0751991271973,30975,8147,22828,22828,0,12,8079000.0
8079,8079999,20.64578379358983,37.673803593271856,0.0894921597436964,1349.4563612937927,524.7039921283722,1247.1242294311523,30979,8149,22830,22830,0,12,8080000.0
8080,8080999,20.647053829652762,37.67504558362286,0.08949908859630562,1349.6534867286682,524.766909122467,1247.7501983642578,30991,8150,22841,22841,0,12,8081000.0
8081,8081999,20.648114767347128,37.678265228483426,0.08946956397363381,1349.7766003608704,524.8322184085846,1248.475902557373,30994,8150,22844,22844,0,12,8082000.0
8082,8082999,20.649094185697706,37.68054935751039,0.08943766143097986,1349.96861743927,524.8941159248352,1248.7606735229492,31004,8151,22853,22853,0,12,8083000.0
8083,8083999,20.650251884054526,37.683180700743115,0.08940461778417552,1350.1490116119385,524.9574744701385,1249.1012802124023,31011,8152,22859,22859,0,12,8084000.0
8084,8084999,20.65111702903155,37.68453400432009,0.08939735420806583,1350.4074926376343,525.0195174217224,1249.2618446350098,31015,8154,22861,22861,0,12,8085000.0
8085,8085999,20.652021461221214,37.68655712269124,0.08937982118735333,1350.732096672058,525.0821449756622,1249.335605621338,31023,8157,22866,22866,0,12,8086000.0
8086,8086999,20.652878107942662,37.687498406798944,0.08936843601517863,1351.0638406276703,525.1475887298584,1249.4597129821777,31029,8160,22869,22869,0,12,8087000.0
8087,8087999,20.65365648384833,37.68820900419796,0.08935776275065954,1351.2634043693542,525.2097551822662,1249.737133026123,31033,8161,22872,22872,0,12,8088000.0
8088,8088999,20.654739961495174,37.689330095737894,0.08935197291600949,1351.388850927353,525.2714602947235,1250.014144897461,31033,8161,22872,22872,0,12,8089000.0
8089,8089999,20.655980841536437,37.69101132228214,0.08935464149087136,1351.584182024002,525.3329427242279,1250.1043243408203,31035,8162,22873,22873,0,12,8090000.0
8090,8090999,20.657255456137786,37.692790514240436,0.08935698517239543,1351.779818058014,525.3951997756958,1250.2816886901855,31042,8163,22879,22879,0,12,8091000.0
8091,8091999,20.658930701306208,37.697486980023804,0.08934905866318799,1351.908699274063,525.4563872814178,1250.4908409118652,31042,8163,22879,22879,0,12,8092000.0
8092,8092999,20.659961182688985,37.698463021240066,0.08934883343209477,1352.2553551197052,525.521253824234,1250.5086059570312,31048,8166,22882,22882,0,12,8093000.0
8093,8093999,20.66134185119001,37.700959415518874,0.08936027091140686,1352.3834671974182,525.5835378170013,1250.6902198791504,31048,8166,22882,22882,0,12,8094000.0
8094,8094999,20.663151141686587,37.70426897334795,0.08936961322294346,1352.656025648117,525.6487500667572,1250.7664680480957,31078,8168,22910,22910,0,12,8095000.0
8095,8095999,20.664996203561113,37.708465211424794,0.08936675867924637,1352.7806029319763,525.7107393741608,1250.9079246520996,31078,8168,22910,22910,0,12,8096000.0
8096,8096999,20.666983522990133,37.712166048214655,0.08937276694130347,1353.057645559311,525.7729179859161,1250.958164215088,31082,8170,22912,22912,0,12,8097000.0
8097,8097999,20.668561537892238,37.714701060856015,0.08938417224013573,1353.178858757019,525.8373363018036,1251.0789794921875,31082,8170,22912,22912,0,12,8098000.0
8098,8098999,20.670290998309884,37.71732719144193,0.08940277854367229,1353.5761630535126,525.9016053676605,1250.9395790100098,31095,8174,22921,22921,0,12,8099000.0
8099,8099999,20.671951896562174,37.719875998769474,0.08932665556783237,1353.7777116298676,525.9641635417938,1251.802833557129,31104,8175,22929,22929,0,12,8100000.0
8100,8100999,20.67260622493685,37.72035742454127,0.0892482846453857,1353.8951115608215,526.0253956317902,1252.341739654541,31105,8175,22930,22930,0,12,8101000.0
8101,8101999,20.673505196294375,37.721223800899246,0.08918020856886888,1354.020293712616,526.0877780914307,1252.6882095336914,31105,8175,22930,22930,0,12,8102000.0
8102,8102999,20.67489301717827,37.72326317417578,0.089058194610379,1354.2678656578064,526.1490433216095,1252.9096794128418,31119,8177,22942,22942,0,12,8103000.0
8103,8103999,20.67557644168333,37.72333273047116,0.08901063495877037,1354.6055483818054,526.2125103473663,1253.0457649230957,31125,8180,22945,22945,0,12,8104000.0
8104,8104999,20.676324386775338,37.72389763901529,0.08894780327291762,1354.731190443039,526.2759592533112,1253.2934875488281,31125,8180,22945,22945,0,12,8105000.0
8105,8105999,20.676648159016583,37.72402038526988,0.0889118079004384,1354.9857485294342,526.3380835056305,1253.3953247070312,31129,8182,22947,22947,0,12,8106000.0
8106,8106999,20.677240560208833,37.723800715667366,0.0888670147484425,1355.32431101799,526.4016842842102,1253.5005073547363,31137,8185,22952,22952,0,12,8107000.0
8107,8107999,20.67806991510881,37.72431641584701,0.08882016022585082,1355.5151860713959,526.4637260437012,1253.7002449035645,31139,8186,22953,22953,0,12,8108000.0
8108,8108999,20.6783858949659,37.72372552329038,0.0887960747252905,1355.7081780433655,526.5251829624176,1253.8577194213867,31141,8187,22954,22954,0,12,8109000.0
8109,8109999,20.678953191249022,37.72365710809358,0.08876459294138972,1355.8986148834229,526.5882425308228,1254.0892486572266,31143,8188,22955,22955,0,12,8110000.0
8110,8110999,20.679430651397677,37.72343465126192,0.08874555733942235,1356.099167585373,526.650336265564,1254.2014770507812,31145,8189,22956,22956,0,12,8111000.0
8111,8111999,20.67998377694685,37.7233245815785,0.088721959643978,1356.3629176616669,526.7126553058624,1254.2812614440918,31149,8191,22958,22958,0,12,8112000.0
8112,8112999,20.680611516046387,37.723612323007366,0.08869658363707056,1356.4934561252594,526.7749066352844,1254.4711380004883,31149,8191,22958,22958,0,12,8113000.0
8113,8113999,20.680956590430043,37.72321390965348,0.08868373237108407,1356.6164681911469,526.8368711471558,1254.6044692993164,31149,8191,22958,22958,0,12,8114000.0
8114,8114999,20.681535631305135,37.723074248176545,0.0886670903991793,1356.8890171051025,526.9017763137817,1254.5732879638672,31153,8193,22960,22960,0,12,8115000.0
8115,8115999,20.682065861049146,37.72287743454508,0.08865296348253648,1357.1034896373749,526.966292142868,1254.771053314209,31155,8194,22961,22961,0,12,8116000.0
8116,8116999,20.682623820395296,37.72402453812545,0.0886375665426079,1357.2327375411987,527.0291802883148,1254.9369506835938,31155,8194,22961,22961,0,12,8117000.0
8117,8117999,20.682996448156413,37.723492614354306,0.08862325194166742,1357.3718092441559,527.0914697647095,1255.042594909668,31155,8194,22961,22961,0,12,8118000.0
8118,8118999,20.6834296911955,37.72316354016049,0.08860824789169852,1357.5027041435242,527.152624130249,1255.1878547668457,31155,8194,22961,22961,0,12,8119000.0
8119,8119999,20.68445556022795,37.72640788911759,0.08850765527682114,1357.6149952411652,527.2143175601959,1255.815902709961,31161,8194,22967,22967,0,12,8120000.0
8120,8120999,20.685846573831974,37.72914109214794,0.08831795040558821,1357.7939324378967,527.2770941257477,1256.3771743774414,31167,8195,22972,22972,0,12,8121000.0
8121,8121999,20.68724615308304,37.73235256478983,0.08812258616589752,1357.9071810245514,527.3381178379059,1256.7713165283203,31167,8195,22972,22972,0,12,8122000.0
8122,8122999,20.68854066213357,37.73428133919002,0.08797294982392578,1358.0932323932648,527.400696516037,1256.9486618041992,31169,8196,22973,22973,0,12,8123000.0
8123,8123999,20.689121312201138,37.73481723767666,0.08789337512002426,1358.566721200943,527.4634766578674,1256.859706878662,31179,8201,22978,22978,0,12,8124000.0
8124,8124999,20.689948523265375,37.73585655766835,0.08779718876695397,1358.7640798091888,527.5256941318512,1257.0907135009766,31181,8202,22979,22979,0,12,8125000.0
8125,8125999,20.690799303155295,37.73816150178377,0.08771860787357244,1359.0976021289825,527.5883476734161,1257.1877098083496,31187,8205,22982,22982,0,12,8126000.0
8126,8126999,20.69121888666287,37.73831436195673,0.08765486022519386,1359.4341492652893,527.6524341106415,1257.261775970459,31194,8208,22986,22986,0,12,8127000.0
8127,8127999,20.69171723190173,37.73889586614927,0.08759407629485172,1359.631987810135,527.714426279068,1257.425724029541,31196,8209,22987,22987,0,12,8128000.0
8128,8128999,20.692241124459887,37.73935538678854,0.08753522788436252,1359.8457715511322,527.779149055481,1257.5345191955566,31198,8210,22988,22988,0,12,8129000.0
8129,8129999,20.692504400875137,37.739005491249635,0.08749190356715142,1360.0364682674408,527.8428931236267,1257.6770973205566,31200,8211,22989,22989,0,12,8130000.0
8130,8130999,20.693174032445103,37.739817326946635,0.08745480502093428,1360.1685600280762,527.9146077632904,1257.8509521484375,31200,8211,22989,22989,0,12,8131000.0
8131,8131999,20.69385140703078,37.74271962520622,0.087408426051236,1360.2949893474579,527.9764993190765,1257.9813270568848,31200,8211,22989,22989,0,12,8132000.0
8132,8132999,20.694357168443826,37.74274922292794,0.08737466450405729,1360.6361203193665,528.0377206802368,1257.8257522583008,31206,8214,22992,22992,0,12,8133000.0
8133,8133999,20.694759609934053,37.74279426033897,0.08734706890486643,1360.7671513557434,528.0985882282257,1257.9792442321777,31206,8214,22992,22992,0,12,8134000.0
8134,8134999,20.695210686231494,37.74275873972016,0.08731868828684586,1360.8878259658813,528.1593382358551,1258.1258583068848,31206,8214,22992,22992,0,12,8135000.0
8135,8135999,20.69575778635292,37.74293060825738,0.08729424221726656,1361.0914628505707,528.221001625061,1258.167465209961,31208,8215,22993,22993,0,12,8136000.0
8136,8136999,20.696370634066096,37.74296393951847,0.08727700641613467,1361.2234191894531,528.2818684577942,1258.2787971496582,31208,8215,22993,22993,0,12,8137000.0
8137,8137999,20.69681957611347,37.74266564057685,0.08726255835308683,1361.3547897338867,528.3462812900543,1258.3903007507324,31208,8215,22993,22993,0,12,8138000.0
8138,8138999,20.69737551291636,37.74254604071038,0.08724018882608098,1361.4863991737366,528.409369468689,1258.4968376159668,31208,8215,22993,22993,0,12,8139000.0
8139,8139999,20.69754242421005,37.74198646362502,0.08721789521520429,1361.6864495277405,528.4706542491913,1258.5474853515625,31210,8216,22994,22994,0,12,8140000.0
8140,8140999,20.698628622317248,37.74293440704593,0.0871359511437888,1361.819171667099,528.5320298671722,1259.3392486572266,31217,8216,23001,23001,0,12,8141000.0
8141,8141999,20.69946399981374,37.74358305514394,0.08707424115316775,1362.0040955543518,528.5934133529663,1259.7291793823242,31221,8217,23004,23004,0,12,8142000.0
8142,8142999,20.70032673476261,37.74416539156732,0.08701338192297947,1362.260816335678,528.6568031311035,1259.9091987609863,31225,8219,23006,23006,0,12,8143000.0
8143,8143999,20.700716294064883,37.74394121059667,0.08697775636044824,1362.5849766731262,528.7186930179596,1259.9306411743164,31231,8222,23009,23009,0,12,8144000.0
8144,8144999,20.701356588170164,37.744616046695256,0.0869361847951392,1362.8511457443237,528.7809457778931,1260.1375541687012,31235,8224,23011,23011,0,12,8145000.0
8145,8145999,20.701628506247864,37.74442312263693,0.08690916477289357,1363.0388813018799,528.8427846431732,1260.3404388427734,31237,8225,23012,23012,0,12,8146000.0
8146,8146999,20.702025587892727,37.74443274977964,0.08688005720054282,1363.2226588726044,528.9038262367249,1260.5469207763672,31241,8226,23015,23015,0,12,8147000.0
8147,8147999,20.702551253011766,37.744352418586395,0.0868494789026476,1363.4794478416443,528.9662275314331,1260.6145973205566,31245,8228,23017,23017,0,12,8148000.0
8148,8148999,20.70328660114057,37.74482786769044,0.08682955665436898,1363.6751761436462,529.0284757614136,1260.7500343322754,31247,8229,23018,23018,0,12,8149000.0
8149,8149999,20.704094791052825,37.74551445278146,0.08681543674851677,1364.0110096931458,529.0929479598999,1260.660243988037,31253,8232,23021,23021,0,12,8150000.0
8150,8150999,20.70480424825446,37.74634210507106,0.08679641758712486,1364.2012467384338,529.1546049118042,1260.837001800537,31255,8233,23022,23022,0,12,8151000.0
8151,8151999,20.705526678716076,37.74732224184271,0.08678751741326274,1364.6207177639008,529.2181751728058,1260.7591972351074,31263,8237,23026,23026,0,12,8152000.0
8152,8152999,20.706346059147496,37.74914891306372,0.08677351487702545,1364.8124532699585,529.2816331386566,1260.952278137207,31269,8238,23031,23031,0,12,8153000.0
8153,8153999,20.707289188884843,37.75119186381619,0.08676248024498567,1364.9346914291382,529.3430171012878,1261.1514129638672,31269,8238,23031,23031,0,12,8154000.0
8154,8154999,20.708683464649045,37.75324152802716,0.0867569850267984,1365.1428139209747,529.4054217338562,1261.239444732666,31271,8239,23032,23032,0,12,8155000.0
8155,8155999,20.709567372673316,37.753814085479824,0.08675320983925827,1365.4262318611145,529.4734783172607,1261.3063774108887,31275,8241,23034,23034,0,12,8156000.0
8156,8156999,20.710404343236494,37.754460641605654,0.0867368131282481,1365.5468072891235,529.5364499092102,1261.7853202819824,31280,8241,23039,23039,0,12,8157000.0
8157,8157999,20.71126168775793,37.75618287913244,0.08670142544888626,1365.736500263214,529.5985450744629,1262.420093536377,31285,8242,23043,23043,0,12,8158000.0
8158,8158999,20.712309458775877,37.76076262705626,0.08666216498453605,1365.9224240779877,529.6603920459747,1262.7176132202148,31287,8243,23044,23044,0,12,8159000.0
8159,8159999,20.713305095095798,37.76249629188802,0.08663075826276045,1366.0371220111847,529.7225682735443,1263.0047340393066,31288,8243,23045,23045,0,12,8160000.0
8160,8160999,20.714125876657462,37.763308953067025,0.08660561368470288,1366.3038370609283,529.7848353385925,1263.1913108825684,31292,8245,23047,23047,0,12,8161000.0
8161,8161999,20.71454985677907,37.763541868664674,0.0865918623798606,1366.4314317703247,529.8466002941132,1263.4494094848633,31292,8245,23047,23047,0,12,8162000.0
8162,8162999,20.715116623810893,37.76392618791582,0.08657820543212347,1366.6289846897125,529.9101204872131,1263.6185989379883,31295,8246,23049,23049,0,12,8163000.0
8163,8163999,20.715918904190286,37.765044344654825,0.086555478918793,1366.8190331459045,529.972639799118,1263.7504959106445,31297,8247,23050,23050,0,12,8164000.0
8164,8164999,20.716716561861762,37.76569988960917,0.08653808895590454,1367.0942933559418,530.0428853034973,1263.7650756835938,31303,8249,23054,23054,0,12,8165000.0
8165,8165999,20.717360060393634,37.76616671416053,0.0865219297137646,1367.296602010727,530.1046674251556,1263.904670715332,31305,8250,23055,23055,0,12,8166000.0
8166,8166999,20.718629098359386,37.77146757210293,0.08648986401783965,1367.7062673568726,530.1678063869476,1263.8066368103027,31323,8254,23069,23069,0,12,8167000.0
8167,8167999,20.720098466262193,37.77443382075226,0.086473498472186,1367.8901093006134,530.2294912338257,1264.0260734558105,31351,8255,23096,23096,0,12,8168000.0
8168,8168999,20.721892941586425,37.77792354840026,0.08645211517938245,1368.0992288589478,530.2908842563629,1264.1279029846191,31353,8256,23097,23097,0,12,8169000.0
8169,8169999,20.723758281626775,37.78117152485059,0.08644572745183288,1368.2915687561035,530.3524193763733,1264.2166862487793,31355,8257,23098,23098,0,12,8170000.0
8170,8170999,20.726208027350307,37.78826450275956,0.08642516414909807,1368.5663692951202,530.4151659011841,1264.2503204345703,31359,8259,23100,23100,0,12,8171000.0
8171,8171999,20.72816209055441,37.791803290863925,0.08642448160899052,1368.772126197815,530.477246761322,1264.3527221679688,31361,8260,23101,23101,0,12,8172000.0
8172,8172999,20.72992366118366,37.79523513695998,0.08642799054650219,1368.8983037471771,530.5409832000732,1264.505874633789,31361,8260,23101,23101,0,12,8173000.0
8173,8173999,20.73124082673274,37.797247962486004,0.08646436793829448,1369.2296433448792,530.6034212112427,1264.4424781799316,31367,8263,23104,23104,0,12,8174000.0
8174,8174999,20.732036883510464,37.79818815222544,0.08649039712339057,1369.4303047657013,530.6661233901978,1265.1479225158691,31380,8264,23116,23116,0,12,8175000.0
8175,8175999,20.731740576025278,37.79838921379647,0.08647345880374258,1369.6122226715088,530.7280652523041,1265.7602043151855,31384,8265,23119,23119,0,12,8176000.0
8176,8176999,20.731504951004073,37.79758610248881,0.08646810373747638,1369.80166721344,530.7888157367706,1266.1242752075195,31386,8266,23120,23120,0,12,8177000.0
8177,8177999,20.731491768325935,37.79756619264253,0.08645774662886996,1369.9127321243286,530.8499822616577,1266.4548835754395,31386,8266,23120,23120,0,12,8178000.0
8178,8178999,20.731566086096386,37.797217797759245,0.08644650044615532,1370.1863164901733,530.913122177124,1266.5383987426758,31390,8268,23122,23122,0,12,8179000.0
8179,8179999,20.731632889282917,37.79754485677599,0.08643555710420603,1370.5228295326233,530.9757528305054,1266.5532035827637,31396,8271,23125,23125,0,12,8180000.0
8180,8180999,20.73179412700208,37.79727647143621,0.08642807560451371,1370.6394860744476,531.0365922451019,1266.8204803466797,31396,8271,23125,23125,0,12,8181000.0
8181,8181999,20.732072839196775,37.797065393230874,0.08642612992000076,1370.773342370987,531.0983862876892,1267.0993957519531,31397,8271,23126,23126,0,12,8182000.0
8182,8182999,20.732665735372994,37.79752831482806,0.08642180577164438,1370.9657862186432,531.1609406471252,1267.2154846191406,31399,8272,23127,23127,0,12,8183000.0
8183,8183999,20.733525189909784,37.798826376494276,0.08641943609045921,1371.1586637496948,531.2238237857819,1267.3373794555664,31401,8273,23128,23128,0,12,8184000.0
8184,8184999,20.734484720762293,37.80007704001174,0.08642573897617245,1371.3585405349731,531.2909574508667,1267.527904510498,31403,8274,23129,23129,0,12,8185000.0
8185,8185999,20.735157018805523,37.8008030141208,0.08643552589244907,1371.6123464107513,531.3533749580383,1267.563117980957,31407,8276,23131,23131,0,12,8186000.0
8186,8186999,20.736264330454894,37.80223917374267,0.08644096373253374,1371.8795866966248,531.4161696434021,1267.6544036865234,31411,8278,23133,23133,0,12,8187000.0
8187,8187999,20.737498578037552,37.80393709348573,0.08645179715222939,1372.023124217987,531.4910674095154,1267.877773284912,31411,8278,23133,23133,0,12,8188000.0
8188,8188999,20.73879650021276,37.805935295195994,0.08646480047514904,1372.367431640625,531.5549614429474,1267.8437957763672,31417,8281,23136,23136,0,12,8189000.0
8189,8189999,20.739894109784817,37.807290000945514,0.08647594535181768,1372.6404712200165,531.6175434589386,1267.8904113769531,31421,8283,23138,23138,0,12,8190000.0
8190,8190999,20.74133673231785,37.81010810839182,0.08649886427612097,1372.7592468261719,531.681896686554,1268.088882446289,31421,8283,23138,23138,0,12,8191000.0
8191,8191999,20.742986624803947,37.81262404995641,0.08653402893339102,1372.9471600055695,531.7454450130463,1268.1808853149414,31423,8284,23139,23139,0,12,8192000.0
8192,8192999,20.744601394799307,37.81659490160637,0.08655885791638007,1373.1548640727997,531.8094778060913,1268.218765258789,31425,8285,23140,23140,0,12,8193000.0
8193,8193999,20.745705251177597,37.81755840112865,0.08658767904596743,1373.292955160141,531.870935678482,1268.368293762207,31425,8285,23140,23140,0,12,8194000.0
8194,8194999,20.7462859070599,37.818489588396204,0.08658460822722192,1373.4213194847107,531.9357061386108,1269.0831871032715,31437,8285,23152,23152,0,12,8195000.0
8195,8195999,20.746001010664262,37.81915010575962,0.08656964842592885,1373.6223154067993,532.000960111618,1269.638126373291,31443,8286,23157,23157,0,12,8196000.0
8196,8196999,20.745626111820382,37.81913358602972,0.08655791934743373,1373.8837416172028,532.0640268325806,1269.913444519043,31447,8288,23159,23159,0,12,8197000.0
8197,8197999,20.745179657130087,37.81829357076297,0.08654901018688566,1374.0666587352753,532.1269261837006,1270.1943321228027,31450,8289,23161,23161,0,12,8198000.0
8198,8198999,20.744817538646235,37.817541849014795,0.08653932219396021,1374.4041585922241,532.1895990371704,1270.2465858459473,31456,8292,23164,23164,0,12,8199000.0
8199,8199999,20.744578878052042,37.816828720880295,0.0865320297047576,1374.5164592266083,532.2492134571075,1270.5136489868164,31456,8292,23164,23164,0,12,8200000.0
8200,8200999,20.744135705334543,37.81557278854412,0.0865271660279947,1374.773903131485,532.3110873699188,1270.6850814819336,31460,8294,23166,23166,0,12,8201000.0
8201,8201999,20.744176258376765,37.81717667026787,0.08650786406710209,1374.9115829467773,532.37770819664,1271.0018577575684,31462,8294,23168,23168,0,12,8202000.0
8202,8202999,20.743887569189845,37.81618509712558,0.08650151957085195,1375.1082165241241,532.4405472278595,1271.0824241638184,31464,8295,23169,23169,0,12,8203000.0
8203,8203999,20.743952552199474,37.81570513100378,0.08649099514524083,1375.3004240989685,532.5058779716492,1271.2400093078613,31466,8296,23170,23170,0,12,8204000.0
8204,8204999,20.7439283479095,37.81513256200711,0.08649036607112093,1375.484365940094,532.5673983097076,1271.379596710205,31468,8297,23171,23171,0,12,8205000.0
8205,8205999,20.74400640726731,37.81470847642752,0.08648437813223842,1375.817846775055,532.6296660900116,1271.3934059143066,31479,8300,23179,23179,0,12,8206000.0
8206,8206999,20.744098178154225,37.814511328643334,0.08648650167485128,1376.0918009281158,532.6942937374115,1271.5336265563965,31483,8302,23181,23181,0,12,8207000.0
8207,8207999,20.74441752119416,37.817235135071805,0.0864708024084182,1376.3584802150726,532.7573862075806,1271.6168327331543,31487,8304,23183,23183,0,12,8208000.0
8208,8208999,20.74453423863518,37.816852173115166,0.08646920805802805,1376.557945728302,532.8195219039917,1271.7190971374512,31489,8305,23184,23184,0,12,8209000.0
8209,8209999,20.74476506561346,37.81677633382119,0.08646913964538738,1376.7474873065948,532.8815524578094,1271.8916778564453,31491,8306,23185,23185,0,12,8210000.0
8210,8210999,20.744883590887884,37.81626172766373,0.08647560847506963,1376.936583518982,532.9446818828583,1271.9870376586914,31493,8307,23186,23186,0,12,8211000.0
8211,8211999,20.74515119139508,37.8159280038106,0.08647389330720645,1377.0700042247772,533.0088725090027,1272.1276054382324,31493,8307,23186,23186,0,12,8212000.0
8212,8212999,20.745175166142076,37.81527957870679,0.08647102929499328,1377.3485443592072,533.0727450847626,1272.0837707519531,31497,8309,23188,23188,0,12,8213000.0
8213,8213999,20.745262973413205,37.814463649123525,0.08646764853403854,1377.6801631450653,533.1375222206116,1272.128017425537,31503,8312,23191,23191,0,12,8214000.0
8214,8214999,20.745226363643148,37.814298065361264,0.08645800515924085,1377.801012992859,533.1992537975311,1272.734390258789,31511,8312,23199,23199,0,12,8215000.0
8215,8215999,20.74445432694134,37.81291273037842,0.08645850528214127,1378.142123222351,533.2624220848083,1273.3174591064453,31523,8315,23208,23208,0,12,8216000.0
8216,8216999,20.74382993832714,37.8126041550043,0.08645532814559409,1378.332490682602,533.3233709335327,1273.7053909301758,31550,8316,23234,23234,0,12,8217000.0
8217,8217999,20.74313477391762,37.811535726932334,0.0864550186768629,1378.7190928459167,533.3853089809418,1273.837059020996,31558,8320,23238,23238,0,12,8218000.0
8218,8218999,20.74238491632324,37.810044598950086,0.08645618338678918,1378.9776947498322,533.4489085674286,1273.9777221679688,31562,8322,23240,23240,0,12,8219000.0
8219,8219999,20.741913015863577,37.808843955211934,0.08645733434835379,1379.1001982688904,533.5131547451019,1274.2883071899414,31562,8322,23240,23240,0,12,8220000.0
8220,8220999,20.7413557015576,37.80779012941249,0.08645633530822172,1379.370620250702,533.5779504776001,1274.4266166687012,31566,8324,23242,23242,0,12,8221000.0
8221,8221999,20.740719875930914,37.80652312768163,0.08645419280119826,1379.6385436058044,533.6440985202789,1274.5545120239258,31571,8326,23245,23245,0,12,8222000.0
8222,8222999,20.740373847228426,37.80569818786057,0.08645187739828775,1379.834670305252,533.7097706794739,1274.7829780578613,31578,8327,23251,23251,0,12,8223000.0
8223,8223999,20.739988777590508,37.80500144087316,0.0864480308778387,1380.0423357486725,533.7759099006653,1274.9657745361328,31590,8328,23262,23262,0,12,8224000.0
8224,8224999,20.739560263285416,37.8040109574527,0.08644544055346215,1380.239949464798,533.8423209190369,1275.141689300537,31592,8329,23263,23263,0,12,8225000.0
8225,8225999,20.73916676772668,37.80294018417502,0.086442960161206,1380.435340166092,533.9078388214111,1275.31693649292,31594,8330,23264,23264,0,12,8226000.0
8226,8226999,20.739149398537442,37.80242202329336,0.08643336607583518,1380.8091700077057,533.9745941162109,1275.3525924682617,31600,8333,23267,23267,0,12,8227000.0
8227,8227999,20.739089076766973,37.80193864707985,0.08642548772276837,1381.0743734836578,534.0398173332214,1275.4044570922852,31614,8335,23279,23279,0,12,8228000.0
8228,8228999,20.73920613450223,37.801635497362646,0.08642012006850508,1381.1983454227448,534.1042351722717,1275.590976715088,31614,8335,23279,23279,0,12,8229000.0
8229,8229999,20.739656769640337,37.801736637803735,0.08641135874271966,1381.4892649650574,534.1708030700684,1275.6323623657227,31621,8337,23284,23284,0,12,8230000.0
8230,8230999,20.740036759881416,37.8018285564648,0.08640402228046751,1381.6899981498718,534.2369573116302,1275.7422485351562,31623,8338,23285,23285,0,12,8231000.0
8231,8231999,20.74043362177915,37.801714477026614,0.08640069129617445,1381.8298773765564,534.3023159503937,1275.8849029541016,31623,8338,23285,23285,0,12,8232000.0
8232,8232999,20.740589190095402,37.801453113171895,0.08639625492645653,1382.0378098487854,534.3682870864868,1275.9614295959473,31625,8339,23286,23286,0,12,8233000.0
8233,8233999,20.740755867089376,37.80087550403717,0.08639201851786482,1382.3151264190674,534.4331772327423,1275.97705078125,31629,8341,23288,23288,0,12,8234000.0
8234,8234999,20.740625017034706,37.80142609711451,0.08638494018551013,1382.508570432663,534.4986724853516,1276.0430488586426,31631,8342,23289,23289,0,12,8235000.0
8235,8235999,20.741013998088246,37.80231098993772,0.08634360366760463,1382.7695360183716,534.563670873642,1276.8023796081543,31641,8344,23297,23297,0,12,8236000.0
8236,8236999,20.74110504132011,37.80193688047432,0.08631268825371485,1383.0353093147278,534.6282370090485,1277.1022987365723,31647,8346,23301,23301,0,12,8237000.0
8237,8237999,20.74121051776701,37.80230071739356,0.08629201863672076,1383.2270126342773,534.6933557987213,1277.3879737854004,31649,8347,23302,23302,0,12,8238000.0
8238,8238999,20.741403692815766,37.80265886829624,0.08627146451615775,1383.497006893158,534.7586200237274,1277.682529449463,31653,8349,23304,23304,0,12,8239000.0
8239,8239999,20.741706545955637,37.80237803712253,0.0862479799078466,1383.8511307239532,534.8242974281311,1277.8122100830078,31659,8352,23307,23307,0,12,8240000.0
8240,8240999,20.742105663846473,37.802644545252065,0.08622277083774055,1384.038655757904,534.8896508216858,1278.0154342651367,31661,8353,23308,23308,0,12,8241000.0
8241,8241999,20.742531001076625,37.80255443786805,0.08620026508138723,1384.1823563575745,534.9645235538483,1278.2254829406738,31661,8353,23308,23308,0,12,8242000.0
8242,8242999,20.742832884503112,37.8022229384168,0.08618533057461908,1384.4589021205902,535.0304861068726,1278.4160614013672,31667,8355,23312,23312,0,12,8243000.0
8243,8243999,20.743115092212683,37.80176659336804,0.08617939831230004,1384.5832283496857,535.0953085422516,1278.6422386169434,31667,8355,23312,23312,0,12,8244000.0
8244,8244999,20.743445504807273,37.80179906263811,0.0861667938885079,1384.7876262664795,535.1606056690216,1278.754955291748,31669,8356,23313,23313,0,12,8245000.0
8245,8245999,20.744107880600886,37.802103962797695,0.0861505161071704,1385.0701282024384,535.226744890213,1278.8650207519531,31673,8358,23315,23315,0,12,8246000.0
8246,8246999,20.74457926507141,37.80224280764572,0.0861519399729418,1385.3633177280426,535.2927875518799,1278.8811073303223,31677,8360,23317,23317,0,12,8247000.0
8247,8247999,20.74494165346263,37.80206551547896,0.08614842005100576,1385.6365308761597,535.3572793006897,1278.9558715820312,31681,8362,23319,23319,0,12,8248000.0
8248,8248999,20.7458487896376,37.80451410898537,0.08613934637282716,1385.7706558704376,535.4228103160858,1279.1627082824707,31681,8362,23319,23319,0,12,8249000.0
8249,8249999,20.74647403268635,37.804734006909,0.08614473152190305,1386.131460905075,535.489150762558,1279.1603965759277,31689,8365,23324,23324,0,12,8250000.0
8250,8250999,20.747083011890247,37.80486829555018,0.08614902094320809,1386.257951259613,535.5550217628479,1279.3426208496094,31689,8365,23324,23324,0,12,8251000.0
8251,8251999,20.748148306686883,37.80625758941863,0.08615544774307482,1386.5309998989105,535.6210951805115,1279.343936920166,31693,8367,23326,23326,0,12,8252000.0
8252,8252999,20.748991388121937,37.80743402970544,0.08616465110393345,1386.672422170639,535.6876358985901,1279.5361976623535,31693,8367,23326,23326,0,12,8253000.0
8253,8253999,20.749941559920547,37.80811123773733,0.08617751452597433,1386.8071591854095,535.7522187232971,1279.6848220825195,31693,8367,23326,23326,0,12,8254000.0
8254,8254999,20.75064848713979,37.808141817082785,0.0861792419027867,1387.0078916549683,535.8169922828674,1279.8315315246582,31700,8368,23332,23332,0,12,8255000.0
8255,8255999,20.750971378580083,37.80952768655634,0.08614191734246968,1387.1281569004059,535.8824310302734,1280.7045288085938,31707,8368,23339,23339,0,12,8256000.0
8256,8256999,20.751447056264688,37.810374930176984,0.08613640697831759,1387.3318877220154,535.9472651481628,1281.0866508483887,31710,8369,23341,23341,0,12,8257000.0
8257,8257999,20.75250948355554,37.81228596627554,0.08613170578938645,1387.6054129600525,536.0116920471191,1281.2634048461914,31715,8371,23344,23344,0,12,8258000.0
8258,8258999,20.753392992226832,37.816432487319986,0.0861244730572368,1387.8905777931213,536.0772898197174,1281.328769683838,31719,8373,23346,23346,0,12,8259000.0
8259,8259999,20.754341540538682,37.81795446881733,0.08612986738262607,1388.3318622112274,536.1504514217377,1281.3810806274414,31727,8377,23350,23350,0,12,8260000.0
8260,8260999,20.75525344235601,37.818818523550796,0.08613000206987442,1388.5941905975342,536.2155683040619,1281.520076751709,31731,8379,23352,23352,0,12,8261000.0
8261,8261999,20.75659365349079,37.820515701127995,0.0861313503540736,1388.7417705059052,536.2860496044159,1281.9302787780762,31732,8379,23353,23353,0,12,8262000.0
8262,8262999,20.75777011152165,37.82159902452294,0.08613318817445625,1388.857575416565,536.3507533073425,1282.1880645751953,31732,8379,23353,23353,0,12,8263000.0
8263,8263999,20.75912272725329,37.82300348060005,0.08614499292759004,1389.14266371727,536.4173586368561,1282.2837295532227,31741,8381,23360,23360,0,12,8264000.0
8264,8264999,20.760342414642547,37.825424241484555,0.08614473162336045,1389.3533375263214,536.4826080799103,1282.376480102539,31743,8382,23361,23361,0,12,8265000.0
8265,8265999,20.761652332503385,37.82695506711951,0.08616043216607738,1389.6235649585724,536.5471541881561,1282.4175109863281,31747,8384,23363,23363,0,12,8266000.0
8266,8266999,20.76306334495272,37.828401186091455,0.08618233180835766,1389.7603635787964,536.6121888160706,1282.6010360717773,31747,8384,23363,23363,0,12,8267000.0
8267,8267999,20.76435206069182,37.82967697558854,0.08620066091645529,1389.977875471115,536.6779136657715,1282.693271636963,31749,8385,23364,23364,0,12,8268000.0
8268,8268999,20.765802251398494,37.83139375042152,0.08622512743274702,1390.1041617393494,536.7432687282562,1282.8694076538086,31749,8385,23364,23364,0,12,8269000.0
8269,8269999,20.76765072115327,37.83518388137719,0.08625260215724861,1390.248021364212,536.8173832893372,1282.9908332824707,31749,8385,23364,23364,0,12,8270000.0
8270,8270999,20.76900772668218,37.83627355749674,0.08628207989919512,1390.4708259105682,536.8851702213287,1283.0225257873535,31751,8386,23365,23365,0,12,8271000.0
8271,8271999,20.770498148938586,37.837534963479335,0.08631790764732106,1390.8919200897217,536.950510263443,1282.8466262817383,31759,8390,23369,23369,0,12,8272000.0
8272,8272999,20.77178030814102,37.838365574943715,0.08636291925703976,1391.1101462841034,537.0158219337463,1282.9289360046387,31761,8391,23370,23370,0,12,8273000.0
8273,8273999,20.772375781238125,37.83903138340195,0.08636234650368457,1391.3118963241577,537.0816857814789,1283.6473655700684,31769,8392,23377,23377,0,12,8274000.0
8274,8274999,20.772230357291374,37.84018329521891,0.08634998881251799,1391.5139486789703,537.1471428871155,1284.2279472351074,31774,8393,23381,23381,0,12,8275000.0
8275,8275999,20.77202087641576,37.840370914448464,0.08633906969711147,1391.7816195487976,537.212249994278,1284.4267539978027,31778,8395,23383,23383,0,12,8276000.0
8276,8276999,20.771815337152393,37.84087244300523,0.08633023241829563,1391.9729380607605,537.2768893241882,1284.641860961914,31780,8396,23384,23384,0,12,8277000.0
8277,8277999,20.771805484103464,37.84069648095094,0.08632238696256467,1392.4081735610962,537.3430399894714,1284.7633895874023,31788,8400,23388,23388,0,12,8278000.0
8278,8278999,20.771650479740813,37.84043980274458,0.0863133708031063,1392.5384802818298,537.407458782196,1285.01957321167,31788,8400,23388,23388,0,12,8279000.0
8279,8279999,20.771734990204127,37.84011850685107,0.08630842871390443,1392.8056721687317,537.4753127098083,1285.1668968200684,31793,8402,23391,23391,0,12,8280000.0
8280,8280999,20.772130835538558,37.840584477843414,0.08630668348362269,1393.0015976428986,537.541296005249,1285.3202857971191,31795,8403,23392,23392,0,12,8281000.0
8281,8281999,20.772328181209865,37.840401563346376,0.08630582832603695,1393.2730569839478,537.6053545475006,1285.377643585205,31799,8405,23394,23394,0,12,8282000.0
8282,8282999,20.772520803371734,37.84031365993429,0.0863041952436725,1393.637063741684,537.6729016304016,1285.4024772644043,31805,8408,23397,23397,0,12,8283000.0
8283,8283999,20.77299597046479,37.840821172291115,0.0863018588074741,1393.9466710090637,537.7432951927185,1285.429355621338,31809,8410,23399,23399,0,12,8284000.0
8284,8284999,20.77339842647615,37.840943938251165,0.08630404175278072,1394.1457479000092,537.8085043430328,1285.5296783447266,31811,8411,23400,23400,0,12,8285000.0
8285,8285999,20.773921227377798,37.84102434870663,0.08630523634287512,1394.4145486354828,537.8736479282379,1285.5483360290527,31815,8413,23402,23402,0,12,8286000.0
8286,8286999,20.77427179777391,37.840895583955316,0.08630478440873235,1394.6207926273346,537.9385657310486,1285.7002334594727,31817,8414,23403,23403,0,12,8287000.0
8287,8287999,20.77469591921457,37.840784185397546,0.08630404577598638,1394.8255274295807,538.0039608478546,1285.80765914917,31819,8415,23404,23404,0,12,8288000.0
8288,8288999,20.775041150259675,37.84071607946851,0.08630126916057101,1395.044902563095,538.076016664505,1285.9337730407715,31821,8416,23405,23405,0,12,8289000.0
8289,8289999,20.775175005129377,37.84000633807122,0.08629917853166158,1395.254237651825,538.1425421237946,1286.1132011413574,31833,8417,23416,23416,0,12,8290000.0
8290,8290999,20.77532193558379,37.84142697565386,0.08627931571960001,1395.4727003574371,538.2083768844604,1286.8302001953125,31842,8418,23424,23424,0,12,8291000.0
8291,8291999,20.775254079580424,37.84079583132111,0.08625895892391788,1395.6033427715302,538.2739264965057,1287.283302307129,31843,8418,23425,23425,0,12,8292000.0
8292,8292999,20.77523555989328,37.84079921331959,0.08624588985995507,1395.7147331237793,538.3383853435516,1287.5630073547363,31843,8418,23425,23425,0,12,8293000.0
8293,8293999,20.775188311811174,37.84022652891672,0.08623411957535065,1395.9129421710968,538.4033572673798,1287.6742515563965,31846,8419,23427,23427,0,12,8294000.0
8294,8294999,20.775273576778538,37.83992613152238,0.08622023375943177,1396.3319396972656,538.469003200531,1287.6313552856445,31854,8423,23431,23431,0,12,8295000.0
8295,8295999,20.775342434736913,37.8399937995885,0.0862112081448484,1396.6118822097778,538.5359129905701,1287.834617614746,31862,8425,23437,23437,0,12,8296000.0
8296,8296999,20.775476599863353,37.84027763331898,0.08620005628002181,1396.7267384529114,538.6004736423492,1288.1142578125,31863,8425,23438,23438,0,12,8297000.0
8297,8297999,20.775754823532573,37.840337388352275,0.08618632001606974,1396.9962983131409,538.6647799015045,1288.233974456787,31867,8427,23440,23440,0,12,8298000.0
8298,8298999,20.776112632777952,37.84048722455289,0.08617646706976734,1397.2815849781036,538.728922367096,1288.2504196166992,31871,8429,23442,23442,0,12,8299000.0
8299,8299999,20.776409447037313,37.84023408033803,0.08616446365060193,1397.4798476696014,538.7942476272583,1288.4127235412598,31873,8430,23443,23443,0,12,8300000.0
8300,8300999,20.776907536446526,37.841213928853705,0.08615194311695473,1397.603618144989,538.8580183982849,1288.573673248291,31873,8430,23443,23443,0,12,8301000.0
8301,8301999,20.777253228302712,37.84109551738246,0.08614112933212059,1398.0306015014648,538.9231162071228,1288.497142791748,31881,8434,23447,23447,0,12,8302000.0
8302,8302999,20.777718692992092,37.841416456379996,0.08613564253873496,1398.1476936340332,538.9870729446411,1288.737850189209,31881,8434,23447,23447,0,12,8303000.0
8303,8303999,20.77797331964456,37.841458644464275,0.08612571513568867,1398.4264163970947,539.0535252094269,1288.776969909668,31885,8436,23449,23449,0,12,8304000.0
8304,8304999,20.77818639326953,37.841330967284456,0.08611784118258947,1398.6272513866425,539.118273973465,1288.9033889770508,31887,8437,23450,23450,0,12,8305000.0
8305,8305999,20.778702770362088,37.841417592031505,0.08610472735328856,1398.8278696537018,539.1826021671295,1289.026252746582,31889,8438,23451,23451,0,12,8306000.0
8306,8306999,20.779079229091604,37.84138846619314,0.08608799762154606,1398.9506039619446,539.2466425895691,1289.2110023498535,31889,8438,23451,23451,0,12,8307000.0
8307,8307999,20.779374293282842,37.84186846137823,0.08607861731266775,1399.160516500473,539.3110699653625,1289.2624015808105,31891,8439,23452,23452,0,12,8308000.0
8308,8308999,20.77933411285572,37.841029357185995,0.08606904186065645,1399.3672206401825,539.3760311603546,1289.370273590088,31893,8440,23453,23453,0,12,8309000.0
8309,8309999,20.779844294636593,37.84110580499396,0.08603988310493516,1399.5831463336945,539.4413819313049,1290.2270774841309,31916,8441,23475,23475,0,12,8310000.0
8310,8310999,20.7801403134533,37.84076880235456,0.08600914931222847,1399.7020335197449,539.5051929950714,1290.7002754211426,31916,8441,23475,23475,0,12,8311000.0
8311,8311999,20.780761209791077,37.84136568459914,0.08597413759697292,1400.040522813797,539.5704913139343,1290.8225631713867,31922,8444,23478,23478,0,12,8312000.0
8312,8312999,20.78124228198591,37.84177333138028,0.08593645210348189,1400.153422832489,539.6347758769989,1291.1213989257812,31922,8444,23478,23478,0,12,8313000.0
8313,8313999,20.78163629006614,37.84222315356939,0.08590279942674506,1400.49787068367,539.6994466781616,1291.1397094726562,31928,8447,23481,23481,0,12,8314000.0
8314,8314999,20.782360163086278,37.84246806062781,0.08587977266038105,1401.13521194458,539.7669837474823,1291.038730621338,31942,8454,23488,23488,0,12,8315000.0
8315,8315999,20.782959481837075,37.842945684067644,0.08585322446257215,1401.4097089767456,539.8330800533295,1291.214942932129,31946,8456,23490,23490,0,12,8316000.0
8316,8316999,20.78326558198179,37.84293848859067,0.0858444729408514,1401.6006484031677,539.898509979248,1291.4814682006836,31949,8457,23492,23492,0,12,8317000.0
8317,8317999,20.78386360358296,37.842925836611975,0.0858206599010739,1401.9428482055664,539.96413230896,1291.443214416504,31955,8460,23495,23495,0,12,8318000.0
8318,8318999,20.784315696542073,37.84296072383598,0.08580047309493533,1402.1536033153534,540.0306994915009,1291.6899032592773,31957,8461,23496,23496,0,12,8319000.0
8319,8319999,20.785214035641786,37.843483538652386,0.08579312896750835,1402.3011589050293,540.1034007072449,1291.9287872314453,31957,8461,23496,23496,0,12,8320000.0
8320,8320999,20.785977910511782,37.8440132151303,0.0857797205491092,1402.4256703853607,540.1690468788147,1292.078701019287,31957,8461,23496,23496,0,12,8321000.0
8321,8321999,20.7866086574396,37.84436312037768,0.08575449311501315,1402.6471445560455,540.2393047809601,1292.1900825500488,31959,8462,23497,23497,0,12,8322000.0
8322,8322999,20.787461654752395,37.84498869083444,0.0857303252042686,1402.9215126037598,540.3053662776947,1292.190284729004,31963,8464,23499,23499,0,12,8323000.0
8323,8323999,20.788224892477512,37.845793706968266,0.08570958501110548,1403.1292588710785,540.3713464736938,1292.2903785705566,31965,8465,23500,23500,0,12,8324000.0
8324,8324999,20.78906953937857,37.84636680098911,0.08568141917703609,1403.4768784046173,540.4368026256561,1292.2250061035156,31971,8468,23503,23503,0,12,8325000.0
8325,8325999,20.78982823731133,37.84676306579429,0.08565872625510185,1403.7565853595734,540.5042221546173,1292.2845649719238,31975,8470,23505,23505,0,12,8326000.0
8326,8326999,20.790740465199505,37.847810669865275,0.08563914124636562,1404.1001403331757,540.5702657699585,1292.3762550354004,31989,8473,23516,23516,0,12,8327000.0
8327,8327999,20.79166616888343,37.84883739742192,0.08562815523498624,1404.459289073944,540.6368408203125,1292.3719215393066,31995,8476,23519,23519,0,12,8328000.0
8328,8328999,20.792257075344494,37.84907348497734,0.08561788229804657,1404.5917258262634,540.703610420227,1292.5719909667969,31995,8476,23519,23519,0,12,8329000.0
8329,8329999,20.792782568485524,37.84985267053806,0.08559797444966333,1404.7924020290375,540.7692608833313,1293.3830947875977,32009,8477,23532,23532,0,12,8330000.0
8330,8330999,20.793024976279405,37.84944936150252,0.0855799956936566,1404.9840440750122,540.835045337677,1293.8397903442383,32013,8478,23535,23535,0,12,8331000.0
8331,8331999,20.793337491510243,37.8498752151815,0.08556428400469507,1405.1900432109833,540.9002332687378,1294.1724548339844,32016,8479,23537,23537,0,12,8332000.0
8332,8332999,20.79389061232445,37.851011308469715,0.08554848827068218,1405.611474275589,540.9664998054504,1294.2079772949219,32024,8483,23541,23541,0,12,8333000.0
8333,8333999,20.79435921053983,37.85099259235084,0.08553965681124809,1405.8015577793121,541.0319566726685,1294.4326972961426,32026,8484,23542,23542,0,12,8334000.0
8334,8334999,20.795000922792656,37.85197708412952,0.08554884603466184,1406.2329123020172,541.0973720550537,1294.4393119812012,32034,8488,23546,23546,0,12,8335000.0
8335,8335999,20.79554402319367,37.85226342331249,0.08554840164889344,1406.4308145046234,541.1654298305511,1294.6666831970215,32036,8489,23547,23547,0,12,8336000.0
8336,8336999,20.79609308965846,37.852575934676665,0.08557375259023925,1406.6380171775818,541.2372610569,1294.993221282959,32041,8490,23551,23551,0,12,8337000.0
8337,8337999,20.796864448003223,37.853457661198625,0.08558136554345397,1406.773717880249,541.3031265735626,1295.2349128723145,32041,8490,23551,23551,0,12,8338000.0
8338,8338999,20.79775527475085,37.85446576879293,0.08560735214976134,1406.9018442630768,541.3707311153412,1295.441261291504,32041,8490,23551,23551,0,12,8339000.0
8339,8339999,20.799039129398732,37.85642993663813,0.08562958054049441,1407.1687421798706,541.4363255500793,1295.4689254760742,32045,8492,23553,23553,0,12,8340000.0
8340,8340999,20.80025312932534,37.858182238794235,0.08564582085248407,1407.4430050849915,541.502631187439,1295.5302200317383,32049,8494,23555,23555,0,12,8341000.0
8341,8341999,20.801486436937466,37.85963598416098,0.0856454126506524,1407.8771328926086,541.5699861049652,1295.5057487487793,32062,8498,23564,23564,0,12,8342000.0
8342,8342999,20.802905893104196,37.861663723109764,0.08566627338559829,1408.1597170829773,541.6367490291595,1295.5789756774902,32066,8500,23566,23566,0,12,8343000.0
8343,8343999,20.80465680696495,37.86426539105884,0.08569444421821293,1408.4312527179718,541.7022616863251,1295.7354774475098,32070,8502,23568,23568,0,12,8344000.0
8344,8344999,20.806141340168047,37.86581166969514,0.08572340378178733,1408.72740650177,541.7695870399475,1295.8374671936035,32074,8504,23570,23570,0,12,8345000.0
8345,8345999,20.808122330184663,37.86864212740822,0.08574963392599522,1408.8579876422882,541.8343939781189,1296.0289039611816,32074,8504,23570,23570,0,12,8346000.0
8346,8346999,20.80964666981447,37.8703765389391,0.08576942484949401,1409.0499329566956,541.8998754024506,1296.1199569702148,32076,8505,23571,23571,0,12,8347000.0
8347,8347999,20.811388940688868,37.87227023807461,0.08577591487525649,1409.167022228241,541.9645268917084,1296.2899932861328,32076,8505,23571,23571,0,12,8348000.0
8348,8348999,20.812250170640823,37.872459487477215,0.08577869941719296,1409.3720018863678,542.0303711891174,1296.52632522583,32079,8506,23573,23573,0,12,8349000.0
8349,8349999,20.812242474812326,37.87265252469592,0.0857604179734961,1409.5626633167267,542.0961883068085,1297.494400024414,32095,8507,23588,23588,0,12,8350000.0
8350,8350999,20.812088643385586,37.872282589273006,0.08574162247662709,1409.6897473335266,542.1602449417114,1297.9192962646484,32096,8507,23589,23589,0,12,8351000.0
8351,8351999,20.81206112550777,37.87246637941505,0.08572523751180228,1410.0327668190002,542.2267365455627,1298.0146446228027,32112,8510,23602,23602,0,12,8352000.0
8352,8352999,20.81181156602101,37.8714126052187,0.08571608487382298,1410.234296321869,542.2910544872284,1298.1841621398926,32114,8511,23603,23603,0,12,8353000.0
8353,8353999,20.811428852954275,37.870173603764414,0.0857059888453997,1410.5830645561218,542.3569440841675,1298.2132606506348,32120,8514,23606,23606,0,12,8354000.0
8354,8354999,20.810993973707685,37.868865022722815,0.08570023410678762,1410.940280199051,542.4236450195312,1298.3086204528809,32126,8517,23609,23609,0,12,8355000.0
8355,8355999,20.810513914927075,37.8676224802559,0.08569522437584354,1411.0600171089172,542.4888973236084,1298.6137237548828,32127,8517,23610,23610,0,12,8356000.0
8356,8356999,20.8101636758417,37.86660537439613,0.08568716649109442,1411.2559559345245,542.5545101165771,1298.7877197265625,32130,8518,23612,23612,0,12,8357000.0
8357,8357999,20.809920875554518,37.865791215951624,0.0856788471600084,1411.3847060203552,542.6198313236237,1299.0502128601074,32130,8518,23612,23612,0,12,8358000.0
8358,8358999,20.80955149464117,37.86466630499416,0.08567036059997879,1411.6694004535675,542.6850740909576,1299.0911674499512,32134,8520,23614,23614,0,12,8359000.0
8359,8359999,20.809230673794772,37.863791164320965,0.08566309979623687,1411.797610282898,542.7494425773621,1299.3017959594727,32134,8520,23614,23614,0,12,8360000.0
8360,8360999,20.80892024997256,37.86283715827114,0.0856580825864548,1412.0043535232544,542.8148746490479,1299.3955688476562,32136,8521,23615,23615,0,12,8361000.0
8361,8361999,20.8087050534031,37.861970116718545,0.08564932384663149,1412.1435120105743,542.8798182010651,1299.5436210632324,32136,8521,23615,23615,0,12,8362000.0
8362,8362999,20.80845886166467,37.8612337061629,0.08563924072447304,1412.3472621440887,542.9459066390991,1299.6274642944336,32138,8522,23616,23616,0,12,8363000.0
8363,8363999,20.808165350436944,37.86008708307066,0.08563151854666229,1412.5646991729736,543.0106530189514,1299.750644683838,32140,8523,23617,23617,0,12,8364000.0
8364,8364999,20.807995780737492,37.8591120800084,0.0856244473092107,1412.6879131793976,543.0759751796722,1299.9289360046387,32140,8523,23617,23617,0,12,8365000.0
8365,8365999,20.807755435988625,37.85817269518047,0.08561855222618442,1412.9086887836456,543.1417353153229,1299.9824028015137,32142,8524,23618,23618,0,12,8366000.0
8366,8366999,20.80757115724529,37.85716110183451,0.0856114589014676,1413.0388729572296,543.2060439586639,1300.1203689575195,32142,8524,23618,23618,0,12,8367000.0
8367,8367999,20.807263460148654,37.85611183477559,0.0856057555078894,1413.2444982528687,543.2724878787994,1300.1982192993164,32144,8525,23619,23619,0,12,8368000.0
8368,8368999,20.806852471391014,37.85514930233028,0.08560151569414232,1413.4426264762878,543.3381631374359,1300.2787895202637,32146,8526,23620,23620,0,12,8369000.0
8369,8369999,20.806636823051296,37.85453431065033,0.08558589011534545,1413.5622837543488,543.4033455848694,1301.0629196166992,32154,8526,23628,23628,0,12,8370000.0
8370,8370999,20.806217922600702,37.85381858579587,0.08557057671866974,1413.8316826820374,543.4682569503784,1301.2389907836914,32158,8528,23630,23630,0,12,8371000.0
8371,8371999,20.80563995764817,37.852348192421495,0.0855652378575561,1414.1843764781952,543.5329945087433,1301.3305892944336,32169,8531,23638,23638,0,12,8372000.0
8372,8372999,20.805233764015895,37.85103098051106,0.0855548271289076,1414.6070120334625,543.5991568565369,1301.3482933044434,32177,8535,23642,23642,0,12,8373000.0
8373,8373999,20.804902053125296,37.85113062044483,0.08554159757753921,1414.879289150238,543.6644752025604,1301.502597808838,32181,8537,23644,23644,0,12,8374000.0
8374,8374999,20.80438112421375,37.8497824334167,0.0855352932938509,1415.1619064807892,543.729433298111,1301.6409873962402,32190,8539,23651,23651,0,12,8375000.0
8375,8375999,20.803814975459552,37.848734894653944,0.0855291562794418,1415.2791306972504,543.7932245731354,1301.8902015686035,32190,8539,23651,23651,0,12,8376000.0
8376,8376999,20.803501465070166,37.84996949111782,0.08551908062059377,1415.4854037761688,543.8579232692719,1302.0282096862793,32194,8540,23654,23654,0,12,8377000.0
8377,8377999,20.803168628306263,37.84991020854216,0.0855042195680682,1415.7693972587585,543.9225649833679,1302.1889419555664,32198,8542,23656,23656,0,12,8378000.0
8378,8378999,20.802842231216367,37.84918479968125,0.08549446071458944,1415.8989446163177,543.9869990348816,1302.3847122192383,32198,8542,23656,23656,0,12,8379000.0
8379,8379999,20.80223716466166,37.84778219209443,0.08548714169880123,1416.039502620697,544.0529189109802,1302.5440864562988,32198,8542,23656,23656,0,12,8380000.0
8380,8380999,20.80177396268766,37.84661064130057,0.08548013618534356,1416.2470695972443,544.1181981563568,1302.5880279541016,32200,8543,23657,23657,0,12,8381000.0
8381,8381999,20.801545192122692,37.84694588416287,0.08546246186841788,1416.5996766090393,544.1837775707245,1302.5567893981934,32206,8546,23660,23660,0,12,8382000.0
8382,8382999,20.80134168387304,37.84620976069954,0.08544882877027027,1416.7333943843842,544.2478334903717,1302.854377746582,32206,8546,23660,23660,0,12,8383000.0
8383,8383999,20.801464069599664,37.84605192568578,0.08542596678359249,1417.006175518036,544.313152551651,1302.8925285339355,32210,8548,23662,23662,0,12,8384000.0
8384,8384999,20.801453431927488,37.84546753876633,0.08540647490752518,1417.2018229961395,544.3773767948151,1303.0397872924805,32212,8549,23663,23663,0,12,8385000.0
8385,8385999,20.80170654528349,37.84559185113419,0.08538119896503071,1417.514174938202,544.44824385643,1303.057819366455,32226,8551,23675,23675,0,12,8386000.0
8386,8386999,20.801539630536425,37.844897276969995,0.08536907894947543,1417.6516711711884,544.514050245285,1303.2267265319824,32226,8551,23675,23675,0,12,8387000.0
8387,8387999,20.801370370129685,37.84408158425476,0.08535551712085176,1417.864774942398,544.5800220966339,1303.3180465698242,32228,8552,23676,23676,0,12,8388000.0
8388,8388999,20.80155590897335,37.845322770395434,0.08534606039323323,1417.9880855083466,544.6449279785156,1303.4754180908203,32228,8552,23676,23676,0,12,8389000.0
8389,8389999,20.801169667702926,37.84427010754058,0.08533416784421133,1418.119781255722,544.7138180732727,1305.0555152893066,32280,8552,23728,23728,0,12,8390000.0
8390,8390999,20.80035166907568,37.84270231420884,0.08533016571375662,1418.2297070026398,544.7787535190582,1305.7069854736328,32282,8552,23730,23730,0,12,8391000.0
8391,8391999,20.799752310078635,37.841842013580546,0.0853262610661698,1418.339587688446,544.8433210849762,1306.0652351379395,32283,8552,23731,23731,0,12,8392000.0
8392,8392999,20.799247985582912,37.84057506540999,0.08532128138213468,1418.5989639759064,544.9075968265533,1306.3356246948242,32287,8554,23733,23733,0,12,8393000.0
8393,8393999,20.79888222590502,37.83977414054287,0.08531588387468103,1419.0167706012726,544.9733099937439,1306.4562759399414,32295,8558,23737,23737,0,12,8394000.0
8394,8394999,20.798651573761617,37.83897538070867,0.08531238902402216,1419.139225244522,545.0376048088074,1306.7564582824707,32295,8558,23737,23737,0,12,8395000.0
8395,8395999,20.79845930818546,37.838185081213624,0.08531185360614346,1419.4815549850464,545.102881193161,1306.852310180664,32302,8561,23741,23741,0,12,8396000.0
8396,8396999,20.798104353797438,37.83713684905222,0.08531115569448189,1419.7506754398346,545.1688764095306,1307.0634727478027,32307,8563,23744,23744,0,12,8397000.0
8397,8397999,20.79827357443385,37.83981182618713,0.08529892789609184,1420.094379901886,545.2347481250763,1307.2033882141113,32314,8566,23748,23748,0,12,8398000.0
8398,8398999,20.79834208549429,37.84003264871458,0.0852958137316504,1420.3690793514252,545.3003947734833,1307.3806648254395,32318,8568,23750,23750,0,12,8399000.0
8399,8399999,20.798265793838727,37.83948157908359,0.08530266021721233,1420.6983621120453,545.4117257595062,1307.6158561706543,32321,8569,23752,23752,0,12,8400000.0
8400,8400999,20.79827785097459,37.83930518399858,0.08530719837141676,1421.0550165176392,545.4857709407806,1307.6661567687988,32327,8572,23755,23755,0,12,8401000.0
8401,8401999,20.79833765900169,37.83945463851454,0.08531479011534304,1421.4821109771729,545.5504870414734,1307.6164779663086,32335,8576,23759,23759,0,12,8402000.0
8402,8402999,20.798470976378443,37.839508240193254,0.08531458110361023,1421.828320980072,545.6157410144806,1307.7300186157227,32341,8579,23762,23762,0,12,8403000.0
8403,8403999,20.798546129009747,37.83924557185773,0.08531992333002436,1422.1274881362915,545.7171115875244,1308.006893157959,32343,8580,23763,23763,0,12,8404000.0
8404,8404999,20.798625460107004,37.83862511736898,0.08533297849576982,1422.4022421836853,545.7834203243256,1308.164909362793,32347,8582,23765,23765,0,12,8405000.0
8405,8405999,20.79913467485909,37.839049286866704,0.08533645971427439,1422.7615284919739,545.8698604106903,1308.2747611999512,32351,8584,23767,23767,0,12,8406000.0
8406,8406999,20.799609193430914,37.83898470166114,0.0853407462225022,1423.0637440681458,545.9513952732086,1308.4583587646484,32355,8586,23769,23769,0,12,8407000.0
8407,8407999,20.800128152944758,37.83929622375513,0.08533410454399604,1423.3616938591003,546.017297744751,1308.581314086914,32359,8588,23771,23771,0,12,8408000.0
8408,8408999,20.800344741101327,37.83886401207932,0.08533703093815082,1423.5979454517365,546.096910238266,1308.828296661377,32361,8589,23772,23772,0,12,8409000.0
8409,8409999,20.80145980521176,37.84072548975559,0.08521326786024452,1423.7185609340668,546.162948846817,1310.215503692627,32379,8589,23790,23790,0,12,8410000.0
8410,8410999,20.802368587634444,37.8423035197375,0.08511861333528115,1423.8347165584564,546.2278246879578,1310.9361305236816,32385,8589,23796,23796,0,12,8411000.0
8411,8411999,20.80270977826733,37.84219737012841,0.08505833122529916,1423.9547815322876,546.2945606708527,1311.376579284668,32385,8589,23796,23796,0,12,8412000.0
8412,8412999,20.80295841641334,37.84181163577138,0.08502283154984225,1424.0721633434296,546.3594529628754,1311.711139678955,32386,8589,23797,23797,0,12,8413000.0
8413,8413999,20.803187636201212,37.84141820811831,0.08498450687690018,1424.3336911201477,546.4244043827057,1311.9100952148438,32391,8591,23800,23800,0,12,8414000.0
8414,8414999,20.803061635475895,37.840508952130826,0.08495900807128898,1424.530151128769,546.4896214008331,1312.1745300292969,32393,8592,23801,23801,0,12,8415000.0
8415,8415999,20.803048697423854,37.83992835304168,0.08492919409056499,1424.8820276260376,546.5552008152008,1312.2434844970703,32399,8595,23804,23804,0,12,8416000.0
8416,8416999,20.803054354197045,37.839289682922114,0.08490573657011824,1425.0790088176727,546.6193506717682,1312.4558410644531,32401,8596,23805,23805,0,12,8417000.0
8417,8417999,20.803025673496958,37.83884015564103,0.08488241512770422,1425.2785024642944,546.6853444576263,1312.5446815490723,32404,8597,23807,23807,0,12,8418000.0
8418,8418999,20.802864351707683,37.83781519876733,0.08486360382302671,1425.4855227470398,546.7508671283722,1312.6738395690918,32406,8598,23808,23808,0,12,8419000.0
8419,8419999,20.802880345069795,37.83725424493064,0.08484778451976693,1425.8481736183167,546.8162908554077,1312.7163848876953,32412,8601,23811,23811,0,12,8420000.0
8420,8420999,20.80285403346536,37.83662905307404,0.08483096675886537,1426.0435483455658,546.8824074268341,1312.9152565002441,32414,8602,23812,23812,0,12,8421000.0
8421,8421999,20.802824088551567,37.8357265567223,0.08481869685785648,1426.246779203415,546.9479084014893,1313.0459213256836,32416,8603,23813,23813,0,12,8422000.0
8422,8422999,20.802946534079855,37.835268492813654,0.08480248599351614,1426.5352494716644,547.0127685070038,1313.1268768310547,32421,8605,23816,23816,0,12,8423000.0
8423,8423999,20.80308207471889,37.835743647350235,0.0847890524534346,1426.7497069835663,547.078088760376,1313.3230094909668,32424,8606,23818,23818,0,12,8424000.0
8424,8424999,20.803125104059145,37.83593899588462,0.0847765061667668,1426.9425797462463,547.1433844566345,1313.4765281677246,32427,8607,23820,23820,0,12,8425000.0
8425,8425999,20.802862718705555,37.83477984488761,0.08476775208359433,1427.075026512146,547.2071442604065,1313.7327194213867,32427,8607,23820,23820,0,12,8426000.0
8426,8426999,20.803905189581293,37.83546477851425,0.08468280251533677,1427.1962084770203,547.2723655700684,1315.2267456054688,32438,8607,23831,23831,0,12,8427000.0
8427,8427999,20.80491920597288,37.837885424931144,0.08461172741545886,1427.312052488327,547.3369579315186,1315.7901458740234,32438,8607,23831,23831,0,12,8428000.0
8428,8428999,20.805610273162607,37.83844598047294,0.08456469728495097,1427.516580581665,547.4035301208496,1316.1188011169434,32448,8608,23840,23840,0,12,8429000.0
8429,8429999,20.805922438774274,37.83821701213421,0.08452553426480403,1427.7196004390717,547.4690825939178,1316.413906097412,32451,8609,23842,23842,0,12,8430000.0
8430,8430999,20.806286041991726,37.83815797057974,0.08448847573536045,1427.9271883964539,547.5332193374634,1316.6466789245605,32453,8610,23843,23843,0,12,8431000.0
8431,8431999,20.80677432880027,37.83828841829916,0.08446579917290054,1428.1153614521027,547.5983674526215,1316.7897338867188,32455,8611,23844,23844,0,12,8432000.0
8432,8432999,20.80715107263503,37.83795208906848,0.08444023680582402,1428.3827540874481,547.6638262271881,1316.9668350219727,32459,8613,23846,23846,0,12,8433000.0
8433,8433999,20.807325467652134,37.83753977293942,0.08441869453044137,1428.5856902599335,547.7290694713593,1317.1301918029785,32462,8614,23848,23848,0,12,8434000.0
8434,8434999,20.807685905316365,37.83810977587597,0.08439973070904627,1428.7915363311768,547.7942445278168,1317.2590103149414,32464,8615,23849,23849,0,12,8435000.0
8435,8435999,20.808132368707465,37.838049204889195,0.08438236509672337,1428.914134979248,547.8582656383514,1317.4505348205566,32464,8615,23849,23849,0,12,8436000.0
8436,8436999,20.808237825210497,37.8373639684921,0.08437114863628137,1429.1250629425049,547.9244565963745,1317.5912780761719,32466,8616,23850,23850,0,12,8437000.0
8437,8437999,20.80854519008442,37.83735804683081,0.08436194936097119,1429.257441997528,547.9884593486786,1317.7243461608887,32466,8616,23850,23850,0,12,8438000.0
8438,8438999,20.808784475149217,37.836879480199684,0.08434751311289646,1429.3853828907013,548.0522713661194,1317.8944969177246,32466,8616,23850,23850,0,12,8439000.0
8439,8439999,20.80914335385996,37.83695041417792,0.08434470124070981,1429.5193507671356,548.1164655685425,1318.1303062438965,32466,8616,23850,23850,0,12,8440000.0
8440,8440999,20.809370859507194,37.8363037425855,0.08433725653509527,1429.6563289165497,548.1809809207916,1318.2629699707031,32466,8616,23850,23850,0,12,8441000.0
8441,8441999,20.809724650370608,37.8360139266131,0.0843311438843336,1429.778048992157,548.2455687522888,1318.4012260437012,32466,8616,23850,23850,0,12,8442000.0
8442,8442999,20.810200821242162,37.83582004401071,0.08432490380209812,1429.9340062141418,548.3184649944305,1318.5638275146484,32467,8616,23851,23851,0,12,8443000.0
8443,8443999,20.81047071596897,37.83597961755221,0.08431076339227694,1430.209879398346,548.3840174674988,1318.5916290283203,32471,8618,23853,23853,0,12,8444000.0
8444,8444999,20.810779773390003,37.837590764438545,0.0842970592839587,1430.4162817001343,548.4497349262238,1318.6696701049805,32475,8619,23856,23856,0,12,8445000.0
8445,8445999,20.810751962498937,37.83733961099086,0.08428363147235751,1430.6317827701569,548.5159668922424,1319.9872779846191,32487,8620,23867,23867,0,12,8446000.0
8446,8446999,20.8103980969163,37.8364177725155,0.08428026322351345,1430.753879070282,548.5807282924652,1320.5350532531738,32487,8620,23867,23867,0,12,8447000.0
8447,8447999,20.810313496395683,37.83658915587193,0.08427516047334427,1430.9512968063354,548.6462907791138,1320.771369934082,32499,8621,23878,23878,0,12,8448000.0
8448,8448999,20.810237454708986,37.83672660793207,0.08426903342435865,1431.0646696090698,548.7111051082611,1321.0954360961914,32499,8621,23878,23878,0,12,8449000.0
8449,8449999,20.81037911619431,37.83656957804353,0.08427082723487134,1431.2678842544556,548.7777247428894,1321.3107566833496,32501,8622,23879,23879,0,12,8450000.0
8450,8450999,20.810640182244555,37.836862004767625,0.08427075592778788,1431.405975818634,548.8426847457886,1321.5235633850098,32501,8622,23879,23879,0,12,8451000.0
8451,8451999,20.810907337047958,37.836904963337815,0.08427089834405277,1431.6003468036652,548.9076714515686,1321.6778755187988,32503,8623,23880,23880,0,12,8452000.0
8452,8452999,20.811065286275664,37.836726493435066,0.08427545478379406,1431.7329730987549,548.9720034599304,1321.8739852905273,32503,8623,23880,23880,0,12,8453000.0
8453,8453999,20.811557264982895,37.837366360383214,0.08427564942695309,1432.02276968956,549.0390133857727,1321.9631996154785,32507,8625,23882,23882,0,12,8454000.0
8454,8454999,20.811990439056377,37.8376935624881,0.0842798003986881,1432.1601965427399,549.1045989990234,1322.1094932556152,32507,8625,23882,23882,0,12,8455000.0
8455,8455999,20.81215490452064,37.83797739490411,0.08428139885203878,1432.438823223114,549.1706736087799,1322.1306915283203,32513,8627,23886,23886,0,12,8456000.0
8456,8456999,20.81281830294886,37.839142017939615,0.0842871442205505,1432.6455869674683,549.2361800670624,1322.2091751098633,32515,8628,23887,23887,0,12,8457000.0
8457,8457999,20.812911247905994,37.838970158400116,0.08428651871618231,1432.9213893413544,549.304692029953,1322.1522178649902,32520,8630,23890,23890,0,12,8458000.0
8458,8458999,20.813491800364396,37.840051771127555,0.08428809152450145,1433.133427143097,549.370365858078,1322.3127059936523,32524,8631,23893,23893,0,12,8459000.0
8459,8459999,20.81391918362507,37.84035098339074,0.08429186202390826,1433.2636096477509,549.4350438117981,1322.521385192871,32524,8631,23893,23893,0,12,8460000.0
8460,8460999,20.81431769998465,37.84058616260994,0.08428936856626501,1433.5456819534302,549.5005021095276,1322.5243644714355,32529,8633,23896,23896,0,12,8461000.0
8461,8461999,20.814928969471556,37.841204889211305,0.08429913407413647,1433.6958906650543,549.5714619159698,1322.7013778686523,32529,8633,23896,23896,0,12,8462000.0
8462,8462999,20.815531972292085,37.84228422648138,0.08430437160285298,1433.8171212673187,549.6375622749329,1322.887466430664,32529,8633,23896,23896,0,12,8463000.0
8463,8463999,20.815791068883954,37.84213781250044,0.08431996681331999,1434.0340068340302,549.7029416561127,1322.9178466796875,32533,8634,23899,23899,0,12,8464000.0
8464,8464999,20.81592437718091,37.841659515467754,0.08434200673271386,1434.1680715084076,549.7683758735657,1323.1111679077148,32533,8634,23899,23899,0,12,8465000.0
8465,8465999,20.81571190053041,37.841952128876855,0.08433008365318595,1434.297462940216,549.8334674835205,1324.5676918029785,32541,8634,23907,23907,0,12,8466000.0
8466,8466999,20.815211827593494,37.84110889304785,0.08432554236227319,1434.4076125621796,549.8976519107819,1325.1279373168945,32543,8634,23909,23909,0,12,8467000.0
8467,8467999,20.81483602281143,37.840443549696765,0.0843185820554091,1434.5241868495941,549.9614150524139,1325.4648475646973,32543,8634,23909,23909,0,12,8468000.0
8468,8468999,20.814370164667636,37.8392757748145,0.084314962053333,1434.7933461666107,550.0264029502869,1325.7120094299316,32547,8636,23911,23911,0,12,8469000.0
8469,8469999,20.814087999831205,37.839300721283735,0.08430271090340824,1434.9922614097595,550.0925302505493,1325.916893005371,32550,8637,23913,23913,0,12,8470000.0
8470,8470999,20.81377214048434,37.838921673071354,0.08429452826061234,1435.1775333881378,550.1570680141449,1326.126293182373,32552,8638,23914,23914,0,12,8471000.0
8471,8471999,20.813396155858268,37.838033052171646,0.08429051130287801,1435.3767285346985,550.2216238975525,1326.3085899353027,32554,8639,23915,23915,0,12,8472000.0
8472,8472999,20.813166537372105,37.837594672067596,0.08428262652998586,1435.5764601230621,550.287969827652,1326.4605827331543,32556,8640,23916,23916,0,12,8473000.0
8473,8473999,20.813274728373496,37.83787615553678,0.08427501355936584,1435.9387612342834,550.3547163009644,1326.4972229003906,32564,8643,23921,23921,0,12,8474000.0
8474,8474999,20.8138702814129,37.838788126702575,0.0842650337433074,1436.0635948181152,550.4202799797058,1326.73099899292,32564,8643,23921,23921,0,12,8475000.0
8475,8475999,20.814638068585293,37.84008752985415,0.08425159250669856,1436.2590136528015,550.4845604896545,1326.8696060180664,32566,8644,23922,23922,0,12,8476000.0
8476,8476999,20.815777115758685,37.8426602425195,0.08423212396397206,1436.3927850723267,550.5513751506805,1327.0373077392578,32566,8644,23922,23922,0,12,8477000.0
8477,8477999,20.817247699631114,37.846090598771255,0.08423819547663591,1436.6096334457397,550.6163220405579,1327.0957870483398,32570,8645,23925,23925,0,12,8478000.0
8478,8478999,20.81867528134826,37.84947582910119,0.08424285227497219,1436.890941143036,550.6812634468079,1327.0989112854004,32575,8647,23928,23928,0,12,8479000.0
8479,8479999,20.820136517736586,37.85353393668167,0.08427796157071821,1437.1001620292664,550.7478921413422,1327.2400245666504,32577,8648,23929,23929,0,12,8480000.0
8480,8480999,20.821039409839344,37.85464218734563,0.08429289894777292,1437.2459299564362,550.8224050998688,1327.425148010254,32577,8648,23929,23929,0,12,8481000.0
8481,8481999,20.822433046275652,37.85845111887279,0.08431991990517729,1437.3783376216888,550.8888854980469,1327.5917434692383,32577,8648,23929,23929,0,12,8482000.0
8482,8482999,20.823492796864052,37.859544200100814,0.08435902852546384,1437.5120544433594,550.9547607898712,1327.712989807129,32577,8648,23929,23929,0,12,8483000.0
8483,8483999,20.82428962297219,37.86074109431521,0.08437948553228636,1437.644544839859,551.0195083618164,1327.9143142700195,32577,8648,23929,23929,0,12,8484000.0
8484,8484999,20.824326689414367,37.86051662615228,0.08437933997221148,1437.7694947719574,551.0857243537903,1329.3444938659668,32588,8648,23940,23940,0,12,8485000.0
8485,8485999,20.82408414345737,37.85993268716057,0.08437425076660032,1437.9637334346771,551.1520602703094,1329.868148803711,32592,8649,23943,23943,0,12,8486000.0
8486,8486999,20.824067030156154,37.86005690509945,0.08436748977461539,1438.1494982242584,551.2161321640015,1330.2756080627441,32594,8650,23944,23944,0,12,8487000.0
8487,8487999,20.824016496861002,37.86029174761616,0.08435961015983873,1438.264050245285,551.2824087142944,1330.648063659668,32594,8650,23944,23944,0,12,8488000.0
8488,8488999,20.824017300034193,37.86012965616299,0.08435874864787785,1438.5413880348206,551.3487510681152,1330.7566947937012,32598,8652,23946,23946,0,12,8489000.0
8489,8489999,20.82388204024887,37.85957546301213,0.08435551278707942,1438.8826150894165,551.4146480560303,1330.8931694030762,32604,8655,23949,23949,0,12,8490000.0
8490,8490999,20.82378095895161,37.859048399160166,0.08435385159825748,1439.1478245258331,551.4809341430664,1331.0698432922363,32630,8657,23973,23973,0,12,8491000.0
8491,8491999,20.823750564282054,37.8587187252975,0.08434921559658348,1439.2786207199097,551.5463342666626,1331.363868713379,32630,8657,23973,23973,0,12,8492000.0
8492,8492999,20.82395025184028,37.85948535248525,0.08433353898629448,1439.4825193881989,551.6121377944946,1331.564567565918,32633,8658,23975,23975,0,12,8493000.0
8493,8493999,20.823963019495256,37.85905132027659,0.08433070461076919,1439.6891062259674,551.6783192157745,1331.6279602050781,32637,8659,23978,23978,0,12,8494000.0
8494,8494999,20.824030913873873,37.85890034914217,0.08433600961720256,1439.8289535045624,551.7440230846405,1331.8230781555176,32637,8659,23978,23978,0,12,8495000.0
8495,8495999,20.82411581911824,37.858510927591645,0.08433382945601431,1440.0339603424072,551.809897184372,1331.9095916748047,32639,8660,23979,23979,0,12,8496000.0
8496,8496999,20.824021470916588,37.85785683327621,0.08433441624002869,1440.2489919662476,551.8751888275146,1331.9962425231934,32642,8661,23981,23981,0,12,8497000.0
8497,8497999,20.82392012893954,37.857131532834615,0.08433483532509067,1440.4546082019806,551.9417197704315,1332.115478515625,32644,8662,23982,23982,0,12,8498000.0
8498,8498999,20.82396511277022,37.85670581605663,0.08433846942785617,1440.5882322788239,552.0075705051422,1332.3124542236328,32644,8662,23982,23982,0,12,8499000.0
8499,8499999,20.823921404841265,37.85611357511546,0.0843358132619999,1440.7298121452332,552.0736839771271,1332.411693572998,32644,8662,23982,23982,0,12,8500000.0
8500,8500999,20.82394261327117,37.8556958899138,0.08433059708512758,1440.8648328781128,552.139762878418,1332.5573463439941,32644,8662,23982,23982,0,12,8501000.0
8501,8501999,20.82395884564417,37.85606074148084,0.08432216378431001,1440.9931268692017,552.2057542800903,1332.698471069336,32644,8662,23982,23982,0,12,8502000.0
8502,8502999,20.8237036076568,37.85501525266556,0.08431881551815423,1441.2027769088745,552.2708842754364,1332.7689208984375,32656,8663,23993,23993,0,12,8503000.0
8503,8503999,20.82351053121899,37.854146968831316,0.08431726907001869,1441.4179916381836,552.3367419242859,1332.8248558044434,32658,8664,23994,23994,0,12,8504000.0
8504,8504999,20.82295867375719,37.85266774731321,0.08431485359574098,1441.5413482189178,557.3497774600983,1334.2008476257324,32670,8664,24006,24006,0,12,8505000.0
8505,8505999,20.822239141618713,37.85131110639181,0.08430995234475391,1441.660372018814,557.4150228500366,1334.7991333007812,32670,8664,24006,24006,0,12,8506000.0
8506,8506999,20.82145100303512,37.84979504879096,0.08431057800296227,1441.8534553050995,557.4804055690765,1335.190788269043,32672,8665,24007,24007,0,12,8507000.0
8507,8507999,20.82079730646765,37.84893075868368,0.08430880499326598,1441.973506450653,557.5466287136078,1335.5373878479004,32672,8665,24007,24007,0,12,8508000.0
8508,8508999,20.820033242379957,37.847457609077146,0.0843089234981046,1442.1837332248688,557.6113469600677,1335.6985397338867,32675,8666,24009,24009,0,12,8509000.0
8509,8509999,20.81944726442625,37.846555255451214,0.08430680366840149,1442.3872346878052,557.6760771274567,1335.8732299804688,32677,8667,24010,24010,0,12,8510000.0
8510,8510999,20.81880832987387,37.84544482757879,0.08430719579907897,1442.5823662281036,557.7413675785065,1336.0864639282227,32679,8668,24011,24011,0,12,8511000.0
8511,8511999,20.81826210755862,37.84496985713517,0.08430403487717897,1442.7931303977966,557.8073770999908,1336.230785369873,32681,8669,24012,24012,0,12,8512000.0
8512,8512999,20.81822774316124,37.845853514422004,0.08429627584047494,1443.1626830101013,557.8738315105438,1336.2974700927734,32687,8672,24015,24015,0,12,8513000.0
8513,8513999,20.818786338212917,37.84882505138114,0.08429370571416439,1443.4684660434723,557.9410953521729,1336.4187240600586,32692,8674,24018,24018,0,12,8514000.0
8514,8514999,20.818852665489562,37.851247196626765,0.08429665107519424,1443.6841881275177,558.0063233375549,1336.601016998291,32694,8675,24019,24019,0,12,8515000.0
8515,8515999,20.8190074964043,37.85191472131957,0.0842885255679533,1443.8948092460632,558.0722863674164,1336.6965293884277,32696,8676,24020,24020,0,12,8516000.0
8516,8516999,20.819276674675745,37.85302709054544,0.08426609213548464,1444.0171399116516,558.1386785507202,1336.898826599121,32696,8676,24020,24020,0,12,8517000.0
8517,8517999,20.819560667946273,37.85367391818432,0.08425181613545296,1444.1547136306763,558.2034349441528,1337.0876693725586,32696,8676,24020,24020,0,12,8518000.0
8518,8518999,20.819885815670496,37.85413741854135,0.08423674936491887,1444.3657898902893,558.2681794166565,1337.1373443603516,32701,8677,24024,24024,0,12,8519000.0
8519,8519999,20.820461017502847,37.85574725411156,0.08421734031591821,1444.6713271141052,558.3344833850861,1337.1356964111328,32705,8679,24026,24026,0,12,8520000.0
8520,8520999,20.82138959980281,37.85738534666745,0.08419490698861742,1444.807561159134,558.4002802371979,1337.3138046264648,32705,8679,24026,24026,0,12,8521000.0
8521,8521999,20.821995777014664,37.85860982061066,0.08418189630061657,1444.9367756843567,558.4671828746796,1337.4984855651855,32705,8679,24026,24026,0,12,8522000.0
8522,8522999,20.82247764992332,37.859178555697035,0.08417115729277613,1445.0742514133453,558.5323679447174,1337.647933959961,32705,8679,24026,24026,0,12,8523000.0
8523,8523999,20.822561832898472,37.85916200212157,0.08416075644379772,1445.2140610218048,558.5974645614624,1337.8292198181152,32705,8679,24026,24026,0,12,8524000.0
8524,8524999,20.822825850360246,37.858974010503864,0.08413305423869111,1445.3458664417267,558.666538476944,1339.2434844970703,32716,8679,24037,24037,0,12,8525000.0
8525,8525999,20.822916384446813,37.85848831256847,0.08410787067687786,1445.4638216495514,558.7318696975708,1339.8149337768555,32716,8679,24037,24037,0,12,8526000.0
8526,8526999,20.823046904333847,37.85817067099961,0.0840907786139784,1445.6660814285278,558.7976167201996,1340.142074584961,32718,8680,24038,24038,0,12,8527000.0
8527,8527999,20.82319336043096,37.8576209465449,0.0840703049010676,1445.9472222328186,558.8638646602631,1340.4030532836914,32723,8682,24041,24041,0,12,8528000.0
8528,8528999,20.823451581243713,37.85739202975668,0.08406060971523521,1446.0869162082672,558.9322803020477,1340.6969604492188,32723,8682,24041,24041,0,12,8529000.0
8529,8529999,20.82372568228512,37.857623704512626,0.08405164621959305,1446.2826986312866,558.9973556995392,1340.9413299560547,32725,8683,24042,24042,0,12,8530000.0
8530,8530999,20.82402853191188,37.85788374153298,0.08404720021720846,1446.4209496974945,559.0631904602051,1341.1436004638672,32725,8683,24042,24042,0,12,8531000.0
8531,8531999,20.82451601083133,37.85876276207161,0.08403520645777574,1446.6315126419067,559.129016160965,1341.2783279418945,32727,8684,24043,24043,0,12,8532000.0
8532,8532999,20.824935629037128,37.859229101336126,0.08403121036504901,1446.7796058654785,559.1963770389557,1341.463924407959,32727,8684,24043,24043,0,12,8533000.0
8533,8533999,20.82526851521571,37.85935833828729,0.0840266366661031,1447.0085217952728,559.2624990940094,1341.498691558838,32730,8685,24045,24045,0,12,8534000.0
8534,8534999,20.826312632923003,37.86267794759364,0.08402647107775285,1447.2991251945496,559.3288996219635,1341.5145225524902,32737,8687,24050,24050,0,12,8535000.0
8535,8535999,20.827462823821076,37.86420662231493,0.08403931332704051,1447.4348878860474,559.394907951355,1341.6919479370117,32737,8687,24050,24050,0,12,8536000.0
8536,8536999,20.828539033134422,37.86565370770301,0.08405153761244377,1447.561099767685,559.4601459503174,1341.8163871765137,32737,8687,24050,24050,0,12,8537000.0
8537,8537999,20.829897560093215,37.86784458697352,0.08406435564192882,1447.7182886600494,559.5275545120239,1341.9563598632812,32737,8687,24050,24050,0,12,8538000.0
8538,8538999,20.831239966047825,37.86965168805384,0.08408441810650025,1447.8498840332031,559.5924215316772,1342.1111373901367,32737,8687,24050,24050,0,12,8539000.0
8539,8539999,20.832771587071754,37.8718060629283,0.08410824699665265,1447.9944522380829,559.6586437225342,1342.2421073913574,32737,8687,24050,24050,0,12,8540000.0
8540,8540999,20.834835246472164,37.8756158243712,0.08413616293170045,1448.2299978733063,559.7244050502777,1342.2879829406738,32739,8688,24051,24051,0,12,8541000.0
8541,8541999,20.836587830236244,37.878029512488354,0.08417974495333957,1448.4463021755219,559.7902603149414,1342.3337211608887,32741,8689,24052,24052,0,12,8542000.0
8542,8542999,20.838163349571435,37.87994176371957,0.08422703418570976,1448.6543385982513,559.8553583621979,1342.4528923034668,32743,8690,24053,24053,0,12,8543000.0
8543,8543999,20.838682666980162,37.88007466295101,0.084228196491276,1448.9578368663788,559.9213473796844,1343.2043113708496,32755,8692,24063,24063,0,12,8544000.0
8544,8544999,20.839279466702273,37.88172796886113,0.0842085291527952,1449.2414529323578,559.9872901439667,1343.7736892700195,32773,8694,24079,24079,0,12,8545000.0
8545,8545999,20.84019500080707,37.8838339460287,0.0841934517155909,1449.3732507228851,560.0543832778931,1344.1148834228516,32773,8694,24079,24079,0,12,8546000.0
8546,8546999,20.841295822302964,37.887155831728556,0.08417872104654167,1449.495726108551,560.1193118095398,1344.394157409668,32773,8694,24079,24079,0,12,8547000.0
8547,8547999,20.842533895334597,37.8889350318921,0.08417267042617527,1449.7811770439148,560.1860685348511,1344.6040496826172,32777,8696,24081,24081,0,12,8548000.0
8548,8548999,20.843914652950847,37.8914029941542,0.08418071572443242,1450.0664870738983,560.2524297237396,1344.7559661865234,32781,8698,24083,24083,0,12,8549000.0
8549,8549999,20.84530409394159,37.894346008843954,0.08419101127300366,1450.4259560108185,560.3192868232727,1344.8574523925781,32787,8701,24086,24086,0,12,8550000.0
8550,8550999,20.84744176485475,37.90141627185675,0.08419022460864523,1450.801909685135,560.3862347602844,1345.007942199707,32795,8704,24091,24091,0,12,8551000.0
8551,8551999,20.849267595234565,37.905474141826375,0.08423785122928096,1451.0845284461975,560.4527730941772,1345.1257972717285,32800,8706,24094,24094,0,12,8552000.0
8552,8552999,20.851479952229955,37.91191871631639,0.08428147895880944,1451.4521081447601,560.5198361873627,1345.0949440002441,32808,8709,24099,24099,0,12,8553000.0
8553,8553999,20.85349778937628,37.918014479480554,0.08434316253446361,1451.6788902282715,560.5869429111481,1345.2844276428223,32810,8710,24100,24100,0,12,8554000.0
8554,8554999,20.855734679754086,37.92392757214899,0.08436344851801247,1451.9740920066833,560.6538808345795,1345.401309967041,32814,8712,24102,24102,0,12,8555000.0
8555,8555999,20.858132114145988,37.92913194814825,0.08442613103439911,1452.3399786949158,560.7205970287323,1345.4271659851074,32820,8715,24105,24105,0,12,8556000.0
8556,8556999,20.86008449691351,37.93352281069611,0.08445904031837537,1452.4849379062653,560.7868421077728,1345.6267471313477,32820,8715,24105,24105,0,12,8557000.0
8557,8557999,20.861931406482825,37.93751213022927,0.08451229018763828,1452.6298282146454,560.853188753128,1345.808277130127,32820,8715,24105,24105,0,12,8558000.0
8558,8558999,20.863660871828788,37.94013302471174,0.08455131769878321,1452.7707357406616,560.9196331501007,1346.0222511291504,32820,8715,24105,24105,0,12,8559000.0
8559,8559999,20.864462159562844,37.9423086413918,0.08454369105423332,1452.9913401603699,560.987256526947,1346.8732261657715,32830,8716,24114,24114,0,12,8560000.0
8560,8560999,20.864340128564013,37.942494411535435,0.08453259186032747,1453.1413617134094,561.0559022426605,1347.3414611816406,32831,8716,24115,24115,0,12,8561000.0
8561,8561999,20.86445911718635,37.9427620605892,0.08451990592246894,1453.2647359371185,561.1212093830109,1347.6303977966309,32831,8716,24115,24115,0,12,8562000.0
8562,8562999,20.864390420017386,37.942685030451166,0.0845133056873546,1453.3843653202057,561.1857786178589,1347.8731956481934,32832,8716,24116,24116,0,12,8563000.0
8563,8563999,20.86411071303375,37.94178669192047,0.08450935509339585,1453.7625885009766,561.2530298233032,1347.9263191223145,32838,8719,24119,24119,0,12,8564000.0
8564,8564999,20.86405517871832,37.94131733090546,0.08450139177845217,1454.1242763996124,561.3185997009277,1348.0854415893555,32850,8722,24128,24128,0,12,8565000.0
8565,8565999,20.864228148358954,37.941258466729565,0.08448976236277606,1454.2433931827545,561.3833630084991,1348.3041610717773,32850,8722,24128,24128,0,12,8566000.0
8566,8566999,20.864485351193455,37.9416577494713,0.08447618351110275,1454.6219885349274,561.4519038200378,1348.1807670593262,32859,8725,24134,24134,0,12,8567000.0
8567,8567999,20.864679424632016,37.941900983895216,0.0844645262149013,1454.841759443283,561.51806807518,1348.3589897155762,32861,8726,24135,24135,0,12,8568000.0
8568,8568999,20.86505672165503,37.942175543404126,0.08445353859111493,1454.9770922660828,561.5837190151215,1348.5506858825684,32861,8726,24135,24135,0,12,8569000.0
8569,8569999,20.865337240130128,37.9422167437871,0.08444553118878351,1455.3537411689758,561.649774312973,1348.466510772705,32867,8729,24138,24138,0,12,8570000.0
8570,8570999,20.865604952292127,37.942116503538806,0.08443919187000792,1455.499140739441,561.7160561084747,1348.6246719360352,32867,8729,24138,24138,0,12,8571000.0
8571,8571999,20.865909172811456,37.942015802861484,0.08444050576877016,1455.6513938903809,561.7832815647125,1348.790470123291,32867,8729,24138,24138,0,12,8572000.0
8572,8572999,20.866260494167648,37.9420530667939,0.08444165880966381,1455.9331107139587,561.8490698337555,1348.8259887695312,32871,8731,24140,24140,0,12,8573000.0
8573,8573999,20.866683116302937,37.94206321956605,0.08443790258715,1456.1526539325714,561.9155278205872,1348.8953895568848,32873,8732,24141,24141,0,12,8574000.0
8574,8574999,20.867449790712413,37.94284675644914,0.0844413329778082,1456.5441763401031,561.98179936409,1348.748794555664,32883,8735,24148,24148,0,12,8575000.0
8575,8575999,20.867648209633284,37.9424619518591,0.08444651692912064,1456.671273469925,562.0473144054413,1348.9523391723633,32883,8735,24148,24148,0,12,8576000.0
8576,8576999,20.867992560435916,37.94239016588768,0.08444895973029554,1456.9024772644043,562.1135091781616,1349.0328254699707,32885,8736,24149,24149,0,12,8577000.0
8577,8577999,20.8680864172046,37.94186134868976,0.08445219825868056,1457.0295667648315,562.1794056892395,1349.183193206787,32885,8736,24149,24149,0,12,8578000.0
8578,8578999,20.867607927374692,37.94112355769072,0.0844486049068548,1457.2452821731567,562.2446057796478,1350.001594543457,32899,8737,24162,24162,0,12,8579000.0
8579,8579999,20.867068657146653,37.9406158418197,0.08444092989309437,1457.3789448738098,562.3108415603638,1350.4541397094727,32901,8737,24164,24164,0,12,8580000.0
8580,8580999,20.866398027100892,37.93940012775435,0.08443750287988849,1457.6601762771606,562.3756868839264,1350.6237030029297,32905,8739,24166,24166,0,12,8581000.0
8581,8581999,20.866035662228303,37.938989755699545,0.08442944707253663,1457.78839969635,562.4418115615845,1350.9083442687988,32905,8739,24166,24166,0,12,8582000.0
8582,8582999,20.865578984781802,37.93822843235581,0.08442405445242207,1458.0011513233185,562.5079066753387,1351.0334854125977,32907,8740,24167,24167,0,12,8583000.0
8583,8583999,20.865134864306413,37.93738852310312,0.08441888703749789,1458.2157666683197,562.5759224891663,1351.1509628295898,32909,8741,24168,24168,0,12,8584000.0
8584,8584999,20.86497048359765,37.93719887557572,0.08440912327079964,1458.4232852458954,562.6412727832794,1351.3295593261719,32911,8742,24169,24169,0,12,8585000.0
8585,8585999,20.864841162042154,37.936771538238446,0.08440331510561061,1458.8037958145142,562.7076480388641,1351.3827323913574,32946,8745,24201,24201,0,12,8586000.0
8586,8586999,20.86495357353443,37.93705128820679,0.08439223331900303,1459.1112027168274,562.774610042572,1351.3824501037598,32953,8747,24206,24206,0,12,8587000.0
8587,8587999,20.865267335070786,37.93804445782092,0.08438435280038048,1459.2433552742004,562.841166973114,1351.543643951416,32953,8747,24206,24206,0,12,8588000.0
8588,8588999,20.865411606266797,37.93838934273303,0.08437997041450918,1459.5307302474976,562.9081501960754,1351.5389404296875,32958,8749,24209,24209,0,12,8589000.0
8589,8589999,20.865518204499214,37.93832121187287,0.08437666318845416,1459.9142117500305,562.9758803844452,1351.4842948913574,32964,8752,24212,24212,0,12,8590000.0
8590,8590999,20.86569868518869,37.93836606685055,0.08437411953379381,1460.2176282405853,563.0427219867706,1351.5318031311035,32971,8754,24217,24217,0,12,8591000.0
8591,8591999,20.865697548960814,37.93814917296883,0.08437497289386608,1460.4246275424957,563.1120550632477,1351.7459144592285,32973,8755,24218,24218,0,12,8592000.0
8592,8592999,20.865876872554853,37.93815288624253,0.08437225212149813,1460.5632796287537,563.1780879497528,1351.972267150879,32973,8755,24218,24218,0,12,8593000.0
8593,8593999,20.866030919647425,37.93816793548656,0.08437298238956892,1460.7737708091736,563.2446012496948,1352.0727882385254,32975,8756,24219,24219,0,12,8594000.0
8594,8594999,20.866109864169516,37.93755317882309,0.08437326645030319,1461.1350944042206,563.3119757175446,1352.0674781799316,32983,8759,24224,24224,0,12,8595000.0
8595,8595999,20.8662181936701,37.937232258285405,0.08437386296991267,1461.6037995815277,563.3795266151428,1351.9806213378906,32991,8763,24228,24228,0,12,8596000.0
8596,8596999,20.866075535533604,37.936367751342516,0.0843728306014031,1461.9028594493866,563.4470663070679,1352.0216255187988,32995,8765,24230,24230,0,12,8597000.0
8597,8597999,20.86596297732131,37.93644964914443,0.0843719649482021,1462.033759355545,563.5139524936676,1352.2191619873047,32995,8765,24230,24230,0,12,8598000.0
8598,8598999,20.86550485890051,37.93542672767594,0.08436744676691177,1462.171380519867,563.5803346633911,1353.093147277832,33008,8765,24243,24243,0,12,8599000.0
8599,8599999,20.865198930195277,37.93520719860791,0.08436324317287636,1462.3815553188324,563.6466979980469,1353.514934539795,33012,8766,24246,24246,0,12,8600000.0
8600,8600999,20.86484840337223,37.93454607750651,0.08436212802411336,1462.585410118103,563.7117276191711,1353.690761566162,33014,8767,24247,24247,0,12,8601000.0
8601,8601999,20.864517165459706,37.933560307153066,0.08436173966975735,1462.7114298343658,563.7770524024963,1353.9438018798828,33014,8767,24247,24247,0,12,8602000.0
8602,8602999,20.864176927929993,37.93293511249606,0.08435592593101848,1462.9272000789642,563.8447432518005,1354.0898094177246,33017,8768,24249,24249,0,12,8603000.0
8603,8603999,20.864068754849438,37.9322813256161,0.08435269501900622,1463.132281780243,563.910040140152,1354.191318511963,33019,8769,24250,24250,0,12,8604000.0
8604,8604999,20.863833168874297,37.93197961862473,0.08434691259498395,1463.5884759426117,563.9762387275696,1354.1614227294922,33029,8773,24256,24256,0,12,8605000.0
8605,8605999,20.863386433657006,37.930865379456584,0.08434660207761313,1463.9652228355408,564.0434510707855,1354.227695465088,33035,8776,24259,24259,0,12,8606000.0
8606,8606999,20.863005660703777,37.92978329528209,0.08435138971266154,1464.3341152668,564.1105349063873,1354.3035354614258,33041,8779,24262,24262,0,12,8607000.0
8607,8607999,20.862594138734316,37.929098979661525,0.0843497210839087,1464.540432214737,564.1759295463562,1354.3948249816895,33043,8780,24263,24263,0,12,8608000.0
8608,8608999,20.862102337482025,37.9278546189535,0.08434996944982842,1464.7585785388947,564.242155790329,1354.595531463623,33045,8781,24264,24264,0,12,8609000.0
8609,8609999,20.86178783973213,37.928261836269705,0.08434384073732948,1465.1375918388367,564.3090949058533,1354.5160865783691,33052,8784,24268,24268,0,12,8610000.0
8610,8610999,20.861451139855703,37.927299074418706,0.08434431809117249,1465.5204045772552,564.3754034042358,1354.4870872497559,33059,8787,24272,24272,0,12,8611000.0
8611,8611999,20.860935146263945,37.92636745995073,0.0843472547227514,1465.7403926849365,564.4430570602417,1354.6170463562012,33061,8788,24273,24273,0,12,8612000.0
8612,8612999,20.860627586730278,37.925265119550595,0.08434908567897714,1466.1125011444092,564.5102427005768,1354.5904159545898,33068,8791,24277,24277,0,12,8613000.0
8613,8613999,20.860200076397703,37.92419311360892,0.0843512834300103,1466.249006986618,564.5770049095154,1354.7546463012695,33068,8791,24277,24277,0,12,8614000.0
8614,8614999,20.85987006354325,37.92307746801906,0.08435327434489437,1466.480110168457,564.6429657936096,1354.8961296081543,33070,8792,24278,24278,0,12,8615000.0
8615,8615999,20.85948290832226,37.92193202919429,0.08435592046968887,1466.699853181839,564.7104840278625,1354.9837036132812,33072,8793,24279,24279,0,12,8616000.0
8616,8616999,20.859089908626387,37.92085503598304,0.08435651757090279,1466.9918184280396,564.7765922546387,1355.0518531799316,33076,8795,24281,24281,0,12,8617000.0
8617,8617999,20.85842083964092,37.91938722113435,0.08436001861573816,1467.1282329559326,564.8426253795624,1355.2321510314941,33076,8795,24281,24281,0,12,8618000.0
8618,8618999,20.85780339272211,37.920030563020454,0.08435189674136667,1467.3417990207672,564.908709526062,1356.1802864074707,33098,8796,24302,24302,0,12,8619000.0
8619,8619999,20.85694705641335,37.918551189598226,0.08435266109703443,1467.4657573699951,564.9759955406189,1356.648380279541,33099,8796,24303,24303,0,12,8620000.0
8620,8620999,20.85627274397232,37.91746558892848,0.08434851723228776,1467.5889599323273,565.041600227356,1356.9568557739258,33099,8796,24303,24303,0,12,8621000.0
8621,8621999,20.855636594642107,37.9164343322441,0.08434735122986525,1467.9707329273224,565.1104803085327,1357.0647583007812,33105,8799,24306,24306,0,12,8622000.0
8622,8622999,20.855146088383634,37.9155355115945,0.08433981208888552,1468.1009533405304,565.1770911216736,1357.3944129943848,33105,8799,24306,24306,0,12,8623000.0
8623,8623999,20.854506869977072,37.91446307260594,0.0843407413157129,1468.545710325241,565.2449111938477,1357.356990814209,33113,8803,24310,24310,0,12,8624000.0
8624,8624999,20.853906285375984,37.91323129315952,0.08433736508183065,1468.9133524894714,565.3136723041534,1357.492332458496,33119,8806,24313,24313,0,12,8625000.0
8625,8625999,20.853217139586256,37.91230702771733,0.08433634628277797,1469.1996059417725,565.3803534507751,1357.6323890686035,33123,8808,24315,24315,0,12,8626000.0
8626,8626999,20.852734913051187,37.91230513363486,0.0843307519675438,1469.3587245941162,565.4573729038239,1357.8452529907227,33123,8808,24315,24315,0,12,8627000.0
8627,8627999,20.85235181454918,37.913481765839265,0.08431677903055468,1469.5743072032928,565.5268578529358,1357.9694633483887,33125,8809,24316,24316,0,12,8628000.0
8628,8628999,20.851976717980154,37.91292660506534,0.08431258181450763,1469.7063076496124,565.5934569835663,1358.1660079956055,33125,8809,24316,24316,0,12,8629000.0
8629,8629999,20.851733656193353,37.914317337689916,0.08429776317251414,1470.1675536632538,565.6609621047974,1358.021167755127,33137,8813,24324,24324,0,12,8630000.0
8630,8630999,20.851412551106325,37.913599929038696,0.08429373764999426,1470.3034126758575,565.7282421588898,1358.250862121582,33137,8813,24324,24324,0,12,8631000.0
8631,8631999,20.85124485558605,37.913116891251015,0.08428926427106886,1470.5180759429932,565.7953581809998,1358.3770790100098,33139,8814,24325,24325,0,12,8632000.0
8632,8632999,20.850971286681464,37.91244028065935,0.08428645011873181,1470.660028219223,565.8642010688782,1358.5667724609375,33139,8814,24325,24325,0,12,8633000.0
8633,8633999,20.850842343980517,37.9119829582287,0.08428148618028797,1470.873750448227,565.9306228160858,1358.640609741211,33141,8815,24326,24326,0,12,8634000.0
8634,8634999,20.850840319927023,37.9116513943873,0.0842727498830983,1471.0202474594116,565.9976980686188,1358.7934036254883,33141,8815,24326,24326,0,12,8635000.0
8635,8635999,20.850765031008784,37.9112601426233,0.08426682256752127,1471.2517864704132,566.0650410652161,1358.862621307373,33143,8816,24327,24327,0,12,8636000.0
8636,8636999,20.850519479848106,37.91036006287225,0.08426415520068198,1471.3802409172058,566.1313195228577,1358.969093322754,33143,8816,24327,24327,0,12,8637000.0
8637,8637999,20.850336188059725,37.909753764566126,0.08425972228293754,1471.5366446971893,566.1976222991943,1359.1001892089844,33143,8816,24327,24327,0,12,8638000.0
8638,8638999,20.849870704686694,37.909264477115876,0.08425409275745266,1471.7646028995514,566.2636280059814,1359.8501358032227,33156,8817,24339,24339,0,12,8639000.0
8639,8639999,20.848980790266992,37.90834523916272,0.08425371280028171,1471.977164030075,566.328934431076,1360.328182220459,33160,8818,24342,24342,0,12,8640000.0
8640,8640999,20.847988569556037,37.90695128498013,0.08425801453545723,1472.100507259369,566.3946626186371,1360.6222190856934,33160,8818,24342,24342,0,12,8641000.0
8641,8641999,20.847233484644953,37.90608393955187,0.08425610215002555,1472.3166236877441,566.4617354869843,1360.877052307129,33162,8819,24343,24343,0,12,8642000.0
8642,8642999,20.84634988822487,37.904859373782294,0.08425738301569952,1472.8270282745361,566.5275189876556,1360.7858085632324,33173,8824,24349,24349,0,12,8643000.0
8643,8643999,20.845539918754206,37.903649175537126,0.08426019064236712,1473.031331539154,566.5933244228363,1361.0157775878906,33175,8825,24350,24350,0,12,8644000.0
8644,8644999,20.844776981913725,37.90257939498189,0.08425974425180471,1473.2396109104156,566.6594383716583,1361.1650848388672,33177,8826,24351,24351,0,12,8645000.0
8645,8645999,20.844007395273728,37.90125943817682,0.08426054896565649,1473.699658870697,566.7269084453583,1361.1584396362305,33185,8830,24355,24355,0,12,8646000.0
8646,8646999,20.84316739022116,37.899764463042374,0.08426331201964365,1474.06769156456,566.7939894199371,1361.1801109313965,33191,8833,24358,24358,0,12,8647000.0
8647,8647999,20.842426569492552,37.898369635534465,0.08426485391943117,1474.3502180576324,566.8624103069305,1361.31498336792,33195,8835,24360,24360,0,12,8648000.0
8648,8648999,20.84166842659809,37.896909004940774,0.08426719130114035,1474.5609402656555,566.9280180931091,1361.5554313659668,33197,8836,24361,24361,0,12,8649000.0
8649,8649999,20.841017921194506,37.895813216660585,0.08426378653310318,1474.759489774704,566.9942882061005,1361.71337890625,33199,8837,24362,24362,0,12,8650000.0
8650,8650999,20.84051758416807,37.8948937685619,0.08425608587180522,1474.894618988037,567.0604186058044,1361.9131507873535,33199,8837,24362,24362,0,12,8651000.0
8651,8651999,20.84005362239032,37.89421910943745,0.0842459849477758,1475.129142522812,567.128983259201,1361.9817581176758,33201,8838,24363,24363,0,12,8652000.0
8652,8652999,20.83951937438223,37.89313339338921,0.08424147485871414,1475.3425459861755,567.1953341960907,1362.083896636963,33204,8839,24365,24365,0,12,8653000.0
8653,8653999,20.839144665055898,37.89227002601809,0.08423268228505965,1475.5585768222809,567.2620327472687,1362.196865081787,33206,8840,24366,24366,0,12,8654000.0
8654,8654999,20.83890828292927,37.89167132971006,0.08422333447533048,1475.7694728374481,567.3284349441528,1362.278476715088,33208,8841,24367,24367,0,12,8655000.0
8655,8655999,20.838598317788346,37.890776316577416,0.08421540212127765,1476.0762522220612,567.3946650028229,1362.272373199463,33212,8843,24369,24369,0,12,8656000.0
8656,8656999,20.838284417908884,37.89007395243649,0.08421161005238831,1476.287901878357,567.4631340503693,1362.3432388305664,33215,8844,24371,24371,0,12,8657000.0
8657,8657999,20.83809680448533,37.88936741779024,0.08420729821670114,1476.4342939853668,567.528263092041,1362.4721031188965,33215,8844,24371,24371,0,12,8658000.0
8658,8658999,20.837622833070885,37.8883096496641,0.08420158276528111,1476.5674841403961,567.5931870937347,1362.6211013793945,33215,8844,24371,24371,0,12,8659000.0
8659,8659999,20.837051642666147,37.88778983376602,0.08419573957296012,1476.694757938385,567.6597528457642,1363.66011428833,33227,8844,24383,24383,0,12,8660000.0
8660,8660999,20.836436689614832,37.88720307605409,0.0841879282100011,1477.0560534000397,567.7265927791595,1363.8283576965332,33234,8847,24387,24387,0,12,8661000.0
8661,8661999,20.83575033964087,37.88604843803719,0.08418455315310625,1477.179426908493,567.7913904190063,1364.0921745300293,33234,8847,24387,24387,0,12,8662000.0
8662,8662999,20.835374266318432,37.88607356014677,0.08417353925479054,1477.2989983558655,567.8558084964752,1364.3777351379395,33234,8847,24387,24387,0,12,8663000.0
8663,8663999,20.83478500428681,37.884719084002334,0.08417073721421531,1477.729142665863,567.9223492145538,1364.3587684631348,33243,8851,24392,24392,0,12,8664000.0
8664,8664999,20.83421181695406,37.883438550353056,0.08416737901693616,1477.9268641471863,567.9881603717804,1364.5236701965332,33245,8852,24393,24393,0,12,8665000.0
8665,8665999,20.833756382045557,37.88237612867197,0.08416194303143754,1478.0699772834778,568.060070514679,1364.7495880126953,33245,8852,24393,24393,0,12,8666000.0
8666,8666999,20.833365680752546,37.88127933222795,0.08415183949157956,1478.5042502880096,568.1259279251099,1364.6750831604004,33254,8856,24398,24398,0,12,8667000.0
8667,8667999,20.833095533866064,37.88096201668413,0.08413877760786148,1478.7197329998016,568.194128036499,1364.8273162841797,33257,8857,24400,24400,0,12,8668000.0
8668,8668999,20.832715257784614,37.87980307727854,0.08413185414595448,1478.8462488651276,568.2594525814056,1365.0380783081055,33257,8857,24400,24400,0,12,8669000.0
8669,8669999,20.83231998366368,37.8787056077295,0.08412513477163142,1478.99423289299,568.3335950374603,1365.195182800293,33257,8857,24400,24400,0,12,8670000.0
8670,8670999,20.832026192833002,37.87771219111791,0.08411548930966073,1479.2751610279083,568.3990476131439,1365.165283203125,33261,8859,24402,24402,0,12,8671000.0
8671,8671999,20.83188645673263,37.87701100601639,0.08410633993113614,1479.7447474002838,568.4654543399811,1365.037197113037,33269,8863,24406,24406,0,12,8672000.0
8672,8672999,20.831845081647746,37.87646901147947,0.08409794713698171,1479.947907447815,568.5327870845795,1365.1237678527832,33271,8864,24407,24407,0,12,8673000.0
8673,8673999,20.83176774760615,37.875788450125015,0.08409019269216311,1480.1525106430054,568.5990397930145,1365.2451133728027,33273,8865,24408,24408,0,12,8674000.0
8674,8674999,20.831834937505793,37.87523263633839,0.08407793544094344,1480.3665616512299,568.6647388935089,1365.3213920593262,33275,8866,24409,24409,0,12,8675000.0
8675,8675999,20.83214198342357,37.874931853041275,0.08406702681675549,1480.590406179428,568.7314841747284,1365.4529495239258,33277,8867,24410,24410,0,12,8676000.0
8676,8676999,20.832310835660728,37.87463857358157,0.08405809640093798,1480.8066275119781,568.7975420951843,1365.5130653381348,33279,8868,24411,24411,0,12,8677000.0
8677,8677999,20.832379134763197,37.874166540747964,0.08405137277295549,1480.9608976840973,568.87242436409,1365.61323928833,33279,8868,24411,24411,0,12,8678000.0
8678,8678999,20.83232417383665,37.8733768257526,0.08404703745638697,1481.173130273819,568.9390506744385,1365.6776161193848,33281,8869,24412,24412,0,12,8679000.0
8679,8679999,20.832397199164927,37.872828661101536,0.0840397066723646,1481.302333831787,569.0055301189423,1366.358081817627,33292,8869,24423,24423,0,12,8680000.0
8680,8680999,20.832558921414567,37.873383593063345,0.08402513111707188,1481.585695028305,569.0719749927521,1366.8347091674805,33300,8871,24429,24429,0,12,8681000.0
8681,8681999,20.83259069871053,37.87346662996494,0.08401143499917985,1481.8621292114258,569.1377284526825,1367.0771408081055,33305,8873,24432,24432,0,12,8682000.0
8682,8682999,20.8326752880403,37.873235210773146,0.08400097796367789,1482.134753227234,569.2035536766052,1367.316505432129,33309,8875,24434,24434,0,12,8683000.0
8683,8683999,20.832883085331655,37.8737236096476,0.08398843745460505,1482.33403134346,569.2696053981781,1367.6141815185547,33311,8876,24435,24435,0,12,8684000.0
8684,8684999,20.83333958709805,37.874250518528406,0.0839749733745051,1482.6865544319153,569.3380734920502,1367.7338981628418,33318,8879,24439,24439,0,12,8685000.0
8685,8685999,20.83354047999382,37.874621136724016,0.08396159202564013,1482.80988240242,569.4047996997833,1367.9745445251465,33318,8879,24439,24439,0,12,8686000.0
8686,8686999,20.83390277692272,37.87577432133061,0.08394567364165861,1483.1026525497437,569.4723057746887,1368.0823669433594,33322,8881,24441,24441,0,12,8687000.0
8687,8687999,20.83431731862956,37.87602106254329,0.08394132850331715,1483.4690148830414,569.5401101112366,1368.1392364501953,33328,8884,24444,24444,0,12,8688000.0
8688,8688999,20.835018400738786,37.878445150312054,0.08392862905859866,1483.9085485935211,569.6073808670044,1368.1355094909668,33336,8888,24448,24448,0,12,8689000.0
8689,8689999,20.835691665733368,37.87940429607584,0.08393205264087167,1484.1989109516144,569.6735455989838,1368.2387619018555,33340,8890,24450,24450,0,12,8690000.0
8690,8690999,20.83692350594221,37.88159121220327,0.08394449251746672,1484.3275725841522,569.7416026592255,1368.4626007080078,33340,8890,24450,24450,0,12,8691000.0
8691,8691999,20.838231904444456,37.884176349649614,0.083968269809792,1484.5416736602783,569.8141031265259,1368.584342956543,33342,8891,24451,24451,0,12,8692000.0
8692,8692999,20.83944103500129,37.886011051073105,0.08399348723780731,1484.8427829742432,569.8811571598053,1368.6443634033203,33346,8893,24453,24453,0,12,8693000.0
8693,8693999,20.841092502579922,37.890007012467976,0.08402567842900333,1485.0536444187164,569.9481272697449,1368.7768211364746,33348,8894,24454,24454,0,12,8694000.0
8694,8694999,20.842524004549468,37.89269005488894,0.08405677183337046,1485.2680826187134,570.0161254405975,1368.941249847412,33350,8895,24455,24455,0,12,8695000.0
8695,8695999,20.843518119675768,37.894307653536565,0.08407822420139333,1485.4017074108124,570.0818474292755,1369.1296081542969,33350,8895,24455,24455,0,12,8696000.0
8696,8696999,20.844438454827653,37.8957795539243,0.08409150516990016,1485.541983127594,570.1473684310913,1369.7179832458496,33357,8895,24462,24462,0,12,8697000.0
8697,8697999,20.84417528754396,37.89537638820992,0.08407890687946395,1485.7398114204407,570.2132546901703,1370.2024421691895,33364,8896,24468,24468,0,12,8698000.0
8698,8698999,20.84411817294722,37.8952656473878,0.08406911318917343,1485.864317893982,570.2795219421387,1370.5075607299805,33364,8896,24468,24468,0,12,8699000.0
8699,8699999,20.84376202071611,37.89437593709009,0.08406037504574948,1485.9887464046478,570.3435814380646,1370.7423095703125,33364,8896,24468,24468,0,12,8700000.0
8700,8700999,20.84352188163563,37.89385878545109,0.084050895309841,1486.3345305919647,570.4099032878876,1370.8714714050293,33381,8899,24482,24482,0,12,8701000.0
8701,8701999,20.843071760103065,37.8927598278872,0.08404401637938808,1486.7164959907532,570.4825811386108,1370.9398231506348,33387,8902,24485,24485,0,12,8702000.0
8702,8702999,20.842552603472086,37.89144434903596,0.08403753730501606,1487.0845913887024,570.548535823822,1370.9699821472168,33394,8905,24489,24489,0,12,8703000.0
8703,8703999,20.84227500083759,37.890568389652955,0.0840301803298732,1487.3038353919983,570.6151766777039,1371.064811706543,33397,8906,24491,24491,0,12,8704000.0
8704,8704999,20.84202110213917,37.88973596243075,0.08402202411743054,1487.508172750473,570.680593252182,1371.2280731201172,33399,8907,24492,24492,0,12,8705000.0
8705,8705999,20.84183799412409,37.88907596139609,0.08401320531084888,1487.7178165912628,570.7470438480377,1371.3502349853516,33401,8908,24493,24493,0,12,8706000.0
8706,8706999,20.841827278438913,37.889025436449145,0.08400256635677283,1487.9190847873688,570.8121049404144,1371.458511352539,33403,8909,24494,24494,0,12,8707000.0
8707,8707999,20.84176581530244,37.888362159660076,0.08399400292567927,1488.2015595436096,570.8788485527039,1371.545207977295,33408,8911,24497,24497,0,12,8708000.0
8708,8708999,20.841732708052504,37.88765916518784,0.0839866179618447,1488.4112122058868,570.9440176486969,1371.5914306640625,33414,8912,24502,24502,0,12,8709000.0
8709,8709999,20.842008221762946,37.887743625245115,0.08397691895541204,1488.6204452514648,571.0097618103027,1371.6984977722168,33416,8913,24503,24503,0,12,8710000.0
8710,8710999,20.84217542295425,37.88744029094634,0.08397021062812615,1488.911574602127,571.0760898590088,1371.819149017334,33420,8915,24505,24505,0,12,8711000.0
8711,8711999,20.842239020849995,37.887271128372255,0.08396596209442186,1489.2052397727966,571.1426303386688,1371.8840408325195,33425,8917,24508,24508,0,12,8712000.0
8712,8712999,20.842533851501585,37.88703096340025,0.08396393701635829,1489.4156155586243,571.2085659503937,1372.0529708862305,33427,8918,24509,24509,0,12,8713000.0
8713,8713999,20.842755245321893,37.88702837430713,0.08396199107613345,1489.6256394386292,571.2749736309052,1372.216293334961,33429,8919,24510,24510,0,12,8714000.0
8714,8714999,20.843128052094585,37.887018316523786,0.08395907591950669,1489.8410263061523,571.3408002853394,1372.3679237365723,33459,8920,24539,24539,0,12,8715000.0
8715,8715999,20.843195764439397,37.88657381419667,0.08395556029939111,1490.0576210021973,571.4056403636932,1372.4725608825684,33461,8921,24540,24540,0,12,8716000.0
8716,8716999,20.84369675319798,37.8875133079978,0.08387905480884672,1490.1751203536987,571.4709076881409,1373.4227714538574,33475,8921,24554,24554,0,12,8717000.0
8717,8717999,20.843773173985397,37.88754911684439,0.08383140785738152,1490.2930743694305,571.5353524684906,1373.8955764770508,33476,8921,24555,24555,0,12,8718000.0
8718,8718999,20.843844624196645,37.88717585960848,0.08378868043338372,1490.5646357536316,571.5999281406403,1374.0487213134766,33480,8923,24557,24557,0,12,8719000.0
8719,8719999,20.84397260158876,37.886800641321116,0.08375315146436202,1490.7617771625519,571.665506362915,1374.2969818115234,33482,8924,24558,24558,0,12,8720000.0
8720,8720999,20.843747771307687,37.88609328646778,0.08373227068830746,1490.8869998455048,571.732451915741,1374.5434112548828,33482,8924,24558,24558,0,12,8721000.0
8721,8721999,20.84357720229452,37.88527517902607,0.08370060956530734,1491.1595826148987,571.7970683574677,1374.591121673584,33486,8926,24560,24560,0,12,8722000.0
8722,8722999,20.84340158101709,37.88466394665564,0.08367748893443228,1491.5324819087982,571.8629949092865,1374.6434288024902,33492,8929,24563,24563,0,12,8723000.0
8723,8723999,20.843198202393044,37.88363351808478,0.08365589446879096,1491.891429424286,571.9288284778595,1374.7833251953125,33498,8932,24566,24566,0,12,8724000.0
8724,8724999,20.843174425489945,37.883327149282955,0.08363420374446173,1492.0948011875153,571.995418548584,1375.0079498291016,33500,8933,24567,24567,0,12,8725000.0
8725,8725999,20.842950322626542,37.88234582869546,0.08361944111271247,1492.6938905715942,572.0632789134979,1374.8672485351562,33512,8939,24573,24573,0,12,8726000.0
8726,8726999,20.8428158706955,37.88144966845476,0.08360257347079603,1493.1403412818909,572.1321325302124,1374.8293685913086,33521,8943,24578,24578,0,12,8727000.0
8727,8727999,20.84270076261814,37.88070626820909,0.08358584935312885,1493.275291442871,572.198771238327,1375.080795288086,33521,8943,24578,24578,0,12,8728000.0
8728,8728999,20.842555885525083,37.879941530208214,0.08357433966504757,1493.400200843811,572.26433634758,1375.314598083496,33521,8943,24578,24578,0,12,8729000.0
8729,8729999,20.842735313456696,37.87975386795835,0.08356034673116186,1493.608083486557,572.330619096756,1375.4251251220703,33523,8944,24579,24579,0,12,8730000.0
8730,8730999,20.842836366301224,37.87924242128244,0.08354645499168789,1493.8265812397003,572.3967332839966,1375.5482139587402,33525,8945,24580,24580,0,12,8731000.0
8731,8731999,20.842911922634194,37.878725055810165,0.08353724540230878,1494.0304155349731,572.4630823135376,1375.62553024292,33527,8946,24581,24581,0,12,8732000.0
8732,8732999,20.843213797459285,37.87852416381953,0.08352299312012235,1494.2468848228455,572.5299007892609,1375.7862663269043,33529,8947,24582,24582,0,12,8733000.0
8733,8733999,20.843463171647194,37.87821184210009,0.0835169840314226,1494.4556658267975,572.5970380306244,1375.8738059997559,33531,8948,24583,24583,0,12,8734000.0
8734,8734999,20.84350727318577,37.8775388739409,0.08350876811997321,1494.658974647522,572.6632726192474,1375.9779319763184,33543,8949,24594,24594,0,12,8735000.0
8735,8735999,20.843628496608705,37.87717010819692,0.08350053936779955,1494.8654022216797,572.7306437492371,1376.0888900756836,33545,8950,24595,24595,0,12,8736000.0
8736,8736999,20.84375547735874,37.877488747666355,0.08348075599592131,1494.9965362548828,572.7974233627319,1376.9563598632812,33557,8950,24607,24607,0,12,8737000.0
8737,8737999,20.844403620264064,37.880372910626434,0.08345451391631797,1495.3526928424835,572.863404750824,1377.3174057006836,33566,8953,24613,24613,0,12,8738000.0
8738,8738999,20.84465921484713,37.88150087074519,0.083436533120952,1495.4668493270874,572.9298102855682,1377.6367988586426,33566,8953,24613,24613,0,12,8739000.0
8739,8739999,20.845458202079467,37.88484875501505,0.08342457134347148,1495.6681833267212,572.996086359024,1377.8194313049316,33568,8954,24614,24614,0,12,8740000.0
8740,8740999,20.84623223172972,37.887239481270754,0.08340491815569628,1495.9571135044098,573.0615386962891,1378.0268630981445,33572,8956,24616,24616,0,12,8741000.0
8741,8741999,20.8469565847742,37.89044129107383,0.08339184643728748,1496.0749335289001,573.12686419487,1378.2588424682617,33572,8956,24616,24616,0,12,8742000.0
8742,8742999,20.848024563247403,37.89426517902949,0.08337780298189212,1496.367918729782,573.194216966629,1378.3501167297363,33576,8958,24618,24618,0,12,8743000.0
8743,8743999,20.84878061639612,37.89630744148657,0.0833704097795861,1496.5762956142426,573.260354757309,1378.5085678100586,33578,8959,24619,24619,0,12,8744000.0
8744,8744999,20.84964688577855,37.89851514351614,0.0833732823660176,1496.8786118030548,573.3281841278076,1378.5389938354492,33582,8961,24621,24621,0,12,8745000.0
8745,8745999,20.850521666541304,37.90043921044012,0.08337168738790868,1497.1729381084442,573.3941991329193,1378.5444030761719,33586,8963,24623,24623,0,12,8746000.0
8746,8746999,20.85152225459506,37.90203260718614,0.08337317399620103,1497.37379860878,573.4600160121918,1378.6385879516602,33588,8964,24624,24624,0,12,8747000.0
8747,8747999,20.852524465650358,37.9056529847664,0.08337495946486828,1497.5906748771667,573.525562286377,1378.7074966430664,33590,8965,24625,24625,0,12,8748000.0
8748,8748999,20.853853684106078,37.90784001124017,0.08338214540083633,1498.0442290306091,573.592809677124,1378.5778541564941,33598,8969,24629,24629,0,12,8749000.0
8749,8749999,20.854899749094436,37.90937817240718,0.08339562248666321,1498.2474508285522,573.6592955589294,1378.7377319335938,33600,8970,24630,24630,0,12,8750000.0
8750,8750999,20.856260957381334,37.9117149614858,0.08340832182919022,1498.6041009426117,573.7253849506378,1378.667568206787,33607,8973,24634,24634,0,12,8751000.0
8751,8751999,20.857745928770267,37.91412694495682,0.08342504083454327,1498.7388751506805,573.7917637825012,1378.8924522399902,33607,8973,24634,24634,0,12,8752000.0
8752,8752999,20.859089220345403,37.91602463316318,0.0834391033082511,1498.8588786125183,573.8578383922577,1379.0554733276367,33607,8973,24634,24634,0,12,8753000.0
8753,8753999,20.86034178661713,37.91740960494925,0.08344182601689032,1499.1637859344482,573.9248151779175,1379.051986694336,33611,8975,24636,24636,0,12,8754000.0
8754,8754999,20.860558286113857,37.91731946633603,0.08343833497036524,1499.2852892875671,573.9911453723907,1379.8532066345215,33623,8975,24648,24648,0,12,8755000.0
8755,8755999,20.860423520813203,37.91826670350449,0.08342038702508026,1499.5615494251251,574.0576448440552,1380.3220138549805,33630,8977,24653,24653,0,12,8756000.0
8756,8756999,20.860107456192683,37.917637574006896,0.0834101187738977,1499.910509109497,574.1246316432953,1380.5456886291504,33637,8980,24657,24657,0,12,8757000.0
8757,8757999,20.860083817223444,37.9186157674145,0.0833960561672149,1500.1234438419342,574.1919124126434,1380.8702392578125,33639,8981,24658,24658,0,12,8758000.0
8758,8758999,20.859832945272274,37.91823511697307,0.08338905123252305,1500.3296067714691,574.2588548660278,1381.108455657959,33641,8982,24659,24659,0,12,8759000.0
8759,8759999,20.85981326235361,37.917831948631516,0.08338387163818106,1500.5324680805206,574.3261489868164,1381.269832611084,33643,8983,24660,24660,0,12,8760000.0
8760,8760999,20.85983891262774,37.91747218709596,0.08337697755250306,1500.8859975337982,574.3933227062225,1381.4351654052734,33649,8986,24663,24663,0,12,8761000.0
8761,8761999,20.860002233648057,37.917474083254795,0.08337198343427232,1501.3291716575623,574.4597828388214,1381.4573364257812,33667,8990,24677,24677,0,12,8762000.0
8762,8762999,20.86062361785342,37.91863368780228,0.08336576190314571,1501.540908575058,574.5268507003784,1381.6608963012695,33669,8991,24678,24678,0,12,8763000.0
8763,8763999,20.86162678254626,37.92063611803248,0.08336693792532168,1501.6625592708588,574.5920996665955,1381.952278137207,33669,8991,24678,24678,0,12,8764000.0
8764,8764999,20.86258946360953,37.92227892830956,0.08337486780509973,1501.9506471157074,574.6583580970764,1381.9884071350098,33674,8993,24681,24681,0,12,8765000.0
8765,8765999,20.863875287062417,37.924412874172184,0.08339250041030988,1502.216549396515,574.7485110759735,1382.1120376586914,33676,8994,24682,24682,0,12,8766000.0
8766,8766999,20.86531780266355,37.9271817365874,0.08340576956833756,1502.419312953949,574.8152585029602,1382.2628326416016,33678,8995,24683,24683,0,12,8767000.0
8767,8767999,20.866832430939173,37.92999072291738,0.08342330527945485,1502.5535032749176,574.882392168045,1382.4818496704102,33678,8995,24683,24683,0,12,8768000.0
8768,8768999,20.86857466884074,37.93294341658478,0.08345112599798299,1502.9185416698456,574.9489576816559,1382.5050926208496,33690,8998,24692,24692,0,12,8769000.0
8769,8769999,20.870491617291673,37.93609766172377,0.08349417882069932,1503.2112262248993,575.0176832675934,1382.580654144287,33694,9000,24694,24694,0,12,8770000.0
8770,8770999,20.872814220389813,37.941454173309715,0.08352545282644364,1503.425473690033,575.0854723453522,1382.7837753295898,33696,9001,24695,24695,0,12,8771000.0
8771,8771999,20.874530808591327,37.943948418521806,0.08356884445740653,1503.6390500068665,575.1519730091095,1382.8789901733398,33698,9002,24696,24696,0,12,8772000.0
8772,8772999,20.87641328978967,37.94692517480432,0.0836144961956432,1503.7672436237335,575.2189054489136,1383.0271797180176,33698,9002,24696,24696,0,12,8773000.0
8773,8773999,20.87824211140681,37.9495201395676,0.08365268265236969,1504.2140538692474,575.2884976863861,1382.9102210998535,33707,9006,24701,24701,0,13,8774000.0
8774,8774999,20.878691680126924,37.94954017112468,0.08365330430224305,1504.5050830841064,575.3555636405945,1383.6597518920898,33724,9008,24716,24716,0,13,8775000.0
8775,8775999,20.87840409754722,37.94988311350211,0.0836448374217732,1504.6281685829163,575.4214549064636,1384.2020416259766,33725,9008,24717,24717,0,13,8776000.0
8776,8776999,20.87798526424496,37.94885642194923,0.08364086780662017,1504.9702835083008,575.5062494277954,1384.40718460083,33738,9010,24728,24728,0,13,8777000.0
8777,8777999,20.877589819516178,37.94799950523372,0.0836377645494839,1505.3277928829193,575.5728588104248,1384.5783424377441,33744,9013,24731,24731,0,13,8778000.0
8778,8778999,20.87716111296164,37.946984842177265,0.08363249482755797,1505.5272915363312,575.6389288902283,1384.8210220336914,33746,9014,24732,24732,0,13,8779000.0
8779,8779999,20.87683674097462,37.94615926584332,0.08362741688090658,1505.7266116142273,575.7047772407532,1385.011074066162,33748,9015,24733,24733,0,13,8780000.0
8780,8780999,20.876650747216402,37.94565677843042,0.08362139273503111,1505.9230253696442,575.7695753574371,1385.1859169006348,33750,9016,24734,24734,0,13,8781000.0
8781,8781999,20.876502751467235,37.94512200593785,0.0836205950156057,1506.2911846637726,575.8366718292236,1385.2363929748535,33756,9019,24737,24737,0,13,8782000.0
8782,8782999,20.87643712100296,37.94480895693238,0.08361342800064098,1506.5039670467377,575.9039301872253,1385.411693572998,33758,9020,24738,24738,0,13,8783000.0
8783,8783999,20.87639982327481,37.944348232989164,0.08361315462472552,1506.6432979106903,575.9696772098541,1385.6225204467773,33758,9020,24738,24738,0,13,8784000.0
8784,8784999,20.876435787292714,37.944114493930044,0.08361642145002934,1506.854233264923,576.0839080810547,1385.7780151367188,33758,9020,24738,24738,0,13,8785000.0
8785,8785999,20.87657766499484,37.944287445611494,0.08362121858847571,1506.977029800415,576.1504588127136,1385.891788482666,33758,9020,24738,24738,0,13,8786000.0
8786,8786999,20.876814753166414,37.944538379495526,0.08361794618211482,1507.118902206421,576.2159261703491,1386.0289840698242,33758,9020,24738,24738,0,13,8787000.0
8787,8787999,20.87705621180291,37.944864698043894,0.08361417363100332,1507.343248128891,576.2822182178497,1386.08646774292,33760,9021,24739,24739,0,13,8788000.0
8788,8788999,20.87718627251993,37.94474578745455,0.08361400107349026,1507.7943012714386,576.3499324321747,1385.8811645507812,33770,9025,24745,24745,0,13,8789000.0
8789,8789999,20.877599890052956,37.94524943148197,0.08362086146842462,1508.0040078163147,576.4171373844147,1386.0845832824707,33772,9026,24746,24746,0,13,8790000.0
8790,8790999,20.87812812068535,37.94594423400366,0.08362306904537409,1508.3631904125214,576.4829752445221,1386.0626983642578,33778,9029,24749,24749,0,13,8791000.0
8791,8791999,20.87859263719396,37.94633566383695,0.08362804746358654,1508.6646428108215,576.5496504306793,1386.1107635498047,33782,9031,24751,24751,0,13,8792000.0
8792,8792999,20.87890277600709,37.94643414613006,0.08363423301908868,1508.8835134506226,576.6172597408295,1386.2409782409668,33794,9032,24762,24762,0,13,8793000.0
8793,8793999,20.879162084477336,37.946393938255625,0.08363969763675227,1509.0897488594055,576.684567451477,1386.3316955566406,33796,9033,24763,24763,0,13,8794000.0
8794,8794999,20.879434805691787,37.9460425344517,0.08363715543378625,1509.2163166999817,576.7502183914185,1386.6556434631348,33799,9033,24766,24766,0,13,8795000.0
8795,8795999,20.87955333083585,37.95070700410847,0.08357489674790364,1509.4163053035736,576.8178961277008,1387.3926239013672,33809,9034,24775,24775,0,13,8796000.0
8796,8796999,20.879133855828314,37.94983346962693,0.08356092397818626,1509.6244010925293,576.8835535049438,1387.7061653137207,33813,9035,24778,24778,0,13,8797000.0
8797,8797999,20.878921685774465,37.95031250729371,0.08355045225840796,1509.911343574524,576.94899725914,1387.838150024414,33817,9037,24780,24780,0,13,8798000.0
8798,8798999,20.878842556264352,37.950118604027075,0.08354019814116065,1510.2842235565186,577.0163884162903,1387.9705085754395,33834,9040,24794,24794,0,13,8799000.0
8799,8799999,20.878758686182582,37.949642995792956,0.08353302574584487,1510.4808990955353,577.0817580223083,1388.1237030029297,33836,9041,24795,24795,0,13,8800000.0
8800,8800999,20.87838879419922,37.948710112544916,0.0835338746681471,1510.6868352890015,577.1477787494659,1388.3371315002441,33838,9042,24796,24796,0,13,8801000.0
8801,8801999,20.8784649280638,37.95068124516349,0.08351589520248592,1511.2325205802917,577.2162249088287,1388.3022918701172,33849,9047,24802,24802,0,13,8802000.0
8802,8802999,20.87842209577045,37.950075474927374,0.08351659749273455,1511.534438610077,577.2831044197083,1388.4304962158203,33853,9049,24804,24804,0,13,8803000.0
8803,8803999,20.878558802593332,37.950181170907605,0.08355380548319613,1511.6664824485779,577.3498251438141,1388.6713371276855,33853,9049,24804,24804,0,13,8804000.0
8804,8804999,20.879177095030098,37.95110892384895,0.08358770312951291,1511.8649797439575,577.4155275821686,1388.7676391601562,33855,9050,24805,24805,0,13,8805000.0
8805,8805999,20.879611722865832,37.95181375239965,0.08361871940912524,1512.0120327472687,577.4822475910187,1388.9459648132324,33855,9050,24805,24805,0,13,8806000.0
8806,8806999,20.880161918363196,37.95258961802915,0.08363468956389064,1512.1371748447418,577.5489974021912,1389.096622467041,33855,9050,24805,24805,0,13,8807000.0
8807,8807999,20.880752482537513,37.954388569275196,0.08367955970327678,1512.344444513321,577.6161131858826,1389.1494789123535,33858,9051,24807,24807,0,13,8808000.0
8808,8808999,20.881336604470132,37.954920899339264,0.0837009435673628,1512.5814967155457,577.683913230896,1389.2047729492188,33861,9052,24809,24809,0,13,8809000.0
8809,8809999,20.882155426937018,37.956727507829264,0.08372502079995447,1512.9531109333038,577.7506182193756,1389.1252365112305,33877,9055,24822,24822,0,13,8810000.0
8810,8810999,20.883392881478667,37.96058785083559,0.08375776214784969,1513.180634021759,577.8172488212585,1389.2318801879883,33879,9056,24823,24823,0,13,8811000.0
8811,8811999,20.884641421776088,37.9645718052112,0.08378565702939889,1513.474258184433,577.8840622901917,1389.1974258422852,33883,9058,24825,24825,0,13,8812000.0
8812,8812999,20.885425387985496,37.96697774660538,0.08381912848415718,1513.703246831894,577.9518384933472,1389.3208465576172,33885,9059,24826,24826,0,13,8813000.0
8813,8813999,20.886193660052218,37.96777910422474,0.08384300981460313,1513.991073846817,578.0185360908508,1389.3732566833496,33889,9061,24828,24828,0,13,8814000.0
8814,8814999,20.886733289090362,37.96855233572799,0.08382681995209662,1514.2043175697327,578.0862989425659,1390.0913848876953,33903,9062,24841,24841,0,13,8815000.0
8815,8815999,20.887002506273348,37.96909292674198,0.08381129288780853,1514.3203437328339,578.1513454914093,1390.6039199829102,33906,9062,24844,24844,0,13,8816000.0
8816,8816999,20.887357216205608,37.970056400261505,0.08379580893071503,1514.5225863456726,578.217583656311,1390.8112564086914,33908,9063,24845,24845,0,13,8817000.0
8817,8817999,20.887628795761167,37.97146383380745,0.08378523311631347,1514.7304091453552,578.2822778224945,1390.9567680358887,33910,9064,24846,24846,0,13,8818000.0
8818,8818999,20.887850297274994,37.971944458816594,0.0837784925136773,1515.387630701065,578.3785018920898,1390.8815460205078,33930,9069,24861,24861,0,13,8819000.0
8819,8819999,20.88793763733985,37.97193380451109,0.0837688017038799,1515.6723697185516,578.4462757110596,1391.1692085266113,33934,9071,24863,24863,0,13,8820000.0
8820,8820999,20.888037244101856,37.97185979509341,0.08375868170255185,1515.8952567577362,578.5136618614197,1391.381748199463,33936,9072,24864,24864,0,13,8821000.0
8821,8821999,20.888109556176076,37.97128739983612,0.08374629893817709,1516.096854686737,578.5796530246735,1391.557186126709,33938,9073,24865,24865,0,13,8822000.0
8822,8822999,20.888440846079536,37.973377589891314,0.08372373665496013,1516.4733436107635,578.6469569206238,1391.6303939819336,33944,9076,24868,24868,0,13,8823000.0
8823,8823999,20.88846814154934,37.97273346776153,0.08371326874667484,1516.7704496383667,578.713958978653,1391.699504852295,33948,9078,24870,24870,0,13,8824000.0
8824,8824999,20.888421773499587,37.97222905056607,0.0837011290154086,1516.90149974823,578.779534816742,1391.894863128662,33948,9078,24870,24870,0,13,8825000.0
8825,8825999,20.888377964599698,37.97173356798171,0.08369037894447917,1517.1860675811768,578.8461391925812,1391.861228942871,33952,9080,24872,24872,0,13,8826000.0
8826,8826999,20.888565145471635,37.97138913768822,0.0836788088028746,1517.3141343593597,578.9113492965698,1392.070571899414,33952,9080,24872,24872,0,13,8827000.0
8827,8827999,20.888615165259647,37.97085143905602,0.08366842834831056,1517.5217592716217,578.9774518013,1392.1930503845215,33964,9081,24883,24883,0,13,8828000.0
8828,8828999,20.888855227706365,37.97042197133209,0.0836533643606655,1517.7300889492035,579.0438802242279,1392.2647819519043,33966,9082,24884,24884,0,13,8829000.0
8829,8829999,20.88882463741502,37.969567070993975,0.08363647872140223,1517.9441692829132,579.1090624332428,1392.3902282714844,33968,9083,24885,24885,0,13,8830000.0
8830,8830999,20.888673704655996,37.968572650912975,0.08363135608353867,1518.0881824493408,579.1753013134003,1392.5611419677734,33968,9083,24885,24885,0,13,8831000.0
8831,8831999,20.888512346057993,37.9679099992285,0.08362019522101105,1518.2202498912811,579.2418584823608,1393.374267578125,33979,9083,24896,24896,0,13,8832000.0
8832,8832999,20.888182707459,37.967995317963194,0.08361267642998971,1518.3386285305023,579.3070273399353,1393.8703727722168,33982,9083,24899,24899,0,13,8833000.0
8833,8833999,20.887949313319098,37.96777374603485,0.08360266796943716,1518.698808670044,579.3727874755859,1393.9839324951172,33989,9086,24903,24903,0,13,8834000.0
8834,8834999,20.887445276517084,37.966564322234916,0.08359861167470983,1518.8185772895813,579.438259601593,1394.2835731506348,33989,9086,24903,24903,0,13,8835000.0
8835,8835999,20.88691451900031,37.96544119871014,0.08359504777023963,1519.1024379730225,579.5042300224304,1394.4312438964844,33995,9088,24907,24907,0,13,8836000.0
8836,8836999,20.8864320074492,37.96444543569154,0.08359103012605196,1519.4639370441437,579.5718877315521,1394.5729866027832,34001,9091,24910,24910,0,13,8837000.0
8837,8837999,20.88604912749591,37.96425444798882,0.08357794030871935,1519.6685745716095,579.6372482776642,1394.7344856262207,34003,9092,24911,24911,0,13,8838000.0
8838,8838999,20.885754171580142,37.96424990910359,0.0835632381814998,1519.954407453537,579.7038595676422,1394.8293151855469,34007,9094,24913,24913,0,13,8839000.0
8839,8839999,20.885375644847812,37.96343942142116,0.08355401956818109,1520.4032938480377,579.7730095386505,1394.822437286377,34016,9098,24918,24918,0,13,8840000.0
8840,8840999,20.88519625987693,37.96290485852851,0.08354354803675423,1520.8553988933563,579.8410613536835,1394.7349967956543,34024,9102,24922,24922,0,13,8841000.0
8841,8841999,20.88488372549772,37.96199542233588,0.08353771466913518,1521.0611126422882,579.9080600738525,1394.8823051452637,34026,9103,24923,24923,0,13,8842000.0
8842,8842999,20.884540392749546,37.96126256383704,0.0835340187391369,1521.337340593338,579.97505402565,1394.9676322937012,34030,9105,24925,24925,0,13,8843000.0
8843,8843999,20.88431861695502,37.96056713643347,0.08352569442833757,1521.6212973594666,580.0432562828064,1394.9972076416016,34034,9107,24927,24927,0,13,8844000.0
8844,8844999,20.884248252522635,37.960237747764964,0.08351785653602817,1521.9249000549316,580.109472990036,1395.0633506774902,34038,9109,24929,24929,0,13,8845000.0
8845,8845999,20.88423163038866,37.95986341342766,0.08351055308103605,1522.2054212093353,580.1764361858368,1395.2096633911133,34042,9111,24931,24931,0,13,8846000.0
8846,8846999,20.88434234717841,37.960422274887875,0.08350034896436553,1522.3378355503082,580.2422223091125,1395.432518005371,34042,9111,24931,24931,0,13,8847000.0
8847,8847999,20.884419457525805,37.960151216827356,0.08347884055137933,1522.5605816841125,580.3093647956848,1395.5491104125977,34044,9112,24932,24932,0,13,8848000.0
8848,8848999,20.88431875508352,37.95960219629026,0.08346341363893728,1522.7785313129425,580.3761484622955,1395.6341552734375,34046,9113,24933,24933,0,13,8849000.0
8849,8849999,20.884069371864936,37.958825334332,0.08345666641192162,1522.9900999069214,580.4904832839966,1395.7892303466797,34046,9113,24933,24933,0,13,8850000.0
8850,8850999,20.88377801609582,37.95803897826772,0.08343817456900471,1523.355937719345,580.5564370155334,1396.153060913086,34061,9116,24945,24945,0,13,8851000.0
8851,8851999,20.883414003497137,37.957476722810775,0.08341720237903982,1523.4813251495361,580.62184715271,1396.7116203308105,34065,9116,24949,24949,0,13,8852000.0
8852,8852999,20.88300471747795,37.95726731597926,0.08340326095533146,1523.6169743537903,580.687760591507,1397.0738220214844,34066,9116,24950,24950,0,13,8853000.0
8853,8853999,20.88245749196553,37.9559937685624,0.08339487671522294,1523.8968334197998,580.7542223930359,1397.221908569336,34070,9118,24952,24952,0,13,8854000.0
8854,8854999,20.88203050024042,37.95500310722478,0.0833844419265769,1524.0962467193604,580.8203103542328,1397.3618965148926,34072,9119,24953,24953,0,13,8855000.0
8855,8855999,20.881553069023518,37.95384981495276,0.08337497702539232,1524.3014483451843,580.8861465454102,1397.5210342407227,34074,9120,24954,24954,0,13,8856000.0
8856,8856999,20.881099539436097,37.95280616776137,0.08336619465589856,1524.7452039718628,580.9526314735413,1397.5225639343262,34083,9124,24959,24959,0,13,8857000.0
8857,8857999,20.880558557631208,37.95180765155958,0.08335896704100265,1525.195555448532,581.0200488567352,1397.4880981445312,34092,9128,24964,24964,0,13,8858000.0
8858,8858999,20.879982156059665,37.95075858456437,0.08335231270534726,1525.3205671310425,581.0873823165894,1397.767749786377,34092,9128,24964,24964,0,13,8859000.0
8859,8859999,20.879488515019734,37.94964842359577,0.08334686468630326,1525.4543416500092,581.1533331871033,1397.9877090454102,34092,9128,24964,24964,0,13,8860000.0
8860,8860999,20.87898671764449,37.94872367094254,0.08333955468003362,1525.7348639965057,581.2188830375671,1397.9484329223633,34096,9130,24966,24966,0,13,8861000.0
8861,8861999,20.87845537063628,37.947502166545604,0.08333463380625039,1526.0502789020538,581.3381741046906,1398.044490814209,34098,9131,24967,24967,0,13,8862000.0
8862,8862999,20.87803220489625,37.94637212309532,0.08332695998242856,1526.2727715969086,581.40607213974,1398.1355476379395,34100,9132,24968,24968,0,13,8863000.0
8863,8863999,20.87755258272365,37.94523460381887,0.08332127483858343,1526.3939554691315,581.4709722995758,1398.257209777832,34100,9132,24968,24968,0,13,8864000.0
8864,8864999,20.877177226007355,37.94550103674856,0.08331036694998928,1526.7171523571014,581.5370495319366,1398.2480926513672,34104,9134,24970,24970,0,13,8865000.0
8865,8865999,20.876717134238486,37.94437456522251,0.08330663827629037,1526.864761352539,581.6027488708496,1398.423915863037,34104,9134,24970,24970,0,13,8866000.0
8866,8866999,20.876300458445893,37.94327082210098,0.08330341638537497,1527.144412279129,581.6682322025299,1398.4246368408203,34108,9136,24972,24972,0,13,8867000.0
8867,8867999,20.8759238652075,37.94210650980596,0.0832995603579243,1527.3492391109467,581.7335126399994,1398.4919700622559,34110,9137,24973,24973,0,13,8868000.0
8868,8868999,20.875527197281333,37.941701046015716,0.08329456721463468,1527.5493705272675,581.7995638847351,1398.604248046875,34112,9138,24974,24974,0,13,8869000.0
8869,8869999,20.87495630492081,37.940502958440916,0.08329284249966595,1527.9121398925781,581.8657557964325,1398.5931396484375,34129,9141,24988,24988,0,13,8870000.0
8870,8870999,20.87431254345911,37.93920112593409,0.08329088069354085,1528.0629496574402,581.9419136047363,1398.7588424682617,34129,9141,24988,24988,0,13,8871000.0
8871,8871999,20.87375095068331,37.938795110784035,0.08328968023786931,1528.2690451145172,582.0075280666351,1399.6663246154785,34146,9142,25004,25004,0,13,8872000.0
8872,8872999,20.873166090251182,37.93834802221543,0.08328459367969643,1528.3962378501892,582.0731496810913,1400.1346969604492,34148,9142,25006,25006,0,13,8873000.0
8873,8873999,20.872398401513156,37.937160822258484,0.08328353527297139,1528.520567893982,582.1376526355743,1400.3811225891113,34148,9142,25006,25006,0,13,8874000.0
8874,8874999,20.872375521257766,37.93722943288967,0.08327113363605965,1528.792979001999,582.2034447193146,1400.4867858886719,34152,9144,25008,25008,0,13,8875000.0
8875,8875999,20.872151053581728,37.93688253452605,0.08326661060591456,1529.07635140419,582.2696805000305,1400.6956977844238,34156,9146,25010,25010,0,13,8876000.0
8876,8876999,20.871993450999327,37.93636666345712,0.08326681127345681,1529.2883768081665,582.3377344608307,1400.860034942627,34158,9147,25011,25011,0,13,8877000.0
8877,8877999,20.87187620739261,37.93610075299671,0.08326067069005827,1529.5786502361298,582.4042479991913,1400.9543838500977,34162,9149,25013,25013,0,13,8878000.0
8878,8878999,20.871593305643657,37.93557144094665,0.08325464313061393,1530.1176497936249,582.4718110561371,1400.9207916259766,34173,9154,25019,25019,0,13,8879000.0
8879,8879999,20.871519940858693,37.93522680923608,0.08325071097718051,1530.4970755577087,582.5388703346252,1401.0140228271484,34189,9157,25032,25032,0,13,8880000.0
8880,8880999,20.871463276127965,37.93484449405901,0.0832462429698062,1530.6227078437805,582.6063005924225,1401.2953643798828,34189,9157,25032,25032,0,13,8881000.0
8881,8881999,20.871517853914142,37.934660515763696,0.0832407997919502,1530.9198336601257,582.6740334033966,1401.390037536621,34193,9159,25034,25034,0,13,8882000.0
8882,8882999,20.871389259436643,37.93414068896452,0.08323631680332533,1531.128086090088,582.7411823272705,1401.5494117736816,34195,9160,25035,25035,0,13,8883000.0
8883,8883999,20.8713246694103,37.933646128023454,0.08323168752561894,1531.4908339977264,582.8076858520508,1401.501937866211,34201,9163,25038,25038,0,13,8884000.0
8884,8884999,20.871338115798036,37.93326848251229,0.08322964563074575,1531.6172409057617,582.8741948604584,1401.7013893127441,34201,9163,25038,25038,0,13,8885000.0
8885,8885999,20.871491913407684,37.93310745667984,0.08322294623411941,1531.8241822719574,582.9412796497345,1401.8074378967285,34203,9164,25039,25039,0,13,8886000.0
8886,8886999,20.871463670479503,37.93253107544858,0.08322055426098418,1532.0504033565521,583.0083668231964,1401.9065437316895,34205,9165,25040,25040,0,13,8887000.0
8887,8887999,20.871696233258433,37.93230294282244,0.08321795986307623,1532.2612013816833,583.0748074054718,1401.97603225708,34207,9166,25041,25041,0,13,8888000.0
8888,8888999,20.871715560708072,37.93173685565181,0.0832143293292128,1532.6182794570923,583.1410722732544,1401.9900169372559,34223,9169,25054,25054,0,13,8889000.0
8889,8889999,20.871766119496172,37.931119861176455,0.08321006582084789,1532.7530422210693,583.2082984447479,1402.1439628601074,34223,9169,25054,25054,0,13,8890000.0
8890,8890999,20.871533612109637,37.930238286292834,0.08320535325510614,1532.9111046791077,583.274819612503,1402.2884712219238,34223,9169,25054,25054,0,13,8891000.0
8891,8891999,20.87058664529504,37.928574874405285,0.08321223564579439,1533.0444004535675,583.341500043869,1403.1286849975586,34235,9169,25066,25066,0,13,8892000.0
8892,8892999,20.86961800617119,37.92735362467326,0.08321563036849966,1533.1607995033264,583.4073216915131,1403.581443786621,34238,9169,25069,25069,0,13,8893000.0
8893,8893999,20.868618761959482,37.92583051382131,0.08322060772067352,1533.381980419159,583.4730212688446,1403.7575607299805,34243,9170,25073,25073,0,13,8894000.0
8894,8894999,20.867880087605233,37.924734171137686,0.08322139185541921,1533.8123679161072,583.5395684242249,1403.7532768249512,34251,9174,25077,25077,0,13,8895000.0
8895,8895999,20.867189284390992,37.92371292998092,0.08322142633978158,1534.097272157669,583.6053802967072,1403.945644378662,34257,9176,25081,25081,0,13,8896000.0
8896,8896999,20.866531831490448,37.92299534496792,0.08321880908630841,1534.3089008331299,583.673357963562,1404.1432723999023,34259,9177,25082,25082,0,13,8897000.0
8897,8897999,20.865873227557234,37.92217657017525,0.08321817753097038,1534.5134091377258,583.7406051158905,1404.297161102295,34261,9178,25083,25083,0,13,8898000.0
8898,8898999,20.865014178211826,37.920612112918484,0.08322046220523116,1534.883740901947,583.8070344924927,1404.342185974121,34267,9181,25086,25086,0,13,8899000.0
8899,8899999,20.864255353646847,37.91917779727203,0.0832215761603049,1535.0834352970123,583.8731906414032,1404.5217552185059,34269,9182,25087,25087,0,13,8900000.0
8900,8900999,20.863705491722857,37.91813213096837,0.08322135852896084,1535.2978127002716,583.9431836605072,1404.5798416137695,34272,9183,25089,25089,0,13,8901000.0
8901,8901999,20.86318951160411,37.91883792396056,0.08321262280596142,1535.661602973938,584.0089087486267,1404.477481842041,34278,9186,25092,25092,0,13,8902000.0
8902,8902999,20.862450427807993,37.917476891372274,0.08321471803788294,1535.7944061756134,584.0755279064178,1404.7106475830078,34278,9186,25092,25092,0,13,8903000.0
8903,8903999,20.86195584604024,37.91648519435921,0.08321395738219117,1536.0991551876068,584.1420216560364,1404.7039489746094,34282,9188,25094,25094,0,13,8904000.0
8904,8904999,20.861406525715562,37.915459077978404,0.0832139262586703,1536.3927719593048,584.2093935012817,1404.7235488891602,34286,9190,25096,25096,0,13,8905000.0
8905,8905999,20.861017863550533,37.914750843370044,0.08321262992343492,1536.5240914821625,584.2751688957214,1404.9499549865723,34286,9190,25096,25096,0,13,8906000.0
8906,8906999,20.860765578755274,37.91403404860489,0.08320806107934986,1536.6491613388062,584.341322183609,1405.0866928100586,34286,9190,25096,25096,0,13,8907000.0
8907,8907999,20.86043629103889,37.91314278868875,0.08320649071620057,1536.9422755241394,584.4088125228882,1405.0903358459473,34290,9192,25098,25098,0,13,8908000.0
8908,8908999,20.860130624645038,37.91233401820201,0.08320320701824002,1537.1665284633636,584.4754106998444,1405.230266571045,34292,9193,25099,25099,0,13,8909000.0
8909,8909999,20.859721394206495,37.91137982937555,0.08320183181697127,1537.378479719162,584.5413248538971,1405.3341827392578,34304,9194,25110,25110,0,13,8910000.0
8910,8910999,20.85916616368349,37.9101992305678,0.08320097985206754,1537.515028476715,584.6078150272369,1405.4949340820312,34304,9194,25110,25110,0,13,8911000.0
8911,8911999,20.858461125414788,37.90878111064022,0.08320112110325473,1537.646305322647,584.6749157905579,1406.3423919677734,34315,9194,25121,25121,0,13,8912000.0
8912,8912999,20.857534100366625,37.90723693832311,0.08320257102764039,1537.7589769363403,584.7395269870758,1406.72806930542,34316,9194,25122,25122,0,13,8913000.0
8913,8913999,20.8567158435197,37.90597590408541,0.08320341297216705,1538.037315607071,584.8045830726624,1406.8611755371094,34320,9196,25124,25124,0,13,8914000.0
8914,8914999,20.856210408508947,37.90490411940713,0.08319835149129529,1538.3248353004456,584.871579170227,1407.0276718139648,34324,9198,25126,25126,0,13,8915000.0
8915,8915999,20.855674946546575,37.9044724802269,0.08319153093241272,1538.6087007522583,584.937591791153,1407.102653503418,34328,9200,25128,25128,0,13,8916000.0
8916,8916999,20.85493827082294,37.90316561159603,0.08319152747478942,1538.806708574295,585.0028123855591,1407.247428894043,34330,9201,25129,25129,0,13,8917000.0
8917,8917999,20.85437907352971,37.9020179579309,0.08318966587059162,1539.1072096824646,585.071106672287,1407.309455871582,34335,9203,25132,25132,0,13,8918000.0
8918,8918999,20.853808531590193,37.90122227897386,0.08318796954579522,1539.3903050422668,585.137433052063,1407.4269752502441,34339,9205,25134,25134,0,13,8919000.0
8919,8919999,20.853363326936403,37.90030057636662,0.08318816908874771,1539.6840620040894,585.2036170959473,1407.4757995605469,34344,9207,25137,25137,0,13,8920000.0
8920,8920999,20.853133852229256,37.900060584815826,0.08318994164648286,1539.905174255371,585.2686581611633,1407.57710647583,34346,9208,25138,25138,0,13,8921000.0
8921,8921999,20.852950342565137,37.899689988783905,0.08319273665437832,1540.1952857971191,585.3339779376984,1407.604232788086,34350,9210,25140,25140,0,13,8922000.0
8922,8922999,20.853087588586256,37.900199641132964,0.08319917239973296,1540.4030530452728,585.4005303382874,1407.6744499206543,34352,9211,25141,25141,0,13,8923000.0
8923,8923999,20.853122350345476,37.90063920350595,0.08319772884331833,1540.6190598011017,585.4678201675415,1407.7363777160645,34355,9212,25143,25143,0,13,8924000.0
8924,8924999,20.8534390540591,37.90145283143704,0.08320657060089243,1540.8318939208984,585.5337882041931,1407.8335418701172,34357,9213,25144,25144,0,13,8925000.0
8925,8925999,20.85408234276527,37.90290913056377,0.0832190712555485,1541.1120610237122,585.6003413200378,1407.9012413024902,34361,9215,25146,25146,0,13,8926000.0
8926,8926999,20.854701528060023,37.90427172865977,0.08323424356520848,1541.2461156845093,585.6655488014221,1408.0336723327637,34361,9215,25146,25146,0,13,8927000.0
8927,8927999,20.85541987233259,37.90581140933111,0.08324812311186969,1541.4641406536102,585.7318422794342,1408.0947227478027,34363,9216,25147,25147,0,13,8928000.0
8928,8928999,20.856416293334167,37.908343838602974,0.08325729520974468,1541.6649632453918,585.7981519699097,1408.227466583252,34375,9217,25158,25158,0,13,8929000.0
8929,8929999,20.857046654101687,37.90953141441645,0.08327213739292882,1541.806561946869,585.8629071712494,1408.3449745178223,34375,9217,25158,25158,0,13,8930000.0
8930,8930999,20.85772907750161,37.91097158051543,0.08327881439747054,1541.9326660633087,585.9272048473358,1408.503890991211,34375,9217,25158,25158,0,13,8931000.0
8931,8931999,20.85800893079168,37.91158552142815,0.08321581912698017,1542.1265819072723,585.9929940700531,1409.4236297607422,34391,9218,25173,25173,0,13,8932000.0
8932,8932999,20.858061764383375,37.91241062169314,0.08316822063940288,1542.4884371757507,586.0604727268219,1409.6405410766602,34399,9221,25178,25178,0,13,8933000.0
8933,8933999,20.857902537729796,37.91212701198533,0.08314124717992755,1542.7797331809998,586.1257700920105,1409.7947311401367,34405,9223,25182,25182,0,13,8934000.0
8934,8934999,20.85792153028198,37.91291777246043,0.08310949736423312,1542.9015228748322,586.1911633014679,1410.0899124145508,34405,9223,25182,25182,0,13,8935000.0
8935,8935999,20.857975525761454,37.912650272910106,0.08307918548636128,1543.3267731666565,586.2564091682434,1410.0675773620605,34413,9227,25186,25186,0,13,8936000.0
8936,8936999,20.858036038910793,37.91233520083647,0.08304568166201709,1543.6766080856323,586.3223576545715,1410.1557540893555,34419,9230,25189,25189,0,13,8937000.0
8937,8937999,20.858107015924006,37.91262883046098,0.08300861887343625,1543.8695018291473,586.3872196674347,1410.459129333496,34421,9231,25190,25190,0,13,8938000.0
8938,8938999,20.85828020134545,37.914551439475396,0.08296524674443306,1544.3191511631012,586.4544794559479,1410.5442924499512,34429,9235,25194,25194,0,13,8939000.0
8939,8939999,20.858635594733347,37.914771346369996,0.08292043085369061,1544.831768989563,586.5219421386719,1410.4751777648926,34439,9240,25199,25199,0,13,8940000.0
8940,8940999,20.85885498159318,37.91466718354001,0.08288732370230234,1544.9608199596405,586.5884358882904,1410.769546508789,34439,9240,25199,25199,0,13,8941000.0
8941,8941999,20.859164636823166,37.91438694681405,0.08286073123672721,1545.0909955501556,586.6531686782837,1411.0044784545898,34439,9240,25199,25199,0,13,8942000.0
8942,8942999,20.8593962749842,37.91440045277285,0.08283591724571904,1545.3789682388306,586.7196674346924,1411.0300331115723,34443,9242,25201,25201,0,13,8943000.0
8943,8943999,20.859661988331627,37.914375840726414,0.08281996435859373,1545.7445423603058,586.786613702774,1411.0339546203613,34450,9245,25205,25205,0,13,8944000.0
8944,8944999,20.860124398836053,37.91459992853255,0.0827981876237397,1545.8802826404572,586.852735042572,1411.260482788086,34450,9245,25205,25205,0,13,8945000.0
8945,8945999,20.860642536058407,37.91483037751448,0.08278125167352879,1546.1683795452118,586.9193425178528,1411.3484687805176,34464,9247,25217,25217,0,13,8946000.0
8946,8946999,20.8610873664269,37.914702485997296,0.08276358470651146,1546.380119562149,586.9852013587952,1411.433650970459,34466,9248,25218,25218,0,13,8947000.0
8947,8947999,20.86176859233549,37.915018196797824,0.08274045749592307,1546.5887734889984,587.0519518852234,1411.5814590454102,34468,9249,25219,25219,0,13,8948000.0
8948,8948999,20.86257466015773,37.91554391529448,0.08272690391119375,1546.8106315135956,587.1172230243683,1411.646198272705,34470,9250,25220,25220,0,13,8949000.0
8949,8949999,20.863101093977644,37.91569154819301,0.08271728694103297,1546.9354228973389,587.1831586360931,1411.7600631713867,34470,9250,25220,25220,0,13,8950000.0
8950,8950999,20.863630261415878,37.91623435392611,0.082708145747721,1547.0679194927216,587.2481882572174,1411.925853729248,34470,9250,25220,25220,0,13,8951000.0
8951,8951999,20.863658579643584,37.91562131732724,0.08269867425487132,1547.1950817108154,587.3130149841309,1412.6000328063965,34479,9250,25229,25229,0,13,8952000.0
8952,8952999,20.86319512248755,37.914747932008126,0.08269011729899023,1547.481120109558,587.3778214454651,1413.0721969604492,34487,9252,25235,25235,0,13,8953000.0
8953,8953999,20.862677572686795,37.914642688722914,0.08268562509217647,1547.6753187179565,587.4421014785767,1413.3501167297363,34490,9253,25237,25237,0,13,8954000.0
8954,8954999,20.862265058206948,37.9136794807758,0.08268020843574686,1547.9498472213745,587.5081059932709,1413.5886726379395,34494,9255,25239,25239,0,13,8955000.0
8955,8955999,20.861832189215242,37.91342534759946,0.08266448720771624,1548.2276029586792,587.5742104053497,1413.815128326416,34498,9257,25241,25241,0,13,8956000.0
8956,8956999,20.861406652172505,37.91328748942293,0.08265662676623398,1548.5153057575226,587.6410222053528,1413.9749908447266,34502,9259,25243,25243,0,13,8957000.0
8957,8957999,20.860985235327288,37.91224101059524,0.08264769599375188,1548.8067588806152,587.7068152427673,1414.0429039001465,34507,9261,25246,25246,0,13,8958000.0
8958,8958999,20.860505859859323,37.911122066306945,0.08264242016057899,1549.0025477409363,587.7721319198608,1414.2406539916992,34509,9262,25247,25247,0,13,8959000.0
8959,8959999,20.860108555789548,37.9101846599799,0.08263704338702504,1549.2124471664429,587.8382396697998,1414.395320892334,34511,9263,25248,25248,0,13,8960000.0
8960,8960999,20.859843943275585,37.911431930652846,0.08262183476326079,1549.416002035141,587.9043126106262,1414.5295295715332,34513,9264,25249,25249,0,13,8961000.0
8961,8961999,20.859683610566396,37.91075656748049,0.08260722214382243,1549.618336200714,587.9706828594208,1414.6380996704102,34515,9265,25250,25250,0,13,8962000.0
8962,8962999,20.859550106490875,37.910168507534266,0.08259747489215241,1549.9098014831543,588.0361413955688,1414.6726379394531,34519,9267,25252,25252,0,13,8963000.0
8963,8963999,20.85958426309052,37.91018752085848,0.082584770110403,1550.0594191551208,588.1040108203888,1414.8512229919434,34519,9267,25252,25252,0,13,8964000.0
8964,8964999,20.859473288560054,37.90952279532423,0.08257409378812874,1550.4283566474915,588.1697716712952,1414.7676467895508,34525,9270,25255,25255,0,13,8965000.0
8965,8965999,20.859616618071513,37.90923368986525,0.0825576159933844,1550.5536499023438,588.2354357242584,1414.9550971984863,34525,9270,25255,25255,0,13,8966000.0
8966,8966999,20.859671350367396,37.9085635343045,0.0825457693308268,1550.6897656917572,588.3019981384277,1415.0937728881836,34525,9270,25255,25255,0,13,8967000.0
8967,8967999,20.8595890364971,37.907800747152365,0.08253864036384839,1550.8942601680756,588.3680024147034,1415.214900970459,34527,9271,25256,25256,0,13,8968000.0
8968,8968999,20.85956633519964,37.90822274961987,0.08252869004474161,1551.1889390945435,588.4343769550323,1415.5578231811523,34539,9273,25266,25266,0,13,8969000.0
8969,8969999,20.859402690321424,37.90794529600666,0.08252029660494542,1551.3866336345673,588.5002262592316,1416.239501953125,34546,9274,25272,25272,0,13,8970000.0
8970,8970999,20.859007719715564,37.90737966735744,0.08251514309128427,1551.5072088241577,588.5659580230713,1416.6017951965332,34547,9274,25273,25273,0,13,8971000.0
8971,8971999,20.858652285020828,37.90659224951668,0.08251011854597035,1551.8609733581543,588.6316635608673,1416.6762733459473,34554,9277,25277,25277,0,13,8972000.0
8972,8972999,20.858472267289574,37.90628744128558,0.08250569760651372,1552.0706782341003,588.6965041160583,1416.9065017700195,34556,9278,25278,25278,0,13,8973000.0
8973,8973999,20.858442760025053,37.90642460218369,0.08250087308411047,1552.5008318424225,588.7611043453217,1416.925479888916,34564,9282,25282,25282,0,13,8974000.0
8974,8974999,20.85820813921495,37.90566423464919,0.08249741822091505,1552.8566377162933,588.8256828784943,1416.9323539733887,34571,9285,25286,25286,0,13,8975000.0
8975,8975999,20.85832156852555,37.90787939021313,0.08248698158316814,1553.291455745697,588.8913688659668,1416.992576599121,34579,9289,25290,25290,0,13,8976000.0
8976,8976999,20.858317426804845,37.90744539666172,0.08248408180849687,1553.403388261795,588.9530458450317,1417.2664833068848,34579,9289,25290,25290,0,13,8977000.0
8977,8977999,20.858686122922112,37.907710399920646,0.0824789659417442,1553.6760702133179,589.0155720710754,1417.2894287109375,34583,9291,25292,25292,0,13,8978000.0
8978,8978999,20.85904109562555,37.908103981068386,0.08247686652952524,1554.049165725708,589.0824942588806,1417.298885345459,34589,9294,25295,25295,0,13,8979000.0
8979,8979999,20.859756238188808,37.90880676106165,0.0824749528632589,1554.3327074050903,589.1466279029846,1417.3334655761719,34593,9296,25297,25297,0,13,8980000.0
8980,8980999,20.86018726488104,37.91018363596908,0.08246886528677011,1554.5611095428467,589.2222127914429,1417.4164009094238,34595,9297,25298,25298,0,13,8981000.0
8981,8981999,20.860847053815874,37.910881456551024,0.08246801590650654,1554.7686924934387,589.2858023643494,1417.593849182129,34597,9298,25299,25299,0,13,8982000.0
8982,8982999,20.861856970832388,37.91278890441887,0.08246925335284738,1554.9842910766602,589.3509674072266,1417.7435302734375,34599,9299,25300,25300,0,13,8983000.0
8983,8983999,20.86274697248316,37.91402435802096,0.08247241394878635,1555.1076004505157,589.4138123989105,1417.9421501159668,34599,9299,25300,25300,0,13,8984000.0
8984,8984999,20.863932410862517,37.91499765245115,0.08248344808090669,1555.3114972114563,589.4756915569305,1418.0360145568848,34601,9300,25301,25301,0,13,8985000.0
8985,8985999,20.86479101570016,37.91548367820873,0.08249111408398002,1555.5267474651337,589.5387809276581,1418.0852584838867,34604,9301,25303,25303,0,13,8986000.0
8986,8986999,20.865662834349695,37.91682743447297,0.08249524961017762,1555.6470022201538,589.6019675731659,1418.2250938415527,34604,9301,25303,25303,0,13,8987000.0
8987,8987999,20.866039182843945,37.91642618762391,0.08249963827677698,1555.9142105579376,589.665326833725,1418.2646522521973,34608,9303,25305,25305,0,13,8988000.0
8988,8988999,20.865896821407844,37.91574565953919,0.08248702772975469,1556.1126699447632,589.728374004364,1418.9366035461426,34619,9304,25315,25315,0,13,8989000.0
8989,8989999,20.865376984733686,37.91461758920634,0.08248177696923498,1556.2275667190552,589.7903060913086,1419.2840766906738,34620,9304,25316,25316,0,13,8990000.0
8990,8990999,20.86529605491297,37.914292874950696,0.0824765853099827,1556.4232575893402,589.8526992797852,1419.4587516784668,34651,9305,25346,25346,0,13,8991000.0
8991,8991999,20.865194205644123,37.91377587876138,0.0824720521068314,1556.7054414749146,589.9149854183197,1419.583381652832,34655,9307,25348,25348,0,13,8992000.0
8992,8992999,20.865064623816078,37.913084124472135,0.08246844584782786,1556.909524679184,589.9779751300812,1419.715663909912,34657,9308,25349,25349,0,13,8993000.0
8993,8993999,20.865437649121365,37.91390263533938,0.08247403103415274,1557.1104731559753,590.0405008792877,1419.8786888122559,34659,9309,25350,25350,0,13,8994000.0
8994,8994999,20.866000524934726,37.915176473673114,0.08248301517960632,1557.546458721161,590.1056513786316,1419.8455619812012,34667,9313,25354,25354,0,13,8995000.0
8995,8995999,20.866468191752094,37.915980089738234,0.08249457829014528,1557.826428413391,590.1674408912659,1419.9807205200195,34671,9315,25356,25356,0,13,8996000.0
8996,8996999,20.867433989414305,37.91809790061158,0.08251988974131153,1558.2717018127441,590.2341375350952,1419.9028396606445,34679,9319,25360,25360,0,13,8997000.0
8997,8997999,20.868416485481507,37.91985910081679,0.08253383992931473,1558.4752826690674,590.2962288856506,1420.04732131958,34681,9320,25361,25361,0,13,8998000.0
8998,8998999,20.86980453360525,37.92327654669579,0.0825500410863721,1558.7578482627869,590.3595094680786,1420.155361175537,34685,9322,25363,25363,0,13,8999000.0
8999,8999999,20.871642502843283,37.927058146239375,0.08257917848960483,1559.0328483581543,590.4241580963135,1420.162483215332,34689,9324,25365,25365,0,13,9000000.0
9000,9000999,20.873264944887676,37.931495894648805,0.08258960791560854,1559.1573972702026,590.4865190982819,1420.342025756836,34689,9324,25365,25365,0,13,9001000.0
9001,9001999,20.875066068098853,37.934703218039566,0.08261628503515572,1559.3752965927124,590.5526552200317,1420.453712463379,34691,9325,25366,25366,0,13,9002000.0
9002,9002999,20.877180160779442,37.938578103509336,0.08264565467395202,1559.503802061081,590.6148691177368,1420.6675300598145,34691,9325,25366,25366,0,13,9003000.0
9003,9003999,20.879186569997056,37.94175539563198,0.08267659344835587,1559.6229548454285,590.6765611171722,1420.8347854614258,34691,9325,25366,25366,0,13,9004000.0
9004,9004999,20.88121960247751,37.94473948339866,0.08271383183164716,1559.8344376087189,590.7399730682373,1420.847827911377,34693,9326,25367,25367,0,13,9005000.0
9005,9005999,20.882900152864185,37.94680014038355,0.08274216274016843,1559.9757840633392,590.8031301498413,1420.9823455810547,34693,9326,25367,25367,0,13,9006000.0
9006,9006999,20.884600915089326,37.94911701799117,0.08277846506357489,1560.254388809204,590.8655524253845,1421.0374183654785,34706,9328,25378,25378,0,13,9007000.0
9007,9007999,20.885938639725058,37.9512924688739,0.08276151315907998,1560.3841948509216,590.9280664920807,1421.8343772888184,34716,9328,25388,25388,0,13,9008000.0
9008,9008999,20.885708226585606,37.950518333986224,0.08273542438523362,1560.5018692016602,590.9914753437042,1422.310775756836,34717,9328,25389,25389,0,13,9009000.0
9009,9009999,20.885351066435867,37.94969525570601,0.08272646614477142,1560.7003870010376,591.0518524646759,1422.6629257202148,34723,9329,25394,25394,0,13,9010000.0
9010,9010999,20.8852850748422,37.94931561449949,0.08271636160002183,1560.9844176769257,591.1155688762665,1422.9026908874512,34729,9331,25398,25398,0,13,9011000.0
9011,9011999,20.88530348634272,37.94980866690682,0.08270530774136642,1561.255990743637,591.1776611804962,1423.086814880371,34733,9333,25400,25400,0,13,9012000.0
9012,9012999,20.885196705083327,37.94923848122729,0.08269314737824729,1561.4572653770447,591.2412824630737,1423.2343482971191,34735,9334,25401,25401,0,13,9013000.0
9013,9013999,20.884923171631108,37.94823870244361,0.08268998434016916,1561.663768529892,591.3047947883606,1423.3732872009277,34737,9335,25402,25402,0,13,9014000.0
9014,9014999,20.88483634336899,37.94769141475103,0.08268338001251607,1561.8695950508118,591.3659834861755,1423.4838676452637,34739,9336,25403,25403,0,13,9015000.0
9015,9015999,20.885046010025345,37.94952047367859,0.08267127055542478,1562.235904455185,591.4274604320526,1423.328125,34747,9339,25408,25408,0,13,9016000.0
9016,9016999,20.885376575348236,37.950060749745056,0.08266595566149904,1562.4291853904724,591.4886865615845,1423.4993896484375,34750,9340,25410,25410,0,13,9017000.0
9017,9017999,20.885817747564676,37.95058398106944,0.08267386530466969,1562.6266460418701,591.5494801998138,1423.6361503601074,34754,9341,25413,25413,0,13,9018000.0
9018,9018999,20.88630007749987,37.950924596608424,0.08268544336880101,1562.7606542110443,591.612598657608,1423.801643371582,34754,9341,25413,25413,0,13,9019000.0
9019,9019999,20.88699059750627,37.95221884688918,0.08268976872257783,1562.960993051529,591.6765098571777,1423.8729286193848,34757,9342,25415,25415,0,13,9020000.0
9020,9020999,20.887684844962873,37.95296117593639,0.08269357631369834,1563.0999805927277,591.7404661178589,1424.0631484985352,34758,9342,25416,25416,0,13,9021000.0
9021,9021999,20.888400873564596,37.95383863075709,0.08270583600782921,1563.3242750167847,591.8064894676208,1424.0686416625977,34761,9343,25418,25418,0,13,9022000.0
9022,9022999,20.889255062101533,37.954978491078776,0.0827236547986896,1563.4610121250153,591.868195772171,1424.1971130371094,34761,9343,25418,25418,0,13,9023000.0
9023,9023999,20.8902836034563,37.95745164470507,0.08272791253561007,1563.5938022136688,591.929890871048,1424.3142204284668,34761,9343,25418,25418,0,13,9024000.0
9024,9024999,20.89135270589953,37.95885971563201,0.08273933913339648,1563.7265040874481,591.9910342693329,1424.4544410705566,34761,9343,25418,25418,0,13,9025000.0
9025,9025999,20.892401008768296,37.96052646395601,0.08275606514232015,1564.0020956993103,592.0525887012482,1424.3997383117676,34765,9345,25420,25420,0,13,9026000.0
9026,9026999,20.89317448762451,37.96116716613986,0.08275829758117714,1564.2855055332184,592.1149699687958,1424.4254875183105,34769,9347,25422,25422,0,13,9027000.0
9027,9027999,20.893313878954164,37.960883400389925,0.08275650109876564,1564.4091801643372,592.1760399341583,1425.5392608642578,34786,9347,25439,25439,0,13,9028000.0
9028,9028999,20.89273190895459,37.9597959119956,0.08275458404370095,1564.592866897583,592.2388272285461,1426.0113639831543,34789,9348,25441,25441,0,13,9029000.0
9029,9029999,20.892126769184983,37.95855421045775,0.08275442820005896,1564.704891204834,592.2998299598694,1426.4549827575684,34792,9348,25444,25444,0,13,9030000.0
9030,9030999,20.891613155700373,37.957787749119454,0.08275158037674424,1564.8209929466248,592.3604421615601,1426.7581977844238,34792,9348,25444,25444,0,13,9031000.0
9031,9031999,20.89111998487982,37.9566772662228,0.08274842629787871,1565.0905451774597,592.4227244853973,1426.9319114685059,34796,9350,25446,25446,0,13,9032000.0
9032,9032999,20.890459717717803,37.955347707450294,0.08274800038149532,1565.3488895893097,592.4841096401215,1427.0125465393066,34800,9352,25448,25448,0,13,9033000.0
9033,9033999,20.890021717344897,37.95427363878532,0.08274714942527162,1565.6282982826233,592.5456383228302,1427.1221008300781,34805,9354,25451,25451,0,13,9034000.0
9034,9034999,20.889367855089482,37.952868300924415,0.08274692120506377,1566.0740370750427,592.6090512275696,1427.1433639526367,34813,9358,25455,25455,0,13,9035000.0
9035,9035999,20.88890618699451,37.95353464232446,0.08273500693254288,1566.1949026584625,592.6705775260925,1427.3730239868164,34813,9358,25455,25455,0,13,9036000.0
9036,9036999,20.888460429178224,37.95274135895837,0.08273355646403169,1566.395709514618,592.7322432994843,1427.511474609375,34815,9359,25456,25456,0,13,9037000.0
9037,9037999,20.888055497292182,37.95175149933574,0.08273057181166255,1566.5345034599304,592.7931890487671,1427.7181816101074,34815,9359,25456,25456,0,13,9038000.0
9038,9038999,20.88750785215296,37.950745233749494,0.08272889398000294,1566.6529393196106,592.8556730747223,1427.8280944824219,34815,9359,25456,25456,0,13,9039000.0
9039,9039999,20.887089129420232,37.9499461890536,0.0827254519277838,1566.865526676178,592.9209454059601,1427.9265975952148,34819,9360,25459,25459,0,13,9040000.0
9040,9040999,20.886548966283613,37.948787554998226,0.08272380244536237,1566.9801404476166,592.9814569950104,1428.0654754638672,34819,9360,25459,25459,0,13,9041000.0
9041,9041999,20.88613147037171,37.94785107073704,0.08272155299387207,1567.1159348487854,593.0460493564606,1428.17972946167,34819,9360,25459,25459,0,13,9042000.0
9042,9042999,20.8858393486167,37.947151006321484,0.08271966938166253,1567.255226612091,593.1072103977203,1428.3040580749512,34819,9360,25459,25459,0,13,9043000.0
9043,9043999,20.885395893773815,37.946092398521266,0.08271902059737535,1567.4619855880737,593.1687133312225,1428.3380317687988,34821,9361,25460,25460,0,13,9044000.0
9044,9044999,20.88496978638858,37.94501141025176,0.08271811494975756,1567.9790275096893,593.2315168380737,1428.1198806762695,34841,9366,25475,25475,0,13,9045000.0
9045,9045999,20.884495923336758,37.94379556773866,0.08271628015719068,1568.104505777359,593.2937443256378,1428.3012199401855,34841,9366,25475,25475,0,13,9046000.0
9046,9046999,20.883979713705052,37.942776634363554,0.08271573094021012,1568.2965025901794,593.3562061786652,1428.3845558166504,34843,9367,25476,25476,0,13,9047000.0
9047,9047999,20.88359491830227,37.94162980434407,0.08271074798857858,1568.4560556411743,593.4202432632446,1429.1882438659668,34855,9367,25488,25488,0,13,9048000.0
9048,9048999,20.883461822205224,37.94134714685323,0.08268252116138564,1568.5674221515656,593.4817416667938,1429.894474029541,34860,9367,25493,25493,0,13,9049000.0
9049,9049999,20.88298229857768,37.940421957516946,0.08267151840102382,1568.7683947086334,593.5461549758911,1430.2695541381836,34863,9368,25495,25495,0,13,9050000.0
9050,9050999,20.882602474104303,37.93984427114233,0.08266247352249656,1568.8812923431396,593.6066663265228,1430.6557426452637,34864,9368,25496,25496,0,13,9051000.0
9051,9051999,20.882359287793875,37.93937142881673,0.08264922514968298,1568.9882712364197,593.6685247421265,1430.8867988586426,34864,9368,25496,25496,0,13,9052000.0
9052,9052999,20.882065291166754,37.93888223990834,0.08263522607936435,1569.2681307792664,593.7308170795441,1431.056755065918,34868,9370,25498,25498,0,13,9053000.0
9053,9053999,20.88185415262241,37.938026073339536,0.08262184497956959,1569.547839164734,593.7922105789185,1431.1134071350098,34872,9372,25500,25500,0,13,9054000.0
9054,9054999,20.881400223818595,37.936838141987685,0.08261492227445677,1569.9106872081757,593.8537573814392,1431.170783996582,34878,9375,25503,25503,0,13,9055000.0
9055,9055999,20.881179126356617,37.93620248860103,0.08260649963630318,1570.274727344513,593.9170453548431,1431.1958770751953,34885,9378,25507,25507,0,13,9056000.0
9056,9056999,20.880949057588182,37.93527736048524,0.08259851354721603,1570.464968919754,593.9783222675323,1431.366901397705,34888,9379,25509,25509,0,13,9057000.0
9057,9057999,20.880643786886036,37.93440002160552,0.08259171683685884,1570.5920696258545,594.0393249988556,1431.5557746887207,34888,9379,25509,25509,0,13,9058000.0
9058,9058999,20.88038547031154,37.933622167286146,0.08258306560650353,1570.8087847232819,594.1043837070465,1431.6426963806152,34890,9380,25510,25510,0,13,9059000.0
9059,9059999,20.880313746387053,37.933091856173995,0.0825775955043837,1570.9333922863007,594.1691751480103,1431.8585472106934,34890,9380,25510,25510,0,13,9060000.0
9060,9060999,20.880110668632618,37.932380515369616,0.08257087265284002,1571.0594851970673,594.230363368988,1431.9995727539062,34890,9380,25510,25510,0,13,9061000.0
9061,9061999,20.8801016006803,37.932128406941644,0.08256530797751394,1571.1892540454865,594.2976758480072,1432.1436805725098,34890,9380,25510,25510,0,13,9062000.0
9062,9062999,20.88012684964213,37.93177359475071,0.08256244667383295,1571.3258917331696,594.3591592311859,1432.2729377746582,34890,9380,25510,25510,0,13,9063000.0
9063,9063999,20.880306237864364,37.931580272556936,0.08255874363814242,1571.5374596118927,594.4220325946808,1432.332233428955,34892,9381,25511,25511,0,13,9064000.0
9064,9064999,20.880348082698617,37.93114464727795,0.08255999400123692,1571.671020269394,594.4842526912689,1432.4244079589844,34892,9381,25511,25511,0,13,9065000.0
9065,9065999,20.88047318942981,37.93079310194205,0.08255883345737314,1571.8662421703339,594.5468311309814,1432.5242233276367,34922,9382,25540,25540,0,13,9066000.0
9066,9066999,20.880616714036705,37.93032537610104,0.08255762846813974,1571.981026172638,594.6087033748627,1432.6131286621094,34922,9382,25540,25540,0,13,9067000.0
9067,9067999,20.880802371901268,37.93000835211005,0.08255814359353042,1572.3012344837189,594.6743760108948,1432.587589263916,34929,9384,25545,25545,0,13,9068000.0
9068,9068999,20.880682992198285,37.929148326024865,0.08254250945310448,1572.4313571453094,594.7370018959045,1433.7391166687012,34943,9384,25559,25559,0,13,9069000.0
9069,9069999,20.880601391843065,37.93004005055094,0.0825244492700492,1572.6272468566895,594.8020956516266,1434.1204948425293,34946,9385,25561,25561,0,13,9070000.0
9070,9070999,20.880871404014115,37.93278001909631,0.08250790718332734,1572.7371394634247,594.8639705181122,1434.38627243042,34946,9385,25561,25561,0,13,9071000.0
9071,9071999,20.880867718056535,37.93208295612347,0.08249738309981414,1572.8535714149475,594.9259188175201,1434.6088485717773,34946,9385,25561,25561,0,13,9072000.0
9072,9072999,20.881096545688504,37.93185668640083,0.08249230375710459,1573.2080373764038,594.990561246872,1434.6274375915527,34953,9388,25565,25565,0,13,9073000.0
9073,9073999,20.881609060881306,37.93243139593208,0.08249034908677144,1573.4244122505188,595.0549108982086,1434.7943801879883,34955,9389,25566,25566,0,13,9074000.0
9074,9074999,20.882391813705684,37.93318958947295,0.08249012442290737,1573.5486674308777,595.1175637245178,1434.9880828857422,34955,9389,25566,25566,0,13,9075000.0
9075,9075999,20.883443622761526,37.93445755668025,0.08250008314978319,1573.8310370445251,595.1805877685547,1435.0243530273438,34959,9391,25568,25568,0,13,9076000.0
9076,9076999,20.8846511775024,37.936218961202776,0.08251696175514922,1574.0205733776093,595.2419431209564,1435.1667404174805,34962,9392,25570,25570,0,13,9077000.0
9077,9077999,20.886321979558783,37.93939644007006,0.08254791563213337,1574.2285225391388,595.3046388626099,1435.2176322937012,34964,9393,25571,25571,0,13,9078000.0
9078,9078999,20.887610739916333,37.94113849563989,0.08258190289271383,1574.5018661022186,595.3673541545868,1435.2644653320312,34978,9395,25583,25583,0,13,9079000.0
9079,9079999,20.889661254073268,37.94622825788875,0.08262437902996689,1574.7091999053955,595.4309849739075,1435.3331336975098,34980,9396,25584,25584,0,13,9080000.0
9080,9080999,20.891438736111546,37.949234294833516,0.08267613430046794,1574.92822432518,595.4965488910675,1435.4963645935059,34982,9397,25585,25585,0,13,9081000.0
9081,9081999,20.893646268464998,37.95352734301888,0.08274103661529597,1575.1289083957672,595.559446811676,1435.5433959960938,34986,9398,25588,25588,0,13,9082000.0
9082,9082999,20.89638337958565,37.96199415685506,0.08280069360647635,1575.3512938022614,595.6229538917542,1435.6484565734863,34988,9399,25589,25589,0,13,9083000.0
9083,9083999,20.898639090025174,37.96613629505846,0.08288960945572998,1575.486798286438,595.6857602596283,1435.7840156555176,34988,9399,25589,25589,0,13,9084000.0
9084,9084999,20.90061978270101,37.969430037534906,0.08296078122063522,1575.6966321468353,595.7511899471283,1435.8415184020996,34990,9400,25590,25590,0,13,9085000.0
9085,9085999,20.902956684685567,37.97391517309054,0.08303182426749467,1576.0590720176697,595.8184504508972,1435.8035926818848,35026,9403,25623,25623,0,13,9086000.0
9086,9086999,20.904842198940077,37.97667150825583,0.08310995545620681,1576.2597918510437,595.8829691410065,1435.8625450134277,35028,9404,25624,25624,0,13,9087000.0
9087,9087999,20.906550501439643,37.97971481990421,0.08317645491450132,1576.3942348957062,595.9448256492615,1435.9852333068848,35028,9404,25624,25624,0,13,9088000.0
9088,9088999,20.90727042471493,37.981000264339166,0.0831459344779023,1576.5156795978546,596.0070369243622,1436.9016723632812,35039,9404,25635,25635,0,13,9089000.0
9089,9089999,20.907154862355945,37.98056419098463,0.0831315649688058,1576.6337921619415,596.0694808959961,1437.3050231933594,35041,9404,25637,25637,0,13,9090000.0
9090,9090999,20.907198581601705,37.9808361457228,0.08311655056627465,1576.7513661384583,596.1303384304047,1437.5622100830078,35041,9404,25637,25637,0,13,9091000.0
9091,9091999,20.907062504658466,37.980317834973086,0.08310733442368579,1577.095737695694,596.1917102336884,1437.6404762268066,35050,9407,25643,25643,0,13,9092000.0
9092,9092999,20.906989554221795,37.979799775636735,0.08309596551788667,1577.3110032081604,596.2553985118866,1437.8171463012695,35052,9408,25644,25644,0,13,9093000.0
9093,9093999,20.90693209675491,37.97963637705908,0.0830846900087372,1577.4296824932098,596.3164048194885,1437.9788246154785,35052,9408,25644,25644,0,13,9094000.0
9094,9094999,20.90686080038748,37.97918055917129,0.08307576627280844,1577.5610721111298,596.3815155029297,1438.1817665100098,35052,9408,25644,25644,0,13,9095000.0
9095,9095999,20.90694948116886,37.98088149111406,0.08305925320995355,1577.764246225357,596.443528175354,1438.258457183838,35054,9409,25645,25645,0,13,9096000.0
9096,9096999,20.906716882048734,37.97996223858057,0.08305241207404168,1577.9700906276703,596.5054986476898,1438.3580741882324,35056,9410,25646,25646,0,13,9097000.0
9097,9097999,20.906823719279515,37.979418427674915,0.08304369571631831,1578.251586675644,596.5687720775604,1438.2766227722168,35060,9412,25648,25648,0,13,9098000.0
9098,9098999,20.906950999789707,37.97911040291241,0.08303596334383567,1578.3995048999786,596.6322040557861,1438.4348106384277,35060,9412,25648,25648,0,13,9099000.0
9099,9099999,20.907233491030144,37.979128483697316,0.08302967647320447,1578.6078062057495,596.6953229904175,1438.51273727417,35062,9413,25649,25649,0,13,9100000.0
9100,9100999,20.907490739169003,37.979084006780596,0.08302119087426618,1578.9800860881805,596.7587656974792,1438.4117126464844,35071,9416,25655,25655,0,13,9101000.0
9101,9101999,20.907892234491285,37.97917729337598,0.08301173171547394,1579.271002292633,596.8216233253479,1438.4004249572754,35077,9418,25659,25659,0,13,9102000.0
9102,9102999,20.90835492528048,37.97930018001841,0.08300158474963926,1579.3921353816986,596.8832643032074,1438.5680809020996,35077,9418,25659,25659,0,13,9103000.0
9103,9103999,20.90865296565972,37.979025598358426,0.08299222688603203,1579.5231490135193,596.9468290805817,1438.7075500488281,35077,9418,25659,25659,0,13,9104000.0
9104,9104999,20.908786911864453,37.97849137976519,0.08298512552361548,1579.8097696304321,597.0090713500977,1438.7380828857422,35081,9420,25661,25661,0,13,9105000.0
9105,9105999,20.908735729818417,37.97799437232384,0.08296701911725934,1580.009147644043,597.0714523792267,1439.7344207763672,35106,9421,25685,25685,0,13,9106000.0
9106,9106999,20.90850959434385,37.977466847042834,0.08295675494604382,1580.2117853164673,597.135329246521,1440.0896453857422,35109,9422,25687,25687,0,13,9107000.0
9107,9107999,20.908153975532862,37.97663297340433,0.08294990788169987,1580.400883436203,597.197304725647,1440.3500900268555,35111,9423,25688,25688,0,13,9108000.0
9108,9108999,20.90769054163306,37.97624135912239,0.08294314352608034,1580.7476675510406,597.258740901947,1440.5017166137695,35118,9426,25692,25692,0,13,9109000.0
9109,9109999,20.907428954435243,37.97560455407794,0.0829330742487615,1580.9521214962006,597.3200447559357,1440.6788597106934,35121,9427,25694,25694,0,13,9110000.0
9110,9110999,20.90721855886823,37.97489740312519,0.08292504818508828,1581.2277071475983,597.3822128772736,1440.7851829528809,35125,9429,25696,25696,0,13,9111000.0
9111,9111999,20.907042284498882,37.97413663415725,0.082917674401919,1581.3693821430206,597.447069644928,1441.0262641906738,35125,9429,25696,25696,0,13,9112000.0
9112,9112999,20.907058481581505,37.973774222756525,0.08290842333734827,1581.4884650707245,597.5102634429932,1441.1981658935547,35125,9429,25696,25696,0,13,9113000.0
9113,9113999,20.9070987457296,37.97343566458127,0.08290205451819121,1581.696849346161,597.5739650726318,1441.2785530090332,35127,9430,25697,25697,0,13,9114000.0
9114,9114999,20.90712059790399,37.97316478637669,0.08289138093958026,1581.983632326126,597.636923789978,1441.3113899230957,35131,9432,25699,25699,0,13,9115000.0
9115,9115999,20.907173406071763,37.97276695298918,0.08288484056134016,1582.18483543396,597.6990323066711,1441.4146881103516,35133,9433,25700,25700,0,13,9116000.0
9116,9116999,20.907572150390063,37.9729690752797,0.08288069219879635,1582.3983645439148,597.7620158195496,1441.546127319336,35135,9434,25701,25701,0,13,9117000.0
9117,9117999,20.908012306542687,37.97303653310547,0.08287287337547833,1582.7692399024963,597.8262751102448,1441.3972358703613,35141,9437,25704,25704,0,13,9118000.0
9118,9118999,20.908521205504115,37.97356291669471,0.08286742749031317,1582.8926410675049,597.8881373405457,1441.657512664795,35141,9437,25704,25704,0,13,9119000.0
9119,9119999,20.90887648910663,37.973577277470824,0.08286334240409188,1583.116185426712,597.9556601047516,1441.7531356811523,35143,9438,25705,25705,0,13,9120000.0
9120,9120999,20.90947538974922,37.97416666564161,0.0828584786776051,1583.3181068897247,598.0197505950928,1441.8481216430664,35146,9439,25707,25707,0,13,9121000.0
9121,9121999,20.910106918737142,37.974608702996605,0.08285541699693799,1583.453424692154,598.081330537796,1442.009506225586,35146,9439,25707,25707,0,13,9122000.0
9122,9122999,20.910715041614907,37.97511103624328,0.08285233153653482,1583.743848323822,598.1459305286407,1441.98486328125,35150,9441,25709,25709,0,13,9123000.0
9123,9123999,20.91106558032768,37.975127981224,0.08284869770046555,1583.8655002117157,598.2081756591797,1442.1554641723633,35150,9441,25709,25709,0,13,9124000.0
9124,9124999,20.91098270787971,37.97457446191879,0.08284518649533024,1583.9833059310913,598.2694358825684,1442.991455078125,35159,9441,25718,25718,0,13,9125000.0
9125,9125999,20.91013727033572,37.97316256159561,0.0828470447891565,1584.0958654880524,598.3334143161774,1443.4067344665527,35161,9441,25720,25720,0,13,9126000.0
9126,9126999,20.909378152914055,37.97184557597675,0.08284739978693934,1584.2957940101624,598.3937311172485,1443.550121307373,35163,9442,25721,25721,0,13,9127000.0
9127,9127999,20.908771350970433,37.97098810519104,0.08284409989125685,1584.5742568969727,598.454668045044,1443.6918487548828,35168,9444,25724,25724,0,13,9128000.0
9128,9128999,20.908155080734932,37.970046266920725,0.08284032702437316,1584.94726228714,598.5176875591278,1443.703815460205,35174,9447,25727,25727,0,13,9129000.0
9129,9129999,20.907465330693626,37.968706545898385,0.08284053726957841,1585.1350531578064,598.5794882774353,1443.8821868896484,35177,9448,25729,25729,0,13,9130000.0
9130,9130999,20.90683115430013,37.96750518074292,0.08283866208567547,1585.3357920646667,598.6399192810059,1443.9968795776367,35179,9449,25730,25730,0,13,9131000.0
9131,9131999,20.906106959117874,37.9662239231213,0.08283778119028373,1585.7737488746643,598.7029132843018,1443.9758911132812,35187,9453,25734,25734,0,13,9132000.0
9132,9132999,20.905531606225825,37.965202013636535,0.08283412046889249,1586.0384125709534,598.7625179290771,1443.9316749572754,35191,9455,25736,25736,0,13,9133000.0
9133,9133999,20.905105210487694,37.96436069935738,0.08282992502609055,1586.1622099876404,598.8237495422363,1444.2075996398926,35191,9455,25736,25736,0,13,9134000.0
9134,9134999,20.904679397488405,37.96333282053062,0.08282644503871384,1586.2918615341187,598.885707616806,1444.379825592041,35191,9455,25736,25736,0,13,9135000.0
9135,9135999,20.90408037840524,37.961991602956445,0.08282507885451473,1586.5885744094849,598.9472515583038,1444.335304260254,35195,9457,25738,25738,0,13,9136000.0
9136,9136999,20.903570921202363,37.96112251188505,0.08282157001797597,1586.7035732269287,599.0084328651428,1444.54443359375,35195,9457,25738,25738,0,13,9137000.0
9137,9137999,20.903314474882002,37.96053362659578,0.08281725502420356,1586.9078741073608,599.0696973800659,1444.6051445007324,35197,9458,25739,25739,0,13,9138000.0
9138,9138999,20.90299471730778,37.95968560820574,0.08281511401731556,1587.0446872711182,599.1337749958038,1444.7624473571777,35197,9458,25739,25739,0,13,9139000.0
9139,9139999,20.90263931312473,37.95878225512124,0.08281261592186484,1587.1756610870361,599.1983370780945,1444.8733978271484,35197,9458,25739,25739,0,13,9140000.0
9140,9140999,20.902329691368124,37.95786899920659,0.0828099626297153,1587.3857054710388,599.2605512142181,1444.92045211792,35199,9459,25740,25740,0,13,9141000.0
9141,9141999,20.902009125951682,37.9568199678478,0.08280774264861401,1587.522308588028,599.3230040073395,1445.0414848327637,35199,9459,25740,25740,0,13,9142000.0
9142,9142999,20.901497413007686,37.95559482901403,0.08280899032786926,1587.7272355556488,599.3855271339417,1445.1460571289062,35229,9460,25769,25769,0,13,9143000.0
9143,9143999,20.900981576945874,37.9546917705441,0.0828073089041802,1587.850513935089,599.4477815628052,1445.2620811462402,35229,9460,25769,25769,0,13,9144000.0
9144,9144999,20.900450292758755,37.953459271707004,0.08280891459817619,1588.1464183330536,599.5133695602417,1445.506420135498,35240,9462,25778,25778,0,13,9145000.0
9145,9145999,20.899416439384275,37.95220823216978,0.08281232317260456,1588.3380467891693,599.5756034851074,1445.9225463867188,35244,9463,25781,25781,0,13,9146000.0
9146,9146999,20.89844653073639,37.95085162601445,0.08281487125549947,1588.538071155548,599.6365621089935,1446.1593322753906,35247,9464,25783,25783,0,13,9147000.0
9147,9147999,20.89759298789237,37.94976804533812,0.0828151464116681,1588.655110359192,599.6978228092194,1446.3396759033203,35247,9464,25783,25783,0,13,9148000.0
9148,9148999,20.89684879568088,37.94894985763486,0.08281220743927464,1589.0253896713257,599.7602152824402,1446.3762016296387,35254,9467,25787,25787,0,13,9149000.0
9149,9149999,20.896059529719647,37.947551916556655,0.08281354141706254,1589.231393814087,599.8211915493011,1446.5320587158203,35256,9468,25788,25788,0,13,9150000.0
9150,9150999,20.895310560350374,37.94619117937646,0.0828147763705942,1589.368891954422,599.8853220939636,1446.6873588562012,35256,9468,25788,25788,0,13,9151000.0
9151,9151999,20.894609186506727,37.9451796088007,0.08281410583101867,1589.653617143631,599.9468636512756,1446.6773147583008,35270,9470,25800,25800,0,13,9152000.0
9152,9152999,20.893926378891397,37.94410514077228,0.08281249213163222,1589.9325637817383,600.0082476139069,1446.6984024047852,35274,9472,25802,25802,0,13,9153000.0
9153,9153999,20.89330667583457,37.94287285191645,0.0828135950501272,1590.1378319263458,600.0721480846405,1446.8601608276367,35277,9473,25804,25804,0,13,9154000.0
9154,9154999,20.89266788319293,37.941513516861725,0.08281507552307366,1590.3440835475922,600.1362226009369,1446.9304313659668,35279,9474,25805,25805,0,13,9155000.0
9155,9155999,20.891916402922536,37.94015552978856,0.08281721619592874,1590.490746498108,600.1990180015564,1447.053092956543,35279,9474,25805,25805,0,13,9156000.0
9156,9156999,20.89134593780307,37.93903496037944,0.08281627028720095,1590.7906210422516,600.2607028484344,1447.0744171142578,35283,9476,25807,25807,0,13,9157000.0
9157,9157999,20.891013298626373,37.93850606076124,0.08281218577174598,1590.9121723175049,600.3225202560425,1447.2733154296875,35283,9476,25807,25807,0,13,9158000.0
9158,9158999,20.890718297959328,37.937881662192936,0.08280711872510149,1591.0460712909698,600.3830010890961,1447.3814315795898,35283,9476,25807,25807,0,13,9159000.0
9159,9159999,20.89058986372848,37.93759496374154,0.0827996476977867,1591.3171281814575,600.4466137886047,1447.342128753662,35287,9478,25809,25809,0,13,9160000.0
9160,9160999,20.890696475965058,37.93797166902988,0.08279029383328651,1591.5326170921326,600.5086448192596,1447.3502235412598,35289,9479,25810,25810,0,13,9161000.0
9161,9161999,20.89096470590738,37.93901589118044,0.08278452535196867,1591.7662606239319,600.5715625286102,1447.4206314086914,35291,9480,25811,25811,0,13,9162000.0
9162,9162999,20.891295448902017,37.9402466235214,0.08277718436640458,1591.8868436813354,600.6335411071777,1447.5540161132812,35291,9480,25811,25811,0,13,9163000.0
9163,9163999,20.89146442537194,37.94057818709584,0.08277118407463557,1592.0859031677246,600.695344209671,1447.6244277954102,35293,9481,25812,25812,0,13,9164000.0
9164,9164999,20.890753119811368,37.939193630208436,0.0827739202096116,1592.3118975162506,600.7650911808014,1448.3701629638672,35309,9482,25827,25827,0,13,9165000.0
9165,9165999,20.890127645266045,37.939154059576396,0.08276675761414942,1592.4442183971405,600.8287377357483,1448.7656936645508,35311,9482,25829,25829,0,13,9166000.0
9166,9166999,20.889489637834178,37.93832504252626,0.08276429534464491,1592.653715133667,600.889261007309,1448.891342163086,35313,9483,25830,25830,0,13,9167000.0
9167,9167999,20.88882146231914,37.937206369657595,0.08276247910080592,1592.8532283306122,600.9499878883362,1449.0656394958496,35316,9484,25832,25832,0,13,9168000.0
9168,9168999,20.888210807997513,37.936378781107095,0.08275842558733748,1592.9644355773926,601.0105364322662,1449.2815971374512,35316,9484,25832,25832,0,13,9169000.0
9169,9169999,20.887615140604073,37.9353040770759,0.08275639039823346,1593.2459728717804,601.0725648403168,1449.3489875793457,35320,9486,25834,25834,0,13,9170000.0
9170,9170999,20.88696725407438,37.933986518948394,0.08275770680913741,1593.6592063903809,601.1340265274048,1449.3035469055176,35328,9490,25838,25838,0,13,9171000.0
9171,9171999,20.88632126295889,37.932689612380514,0.08275861166137155,1594.0483009815216,601.2050025463104,1449.279426574707,35334,9493,25841,25841,0,13,9172000.0
9172,9172999,20.885853518041394,37.93188323169346,0.08275451632703534,1594.3339366912842,601.268098115921,1449.3351287841797,35341,9495,25846,25846,0,13,9173000.0
9173,9173999,20.88533514172055,37.93069659385538,0.08275345896390007,1594.5405378341675,601.3304169178009,1449.5081672668457,35344,9496,25848,25848,0,13,9174000.0
9174,9174999,20.88488210422616,37.93003821891511,0.08275098132896319,1594.661777973175,601.3918437957764,1449.6943626403809,35344,9496,25848,25848,0,13,9175000.0
9175,9175999,20.88440101621204,37.92899409526797,0.08274883876843575,1594.789358139038,601.4561257362366,1449.872573852539,35344,9496,25848,25848,0,13,9176000.0
9176,9176999,20.88417326097694,37.92846263451122,0.08274530404985414,1594.9300644397736,601.5196933746338,1450.023754119873,35344,9496,25848,25848,0,13,9177000.0
9177,9177999,20.88388547325254,37.92768029018506,0.08274189218442152,1595.073940038681,601.582909822464,1450.1446495056152,35344,9496,25848,25848,0,13,9178000.0
9178,9178999,20.883892131641495,37.927766193878995,0.08273598856033182,1595.1963918209076,601.6438963413239,1450.25244140625,35344,9496,25848,25848,0,13,9179000.0
9179,9179999,20.883891698350293,37.92751393936667,0.08273247903946357,1595.3152523040771,601.7050678730011,1450.3533897399902,35344,9496,25848,25848,0,13,9180000.0
9180,9180999,20.884235398642016,37.92923271892591,0.08272023714094401,1595.4522497653961,601.768096446991,1450.4495315551758,35344,9496,25848,25848,0,13,9181000.0
9181,9181999,20.884230504069198,37.9290449659446,0.0827146088925732,1595.583651304245,601.8318326473236,1450.5217247009277,35344,9496,25848,25848,0,13,9182000.0
9182,9182999,20.884270310788377,37.92900363040786,0.08270766812947217,1595.8158457279205,601.8962037563324,1450.5513534545898,35346,9497,25849,25849,0,13,9183000.0
9183,9183999,20.883972795946296,37.92830211246115,0.08270643220844975,1595.9407873153687,601.9587323665619,1451.4514541625977,35362,9497,25865,25865,0,13,9184000.0
9184,9184999,20.883713951322957,37.92795679337018,0.08270097397611653,1596.0563633441925,602.0196599960327,1451.9465560913086,35365,9497,25868,25868,0,13,9185000.0
9185,9185999,20.883767046722305,37.928668463237194,0.08268873317733405,1596.2720692157745,602.080854177475,1452.2520751953125,35368,9498,25870,25870,0,13,9186000.0
9186,9186999,20.883777262002152,37.92885115417614,0.08267928981968364,1596.3846852779388,602.1432967185974,1452.532096862793,35368,9498,25870,25870,0,13,9187000.0
9187,9187999,20.88359020611412,37.928155580501766,0.08267513364801515,1596.575686454773,602.2041733264923,1452.6516036987305,35370,9499,25871,25871,0,13,9188000.0
9188,9188999,20.883544933632873,37.92765500622006,0.08266990763485282,1596.8472216129303,602.2656211853027,1452.7274475097656,35374,9501,25873,25873,0,13,9189000.0
9189,9189999,20.883812437428016,37.92779826246591,0.08266316798138507,1597.1196489334106,602.3281252384186,1452.80025100708,35378,9503,25875,25875,0,13,9190000.0
9190,9190999,20.883945189725775,37.927756945451435,0.08266026895158529,1597.7362327575684,602.3950748443604,1452.5914688110352,35390,9509,25881,25881,0,13,9191000.0
9191,9191999,20.884560797693617,37.929055407352415,0.08265492800513063,1597.9291031360626,602.4575324058533,1452.7679405212402,35393,9510,25883,25883,0,13,9192000.0
9192,9192999,20.885051775043745,37.9300921474371,0.08264808452824712,1598.3290901184082,602.5242741107941,1452.7772254943848,35399,9513,25886,25886,0,13,9193000.0
9193,9193999,20.885904902452904,37.93168849272336,0.0826547805121638,1598.5191175937653,602.5884389877319,1452.958179473877,35402,9514,25888,25888,0,13,9194000.0
9194,9194999,20.887302146544233,37.942773217918,0.08262697674726571,1598.7324311733246,602.6519305706024,1453.0678520202637,35404,9515,25889,25889,0,13,9195000.0
9195,9195999,20.888053059256848,37.94391931123762,0.0826311351176725,1598.937730550766,602.7146604061127,1453.0989036560059,35406,9516,25890,25890,0,13,9196000.0
9196,9196999,20.88929226297492,37.94645495070472,0.0826392635527946,1599.1421391963959,602.7778518199921,1453.2181358337402,35408,9517,25891,25891,0,13,9197000.0
9197,9197999,20.890454477324038,37.94962582835141,0.08264891308056976,1599.2837932109833,602.8517465591431,1453.438980102539,35408,9517,25891,25891,0,13,9198000.0
9198,9198999,20.891575986572064,37.95147443324446,0.08266380070084978,1599.6372163295746,602.9146900177002,1453.4001579284668,35414,9520,25894,25894,0,13,9199000.0
9199,9199999,20.893589682998773,37.95723873386288,0.08269103625503815,1599.9406065940857,602.9777181148529,1453.4120445251465,35418,9522,25896,25896,0,13,9200000.0
9200,9200999,20.895062112788896,37.96010912464402,0.0827154189102628,1600.0596370697021,603.039547920227,1453.5788803100586,35418,9522,25896,25896,0,13,9201000.0
9201,9201999,20.896359379156998,37.96229144900374,0.08273648177932125,1600.1889431476593,603.1033132076263,1453.7172203063965,35418,9522,25896,25896,0,13,9202000.0
9202,9202999,20.897151817631112,37.96294744447837,0.08269904882947465,1600.3271083831787,603.165271282196,1454.4724617004395,35431,9522,25909,25909,0,13,9203000.0
9203,9203999,20.897350630437572,37.96391451969379,0.08265654123661292,1600.4356236457825,603.2269113063812,1455.001377105713,35434,9522,25912,25912,0,13,9204000.0
9204,9204999,20.897217434162712,37.96382378272708,0.08263131077379726,1600.6358730793,603.2884447574615,1455.2303848266602,35437,9523,25914,25914,0,13,9205000.0
9205,9205999,20.89706849718695,37.96362558392789,0.08261100556909906,1600.835304260254,603.3498418331146,1455.413688659668,35439,9524,25915,25915,0,13,9206000.0
9206,9206999,20.897025529377554,37.963328043511964,0.08259621487867586,1601.1172020435333,603.4118702411652,1455.4975242614746,35447,9526,25921,25921,0,13,9207000.0
9207,9207999,20.897105656623538,37.963322969107175,0.08257052167976386,1601.323045015335,603.4735164642334,1455.5995979309082,35449,9527,25922,25922,0,13,9208000.0
9208,9208999,20.897003383115766,37.96282972692887,0.08255657938498284,1601.4487581253052,603.5358908176422,1455.7899436950684,35449,9527,25922,25922,0,13,9209000.0
9209,9209999,20.896920567366315,37.96244610854452,0.08254557485889447,1602.0337584018707,603.6000645160675,1455.6826515197754,35487,9533,25954,25954,0,13,9210000.0
9210,9210999,20.897043276809526,37.96269276985543,0.0825234592731644,1602.2364709377289,603.6623373031616,1455.8005294799805,35489,9534,25955,25955,0,13,9211000.0
9211,9211999,20.897432975815025,37.96361266817415,0.08251261663096443,1602.443806886673,603.7243328094482,1455.9205627441406,35491,9535,25956,25956,0,13,9212000.0
9212,9212999,20.897880908330237,37.965148510649605,0.08250431474317665,1602.567227602005,603.7862539291382,1456.05082321167,35491,9535,25956,25956,0,13,9213000.0
9213,9213999,20.89812632708153,37.96520221674901,0.08251055669239349,1602.780707359314,603.8485293388367,1456.0723457336426,35493,9536,25957,25957,0,13,9214000.0
9214,9214999,20.898517389177403,37.96557005108495,0.08251125429353756,1603.0049884319305,603.9115672111511,1456.1523132324219,35496,9537,25959,25959,0,13,9215000.0
9215,9215999,20.898833968096927,37.965714358183384,0.08251943318099642,1603.2082648277283,603.9753654003143,1456.2418174743652,35498,9538,25960,25960,0,13,9216000.0
9216,9216999,20.89956730472857,37.96682403422421,0.08252690534442464,1603.3253650665283,604.0367827415466,1456.3570518493652,35498,9538,25960,25960,0,13,9217000.0
9217,9217999,20.900413113574906,37.96796039348195,0.08254885139246737,1603.4493534564972,604.0986154079437,1456.4510231018066,35498,9538,25960,25960,0,13,9218000.0
9218,9218999,20.901732168843594,37.97158731921196,0.08255814606350143,1603.7335255146027,604.1607921123505,1456.399055480957,35503,9540,25963,25963,0,13,9219000.0
9219,9219999,20.903012644715854,37.97386444485319,0.082579913360178,1604.0453667640686,604.2252061367035,1456.4175567626953,35508,9542,25966,25966,0,13,9220000.0
9220,9220999,20.904610602509617,37.978399196292344,0.08259836817759969,1604.166755914688,604.2878308296204,1456.5191688537598,35508,9542,25966,25966,0,13,9221000.0
9221,9221999,20.90600948545272,37.980086378256324,0.08261911661355403,1604.3868989944458,604.352216720581,1456.5776901245117,35510,9543,25967,25967,0,13,9222000.0
9222,9222999,20.90660199648896,37.98115808744229,0.08261043035108451,1604.6708929538727,604.4142444133759,1457.134708404541,35528,9545,25983,25983,0,13,9223000.0
9223,9223999,20.90629176419657,37.980133736326984,0.08259813583247633,1604.9468479156494,604.4766218662262,1457.3581314086914,35538,9547,25991,25991,0,13,9224000.0
9224,9224999,20.905982460434377,37.979227971285304,0.08258570326237025,1605.227205991745,604.5386121273041,1457.6453666687012,35544,9549,25995,25995,0,13,9225000.0
9225,9225999,20.905701970734025,37.978741696077,0.08257675584825475,1605.4352984428406,604.5999939441681,1457.7543601989746,35546,9550,25996,25996,0,13,9226000.0
9226,9226999,20.905369430780226,37.97792916536825,0.0825692606226004,1605.6380364894867,604.6634924411774,1457.951919555664,35548,9551,25997,25997,0,13,9227000.0
9227,9227999,20.90504014170891,37.97687847759214,0.08256317687701398,1605.8369357585907,604.7258880138397,1458.084300994873,35550,9552,25998,25998,0,13,9228000.0
9228,9228999,20.904613124328506,37.975874602654734,0.08255440290264349,1605.9721648693085,604.7880897521973,1458.2790489196777,35550,9552,25998,25998,0,13,9229000.0
9229,9229999,20.90427179895502,37.97509458814386,0.08254853912382598,1606.1765429973602,604.8514552116394,1458.372875213623,35552,9553,25999,25999,0,13,9230000.0
9230,9230999,20.90412418006702,37.97449688463574,0.0825423931081164,1606.4553339481354,604.9149603843689,1458.4280242919922,35557,9555,26002,26002,0,13,9231000.0
9231,9231999,20.90411439362259,37.975224263154296,0.08253009276191192,1606.7479906082153,604.9779965877533,1458.5044250488281,35562,9557,26005,26005,0,13,9232000.0
9232,9232999,20.904196797612034,37.975196558987804,0.08252112357105901,1606.8779952526093,605.0400874614716,1458.6732902526855,35562,9557,26005,26005,0,13,9233000.0
9233,9233999,20.904337974504923,37.97530724623082,0.08250897815092939,1607.0094065666199,605.1003122329712,1458.8136711120605,35562,9557,26005,26005,0,13,9234000.0
9234,9234999,20.90453849737559,37.97506121753754,0.08250049565079798,1607.217348575592,605.1642382144928,1458.8673286437988,35564,9558,26006,26006,0,13,9235000.0
9235,9235999,20.904670272851423,37.974698613413985,0.0824936702449619,1607.3400356769562,605.2261521816254,1459.0077209472656,35564,9558,26006,26006,0,13,9236000.0
9236,9236999,20.904756148409604,37.974092818111046,0.08248151565274575,1607.4619271755219,605.2875423431396,1459.1419830322266,35564,9558,26006,26006,0,13,9237000.0
9237,9237999,20.90479960581243,37.97345622299255,0.08247252496146285,1607.6692986488342,605.3505249023438,1459.214828491211,35566,9559,26007,26007,0,13,9238000.0
9238,9238999,20.904799779766922,37.97268891047661,0.08246224519758472,1607.805902481079,605.411868095398,1459.3782539367676,35566,9559,26007,26007,0,13,9239000.0
9239,9239999,20.904420552939296,37.97255483223907,0.08245239444210584,1607.9449152946472,605.4745020866394,1460.3151969909668,35578,9559,26019,26019,0,13,9240000.0
9240,9240999,20.90388871837227,37.97160277793231,0.08244828833988438,1608.0645649433136,605.538254737854,1460.7658386230469,35582,9559,26023,26023,0,13,9241000.0
9241,9241999,20.903540754904956,37.97187442961872,0.08244143939857607,1608.2638640403748,605.600296497345,1460.9669609069824,35584,9560,26024,26024,0,13,9242000.0
9242,9242999,20.90289789427906,37.97086970767898,0.08244108249089133,1608.550036430359,605.661655664444,1461.0197868347168,35588,9562,26026,26026,0,13,9243000.0
9243,9243999,20.902201196367994,37.969514805642135,0.08244298594928401,1609.0045731067657,605.7251734733582,1460.9130897521973,35597,9566,26031,26031,0,13,9244000.0
9244,9244999,20.901373848350666,37.96807142399777,0.08244291497414702,1609.1134703159332,605.7872593402863,1461.1823120117188,35597,9566,26031,26031,0,13,9245000.0
9245,9245999,20.90070374701214,37.96690179777143,0.0824399598587795,1609.4045736789703,605.8505790233612,1461.240119934082,35601,9568,26033,26033,0,13,9246000.0
9246,9246999,20.900214510634854,37.96606743798696,0.08243538079699508,1609.6063599586487,605.9122421741486,1461.411376953125,35603,9569,26034,26034,0,13,9247000.0
9247,9247999,20.899710580726403,37.96518691579401,0.08243308499447854,1610.0386748313904,605.9762411117554,1461.3170776367188,35611,9573,26038,26038,0,13,9248000.0
9248,9248999,20.899217092650467,37.96426868638138,0.08242919779174718,1610.1722421646118,606.0389883518219,1461.5683479309082,35611,9573,26038,26038,0,13,9249000.0
9249,9249999,20.89884236920014,37.96347693279919,0.0824231662386391,1610.285232782364,606.1025075912476,1461.7402954101562,35612,9573,26039,26039,0,13,9250000.0
9250,9250999,20.898491519771802,37.96256321361727,0.08241838350908359,1610.412458896637,606.1649243831635,1461.9054985046387,35612,9573,26039,26039,0,13,9251000.0
9251,9251999,20.89826057375457,37.9620219794838,0.08241045286822068,1610.710194826126,606.2290518283844,1461.876838684082,35616,9575,26041,26041,0,13,9252000.0
9252,9252999,20.89810769655559,37.962312656118044,0.08239970911982053,1610.924304485321,606.2913677692413,1462.011573791504,35618,9576,26042,26042,0,13,9253000.0
9253,9253999,20.89784204339326,37.96153025964264,0.08239479358351931,1611.13844704628,606.3548316955566,1462.0551681518555,35620,9577,26043,26043,0,13,9254000.0
9254,9254999,20.897551426367748,37.96066239714649,0.08239189751280684,1611.2894444465637,606.417486667633,1462.1958084106445,35620,9577,26043,26043,0,13,9255000.0
9255,9255999,20.89744942707824,37.96067512852486,0.0823829491608159,1611.506463766098,606.4870245456696,1462.256980895996,35622,9578,26044,26044,0,13,9256000.0
9256,9256999,20.89716536246641,37.960342068486874,0.08237544102142513,1611.6216657161713,606.5527675151825,1462.3487014770508,35622,9578,26044,26044,0,13,9257000.0
9257,9257999,20.89687628908991,37.95950104759798,0.08237069325931834,1611.762336730957,606.6153287887573,1462.467155456543,35622,9578,26044,26044,0,13,9258000.0
9258,9258999,20.896301377432568,37.95880330194325,0.08236221079943495,1611.8847887516022,606.6801807880402,1463.1734313964844,35632,9578,26054,26054,0,13,9259000.0
9259,9259999,20.895471408931435,37.9573360188937,0.08236488107031603,1611.9912559986115,606.7411348819733,1463.626522064209,35632,9578,26054,26054,0,13,9260000.0
9260,9260999,20.89460877359039,37.95579524409434,0.08236675197414167,1612.1172778606415,606.8043854236603,1463.9546165466309,35634,9578,26056,26056,0,13,9261000.0
9261,9261999,20.893856620420735,37.9545064435567,0.08236795484294501,1612.3177590370178,606.8650109767914,1464.1406440734863,35636,9579,26057,26057,0,13,9262000.0
9262,9262999,20.893235543891823,37.95341896455507,0.08236798148827518,1612.5997128486633,606.9260928630829,1464.262336730957,35640,9581,26059,26059,0,13,9263000.0
9263,9263999,20.89260636973335,37.952148235412636,0.08237064653228365,1612.7063157558441,606.987508058548,1464.4813385009766,35640,9581,26059,26059,0,13,9264000.0
9264,9264999,20.892026309018167,37.95094083462889,0.08237230959775499,1612.824381351471,607.0488841533661,1464.6057662963867,35640,9581,26059,26059,0,13,9265000.0
9265,9265999,20.891236852698285,37.94941863703934,0.08237572767338763,1613.355630159378,607.1127123832703,1464.5150146484375,35650,9586,26064,26064,0,13,9266000.0
9266,9266999,20.890634241535697,37.9491608288671,0.0823744591700657,1613.8017728328705,607.1751434803009,1464.4619789123535,35687,9590,26097,26097,0,13,9267000.0
9267,9267999,20.89009967452011,37.948387139681955,0.08237291974268313,1613.9703979492188,607.2436046600342,1464.6517906188965,35687,9590,26097,26097,0,13,9268000.0
9268,9268999,20.8895028343455,37.9475177655365,0.08237104724784061,1614.1776757240295,607.3069355487823,1464.7579383850098,35689,9591,26098,26098,0,13,9269000.0
9269,9269999,20.888871446768174,37.94619766217257,0.08237174627898936,1614.379198551178,607.3685786724091,1464.82523727417,35692,9592,26100,26100,0,13,9270000.0
9270,9270999,20.88846816895328,37.94552164601241,0.08236761817818594,1614.5234830379486,607.4396958351135,1464.986644744873,35692,9592,26100,26100,0,13,9271000.0
9271,9271999,20.887924559685718,37.94448214561796,0.08236676028681411,1614.8210632801056,607.5032391548157,1464.9197235107422,35696,9594,26102,26102,0,13,9272000.0
9272,9272999,20.887500869806924,37.94341858203466,0.08236480170837979,1614.954547405243,607.5660631656647,1465.071117401123,35696,9594,26102,26102,0,13,9273000.0
9273,9273999,20.886974786233292,37.94222897896278,0.08236464282451628,1615.0954871177673,607.6305453777313,1465.2177810668945,35696,9594,26102,26102,0,13,9274000.0
9274,9274999,20.886644999529036,37.941219240349234,0.08236486223172756,1615.3994009494781,607.6962630748749,1465.1832580566406,35700,9596,26104,26104,0,13,9275000.0
9275,9275999,20.886350283273654,37.94122091234458,0.08235994470552799,1615.5259766578674,607.7590842247009,1465.284008026123,35700,9596,26104,26104,0,13,9276000.0
9276,9276999,20.88584661598681,37.94003721341223,0.08236172729619384,1615.6602902412415,607.8214910030365,1465.3953971862793,35700,9596,26104,26104,0,13,9277000.0
9277,9277999,20.88525624269945,37.938814852461,0.08236370275096638,1615.8862433433533,607.8928620815277,1465.4070739746094,35702,9597,26105,26105,0,13,9278000.0
9278,9278999,20.884612004348295,37.93814364046948,0.082361913926018,1616.0249617099762,607.9546639919281,1465.5347328186035,35702,9597,26105,26105,0,13,9279000.0
9279,9279999,20.884164599069056,37.937007690858024,0.08235216424099134,1616.1399519443512,608.0153512954712,1466.3127670288086,35713,9597,26116,26116,0,13,9280000.0
9280,9280999,20.88367516718253,37.936177041275734,0.08233908363040143,1616.2670199871063,608.0763185024261,1466.6686401367188,35716,9597,26119,26119,0,13,9281000.0
9281,9281999,20.88315564795665,37.934960744238495,0.08232721292151379,1616.376053571701,608.1366171836853,1466.875228881836,35716,9597,26119,26119,0,13,9282000.0
9282,9282999,20.88274916801402,37.93397216651689,0.08230879542099112,1616.7396547794342,608.1979506015778,1466.8339157104492,35722,9600,26122,26122,0,13,9283000.0
9283,9283999,20.88213770093765,37.93271233960308,0.08230267341196595,1617.1794872283936,608.2656173706055,1466.9063262939453,35740,9604,26136,26136,0,13,9284000.0
9284,9284999,20.881508236397007,37.931493774762174,0.08230007915433046,1617.462794303894,608.3310217857361,1466.9304962158203,35744,9606,26138,26138,0,13,9285000.0
9285,9285999,20.8808321834143,37.93018453922815,0.08229784206781965,1617.7385578155518,608.3933947086334,1467.0138816833496,35748,9608,26140,26140,0,13,9286000.0
9286,9286999,20.880213559431745,37.92910463498688,0.08229410513923752,1618.025675535202,608.4570078849792,1467.1130180358887,35752,9610,26142,26142,0,13,9287000.0
9287,9287999,20.87959733474873,37.927944125796216,0.08229245169337396,1618.4066472053528,608.5201940536499,1467.198787689209,35758,9613,26145,26145,0,13,9288000.0
9288,9288999,20.87918832139405,37.92842084972824,0.08228098939514461,1618.5315597057343,608.5827848911285,1467.3921203613281,35758,9613,26145,26145,0,13,9289000.0
9289,9289999,20.87861926975234,37.92749904080035,0.08227946121169849,1618.7300899028778,608.6468241214752,1467.4503860473633,35760,9614,26146,26146,0,13,9290000.0
9290,9290999,20.87802074516129,37.92635280735046,0.08227416392510212,1619.1710624694824,608.7104570865631,1467.3663024902344,35769,9618,26151,26151,0,13,9291000.0
9291,9291999,20.877373340306626,37.925214599723866,0.08227123509507905,1619.3353962898254,608.776624917984,1467.5100708007812,35769,9618,26151,26151,0,13,9292000.0
9292,9292999,20.876810317588724,37.92408456207927,0.08226777109790695,1619.533716917038,608.8391816616058,1467.5997161865234,35771,9619,26152,26152,0,13,9293000.0
9293,9293999,20.87623697701625,37.92295746616285,0.08226659182416718,1619.7351524829865,608.9021148681641,1467.7050132751465,35773,9620,26153,26153,0,13,9294000.0
9294,9294999,20.87571204154992,37.921768372479775,0.08226354668860136,1619.89022564888,608.9785101413727,1467.8503036499023,35773,9620,26153,26153,0,13,9295000.0
9295,9295999,20.8753156390327,37.92078669598962,0.08225829357712655,1620.1053586006165,609.0406939983368,1467.8827438354492,35775,9621,26154,26154,0,13,9296000.0
9296,9296999,20.874625630390234,37.91939798455553,0.08225937955755469,1620.252427816391,609.1132259368896,1467.9928131103516,35775,9621,26154,26154,0,13,9297000.0
9297,9297999,20.873860715376,37.917928858558454,0.08226100973886263,1620.3802297115326,609.1754794120789,1468.1135330200195,35775,9621,26154,26154,0,13,9298000.0
9298,9298999,20.873206386715783,37.916555229345924,0.08225892845813598,1620.5251421928406,609.2383816242218,1468.5245094299316,35784,9621,26163,26163,0,13,9299000.0
9299,9299999,20.872583622623,37.91517642521895,0.08225897785936931,1620.6452288627625,609.299676656723,1469.23490524292,35792,9621,26171,26171,0,13,9300000.0
9300,9300999,20.871886955183452,37.913965753628595,0.0822557085661646,1620.838397026062,609.3619222640991,1469.5809288024902,35796,9622,26174,26174,0,13,9301000.0
9301,9301999,20.87115205224976,37.912904104184456,0.08225410875264927,1621.0530111789703,609.4249746799469,1469.8628005981445,35798,9623,26175,26175,0,13,9302000.0
9302,9302999,20.870528160580005,37.91177942401161,0.08225164685980868,1621.4145131111145,609.4893901348114,1469.8457794189453,35805,9626,26179,26179,0,13,9303000.0
9303,9303999,20.86973673514721,37.91047220994342,0.0822541543783194,1621.5243954658508,609.5502169132233,1470.1599349975586,35805,9626,26179,26179,0,13,9304000.0
9304,9304999,20.869026161877986,37.9096060292223,0.0822519093586922,1621.65030503273,609.612833738327,1470.3758659362793,35805,9626,26179,26179,0,13,9305000.0
9305,9305999,20.86820197563452,37.9081530864617,0.08225280437305649,1622.089453458786,609.6768963336945,1470.3149147033691,35813,9630,26183,26183,0,13,9306000.0
9306,9306999,20.867412000267354,37.90670005151934,0.08225176309083082,1622.2159197330475,609.7396483421326,1470.5500450134277,35813,9630,26183,26183,0,13,9307000.0
9307,9307999,20.866932626007454,37.90889382639453,0.08223631484884752,1622.4996900558472,609.8028221130371,1470.681251525879,35817,9632,26185,26185,0,13,9308000.0
9308,9308999,20.866259266274298,37.90768945947834,0.08223608909137214,1622.7967743873596,609.8663175106049,1470.7702026367188,35821,9634,26187,26187,0,13,9309000.0
9309,9309999,20.86561621341994,37.906477954316266,0.08223279631128555,1622.9281284809113,609.9309678077698,1470.9631080627441,35821,9634,26187,26187,0,13,9310000.0
9310,9310999,20.865066344708808,37.90537278478112,0.08222947122593038,1623.141138792038,609.9940116405487,1471.065414428711,35823,9635,26188,26188,0,13,9311000.0
9311,9311999,20.864474557019467,37.90436625434224,0.08222627998836496,1623.443202495575,610.0602843761444,1471.063648223877,35827,9637,26190,26190,0,13,9312000.0
9312,9312999,20.86416048374572,37.903595725287296,0.08222056084058971,1623.5636057853699,610.1234319210052,1471.2159690856934,35827,9637,26190,26190,0,13,9313000.0
9313,9313999,20.86383285456587,37.90277381997889,0.08221547384859695,1623.6893799304962,610.1859543323517,1471.365249633789,35827,9637,26190,26190,0,13,9314000.0
9314,9314999,20.863705425373336,37.9023150472066,0.08221487123545368,1623.9114367961884,610.2497501373291,1471.3610229492188,35829,9638,26191,26191,0,13,9315000.0
9315,9315999,20.863675876266896,37.90187308518301,0.08221129499673219,1624.1192045211792,610.3131582736969,1471.3832511901855,35831,9639,26192,26192,0,13,9316000.0
9316,9316999,20.863492221984753,37.901134467063365,0.08221264725060917,1624.3376286029816,610.3769719600677,1471.4313507080078,35833,9640,26193,26193,0,13,9317000.0
9317,9317999,20.86324471444787,37.900373750737316,0.08221156143160901,1624.638456583023,610.4414751529694,1471.48193359375,35837,9642,26195,26195,0,13,9318000.0
9318,9318999,20.862629201313823,37.89910864296604,0.0822125523651952,1624.8352432250977,610.5037174224854,1471.560245513916,35839,9643,26196,26196,0,13,9319000.0
9319,9319999,20.861940089967185,37.89771324713244,0.08221332022968031,1624.980964899063,610.5683162212372,1472.5520820617676,35856,9643,26213,26213,0,13,9320000.0
9320,9320999,20.860997019611432,37.8961933327407,0.08221737629972692,1625.178611755371,610.6296789646149,1472.908576965332,35861,9644,26217,26217,0,13,9321000.0
9321,9321999,20.860350872773427,37.89516880176062,0.08221742613297134,1625.3660020828247,610.6917498111725,1473.23091506958,35863,9645,26218,26218,0,13,9322000.0
9322,9322999,20.85971721733506,37.89408494879113,0.08221780087555852,1625.5588865280151,610.756285905838,1473.4616889953613,35865,9646,26219,26219,0,13,9323000.0
9323,9323999,20.858851237738023,37.89258881470036,0.0822219447915079,1626.0767652988434,610.8201146125793,1473.2854804992676,35875,9651,26224,26224,0,13,9324000.0
9324,9324999,20.857988480530075,37.89132308561174,0.08222699869900152,1626.1938698291779,610.8829441070557,1473.5488166809082,35875,9651,26224,26224,0,13,9325000.0
9325,9325999,20.85700880315977,37.889788190772066,0.0822339238596862,1626.475580215454,610.9466888904572,1473.5630149841309,35879,9653,26226,26226,0,13,9326000.0
9326,9326999,20.856075633764654,37.888327150687644,0.08223857608850993,1626.8380739688873,611.0088250637054,1473.6840934753418,35885,9656,26229,26229,0,13,9327000.0
9327,9327999,20.855132104495137,37.88682033254137,0.08224596741803414,1627.1258401870728,611.0733935832977,1473.7623291015625,35889,9658,26231,26231,0,13,9328000.0
9328,9328999,20.85429379497973,37.88557423729378,0.08225153988218525,1627.2509505748749,611.1366403102875,1473.984977722168,35889,9658,26231,26231,0,13,9329000.0
9329,9329999,20.85342747105821,37.884145186351006,0.08225665570496987,1627.5469818115234,611.2003221511841,1473.984203338623,35894,9660,26234,26234,0,13,9330000.0
9330,9330999,20.852703111987484,37.88311313411809,0.08225733097868071,1627.8490216732025,611.2671303749084,1473.9915580749512,35899,9662,26237,26237,0,13,9331000.0
9331,9331999,20.851934929080794,37.881815605106276,0.08225825666518938,1628.1331293582916,611.3306586742401,1473.9951515197754,35905,9664,26241,26241,0,13,9332000.0
9332,9332999,20.851308473486654,37.88084757394721,0.08225589640502129,1628.3464307785034,611.393735408783,1474.1083679199219,35907,9665,26242,26242,0,13,9333000.0
9333,9333999,20.850657215000435,37.879735153835995,0.0822539599716059,1628.4810121059418,611.4565670490265,1474.2612991333008,35907,9665,26242,26242,0,13,9334000.0
9334,9334999,20.850165270835767,37.87883463582083,0.08225120164360289,1628.6281399726868,611.5187020301819,1474.4114799499512,35907,9665,26242,26242,0,13,9335000.0
9335,9335999,20.849931939773892,37.878342133780535,0.082243502385564,1628.7448375225067,611.5812091827393,1474.5206451416016,35907,9665,26242,26242,0,13,9336000.0
9336,9336999,20.849883043636552,37.87858717031879,0.08223059290233692,1628.9560487270355,611.6435644626617,1474.5644645690918,35909,9666,26243,26243,0,13,9337000.0
9337,9337999,20.849850832795077,37.87898670928793,0.08222313299267348,1629.1647930145264,611.705851316452,1474.6500549316406,35911,9667,26244,26244,0,13,9338000.0
9338,9338999,20.850282031150048,37.880235773639775,0.08220793623712175,1629.3584995269775,611.769758939743,1474.7260398864746,35913,9668,26245,26245,0,13,9339000.0
9339,9339999,20.850191011994575,37.88046098979201,0.08219822884009653,1629.5663220882416,611.8335733413696,1475.3480262756348,35937,9669,26268,26268,0,13,9340000.0
9340,9340999,20.84951807491245,37.87933506892226,0.0821985334425277,1629.7688641548157,611.8961925506592,1475.8136024475098,35943,9670,26273,26273,0,13,9341000.0
9341,9341999,20.84899395336422,37.87908743738418,0.08219384937536589,1629.9719483852386,611.9617304801941,1476.1553001403809,35948,9671,26277,26277,0,13,9342000.0
9342,9342999,20.84824996487642,37.87765679257682,0.0821967694020781,1630.238805770874,612.0234844684601,1476.3168411254883,35952,9673,26279,26279,0,13,9343000.0
9343,9343999,20.847737418613992,37.87883474496079,0.08218673848917679,1630.6920228004456,612.0868847370148,1476.3246269226074,35961,9677,26284,26284,0,13,9344000.0
9344,9344999,20.847199384985117,37.87854055576277,0.08218288079240499,1630.9082748889923,612.1505365371704,1476.5511589050293,35963,9678,26285,26285,0,13,9345000.0
9345,9345999,20.84660733165713,37.87773730721104,0.08218483080540029,1631.1865561008453,612.2126941680908,1476.6566429138184,35971,9680,26291,26291,0,13,9346000.0
9346,9346999,20.846029820012323,37.876593634324784,0.08218192749436226,1631.544064283371,612.275839805603,1476.709373474121,35977,9683,26294,26294,0,13,9347000.0
9347,9347999,20.845292369738498,37.875401933790954,0.08218196839183611,1631.8276228904724,612.3399150371552,1476.8297080993652,35981,9685,26296,26296,0,13,9348000.0
9348,9348999,20.844581602426523,37.874056534013036,0.08218354477042333,1632.1068060398102,612.403373003006,1476.9141006469727,35986,9687,26299,26299,0,13,9349000.0
9349,9349999,20.84405192382749,37.87350994216949,0.08218007362925728,1632.3102946281433,612.4668726921082,1477.0433044433594,35991,9688,26303,26303,0,13,9350000.0
9350,9350999,20.843466373498924,37.87263717553018,0.08217870243065328,1632.5242178440094,612.5304458141327,1477.085678100586,35993,9689,26304,26304,0,13,9351000.0
9351,9351999,20.842976479632217,37.87168968753594,0.0821758845239069,1632.6545400619507,612.5927290916443,1477.226219177246,35993,9689,26304,26304,0,13,9352000.0
9352,9352999,20.842342432299745,37.870463400710506,0.08217473742955572,1632.7848036289215,612.6571574211121,1477.3510665893555,35993,9689,26304,26304,0,13,9353000.0
9353,9353999,20.84185953156731,37.86941738064493,0.0821716010787723,1632.9141266345978,612.7222499847412,1477.5046730041504,35993,9689,26304,26304,0,13,9354000.0
9354,9354999,20.841427227836835,37.86846703497765,0.08216706621796865,1633.0439066886902,612.7868032455444,1477.6389198303223,35993,9689,26304,26304,0,13,9355000.0
9355,9355999,20.840979449603378,37.867394867313756,0.08216254172469717,1633.2583804130554,612.850389957428,1477.679630279541,35995,9690,26305,26305,0,13,9356000.0
9356,9356999,20.840617955679324,37.866501463464296,0.08215918626620378,1633.470244884491,612.9135720729828,1477.7250366210938,35997,9691,26306,26306,0,13,9357000.0
9357,9357999,20.84016325790838,37.86544125489005,0.08215601811973705,1633.598155260086,612.9759001731873,1477.8566055297852,35997,9691,26306,26306,0,13,9358000.0
9358,9358999,20.83967275663636,37.86432442282458,0.08215329326253484,1633.7322187423706,613.0389955043793,1477.9722633361816,35997,9691,26306,26306,0,13,9359000.0
9359,9359999,20.839209381133877,37.86372582864147,0.08214624319234054,1633.8615686893463,613.1029088497162,1478.0890426635742,35997,9691,26306,26306,0,13,9360000.0
9360,9360999,20.838578685994158,37.86344850966622,0.0821478833657302,1634.0731537342072,613.1650593280792,1478.8028678894043,36012,9692,26320,26320,0,13,9361000.0
9361,9361999,20.83765363824828,37.861863447693956,0.0821574523055636,1634.1898577213287,613.2257876396179,1479.2136917114258,36014,9692,26322,26322,0,13,9362000.0
9362,9362999,20.83688508511075,37.861152342115595,0.082160913183143,1634.4733397960663,613.290296792984,1479.4589729309082,36019,9694,26325,26325,0,13,9363000.0
9363,9363999,20.83625846877216,37.860560806260295,0.08216105189877143,1634.6669132709503,613.3527119159698,1479.6801376342773,36021,9695,26326,26326,0,13,9364000.0
9364,9364999,20.835647372258045,37.8595332201877,0.08216142233785684,1634.8800575733185,613.414204120636,1479.828411102295,36023,9696,26327,26327,0,13,9365000.0
9365,9365999,20.835109111073084,37.858577094711826,0.08216209081540882,1635.0751180648804,613.4784116744995,1480.0521621704102,36025,9697,26328,26328,0,13,9366000.0
9366,9366999,20.834583710811575,37.858177090151564,0.08215946979327804,1635.455284357071,613.5439541339874,1480.0330772399902,36031,9700,26331,26331,0,13,9367000.0
9367,9367999,20.83403357297328,37.85714965119057,0.08216121912124252,1635.8209838867188,613.6065974235535,1480.0598487854004,36037,9703,26334,26334,0,13,9368000.0
9368,9368999,20.833576463156007,37.85667002036178,0.08216083693987553,1636.1200318336487,613.669064283371,1480.1024131774902,36047,9705,26342,26342,0,13,9369000.0
9369,9369999,20.833132816959434,37.855913313152,0.08216278348177153,1636.2542114257812,613.7323400974274,1480.2971267700195,36047,9705,26342,26342,0,13,9370000.0
9370,9370999,20.83262912462047,37.85474273298564,0.08216722668293985,1636.4426381587982,613.7932481765747,1480.3559226989746,36049,9706,26343,26343,0,13,9371000.0
9371,9371999,20.83214726561985,37.85380230037625,0.08217142548604528,1636.5675530433655,613.8562948703766,1480.475471496582,36049,9706,26343,26343,0,13,9372000.0
9372,9372999,20.831737443627706,37.852820604582156,0.0821776005721202,1636.6861929893494,613.9185788631439,1480.6103515625,36049,9706,26343,26343,0,13,9373000.0
9373,9373999,20.831246315428018,37.851610655761235,0.08218393103240751,1636.8138146400452,613.9815838336945,1480.7327880859375,36049,9706,26343,26343,0,13,9374000.0
9374,9374999,20.8309298261862,37.850673536520816,0.0821877678829891,1637.0430936813354,614.0436720848083,1480.7605285644531,36051,9707,26344,26344,0,13,9375000.0
9375,9375999,20.8304560381151,37.84959176900446,0.08219473025517565,1637.2607135772705,614.1082632541656,1480.8503456115723,36053,9708,26345,26345,0,13,9376000.0
9376,9376999,20.829805122846086,37.848231140821,0.0822005716373585,1637.458033323288,614.1706869602203,1480.9326438903809,36056,9709,26347,26347,0,13,9377000.0
9377,9377999,20.82906577653549,37.8474274759708,0.082209682372684,1637.5932023525238,614.2329394817352,1481.724754333496,36066,9709,26357,26357,0,13,9378000.0
9378,9378999,20.82821510982458,37.84635005301933,0.08221499152932432,1637.7948174476624,614.2963206768036,1482.0095024108887,36069,9710,26359,26359,0,13,9379000.0
9379,9379999,20.8273569829607,37.84495735317571,0.08222196709687779,1637.90451669693,614.3569188117981,1482.2701034545898,36069,9710,26359,26359,0,13,9380000.0
9380,9380999,20.82652714577832,37.84368127864512,0.08222567793933067,1638.118196964264,614.421959400177,1482.4519271850586,36072,9711,26361,26361,0,13,9381000.0
9381,9381999,20.825803822919696,37.8424476286975,0.08222794851187176,1638.3069760799408,614.4841196537018,1482.5804557800293,36074,9712,26362,26362,0,13,9382000.0
9382,9382999,20.82511697676573,37.84172018120337,0.08222712732209536,1638.6002087593079,614.5475988388062,1482.6495780944824,36079,9714,26365,26365,0,13,9383000.0
9383,9383999,20.824523865666553,37.84089421513053,0.08222516591896123,1638.813069820404,614.6099545955658,1482.748104095459,36081,9715,26366,26366,0,13,9384000.0
9384,9384999,20.823916747860714,37.84040241207378,0.08222251105059653,1639.3396534919739,614.672351360321,1482.644874572754,36092,9720,26372,26372,0,13,9385000.0
9385,9385999,20.823330562536583,37.83939873334283,0.08222208041668044,1639.4689722061157,614.7351558208466,1482.8826332092285,36092,9720,26372,26372,0,13,9386000.0
9386,9386999,20.82284970495345,37.83862548873137,0.08222109439252945,1639.8460059165955,614.79798579216,1482.918270111084,36098,9723,26375,26375,0,13,9387000.0
9387,9387999,20.822784636844077,37.83867491892718,0.08221223135860445,1639.9653160572052,614.861083984375,1483.0851974487305,36098,9723,26375,26375,0,13,9388000.0
9388,9388999,20.822653666856997,37.83851228732021,0.08220407792317586,1640.0992574691772,614.9236297607422,1483.2206726074219,36098,9723,26375,26375,0,13,9389000.0
9389,9389999,20.82274459101627,37.83873749789438,0.0821972211697104,1640.3131184577942,614.9867701530457,1483.2596702575684,36100,9724,26376,26376,0,13,9390000.0
9390,9390999,20.82278603585762,37.83890899928955,0.0821906807324243,1640.531111240387,615.0486993789673,1483.315761566162,36102,9725,26377,26377,0,13,9391000.0
9391,9391999,20.823127966060117,37.8396179169136,0.08217998078124311,1640.6581637859344,615.1108689308167,1483.4366035461426,36102,9725,26377,26377,0,13,9392000.0
9392,9392999,20.8234733708296,37.84010405792147,0.08217651838982021,1640.7853465080261,615.172774553299,1483.5627326965332,36102,9725,26377,26377,0,13,9393000.0
9393,9393999,20.82371083595971,37.84032857145145,0.08217105864230845,1640.998703956604,615.2344906330109,1483.6116333007812,36110,9726,26384,26384,0,13,9394000.0
9394,9394999,20.82389114075924,37.84086303622587,0.08216345485550547,1641.130827665329,615.2964136600494,1483.687572479248,36110,9726,26384,26384,0,13,9395000.0
9395,9395999,20.824026944239478,37.84077348800184,0.08215947291655756,1641.2541179656982,615.3613040447235,1483.7881927490234,36110,9726,26384,26384,0,13,9396000.0
9396,9396999,20.823780348035427,37.840222643719024,0.0821566986565142,1641.3966841697693,615.4274256229401,1484.3788375854492,36121,9726,26395,26395,0,13,9397000.0
9397,9397999,20.822840694718423,37.839104139362156,0.0821612016439397,1641.5024893283844,615.489015340805,1484.8061637878418,36121,9726,26395,26395,0,13,9398000.0
9398,9398999,20.821934565703312,37.83806510839898,0.0821641796569842,1641.8537719249725,615.5512547492981,1484.893268585205,36130,9729,26401,26401,0,13,9399000.0
9399,9399999,20.821073009928444,37.83672985656142,0.08216811529492551,1642.1239590644836,615.613362789154,1485.0004844665527,36134,9731,26403,26403,0,13,9400000.0
9400,9400999,20.82037775480933,37.8359119048446,0.08216640292147381,1642.3448193073273,615.6761782169342,1485.2054862976074,36136,9732,26404,26404,0,13,9401000.0
9401,9401999,20.819633286492323,37.83529422073424,0.08216371026808256,1642.548951625824,615.738799571991,1485.3731307983398,36138,9733,26405,26405,0,13,9402000.0
9402,9402999,20.818840418327017,37.83395575755356,0.08216556106014494,1642.7585725784302,615.8021490573883,1485.4153594970703,36140,9734,26406,26406,0,13,9403000.0
9403,9403999,20.818095765462516,37.83270240129457,0.08216770132434725,1643.0565140247345,615.8636333942413,1485.4273643493652,36145,9736,26409,26409,0,13,9404000.0
9404,9404999,20.817322986560313,37.831449168604834,0.08216824752290597,1643.418924331665,615.9269659519196,1485.389560699463,36151,9739,26412,26412,0,13,9405000.0
9405,9405999,20.816614613527786,37.830205745935395,0.08216980142744168,1643.6167781352997,615.9886884689331,1485.5208549499512,36154,9740,26414,26414,0,13,9406000.0
9406,9406999,20.815960934160554,37.82902873643649,0.08217004410032924,1643.7466576099396,616.0510070323944,1485.6589317321777,36154,9740,26414,26414,0,13,9407000.0
9407,9407999,20.815403980513942,37.828021728495884,0.08216942180826381,1643.9498949050903,616.1140336990356,1485.6892280578613,36156,9741,26415,26415,0,13,9408000.0
9408,9408999,20.814753835734045,37.8268676162096,0.08216931297605601,1644.1702191829681,616.1757800579071,1485.732192993164,36158,9742,26416,26416,0,13,9409000.0
9409,9409999,20.81420141265701,37.82597723193692,0.08216950532231349,1644.3837337493896,616.2401251792908,1485.7821006774902,36160,9743,26417,26417,0,13,9410000.0
9410,9410999,20.81377442110352,37.82510600932976,0.08216990226359444,1644.527818441391,616.3042812347412,1485.9286003112793,36160,9743,26417,26417,0,13,9411000.0
9411,9411999,20.813335633868984,37.824140036094725,0.08217188174789503,1644.7242333889008,616.3665590286255,1486.0051193237305,36162,9744,26418,26418,0,13,9412000.0
9412,9412999,20.812949821230163,37.823286083116734,0.08217049881875149,1644.9365186691284,616.4294531345367,1486.0335960388184,36164,9745,26419,26419,0,13,9413000.0
9413,9413999,20.812605880610697,37.82254302814055,0.08216816775560731,1645.1366019248962,616.4921762943268,1486.0860786437988,36166,9746,26420,26420,0,13,9414000.0
9414,9414999,20.81218806946634,37.8225535560553,0.08216456823236551,1645.4622745513916,616.5631268024445,1486.0297012329102,36171,9748,26423,26423,0,13,9415000.0
9415,9415999,20.81151390372299,37.82126827262423,0.08216601633595477,1645.7494390010834,616.6262011528015,1486.0159721374512,36175,9750,26425,26425,0,13,9416000.0
9416,9416999,20.810848603299632,37.82002313457621,0.08216651230973848,1645.961880683899,616.687915802002,1486.1044006347656,36177,9751,26426,26426,0,13,9417000.0
9417,9417999,20.80999887512821,37.8184933471016,0.08217434537333135,1646.250064611435,616.7509894371033,1486.7079048156738,36192,9753,26439,26439,0,13,9418000.0
9418,9418999,20.809041652899968,37.81711381774509,0.08218101393188926,1646.3603348731995,616.8117461204529,1487.1208229064941,36193,9753,26440,26440,0,13,9419000.0
9419,9419999,20.808064778181173,37.81547708305618,0.0821895247436708,1646.5613176822662,616.8744132518768,1487.3539428710938,36195,9754,26441,26441,0,13,9420000.0
9420,9420999,20.807155372917897,37.814001196149036,0.08219442291928647,1647.1002509593964,616.9380939006805,1487.2955703735352,36216,9759,26457,26457,0,13,9421000.0
9421,9421999,20.80636251100317,37.8126927749227,0.08219807457130435,1647.216472864151,617.0012481212616,1487.5780181884766,36216,9759,26457,26457,0,13,9422000.0
9422,9422999,20.80549462761335,37.811262450359685,0.08220245977187302,1647.3217642307281,617.0618028640747,1487.7810249328613,36216,9759,26457,26457,0,13,9423000.0
9423,9423999,20.804663586920213,37.80986162801492,0.0822077634415812,1647.6201508045197,617.1239976882935,1487.854606628418,36220,9761,26459,26459,0,13,9424000.0
9424,9424999,20.803786095169734,37.80841668723398,0.08221183992871262,1648.0664949417114,617.1867423057556,1487.8794288635254,36228,9765,26463,26463,0,13,9425000.0
9425,9425999,20.80298696478653,37.80706707053415,0.08221630848847239,1648.4388971328735,617.2510607242584,1487.98486328125,36234,9768,26466,26466,0,13,9426000.0
9426,9426999,20.802292231250355,37.80601011136581,0.0822199933045692,1648.5734384059906,617.3133125305176,1488.1647300720215,36234,9768,26466,26466,0,13,9427000.0
9427,9427999,20.801459794062204,37.804533523061075,0.0822252864159162,1648.699250459671,617.375004529953,1488.3440170288086,36234,9768,26466,26466,0,13,9428000.0
9428,9428999,20.800742151988935,37.8032489368251,0.08222876127680834,1648.901948928833,617.4384989738464,1488.3478622436523,36237,9769,26468,26468,0,13,9429000.0
9429,9429999,20.80009688822175,37.80213568010002,0.08222948625814452,1649.0403394699097,617.5035016536713,1488.5112648010254,36237,9769,26468,26468,0,13,9430000.0
9430,9430999,20.799438905658043,37.80086953077039,0.0822320901260285,1649.1578180789948,617.5647740364075,1488.636318206787,36237,9769,26468,26468,0,13,9431000.0
9431,9431999,20.798860271230033,37.79994493051641,0.08223452332582326,1649.3725373744965,617.6275568008423,1488.6655654907227,36239,9770,26469,26469,0,13,9432000.0
9432,9432999,20.798240740417153,37.79867783942572,0.08223819398747245,1649.5709455013275,617.6920199394226,1488.75537109375,36241,9771,26470,26470,0,13,9433000.0
9433,9433999,20.797560990508074,37.797305450437804,0.08224455375241024,1649.7255532741547,617.7545564174652,1488.8787536621094,36241,9771,26470,26470,0,13,9434000.0
9434,9434999,20.796925579757715,37.79596734764277,0.08224869817944824,1649.8630561828613,617.8160412311554,1488.9794425964355,36241,9771,26470,26470,0,13,9435000.0
9435,9435999,20.79623040924071,37.79455548999195,0.08225497718301045,1650.0610239505768,617.8788912296295,1488.9695739746094,36244,9772,26472,26472,0,13,9436000.0
9436,9436999,20.795397207021537,37.793042392105576,0.0822631621301132,1650.1920766830444,617.941211938858,1489.1406364440918,36244,9772,26472,26472,0,13,9437000.0
9437,9437999,20.794504092317897,37.79172859436261,0.08227047825535394,1650.4683039188385,618.0033442974091,1489.9706954956055,36277,9774,26503,26503,0,13,9438000.0
9438,9438999,20.793569816855946,37.79088915765034,0.082279190212309,1650.5793421268463,618.0643169879913,1490.4398803710938,36279,9774,26505,26505,0,13,9439000.0
9439,9439999,20.792879426478443,37.789901677449464,0.08228222405936314,1650.863998413086,618.1267504692078,1490.6535987854004,36284,9776,26508,26508,0,13,9440000.0
9440,9440999,20.792155974189725,37.78862959169353,0.08228467584084154,1651.232275724411,618.1871161460876,1490.5840377807617,36290,9779,26511,26511,0,13,9441000.0
9441,9441999,20.79130302419858,37.78736940875874,0.08228822740315245,1651.425620317459,618.2485792636871,1490.8952522277832,36293,9780,26513,26513,0,13,9442000.0
9442,9442999,20.79063063648348,37.7863303837717,0.0822887812338442,1651.7168138027191,618.3179187774658,1491.0592880249023,36297,9782,26515,26515,0,13,9443000.0
9443,9443999,20.7899943975565,37.78539200849803,0.0822886919194411,1652.0932433605194,618.3829507827759,1491.0526733398438,36303,9785,26518,26518,0,13,9444000.0
9444,9444999,20.789352848448058,37.78476824470245,0.08228626363913594,1652.2276394367218,618.4458341598511,1491.3753356933594,36303,9785,26518,26518,0,13,9445000.0
9445,9445999,20.78879952627149,37.78377128915867,0.08228444948083435,1652.5978872776031,618.5091414451599,1491.3887977600098,36309,9788,26521,26521,0,13,9446000.0
9446,9446999,20.788136719635123,37.78268240653934,0.08228452397361119,1652.7232525348663,618.5741047859192,1491.5818634033203,36309,9788,26521,26521,0,13,9447000.0
9447,9447999,20.787595283252074,37.781707382631936,0.08228369659508383,1652.8420188426971,618.6365249156952,1491.739315032959,36309,9788,26521,26521,0,13,9448000.0
9448,9448999,20.78701154903604,37.78104041892342,0.08228266658485872,1653.0501265525818,618.6985640525818,1491.7931823730469,36317,9789,26528,26528,0,13,9449000.0
9449,9449999,20.786390802484508,37.77988114358867,0.08228348819258358,1653.3474617004395,618.7632484436035,1491.7800331115723,36321,9791,26530,26530,0,13,9450000.0
9450,9450999,20.785791497203967,37.778661749039124,0.08228388666306652,1653.5514731407166,618.8258578777313,1491.84912109375,36323,9792,26531,26531,0,13,9451000.0
9451,9451999,20.785292562541926,37.777770870648,0.08228188607739406,1653.680836200714,618.8874921798706,1492.0211181640625,36323,9792,26531,26531,0,13,9452000.0
9452,9452999,20.78500404638135,37.77703370270356,0.082278015289598,1653.8089368343353,618.949718952179,1492.1438102722168,36323,9792,26531,26531,0,13,9453000.0
9453,9453999,20.784706630259276,37.77643616849009,0.082274778761662,1653.9474716186523,619.0156364440918,1492.2663536071777,36323,9792,26531,26531,0,13,9454000.0
9454,9454999,20.784501620113787,37.77577503118515,0.08226903974764355,1654.0915458202362,619.0775992870331,1492.3732452392578,36323,9792,26531,26531,0,13,9455000.0
9455,9455999,20.784322383456384,37.77591345047575,0.08226340606235716,1654.2977652549744,619.1403863430023,1492.3622932434082,36325,9793,26532,26532,0,13,9456000.0
9456,9456999,20.78430216327876,37.7763924636566,0.08225816061298008,1654.4262268543243,619.2067513465881,1492.4980430603027,36325,9793,26532,26532,0,13,9457000.0
9457,9457999,20.784003877634845,37.776097004194405,0.08225783187356628,1654.555831670761,619.2720279693604,1493.3391304016113,36340,9793,26547,26547,0,13,9458000.0
9458,9458999,20.783292571914302,37.77547306508424,0.08225821814103706,1654.6640360355377,619.3328461647034,1493.804946899414,36342,9793,26549,26549,0,13,9459000.0
9459,9459999,20.782428144359937,37.774171475737155,0.08226187693535914,1654.8565392494202,619.3954522609711,1494.1161994934082,36346,9794,26552,26552,0,13,9460000.0
9460,9460999,20.781676648572144,37.77304841889511,0.08226126889454388,1655.0596437454224,619.4580583572388,1494.3413772583008,36348,9795,26553,26553,0,13,9461000.0
9461,9461999,20.780945110634082,37.77182727032644,0.08225965785688227,1655.195678472519,619.5205507278442,1494.5404663085938,36348,9795,26553,26553,0,13,9462000.0
9462,9462999,20.780236117785734,37.7730899036911,0.0822517714833193,1655.396433353424,619.5831594467163,1494.640697479248,36350,9796,26554,26554,0,13,9463000.0
9463,9463999,20.77944588498208,37.771687180352636,0.0822527302667504,1655.858610868454,619.6464824676514,1494.6225547790527,36364,9800,26564,26564,0,13,9464000.0
9464,9464999,20.778785846448162,37.77154317161655,0.08219192776001027,1656.067643404007,619.7093849182129,1494.7709350585938,36366,9801,26565,26565,0,13,9465000.0
9465,9465999,20.778446623168932,37.77264822028983,0.08210730738953864,1656.2741661071777,619.7711958885193,1494.902473449707,36368,9802,26566,26566,0,13,9466000.0
9466,9466999,20.77820802778844,37.77287952150367,0.0820448580299169,1656.413994550705,619.8329091072083,1495.0981750488281,36368,9802,26566,26566,0,13,9467000.0
9467,9467999,20.777740120466227,37.772074349097814,0.08202424867567615,1656.6072373390198,619.893789768219,1495.1645545959473,36370,9803,26567,26567,0,13,9468000.0
9468,9468999,20.777347948603943,37.77162994076709,0.08200654039075328,1656.7230687141418,619.9574961662292,1495.3017654418945,36370,9803,26567,26567,0,13,9469000.0
9469,9469999,20.776899115851062,37.77064360084067,0.08199193581659792,1656.940357208252,620.0208103656769,1495.3626899719238,36372,9804,26568,26568,0,13,9470000.0
9470,9470999,20.77652972454561,37.76991926483103,0.08197926463299154,1657.151468038559,620.0836808681488,1495.3825073242188,36374,9805,26569,26569,0,13,9471000.0
9471,9471999,20.776167377976364,37.76911823479794,0.08197228420390212,1657.352145910263,620.1480798721313,1495.4302711486816,36376,9806,26570,26570,0,13,9472000.0
9472,9472999,20.775739266277586,37.768398555560175,0.08196593092168047,1657.5607318878174,620.2108964920044,1495.5264778137207,36378,9807,26571,26571,0,13,9473000.0
9473,9473999,20.77562572796987,37.767954463221024,0.08195634516526806,1657.6874165534973,620.2724375724792,1495.6709365844727,36378,9807,26571,26571,0,13,9474000.0
9474,9474999,20.77547928523394,37.76719507489752,0.08194957031717687,1658.131828546524,620.3352355957031,1495.477424621582,36386,9811,26575,26575,0,13,9475000.0
9475,9475999,20.775212876286115,37.766443521057205,0.0819467513286688,1658.363713502884,620.408616065979,1495.5375862121582,36388,9812,26576,26576,0,13,9476000.0
9476,9476999,20.77489750411672,37.76557635522671,0.08194242780951189,1658.6688990592957,620.4727501869202,1495.6030006408691,36393,9814,26579,26579,0,13,9477000.0
9477,9477999,20.774473625410128,37.764522015961965,0.08194074488838754,1658.7938375473022,620.5353603363037,1495.928524017334,36396,9814,26582,26582,0,13,9478000.0
9478,9478999,20.774498055795593,37.76428441494292,0.08188339304840009,1658.924432516098,620.5981938838959,1496.751537322998,36410,9814,26596,26596,0,13,9479000.0
9479,9479999,20.77397966891538,37.763136501079266,0.08186751175764984,1659.2036805152893,620.6608471870422,1496.945571899414,36418,9816,26602,26602,0,13,9480000.0
9480,9480999,20.77345246170986,37.76232088882575,0.08185380953880728,1659.4780716896057,620.7236711978912,1497.1087226867676,36432,9818,26614,26614,0,13,9481000.0
9481,9481999,20.772896615352213,37.761160521247355,0.08184431811912118,1659.8381776809692,620.789133310318,1497.1845703125,36438,9821,26617,26617,0,13,9482000.0
9482,9482999,20.77239222219506,37.76038770549517,0.08183818724124814,1660.0310776233673,620.8511862754822,1497.513271331787,36440,9822,26618,26618,0,13,9483000.0
9483,9483999,20.771989777866704,37.75939718969243,0.08183393970085484,1660.1648499965668,620.9138283729553,1497.714340209961,36440,9822,26618,26618,0,13,9484000.0
9484,9484999,20.771638588996332,37.75856452525499,0.08183245970122321,1660.477117061615,620.979421377182,1497.7069511413574,36444,9824,26620,26620,0,13,9485000.0
9485,9485999,20.77121260942328,37.75771708775441,0.08183420564129573,1660.6831226348877,621.042605638504,1497.875343322754,36446,9825,26621,26621,0,13,9486000.0
9486,9486999,20.770965370059105,37.75696159129501,0.08184350268579343,1660.9744493961334,621.1048395633698,1497.972743988037,36450,9827,26623,26623,0,13,9487000.0
9487,9487999,20.770851181874733,37.75647988398522,0.08184637294075237,1661.099065065384,621.1678614616394,1498.1380424499512,36450,9827,26623,26623,0,13,9488000.0
9488,9488999,20.77131287150042,37.7574388826523,0.08186396701450671,1661.2198972702026,621.2307591438293,1498.313377380371,36450,9827,26623,26623,0,13,9489000.0
9489,9489999,20.77184257665621,37.75922904481558,0.0818780906324692,1661.4368596076965,621.2938117980957,1498.3825798034668,36452,9828,26624,26624,0,13,9490000.0
9490,9490999,20.772373664593893,37.760385997003105,0.08188446925212023,1661.5607569217682,621.3577103614807,1498.4979858398438,36452,9828,26624,26624,0,13,9491000.0
9491,9491999,20.773211000307544,37.762523475320094,0.08189038674143234,1661.7685935497284,621.4203305244446,1498.541576385498,36454,9829,26625,26625,0,13,9492000.0
9492,9492999,20.77444169016952,37.76644966652325,0.08188977378229223,1662.0574486255646,621.4860098361969,1498.5956726074219,36458,9831,26627,26627,0,13,9493000.0
9493,9493999,20.776053603970393,37.77270729285517,0.08190701527849109,1662.3447005748749,621.5493175983429,1498.5942611694336,36462,9833,26629,26629,0,13,9494000.0
9494,9494999,20.777549005079553,37.77711102343421,0.08192282897216052,1662.644850730896,621.613452911377,1498.6692733764648,36466,9835,26631,26631,0,13,9495000.0
9495,9495999,20.7791799333831,37.780565753993166,0.0819276701001318,1662.95068693161,621.678197145462,1498.6517028808594,36470,9837,26633,26633,0,13,9496000.0
9496,9496999,20.78063719233986,37.78383629252124,0.08194341518625481,1663.1735599040985,621.7507688999176,1498.7468643188477,36472,9838,26634,26634,0,13,9497000.0
9497,9497999,20.781535347464885,37.78573227963077,0.08194253776165217,1663.2926774024963,621.8130295276642,1499.1354942321777,36478,9838,26640,26640,0,13,9498000.0
9498,9498999,20.781626470846092,37.785775362486625,0.08190947964029749,1663.505780696869,621.8744275569916,1499.626823425293,36487,9839,26648,26648,0,13,9499000.0
9499,9499999,20.781321797029406,37.78591400330273,0.08189795045093795,1663.619281053543,621.9386854171753,1499.9839210510254,36489,9839,26650,26650,0,13,9500000.0
9500,9500999,20.781009664736985,37.78547675592241,0.08189215690421436,1663.8895297050476,621.999743938446,1500.08296585083,36493,9841,26652,26652,0,13,9501000.0
9501,9501999,20.780743819411583,37.78493799141079,0.08188767345846037,1664.0814232826233,622.0612418651581,1500.3122634887695,36496,9842,26654,26654,0,13,9502000.0
9502,9502999,20.780402568279165,37.7842875105555,0.08187713286526821,1664.2038197517395,622.1218922138214,1500.5542526245117,36496,9842,26654,26654,0,13,9503000.0
9503,9503999,20.78001758490737,37.78361008999332,0.08186762352880361,1664.487738609314,622.1836614608765,1500.6293144226074,36500,9844,26656,26656,0,13,9504000.0
9504,9504999,20.77959406601501,37.78279816288326,0.08186342239970346,1664.6963760852814,622.245334148407,1500.759132385254,36502,9845,26657,26657,0,13,9505000.0
9505,9505999,20.779130020091127,37.78196890444703,0.08186071634002756,1664.970243692398,622.3074533939362,1500.8030815124512,36506,9847,26659,26659,0,13,9506000.0
9506,9506999,20.778831224720694,37.78136780993444,0.08185810926037362,1665.281858921051,622.3699686527252,1500.7725944519043,36510,9849,26661,26661,0,13,9507000.0
9507,9507999,20.7787868314683,37.781401258109426,0.08184855688930148,1665.5585398674011,622.4318337440491,1500.8490943908691,36514,9851,26663,26663,0,13,9508000.0
9508,9508999,20.778637478353406,37.78110085668767,0.0818489161654995,1665.771628856659,622.495275259018,1500.9540672302246,36516,9852,26664,26664,0,13,9509000.0
9509,9509999,20.77840996072801,37.780566580431,0.08185174085919444,1665.9819505214691,622.557669878006,1501.0882835388184,36518,9853,26665,26665,0,13,9510000.0
9510,9510999,20.77837020055452,37.780546500612495,0.08185625578412714,1666.1792538166046,622.6206047534943,1501.1575469970703,36520,9854,26666,26666,0,13,9511000.0
9511,9511999,20.778316321392946,37.780117697541634,0.08186358902993107,1666.310583114624,622.6830408573151,1501.3108024597168,36520,9854,26666,26666,0,13,9512000.0
9512,9512999,20.77811408133675,37.77948777414626,0.08186683368344749,1666.5193965435028,622.7458486557007,1501.3795433044434,36522,9855,26667,26667,0,13,9513000.0
9513,9513999,20.778165899916818,37.779815026034925,0.08186636708560291,1666.737071275711,622.8084847927094,1501.5178451538086,36524,9856,26668,26668,0,13,9514000.0
9514,9514999,20.77805309370607,37.77925740158512,0.08185484026142431,1666.8669893741608,622.8705697059631,1502.1782341003418,36535,9856,26679,26679,0,13,9515000.0
9515,9515999,20.777816876572448,37.77913980404576,0.08183855725999689,1666.981181383133,622.9328985214233,1502.6645851135254,36538,9856,26682,26682,0,13,9516000.0
9516,9516999,20.777673696736727,37.77867615280361,0.08182209206495183,1667.175725698471,622.9929645061493,1502.8714294433594,36541,9857,26684,26684,0,13,9517000.0
9517,9517999,20.777324343421977,37.77788948924398,0.08181325636599923,1667.5392158031464,623.0563263893127,1502.891212463379,36548,9860,26688,26688,0,13,9518000.0
9518,9518999,20.777059688101854,37.777899839319566,0.08179683670678117,1667.6536662578583,623.1172802448273,1503.1527481079102,36549,9860,26689,26689,0,13,9519000.0
9519,9519999,20.776690192672135,37.77750794753409,0.08178449209349192,1667.9512765407562,623.1798837184906,1503.2058753967285,36553,9862,26691,26691,0,13,9520000.0
9520,9520999,20.776095033029318,37.77632390749248,0.08177621265623691,1668.2260673046112,623.243180513382,1503.2687873840332,36557,9864,26693,26693,0,13,9521000.0
9521,9521999,20.77570745845567,37.77619983489821,0.08176643600712086,1668.4577634334564,623.3165049552917,1503.3544464111328,36560,9865,26695,26695,0,13,9522000.0
9522,9522999,20.775327200582563,37.77559888399504,0.08175962508610934,1668.7462935447693,623.3773958683014,1503.366096496582,36564,9867,26697,26697,0,13,9523000.0
9523,9523999,20.774900824915353,37.77486380310564,0.08175318997988956,1669.056325674057,623.444497346878,1503.456672668457,36568,9869,26699,26699,0,13,9524000.0
9524,9524999,20.774475422062217,37.77445224543911,0.08175147458362164,1669.2699587345123,623.5071992874146,1503.5305366516113,36571,9870,26701,26701,0,13,9525000.0
9525,9525999,20.774180062365993,37.773822183528026,0.08174208075251843,1669.3911924362183,623.5683233737946,1503.6760025024414,36571,9870,26701,26701,0,13,9526000.0
9526,9526999,20.7736420116063,37.77268062958078,0.08173668875743711,1669.5173153877258,623.6322405338287,1503.7772064208984,36572,9870,26702,26702,0,13,9527000.0
9527,9527999,20.773736485954277,37.775744087151025,0.08171056124798137,1669.7344405651093,623.6942746639252,1503.8452758789062,36579,9871,26708,26708,0,13,9528000.0
9528,9528999,20.773589113275943,37.775225715140046,0.08170156797424077,1669.84543633461,623.7564396858215,1503.9638786315918,36579,9871,26708,26708,0,13,9529000.0
9529,9529999,20.77337155197433,37.77467265796681,0.08169128010283822,1670.082002401352,623.8195683956146,1504.0163612365723,36581,9872,26709,26709,0,13,9530000.0
9530,9530999,20.773011092586167,37.77387718035799,0.08168682730333787,1670.3011615276337,623.8828468322754,1504.067050933838,36583,9873,26710,26710,0,13,9531000.0
9531,9531999,20.772833964188074,37.77339995383826,0.08167757896370587,1670.4182450771332,623.9451060295105,1504.1702575683594,36583,9873,26710,26710,0,13,9532000.0
9532,9532999,20.77242612249068,37.772345611726514,0.08167359865956747,1670.547835111618,624.0067405700684,1504.2737274169922,36583,9873,26710,26710,0,13,9533000.0
9533,9533999,20.77211878004152,37.77185829771434,0.08166449639013373,1670.828158378601,624.0686457157135,1504.225887298584,36587,9875,26712,26712,0,13,9534000.0
9534,9534999,20.771346752410388,37.770748436631166,0.08166577268187525,1670.9591536521912,624.1295239925385,1504.959129333496,36596,9875,26721,26721,0,13,9535000.0
9535,9535999,20.77053551531448,37.76938501948819,0.0816688605847834,1671.160872220993,624.1900696754456,1505.1974029541016,36599,9876,26723,26723,0,13,9536000.0
9536,9536999,20.769971907865838,37.76828417760058,0.08166693153776827,1671.3728187084198,624.2530806064606,1505.4215621948242,36601,9877,26724,26724,0,13,9537000.0
9537,9537999,20.769387365438057,37.76725819517306,0.08166576175839857,1671.8087038993835,624.3144187927246,1505.394588470459,36610,9881,26729,26729,0,13,9538000.0
9538,9538999,20.768878879412185,37.766594579522206,0.08166239706959433,1672.082872390747,624.3766248226166,1505.528190612793,36614,9883,26731,26731,0,13,9539000.0
9539,9539999,20.768596233896304,37.76675318947801,0.08165560601722766,1672.384449481964,624.4390902519226,1505.5931930541992,36618,9885,26733,26733,0,13,9540000.0
9540,9540999,20.768416478322862,37.76709842459816,0.08164558837833014,1672.5830714702606,624.5006146430969,1505.7531967163086,36620,9886,26734,26734,0,13,9541000.0
9541,9541999,20.76830645447827,37.76717060495757,0.08163981858068825,1672.87886095047,624.5626919269562,1505.7987747192383,36624,9888,26736,26736,0,13,9542000.0
9542,9542999,20.768306611662137,37.76734072902661,0.08163812682056792,1673.1779713630676,624.6274070739746,1505.9442901611328,36628,9890,26738,26738,0,13,9543000.0
9543,9543999,20.76881550416401,37.76854413137272,0.08163631437575636,1673.3811392784119,624.6901624202728,1506.0387649536133,36631,9891,26740,26740,0,13,9544000.0
9544,9544999,20.76946837377641,37.76974593937547,0.08163255072727083,1673.5096580982208,624.7519218921661,1506.2033081054688,36631,9891,26740,26740,0,13,9545000.0
9545,9545999,20.77024706574537,37.77134242778114,0.08163695639455149,1673.7230854034424,624.8169271945953,1506.204948425293,36633,9892,26741,26741,0,13,9546000.0
9546,9546999,20.771227087099113,37.773616965256046,0.08163739934819181,1674.0146594047546,624.878937959671,1506.2189903259277,36637,9894,26743,26743,0,13,9547000.0
9547,9547999,20.772215004615088,37.77551248861938,0.08165449814686165,1674.2226519584656,624.9408242702484,1506.296314239502,36639,9895,26744,26744,0,13,9548000.0
9548,9548999,20.773396317071462,37.777861778332536,0.08166401362644637,1674.4357392787933,625.004930973053,1506.2924346923828,36642,9896,26746,26746,0,13,9549000.0
9549,9549999,20.77435157873642,37.779358455447834,0.08168495050506408,1674.5657634735107,625.0661413669586,1506.4518356323242,36642,9896,26746,26746,0,13,9550000.0
9550,9550999,20.77544396135514,37.781741603508145,0.08170131197430519,1674.857539653778,625.128036737442,1506.4994049072266,36646,9898,26748,26748,0,13,9551000.0
9551,9551999,20.776660913437304,37.783680161349416,0.08171436163848844,1674.981626033783,625.1903645992279,1506.6497230529785,36646,9898,26748,26748,0,13,9552000.0
9552,9552999,20.777538154932095,37.78484630227886,0.08172976491089279,1675.286906003952,625.2552440166473,1506.657814025879,36650,9900,26750,26750,0,13,9553000.0
9553,9553999,20.777943008013217,37.785167037071936,0.08172529647841476,1675.4149327278137,625.3213763237,1506.821704864502,36650,9900,26750,26750,0,13,9554000.0
9554,9554999,20.777310420743834,37.784055151906074,0.08172768858558443,1675.5465264320374,625.3833730220795,1507.6250038146973,36659,9900,26759,26759,0,13,9555000.0
9555,9555999,20.776406930626848,37.78261480142267,0.08173044645460015,1675.8242299556732,625.4442732334137,1507.891529083252,36670,9902,26768,26768,0,13,9556000.0
9556,9556999,20.775675581468608,37.78243576510894,0.08172832256030382,1676.192148923874,625.5067250728607,1508.0079727172852,36677,9905,26772,26772,0,13,9557000.0
9557,9557999,20.77489329046193,37.78116837238714,0.08173034232976495,1676.5652167797089,625.5702509880066,1508.0898971557617,36683,9908,26775,26775,0,13,9558000.0
9558,9558999,20.77416669059261,37.78009376869929,0.08173101805835048,1676.6994166374207,625.6322870254517,1508.363208770752,36683,9908,26775,26775,0,13,9559000.0
9559,9559999,20.773393034040065,37.77884855191104,0.08173362145887408,1676.8231892585754,625.6946969032288,1508.5178680419922,36683,9908,26775,26775,0,13,9560000.0
9560,9560999,20.77264759200579,37.777480874808106,0.08173537300668998,1677.0497539043427,625.7598230838776,1508.5762367248535,36685,9909,26776,26776,0,13,9561000.0
9561,9561999,20.77184276692615,37.7761252507131,0.08173809017198153,1677.19491481781,625.8239121437073,1508.730655670166,36685,9909,26776,26776,0,13,9562000.0
9562,9562999,20.771159336028777,37.77482281046588,0.08174061678409517,1677.497138261795,625.8904263973236,1508.757984161377,36689,9911,26778,26778,0,13,9563000.0
9563,9563999,20.770610086414518,37.77384094523647,0.08174197913172798,1677.8121242523193,625.9524884223938,1508.7912940979004,36694,9913,26781,26781,0,13,9564000.0
9564,9564999,20.770088588694854,37.77280228197746,0.0817402313758725,1678.1065895557404,626.0189776420593,1508.802448272705,36699,9915,26784,26784,0,13,9565000.0
9565,9565999,20.769580040990018,37.77176943032391,0.08174086384912638,1678.2286982536316,626.0817284584045,1508.9254760742188,36699,9915,26784,26784,0,13,9566000.0
9566,9566999,20.769151051712395,37.77084965636449,0.08174208793698712,1678.5316598415375,626.1442866325378,1508.870662689209,36703,9917,26786,26786,0,13,9567000.0
9567,9567999,20.768723625941966,37.769937652761854,0.0817437543113938,1678.7402844429016,626.2062993049622,1508.9676246643066,36705,9918,26787,26787,0,13,9568000.0
9568,9568999,20.768334011697032,37.76910038615752,0.08174884633912205,1679.0404953956604,626.2681648731232,1509.0515098571777,36710,9920,26790,26790,0,13,9569000.0
9569,9569999,20.767939897200563,37.76829027277334,0.08174949872353299,1679.1565434932709,626.3322110176086,1509.18998336792,36710,9920,26790,26790,0,13,9570000.0
9570,9570999,20.76752501270713,37.76749149507359,0.08175289780369288,1679.3659648895264,626.3939936161041,1509.2430839538574,36712,9921,26791,26791,0,13,9571000.0
9571,9571999,20.76721540142123,37.7668149125886,0.08175027804902946,1679.6690227985382,626.4545764923096,1509.1426124572754,36716,9923,26793,26793,0,13,9572000.0
9572,9572999,20.766677555414194,37.7656561341398,0.08175382678274246,1679.7882144451141,626.5174701213837,1509.3540229797363,36716,9923,26793,26793,0,13,9573000.0
9573,9573999,20.76602512881297,37.76442303372477,0.08175679377112055,1679.9169085025787,626.5788872241974,1509.5121574401855,36716,9923,26793,26793,0,13,9574000.0
9574,9574999,20.765392676328126,37.76341631874806,0.08176084247348081,1680.0402965545654,626.6425218582153,1510.5588722229004,36732,9923,26809,26809,0,13,9575000.0
9575,9575999,20.764950172822218,37.76432699697926,0.0817521383710913,1680.2384610176086,626.7044620513916,1510.858097076416,36735,9924,26811,26811,0,13,9576000.0
9576,9576999,20.764186154083156,37.76324315156767,0.08175715166342712,1680.5269527435303,626.7688913345337,1511.04292678833,36739,9926,26813,26813,0,13,9577000.0
9577,9577999,20.76345597330379,37.7622832767371,0.08175886856477088,1680.8888030052185,626.8317174911499,1511.1432876586914,36745,9929,26816,26816,0,13,9578000.0
9578,9578999,20.762714114352256,37.76111944802535,0.08176213993784964,1681.110651254654,626.9014136791229,1511.3718605041504,36747,9930,26817,26817,0,13,9579000.0
9579,9579999,20.76200978641744,37.76001431610961,0.08176420867539702,1681.3088145256042,626.9647634029388,1511.5309791564941,36749,9931,26818,26818,0,13,9580000.0
9580,9580999,20.761164196081538,37.75857743725555,0.0817686761679065,1681.6865060329437,627.0289421081543,1511.4639778137207,36755,9934,26821,26821,0,13,9581000.0
9581,9581999,20.76039357450602,37.75736771305275,0.08177147838999954,1681.8964648246765,627.0925285816193,1511.7320442199707,36757,9935,26822,26822,0,13,9582000.0
9582,9582999,20.759606994267898,37.755956691439955,0.08177533672812465,1682.1239602565765,627.155707359314,1511.7760124206543,36759,9936,26823,26823,0,13,9583000.0
9583,9583999,20.75881311935513,37.754569504118706,0.08177874355703008,1682.490080833435,627.2197258472443,1511.762264251709,36771,9939,26832,26832,0,13,9584000.0
9584,9584999,20.758008786369686,37.75316214322069,0.0817824328186586,1682.6947910785675,627.2818562984467,1511.8565521240234,36773,9940,26833,26833,0,13,9585000.0
9585,9585999,20.75719042874291,37.7517656146153,0.08178471135439214,1682.9906203746796,627.3444421291351,1511.8393745422363,36777,9942,26835,26835,0,13,9586000.0
9586,9586999,20.756357440141947,37.75042626107011,0.08178672389374064,1683.1206016540527,627.4084739685059,1512.0503158569336,36777,9942,26835,26835,0,13,9587000.0
9587,9587999,20.755863663963083,37.75043525396093,0.08178167504579859,1683.2431206703186,627.471164226532,1512.1825408935547,36777,9942,26835,26835,0,13,9588000.0
9588,9588999,20.755108207637544,37.74906874785647,0.08178279316341719,1683.3637816905975,627.5332906246185,1512.3292655944824,36777,9942,26835,26835,0,13,9589000.0
9589,9589999,20.754291501883326,37.74772916196119,0.081785536972793,1683.5864551067352,627.5970039367676,1512.3329277038574,36785,9943,26842,26842,0,13,9590000.0
9590,9590999,20.75358274331087,37.74646232753408,0.08178654749542669,1683.945957183838,627.6615085601807,1512.287799835205,36792,9946,26846,26846,0,13,9591000.0
9591,9591999,20.75285956510347,37.74505337398109,0.08178993533134216,1684.15216588974,627.7237575054169,1512.3969688415527,36794,9947,26847,26847,0,13,9592000.0
9592,9592999,20.752061265164805,37.74362728643996,0.08179348028420097,1684.390352010727,627.7888960838318,1512.4444046020508,36796,9948,26848,26848,0,13,9593000.0
9593,9593999,20.751180328039336,37.74225828294494,0.08179525884142835,1684.6151401996613,627.8547179698944,1512.5918769836426,36799,9949,26850,26850,0,13,9594000.0
9594,9594999,20.750266082535322,37.740736643336206,0.08180287480866433,1684.7329440116882,627.916544675827,1513.584098815918,36821,9949,26872,26872,0,13,9595000.0
9595,9595999,20.74925034449552,37.74016521423595,0.08180490089275538,1684.9285173416138,627.9784650802612,1513.9268035888672,36827,9950,26877,26877,0,13,9596000.0
9596,9596999,20.74819248844781,37.73857863477762,0.08181133279681407,1685.0346775054932,628.0402526855469,1514.328025817871,36829,9950,26879,26879,0,13,9597000.0
9597,9597999,20.747197893766277,37.73734886009574,0.08181509635111872,1685.7100403308868,628.1045887470245,1514.2774276733398,36843,9957,26886,26886,0,13,9598000.0
9598,9598999,20.746230343545424,37.73590134337002,0.0818190957473729,1685.8265523910522,628.1693136692047,1514.7145042419434,36843,9957,26886,26886,0,13,9599000.0
9599,9599999,20.74520878720004,37.734452548357574,0.08182371765998098,1685.9541347026825,628.232658624649,1515.0033645629883,36843,9957,26886,26886,0,13,9600000.0
9600,9600999,20.744497901574043,37.73330849395056,0.08182307151899337,1686.1428530216217,628.2943015098572,1515.1695671081543,36845,9958,26887,26887,0,13,9601000.0
9601,9601999,20.743807065242,37.7323078139504,0.08182266029447827,1686.5172381401062,628.355997800827,1515.2705459594727,36851,9961,26890,26890,0,13,9602000.0
9602,9602999,20.74307748525505,37.73125024280667,0.08182338695512026,1687.045250415802,628.418933391571,1515.1923332214355,36862,9966,26896,26896,0,13,9603000.0
9603,9603999,20.742393779972286,37.730318191892366,0.08182288878431065,1687.1661884784698,628.4814031124115,1515.472858428955,36862,9966,26896,26896,0,13,9604000.0
9604,9604999,20.741723993961813,37.72923173327225,0.08182328349596091,1687.5374813079834,628.5445067882538,1515.4734230041504,36871,9969,26902,26902,0,13,9605000.0
9605,9605999,20.741307266937305,37.7287800977279,0.08182439412541909,1687.6693654060364,628.607589006424,1515.7527198791504,36871,9969,26902,26902,0,13,9606000.0
9606,9606999,20.74084908928072,37.72799002663193,0.08182906137385393,1687.786169052124,628.6698408126831,1516.0922164916992,36874,9969,26905,26905,0,13,9607000.0
9607,9607999,20.74047248806823,37.72719976343224,0.08183688342057271,1687.8963611125946,628.7315917015076,1516.3292770385742,36874,9969,26905,26905,0,13,9608000.0
9608,9608999,20.740353729773002,37.72687833734164,0.08183740442470755,1688.1023166179657,628.7943272590637,1516.466152191162,36876,9970,26906,26906,0,13,9609000.0
9609,9609999,20.740025910062357,37.72601461904028,0.08183831668895225,1688.5645310878754,628.8578820228577,1516.3393058776855,36884,9974,26910,26910,0,13,9610000.0
9610,9610999,20.739701514211045,37.725099672761324,0.08184079998818794,1688.8523163795471,628.9216225147247,1516.5821571350098,36888,9976,26912,26912,0,13,9611000.0
9611,9611999,20.73964030511071,37.725041184191966,0.08184305472288267,1689.127451658249,628.9843578338623,1516.719223022461,36892,9978,26914,26914,0,13,9612000.0
9612,9612999,20.739274081644247,37.72416380325275,0.08184017481259653,1689.257375717163,629.0479547977448,1516.9015464782715,36892,9978,26914,26914,0,13,9613000.0
9613,9613999,20.738947072314474,37.72331389232791,0.08184463631018102,1689.3880608081818,629.1127047538757,1517.084629058838,36892,9978,26914,26914,0,13,9614000.0
9614,9614999,20.738466073118644,37.72227745497954,0.08184132373743025,1689.5304889678955,629.1787178516388,1517.893970489502,36910,9978,26932,26932,0,13,9615000.0
9615,9615999,20.73752598888801,37.72091249122054,0.08184450808176202,1689.6486206054688,629.2416460514069,1518.5359840393066,36913,9978,26935,26935,0,13,9616000.0
9616,9616999,20.73688566773935,37.72013320654785,0.08184290274846495,1689.839631319046,629.3013763427734,1518.8903884887695,36918,9979,26939,26939,0,13,9617000.0
9617,9617999,20.736493719556293,37.71952302572982,0.08183963970213559,1690.1136808395386,629.363828420639,1519.1000862121582,36922,9981,26941,26941,0,13,9618000.0
9618,9618999,20.73666151777543,37.720353973263876,0.0818347218475115,1690.8186202049255,629.4295239448547,1519.085708618164,36936,9988,26948,26948,0,13,9619000.0
9619,9619999,20.737039011087685,37.72093991604739,0.08183638099179813,1691.0190682411194,629.4995265007019,1519.3601150512695,36938,9989,26949,26949,0,13,9620000.0
9620,9620999,20.737850327022443,37.72271193246465,0.08183476185147398,1691.2148864269257,629.5621948242188,1519.6235542297363,36940,9990,26950,26950,0,13,9621000.0
9621,9621999,20.738817316360418,37.72604740428889,0.08184136488567006,1691.4113883972168,629.623473405838,1519.810634613037,36942,9991,26951,26951,0,13,9622000.0
9622,9622999,20.740108830404573,37.72920223234652,0.08184168833469274,1691.8944370746613,629.6870512962341,1519.8093070983887,36950,9995,26955,26955,0,13,9623000.0
9623,9623999,20.741573326831556,37.73201920213472,0.08184970567351602,1692.250851392746,629.7475697994232,1519.8708305358887,36958,9998,26960,26960,0,13,9624000.0
9624,9624999,20.74292460193134,37.73547411532277,0.08186474470616989,1692.4438490867615,629.8089873790741,1520.101634979248,36961,9999,26962,26962,0,13,9625000.0
9625,9625999,20.744255367776585,37.7379907622724,0.08191223178480145,1692.6576664447784,629.870454788208,1520.240982055664,36966,10000,26966,26966,0,13,9626000.0
9626,9626999,20.74547401711781,37.741252679109856,0.08194112540847553,1692.873952627182,629.9325933456421,1520.5145683288574,36971,10001,26970,26970,0,13,9627000.0
9627,9627999,20.74691646289057,37.74364303245263,0.08197395969152732,1692.9843845367432,629.9942848682404,1520.746078491211,36971,10001,26970,26970,0,13,9628000.0
9628,9628999,20.74830125560719,37.745835190570126,0.08200149429603809,1693.2655098438263,630.0568497180939,1520.7397079467773,36977,10003,26974,26974,0,13,9629000.0
9629,9629999,20.750167360991874,37.74863240618244,0.08205390830519077,1693.3847396373749,630.1189949512482,1520.922264099121,36977,10003,26974,26974,0,13,9630000.0
9630,9630999,20.751757028279055,37.75162316489099,0.08210590004056406,1693.615710735321,630.1823127269745,1521.0756568908691,36979,10004,26975,26975,0,13,9631000.0
9631,9631999,20.753751253369316,37.755165279071534,0.08216500033004048,1693.735836982727,630.2434153556824,1521.2395210266113,36979,10004,26975,26975,0,13,9632000.0
9632,9632999,20.755438059572455,37.75799352484419,0.0822125545773561,1693.8576219081879,630.3050475120544,1521.3541526794434,36979,10004,26975,26975,0,13,9633000.0
9633,9633999,20.75654767013635,37.75882609447754,0.08223720615551422,1694.155654668808,630.3692419528961,1521.338550567627,36985,10006,26979,26979,0,13,9634000.0
9634,9634999,20.75700625427997,37.75910832839248,0.08222786222039102,1694.2859899997711,630.4304933547974,1522.0673027038574,36994,10006,26988,26988,0,13,9635000.0
9635,9635999,20.756597466163715,37.7591583543788,0.08222515934460939,1694.6446108818054,630.4913716316223,1522.2334823608398,37009,10009,27000,27000,0,13,9636000.0
9636,9636999,20.756236755666933,37.75917951673179,0.08222451364992289,1694.9272661209106,630.5541546344757,1522.4058647155762,37019,10011,27008,27008,0,13,9637000.0
9637,9637999,20.75588730884898,37.75909270470138,0.0822214441121728,1695.134518146515,630.6160154342651,1522.6668014526367,37021,10012,27009,27009,0,13,9638000.0
9638,9638999,20.75538523155819,37.75813524341254,0.0822227753676621,1695.351675271988,630.6787390708923,1522.8312530517578,37023,10013,27010,27010,0,13,9639000.0
9639,9639999,20.754964097517913,37.757173830165364,0.08222084372119054,1695.550922870636,630.7396733760834,1522.9620513916016,37025,10014,27011,27011,0,13,9640000.0
9640,9640999,20.754589354129948,37.75636286089662,0.08221898976726416,1695.7485928535461,630.8006227016449,1523.1195526123047,37029,10015,27014,27014,0,13,9641000.0
9641,9641999,20.75423446294344,37.75759230650972,0.08220988899373649,1696.2780113220215,630.8636739253998,1522.9663276672363,37041,10020,27021,27021,0,13,9642000.0
9642,9642999,20.753929981811265,37.7568727573131,0.082206492498749,1696.4980247020721,630.932037115097,1523.11865234375,37045,10021,27024,27024,0,13,9643000.0
9643,9643999,20.753676586384177,37.7563088898924,0.08220267741372034,1696.6202602386475,630.9937543869019,1523.3729934692383,37048,10021,27027,27027,0,13,9644000.0
9644,9644999,20.753523697697393,37.757268104941495,0.08219481846059251,1696.7320704460144,631.0579845905304,1523.5290756225586,37048,10021,27027,27027,0,13,9645000.0
9645,9645999,20.7531697101615,37.756439924721995,0.08219144423186242,1697.133285522461,631.1227543354034,1523.566463470459,37059,10024,27035,27035,0,13,9646000.0
9646,9646999,20.752860487042128,37.75543985061337,0.0821882468481826,1697.3401584625244,631.1850955486298,1523.7105293273926,37063,10025,27038,27038,0,13,9647000.0
9647,9647999,20.752692821732296,37.75474611317859,0.0821852029503829,1697.457363128662,631.2490670681,1523.9115943908691,37063,10025,27038,27038,0,13,9648000.0
9648,9648999,20.752201560922703,37.753497399274835,0.082187729397592,1697.8341863155365,631.313238620758,1523.9519119262695,37069,10028,27041,27041,0,13,9649000.0
9649,9649999,20.751778146315043,37.752335137673285,0.0821875140699031,1698.039967060089,631.3752610683441,1524.1055374145508,37071,10029,27042,27042,0,13,9650000.0
9650,9650999,20.75124948319075,37.751097976170044,0.08218902321780519,1698.2506096363068,631.436830997467,1524.3070945739746,37073,10030,27043,27043,0,13,9651000.0
9651,9651999,20.750640184121384,37.7500576655092,0.08219363638492494,1698.3708860874176,631.4985103607178,1525.3284034729004,37088,10030,27058,27058,0,13,9652000.0
9652,9652999,20.749786131969792,37.74870207119889,0.08220358998971289,1698.498538017273,631.5602426528931,1525.7535438537598,37088,10030,27058,27058,0,13,9653000.0
9653,9653999,20.748864143827078,37.74714107658814,0.08221290884508847,1698.6138951778412,631.6210963726044,1526.0154075622559,37088,10030,27058,27058,0,13,9654000.0
9654,9654999,20.748051625480425,37.745849940439456,0.08221913048753793,1698.7362773418427,631.6827943325043,1526.2359657287598,37088,10030,27058,27058,0,13,9655000.0
9655,9655999,20.747340201748987,37.744755260783634,0.08222193974106407,1698.9390532970428,631.7444577217102,1526.3485946655273,37090,10031,27059,27059,0,13,9656000.0
9656,9656999,20.746625298649132,37.743593848180275,0.08222622392005918,1699.2973341941833,631.8063070774078,1526.275764465332,37099,10034,27065,27065,0,13,9657000.0
9657,9657999,20.745895060824317,37.74259886970663,0.08222759449171113,1699.6835415363312,631.8693096637726,1526.317180633545,37108,10037,27071,27071,0,13,9658000.0
9658,9658999,20.7452649762697,37.74156339935329,0.0822290787767348,1699.9713416099548,631.9319014549255,1526.459545135498,37113,10039,27074,27074,0,13,9659000.0
9659,9659999,20.744681036544687,37.74052179882436,0.08222899355664126,1700.1789553165436,631.9946224689484,1526.6270370483398,37115,10040,27075,27075,0,13,9660000.0
9660,9660999,20.744321349982034,37.73981663220451,0.08222460329801651,1700.557256937027,632.0580749511719,1526.6900329589844,37122,10043,27079,27079,0,13,9661000.0
9661,9661999,20.743901709657624,37.73899042341624,0.08222080925045516,1700.6777844429016,632.1197381019592,1526.8456993103027,37122,10043,27079,27079,0,13,9662000.0
9662,9662999,20.74352837810092,37.738216342472775,0.08221686486695168,1700.8104691505432,632.1811883449554,1527.1374816894531,37124,10043,27081,27081,0,13,9663000.0
9663,9663999,20.74333235788115,37.73774071789534,0.08221120012348382,1701.106573343277,632.2439608573914,1527.1917839050293,37130,10045,27085,27085,0,13,9664000.0
9664,9664999,20.743053787140532,37.73712798847002,0.08220768183981908,1701.2254457473755,632.3055980205536,1527.3933181762695,37130,10045,27085,27085,0,13,9665000.0
9665,9665999,20.742774179993027,37.73664065844194,0.08220311837143535,1701.43234872818,632.3674397468567,1527.476791381836,37132,10046,27086,27086,0,13,9666000.0
9666,9666999,20.74267398128844,37.73684860725449,0.08219474821049899,1701.8128552436829,632.4308412075043,1527.3927001953125,37143,10049,27094,27094,0,13,9667000.0
9667,9667999,20.742422477787546,37.7361091163589,0.0821937019107648,1702.0251286029816,632.4929196834564,1527.4823455810547,37145,10050,27095,27095,0,13,9668000.0
9668,9668999,20.741964678847445,37.73503519325726,0.08219227016628672,1702.3232731819153,632.5555491447449,1527.54878616333,37149,10052,27097,27097,0,13,9669000.0
9669,9669999,20.741416537602113,37.73389182015239,0.0821893708570487,1702.532133102417,632.6192348003387,1527.6530265808105,37151,10053,27098,27098,0,13,9670000.0
9670,9670999,20.740715630318135,37.732582973564384,0.0821944404343854,1702.6621525287628,632.6853401660919,1528.562328338623,37165,10053,27112,27112,0,13,9671000.0
9671,9671999,20.739752509437526,37.73125669273859,0.08220160236227114,1702.7835037708282,632.7456560134888,1529.0473136901855,37169,10053,27116,27116,0,13,9672000.0
9672,9672999,20.739135029210413,37.73075215289127,0.08220139113914304,1702.9757702350616,632.80610871315,1529.3156814575195,37171,10054,27117,27117,0,13,9673000.0
9673,9673999,20.738385354701503,37.729647865130964,0.08220366683519276,1703.091362953186,632.866530418396,1529.6147994995117,37171,10054,27117,27117,0,13,9674000.0
9674,9674999,20.737729406518653,37.72883599721162,0.08220555256732653,1703.5200226306915,632.9269111156464,1529.639991760254,37182,10058,27124,27124,0,13,9675000.0
9675,9675999,20.737049378578696,37.72766392855166,0.08221060478188913,1703.713731765747,632.9876508712769,1529.8331298828125,37184,10059,27125,27125,0,13,9676000.0
9676,9676999,20.736390860885464,37.72654102612225,0.08221593622352663,1703.9068303108215,633.0499794483185,1529.9666938781738,37188,10060,27128,27128,0,13,9677000.0
9677,9677999,20.735756343199476,37.7255617918677,0.08221978218599624,1704.1338579654694,633.11230301857,1530.1141662597656,37190,10061,27129,27129,0,13,9678000.0
9678,9678999,20.735187932794002,37.724655070070995,0.08222368367988875,1704.35378408432,633.1757643222809,1530.17720413208,37192,10062,27130,27130,0,13,9679000.0
9679,9679999,20.734683974523772,37.72392285949787,0.08222278095689839,1704.4889962673187,633.2419068813324,1530.3508071899414,37192,10062,27130,27130,0,13,9680000.0
9680,9680999,20.73418362447754,37.72296532819902,0.08222186140182319,1704.7978298664093,633.304931640625,1530.3790168762207,37201,10064,27137,27137,0,13,9681000.0
9681,9681999,20.733694114681082,37.72199214110803,0.08222185980932617,1704.997938632965,633.367134809494,1530.4968643188477,37203,10065,27138,27138,0,13,9682000.0
9682,9682999,20.733579661261885,37.72259286490957,0.08221633828965735,1705.2133815288544,633.429092168808,1530.6919059753418,37207,10066,27141,27141,0,13,9683000.0
9683,9683999,20.733319496943654,37.72178039383248,0.0822164394600875,1705.4131739139557,633.4921307563782,1530.7573013305664,37209,10067,27142,27142,0,13,9684000.0
9684,9684999,20.732944401261946,37.720853232162284,0.08221598708812239,1705.6949117183685,633.5546045303345,1530.78178024292,37213,10069,27144,27144,0,13,9685000.0
9685,9685999,20.732613907824142,37.71994875997349,0.08221654905113618,1706.11074924469,633.6228165626526,1530.8692626953125,37219,10072,27147,27147,0,13,9686000.0
9686,9686999,20.732308445140973,37.71915792826431,0.08221373067540105,1706.4102754592896,633.6861164569855,1531.0674667358398,37225,10074,27151,27151,0,13,9687000.0
9687,9687999,20.732191314174052,37.718564025270354,0.08221130306738311,1706.536474943161,633.7480192184448,1531.2407188415527,37225,10074,27151,27151,0,13,9688000.0
9688,9688999,20.731997149471532,37.71781287929334,0.08221063346037183,1706.742770433426,633.8115842342377,1531.3754425048828,37230,10075,27155,27155,0,13,9689000.0
9689,9689999,20.731454230223278,37.71669122831183,0.08220964520518859,1706.8707189559937,633.8737659454346,1531.516227722168,37230,10075,27155,27155,0,13,9690000.0
9690,9690999,20.730851576720802,37.715375963683336,0.08221310114129055,1707.0873339176178,633.936595916748,1532.1435928344727,37252,10076,27176,27176,0,13,9691000.0
9691,9691999,20.72999316287529,37.714091925335836,0.08221827608366306,1707.198588848114,633.9998445510864,1532.7795028686523,37255,10076,27179,27179,0,13,9692000.0
9692,9692999,20.729231651891215,37.712780864951434,0.08222340984932686,1707.3896977901459,634.0601074695587,1533.1047554016113,37257,10077,27180,27180,0,13,9693000.0
9693,9693999,20.7287820699808,37.712243888542886,0.08222381798243028,1707.6668863296509,634.1207292079926,1533.3195419311523,37261,10079,27182,27182,0,13,9694000.0
9694,9694999,20.72816475531337,37.71105696455765,0.08222671176405882,1708.0325853824615,634.1819002628326,1533.343879699707,37270,10082,27188,27188,0,13,9695000.0
9695,9695999,20.727806548970282,37.710307083409575,0.08222649344169686,1708.2266631126404,634.2425425052643,1533.5807609558105,37272,10083,27189,27189,0,13,9696000.0
9696,9696999,20.727288651039952,37.709256559216996,0.08223086003486957,1708.5189707279205,634.3033678531647,1533.6331634521484,37278,10085,27193,27193,0,13,9697000.0
9697,9697999,20.726786025416676,37.70833192621205,0.08223445993228784,1708.798210144043,634.3657014369965,1533.7803268432617,37282,10087,27195,27195,0,13,9698000.0
9698,9698999,20.72630216918736,37.70755591533344,0.08223639308832797,1709.087811946869,634.4273548126221,1533.917465209961,37286,10089,27197,27197,0,13,9699000.0
9699,9699999,20.72573853855274,37.70629753903802,0.0822410538022268,1709.3097367286682,634.488936662674,1534.0993843078613,37288,10090,27198,27198,0,13,9700000.0
9700,9700999,20.72505942082753,37.704978391988114,0.08224699274254377,1709.6849966049194,634.5517203807831,1534.2504653930664,37297,10093,27204,27204,0,13,9701000.0
9701,9701999,20.724428840037667,37.70372048089484,0.08225153244141548,1709.7991082668304,634.6138036251068,1534.4620361328125,37297,10093,27204,27204,0,13,9702000.0
9702,9702999,20.723853636231013,37.7028545104373,0.08225223483832944,1710.0097789764404,634.6770379543304,1534.727222442627,37304,10094,27210,27210,0,13,9703000.0
9703,9703999,20.723517832128724,37.7069060481689,0.08223262125704833,1710.130384683609,634.7380788326263,1534.9372024536133,37304,10094,27210,27210,0,13,9704000.0
9704,9704999,20.723108654042747,37.70694710552498,0.08222988789998065,1710.416345357895,634.7993836402893,1534.925308227539,37311,10096,27215,27215,0,13,9705000.0
9705,9705999,20.722539517151265,37.70569577256055,0.08223297187852197,1710.557097196579,634.8609917163849,1535.124771118164,37311,10096,27215,27215,0,13,9706000.0
9706,9706999,20.721930344618105,37.70447770891857,0.08223526158948502,1710.7614600658417,634.9229309558868,1535.1764755249023,37313,10097,27216,27216,0,13,9707000.0
9707,9707999,20.72130381977824,37.703129967133066,0.08223809702500606,1710.9722299575806,634.9842321872711,1535.265064239502,37317,10098,27219,27219,0,13,9708000.0
9708,9708999,20.720708246660642,37.70190831847811,0.08224005277176794,1711.1085166931152,635.0461304187775,1535.4065628051758,37317,10098,27219,27219,0,13,9709000.0
9709,9709999,20.720079523310304,37.700657439331536,0.08224154860355293,1711.3864576816559,635.1072916984558,1535.4248313903809,37321,10100,27221,27221,0,13,9710000.0
9710,9710999,20.719303337439143,37.699500705305674,0.08224650203469352,1711.5937132835388,635.1704931259155,1536.380657196045,37342,10101,27241,27241,0,13,9711000.0
9711,9711999,20.718299618232955,37.698152930208536,0.08225217133631268,1711.712013244629,635.2315700054169,1536.873218536377,37342,10101,27241,27241,0,13,9712000.0
9712,9712999,20.717413717515203,37.6969621464755,0.0822566495510163,1711.9833500385284,635.2936210632324,1537.1087532043457,37346,10103,27243,27243,0,13,9713000.0
9713,9713999,20.716658389044248,37.696034139339375,0.08225881035212257,1712.4266819953918,635.3560111522675,1537.2211570739746,37354,10107,27247,27247,0,13,9714000.0
9714,9714999,20.716059264642876,37.69502760384216,0.08225926824571828,1712.624838590622,635.4185664653778,1537.5336303710938,37356,10108,27248,27248,0,13,9715000.0
9715,9715999,20.715532665404726,37.69399846007541,0.08225932615185949,1712.8145868778229,635.4804494380951,1537.718132019043,37361,10109,27252,27252,0,13,9716000.0
9716,9716999,20.714907657338852,37.692741462445596,0.08226116465961586,1712.9368364810944,635.5425374507904,1537.9245910644531,37361,10109,27252,27252,0,13,9717000.0
9717,9717999,20.714261257200526,37.691483983640545,0.08226320358945483,1713.4789259433746,641.4159967899323,1537.8518753051758,37371,10114,27257,27257,0,13,9718000.0
9718,9718999,20.71377433112428,37.690525240270716,0.08226307610252181,1713.9533114433289,641.4794828891754,1537.8428268432617,37380,10118,27262,27262,0,13,9719000.0
9719,9719999,20.71336084353733,37.68953383319165,0.08226247566930778,1714.0811262130737,641.5427799224854,1538.1533241271973,37380,10118,27262,27262,0,13,9720000.0
9720,9720999,20.713098027798086,37.688830797078936,0.082262290264698,1714.2886271476746,641.608167886734,1538.40230178833,37386,10119,27267,27267,0,13,9721000.0
9721,9721999,20.712740456390446,37.68802653696377,0.0822634000298843,1714.4203519821167,641.669685125351,1538.6103477478027,37386,10119,27267,27267,0,13,9722000.0
9722,9722999,20.712353419212434,37.687110802580015,0.0822657407112154,1714.5439393520355,641.732321023941,1538.9075317382812,37387,10119,27268,27268,0,13,9723000.0
9723,9723999,20.71222715844879,37.686549824908305,0.08227142944873467,1714.6638612747192,641.7933206558228,1539.1362533569336,37387,10119,27268,27268,0,13,9724000.0
9724,9724999,20.712094332144392,37.68606533297807,0.08227021956839742,1714.8921859264374,641.8575668334961,1539.201301574707,37389,10120,27269,27269,0,13,9725000.0
9725,9725999,20.712184007113052,37.6860198321029,0.08227693875520681,1715.186692237854,641.9193880558014,1539.2618598937988,37393,10122,27271,27271,0,13,9726000.0
9726,9726999,20.71248825116961,37.685928775033055,0.08228763433173525,1715.3938426971436,641.9824659824371,1539.4758491516113,37395,10123,27272,27272,0,13,9727000.0
9727,9727999,20.712947172040145,37.68616253831299,0.08229495332061398,1715.6072552204132,642.0456838607788,1539.5973663330078,37397,10124,27273,27273,0,13,9728000.0
9728,9728999,20.713113607598554,37.68585331244795,0.08230370776060347,1715.7513191699982,642.1166622638702,1539.7400207519531,37397,10124,27273,27273,0,13,9729000.0
9729,9729999,20.713092812016797,37.68563515359843,0.0823021830862034,1715.9005472660065,642.179386138916,1539.9070777893066,37397,10124,27273,27273,0,13,9730000.0
9730,9730999,20.712476742796134,37.684674306006066,0.08230436439629596,1716.0143077373505,642.2430093288422,1540.9222373962402,37414,10124,27290,27290,0,13,9731000.0
9731,9731999,20.71136705987044,37.68325553846304,0.08231086675669419,1716.1248185634613,642.3063077926636,1541.4038887023926,37415,10124,27291,27291,0,13,9732000.0
9732,9732999,20.710421227008297,37.68187402850952,0.08231433700399615,1716.2335827350616,642.3689815998077,1541.7290992736816,37415,10124,27291,27291,0,13,9733000.0
9733,9733999,20.709482734144654,37.68045437473383,0.08232005987805313,1716.8685507774353,642.4321579933167,1541.6376762390137,37431,10130,27301,27301,0,13,9734000.0
9734,9734999,20.708637459934785,37.67923327555583,0.0823218609193117,1717.069575548172,642.4957258701324,1541.9439277648926,37433,10131,27302,27302,0,13,9735000.0
9735,9735999,20.707736413576928,37.67780442862902,0.0823266655801893,1717.2734811306,642.5598678588867,1542.1303520202637,37435,10132,27303,27303,0,13,9736000.0
9736,9736999,20.706813204629654,37.67636650424815,0.08233139485152707,1717.564800977707,642.6215221881866,1542.2480964660645,37439,10134,27305,27305,0,13,9737000.0
9737,9737999,20.705930639613044,37.674901110644086,0.08233491065214205,1717.8805088996887,642.6842005252838,1542.4029350280762,37443,10136,27307,27307,0,13,9738000.0
9738,9738999,20.705173127103556,37.673656553247504,0.08233679871659694,1718.1973509788513,642.7474389076233,1542.4557151794434,37448,10138,27310,27310,0,13,9739000.0
9739,9739999,20.704518084593392,37.6727451550728,0.08233507883142488,1718.3146622180939,642.8100237846375,1542.704818725586,37448,10138,27310,27310,0,13,9740000.0
9740,9740999,20.703991726969573,37.67181828060588,0.0823336808427938,1718.5479323863983,642.8730509281158,1542.9179191589355,37453,10139,27314,27314,0,13,9741000.0
9741,9741999,20.703498569137103,37.67090400379541,0.08233114133794284,1718.6699814796448,642.9361062049866,1543.0993690490723,37453,10139,27314,27314,0,13,9742000.0
9742,9742999,20.702948511652124,37.66984526095074,0.08232927104988197,1718.7934985160828,642.9972560405731,1543.371166229248,37455,10139,27316,27316,0,13,9743000.0
9743,9743999,20.702448962821375,37.66882233914819,0.08232708265013344,1718.9992299079895,643.0587720870972,1543.5144348144531,37457,10140,27317,27317,0,13,9744000.0
9744,9744999,20.702076376554114,37.667976877773036,0.08232405755359573,1719.3033578395844,643.1205344200134,1543.5413284301758,37461,10142,27319,27319,0,13,9745000.0
9745,9745999,20.70174335792392,37.66737398586419,0.08232185213151189,1719.6883780956268,643.1836566925049,1543.5397605895996,37467,10145,27322,27322,0,13,9746000.0
9746,9746999,20.701346370289198,37.66660496719673,0.08231978978673582,1719.8961427211761,643.2454578876495,1543.7569541931152,37469,10146,27323,27323,0,13,9747000.0
9747,9747999,20.701084339072416,37.66568819439079,0.08231805355679556,1720.044014930725,643.3081960678101,1543.9340858459473,37469,10146,27323,27323,0,13,9748000.0
9748,9748999,20.700680743128324,37.66482603177874,0.08231680255414842,1720.1656203269958,643.3696458339691,1544.074966430664,37469,10146,27323,27323,0,13,9749000.0
9749,9749999,20.70025829549178,37.66382680712117,0.0823154254642996,1720.4762921333313,643.4329884052277,1544.03178024292,37475,10148,27327,27327,0,13,9750000.0
9750,9750999,20.69989572965306,37.662815969240754,0.08231298954977673,1720.7012050151825,643.4949023723602,1544.7169914245605,37492,10149,27343,27343,0,13,9751000.0
9751,9751999,20.698961899026248,37.66142734520338,0.08231690569752259,1720.904947757721,643.5590465068817,1545.2471542358398,37500,10150,27350,27350,0,13,9752000.0
9752,9752999,20.6981546812186,37.66026318780156,0.08231920276291993,1721.107335805893,643.6222107410431,1545.5484619140625,37505,10151,27354,27354,0,13,9753000.0
9753,9753999,20.697509112253993,37.65927415759567,0.08231830521159034,1721.3908386230469,643.683253288269,1545.6989784240723,37509,10153,27356,27356,0,13,9754000.0
9754,9754999,20.696878905377716,37.65892879024878,0.08231351633153083,1721.953697681427,643.747965335846,1545.834732055664,37519,10158,27361,27361,0,13,9755000.0
9755,9755999,20.69628656462819,37.65820963075533,0.08230992840148721,1722.1522572040558,643.8098654747009,1546.1086387634277,37521,10159,27362,27362,0,13,9756000.0
9756,9756999,20.69570624025144,37.65725256139607,0.08230942201444047,1722.370050907135,643.8733327388763,1546.3606452941895,37523,10160,27363,27363,0,13,9757000.0
9757,9757999,20.695214615592946,37.65634874933066,0.08230787815281326,1722.7634797096252,643.9375290870667,1546.4390487670898,37529,10163,27366,27366,0,13,9758000.0
9758,9758999,20.694933729331616,37.656177664923305,0.0823019843713757,1723.0697762966156,643.9995784759521,1546.5380477905273,37533,10165,27368,27368,0,13,9759000.0
9759,9759999,20.6946598495819,37.655832829169256,0.08229808751305456,1723.1941573619843,644.0608191490173,1546.8338584899902,37534,10165,27369,27369,0,13,9760000.0
9760,9760999,20.694571502372348,37.6558219547507,0.0822970638625804,1723.5033721923828,644.1253759860992,1546.8228492736816,37538,10167,27371,27371,0,13,9761000.0
9761,9761999,20.69453412942086,37.65612199332974,0.08230861211528728,1723.633709192276,644.1886034011841,1547.1230201721191,37541,10167,27374,27374,0,13,9762000.0
9762,9762999,20.6945655871677,37.656174333670904,0.08231065286638994,1723.7651154994965,644.2506201267242,1547.383071899414,37543,10167,27376,27376,0,13,9763000.0
9763,9763999,20.694879019889687,37.65684746790013,0.08230509501438454,1724.0707948207855,644.3144111633301,1547.5097923278809,37547,10169,27378,27378,0,13,9764000.0
9764,9764999,20.69486367467342,37.656592452357835,0.08230328383621066,1724.1987817287445,644.3864438533783,1547.688533782959,37547,10169,27378,27378,0,13,9765000.0
9765,9765999,20.695222659356084,37.65722523978057,0.08231430846705323,1724.769071817398,644.4502284526825,1547.50345993042,37557,10174,27383,27383,0,13,9766000.0
9766,9766999,20.69559877921159,37.65775984465131,0.08231508570284152,1725.2704720497131,644.5195832252502,1547.5155067443848,37565,10178,27387,27387,0,13,9767000.0
9767,9767999,20.695850419212952,37.658743822350004,0.08231862560122916,1725.4004130363464,644.582456111908,1547.811122894287,37565,10178,27387,27387,0,13,9768000.0
9768,9768999,20.696271880500575,37.65959410571958,0.08233943017249601,1725.6160700321198,644.6468591690063,1547.8754768371582,37568,10179,27389,27389,0,13,9769000.0
9769,9769999,20.6964619834825,37.65953004259548,0.08233944703782303,1725.8383758068085,644.7099940776825,1548.027458190918,37570,10180,27390,27390,0,13,9770000.0
9770,9770999,20.69644821251283,37.6593031058702,0.08233567537403075,1725.9666669368744,644.7715048789978,1548.4019584655762,37573,10180,27393,27393,0,13,9771000.0
9771,9771999,20.695815253684223,37.658408313836176,0.08233530594594363,1726.0785779953003,644.8330841064453,1549.4042701721191,37591,10180,27411,27411,0,13,9772000.0
9772,9772999,20.69519608022308,37.65762643419198,0.0823348228110562,1726.2123806476593,644.8948209285736,1549.7997436523438,37591,10180,27411,27411,0,13,9773000.0
9773,9773999,20.69465671517232,37.65670397180327,0.08233198665320585,1726.50741314888,644.9580936431885,1550.023338317871,37595,10182,27413,27413,0,13,9774000.0
9774,9774999,20.694023752626418,37.65548450260239,0.08233312554133898,1726.6132745742798,645.0173187255859,1550.304630279541,37595,10182,27413,27413,0,13,9775000.0
9775,9775999,20.693498783161694,37.654424365443724,0.08233271871866732,1726.829908132553,645.0819778442383,1550.445468902588,37597,10183,27414,27414,0,13,9776000.0
9776,9776999,20.69283156591325,37.65330080512003,0.0823337665613737,1727.0307245254517,645.1424889564514,1550.5662651062012,37599,10184,27415,27415,0,13,9777000.0
9777,9777999,20.692178613245378,37.651979565594246,0.08233347560373305,1727.5902626514435,645.2044417858124,1550.5469017028809,37609,10189,27420,27420,0,13,9778000.0
9778,9778999,20.69157074451161,37.65080763999422,0.08233355671880926,1727.8069338798523,645.2675433158875,1550.747573852539,37612,10190,27422,27422,0,13,9779000.0
9779,9779999,20.691007907918866,37.64979082717908,0.08233324865199632,1728.0212168693542,645.329639673233,1550.876766204834,37614,10191,27423,27423,0,13,9780000.0
9780,9780999,20.69038840385803,37.64856863382449,0.08233523927861319,1728.2369918823242,645.3929316997528,1551.076042175293,37618,10192,27426,27426,0,13,9781000.0
9781,9781999,20.689770617750707,37.64726899138129,0.08233575224603351,1728.3539452552795,645.4561553001404,1551.36763381958,37621,10192,27429,27429,0,13,9782000.0
9782,9782999,20.68936803182023,37.646203795449686,0.08233194707032876,1728.4860191345215,645.5182762145996,1551.596134185791,37621,10192,27429,27429,0,13,9783000.0
9783,9783999,20.68905026033604,37.64662724670629,0.08232343358976624,1728.6968882083893,645.5810544490814,1551.7456092834473,37623,10193,27430,27430,0,13,9784000.0
9784,9784999,20.68866137601105,37.645512952901996,0.08232157496423831,1729.179001569748,645.6443138122559,1551.6495971679688,37631,10197,27434,27434,0,13,9785000.0
9785,9785999,20.688272033295593,37.64533228600321,0.08231840258481837,1729.5715942382812,645.7075834274292,1551.723445892334,37637,10200,27437,27437,0,13,9786000.0
9786,9786999,20.687849704907183,37.644289172927586,0.08232074679181456,1729.7830328941345,645.7707185745239,1551.9309120178223,37639,10201,27438,27438,0,13,9787000.0
9787,9787999,20.687532187406923,37.64407892740648,0.08231552259034047,1729.9112079143524,645.8334891796112,1552.6476097106934,37654,10201,27453,27453,0,13,9788000.0
9788,9788999,20.687094985517803,37.643625158435654,0.08230845291886524,1730.0297665596008,645.8982667922974,1553.1742668151855,37654,10201,27453,27453,0,13,9789000.0
9789,9789999,20.686740097688727,37.64341706460351,0.0823038172914905,1730.1483478546143,645.9601962566376,1553.4782371520996,37654,10201,27453,27453,0,13,9790000.0
9790,9790999,20.686255300011133,37.64235492210554,0.08230227714458871,1730.3698043823242,646.0223515033722,1553.6075630187988,37666,10202,27464,27464,0,13,9791000.0
9791,9791999,20.685982577097004,37.641674908185486,0.08229152790004246,1730.753580570221,646.0859565734863,1553.720531463623,37673,10205,27468,27468,0,13,9792000.0
9792,9792999,20.685950066416638,37.64503891753796,0.0822653859947221,1730.8682367801666,646.1473479270935,1554.0284233093262,37673,10205,27468,27468,0,13,9793000.0
9793,9793999,20.685739607346562,37.644680872631916,0.08225602280917343,1731.2685704231262,646.211302280426,1553.9948272705078,37679,10208,27471,27471,0,13,9794000.0
9794,9794999,20.68566288844212,37.644415360450154,0.08224770346190524,1731.5746002197266,646.2755496501923,1554.1696166992188,37683,10210,27473,27473,0,13,9795000.0
9795,9795999,20.68565922798888,37.64480986025156,0.08224936395502358,1731.7908170223236,646.3384552001953,1554.3195304870605,37686,10211,27475,27475,0,13,9796000.0
9796,9796999,20.68562579390322,37.64449730884965,0.08224764440887389,1732.0873396396637,646.4036836624146,1554.3231773376465,37694,10213,27481,27481,0,13,9797000.0
9797,9797999,20.68582962876034,37.64463541460186,0.08225295419678025,1732.2180182933807,646.4668159484863,1554.557559967041,37695,10213,27482,27482,0,13,9798000.0
9798,9798999,20.68604767974165,37.64460069876663,0.08224678821314979,1732.3468925952911,646.5302491188049,1554.7948760986328,37697,10213,27484,27484,0,13,9799000.0
9799,9799999,20.68621833519503,37.64452018174138,0.082238785638998,1732.5602641105652,646.5929234027863,1554.874698638916,37699,10214,27485,27485,0,13,9800000.0
9800,9800999,20.68631825706042,37.644317956185205,0.08223721774450099,1732.9469528198242,646.655552148819,1554.863368988037,37705,10217,27488,27488,0,13,9801000.0
9801,9801999,20.686415775851874,37.644154830398946,0.08223494195184178,1733.2527334690094,646.7178359031677,1554.9416427612305,37711,10219,27492,27492,0,13,9802000.0
9802,9802999,20.686619716912436,37.6440890831349,0.0822314459841913,1733.7369198799133,646.7816264629364,1554.9996337890625,37720,10223,27497,27497,0,13,9803000.0
9803,9803999,20.686794464736323,37.64395257119527,0.08222585569492002,1733.8700623512268,646.8536834716797,1555.2216529846191,37720,10223,27497,27497,0,13,9804000.0
9804,9804999,20.686861038387242,37.64350713730964,0.08222534827294159,1733.9981095790863,646.9158780574799,1555.3855514526367,37720,10223,27497,27497,0,13,9805000.0
9805,9805999,20.686732697387185,37.64270439466515,0.08222092287556138,1734.1267030239105,646.9798853397369,1555.524715423584,37720,10223,27497,27497,0,13,9806000.0
9806,9806999,20.686540834417514,37.64185424548011,0.08221788353323045,1734.341157913208,647.043173789978,1556.0326881408691,37738,10224,27514,27514,0,13,9807000.0
9807,9807999,20.685633609069008,37.6407472199863,0.08222092624463828,1734.4630494117737,647.1090517044067,1556.829532623291,37748,10224,27524,27524,0,13,9808000.0
9808,9808999,20.684913444164994,37.63978528912821,0.08221955248420132,1734.6627204418182,647.1726846694946,1557.2079429626465,37751,10225,27526,27526,0,13,9809000.0
9809,9809999,20.68453741505139,37.63981968974573,0.08221168457370664,1734.881172657013,647.2363953590393,1557.436954498291,37753,10226,27527,27527,0,13,9810000.0
9810,9810999,20.68412394188116,37.639633154688354,0.08220382804878623,1735.2946908473969,647.3087775707245,1557.4697799682617,37759,10229,27530,27530,0,13,9811000.0
9811,9811999,20.68392003055768,37.639153363475685,0.08219831580530423,1735.5916504859924,647.3721647262573,1557.6848793029785,37765,10231,27534,27534,0,13,9812000.0
9812,9812999,20.683502254001958,37.63833738017849,0.08220008119250188,1735.8810148239136,647.4355964660645,1557.8589324951172,37769,10233,27536,27536,0,13,9813000.0
9813,9813999,20.683378110804032,37.638563958463614,0.0821939342245519,1736.1831424236298,647.5008113384247,1557.9852676391602,37773,10235,27538,27538,0,13,9814000.0
9814,9814999,20.683355879071538,37.63864562487675,0.08219681171566773,1736.390629529953,647.5629329681396,1558.2067832946777,37775,10236,27539,27539,0,13,9815000.0
9815,9815999,20.683450457723904,37.63905870790403,0.08220119115746494,1736.5957357883453,647.62384724617,1558.336109161377,37777,10237,27540,27540,0,13,9816000.0
9816,9816999,20.6836973566033,37.63951956804895,0.08219779419793893,1736.8969371318817,647.6880526542664,1558.4409408569336,37781,10239,27542,27542,0,13,9817000.0
9817,9817999,20.684015625819768,37.64013712809834,0.08220130010051052,1737.2124736309052,647.7527465820312,1558.5529098510742,37790,10241,27549,27549,0,13,9818000.0
9818,9818999,20.684197278588332,37.640193005660095,0.08220474813970768,1737.4270753860474,647.8163928985596,1558.780418395996,37793,10242,27551,27551,0,13,9819000.0
9819,9819999,20.684349412980062,37.64015035692172,0.08220927861919025,1737.731012582779,647.881430387497,1558.884464263916,37798,10244,27554,27554,0,13,9820000.0
9820,9820999,20.684501643991695,37.639947908929386,0.08221867332281751,1737.8501574993134,647.9446880817413,1559.1770248413086,37798,10244,27554,27554,0,13,9821000.0
9821,9821999,20.684649577825823,37.639876218283995,0.08221631207091151,1738.1698274612427,648.0083067417145,1559.2591171264648,37804,10246,27558,27558,0,13,9822000.0
9822,9822999,20.684818007260372,37.63975531570724,0.08221804803252064,1738.5642230510712,648.0737948417664,1559.38374710083,37810,10249,27561,27561,0,13,9823000.0
9823,9823999,20.684985396309184,37.63972282190729,0.08221607513037454,1738.6888675689697,648.1390235424042,1559.585163116455,37810,10249,27561,27561,0,13,9824000.0
9824,9824999,20.685153073186793,37.63963255927772,0.08220566179548339,1738.8524992465973,648.2030816078186,1559.7625122070312,37810,10249,27561,27561,0,13,9825000.0
9825,9825999,20.685246556516574,37.6393851443085,0.08219330215746612,1738.9761006832123,648.2667415142059,1559.919979095459,37810,10249,27561,27561,0,13,9826000.0
9826,9826999,20.685247306492535,37.639040949238264,0.08218408138404354,1739.1061551570892,648.3328154087067,1560.5633697509766,37824,10249,27575,27575,0,13,9827000.0
9827,9827999,20.6843287377537,37.63770359314181,0.08218898906683558,1739.2238309383392,648.3954107761383,1561.38032913208,37831,10249,27582,27582,0,13,9828000.0
9828,9828999,20.683433962503123,37.6366841201749,0.08219288715778916,1739.4193677902222,648.4570848941803,1561.7772026062012,37834,10250,27584,27584,0,13,9829000.0
9829,9829999,20.682566113286203,37.635576724244835,0.08219607056603939,1739.6284532546997,648.5212259292603,1562.0063209533691,37836,10251,27585,27585,0,13,9830000.0
9830,9830999,20.68177102038047,37.63418702619891,0.08219945546576102,1739.8465149402618,648.5866377353668,1562.1798858642578,37838,10252,27586,27586,0,13,9831000.0
9831,9831999,20.680982384014182,37.63293229048403,0.08220225351707866,1739.9654014110565,648.6483130455017,1562.4327011108398,37838,10252,27586,27586,0,13,9832000.0
9832,9832999,20.68019922428353,37.63152166063454,0.0822058178569619,1740.1709570884705,648.7128739356995,1562.5595016479492,37840,10253,27587,27587,0,13,9833000.0
9833,9833999,20.6793899675443,37.63025453203748,0.08220823170893787,1740.3988745212555,648.7759757041931,1562.7150535583496,37842,10254,27588,27588,0,13,9834000.0
9834,9834999,20.678618782796217,37.62887770876931,0.0822107302880215,1740.973778963089,648.8450000286102,1562.5830154418945,37852,10259,27593,27593,0,13,9835000.0
9835,9835999,20.677886139539364,37.627550888568486,0.082212958104248,1741.358666419983,648.9087326526642,1562.71337890625,37859,10262,27597,27597,0,13,9836000.0
9836,9836999,20.677301700731704,37.62654562047887,0.08221196882814918,1741.8293380737305,648.9727368354797,1562.7436637878418,37869,10266,27603,27603,0,13,9837000.0
9837,9837999,20.676672847398336,37.62557682737605,0.08221222918225257,1741.9701840877533,649.0479171276093,1562.9816436767578,37869,10266,27603,27603,0,13,9838000.0
9838,9838999,20.676236890151944,37.6247889266176,0.08221099057634063,1742.1009621620178,649.1122822761536,1563.330410003662,37871,10266,27605,27605,0,13,9839000.0
9839,9839999,20.675727125288056,37.623764559225755,0.08221180453278654,1742.3031871318817,649.1750552654266,1563.5024337768555,37873,10267,27606,27606,0,13,9840000.0
9840,9840999,20.675215373790877,37.62273031434648,0.08221243624789754,1742.6013624668121,649.2374694347382,1563.633529663086,37878,10269,27609,27609,0,13,9841000.0
9841,9841999,20.674843371339414,37.62183524649604,0.08221301091572086,1743.088145017624,649.3009855747223,1563.6110038757324,37886,10273,27613,27613,0,13,9842000.0
9842,9842999,20.674801881743807,37.621703065516876,0.08220697207259453,1743.304868221283,649.3641469478607,1563.867000579834,37888,10274,27614,27614,0,13,9843000.0
9843,9843999,20.67482453583599,37.62154585700585,0.08220476479804295,1743.436973810196,649.4261791706085,1564.093677520752,37888,10274,27614,27614,0,13,9844000.0
9844,9844999,20.67495597963007,37.62152768597354,0.08220386198570806,1743.5766472816467,649.4881780147552,1564.2414627075195,37888,10274,27614,27614,0,13,9845000.0
9845,9845999,20.674904140852696,37.62111134006541,0.08221037728384117,1743.7998931407928,649.5529224872589,1564.3625526428223,37890,10275,27615,27615,0,13,9846000.0
9846,9846999,20.6742908563392,37.62004028849178,0.08221562989043119,1744.0133426189423,649.6171932220459,1565.2202415466309,37913,10276,27637,27637,0,13,9847000.0
9847,9847999,20.67361386278611,37.619265377960346,0.08221402984054027,1744.1290068626404,649.6793928146362,1565.6958045959473,37913,10276,27637,27637,0,13,9848000.0
9848,9848999,20.67297144998398,37.61807401188537,0.08221683997191864,1744.3296575546265,649.7410612106323,1566.012466430664,37915,10277,27638,27638,0,13,9849000.0
9849,9849999,20.67263611945255,37.61763989079486,0.0822146920876976,1744.6277811527252,649.8028347492218,1566.1580276489258,37919,10279,27640,27640,0,13,9850000.0
9850,9850999,20.67219896227509,37.616660877966254,0.08221499718604608,1744.832046031952,649.8655021190643,1566.3652458190918,37921,10280,27641,27641,0,13,9851000.0
9851,9851999,20.672019077067436,37.616074650974475,0.08221377572977528,1745.045955657959,649.9308199882507,1566.5223007202148,37927,10281,27646,27646,0,13,9852000.0
9852,9852999,20.671816240020544,37.61549257946622,0.08221147341427737,1745.3508973121643,649.9926671981812,1566.574119567871,37931,10283,27648,27648,0,13,9853000.0
9853,9853999,20.671622935441256,37.61484676678942,0.08221299043148156,1745.9919102191925,650.0563390254974,1566.5377044677734,37945,10289,27656,27656,0,13,9854000.0
9854,9854999,20.671429685185466,37.614127567822166,0.08221554483878801,1746.637099981308,650.1207683086395,1566.4346733093262,37958,10295,27663,27663,0,13,9855000.0
9855,9855999,20.671185367774342,37.61333336361972,0.08221788733586377,1746.7690579891205,650.1856715679169,1566.7328262329102,37958,10295,27663,27663,0,13,9856000.0
9856,9856999,20.670890493029273,37.61244700693524,0.0822186791141748,1746.896487236023,650.2508146762848,1567.0658569335938,37961,10295,27666,27666,0,13,9857000.0
9857,9857999,20.6706036609369,37.611545084990794,0.08221836495565094,1747.02117228508,650.3153827190399,1567.2700500488281,37961,10295,27666,27666,0,13,9858000.0
9858,9858999,20.670345625019774,37.6106201952068,0.08221913120729729,1747.1631557941437,650.3807468414307,1567.5363807678223,37962,10295,27667,27667,0,13,9859000.0
9859,9859999,20.670136376156602,37.60983142256099,0.08221995445539321,1747.290817975998,650.4420473575592,1567.7191848754883,37962,10295,27667,27667,0,13,9860000.0
9860,9860999,20.670124948809896,37.611779490059085,0.08221063227731706,1747.4037375450134,650.5035221576691,1567.8896408081055,37962,10295,27667,27667,0,13,9861000.0
9861,9861999,20.66986087569856,37.61085810048928,0.082209378265095,1747.7219116687775,650.5661263465881,1567.8984107971191,37966,10297,27669,27669,0,13,9862000.0
9862,9862999,20.66964474942656,37.609893265690076,0.08220658440108541,1748.1408286094666,650.6354513168335,1567.8786659240723,37975,10300,27675,27675,0,13,9863000.0
9863,9863999,20.669537167372717,37.60932652271876,0.08220375952558279,1748.2959401607513,650.7005536556244,1568.0704917907715,37975,10300,27675,27675,0,13,9864000.0
9864,9864999,20.66922341588656,37.60835423196058,0.08220317857717718,1748.5231938362122,650.7641797065735,1568.1044082641602,37977,10301,27676,27676,0,13,9865000.0
9865,9865999,20.66882479658379,37.60737564947843,0.082203875649699,1748.7551307678223,650.8283038139343,1568.4848403930664,38038,10302,27736,27736,0,13,9866000.0
9866,9866999,20.668429272444378,37.60727317160726,0.0822009179550568,1748.8848054409027,650.8916273117065,1569.6415748596191,38060,10302,27758,27758,0,13,9867000.0
9867,9867999,20.667698930602114,37.60601733476714,0.08220273358455565,1748.9930539131165,650.9553980827332,1570.1056900024414,38061,10302,27759,27759,0,13,9868000.0
9868,9868999,20.666993926537888,37.60466775476166,0.082204112568937,1749.104709148407,651.0175569057465,1570.4459800720215,38061,10302,27759,27759,0,13,9869000.0
9869,9869999,20.666303815017717,37.60344300945004,0.082204419746021,1749.7457189559937,651.0809710025787,1570.3001861572266,38073,10308,27765,27765,0,13,9870000.0
9870,9870999,20.665633011299725,37.60295018137582,0.08220336777338844,1749.9502744674683,651.143785238266,1570.6422958374023,38075,10309,27766,27766,0,13,9871000.0
9871,9871999,20.665037136086035,37.601881490661235,0.08220023027558676,1750.3290100097656,651.20694231987,1570.840503692627,38081,10312,27769,27769,0,13,9872000.0
9872,9872999,20.664424623790897,37.60074395529972,0.0821979192306529,1750.6405057907104,651.2754189968109,1571.0129165649414,38085,10314,27771,27771,0,13,9873000.0
9873,9873999,20.663874661010713,37.599984351574825,0.08219286334735754,1750.7656939029694,651.338095664978,1571.3088150024414,38085,10314,27771,27771,0,13,9874000.0
9874,9874999,20.6633043238394,37.59877550099778,0.08219039832356623,1751.2425303459167,651.4010124206543,1571.2539710998535,38094,10318,27776,27776,0,13,9875000.0
9875,9875999,20.66280282382683,37.59809537600409,0.0821865918648712,1751.4742352962494,651.464239358902,1571.468620300293,38096,10319,27777,27777,0,13,9876000.0
9876,9876999,20.662358008727363,37.597107751104765,0.08218238968105906,1751.5857872962952,651.5260465145111,1571.785629272461,38098,10319,27779,27779,0,13,9877000.0
9877,9877999,20.66200303728872,37.59647905100893,0.0821772526267166,1751.805875301361,651.5895476341248,1571.9246788024902,38100,10320,27780,27780,0,13,9878000.0
9878,9878999,20.661681152643748,37.59585187514685,0.08216897995617445,1752.0254726409912,651.6531188488007,1572.176914215088,38104,10321,27783,27783,0,13,9879000.0
9879,9879999,20.661442279805822,37.5950191633377,0.08216025368572044,1752.1450307369232,651.7144229412079,1572.4032096862793,38104,10321,27783,27783,0,13,9880000.0
9880,9880999,20.66123094480382,37.59520714212206,0.08215017024418891,1752.5514233112335,651.7782936096191,1572.3537902832031,38110,10324,27786,27786,0,13,9881000.0
9881,9881999,20.66108104550495,37.59446794795151,0.08214155429002234,1752.779019832611,651.8412048816681,1572.4860877990723,38112,10325,27787,27787,0,13,9882000.0
9882,9882999,20.660926025036705,37.59361167807193,0.08213666283949239,1752.98863863945,651.9028248786926,1572.645362854004,38114,10326,27788,27788,0,13,9883000.0
9883,9883999,20.66078162080402,37.59294749099272,0.08212935913422725,1753.1217703819275,651.9653873443604,1572.795883178711,38114,10326,27788,27788,0,13,9884000.0
9884,9884999,20.66051911419312,37.59198714300296,0.0821248597396167,1753.241815328598,652.0302321910858,1572.9314651489258,38114,10326,27788,27788,0,13,9885000.0
9885,9885999,20.660379700170843,37.59121238770261,0.08211933556459228,1753.5699982643127,652.0939376354218,1572.9392738342285,38118,10328,27790,27790,0,13,9886000.0
9886,9886999,20.659947469879633,37.59071290469314,0.08211274877864849,1753.7045941352844,652.1559181213379,1573.7628326416016,38140,10328,27812,27812,0,13,9887000.0
9887,9887999,20.65937747798873,37.59090277512297,0.08210240613314701,1753.8094201087952,652.2179164886475,1574.3498458862305,38140,10328,27812,27812,0,13,9888000.0
9888,9888999,20.658693793507673,37.58962261690615,0.08210106122168426,1753.9163472652435,652.2788767814636,1574.732707977295,38140,10328,27812,27812,0,13,9889000.0
9889,9889999,20.658127042652932,37.588539579689005,0.08209971820480244,1754.3027019500732,652.3407514095306,1574.824550628662,38146,10331,27815,27815,0,13,9890000.0
9890,9890999,20.657458750268706,37.58732620997433,0.08210061619714437,1754.759705543518,652.403406381607,1574.9138145446777,38154,10335,27819,27819,0,13,9891000.0
9891,9891999,20.656983896841187,37.5863821318584,0.08209655027076546,1754.8791298866272,652.4686305522919,1575.2446250915527,38154,10335,27819,27819,0,13,9892000.0
9892,9892999,20.65644996032928,37.58528360969452,0.08209392439260121,1755.092536687851,652.5305874347687,1575.4676055908203,38156,10336,27820,27820,0,13,9893000.0
9893,9893999,20.656272976760274,37.58584890483549,0.08208261090640723,1755.5592470169067,652.593608379364,1575.4450645446777,38166,10340,27826,27826,0,13,9894000.0
9894,9894999,20.656080537259275,37.585410129198166,0.08207765138361434,1755.9513802528381,652.6570191383362,1575.466724395752,38174,10343,27831,27831,0,13,9895000.0
9895,9895999,20.655935897434542,37.58497202693408,0.08207430101015878,1756.3388035297394,652.7219512462616,1575.6142272949219,38181,10346,27835,27835,0,13,9896000.0
9896,9896999,20.65609811947439,37.58518605539296,0.08207292169225056,1756.466989517212,652.7838962078094,1575.827865600586,38181,10346,27835,27835,0,13,9897000.0
9897,9897999,20.656472158045386,37.585890745477776,0.08207623816861287,1757.0111422538757,652.8459482192993,1575.7826385498047,38194,10351,27843,27843,0,13,9898000.0
9898,9898999,20.65699009015943,37.58752042618627,0.08206771015237779,1757.2300934791565,652.9110381603241,1575.9849853515625,38197,10352,27845,27845,0,13,9899000.0
9899,9899999,20.657612282890145,37.58853388754501,0.08207581381733853,1757.442304611206,652.9722857475281,1576.1943054199219,38200,10353,27847,27847,0,13,9900000.0
9900,9900999,20.658274463959543,37.59054138432403,0.0820822429788125,1757.6498951911926,653.0345420837402,1576.4205017089844,38202,10354,27848,27848,0,13,9901000.0
9901,9901999,20.65900498019526,37.591359878467934,0.08209927802871697,1757.966299533844,653.0989806652069,1576.4787368774414,38206,10356,27850,27850,0,13,9902000.0
9902,9902999,20.65975603845536,37.592136996614485,0.08210591634698905,1758.2900307178497,653.1620826721191,1576.61372756958,38210,10358,27852,27852,0,13,9903000.0
9903,9903999,20.660275583650467,37.59237472147355,0.08212872758628131,1758.4982607364655,653.2263941764832,1576.7433433532715,38212,10359,27853,27853,0,13,9904000.0
9904,9904999,20.66093331468191,37.5935346268108,0.08214359401246407,1758.7093260288239,653.2888975143433,1576.8604469299316,38214,10360,27854,27854,0,13,9905000.0
9905,9905999,20.661563551532037,37.59402820669705,0.08214973296758954,1758.8570096492767,653.3600561618805,1577.0218696594238,38214,10360,27854,27854,0,13,9906000.0
9906,9906999,20.661848591317707,37.59409112135074,0.0821452750063063,1759.0815525054932,653.4225921630859,1577.2759895324707,38228,10361,27867,27867,0,13,9907000.0
9907,9907999,20.661203035753424,37.593328901200955,0.0821426003220811,1759.20517039299,653.4846658706665,1578.3670539855957,38250,10361,27889,27889,0,13,9908000.0
9908,9908999,20.660401363743887,37.59219788995125,0.08214680167242361,1759.332480430603,653.5486068725586,1578.7704124450684,38250,10361,27889,27889,0,13,9909000.0
9909,9909999,20.65976568618263,37.59150952484701,0.08214960209131195,1759.4500527381897,653.6121542453766,1579.0667152404785,38250,10361,27889,27889,0,13,9910000.0
9910,9910999,20.659064285145178,37.59046113010388,0.08215451329446433,1759.6553728580475,653.6751296520233,1579.1496887207031,38256,10362,27894,27894,0,13,9911000.0
9911,9911999,20.658242206893398,37.58908789327403,0.0821626756254139,1759.955590724945,653.7385582923889,1579.1869354248047,38263,10364,27899,27899,0,13,9912000.0
9912,9912999,20.657425315762104,37.58775300782229,0.08216731838393199,1760.2390174865723,653.7993776798248,1579.3609619140625,38267,10366,27901,27901,0,13,9913000.0
9913,9913999,20.656776369943856,37.58733789053421,0.08216691739963244,1760.8091280460358,653.8638656139374,1579.2641487121582,38277,10371,27906,27906,0,13,9914000.0
9914,9914999,20.656018590465017,37.58625995852038,0.08217051503158135,1761.01673746109,653.9282684326172,1579.4490242004395,38284,10372,27912,27912,0,13,9915000.0
9915,9915999,20.65523836117238,37.585035913740214,0.0821740012110217,1761.3302612304688,653.9948902130127,1579.5383415222168,38288,10374,27914,27914,0,13,9916000.0
9916,9916999,20.654532453373204,37.5839086426722,0.08217802049877265,1761.5416243076324,654.0576350688934,1579.7746200561523,38294,10375,27919,27919,0,13,9917000.0
9917,9917999,20.653800727959784,37.58291839122503,0.08218042849071494,1761.9315848350525,654.1208078861237,1579.906795501709,38301,10378,27923,27923,0,13,9918000.0
9918,9918999,20.653325203873102,37.58215046967585,0.0821811047172818,1762.232946395874,654.1834051609039,1580.0673446655273,38306,10380,27926,27926,0,13,9919000.0
9919,9919999,20.652781961184328,37.58097004243334,0.08218696763208189,1762.3559637069702,654.2483251094818,1580.297233581543,38306,10380,27926,27926,0,13,9920000.0
9920,9920999,20.652300263348103,37.580003785681576,0.08218959042044327,1762.4818105697632,654.3118114471436,1580.4612617492676,38306,10380,27926,27926,0,13,9921000.0
9921,9921999,20.65169153148051,37.578695478241386,0.08219718931807907,1762.9586973190308,654.3745687007904,1580.3916397094727,38314,10384,27930,27930,0,13,9922000.0
9922,9922999,20.651032061695396,37.57736245896542,0.08220686006198552,1763.257628440857,654.43727850914,1580.471836090088,38318,10386,27932,27932,0,13,9923000.0
9923,9923999,20.650349002760898,37.57611829411738,0.0822132829594332,1763.4693503379822,654.4979839324951,1580.8010864257812,38324,10387,27937,27937,0,13,9924000.0
9924,9924999,20.649483709413385,37.57473738695148,0.08221721127409065,1763.6676814556122,654.5617678165436,1581.762409210205,38343,10388,27955,27955,0,13,9925000.0
9925,9925999,20.64877909427506,37.573641175789874,0.0822217530278967,1763.7819015979767,654.6235263347626,1582.2163314819336,38344,10388,27956,27956,0,13,9926000.0
9926,9926999,20.64801929324713,37.5726980799151,0.08222579720830625,1763.9092972278595,654.6877374649048,1582.4794464111328,38344,10388,27956,27956,0,13,9927000.0
9927,9927999,20.64722523351613,37.5713193271929,0.08223131919399873,1764.107503414154,654.7498083114624,1582.666187286377,38346,10389,27957,27957,0,13,9928000.0
9928,9928999,20.646535291246433,37.570078427644525,0.08223390381100493,1764.3199172019958,654.8153548240662,1582.8936195373535,38348,10390,27958,27958,0,13,9929000.0
9929,9929999,20.645809478391904,37.568824827451586,0.08223598297001045,1764.6116347312927,654.8787624835968,1582.948169708252,38353,10392,27961,27961,0,13,9930000.0
9930,9930999,20.6450967788583,37.567579356810164,0.08223975532292216,1764.9069776535034,654.9409494400024,1583.1231155395508,38357,10394,27963,27963,0,13,9931000.0
9931,9931999,20.64447141049366,37.566470110678594,0.08223931519127092,1765.2894704341888,655.0041971206665,1583.1843032836914,38364,10397,27967,27967,0,13,9932000.0
9932,9932999,20.643846961656084,37.56547984711095,0.08223911282591645,1765.5920085906982,655.0670490264893,1583.255283355713,38368,10399,27969,27969,0,13,9933000.0
9933,9933999,20.643429318121623,37.56468326133507,0.08223786278825074,1765.9867107868195,655.133118391037,1583.3095207214355,38375,10402,27973,27973,0,13,9934000.0
9934,9934999,20.643159315103805,37.56412758220345,0.08223459130201072,1766.116506576538,655.1955699920654,1583.5657501220703,38376,10402,27974,27974,0,13,9935000.0
9935,9935999,20.642899080111025,37.563905409608466,0.0822294647954237,1766.4280025959015,655.2588889598846,1583.759880065918,38381,10404,27977,27977,0,13,9936000.0
9936,9936999,20.642740701420507,37.56349558059242,0.08222371061819433,1766.5559301376343,655.3231089115143,1583.9649963378906,38381,10404,27977,27977,0,13,9937000.0
9937,9937999,20.642700629460737,37.563307304078656,0.08221964374919588,1766.8443689346313,655.3852670192719,1583.9929122924805,38385,10406,27979,27979,0,13,9938000.0
9938,9938999,20.64293896334284,37.56346233852812,0.08220959065847344,1767.2362396717072,655.451235294342,1584.069435119629,38391,10409,27982,27982,0,13,9939000.0
9939,9939999,20.64311509703275,37.563709061494706,0.08220191211683225,1767.5485558509827,655.5138750076294,1584.150951385498,38399,10411,27988,27988,0,13,9940000.0
9940,9940999,20.64319300061634,37.56348818669759,0.08219724094744074,1767.6776292324066,655.5763370990753,1584.3524627685547,38399,10411,27988,27988,0,13,9941000.0
9941,9941999,20.643345985222687,37.563826882698386,0.08218936312488923,1767.8870441913605,655.6385378837585,1584.4130783081055,38405,10412,27993,27993,0,13,9942000.0
9942,9942999,20.64315813122193,37.56317472995203,0.08218273855682978,1768.1037356853485,655.7013444900513,1584.51025390625,38407,10413,27994,27994,0,13,9943000.0
9943,9943999,20.642345769706278,37.56213193782986,0.08218597001479544,1768.2357158660889,655.7694220542908,1585.5519256591797,38427,10413,28014,28014,0,13,9944000.0
9944,9944999,20.64135621222563,37.560966081297956,0.08218975158932762,1768.4332296848297,655.831972360611,1585.9766464233398,38432,10414,28018,28018,0,13,9945000.0
9945,9945999,20.64054661919838,37.5600451966057,0.08219163626306947,1768.6329741477966,655.8934762477875,1586.3198585510254,38437,10415,28022,28022,0,13,9946000.0
9946,9946999,20.63965371463475,37.558672958896025,0.08219525706988406,1768.8420243263245,655.9579315185547,1586.5865516662598,38439,10416,28023,28023,0,13,9947000.0
9947,9947999,20.638917992880987,37.55751151386507,0.08219557351529405,1769.140747308731,656.0225622653961,1586.6989974975586,38443,10418,28025,28025,0,13,9948000.0
9948,9948999,20.638075559797603,37.55628513797787,0.08219731411491471,1769.4289104938507,656.0862145423889,1586.8437042236328,38447,10420,28027,28027,0,13,9949000.0
9949,9949999,20.63733129390757,37.555141577112494,0.08219967430564401,1769.817134141922,656.1499836444855,1586.8744354248047,38460,10423,28037,28037,0,13,9950000.0
9950,9950999,20.63665256113544,37.55417110678681,0.08220021080157025,1770.1275236606598,656.2181029319763,1587.011245727539,38464,10425,28039,28039,0,13,9951000.0
9951,9951999,20.63613874606632,37.55372178477171,0.08219668872828156,1770.4182238578796,656.2803087234497,1587.1032829284668,38473,10427,28046,28046,0,13,9952000.0
9952,9952999,20.6356256826415,37.55297715888051,0.08219263056380699,1770.8160345554352,656.3444828987122,1587.1209983825684,38480,10430,28050,28050,0,13,9953000.0
9953,9953999,20.63515220067711,37.55207826693016,0.08219011057231218,1771.0339024066925,656.4091944694519,1587.4423522949219,38484,10431,28053,28053,0,13,9954000.0
9954,9954999,20.63495706047557,37.55164402880033,0.08218458424703556,1771.1626117229462,656.4730982780457,1587.671199798584,38484,10431,28053,28053,0,13,9955000.0
9955,9955999,20.634646553426496,37.55089304972919,0.08218142396359462,1771.375646352768,656.5358901023865,1587.9227828979492,38488,10432,28056,28056,0,13,9956000.0
9956,9956999,20.634354484252253,37.55050639230471,0.08217596593069265,1771.6634783744812,656.5992450714111,1587.9549598693848,38497,10434,28063,28063,0,13,9957000.0
9957,9957999,20.634056562772027,37.54982584313116,0.08217337365985344,1771.9616527557373,656.6632070541382,1588.0927352905273,38501,10436,28065,28065,0,13,9958000.0
9958,9958999,20.633818387385205,37.54939948685184,0.08217036369776642,1772.4391689300537,656.7267687320709,1588.0528831481934,38514,10440,28074,28074,0,13,9959000.0
9959,9959999,20.63368024175454,37.548744311981665,0.08216726855989387,1772.5817847251892,656.7927412986755,1588.3283615112305,38514,10440,28074,28074,0,13,9960000.0
9960,9960999,20.63326626801405,37.54773629669818,0.08216736860746365,1772.7994277477264,656.8607766628265,1588.4688529968262,38516,10441,28075,28075,0,13,9961000.0
9961,9961999,20.632935881432292,37.54699086274253,0.08216559153761605,1772.9415056705475,656.9234454631805,1588.6225204467773,38516,10441,28075,28075,0,13,9962000.0
9962,9962999,20.63250779166563,37.54602795721749,0.08216440071690811,1773.1553909778595,656.9866437911987,1588.7146530151367,38518,10442,28076,28076,0,13,9963000.0
9963,9963999,20.631771478021523,37.54489793978509,0.0821677217068334,1773.4514892101288,657.0503935813904,1589.4993324279785,38539,10444,28095,28095,0,13,9964000.0
9964,9964999,20.630685621988786,37.54337792891759,0.08217446287808405,1773.568282842636,657.1133480072021,1589.9998054504395,38542,10444,28098,28098,0,13,9965000.0
9965,9965999,20.6297097715077,37.542067927401774,0.08217949469125696,1773.6798295974731,657.173989534378,1590.3400382995605,38543,10444,28099,28099,0,13,9966000.0
9966,9966999,20.628834138751333,37.54083098889287,0.08218270600427535,1774.1475791931152,657.2369608879089,1590.4124908447266,38556,10448,28108,28108,0,13,9967000.0
9967,9967999,20.628094194234784,37.540082128197554,0.08218195486871616,1774.4456770420074,657.3029839992523,1590.6412506103516,38560,10450,28110,28110,0,13,9968000.0
9968,9968999,20.627255669524995,37.53874409646645,0.08218565159016289,1774.9094455242157,657.365510225296,1590.6279754638672,38570,10454,28116,28116,0,13,9969000.0
9969,9969999,20.626432713008207,37.53737618099651,0.08218859869866313,1775.0303921699524,657.4275050163269,1590.9380722045898,38570,10454,28116,28116,0,13,9970000.0
9970,9970999,20.62576879804473,37.53658672714231,0.08218793425296311,1775.3313157558441,657.4910674095154,1591.1002616882324,38574,10456,28118,28118,0,13,9971000.0
9971,9971999,20.62519405328471,37.53561522804389,0.08218592823002246,1775.547461271286,657.5526976585388,1591.250114440918,38577,10457,28120,28120,0,13,9972000.0
9972,9972999,20.62479812064117,37.53507509402415,0.08217998634033785,1775.8424863815308,657.6149401664734,1591.4081954956055,38582,10459,28123,28123,0,13,9973000.0
9973,9973999,20.62464612763865,37.53516060187116,0.08216946506874379,1775.9825191497803,657.6774618625641,1591.6977729797363,38584,10459,28125,28125,0,13,9974000.0
9974,9974999,20.624400034528506,37.53461628808139,0.0821649129341927,1776.1065549850464,657.7385814189911,1591.8711853027344,38584,10459,28125,28125,0,13,9975000.0
9975,9975999,20.62426158151336,37.53428339621542,0.08216184584766295,1776.3046293258667,657.7996544837952,1592.1200141906738,38591,10460,28131,28131,0,13,9976000.0
9976,9976999,20.624640884137417,37.53493093564521,0.08215984596878745,1776.5976221561432,657.862254858017,1592.2297401428223,38595,10462,28133,28133,0,13,9977000.0
9977,9977999,20.625085676900788,37.53592745450002,0.08216363493092826,1776.8088431358337,657.9245066642761,1592.4590339660645,38598,10463,28135,28135,0,13,9978000.0
9978,9978999,20.62578997090646,37.53722493136325,0.08216771033446968,1777.0270369052887,657.9869091510773,1592.592929840088,38600,10464,28136,28136,0,13,9979000.0
9979,9979999,20.62663468374985,37.53809865441823,0.0821770264598306,1777.1588792800903,658.0483083724976,1592.8022155761719,38600,10464,28136,28136,0,13,9980000.0
9980,9980999,20.627388168656253,37.53896275039204,0.08217754388272358,1777.2932450771332,658.1093304157257,1592.9761772155762,38600,10464,28136,28136,0,13,9981000.0
9981,9981999,20.628477721642568,37.54036023502988,0.08218415833574999,1777.505525112152,658.1719624996185,1593.0352210998535,38602,10465,28137,28137,0,13,9982000.0
9982,9982999,20.629079882752563,37.540796794458046,0.08218376598194943,1777.6214764118195,658.233099937439,1593.1813049316406,38602,10465,28137,28137,0,13,9983000.0
9983,9983999,20.62855518953828,37.54002314060582,0.08218270013251272,1777.8308448791504,658.2957453727722,1594.0049018859863,38623,10466,28157,28157,0,13,9984000.0
9984,9984999,20.62768056569194,37.539089245176335,0.08218491193430766,1777.9464130401611,658.3561954498291,1594.3842811584473,38623,10466,28157,28157,0,13,9985000.0
9985,9985999,20.62680126868154,37.53779760311663,0.0821882298413803,1778.1410884857178,658.4161427021027,1594.5581970214844,38625,10467,28158,28158,0,13,9986000.0
9986,9986999,20.625917840321897,37.53641274581945,0.08219305081473816,1778.6799757480621,658.4798445701599,1594.5473976135254,38635,10472,28163,28163,0,13,9987000.0
9987,9987999,20.625134351736826,37.535049607104085,0.0821952203680284,1778.8779768943787,658.541746377945,1594.8599281311035,38637,10473,28164,28164,0,13,9988000.0
9988,9988999,20.624386860141193,37.534030473206165,0.08219557234348929,1779.100265264511,658.6089227199554,1595.0144653320312,38639,10474,28165,28165,0,13,9989000.0
9989,9989999,20.6235066460641,37.532547795546925,0.08220112557384562,1779.6787123680115,658.6778264045715,1594.8942031860352,38651,10479,28172,28172,0,13,9990000.0
9990,9990999,20.62269979416619,37.53140095518744,0.0822037860078163,1780.0541641712189,658.73983335495,1595.1147422790527,38657,10482,28175,28175,0,13,9991000.0
9991,9991999,20.62208541917319,37.530434907993055,0.08220266627863204,1780.450026512146,658.8036663532257,1595.2695808410645,38664,10485,28179,28179,0,13,9992000.0
9992,9992999,20.62148304964053,37.531033670395146,0.08219621388105358,1780.5731596946716,658.8657031059265,1595.4895935058594,38664,10485,28179,28179,0,13,9993000.0
9993,9993999,20.620935267321997,37.53004615728232,0.08219525191456456,1780.6956052780151,658.9277329444885,1595.8268699645996,38667,10485,28182,28182,0,13,9994000.0
9994,9994999,20.62044359912289,37.52903761722627,0.08219341347267328,1780.9082763195038,658.992538690567,1595.9469833374023,38670,10486,28184,28184,0,13,9995000.0
9995,9995999,20.619877048158884,37.527889688312264,0.08219313327909916,1781.1990509033203,659.0560810565948,1596.1269416809082,38676,10488,28188,28188,0,13,9996000.0
9996,9996999,20.619522006254776,37.52802770796772,0.08218433752420518,1781.3336071968079,659.117259979248,1596.3688507080078,38676,10488,28188,28188,0,13,9997000.0
9997,9997999,20.619077616883033,37.52723137466333,0.08218261973171692,1781.4503486156464,659.1804609298706,1596.547508239746,38676,10488,28188,28188,0,13,9998000.0
9998,9998999,20.618606357753755,37.52624030093809,0.08217991588635498,1781.8406929969788,659.243542432785,1596.4942207336426,38682,10491,28191,28191,0,13,9999000.0
9999,9999999,20.618305021485355,37.525452706762515,0.08217618789191972,1782.136278629303,659.3064162731171,1596.663589477539,38697,10493,28204,28204,0,13,10000000.0
10000,10000999,20.618008021415452,37.524552382592795,0.08217309230777514,1782.2744295597076,659.3705248832703,1596.9789581298828,38697,10493,28204,28204,0,13,10001000.0
10001,10001999,20.617694936715026,37.52378091909576,0.08216857497432484,1782.3907539844513,659.4299297332764,1597.1639976501465,38697,10493,28204,28204,0,13,10002000.0
10002,10002999,20.617220423637406,37.52267698868422,0.08216738404504265,1782.7149147987366,659.4921543598175,1597.2275276184082,38703,10495,28208,28208,0,13,10003000.0
10003,10003999,20.616462939693623,37.52140270657691,0.08216769256748324,1782.8311190605164,659.55593085289,1598.3979377746582,38727,10495,28232,28232,0,13,10004000.0
10004,10004999,20.615723782562753,37.52047432110662,0.08216415872063032,1782.9364366531372,659.6184546947479,1598.911476135254,38728,10495,28233,28233,0,13,10005000.0
10005,10005999,20.61498902271979,37.51946176224335,0.08216208694062554,1783.1303369998932,659.6798903942108,1599.2627029418945,38730,10496,28234,28234,0,13,10006000.0
10006,10006999,20.614482704433488,37.51916015978394,0.08215345081108583,1783.5203104019165,659.7458822727203,1599.4158096313477,38736,10499,28237,28237,0,13,10007000.0
10007,10007999,20.61401182776079,37.518224537747386,0.0821485942577389,1783.797072649002,659.807772397995,1599.645278930664,38740,10501,28239,28239,0,13,10008000.0
10008,10008999,20.61336759198237,37.51720253889348,0.08214534393512307,1783.9935548305511,659.8716578483582,1599.8846244812012,38742,10502,28240,28240,0,13,10009000.0
10009,10009999,20.613070861065363,37.51684093918424,0.08213630613207668,1784.2883117198944,659.9330790042877,1600.0635833740234,38746,10504,28242,28242,0,13,10010000.0
10010,10010999,20.61267115549238,37.51634867896594,0.08213189716973279,1784.674887418747,659.9966535568237,1600.2373847961426,38771,10507,28264,28264,0,13,10011000.0
10011,10011999,20.612613613736347,37.51680399109385,0.08212261900731,1785.145271062851,660.0590727329254,1600.265224456787,38780,10511,28269,28269,0,13,10012000.0
10012,10012999,20.612291899845715,37.51590130243676,0.08211840595700737,1785.3466775417328,660.120480298996,1600.492244720459,38782,10512,28270,28270,0,13,10013000.0
10013,10013999,20.612532619125446,37.51657957177541,0.08210888804725436,1785.559772491455,660.1821596622467,1600.7152481079102,38786,10513,28273,28273,0,13,10014000.0
10014,10014999,20.612640897714936,37.51632082355606,0.08210380916911664,1785.757847070694,660.2433242797852,1600.887264251709,38788,10514,28274,28274,0,13,10015000.0
10015,10015999,20.612836140992467,37.516060511353004,0.08210004646864755,1785.9641847610474,660.3061425685883,1601.1797637939453,38792,10515,28277,28277,0,13,10016000.0
10016,10016999,20.61332834121417,37.51640350009659,0.08209724053735012,1786.2553911209106,660.3692200183868,1601.271770477295,38796,10517,28279,28279,0,13,10017000.0
10017,10017999,20.6136982508377,37.516341580701,0.0821005909675061,1786.6377122402191,660.4323086738586,1601.332347869873,38809,10520,28289,28289,0,13,10018000.0
10018,10018999,20.614197013056877,37.516722320026204,0.08210448191497499,1786.8608813285828,660.4966051578522,1601.520034790039,38811,10521,28290,28290,0,13,10019000.0
10019,10019999,20.614875195204416,37.51729448977525,0.08210551149925838,1787.070391178131,660.5581827163696,1601.761344909668,38813,10522,28291,28291,0,13,10020000.0
10020,10020999,20.61550694206767,37.51753243289152,0.08210978880866482,1787.2738690376282,660.6190185546875,1601.8969764709473,38815,10523,28292,28292,0,13,10021000.0
10021,10021999,20.616055780488797,37.5175704051169,0.08211528537180135,1787.391673564911,660.682923078537,1602.0337524414062,38815,10523,28292,28292,0,13,10022000.0
10022,10022999,20.61643681189941,37.51735091392803,0.08211970255245349,1787.6222605705261,660.7450375556946,1602.0898818969727,38817,10524,28293,28293,0,13,10023000.0
10023,10023999,20.61641741248647,37.51671399173695,0.08211860081464784,1787.8282470703125,660.8080856800079,1602.8821411132812,38840,10525,28315,28315,0,13,10024000.0
10024,10024999,20.615542472144497,37.51551796944262,0.082120069374368,1787.9412705898285,660.8686842918396,1603.4949264526367,38841,10525,28316,28316,0,13,10025000.0
10025,10025999,20.61492033581429,37.51538189952741,0.08211460348472954,1788.043208360672,660.9287896156311,1603.8786163330078,38841,10525,28316,28316,0,13,10026000.0
10026,10026999,20.614133430997406,37.51462120228954,0.08211332224915135,1788.4176588058472,660.990115404129,1603.9994850158691,38847,10528,28319,28319,0,13,10027000.0
10027,10027999,20.613428235156004,37.51335357331309,0.08211314462339214,1788.7914187908173,661.0536322593689,1604.1205940246582,38853,10531,28322,28322,0,13,10028000.0
10028,10028999,20.612679797744832,37.51210229316375,0.08211244873584855,1788.9889388084412,661.115852355957,1604.400333404541,38855,10532,28323,28323,0,13,10029000.0
10029,10029999,20.611976758886225,37.510913516730206,0.08211289066397098,1789.192286491394,661.1782851219177,1604.6092567443848,38857,10533,28324,28324,0,13,10030000.0
10030,10030999,20.61139629858347,37.509862051373275,0.0821108569800405,1789.558497428894,661.2404088973999,1604.6426391601562,38863,10536,28327,28327,0,13,10031000.0
10031,10031999,20.610860776528398,37.51051705693958,0.08210152982451724,1790.0322153568268,661.3032469749451,1604.6325569152832,38871,10540,28331,28331,0,13,10032000.0
10032,10032999,20.610343555283062,37.509491904370826,0.08209881740375902,1790.4454531669617,661.3717155456543,1604.7144813537598,38878,10543,28335,28335,0,13,10033000.0
10033,10033999,20.609968028063978,37.50872684185616,0.08209443401388161,1790.7275803089142,661.4333417415619,1604.772792816162,38882,10545,28337,28337,0,13,10034000.0
10034,10034999,20.609826467622064,37.508357815537835,0.08208613314364455,1790.8594779968262,661.4977848529816,1605.110912322998,38884,10545,28339,28339,0,13,10035000.0
10035,10035999,20.609612004216643,37.50775923409896,0.08207863763346723,1791.0869598388672,661.5646483898163,1605.3262634277344,38888,10546,28342,28342,0,13,10036000.0
10036,10036999,20.609778446667743,37.507784031484924,0.08206910995040784,1791.2833256721497,661.6265716552734,1605.53031539917,38890,10547,28343,28343,0,13,10037000.0
10037,10037999,20.609826164429332,37.50759790802477,0.08206181014298608,1791.5700418949127,661.6885707378387,1605.6300315856934,38894,10549,28345,28345,0,13,10038000.0
10038,10038999,20.609940777040574,37.507228987811764,0.08205394329150839,1791.7945981025696,661.7514796257019,1605.7798957824707,38896,10550,28346,28346,0,13,10039000.0
10039,10039999,20.61032224185389,37.50736900023848,0.08204493684217751,1792.023089647293,661.8134808540344,1605.9216384887695,38898,10551,28347,28347,0,13,10040000.0
10040,10040999,20.610622802948704,37.50710046386065,0.08203871908136728,1792.226666688919,661.8771378993988,1605.965877532959,38900,10552,28348,28348,0,13,10041000.0
10041,10041999,20.610812637685207,37.50675471041352,0.08203253103621588,1792.532308101654,661.9414563179016,1606.0586318969727,38908,10554,28354,28354,0,13,10042000.0
10042,10042999,20.61104950737895,37.506483366202964,0.08202453682976318,1792.662781238556,662.0028328895569,1606.2172775268555,38908,10554,28354,28354,0,13,10043000.0
10043,10043999,20.611151863388116,37.50690637555194,0.08201627047413618,1792.8002243041992,662.0669302940369,1606.3671989440918,38908,10554,28354,28354,0,13,10044000.0
10044,10044999,20.6104746172583,37.50568229536174,0.0820188445512422,1793.0118935108185,662.1312837600708,1607.338565826416,38936,10555,28381,28381,0,13,10045000.0
10045,10045999,20.609995796497962,37.506095737904744,0.08201026101768893,1793.2150592803955,662.1936588287354,1607.7418632507324,38948,10556,28392,28392,0,13,10046000.0
10046,10046999,20.609180103964153,37.50466382964732,0.08201557979211838,1793.3213663101196,662.2553431987762,1608.1017951965332,38949,10556,28393,28393,0,13,10047000.0
10047,10047999,20.608571748362372,37.50360425453238,0.08201642075652882,1793.5226874351501,662.3174126148224,1608.3075523376465,38951,10557,28394,28394,0,13,10048000.0
10048,10048999,20.60808763961446,37.504071236842954,0.08200971324970507,1793.6364455223083,662.3794567584991,1608.556770324707,38951,10557,28394,28394,0,13,10049000.0
10049,10049999,20.60758893550987,37.50328963901414,0.0820077554069436,1794.0126440525055,662.4411556720734,1608.6251945495605,38957,10560,28397,28397,0,13,10050000.0
10050,10050999,20.607095271492238,37.50233987271132,0.08200609613476695,1794.6650381088257,662.5060367584229,1608.6019477844238,38969,10566,28403,28403,0,13,10051000.0
10051,10051999,20.606620513567545,37.50151858238609,0.08200424239890192,1794.7812895774841,662.5673658847809,1608.9003639221191,38970,10566,28404,28404,0,13,10052000.0
10052,10052999,20.60604775154362,37.50034719096705,0.08200488268619299,1795.2548143863678,662.6316049098969,1608.91898727417,38978,10570,28408,28408,0,13,10053000.0
10053,10053999,20.605741699281623,37.49983723349328,0.0820006016340058,1795.4605417251587,662.6955358982086,1609.171215057373,38982,10571,28411,28411,0,13,10054000.0
10054,10054999,20.605295998422825,37.49889407127313,0.0819996756887642,1795.7575554847717,662.7585768699646,1609.3128547668457,38987,10573,28414,28414,0,13,10055000.0
10055,10055999,20.604936774992535,37.49810682237086,0.08199940242772386,1796.1359951496124,662.820662021637,1609.4844512939453,38994,10576,28418,28418,0,13,10056000.0
10056,10056999,20.604548193640216,37.4970179786092,0.082000991355891,1796.41889834404,662.882993221283,1609.649715423584,38998,10578,28420,28420,0,13,10057000.0
10057,10057999,20.604187143970435,37.49593161810866,0.08200402559195219,1796.6289632320404,662.9455091953278,1609.8195610046387,39000,10579,28421,28421,0,13,10058000.0
10058,10058999,20.60393688245851,37.49500736718403,0.08200646960139646,1797.0958771705627,663.0094413757324,1609.8681297302246,39008,10583,28425,28425,0,13,10059000.0
10059,10059999,20.60359056799726,37.493938662227244,0.08200952019859886,1797.297946214676,663.071084022522,1610.0677185058594,39010,10584,28426,28426,0,13,10060000.0
10060,10060999,20.603168257876835,37.49277851195228,0.08201386862816495,1797.431265592575,663.1344339847565,1610.7705917358398,39026,10584,28442,28442,0,13,10061000.0
10061,10061999,20.602410100099426,37.49225935254561,0.08202221404726207,1797.6229403018951,663.1951324939728,1611.427635192871,39039,10585,28454,28454,0,13,10062000.0
10062,10062999,20.601678326308264,37.49104013891417,0.0820356457824083,1797.734094619751,663.2559270858765,1611.8842163085938,39040,10585,28455,28455,0,13,10063000.0
10063,10063999,20.600881271630257,37.48977445334468,0.08204804580223835,1798.0250127315521,663.3186345100403,1612.1219673156738,39051,10587,28464,28464,0,13,10064000.0
10064,10064999,20.59998488176438,37.488377983372445,0.08206280234758112,1798.3062114715576,663.3811345100403,1612.4174537658691,39055,10589,28466,28466,0,13,10065000.0
10065,10065999,20.599194999452912,37.487113484829635,0.08207313835655083,1798.4139745235443,663.4431858062744,1612.6721115112305,39055,10589,28466,28466,0,13,10066000.0
10066,10066999,20.598369500077567,37.48580451376417,0.0820836573045236,1798.8005883693695,663.5065541267395,1612.7993621826172,39061,10592,28469,28469,0,13,10067000.0
10067,10067999,20.597640050964714,37.484830584027804,0.0820896430287118,1799.091638326645,663.5693306922913,1612.9879150390625,39066,10594,28472,28472,0,13,10068000.0
10068,10068999,20.596879786447023,37.483745235796135,0.08209800389885746,1799.5618228912354,663.6341834068298,1613.0033683776855,39075,10598,28477,28477,0,13,10069000.0
10069,10069999,20.5960897470039,37.48254489702131,0.08210880898510808,1799.9436509609222,663.6980061531067,1613.1736679077148,39082,10601,28481,28481,0,13,10070000.0
10070,10070999,20.595401043873174,37.48138062306254,0.08211905353334037,1800.1518626213074,663.7630026340485,1613.5375900268555,39086,10602,28484,28484,0,13,10071000.0
10071,10071999,20.594713521156187,37.48020495873935,0.08213012577013146,1800.445894241333,663.8256502151489,1613.6902198791504,39090,10604,28486,28486,0,13,10072000.0
10072,10072999,20.59408301356361,37.47914362584364,0.08213979746160616,1800.6459398269653,663.8891019821167,1613.9228782653809,39092,10605,28487,28487,0,13,10073000.0
10073,10073999,20.5934249280885,37.477923514214694,0.08214794880094434,1801.1321840286255,663.9551780223846,1613.9274215698242,39102,10609,28493,28493,0,13,10074000.0
10074,10074999,20.59277943140834,37.476827838965704,0.08215628423836363,1801.2608239650726,664.0180313587189,1614.232852935791,39102,10609,28493,28493,0,13,10075000.0
10075,10075999,20.592117204243507,37.47563085889951,0.08216570509653764,1801.4867990016937,664.0819199085236,1614.402000427246,39104,10610,28494,28494,0,13,10076000.0
10076,10076999,20.591433857253698,37.47482043266681,0.08217026858802046,1801.6126866340637,664.1450970172882,1614.632740020752,39104,10610,28494,28494,0,13,10077000.0
10077,10077999,20.59077733181678,37.47399933064278,0.08217383016217228,1801.7311794757843,664.2095394134521,1615.666561126709,39126,10610,28516,28516,0,13,10078000.0
10078,10078999,20.590032851730417,37.47297713461966,0.08218067294378206,1801.846519947052,664.2728941440582,1616.2162246704102,39131,10610,28521,28521,0,13,10079000.0
10079,10079999,20.589146582344693,37.471510477007655,0.0821931171689082,1801.95965218544,664.3349409103394,1616.5710372924805,39132,10610,28522,28522,0,13,10080000.0
10080,10080999,20.588483803229522,37.470491588747855,0.08219928565789447,1802.516348361969,664.3993308544159,1616.676067352295,39142,10615,28527,28527,0,13,10081000.0
10081,10081999,20.587692572666533,37.46932307638826,0.08220776556097587,1802.6242961883545,664.4605338573456,1617.0003967285156,39142,10615,28527,28527,0,13,10082000.0
10082,10082999,20.587024609886544,37.46835938917703,0.0822118940824843,1802.9149012565613,664.5236005783081,1617.18892288208,39149,10617,28532,28532,0,13,10083000.0
10083,10083999,20.58629674806538,37.46753796496576,0.08221441574778399,1803.4611296653748,664.5867297649384,1617.1242561340332,39159,10622,28537,28537,0,13,10084000.0
10084,10084999,20.58568436477823,37.46673192535595,0.08221476452225818,1803.6699483394623,664.6500773429871,1617.3688735961914,39162,10623,28539,28539,0,13,10085000.0
10085,10085999,20.585068007868077,37.465856907937635,0.08221604920937353,1804.070344209671,664.7175736427307,1617.4822158813477,39168,10626,28542,28542,0,13,10086000.0
10086,10086999,20.584445713920413,37.46477771481183,0.08221851299149519,1804.3763959407806,664.7837874889374,1617.6760864257812,39174,10628,28546,28546,0,13,10087000.0
10087,10087999,20.584028160700665,37.46414814314339,0.08221831355377407,1804.6672558784485,664.8472301959991,1617.8199501037598,39178,10630,28548,28548,0,13,10088000.0
10088,10088999,20.58353064925332,37.46371152473978,0.08221572539912436,1804.864703655243,664.9103157520294,1618.0757637023926,39182,10631,28551,28551,0,13,10089000.0
10089,10089999,20.582950704045565,37.4625105533431,0.08221956182937029,1805.0945205688477,664.9746603965759,1618.2163848876953,39186,10632,28554,28554,0,13,10090000.0
10090,10090999,20.582457850162594,37.46159136876815,0.08221849950233351,1805.3918051719666,665.0407195091248,1618.345344543457,39190,10634,28556,28556,0,13,10091000.0
10091,10091999,20.582024609978625,37.4608659170364,0.08221621638407439,1805.620048046112,665.105019569397,1618.4903869628906,39192,10635,28557,28557,0,13,10092000.0
10092,10092999,20.581488243181987,37.459930746378745,0.08221694210582375,1805.8365013599396,665.1706907749176,1618.6701927185059,39194,10636,28558,28558,0,13,10093000.0
10093,10093999,20.581063263682186,37.45976980898331,0.08221048752416582,1806.123084306717,665.2347550392151,1618.7012100219727,39198,10638,28560,28560,0,13,10094000.0
10094,10094999,20.580434823228412,37.45855836447009,0.08221023214926582,1806.2567439079285,665.2969739437103,1618.8784980773926,39198,10638,28560,28560,0,13,10095000.0
10095,10095999,20.579871199562675,37.45775872226554,0.08220741588304059,1806.4653940200806,665.3595974445343,1618.9961738586426,39200,10639,28561,28561,0,13,10096000.0
10096,10096999,20.579248847192126,37.45725571225452,0.08220984691451871,1806.5850417613983,665.4233999252319,1619.8419494628906,39215,10639,28576,28576,0,13,10097000.0
10097,10097999,20.578357489406038,37.455918689136695,0.08221310798525516,1806.6912262439728,665.4850132465363,1620.334300994873,39220,10639,28581,28581,0,13,10098000.0
10098,10098999,20.577553608892714,37.45481315537572,0.08221506013961521,1806.8920953273773,665.5503060817719,1620.6997871398926,39223,10640,28583,28583,0,13,10099000.0
10099,10099999,20.57676329581111,37.45377614967736,0.08221786908334039,1807.1047902107239,665.6137642860413,1620.8907356262207,39225,10641,28584,28584,0,13,10100000.0
10100,10100999,20.576299485474866,37.453604956726025,0.08221204499618484,1807.3066697120667,665.6747257709503,1621.0621032714844,39227,10642,28585,28585,0,13,10101000.0
10101,10101999,20.57576200439561,37.45355273536788,0.08221347229969067,1807.6004593372345,665.7371525764465,1621.1722297668457,39237,10644,28593,28593,0,13,10102000.0
10102,10102999,20.57549332287574,37.454443463274984,0.08220622552247248,1807.8258845806122,665.8013293743134,1621.294849395752,39239,10645,28594,28594,0,13,10103000.0
10103,10103999,20.575725492904557,37.4569775580469,0.08220380023043894,1808.3090007305145,665.8633706569672,1621.2190284729004,39247,10649,28598,28598,0,13,10104000.0
10104,10104999,20.576037195444567,37.45890375760372,0.08221277637995617,1808.6866037845612,665.9278931617737,1621.3422050476074,39254,10652,28602,28602,0,13,10105000.0
10105,10105999,20.576217830880545,37.46020597568295,0.08223664428756661,1808.8987019062042,665.9901039600372,1621.6100387573242,39256,10653,28603,28603,0,13,10106000.0
10106,10106999,20.57706163156547,37.46397470055227,0.08223394243613924,1809.1121289730072,666.0526146888733,1621.8226013183594,39260,10654,28606,28606,0,13,10107000.0
10107,10107999,20.57793102644313,37.46717941341532,0.08223616357155694,1809.499088048935,666.1158466339111,1621.773941040039,39266,10657,28609,28609,0,13,10108000.0
10108,10108999,20.579016169722294,37.47052205478251,0.08224921517159689,1809.701000213623,666.1786415576935,1622.1249961853027,39270,10658,28612,28612,0,13,10109000.0
10109,10109999,20.580308415586266,37.47441976866734,0.08225432784182785,1809.9129812717438,666.2412757873535,1622.3355445861816,39272,10659,28613,28613,0,13,10110000.0
10110,10110999,20.581953577920306,37.47990330040456,0.0822513446066443,1810.1211810112,666.3037858009338,1622.5446319580078,39275,10660,28615,28615,0,13,10111000.0
10111,10111999,20.583785588061936,37.48545605097718,0.08227168199088675,1810.6937007904053,666.3670427799225,1622.4004745483398,39287,10665,28622,28622,0,13,10112000.0
10112,10112999,20.585367452585974,37.48862762651959,0.08229131127188904,1810.9851870536804,666.4306297302246,1622.6918601989746,39291,10667,28624,28624,0,13,10113000.0
10113,10113999,20.586788380235188,37.49118205060952,0.08231794421751559,1811.1984252929688,666.4927756786346,1622.8651237487793,39293,10668,28625,28625,0,13,10114000.0
10114,10114999,20.588002761443374,37.49302543791627,0.08232454241575726,1811.3222620487213,666.5555245876312,1623.075180053711,39293,10668,28625,28625,0,13,10115000.0
10115,10115999,20.588797425388268,37.49427359546664,0.08232749093907943,1811.4505314826965,666.6177494525909,1623.28071975708,39293,10668,28625,28625,0,13,10116000.0
10116,10116999,20.58826195756285,37.493633505381325,0.08232657729046744,1811.561648607254,666.6804029941559,1624.3130073547363,39312,10668,28644,28644,0,13,10117000.0
10117,10117999,20.587666987178157,37.493274753521405,0.08232618280883319,1811.8471455574036,666.7423133850098,1624.586082458496,39316,10670,28646,28646,0,13,10118000.0
10118,10118999,20.586895264979077,37.492014348404716,0.08232956524133539,1811.970493555069,666.8045601844788,1624.9073905944824,39316,10670,28646,28646,0,13,10119000.0
10119,10119999,20.586257057449014,37.490902194516096,0.08233082605628361,1812.3486478328705,666.8653788566589,1624.9929885864258,39322,10673,28649,28649,0,13,10120000.0
10120,10120999,20.585616436436354,37.490034142893435,0.08233172470241701,1812.4548778533936,666.9278967380524,1625.2736930847168,39322,10673,28649,28649,0,13,10121000.0
10121,10121999,20.584846046287833,37.48863142581001,0.08233566366125655,1812.8341698646545,666.9908888339996,1625.3252563476562,39328,10676,28652,28652,0,13,10122000.0
10122,10122999,20.584122520024998,37.48734609120358,0.08233878059749711,1813.4815678596497,667.0541021823883,1625.2531776428223,39340,10682,28658,28658,0,13,10123000.0
10123,10123999,20.583612428485786,37.48638517102738,0.08233632497863619,1813.7814474105835,667.1174018383026,1625.513298034668,39344,10684,28660,28660,0,13,10124000.0
10124,10124999,20.582988289463625,37.48520505941113,0.0823375756587087,1813.9987988471985,667.1790969371796,1625.7479209899902,39347,10685,28662,28662,0,13,10125000.0
10125,10125999,20.58245553220634,37.48415716159882,0.08233672711204076,1814.1093628406525,667.2432119846344,1625.9369850158691,39347,10685,28662,28662,0,13,10126000.0
10126,10126999,20.581830382068336,37.483021750841154,0.08233711746120853,1814.4961063861847,667.306314945221,1626.1273193359375,39357,10688,28669,28669,0,13,10127000.0
10127,10127999,20.581225229322868,37.481909548051014,0.08233724915463869,1814.632247686386,667.3695909976959,1626.3962783813477,39358,10688,28670,28670,0,13,10128000.0
10128,10128999,20.580871026980457,37.48139212705218,0.08233167498920324,1814.74418258667,667.4306163787842,1626.713722229004,39359,10688,28671,28671,0,13,10129000.0
10129,10129999,20.580376464514867,37.480264135037174,0.08233155158297578,1814.8620285987854,667.4924931526184,1626.960838317871,39359,10688,28671,28671,0,13,10130000.0
10130,10130999,20.580047233722265,37.479428211228424,0.0823300471288344,1815.0673983097076,667.5552568435669,1627.0701217651367,39361,10689,28672,28672,0,13,10131000.0
10131,10131999,20.579687589424555,37.47863320038789,0.08232612114224103,1815.5470461845398,667.6189427375793,1627.07080078125,39369,10693,28676,28676,0,13,10132000.0
10132,10132999,20.5793333173739,37.477640583414065,0.08232663119298889,1815.7676494121552,667.6820492744446,1627.1971588134766,39371,10694,28677,28677,0,13,10133000.0
10133,10133999,20.5789523523631,37.476704530816455,0.08232682131479752,1815.9854159355164,667.7481055259705,1627.3016395568848,39373,10695,28678,28678,0,13,10134000.0
10134,10134999,20.57861736620033,37.4758239431542,0.08232438958800237,1816.1107215881348,667.8092985153198,1627.4929161071777,39373,10695,28678,28678,0,13,10135000.0
10135,10135999,20.578042222460574,37.47468970805202,0.08232492406831748,1816.4224553108215,667.8719279766083,1627.5915031433105,39377,10697,28680,28680,0,13,10136000.0
10136,10136999,20.577170916151804,37.47328223492816,0.08233407912274504,1816.5343925952911,667.9326899051666,1628.62251663208,39394,10697,28697,28697,0,13,10137000.0
10137,10137999,20.576189901899465,37.47194467765902,0.08234134495428624,1816.639545917511,667.9917902946472,1629.0998878479004,39396,10697,28699,28699,0,13,10138000.0
10138,10138999,20.57529283742768,37.47061109091485,0.08234616439292874,1816.9237658977509,668.0530865192413,1629.305263519287,39400,10699,28701,28701,0,13,10139000.0
10139,10139999,20.57437551763841,37.469465502848884,0.08235119276569336,1817.379072189331,668.115736246109,1629.4420890808105,39408,10703,28705,28705,0,13,10140000.0
10140,10140999,20.573551384443686,37.468123674052904,0.08235533378477944,1817.4960660934448,668.1765668392181,1629.7689666748047,39408,10703,28705,28705,0,13,10141000.0
10141,10141999,20.572750688318262,37.466921835527394,0.08236021905958513,1817.6193957328796,668.2390244007111,1629.9930458068848,39408,10703,28705,28705,0,13,10142000.0
10142,10142999,20.572043410338132,37.46572671560138,0.08236331874203884,1817.9939241409302,668.3003041744232,1629.9815101623535,39417,10706,28711,28711,0,13,10143000.0
10143,10143999,20.57116342325838,37.464305447816926,0.08236846870950887,1818.3740983009338,668.3620226383209,1630.0540351867676,39423,10709,28714,28714,0,13,10144000.0
10144,10144999,20.570500217868652,37.463366626733674,0.08236945908646631,1818.8563468456268,668.4250893592834,1630.0640678405762,39432,10713,28719,28719,0,13,10145000.0
10145,10145999,20.56988031866633,37.46235595322002,0.08237043837862679,1819.148990869522,668.4879107475281,1630.1826057434082,39436,10715,28721,28721,0,13,10146000.0
10146,10146999,20.569260011518818,37.4613104712743,0.08237085605164873,1819.2667689323425,668.5493242740631,1630.4961051940918,39438,10715,28723,28723,0,13,10147000.0
10147,10147999,20.568781327258222,37.460533446983995,0.08236980080684508,1819.5696132183075,668.6123154163361,1630.5386276245117,39442,10717,28725,28725,0,13,10148000.0
10148,10148999,20.568180865268346,37.45947549477836,0.08237072575487414,1819.8012239933014,668.6859667301178,1630.7719688415527,39446,10718,28728,28728,0,13,10149000.0
10149,10149999,20.567584455476744,37.45836861108115,0.08237176059629392,1819.9283385276794,668.7473034858704,1631.0432357788086,39446,10718,28728,28728,0,13,10150000.0
10150,10150999,20.56713785826529,37.457638562308404,0.08237174647359213,1820.2392070293427,668.8101871013641,1631.0947952270508,39451,10720,28731,28731,0,13,10151000.0
10151,10151999,20.56665364625128,37.45670259716543,0.08237296687359075,1820.541586637497,668.8730912208557,1631.1947746276855,39455,10722,28733,28733,0,13,10152000.0
10152,10152999,20.566228595046965,37.45572882061496,0.08237049106664529,1820.752634048462,668.9356734752655,1631.4092559814453,39457,10723,28734,28734,0,13,10153000.0
10153,10153999,20.56591321566039,37.45501235239288,0.08236748330471133,1820.8747749328613,668.9987206459045,1631.5817985534668,39457,10723,28734,28734,0,13,10154000.0
10154,10154999,20.565423804363515,37.45393670772102,0.08236795578286438,1821.0026104450226,669.0639998912811,1631.7043991088867,39457,10723,28734,28734,0,13,10155000.0
10155,10155999,20.564818165821823,37.45273358895717,0.08236912893264514,1821.408231973648,669.1258406639099,1631.6325988769531,39470,10726,28744,28744,0,13,10156000.0
10156,10156999,20.56430310122288,37.451675865981414,0.08237115200284195,1821.523167848587,669.1875863075256,1632.6128616333008,39490,10726,28764,28764,0,13,10157000.0
10157,10157999,20.56351141553234,37.45035678394934,0.08237517212620238,1821.6289567947388,669.2484447956085,1633.152172088623,39492,10726,28766,28766,0,13,10158000.0
10158,10158999,20.562813464841668,37.44909629373823,0.08237870011511905,1821.7331130504608,669.3090772628784,1633.5213508605957,39492,10726,28766,28766,0,13,10159000.0
10159,10159999,20.562361621649224,37.44802202587119,0.08238020085913123,1822.194444656372,669.3706209659576,1633.5806922912598,39500,10730,28770,28770,0,13,10160000.0
10160,10160999,20.56174925184947,37.44681841432858,0.08238355144165743,1822.5920062065125,669.433340549469,1633.8167572021484,39507,10733,28774,28774,0,13,10161000.0
10161,10161999,20.5613638357669,37.44632913377765,0.08238370323451671,1822.7938063144684,669.4950909614563,1634.0791015625,39509,10734,28775,28775,0,13,10162000.0
10162,10162999,20.561182030251768,37.4460355470563,0.08238472400879537,1822.9038138389587,669.5573260784149,1634.3643226623535,39509,10734,28775,28775,0,13,10163000.0
10163,10163999,20.560893539996236,37.44533996716326,0.08238881794013331,1823.2939991950989,669.6207005977631,1634.3718299865723,39515,10737,28778,28778,0,13,10164000.0
10164,10164999,20.560654136394135,37.44469901975285,0.08239687772952997,1823.6912288665771,669.6844296455383,1634.4269943237305,39521,10740,28781,28781,0,13,10165000.0
10165,10165999,20.560485838878204,37.444287119575414,0.08240182018710318,1823.8984837532043,669.7473638057709,1634.7047309875488,39524,10741,28783,28783,0,13,10166000.0
10166,10166999,20.560553172305145,37.444210933897565,0.08242420052519994,1824.122470855713,669.8136413097382,1634.9127464294434,39528,10742,28786,28786,0,13,10167000.0
10167,10167999,20.560777428882115,37.444442220717136,0.08243500382292612,1824.5064780712128,669.8771300315857,1634.9683303833008,39534,10745,28789,28789,0,13,10168000.0
10168,10168999,20.560878185117517,37.44428026846785,0.08244539565188425,1824.7914884090424,669.9415218830109,1635.2219581604004,39549,10747,28802,28802,0,13,10169000.0
10169,10169999,20.561149685941228,37.4445591474704,0.08244838912070507,1825.006805896759,670.0034193992615,1635.3800430297852,39551,10748,28803,28803,0,13,10170000.0
10170,10170999,20.56148470731697,37.44479021514068,0.0824447040168308,1825.308186531067,670.0669033527374,1635.4419631958008,39555,10750,28805,28805,0,13,10171000.0
10171,10171999,20.56185776287791,37.44493498352243,0.08244337654196154,1825.698865890503,670.1307260990143,1635.4652290344238,39561,10753,28808,28808,0,13,10172000.0
10172,10172999,20.562168858906567,37.44516844820007,0.08245040647945134,1826.273416519165,670.1942391395569,1635.524745941162,39571,10758,28813,28813,0,13,10173000.0
10173,10173999,20.56274686581076,37.44581986855619,0.08245292472839583,1826.4816484451294,670.2585988044739,1635.6450958251953,39574,10759,28815,28815,0,13,10174000.0
10174,10174999,20.563169409228852,37.446020663339624,0.08246338795205299,1826.6002793312073,670.3214738368988,1635.865951538086,39574,10759,28815,28815,0,13,10175000.0
10175,10175999,20.56351911083774,37.44620313180921,0.0824628703774013,1826.7570164203644,670.3882751464844,1636.0597915649414,39574,10759,28815,28815,0,13,10176000.0
10176,10176999,20.563572480118015,37.44568213130028,0.08246257170941429,1826.965002298355,670.4533557891846,1636.6396675109863,39598,10760,28838,28838,0,13,10177000.0
10177,10177999,20.562885933340738,37.444642383480264,0.08246338500520967,1827.17667222023,670.5182666778564,1637.1818618774414,39611,10761,28850,28850,0,13,10178000.0
10178,10178999,20.56231348953949,37.44420987388088,0.08246313692630591,1827.2867708206177,670.579220533371,1637.5471649169922,39611,10761,28850,28850,0,13,10179000.0
10179,10179999,20.561701341031203,37.443191840830096,0.08246364525502714,1827.4901263713837,670.6410157680511,1637.7826843261719,39613,10762,28851,28851,0,13,10180000.0
10180,10180999,20.561165345613905,37.4420492985851,0.08246503445853992,1827.6939630508423,670.7029666900635,1637.9667854309082,39615,10763,28852,28852,0,13,10181000.0
10181,10181999,20.560649769092173,37.44127463523054,0.08246588190670712,1827.9035820960999,670.7652237415314,1638.115608215332,39617,10764,28853,28853,0,13,10182000.0
10182,10182999,20.560263033929235,37.44072341084358,0.08246353017511254,1828.2925772666931,670.8273084163666,1638.1933212280273,39623,10767,28856,28856,0,13,10183000.0
10183,10183999,20.560040742495257,37.440502754103065,0.08245650606598409,1828.8491008281708,670.8900365829468,1638.1857528686523,39633,10772,28861,28861,0,13,10184000.0
10184,10184999,20.560458741056312,37.44200160589728,0.08243692785696777,1829.1615707874298,670.9556574821472,1638.395492553711,39638,10774,28864,28864,0,13,10185000.0
10185,10185999,20.560993074521807,37.44334362955971,0.08242380261146443,1829.5481734275818,671.0191617012024,1638.478214263916,39645,10777,28868,28868,0,13,10186000.0
10186,10186999,20.56183202103572,37.44494939652907,0.08240816709378973,1829.7601885795593,671.0821228027344,1638.7024230957031,39648,10778,28870,28870,0,13,10187000.0
10187,10187999,20.562792840401524,37.44704653754174,0.08239772697115533,1829.879118680954,671.1435976028442,1639.0249557495117,39650,10778,28872,28872,0,13,10188000.0
10188,10188999,20.563920596451023,37.44940549702782,0.08239490595443355,1830.0947244167328,671.2056248188019,1639.2290306091309,39652,10779,28873,28873,0,13,10189000.0
10189,10189999,20.565023282548285,37.45133993345955,0.08239288431598213,1830.2986912727356,671.2682273387909,1639.3486824035645,39654,10780,28874,28874,0,13,10190000.0
10190,10190999,20.566403935458087,37.45400785105103,0.08238530513367681,1830.688283920288,671.331770658493,1639.283058166504,39660,10783,28877,28877,0,13,10191000.0
10191,10191999,20.567543551674383,37.45568898010966,0.08238348825756747,1831.0894222259521,671.3944435119629,1639.348861694336,39666,10786,28880,28880,0,13,10192000.0
10192,10192999,20.568479044311477,37.45715349307212,0.082376482515363,1831.2219874858856,671.4584772586823,1639.572566986084,39666,10786,28880,28880,0,13,10193000.0
10193,10193999,20.568795254689217,37.45778623454946,0.08236945496219406,1831.5128779411316,671.5206344127655,1640.2620239257812,39687,10788,28899,28899,0,13,10194000.0
10194,10194999,20.568429030259658,37.456782109646745,0.08236697248140301,1831.6238095760345,671.5805292129517,1640.7769050598145,39688,10788,28900,28900,0,13,10195000.0
10195,10195999,20.56803987747729,37.45571368513557,0.08236393971792921,1831.8226199150085,671.6407489776611,1641.0503768920898,39691,10789,28902,28902,0,13,10196000.0
10196,10196999,20.567716538516784,37.455492597545096,0.08235755581833615,1832.2245514392853,671.704371213913,1641.1655349731445,39700,10792,28908,28908,0,13,10197000.0
10197,10197999,20.56732996261833,37.454527057465576,0.08235445491030291,1832.422124862671,671.7678105831146,1641.3852272033691,39703,10793,28910,28910,0,13,10198000.0
10198,10198999,20.566917521988177,37.45352645759726,0.08235229701460389,1832.629787683487,671.8284590244293,1641.5705528259277,39705,10794,28911,28911,0,13,10199000.0
10199,10199999,20.566379439005157,37.45245830827502,0.08235113973275132,1832.8455228805542,671.8903479576111,1641.6685981750488,39708,10795,28913,28913,0,13,10200000.0
10200,10200999,20.56600855374017,37.451861908865055,0.08234555834692536,1832.9770102500916,671.9511141777039,1641.8233680725098,39708,10795,28913,28913,0,13,10201000.0
10201,10201999,20.565564397632706,37.45096864047314,0.08234170507415106,1833.1897659301758,672.0112431049347,1641.9338264465332,39711,10796,28915,28915,0,13,10202000.0
10202,10202999,20.5653126132832,37.450684542172176,0.08233593777215198,1833.4039561748505,672.0727250576019,1641.994873046875,39713,10797,28916,28916,0,13,10203000.0
10203,10203999,20.56498394134811,37.449741662958075,0.08233045299308162,1833.6126441955566,672.133956193924,1642.1366119384766,39715,10798,28917,28917,0,13,10204000.0
10204,10204999,20.564854244526707,37.44948542157836,0.08232488844212127,1833.8344781398773,672.1942803859711,1642.2575378417969,39717,10799,28918,28918,0,13,10205000.0
10205,10205999,20.56472710552229,37.44922974718249,0.08231430810376594,1833.9559395313263,672.2545804977417,1642.422592163086,39718,10799,28919,28919,0,13,10206000.0
10206,10206999,20.564751258148338,37.449145440741376,0.08230394758230364,1834.2640852928162,672.3169631958008,1642.3914527893066,39724,10801,28923,28923,0,13,10207000.0
10207,10207999,20.565125067353108,37.44966563779925,0.08229376727817683,1834.479845046997,672.377599477768,1642.4786987304688,39727,10802,28925,28925,0,13,10208000.0
10208,10208999,20.56532610950288,37.45072919140932,0.08228403045111254,1834.60271859169,672.4394173622131,1642.6181602478027,39727,10802,28925,28925,0,13,10209000.0
10209,10209999,20.565448786793905,37.45067769969855,0.08227915523919249,1834.7422888278961,672.5008111000061,1642.729419708252,39727,10802,28925,28925,0,13,10210000.0
10210,10210999,20.56541255179071,37.45027900729699,0.08227265574518605,1834.975388288498,672.5651891231537,1642.7907829284668,39729,10803,28926,28926,0,13,10211000.0
10211,10211999,20.56538902020334,37.44983568547292,0.0822663669654603,1835.1912343502045,672.6271607875824,1642.8313522338867,39731,10804,28927,28927,0,13,10212000.0
10212,10212999,20.56512330883655,37.44893081367211,0.08226318592077153,1835.4101603031158,672.6888132095337,1642.949893951416,39735,10805,28930,28930,0,13,10213000.0
10213,10213999,20.564520036508863,37.448103865229825,0.08226338970256386,1835.5235641002655,672.7502043247223,1644.1185493469238,39750,10805,28945,28945,0,13,10214000.0
10214,10214999,20.56374654365207,37.44708307877424,0.08226629127906726,1835.6320087909698,672.8106784820557,1644.571231842041,39751,10805,28946,28946,0,13,10215000.0
10215,10215999,20.563056262800007,37.44583054017908,0.08226860627589494,1835.843269109726,672.8728837966919,1644.8419609069824,39753,10806,28947,28947,0,13,10216000.0
10216,10216999,20.562371825278728,37.44486061509535,0.08226966476831088,1835.9710125923157,672.9357271194458,1645.0851554870605,39753,10806,28947,28947,0,13,10217000.0
10217,10217999,20.561773118552562,37.44368858070379,0.08227068026431805,1836.2644143104553,672.9993984699249,1645.1626472473145,39759,10808,28951,28951,0,13,10218000.0
10218,10218999,20.561033490765602,37.44233950230315,0.08227479176629782,1836.4770591259003,673.0633645057678,1645.2645950317383,39761,10809,28952,28952,0,13,10219000.0
10219,10219999,20.56040684770803,37.441328736145,0.08227883520423218,1836.8612806797028,673.124894618988,1645.2868270874023,39767,10812,28955,28955,0,13,10220000.0
10220,10220999,20.55981258176084,37.4403533716931,0.08228058803431981,1837.1691725254059,673.1862301826477,1645.411766052246,39771,10814,28957,28957,0,13,10221000.0
10221,10221999,20.559137459759597,37.43916961418642,0.08228248623954026,1837.3770310878754,673.2484006881714,1645.5383377075195,39775,10815,28960,28960,0,13,10222000.0
10222,10222999,20.55854534216504,37.4381135400671,0.08228437609274952,1837.5929362773895,673.3104605674744,1645.66646194458,39777,10816,28961,28961,0,13,10223000.0
10223,10223999,20.558164965128267,37.43865576302053,0.08227732524157716,1837.7313346862793,673.370777130127,1645.835536956787,39777,10816,28961,28961,0,13,10224000.0
10224,10224999,20.557600983225445,37.43757831857641,0.0822808287360639,1837.8539674282074,673.43443608284,1645.9530143737793,39777,10816,28961,28961,0,13,10225000.0
10225,10225999,20.557071750114613,37.43654834634875,0.08228039279785282,1837.9708025455475,673.4935369491577,1646.123519897461,39778,10816,28962,28962,0,13,10226000.0
10226,10226999,20.5565989542638,37.43575528400364,0.08227884109706529,1838.177776813507,673.5548255443573,1646.1916427612305,39780,10817,28963,28963,0,13,10227000.0
10227,10227999,20.556193193128085,37.4362664928949,0.08227425140023914,1838.410863161087,673.6177198886871,1646.2580070495605,39782,10818,28964,28964,0,13,10228000.0
10228,10228999,20.555682940583743,37.435209650853714,0.08227490369275792,1838.543948173523,673.6813583374023,1646.3842277526855,39782,10818,28964,28964,0,13,10229000.0
10229,10229999,20.555224285912736,37.43435592982161,0.08227477890856538,1838.763146162033,673.7421669960022,1646.3688697814941,39786,10819,28967,28967,0,13,10230000.0
10230,10230999,20.55474134457286,37.43329570214849,0.08227643552018671,1838.973528623581,673.8065495491028,1646.4510459899902,39789,10820,28969,28969,0,13,10231000.0
10231,10231999,20.554207702683875,37.43225666052232,0.0822768800226441,1839.1149649620056,673.8689966201782,1646.5482215881348,39789,10820,28969,28969,0,13,10232000.0
10232,10232999,20.553687934536196,37.431264557810934,0.08227634080777779,1839.261126279831,673.9322497844696,1646.6656379699707,39789,10820,28969,28969,0,13,10233000.0
10233,10233999,20.553286959012883,37.43067112925826,0.08227036488959139,1839.3802464008331,673.9938304424286,1647.7821960449219,39807,10820,28987,28987,0,13,10234000.0
10234,10234999,20.55287169149315,37.42977698064233,0.08226151994077535,1839.487316608429,674.0558731555939,1648.3307418823242,39807,10820,28987,28987,0,13,10235000.0
10235,10235999,20.552319967741873,37.429135976759994,0.08225748754943374,1839.6796922683716,674.1160752773285,1648.699562072754,39809,10821,28988,28988,0,13,10236000.0
10236,10236999,20.55190439919922,37.428085342784726,0.08225283250354287,1839.7914290428162,674.1761977672577,1649.0367393493652,39810,10821,28989,28989,0,13,10237000.0
10237,10237999,20.551577153823523,37.427274358779044,0.08224690000487866,1840.0784122943878,674.2376310825348,1649.1860466003418,39814,10823,28991,28991,0,13,10238000.0
10238,10238999,20.551296258886797,37.426558086964775,0.08224204141048808,1840.2838373184204,674.298214673996,1649.3515663146973,39816,10824,28992,28992,0,13,10239000.0
10239,10239999,20.55114545217859,37.42593013156424,0.08223851936855364,1840.5723016262054,674.3594670295715,1649.4392013549805,39820,10826,28994,28994,0,13,10240000.0
10240,10240999,20.551084751742792,37.42583998409755,0.08223393273559632,1840.7044892311096,674.424929857254,1649.7295875549316,39820,10826,28994,28994,0,13,10241000.0
10241,10241999,20.551147608905907,37.425878298433716,0.08223283649587998,1841.0864379405975,674.4870822429657,1649.6603660583496,39827,10829,28998,28998,0,13,10242000.0
10242,10242999,20.55142526208682,37.42620629930254,0.08223453705763717,1841.3799438476562,674.5487205982208,1649.8149795532227,39831,10831,29000,29000,0,13,10243000.0
10243,10243999,20.551924838936458,37.426669021181745,0.0822389799387434,1841.6134793758392,674.6118416786194,1649.9276657104492,39833,10832,29001,29001,0,13,10244000.0
10244,10244999,20.552509541359736,37.427286093920095,0.08225068192121177,1841.8248670101166,674.6745498180389,1650.0296173095703,39835,10833,29002,29002,0,13,10245000.0
10245,10245999,20.552773447742208,37.427272976294994,0.0822563639977133,1841.949381828308,674.7365608215332,1650.2428169250488,39836,10833,29003,29003,0,13,10246000.0
10246,10246999,20.55317476654392,37.42751709455872,0.08225987365995802,1842.236650943756,674.7976624965668,1650.3091430664062,39841,10835,29006,29006,0,13,10247000.0
10247,10247999,20.55374225388002,37.428073759651404,0.08227069106958562,1842.441967010498,674.8587102890015,1650.3953094482422,39843,10836,29007,29007,0,13,10248000.0
10248,10248999,20.55431312559991,37.42849172919988,0.0822835170735553,1842.5648791790009,674.9203155040741,1650.5529136657715,39843,10836,29007,29007,0,13,10249000.0
10249,10249999,20.554936133412383,37.42904955280569,0.08228975554490248,1842.798342704773,674.9817414283752,1650.62601852417,39846,10837,29009,29009,0,13,10250000.0
10250,10250999,20.555580921249867,37.42981834788556,0.08230748826677914,1842.9281251430511,675.0411784648895,1650.7943420410156,39846,10837,29009,29009,0,13,10251000.0
10251,10251999,20.55615264431603,37.43027607974836,0.08230741753250259,1843.048935174942,675.1031918525696,1650.929069519043,39846,10837,29009,29009,0,13,10252000.0
10252,10252999,20.556596867330143,37.43130455482036,0.08230350072242776,1843.1739580631256,675.1640720367432,1651.0812492370605,39846,10837,29009,29009,0,13,10253000.0
10253,10253999,20.556586627897794,37.43105106387249,0.08227926784909023,1843.4795019626617,675.2259113788605,1652.012035369873,39867,10839,29028,29028,0,13,10254000.0
10254,10254999,20.556254798410336,37.43038988675988,0.08227159619634461,1843.5842020511627,675.2870624065399,1652.552001953125,39868,10839,29029,29029,0,13,10255000.0
10255,10255999,20.555879454253137,37.42940231741213,0.08226754221000376,1843.7863845825195,675.347983121872,1652.885654449463,39870,10840,29030,29030,0,13,10256000.0
10256,10256999,20.55561828818045,37.428852588012774,0.08226486723658333,1843.9805834293365,675.4093172550201,1653.0810623168945,39872,10841,29031,29031,0,13,10257000.0
10257,10257999,20.555450926910414,37.42901271539801,0.08225632333910271,1844.1880826950073,675.4708366394043,1653.3830070495605,39874,10842,29032,29032,0,13,10258000.0
10258,10258999,20.555035999680943,37.42790801579471,0.08225613353737637,1844.4110407829285,675.5342471599579,1653.544578552246,39876,10843,29033,29033,0,13,10259000.0
10259,10259999,20.554749555024518,37.42713661449061,0.08225436616113291,1844.5365767478943,675.5959763526917,1653.7486763000488,39876,10843,29033,29033,0,13,10260000.0
10260,10260999,20.55459715121426,37.42650123820563,0.0822531270953557,1844.939343214035,675.6582481861115,1653.7182655334473,39883,10846,29037,29037,0,13,10261000.0
10261,10261999,20.554432609537045,37.42588052275481,0.08225496642893859,1845.0571286678314,675.719703912735,1653.9564399719238,39883,10846,29037,29037,0,13,10262000.0
10262,10262999,20.554558633060154,37.42557625795167,0.08225575511568894,1845.2695100307465,675.7812936306,1654.0128059387207,39895,10847,29048,29048,0,13,10263000.0
10263,10263999,20.55502007709494,37.42605805630593,0.08226362855052971,1845.4937715530396,675.8439936637878,1654.137062072754,39897,10848,29049,29049,0,13,10264000.0
10264,10264999,20.556109733254424,37.42843240898269,0.08227440496883176,1845.7248215675354,675.9103081226349,1654.1772994995117,39899,10849,29050,29050,0,13,10265000.0
10265,10265999,20.557245364347175,37.430780662874945,0.08228280597657367,1846.0332453250885,675.9737000465393,1654.211856842041,39903,10851,29052,29052,0,13,10266000.0
10266,10266999,20.55861045928919,37.433571752971545,0.08229211540611048,1846.236037015915,676.0360293388367,1654.3116569519043,39905,10852,29053,29053,0,13,10267000.0
10267,10267999,20.560439990593892,37.43711042391356,0.08231799762574188,1846.4561557769775,676.1014015674591,1654.429801940918,39907,10853,29054,29054,0,13,10268000.0
10268,10268999,20.562550345333968,37.44220914502033,0.08233850830605338,1846.679737329483,676.1634833812714,1654.5103340148926,39909,10854,29055,29055,0,13,10269000.0
10269,10269999,20.564674953094706,37.446772837028895,0.08235745269375117,1846.7935342788696,676.2245934009552,1654.646484375,39909,10854,29055,29055,0,13,10270000.0
10270,10270999,20.566732216322716,37.451361056713694,0.08240019239646024,1847.0001883506775,676.2867488861084,1654.766300201416,39911,10855,29056,29056,0,13,10271000.0
10271,10271999,20.568724424951213,37.45456902837079,0.08244794513125475,1847.30419754982,676.3489143848419,1654.7778968811035,39915,10857,29058,29058,0,13,10272000.0
10272,10272999,20.57019500023728,37.456660504823724,0.08247921411325099,1847.4402599334717,676.4098207950592,1654.9819869995117,39915,10857,29058,29058,0,13,10273000.0
10273,10273999,20.569932224845,37.45650514639056,0.0824718631448399,1847.5694966316223,676.4822840690613,1656.1750602722168,39932,10857,29075,29075,0,13,10274000.0
10274,10274999,20.56956219692208,37.455902800766125,0.08246409533944032,1847.7690405845642,676.5441677570343,1656.6424140930176,39935,10858,29077,29077,0,13,10275000.0
10275,10275999,20.569290927033002,37.45570163357307,0.08245734600937582,1847.9702715873718,676.6060721874237,1656.9156761169434,39940,10859,29081,29081,0,13,10276000.0
10276,10276999,20.569246028073287,37.45598442166423,0.08244788214117127,1848.098361492157,676.6670053005219,1657.1616592407227,39940,10859,29081,29081,0,13,10277000.0
10277,10277999,20.56902100389486,37.45541698833693,0.08244264569797755,1848.3932807445526,676.7288510799408,1657.2829704284668,39944,10861,29083,29083,0,13,10278000.0
10278,10278999,20.568741430095482,37.45470957105836,0.08243830769079741,1848.601639509201,676.7910308837891,1657.3993797302246,39947,10862,29085,29085,0,13,10279000.0
10279,10279999,20.568570654437814,37.453863220185625,0.0824338875671149,1848.806911945343,676.8535490036011,1657.5307502746582,39949,10863,29086,29086,0,13,10280000.0
10280,10280999,20.568477692963754,37.45350426529394,0.08242830302146265,1849.1072924137115,676.9144222736359,1657.5831298828125,39953,10865,29088,29088,0,13,10281000.0
10281,10281999,20.568437524951733,37.45311661921176,0.08242100434835586,1849.3369369506836,676.9779558181763,1657.6833305358887,39955,10866,29089,29089,0,13,10282000.0
10282,10282999,20.568462969232453,37.45280806918226,0.08241901269365848,1849.9999451637268,677.0433242321014,1657.453727722168,39967,10872,29095,29095,0,13,10283000.0
10283,10283999,20.56863934000919,37.45282356589558,0.08241715406131045,1850.118005514145,677.1059730052948,1657.7097663879395,39967,10872,29095,29095,0,13,10284000.0
10284,10284999,20.56898137276835,37.45306327152634,0.08241847968502303,1850.242428302765,677.1670939922333,1657.907112121582,39967,10872,29095,29095,0,13,10285000.0
10285,10285999,20.56928737535145,37.453588528776564,0.08242134607081353,1850.5347599983215,677.2291238307953,1657.9783973693848,39972,10874,29098,29098,0,13,10286000.0
10286,10286999,20.569841855231598,37.45425658297808,0.08241954641698845,1850.6554698944092,677.2905964851379,1658.1782569885254,39972,10874,29098,29098,0,13,10287000.0
10287,10287999,20.570863368737513,37.4564391806932,0.08241447546105451,1851.0819201469421,677.355274438858,1658.1913719177246,39978,10877,29101,29101,0,13,10288000.0
10288,10288999,20.571832810695525,37.4578432557224,0.08241620403112804,1851.2904558181763,677.4169268608093,1658.328701019287,39980,10878,29102,29102,0,13,10289000.0
10289,10289999,20.572693332825626,37.4587669356567,0.08242246364032735,1851.4109616279602,677.4785878658295,1658.5209770202637,39980,10878,29102,29102,0,13,10290000.0
10290,10290999,20.573718291771353,37.45964198406354,0.08243339309795139,1851.627959728241,677.540777683258,1658.632900238037,39982,10879,29103,29103,0,13,10291000.0
10291,10291999,20.574739664549227,37.46162014096647,0.08243508068478567,1851.753540277481,677.6030080318451,1658.772933959961,39982,10879,29103,29103,0,13,10292000.0
10292,10292999,20.57592793974779,37.46342944702573,0.08243976223702731,1851.98876953125,677.6664168834686,1658.8638725280762,39985,10880,29105,29105,0,13,10293000.0
10293,10293999,20.576072593316976,37.46392718698204,0.08243215779525526,1852.1986634731293,677.7295334339142,1659.6529693603516,39999,10881,29118,29118,0,13,10294000.0
10294,10294999,20.57555943019361,37.463292516229465,0.08242438982866473,1852.4844930171967,677.7912769317627,1659.9792747497559,40004,10883,29121,29121,0,13,10295000.0
10295,10295999,20.575025735358363,37.46224824732727,0.08242073497641411,1852.6037876605988,677.8544085025787,1660.2896041870117,40004,10883,29121,29121,0,13,10296000.0
10296,10296999,20.574651794924165,37.46162408301507,0.08241546480640816,1852.9831607341766,677.9159514904022,1660.4139671325684,40010,10886,29124,29124,0,13,10297000.0
10297,10297999,20.57424472186781,37.46077031875334,0.08241026819494057,1853.2084186077118,677.9787011146545,1660.580322265625,40012,10887,29125,29125,0,13,10298000.0
10298,10298999,20.573878801261024,37.45998728723183,0.0824057683977143,1853.516725063324,678.0409009456635,1660.6411361694336,40017,10889,29128,29128,0,13,10299000.0
10299,10299999,20.573566987261806,37.4592168332423,0.08239896591128049,1853.728063583374,678.1029436588287,1660.772804260254,40019,10890,29129,29129,0,13,10300000.0
10300,10300999,20.57326029882893,37.45834829876047,0.08239432985881323,1854.1359572410583,678.1672556400299,1660.8134117126465,40025,10893,29132,29132,0,13,10301000.0
10301,10301999,20.57320748893152,37.45786478407384,0.082389200037147,1854.256040096283,678.2292025089264,1660.96928024292,40025,10893,29132,29132,0,13,10302000.0
10302,10302999,20.57354510035818,37.45872256099592,0.08237860375113726,1854.3854229450226,678.2936191558838,1661.167652130127,40025,10893,29132,29132,0,13,10303000.0
10303,10303999,20.574406654040985,37.46051855719573,0.08237563543629889,1854.5865988731384,678.3531398773193,1661.2797164916992,40027,10894,29133,29133,0,13,10304000.0
10304,10304999,20.57554857158589,37.46319470085293,0.08238852609134617,1854.9947097301483,678.4174048900604,1661.2450904846191,40034,10897,29137,29137,0,13,10305000.0
10305,10305999,20.576328385431278,37.46459050338699,0.08239810807028114,1855.301944732666,678.479939699173,1661.2852478027344,40038,10899,29139,29139,0,13,10306000.0
10306,10306999,20.577361337075594,37.4666323078423,0.08240336446792562,1855.5289545059204,678.5418426990509,1661.4136009216309,40040,10900,29140,29140,0,13,10307000.0
10307,10307999,20.578455899967118,37.468608572278114,0.08241741849030948,1855.6572580337524,678.6033046245575,1661.5479278564453,40040,10900,29140,29140,0,13,10308000.0
10308,10308999,20.57959024880922,37.47050038503731,0.08244064231441983,1855.8918080329895,678.6650104522705,1661.5897216796875,40043,10901,29142,29142,0,13,10309000.0
10309,10309999,20.580661173181163,37.4724292231316,0.08245659929716398,1856.000224351883,678.7281353473663,1661.7436294555664,40043,10901,29142,29142,0,13,10310000.0
10310,10310999,20.58178487176185,37.474308743352466,0.08246211120529856,1856.2375285625458,678.7926125526428,1661.7602996826172,40046,10902,29144,29144,0,13,10311000.0
10311,10311999,20.582661975635048,37.47543587818725,0.08248001658459292,1856.3656735420227,678.854113817215,1661.9031143188477,40046,10902,29144,29144,0,13,10312000.0
10312,10312999,20.58348917757994,37.4771971730234,0.08248623561444901,1856.6826148033142,678.919793844223,1661.7552070617676,40050,10904,29146,29146,0,13,10313000.0
10313,10313999,20.583718062201328,37.477038495013055,0.08248318091619256,1856.9063222408295,678.9816317558289,1662.4428100585938,40060,10905,29155,29155,0,13,10314000.0
10314,10314999,20.58343019185588,37.47646002685455,0.08247292526811911,1857.1116774082184,679.0436885356903,1662.8204498291016,40065,10906,29159,29159,0,13,10315000.0
10315,10315999,20.583007313002017,37.476096420411366,0.08247061489957852,1857.320945262909,679.1049973964691,1663.0655212402344,40067,10907,29160,29160,0,13,10316000.0
10316,10316999,20.582876256413645,37.476366565589764,0.08246459540912887,1857.5397853851318,679.1666905879974,1663.243724822998,40069,10908,29161,29161,0,13,10317000.0
10317,10317999,20.582866593213666,37.47671054266295,0.0824582340570107,1857.6665349006653,679.228679895401,1663.429759979248,40069,10908,29161,29161,0,13,10318000.0
10318,10318999,20.582785077772318,37.476728198185185,0.08245265479675268,1857.9760389328003,679.2913863658905,1663.4636535644531,40073,10910,29163,29163,0,13,10319000.0
10319,10319999,20.582816785943752,37.4767102045455,0.08244538975353055,1858.1014595031738,679.3522284030914,1663.6120986938477,40073,10910,29163,29163,0,13,10320000.0
10320,10320999,20.582792472639262,37.476397892742135,0.08244228314080637,1858.4208188056946,679.4149761199951,1663.6126441955566,40078,10912,29166,29166,0,13,10321000.0
10321,10321999,20.582626475693246,37.47576552496941,0.08244260407964454,1858.5290699005127,679.476310968399,1663.7848091125488,40078,10912,29166,29166,0,13,10322000.0
10322,10322999,20.582564846331678,37.47525317470335,0.08244480370639262,1858.8415741920471,679.5386035442352,1663.802791595459,40082,10914,29168,29168,0,13,10323000.0
10323,10323999,20.58277230616889,37.47646471709224,0.08243574350253446,1859.0599133968353,679.6012790203094,1663.900146484375,40085,10915,29170,29170,0,13,10324000.0
10324,10324999,20.58271834053463,37.47598073109185,0.08243678674351163,1859.2920324802399,679.6665337085724,1663.963176727295,40088,10916,29172,29172,0,13,10325000.0
10325,10325999,20.582716138626328,37.47552420187433,0.08243872144459019,1859.6079938411713,679.7288537025452,1664.0163955688477,40092,10918,29174,29174,0,13,10326000.0
10326,10326999,20.582999400756453,37.47722971688003,0.08243649083850868,1859.7409718036652,679.7947473526001,1664.160301208496,40092,10918,29174,29174,0,13,10327000.0
10327,10327999,20.58328307553949,37.47738230912232,0.08244444551731744,1860.2389314174652,679.8587732315063,1663.9646186828613,40111,10922,29189,29189,0,13,10328000.0
10328,10328999,20.583446899476893,37.47706784042657,0.08245032668509156,1860.3554048538208,679.91929936409,1664.139316558838,40111,10922,29189,29189,0,13,10329000.0
10329,10329999,20.584108828654927,37.47792489153693,0.08246411560097888,1860.579047203064,679.9806072711945,1664.249252319336,40113,10923,29190,29190,0,13,10330000.0
10330,10330999,20.58425972418971,37.477620395942246,0.08247183605234176,1860.7947716712952,680.0428051948547,1664.3596649169922,40115,10924,29191,29191,0,13,10331000.0
10331,10331999,20.584622654623583,37.479155208602734,0.08244111578051705,1861.1043527126312,680.1067509651184,1665.0194129943848,40129,10926,29203,29203,0,13,10332000.0
10332,10332999,20.584533692926097,37.478744225733344,0.08242588202711765,1861.3135721683502,680.1689863204956,1665.3565979003906,40132,10927,29205,29205,0,13,10333000.0
10333,10333999,20.584513182201466,37.47944147754285,0.08240355307857994,1861.6357004642487,680.2389597892761,1665.4810371398926,40138,10929,29209,29209,0,13,10334000.0
10334,10334999,20.58444631245653,37.47909207167599,0.08239147700008675,1861.9295499324799,680.3014335632324,1665.7156791687012,40142,10931,29211,29211,0,13,10335000.0
10335,10335999,20.58431672056227,37.47881105652286,0.08238101860233293,1862.1351609230042,680.3622529506683,1665.872573852539,40144,10932,29212,29212,0,13,10336000.0
10336,10336999,20.584409955526564,37.479015412651215,0.08237224364342233,1862.4410536289215,680.4248967170715,1666.0059394836426,40148,10934,29214,29214,0,13,10337000.0
10337,10337999,20.584476738955086,37.47906537946354,0.08236351650760299,1862.566266298294,680.4844715595245,1666.2275695800781,40148,10934,29214,29214,0,13,10338000.0
10338,10338999,20.5853967218874,37.48204353073979,0.08234680662497296,1862.95858836174,680.5476641654968,1666.2180137634277,40155,10937,29218,29218,0,13,10339000.0
10339,10339999,20.58626665381542,37.484638510273086,0.08233781161200382,1863.1708283424377,680.6105968952179,1666.4352416992188,40157,10938,29219,29219,0,13,10340000.0
10340,10340999,20.5877655774545,37.48855137746942,0.08233992199833406,1863.3920707702637,680.6767179965973,1666.6029624938965,40159,10939,29220,29220,0,13,10341000.0
10341,10341999,20.589292310400804,37.493262952333964,0.08233753053799253,1863.778481245041,680.7397701740265,1666.5429649353027,40166,10942,29224,29224,0,13,10342000.0
10342,10342999,20.59031894024691,37.496476013397846,0.08231730346379718,1864.361941576004,680.8024451732635,1666.4865951538086,40179,10947,29232,29232,0,13,10343000.0
10343,10343999,20.59152143682906,37.49910316334568,0.08232187158161852,1864.5702452659607,680.8653364181519,1666.738784790039,40181,10948,29233,29233,0,13,10344000.0
10344,10344999,20.59337173085274,37.5031023303606,0.08234585848230236,1864.7773697376251,680.9284355640411,1666.9355010986328,40183,10949,29234,29234,0,13,10345000.0
10345,10345999,20.595082169460703,37.50766437210156,0.08236362416478626,1864.9161927700043,680.9896035194397,1667.1307487487793,40183,10949,29234,29234,0,13,10346000.0
10346,10346999,20.59698993572264,37.51360863068949,0.08237713826914517,1865.0430405139923,681.0509006977081,1667.2938652038574,40183,10949,29234,29234,0,13,10347000.0
10347,10347999,20.599088863159146,37.51862888029738,0.08241942778701905,1865.178278207779,681.11887383461,1667.4528770446777,40183,10949,29234,29234,0,13,10348000.0
10348,10348999,20.60110757847784,37.52293406146739,0.08246175302625836,1865.4005885124207,681.1820826530457,1667.521484375,40185,10950,29235,29235,0,13,10349000.0
10349,10349999,20.602563309684815,37.52614532194816,0.08248976020345966,1865.5252599716187,681.2445683479309,1667.6902389526367,40185,10950,29235,29235,0,13,10350000.0
10350,10350999,20.602519900310373,37.52598024321029,0.08248765449038498,1865.647360086441,681.3064498901367,1668.8165855407715,40200,10950,29250,29250,0,13,10351000.0
10351,10351999,20.60221284637667,37.52620641793616,0.08247898425303402,1865.8475239276886,681.3689403533936,1669.2108879089355,40202,10951,29251,29251,0,13,10352000.0
10352,10352999,20.601833201228672,37.525596339865366,0.0824746683876374,1865.959417104721,681.431126832962,1669.519905090332,40202,10951,29251,29251,0,13,10353000.0
10353,10353999,20.601780042934305,37.52552033332189,0.0824678368217403,1866.5276799201965,681.4937169551849,1669.4432182312012,40212,10956,29256,29256,0,13,10354000.0
10354,10354999,20.601592922249946,37.52518231594673,0.08246157942135512,1866.7252640724182,681.5570795536041,1669.7058563232422,40214,10957,29257,29257,0,13,10355000.0
10355,10355999,20.601228304260164,37.52450664050982,0.0824589101404618,1867.2797565460205,681.6201140880585,1669.6843452453613,40225,10962,29263,29263,0,13,10356000.0
10356,10356999,20.601050022987373,37.52412270618976,0.08245432649438023,1867.497652053833,681.6847710609436,1669.9555740356445,40255,10963,29292,29292,0,13,10357000.0
10357,10357999,20.60088709252916,37.52421072122212,0.08244860805031429,1867.8967802524567,681.7475037574768,1669.969352722168,40261,10966,29295,29295,0,13,10358000.0
10358,10358999,20.60083368522408,37.52414036233393,0.08244270446065904,1868.1104419231415,681.8100249767303,1670.1034088134766,40263,10967,29296,29296,0,13,10359000.0
10359,10359999,20.600769031677867,37.52395092814269,0.08244042733711598,1868.320172071457,681.873617887497,1670.2552490234375,40265,10968,29297,29297,0,13,10360000.0
10360,10360999,20.600951803216628,37.52408569130428,0.08244247668663429,1868.5356879234314,681.9365620613098,1670.400302886963,40271,10969,29302,29302,0,13,10361000.0
10361,10361999,20.601500839825054,37.52461415535815,0.08244425225604302,1868.850622177124,681.9996082782745,1670.3320999145508,40276,10971,29305,29305,0,13,10362000.0
10362,10362999,20.602353789699123,37.52794924949312,0.08243912830117384,1869.1568813323975,682.0631814002991,1670.4568252563477,40280,10973,29307,29307,0,13,10363000.0
10363,10363999,20.603324869007395,37.530126088614466,0.08243799311010513,1869.356850862503,682.125649690628,1670.6031112670898,40282,10974,29308,29308,0,13,10364000.0
10364,10364999,20.604298092872405,37.531501085933314,0.0824423572142089,1869.493968486786,682.1894915103912,1670.804328918457,40282,10974,29308,29308,0,13,10365000.0
10365,10365999,20.605480783331885,37.533079650809576,0.08244992967668763,1869.6192047595978,682.2519435882568,1670.9314498901367,40282,10974,29308,29308,0,13,10366000.0
10366,10366999,20.606542501643496,37.53408946942746,0.08245917253563706,1869.9373259544373,682.3165910243988,1670.935173034668,40287,10976,29311,29311,0,13,10367000.0
10367,10367999,20.607849892662617,37.53642817628335,0.0824726041473266,1870.0647382736206,682.3792111873627,1671.1554374694824,40287,10976,29311,29311,0,13,10368000.0
10368,10368999,20.608715029197565,37.53706378301724,0.08248720074885219,1870.1823422908783,682.4425358772278,1671.2881965637207,40287,10976,29311,29311,0,13,10369000.0
10369,10369999,20.609802162803835,37.537960034958644,0.08249632833955056,1870.325929403305,682.5054295063019,1671.4419250488281,40287,10976,29311,29311,0,13,10370000.0
10370,10370999,20.609806342216153,37.537325506346086,0.08249181511369519,1870.4441442489624,682.5677466392517,1672.404441833496,40302,10976,29326,29326,0,13,10371000.0
10371,10371999,20.609187990745077,37.53617201249595,0.08249063399892931,1870.7554733753204,682.6312942504883,1672.6821098327637,40306,10978,29328,29328,0,13,10372000.0
10372,10372999,20.608964598794742,37.535971371016274,0.08248499702124457,1870.8669691085815,682.6933236122131,1673.1100273132324,40306,10978,29328,29328,0,13,10373000.0
10373,10373999,20.60855280120211,37.53515198707502,0.08248283181634108,1871.2483687400818,682.7555012702942,1673.181625366211,40313,10981,29332,29332,0,13,10374000.0
10374,10374999,20.608436584895742,37.53473429570626,0.08247653151775203,1871.5382030010223,682.8164267539978,1673.3549346923828,40317,10983,29334,29334,0,13,10375000.0
10375,10375999,20.608203326790964,37.5344566823618,0.0824721244968083,1871.8289391994476,682.8787143230438,1673.4860801696777,40324,10985,29339,29339,0,13,10376000.0
10376,10376999,20.60793063441477,37.53374424552087,0.0824685580937381,1872.3178734779358,682.9418878555298,1673.5084991455078,40333,10989,29344,29344,0,13,10377000.0
10377,10377999,20.607720909875887,37.53296659014301,0.08246627035767262,1872.5258972644806,683.0043337345123,1673.781063079834,40335,10990,29345,29345,0,13,10378000.0
10378,10378999,20.60753893141928,37.532248425891574,0.08246254566931221,1872.7476036548615,683.0676600933075,1673.8622283935547,40337,10991,29346,29346,0,13,10379000.0
10379,10379999,20.60755243457836,37.53207852731563,0.08245842646662194,1873.0479717254639,683.1306838989258,1673.9644317626953,40341,10993,29348,29348,0,13,10380000.0
10380,10380999,20.60760608067426,37.53195378148931,0.08245354551820117,1873.1767311096191,683.1928880214691,1674.162094116211,40341,10993,29348,29348,0,13,10381000.0
10381,10381999,20.60771374715729,37.5318879438318,0.08245115539652481,1873.5757994651794,683.2561686038971,1674.0848350524902,40348,10996,29352,29352,0,13,10382000.0
10382,10382999,20.60802818070434,37.53230929312716,0.08244568342587177,1873.782612323761,683.3176438808441,1674.2783279418945,40350,10997,29353,29353,0,13,10383000.0
10383,10383999,20.608626360874432,37.533719241842086,0.08244259227850348,1873.995496749878,683.3802871704102,1674.4523429870605,40352,10998,29354,29354,0,13,10384000.0
10384,10384999,20.609911445560613,37.537041459268636,0.08243436404206517,1874.2153856754303,683.442066192627,1674.6289978027344,40354,10999,29355,29355,0,13,10385000.0
10385,10385999,20.611682570662822,37.541952453333344,0.0824290857283656,1874.4366641044617,683.5044059753418,1674.8169975280762,40356,11000,29356,29356,0,13,10386000.0
10386,10386999,20.613492917148214,37.546494593835135,0.08243099847475388,1874.5648455619812,683.5760846138,1675.0038299560547,40356,11000,29356,29356,0,13,10387000.0
10387,10387999,20.61512590464997,37.54982250689191,0.08243870009675258,1874.878301858902,683.6395463943481,1674.946720123291,40360,11002,29358,29358,0,13,10388000.0
10388,10388999,20.616960971186437,37.55438928719341,0.08245676090970666,1875.0160689353943,683.7043642997742,1675.1162643432617,40360,11002,29358,29358,0,13,10389000.0
10389,10389999,20.618478131685286,37.557110599855385,0.08247054670398224,1875.143455505371,683.765275478363,1675.2780647277832,40360,11002,29358,29358,0,13,10390000.0
10390,10390999,20.618683398652994,37.55685772635942,0.0824683814626953,1875.2775149345398,683.8386468887329,1676.3465385437012,40378,11002,29376,29376,0,13,10391000.0
10391,10391999,20.61822795604723,37.55586498422265,0.08246100423747649,1875.668672800064,683.9024789333344,1676.576759338379,40389,11005,29384,29384,0,13,10392000.0
10392,10392999,20.61783398934735,37.555599223610336,0.0824515476444233,1875.8784747123718,683.9677321910858,1676.93168258667,40391,11006,29385,29385,0,13,10393000.0
10393,10393999,20.617599401497635,37.55514783144682,0.08244210177411704,1876.0096683502197,684.0422687530518,1677.228313446045,40391,11006,29385,29385,0,13,10394000.0
10394,10394999,20.61729062221278,37.55449614575968,0.08243470390165908,1876.3190703392029,684.1069259643555,1677.3469276428223,40395,11008,29387,29387,0,13,10395000.0
10395,10395999,20.616925840879002,37.5537429902992,0.08242873109291549,1876.7177526950836,684.1691381931305,1677.3619346618652,40401,11011,29390,29390,0,13,10396000.0
10396,10396999,20.616441021984524,37.55274282843426,0.08242663968067465,1877.0333745479584,684.2323455810547,1677.4878616333008,40405,11013,29392,29392,0,13,10397000.0
10397,10397999,20.616164950086745,37.55233627080812,0.08241913344164431,1877.3293199539185,684.2955548763275,1677.6132125854492,40409,11015,29394,29394,0,13,10398000.0
10398,10398999,20.615825128521102,37.55139587706167,0.08241453126134912,1877.6559374332428,684.3619401454926,1677.6819038391113,40413,11017,29396,29396,0,13,10399000.0
10399,10399999,20.61557108576268,37.55077399761452,0.08240826394967893,1877.778990983963,684.4260494709015,1677.921043395996,40413,11017,29396,29396,0,13,10400000.0
10400,10400999,20.615275567763277,37.54989065024332,0.08240201278813697,1877.9105107784271,684.4888505935669,1678.104076385498,40413,11017,29396,29396,0,13,10401000.0
10401,10401999,20.615047610319262,37.54916804990492,0.08239595837779179,1878.1473910808563,684.5520143508911,1678.2131156921387,40415,11018,29397,29397,0,13,10402000.0
10402,10402999,20.614884927988765,37.54866377026753,0.08238909752416856,1878.3714606761932,684.6151971817017,1678.3080368041992,40417,11019,29398,29398,0,13,10403000.0
10403,10403999,20.61495907829097,37.548292400234885,0.08237669238291201,1878.6119050979614,684.6891717910767,1678.3967742919922,40419,11020,29399,29399,0,13,10404000.0
10404,10404999,20.61532287772927,37.548677364984215,0.08236532041089295,1878.744778394699,684.7534394264221,1678.5429153442383,40419,11020,29399,29399,0,13,10405000.0
10405,10405999,20.61593969696839,37.54936317399349,0.08235572971650906,1878.965168952942,684.8187565803528,1678.5934410095215,40422,11021,29401,29401,0,13,10406000.0
10406,10406999,20.616831698250788,37.551257892704946,0.08234617877479233,1879.0931372642517,684.882444858551,1678.752384185791,40422,11021,29401,29401,0,13,10407000.0
10407,10407999,20.61737906337633,37.551542007234666,0.0823404009361568,1879.230301141739,684.9457633495331,1678.8812637329102,40422,11021,29401,29401,0,13,10408000.0
10408,10408999,20.61814122427682,37.5523723313142,0.08234049104295693,1879.3675701618195,685.0081031322479,1678.9763412475586,40422,11021,29401,29401,0,13,10409000.0
10409,10409999,20.61879486518289,37.55288243741189,0.0823339127961017,1879.500694513321,685.0775985717773,1679.0976753234863,40422,11021,29401,29401,0,13,10410000.0
10410,10410999,20.619765482381148,37.55402526301009,0.08232214561105144,1879.7297279834747,685.1402587890625,1679.8883819580078,40442,11022,29420,29420,0,13,10411000.0
10411,10411999,20.61974690848286,37.55447977981252,0.08229786913418413,1879.8474023342133,685.2043240070343,1680.5968894958496,40446,11022,29424,29424,0,13,10412000.0
10412,10412999,20.619562755236643,37.55415846335681,0.08227867884942819,1880.0772788524628,685.2770321369171,1681.106544494629,40448,11023,29425,29425,0,13,10413000.0
10413,10413999,20.61920261580535,37.553297796713125,0.08226713253516182,1880.280263185501,685.3399746417999,1681.3708686828613,40450,11024,29426,29426,0,13,10414000.0
10414,10414999,20.618883639043286,37.55255468693025,0.0822521434608402,1880.5830709934235,685.4034373760223,1681.4833908081055,40457,11026,29431,29431,0,13,10415000.0
10415,10415999,20.61863250510997,37.552075193612126,0.08224079171630827,1880.8859016895294,685.465343952179,1681.56880569458,40461,11028,29433,29433,0,13,10416000.0
10416,10416999,20.618541526100536,37.55147108622496,0.08221290674422532,1881.1794273853302,685.527012348175,1681.7204399108887,40465,11030,29435,29435,0,13,10417000.0
10417,10417999,20.618211065359667,37.5506474560525,0.08220304573201798,1881.4724214076996,685.5890731811523,1681.840835571289,40469,11032,29437,29437,0,13,10418000.0
10418,10418999,20.61797933665886,37.55015713987369,0.08218859592066796,1881.7944750785828,685.6556489467621,1682.0236701965332,40473,11034,29439,29439,0,13,10419000.0
10419,10419999,20.61769486157788,37.54972058623104,0.08217744694876439,1882.1831064224243,685.7188739776611,1682.0498886108398,40483,11037,29446,29446,0,13,10420000.0
10420,10420999,20.617504178425392,37.54902347587876,0.08216890708429514,1882.3922448158264,685.7815701961517,1682.2414436340332,40485,11038,29447,29447,0,13,10421000.0
10421,10421999,20.617404780352807,37.54866068363038,0.08215592357150237,1882.7283418178558,685.8456981182098,1682.2773895263672,40489,11040,29449,29449,0,13,10422000.0
10422,10422999,20.61745038508751,37.54824154700722,0.0821432599676255,1882.8548924922943,685.9091186523438,1682.4836158752441,40489,11040,29449,29449,0,13,10423000.0
10423,10423999,20.61763706413506,37.54821426401536,0.08212105987626073,1883.0578978061676,685.9712445735931,1682.6155548095703,40491,11041,29450,29450,0,13,10424000.0
10424,10424999,20.617831435086025,37.54821983321442,0.0821049391063311,1883.200677871704,686.0419700145721,1682.8052787780762,40491,11041,29450,29450,0,13,10425000.0
10425,10425999,20.618103673717386,37.54828735990222,0.08208782673837955,1883.325599193573,686.1038844585419,1682.98974609375,40491,11041,29450,29450,0,13,10426000.0
10426,10426999,20.618545125399443,37.54860118302302,0.08207366755396284,1883.551818370819,686.1756341457367,1683.0581359863281,40493,11042,29451,29451,0,13,10427000.0
10427,10427999,20.61895096157413,37.548725709171585,0.08206338169175043,1883.943871974945,686.2388114929199,1682.986156463623,40500,11045,29455,29455,0,13,10428000.0
10428,10428999,20.619534532618218,37.54919595333817,0.08205308737555284,1884.1520028114319,686.2993702888489,1683.159122467041,40502,11046,29456,29456,0,13,10429000.0
10429,10429999,20.620323391022218,37.549862360075174,0.08204431065679951,1884.2763118743896,686.3612117767334,1683.3124046325684,40502,11046,29456,29456,0,13,10430000.0
10430,10430999,20.620620726374543,37.54980907170059,0.08204140002086302,1884.426328420639,686.4235928058624,1683.4767112731934,40502,11046,29456,29456,0,13,10431000.0
10431,10431999,20.62066856866794,37.54948193233029,0.08202986166989834,1884.5506856441498,686.4858655929565,1684.3445892333984,40514,11046,29468,29468,0,13,10432000.0
10432,10432999,20.62036415790007,37.548993745175565,0.08201666413106401,1884.7660059928894,686.5497839450836,1684.6543884277344,40516,11047,29469,29469,0,13,10433000.0
10433,10433999,20.620282386820456,37.548477871812295,0.08200140867508932,1884.8708832263947,686.6098213195801,1684.9866790771484,40516,11047,29469,29469,0,13,10434000.0
10434,10434999,20.62015191870962,37.54788041655352,0.08198572603826149,1885.164618730545,686.6729028224945,1685.173007965088,40520,11049,29471,29471,0,13,10435000.0
10435,10435999,20.620097129356417,37.5474152828728,0.08197746888634794,1885.4820818901062,686.7385427951813,1685.2912406921387,40524,11051,29473,29473,0,13,10436000.0
10436,10436999,20.620064373766386,37.546916151090315,0.08197268072760477,1885.6016495227814,686.7993276119232,1685.5137481689453,40524,11051,29473,29473,0,13,10437000.0
10437,10437999,20.619862309877202,37.54634096171101,0.08197015042640454,1886.1023919582367,686.86305975914,1685.4397468566895,40533,11055,29478,29478,0,13,10438000.0
10438,10438999,20.619643415155167,37.54564416824582,0.08196700399296808,1886.2309052944183,686.9283781051636,1685.6969184875488,40533,11055,29478,29478,0,13,10439000.0
10439,10439999,20.619546513160692,37.54518122923113,0.08196308877323566,1886.5422868728638,686.991580247879,1685.730556488037,40537,11057,29480,29480,0,13,10440000.0
10440,10440999,20.619890648515494,37.54706779830642,0.08195347506914419,1886.7643823623657,687.0553059577942,1685.8261528015137,40540,11058,29482,29482,0,13,10441000.0
10441,10441999,20.6202181015907,37.547261465137815,0.08194924809108983,1886.9815590381622,687.1182579994202,1685.9287300109863,40542,11059,29483,29483,0,13,10442000.0
10442,10442999,20.62122044373671,37.550632926264,0.08193518607772243,1887.1159689426422,687.1831800937653,1686.0448913574219,40542,11059,29483,29483,0,13,10443000.0
10443,10443999,20.62187065752889,37.55190457924952,0.08192811964698765,1887.34437417984,687.2517476081848,1686.1306228637695,40544,11060,29484,29484,0,13,10444000.0
10444,10444999,20.622692581571133,37.55278766058578,0.08192593092984135,1887.56383228302,687.3136177062988,1686.1988563537598,40546,11061,29485,29485,0,13,10445000.0
10445,10445999,20.6238096212174,37.55442156916753,0.08192322806430763,1887.7903606891632,687.3775682449341,1686.3031196594238,40548,11062,29486,29486,0,13,10446000.0
10446,10446999,20.624834777653113,37.55581348826693,0.0819311300317902,1887.9363324642181,687.4467141628265,1686.4751091003418,40548,11062,29486,29486,0,13,10447000.0
10447,10447999,20.625813413082213,37.557480812540526,0.08193339817249723,1888.0617880821228,687.5089616775513,1686.6159210205078,40548,11062,29486,29486,0,13,10448000.0
10448,10448999,20.626735771428816,37.55875700938229,0.08193969166633452,1888.4872097969055,687.5737483501434,1686.446060180664,40555,11065,29490,29490,0,13,10449000.0
10449,10449999,20.627834182430046,37.56060678531633,0.08194825919930426,1888.619443655014,687.6400628089905,1686.6037712097168,40555,11065,29490,29490,0,13,10450000.0
10450,10450999,20.62887135962808,37.561897534361734,0.08195649898707902,1888.7378075122833,687.7026882171631,1686.7345504760742,40555,11065,29490,29490,0,13,10451000.0
10451,10451999,20.629238963374526,37.561820350164076,0.08195255846854266,1888.8594069480896,687.7653300762177,1687.2500305175781,40564,11065,29499,29499,0,13,10452000.0
10452,10452999,20.629010215641273,37.5617681496333,0.08194390741342694,1888.9732155799866,687.8261826038361,1687.9902839660645,40567,11065,29502,29502,0,13,10453000.0
10453,10453999,20.628484706684162,37.56080628252388,0.08194217953684224,1889.2638928890228,687.8878123760223,1688.1895561218262,40571,11067,29504,29504,0,13,10454000.0
10454,10454999,20.627946049284535,37.55985919930118,0.08194088412231115,1889.4843833446503,687.950868844986,1688.4569282531738,40573,11068,29505,29505,0,13,10455000.0
10455,10455999,20.627525087969495,37.559168481126655,0.08193744829313898,1889.5932636260986,688.0109932422638,1688.681282043457,40573,11068,29505,29505,0,13,10456000.0
10456,10456999,20.62694566145172,37.557925005291295,0.0819371518757096,1889.81320810318,688.071634054184,1688.760009765625,40579,11069,29510,29510,0,13,10457000.0
10457,10457999,20.626444334277227,37.556942993486444,0.08193450667944058,1890.3791637420654,688.1346640586853,1688.6543807983398,40589,11074,29515,29515,0,13,10458000.0
10458,10458999,20.625983344604013,37.555975920675955,0.08193178609854168,1890.691326379776,688.1973576545715,1688.749526977539,40597,11076,29521,29521,0,13,10459000.0
10459,10459999,20.625582011423962,37.55502393260741,0.08192956269538076,1890.8919615745544,688.2581763267517,1688.8532257080078,40599,11077,29522,29522,0,13,10460000.0
10460,10460999,20.625335809487773,37.55443091716713,0.08192525889567615,1891.3043773174286,688.3282051086426,1688.8341789245605,40605,11080,29525,29525,0,13,10461000.0
10461,10461999,20.62544377767798,37.554586712251,0.08191900907403926,1891.4302718639374,688.3896598815918,1689.106113433838,40605,11080,29525,29525,0,13,10462000.0
10462,10462999,20.62570433715902,37.55517848668902,0.08191531927618867,1891.7247443199158,688.4512603282928,1689.1769332885742,40610,11082,29528,29528,0,13,10463000.0
10463,10463999,20.625979569803427,37.555612442051654,0.08191535224581104,1892.0405683517456,688.5129754543304,1689.163875579834,40614,11084,29530,29530,0,13,10464000.0
10464,10464999,20.62673024404466,37.558129950637195,0.08191545863926786,1892.1644968986511,688.5753514766693,1689.435848236084,40614,11084,29530,29530,0,13,10465000.0
10465,10465999,20.628265937946505,37.56421123632772,0.08191164491295733,1892.303624868393,688.6384830474854,1689.5936279296875,40614,11084,29530,29530,0,13,10466000.0
10466,10466999,20.62938625411689,37.56772970930849,0.0819077484876014,1892.4173817634583,688.699658870697,1689.7531356811523,40614,11084,29530,29530,0,13,10467000.0
10467,10467999,20.630616176929546,37.57121534817907,0.08192030162439512,1892.7303795814514,688.7615625858307,1689.7365226745605,40618,11086,29532,29532,0,13,10468000.0
10468,10468999,20.63196653487801,37.575074532208205,0.0819285106217299,1892.9440507888794,688.8229343891144,1689.8887252807617,40620,11087,29533,29533,0,13,10469000.0
10469,10469999,20.63252348653542,37.57644693258776,0.08193249332940988,1893.10724568367,688.8871774673462,1690.6114540100098,40630,11087,29543,29543,0,13,10470000.0
10470,10470999,20.63217558698054,37.57620379340676,0.08192809308304283,1893.3120093345642,688.9494163990021,1690.9861907958984,40632,11088,29544,29544,0,13,10471000.0
10471,10471999,20.63192377031983,37.575570282967035,0.0819231740275449,1893.5086555480957,689.0100047588348,1691.2203674316406,40639,11089,29550,29550,0,13,10472000.0
10472,10472999,20.632315387844418,37.576307031222534,0.08191241995740473,1893.8168029785156,689.0741903781891,1691.4175453186035,40643,11091,29552,29552,0,13,10473000.0
10473,10473999,20.632489288599956,37.57635719615259,0.08190619720105663,1894.2017152309418,689.1365261077881,1691.3220558166504,40653,11094,29559,29559,0,13,10474000.0
10474,10474999,20.632655982042774,37.576306315286075,0.08190064886365145,1894.693038702011,689.1991608142853,1691.3114280700684,40661,11098,29563,29563,0,13,10475000.0
10475,10475999,20.632692465632413,37.57620103622861,0.08190204306723747,1894.9977326393127,689.2653498649597,1691.576473236084,40665,11100,29565,29565,0,13,10476000.0
10476,10476999,20.632843202232102,37.57651013492512,0.08189789689358928,1895.1995441913605,689.3265991210938,1691.7488059997559,40667,11101,29566,29566,0,13,10477000.0
10477,10477999,20.633009957060438,37.576598636108734,0.08189447630256641,1895.437994003296,689.394912481308,1691.8310928344727,40670,11102,29568,29568,0,13,10478000.0
10478,10478999,20.633557198768884,37.577716703741324,0.08188763330453674,1895.76402926445,689.4583055973053,1691.940616607666,40675,11104,29571,29571,0,13,10479000.0
10479,10479999,20.633893652100475,37.57814162191104,0.08189045525898797,1896.075273513794,689.520177602768,1691.9775505065918,40680,11106,29574,29574,0,13,10480000.0
10480,10480999,20.634444806069986,37.579057914685926,0.08189131384467296,1896.3751492500305,689.5831823348999,1692.06840133667,40694,11108,29586,29586,0,13,10481000.0
10481,10481999,20.635023129252815,37.58132566458578,0.08189053163338011,1896.5306038856506,689.6492245197296,1692.2305374145508,40694,11108,29586,29586,0,13,10482000.0
10482,10482999,20.635640048084582,37.582060464260735,0.08188954094186096,1896.655446767807,689.7113234996796,1692.3666763305664,40694,11108,29586,29586,0,13,10483000.0
10483,10483999,20.636604026716924,37.58362679011673,0.08189720406206369,1896.7773740291595,689.7741816043854,1692.4922828674316,40694,11108,29586,29586,0,13,10484000.0
10484,10484999,20.637432077604974,37.584687863941724,0.08190266845918259,1896.9096236228943,689.8364660739899,1692.6250228881836,40694,11108,29586,29586,0,13,10485000.0
10485,10485999,20.638106285564884,37.58549861837583,0.0819094243744114,1897.0390553474426,689.897716999054,1692.689079284668,40694,11108,29586,29586,0,13,10486000.0
10486,10486999,20.639089197591467,37.58729515562609,0.08191814458377766,1897.2666611671448,689.9617683887482,1692.7030868530273,40696,11109,29587,29587,0,13,10487000.0
10487,10487999,20.639939362054534,37.588692483448995,0.08192493642704834,1897.3966574668884,690.0254058837891,1692.8031730651855,40696,11109,29587,29587,0,13,10488000.0
10488,10488999,20.640220070651953,37.58842807174486,0.08192852644122395,1897.6325306892395,690.0907680988312,1692.8940773010254,40698,11110,29588,29588,0,13,10489000.0
10489,10489999,20.64026340365824,37.58920761714492,0.08189331323562365,1897.7492468357086,690.1527233123779,1693.8073196411133,40711,11110,29601,29601,0,13,10490000.0
10490,10490999,20.639827174812346,37.588529033542834,0.08188720744447553,1897.8693339824677,690.2162480354309,1694.1869316101074,40711,11110,29601,29601,0,13,10491000.0
10491,10491999,20.639609232371587,37.58988283973395,0.0818718463814655,1898.2724742889404,690.2780201435089,1694.2455940246582,40717,11113,29604,29604,0,13,10492000.0
10492,10492999,20.639233773834736,37.588988015855215,0.08186995431234823,1898.5758683681488,690.3416333198547,1694.4248008728027,40721,11115,29606,29606,0,13,10493000.0
10493,10493999,20.63904173032747,37.588608763617565,0.08186287643990386,1898.7993245124817,690.4046895503998,1694.610996246338,40723,11116,29607,29607,0,13,10494000.0
10494,10494999,20.638793764415254,37.58779713038263,0.0818590482019238,1899.016846895218,690.4704847335815,1694.7674407958984,40725,11117,29608,29608,0,13,10495000.0
10495,10495999,20.638610283340952,37.587213951440546,0.08185558127696202,1899.2288014888763,690.5327093601227,1694.927188873291,40727,11118,29609,29609,0,13,10496000.0
10496,10496999,20.638647136008686,37.58713637208859,0.08184831860292796,1899.615221977234,690.5946846008301,1694.9575653076172,40733,11121,29612,29612,0,13,10497000.0
10497,10497999,20.638869725441236,37.58750900202571,0.08184427440868869,1899.7627384662628,690.6575076580048,1695.1621780395508,40733,11121,29612,29612,0,13,10498000.0
10498,10498999,20.63915324346508,37.58791278212262,0.08184749089568177,1899.9690549373627,690.7196552753448,1695.241958618164,40735,11122,29613,29613,0,13,10499000.0
10499,10499999,20.639872349213448,37.59180552706567,0.08184415192711625,1900.1066060066223,690.7815330028534,1695.3776588439941,40735,11122,29613,29613,0,13,10500000.0
10500,10500999,20.641221922634482,37.59871401202892,0.08183635138408851,1900.265121459961,690.8533751964569,1695.4834899902344,40735,11122,29613,29613,0,13,10501000.0
10501,10501999,20.642516627570977,37.60249411680718,0.08183628134868459,1900.6677560806274,690.9181015491486,1695.331356048584,40742,11125,29617,29617,0,13,10502000.0
10502,10502999,20.643910352642145,37.60609923088073,0.08184608276510963,1900.8889770507812,690.9830994606018,1695.4191436767578,40754,11126,29628,29628,0,13,10503000.0
10503,10503999,20.645447348790434,37.609570643125174,0.08186641973244457,1901.4569253921509,691.0472655296326,1695.322395324707,40764,11131,29633,29633,0,13,10504000.0
10504,10504999,20.647457953900165,37.614114584007076,0.08188854568223769,1901.5938653945923,691.1120400428772,1695.549648284912,40764,11131,29633,29633,0,13,10505000.0
10505,10505999,20.64926000128037,37.617649998683596,0.08191420728439469,1901.7345418930054,691.1844806671143,1695.7114715576172,40764,11131,29633,29633,0,13,10506000.0
10506,10506999,20.65085145800465,37.62080077599029,0.0819324995970373,1901.980578660965,691.2474055290222,1695.7995948791504,40766,11132,29634,29634,0,13,10507000.0
10507,10507999,20.652489700093692,37.62346305423616,0.08195814095345622,1902.1221368312836,691.3109726905823,1695.9074668884277,40766,11132,29634,29634,0,13,10508000.0
10508,10508999,20.653727822492765,37.62621956542535,0.08196883368759822,1902.3293204307556,691.3730804920197,1696.0242233276367,40778,11133,29645,29645,0,13,10509000.0
10509,10509999,20.653562673692228,37.626110576845484,0.08196388097107576,1902.546394109726,691.4354751110077,1696.8888816833496,40792,11134,29658,29658,0,13,10510000.0
10510,10510999,20.652988980014598,37.62514147465927,0.08196183291858583,1902.754689693451,691.4962861537933,1697.2038345336914,40794,11135,29659,29659,0,13,10511000.0
10511,10511999,20.652541595841505,37.624574352749036,0.08195757936189929,1902.9571788311005,691.5590944290161,1697.422451019287,40797,11136,29661,29661,0,13,10512000.0
10512,10512999,20.652066873827412,37.62389983967853,0.08195532784441928,1903.179069519043,691.621673822403,1697.555950164795,40799,11137,29662,29662,0,13,10513000.0
10513,10513999,20.65154111776681,37.62290569415313,0.08195439737833721,1903.4830660820007,691.6838233470917,1697.655860900879,40804,11139,29665,29665,0,13,10514000.0
10514,10514999,20.651001326317655,37.6219566892185,0.08195324491054046,1903.6990988254547,691.7458980083466,1697.8044395446777,40806,11140,29666,29666,0,13,10515000.0
10515,10515999,20.650550723979503,37.62129856137419,0.0819496190087936,1904.0173993110657,691.8108518123627,1697.8749084472656,40811,11142,29669,29669,0,13,10516000.0
10516,10516999,20.65045748984747,37.62133569816131,0.08194085613452295,1904.317843914032,691.8720035552979,1697.9450569152832,40816,11144,29672,29672,0,13,10517000.0
